housing_units_occ,homeowner_units_occ,renters_units_occ,med_rent,med_household_price,zip
5517,3010,2507,363,86200,601
12738,9481,3257,405,86300,602
19233,11152,8081,427,122400,603
2014,1501,513,312,91600,606
8858,6794,2064,410,88600,610
22589,14695,7894,389,97800,612
3515,2657,858,388,96100,616
7929,5858,2071,475,106100,617
2133,1436,697,456,129700,622
13523,8087,5436,432,110500,623
7581,5700,1881,428,75800,624
11431,7994,3437,449,100200,627
643,263,380,268,84700,631
7479,5705,1774,474,96600,637
5938,4057,1881,385,92100,638
9218,5769,3449,407,91800,641
11928,9248,2680,655,138700,646
1905,1430,475,-,89600,647
5149,3941,1208,538,93000,650
1315,1142,173,439,98700,652
3564,2498,1066,406,91400,653
6478,4605,1873,340,80400,656
14093,10448,3645,439,93500,659
6253,4574,1679,400,101600,660
14144,8889,5255,469,106400,662
5118,3095,2023,400,93900,664
8014,4642,3372,451,89000,667
9620,5699,3921,422,88000,669
2833,1924,909,291,83600,670
15374,11206,4168,486,107600,674
13310,8557,4753,420,96500,676
5141,3589,1552,447,121100,677
9033,5702,3331,469,107100,678
18557,11143,7414,423,90200,680
11902,6738,5164,411,113400,682
11217,8045,3172,416,91500,683
14025,9067,4958,402,97500,685
9943,6981,2962,510,100300,687
4286,3036,1250,433,96200,688
2371,1749,622,608,114000,690
11620,7960,3660,511,116900,692
18405,14610,3795,529,107300,693
29,29,0,-,-,694
10727,8080,2647,368,92000,698
8464,5751,2713,469,114500,703
2863,2393,470,401,77000,704
8222,6500,1722,457,114200,705
3862,2790,1072,375,89100,707
5974,4580,1394,475,88800,714
1073,734,339,301,81100,715
11150,6835,4315,382,115400,716
6640,3025,3615,261,105500,717
8241,6392,1849,423,91400,718
8701,6740,1961,486,90300,719
6665,4384,2281,376,89900,720
6253,4308,1945,314,92300,723
30216,19862,10354,500,123500,725
19711,14491,5220,713,142600,727
13284,9828,3456,405,98200,728
16333,12334,3999,524,110100,729
11961,7321,4640,383,93900,730
4380,3000,1380,447,80100,731
4443,3210,1233,481,92200,735
17219,11185,6034,476,117700,736
11593,7662,3931,523,101000,738
11737,7909,3828,518,121300,739
638,293,345,467,66400,740
1494,1211,283,561,83900,741
15976,12114,3862,530,114900,745
7829,6179,1650,425,88000,751
13673,10200,3473,500,108600,754
7465,5642,1823,458,92400,757
2403,1742,661,668,99900,765
7809,5523,2286,396,90800,766
11730,8498,3232,452,88100,767
13270,10188,3082,486,89000,769
12373,9207,3166,539,118200,771
6637,4479,2158,389,94900,772
6519,4623,1896,447,110400,773
465,296,169,525,116700,775
12931,9159,3772,429,108600,777
14733,12290,2443,682,144000,778
4021,3446,575,747,101000,780
5495,3128,2367,402,92000,782
10580,8371,2209,514,89400,783
14143,10150,3993,376,89200,784
127,127,0,-,95700,786
16394,11930,4464,429,97400,791
8918,6552,2366,412,101200,794
15083,10881,4202,488,92700,795
2743,1132,1611,542,267100,901
115,93,22,-,358500,906
8640,5056,3584,746,226400,907
2346,996,1350,484,137700,909
3721,1933,1788,711,270600,911
2491,1402,1089,549,134800,912
3392,477,2915,200,353700,913
10980,4846,6134,403,88400,915
8238,3758,4480,465,114700,917
8086,3766,4320,299,173400,918
6924,4068,2856,659,154000,920
13674,6621,7053,507,139100,921
10087,4252,5835,370,109800,923
19444,10716,8728,365,131000,924
3355,793,2562,441,124600,925
36420,25343,11077,593,172500,926
5972,3083,2889,531,198800,927
34,0,34,-,-,934
0,0,0,-,-,936
25361,19245,6116,583,131200,949
0,0,0,-,-,950
0,0,0,-,-,951
2825,1715,1110,518,102900,952
21687,17962,3725,629,138100,953
24585,17646,6939,571,125900,956
14440,10032,4408,529,131300,957
17966,11441,6525,597,139900,959
0,0,0,-,-,960
11446,7626,3820,549,152700,961
6888,3831,3057,415,107400,962
2598,1579,1019,501,94900,965
5784,4287,1497,771,220800,966
1826,1292,534,895,229400,968
14325,11186,3139,848,227500,969
8854,6189,2665,580,126100,971
21395,14381,7014,546,147000,976
8069,5383,2686,876,171100,979
5953,4047,1906,582,139400,982
13764,8998,4766,557,138700,983
12344,8731,3613,553,136200,985
21440,15841,5599,715,146800,987
7481,5484,1997,1093,213000,1001
9877,4578,5299,1316,355600,1002
36,4,32,-,-,1003
1798,1506,292,926,231000,1005
5475,4489,986,979,272500,1007
510,485,25,1675,231700,1008
105,105,0,-,227800,1009
1431,1266,165,1043,272600,1010
569,453,116,975,202100,1011
252,222,30,1250,255400,1012
9285,4316,4969,899,175600,1013
12609,8003,4606,924,182600,1020
1108,790,318,1198,122800,1022
449,361,88,857,244300,1026
7976,4847,3129,985,257200,1027
5957,4899,1058,930,266600,1028
283,211,72,695,245000,1029
4394,3643,751,903,243000,1030
507,298,209,904,180800,1031
228,206,22,1094,266000,1032
2493,2106,387,809,253900,1033
841,772,69,1292,275400,1034
2355,1848,507,1174,329900,1035
1985,1770,215,1105,282900,1036
247,225,22,-,294200,1037
1330,965,365,1113,299400,1038
511,343,168,1077,286600,1039
15275,6226,9049,818,188900,1040
1031,837,194,975,210900,1050
612,476,136,1098,267000,1053
780,682,98,1174,337600,1054
7961,5881,2080,999,230700,1056
3448,2914,534,835,242000,1057
6486,2621,3865,1175,340500,1060
4065,2929,1136,934,316500,1062
0,0,0,-,-,1063
9,0,9,-,-,1066
670,634,36,1225,284500,1068
3557,2686,871,859,200900,1069
261,225,36,850,233000,1070
513,479,34,855,216400,1071
650,588,62,1515,278800,1072
2397,2187,210,1010,325400,1073
151,18,133,1177,-,1074
6682,4860,1822,960,235900,1075
3801,3161,640,972,289800,1077
319,187,132,1375,184600,1079
955,530,425,902,163700,1080
775,619,156,843,190800,1081
4565,3210,1355,948,193700,1082
1113,834,279,653,217400,1083
76,70,6,-,266700,1084
15557,10636,4921,961,228900,1085
0,0,0,-,-,1086
211,148,63,1085,279500,1088
12037,7033,5004,868,222000,1089
540,420,120,859,216100,1092
116,109,7,-,349000,1093
176,82,94,503,183300,1094
5353,4707,646,768,299900,1095
1085,871,214,1083,282200,1096
21,6,15,-,-,1097
562,500,62,758,275500,1098
1449,123,1326,841,119900,1103
9077,4161,4916,851,138200,1104
4965,485,4480,658,142000,1105
5826,5186,640,1380,336400,1106
3794,867,2927,696,159900,1107
9878,3515,6363,928,156700,1108
9267,4084,5183,921,132300,1109
5686,4525,1161,799,164700,1118
4966,3477,1489,770,153600,1119
1078,1016,62,1714,171700,1128
2830,2142,688,1094,171900,1129
3335,1421,1914,953,132800,1151
0,0,0,-,-,1199
19879,12312,7567,853,174300,1201
3842,2387,1455,745,155000,1220
337,298,39,1536,254400,1222
1043,976,67,1118,264000,1223
126,76,50,-,184400,1224
1423,1159,264,995,193500,1225
3090,2323,767,848,184800,1226
43,33,10,-,312500,1229
3565,2546,1019,918,348000,1230
1175,1016,159,751,195300,1235
462,380,82,1338,288900,1236
1002,845,157,1103,278700,1237
2292,1537,755,887,288200,1238
2175,1403,772,910,332500,1240
172,100,72,-,268800,1242
140,138,2,-,241700,1243
41,31,10,-,381600,1244
416,349,67,1139,453000,1245
6752,4220,2532,738,151800,1247
351,335,16,658,255600,1253
489,461,28,1300,457200,1254
355,348,7,725,292400,1255
297,279,18,729,178800,1256
929,828,101,-,329900,1257
232,207,25,-,423800,1258
277,258,19,1050,362300,1259
152,82,70,-,427300,1260
535,263,272,769,392100,1262
76,57,19,850,350000,1264
601,525,76,1793,376500,1266
2397,1791,606,955,312400,1267
334,334,0,-,287300,1270
7989,4476,3513,866,190100,1301
588,487,101,906,283800,1330
5281,3861,1420,898,159700,1331
1053,838,215,940,243500,1337
50,44,6,-,212500,1338
580,497,83,928,234300,1339
743,615,128,959,217900,1340
751,646,105,1199,318500,1341
457,297,160,1741,291000,1342
24,24,0,-,255600,1343
581,471,110,791,199800,1344
173,166,7,-,245200,1346
79,59,20,-,124400,1347
463,368,95,1017,195200,1349
47,31,16,913,107800,1350
959,688,271,895,250900,1351
576,489,87,950,241800,1354
406,358,48,1098,253800,1355
1234,993,241,827,237200,1360
3199,2292,907,812,163200,1364
495,417,78,885,278000,1366
222,193,29,1330,208000,1367
497,415,82,917,231600,1368
1839,1328,511,865,246600,1370
1974,1642,332,948,295700,1373
1610,673,937,1389,295100,1375
2319,1209,1110,844,195600,1376
339,326,13,1089,219400,1378
385,309,76,940,209800,1379
14817,7845,6972,995,190900,1420
2008,1777,231,1579,247200,1430
1110,1013,97,1175,263300,1431
3415,2093,1322,1030,322500,1432
212,140,72,-,302900,1434
1274,902,372,614,171900,1436
206,190,16,-,202000,1438
8222,4288,3934,811,181500,1440
4048,3510,538,1258,459900,1450
1583,1488,95,1288,580600,1451
1732,1560,172,1267,263100,1452
16941,9666,7275,935,237100,1453
3559,3034,525,1354,436100,1460
4203,3475,728,1531,293300,1462
4338,3425,913,1115,338900,1463
2441,1691,750,944,309200,1464
135,135,0,-,404500,1467
1751,1493,258,1134,197700,1468
2735,2231,504,888,267600,1469
2844,2607,237,1132,281800,1473
694,655,39,1216,288500,1474
3821,2765,1056,710,195200,1475
6703,5673,1030,950,253300,1501
1125,958,167,1101,401100,1503
3428,2556,872,892,270900,1504
1771,1494,277,903,374600,1505
1467,1235,232,1008,226100,1506
4886,3976,910,1022,291700,1507
5533,3000,2533,1144,245200,1510
822,681,141,1030,247700,1515
3146,2509,637,1107,304800,1516
1449,991,458,908,333700,1518
2450,1973,477,1147,365100,1519
5692,5124,568,1269,309700,1520
953,819,134,1265,241400,1521
1150,993,157,1163,296500,1522
2304,1899,405,937,355200,1523
2517,1845,672,897,247900,1524
163,41,122,1125,272100,1525
5234,3829,1405,1104,278700,1527
1226,909,317,1166,298500,1529
460,401,59,925,285100,1531
5429,4407,1022,1399,415000,1532
2307,1728,579,797,342700,1534
1821,1282,539,842,246900,1535
2803,2235,568,1117,345700,1536
954,677,277,1025,181300,1537
4316,3156,1160,865,249100,1540
1240,1156,84,1125,374100,1541
788,606,182,960,260100,1542
2956,2447,509,959,283800,1543
13140,9797,3343,1344,398000,1545
6943,2928,4015,901,193500,1550
1733,1098,635,1130,345900,1560
108,43,65,-,-,1561
4865,3405,1460,879,254200,1562
2755,2423,332,1314,340700,1564
2146,1914,232,1429,267400,1566
2608,2221,387,849,438600,1568
4805,3805,1000,1177,287300,1569
6884,3975,2909,891,222800,1570
3878,2691,1187,971,258500,1571
6794,4232,2562,1625,449600,1581
2074,1738,336,940,278800,1583
1874,1345,529,1252,241000,1585
3534,2022,1512,975,264300,1588
3441,3248,193,841,350700,1590
9695,5713,3982,1206,231000,1602
7110,3195,3915,1046,188700,1603
14575,6770,7805,1118,219100,1604
10656,3305,7351,960,213300,1605
8120,5221,2899,1105,225400,1606
3714,1425,2289,1049,178600,1607
1717,179,1538,938,168400,1608
7722,2909,4813,1060,313200,1609
7928,1143,6785,1068,172700,1610
792,506,286,1081,223600,1611
1570,1455,115,973,309500,1612
12997,10227,2770,1465,408800,1701
15227,5326,9901,1331,334100,1702
261,163,98,-,265600,1718
2263,1617,646,1097,527400,1719
8527,6280,2247,1357,578200,1720
6685,5456,1229,1340,386400,1721
5230,3871,1359,1843,627000,1730
555,6,549,2789,-,1731
1678,1561,117,875,525500,1740
1823,1718,105,1059,824100,1741
6772,5094,1678,2007,814000,1742
210,170,40,1423,378100,1745
5278,4742,536,1083,435600,1746
2263,1869,394,1196,328900,1747
5991,4976,1015,1740,581700,1748
7686,5705,1981,1248,335300,1749
15718,8980,6738,1435,333600,1752
4250,3262,988,1157,340500,1754
2023,1780,243,1487,442500,1756
11135,7608,3527,1192,297800,1757
14310,10162,4148,1509,537200,1760
1556,1452,104,1447,769800,1770
3278,2955,323,1004,612200,1772
2140,1613,527,1849,883600,1773
2575,2270,305,1453,487200,1775
6355,5875,480,1005,677900,1776
5002,4479,523,1270,690500,1778
15756,9775,5981,1516,421200,1801
9942,7244,2698,1919,491800,1803
12474,10173,2301,1515,608400,1810
11509,9047,2462,1475,386400,1821
9766,8286,1480,1530,405900,1824
11224,8874,2350,1287,316900,1826
1140,1101,39,1750,465400,1827
10049,5382,4667,1170,294900,1830
8849,4964,3885,1177,279300,1832
3253,2594,659,1571,458400,1833
2368,2007,361,1337,390700,1834
5257,3690,1567,1183,276900,1835
2262,144,2118,906,103000,1840
14795,4303,10492,1098,261800,1841
8578,2903,5675,1183,255300,1843
17692,12752,4940,1202,324300,1844
11121,7984,3137,1499,484500,1845
5457,2133,3324,1161,217500,1850
10165,4338,5827,1182,263600,1851
13747,6474,7273,1092,263700,1852
9492,3541,5951,968,239900,1854
2775,2445,330,1094,340300,1860
3388,2886,502,1265,371700,1862
3860,3145,715,1193,315200,1863
5412,4753,659,1451,497600,1864
9099,7562,1537,1257,534100,1867
11529,9859,1670,1709,370500,1876
4440,3721,719,1086,368500,1879
10556,7998,2558,1343,470900,1880
8350,7231,1119,1781,530400,1886
8028,6890,1138,1915,447300,1887
7879,6713,1166,1813,893700,1890
885,85,800,883,297400,1901
17247,5907,11340,1121,272500,1902
6164,4670,1494,1329,337700,1904
8374,3897,4477,1118,278600,1905
10436,8500,1936,937,374500,1906
5535,4335,1200,1754,455400,1907
1572,1075,497,1367,628200,1908
7131,4891,2240,1144,326900,1913
16687,10202,6485,1212,411700,1915
2753,2699,54,850,662400,1921
1144,1012,132,-,487800,1922
10703,7723,2980,1356,395100,1923
1430,1184,246,1128,555900,1929
13137,8265,4872,1108,395800,1930
0,0,0,-,-,1937
5683,4219,1464,1084,472800,1938
4891,4145,746,1912,633700,1940
2072,1530,542,1183,815700,1944
8236,6424,1812,1507,632600,1945
2975,2662,313,1573,494900,1949
7918,6156,1762,1274,514700,1950
1654,1320,334,1319,510100,1951
3759,2970,789,1344,353800,1952
21576,14177,7399,1314,373100,1960
3243,2324,919,1286,489200,1966
2170,1861,309,1261,436900,1969
18206,9162,9044,1235,347200,1970
2658,2128,530,1162,552800,1982
2145,1946,199,-,588500,1983
1397,1277,120,-,579900,1984
1589,1459,130,2013,557800,1985
6430,5340,1090,1147,291400,2019
9021,6840,2181,1660,486400,2021
3119,2346,773,1688,861800,2025
9974,7017,2957,1614,445200,2026
2015,1857,158,2783,1002500,2030
1590,1345,245,-,479000,2032
6657,4253,2404,1428,411100,2035
11655,9476,2179,1250,420000,2038
8743,7116,1627,2163,742300,2043
4860,3400,1460,1308,393700,2045
66,32,34,-,-,2047
8477,6106,2371,1208,394200,2048
9779,7795,1984,1362,442900,2050
4153,3613,540,1291,646400,2052
4691,4197,494,1060,400700,2053
3007,2482,525,1659,398100,2054
3149,3022,127,1309,484900,2056
3674,3420,254,446,615700,2061
11764,6857,4907,1530,420300,2062
6846,5911,935,1116,566500,2066
6274,5542,732,1563,538700,2067
259,243,16,-,406600,2071
10784,7618,3166,1399,333700,2072
7090,5813,1277,1432,471500,2081
5474,4655,819,1662,703000,2090
4162,3465,697,1094,434900,2093
1810,816,994,2446,1195400,2108
1917,709,1208,2749,852900,2109
1385,934,451,2529,1059200,2110
3476,845,2631,1401,848800,2111
4333,931,3402,1850,589900,2113
7426,1882,5544,2234,693200,2114
9234,1126,8108,1584,682200,2115
12160,4650,7510,1865,1090500,2116
12962,4492,8470,1230,804700,2118
11428,2632,8796,919,392600,2119
4933,381,4552,1078,444600,2120
10675,2297,8378,862,455900,2121
8536,3509,5027,1419,443900,2122
18953,7324,11629,1384,385200,2124
12474,4322,8152,1397,408900,2125
10095,4192,5903,1479,349700,2126
16976,6907,10069,1528,591000,2127
16399,4514,11885,1396,401300,2128
9050,4175,4875,1355,686700,2129
16631,7502,9129,1546,515100,2130
12684,7037,5647,1438,443700,2131
11421,8221,3200,1615,491300,2132
8205,1057,7148,1788,486200,2134
19539,4816,14723,1769,475500,2135
11955,6247,5708,1310,381900,2136
14131,5565,8566,2149,823400,2138
14414,5163,9251,2047,674600,2139
9445,3321,6124,1769,753100,2140
6745,2284,4461,1956,637600,2141
1522,215,1307,3134,932400,2142
11168,3236,7932,1775,626000,2143
10891,3854,7037,1898,675700,2144
10773,3957,6816,1622,541700,2145
23076,9432,13644,1520,381500,2148
15736,5959,9777,1386,382400,2149
13141,3436,9705,1362,323400,2150
19999,9531,10468,1351,354700,2151
8006,4427,3579,1330,408900,2152
22972,13142,9830,1669,464600,2155
517,0,517,2348,-,2163
25076,10401,14675,1460,383300,2169
7621,4078,3543,1308,437900,2170
7886,4493,3393,1621,439500,2171
11256,7349,3907,1362,508700,2176
9241,6091,3150,1477,460800,2180
14074,10384,3690,1424,436800,2184
8881,7459,1422,1459,586200,2186
6348,3715,2633,1430,356800,2188
6206,3999,2207,1426,335800,2189
7150,4905,2245,1434,377800,2190
3580,2889,691,1419,348800,2191
765,22,743,3001,-,2199
25,12,13,-,-,2203
1945,673,1272,3087,815000,2210
7553,810,6743,1883,515900,2215
21401,9777,11624,1096,258900,2301
10756,7692,3064,1036,232900,2302
1582,1158,424,1087,309300,2322
8050,5705,2345,1495,351100,2324
4491,4085,406,1361,281500,2330
5590,4997,593,1857,629000,2332
4907,3985,922,1201,331500,2333
2798,2482,316,1703,285100,2338
4882,4281,601,1159,489600,2339
3806,3495,311,775,353400,2341
4085,3288,797,981,293000,2343
9196,7361,1835,1189,299500,2346
3987,3458,529,1352,367700,2347
6413,4491,1922,1167,339000,2351
4422,3536,886,1348,432100,2356
22,10,12,-,-,2357
6489,5606,883,1653,382700,2359
23101,18260,4841,1376,359300,2360
4859,3992,867,1277,365900,2364
0,0,0,-,-,2366
1019,879,140,1281,372100,2367
12274,8421,3853,1331,301600,2368
6897,5137,1760,1216,298400,2370
3739,2945,794,1536,346000,2375
2515,2153,362,1391,341400,2379
5379,3770,1609,1227,300200,2382
4991,4432,559,2131,850300,2420
6766,5216,1550,2316,848500,2421
8529,4913,3616,2199,880800,2445
13216,5592,7624,2180,843400,2446
7500,4285,3215,1830,477500,2451
4939,3076,1863,1769,527100,2452
11139,4519,6620,1454,502200,2453
0,0,0,-,-,2457
4951,3021,1930,1793,766500,2458
6605,5333,1272,1903,1047600,2459
3664,2235,1429,1800,828600,2460
2708,2059,649,1957,875800,2461
552,340,212,1986,884000,2462
1194,806,388,1750,627200,2464
4227,3356,871,1852,760100,2465
2955,1646,1309,1731,809700,2466
6004,4101,1903,2187,850600,2467
1974,1832,142,2176,1168900,2468
15607,8062,7545,1794,521700,2472
11560,6538,5022,1677,597500,2474
7250,4602,2648,1580,628200,2476
9771,6239,3532,1903,812500,2478
4768,4005,763,2218,1186400,2481
3886,3097,789,1425,983700,2482
7093,6363,730,926,835200,2492
3800,3288,512,1729,1211500,2493
3672,2585,1087,1783,730900,2494
5707,4473,1234,1293,332800,2532
230,165,65,-,649200,2534
480,397,83,1569,1075000,2535
7990,6437,1553,1508,344800,2536
2489,2319,170,1496,434500,2537
1459,996,463,1138,250900,2538
1397,1076,321,1774,738000,2539
4003,2700,1303,980,573300,2540
286,10,276,1486,-,2542
370,249,121,1232,819200,2543
97,97,0,-,-,2553
3637,2491,1146,1765,1044800,2554
1182,1005,177,1492,517500,2556
1760,1417,343,1530,561100,2557
642,434,208,1322,239900,2558
1905,1401,504,1344,359600,2559
133,106,27,-,370000,2561
1247,969,278,1418,390000,2562
3902,3401,501,1271,369900,2563
73,73,0,-,"2,000,000+",2564
1571,1006,565,1399,589700,2568
4461,2901,1560,1003,285000,2571
1136,1011,125,1158,745500,2575
1775,1671,104,1256,268400,2576
12,12,0,-,-,2584
6353,3205,3148,1193,258700,2601
826,726,100,1703,581100,2630
4241,3708,533,917,428700,2631
4433,3819,614,1361,363300,2632
2033,1617,416,956,632700,2633
1481,1342,139,-,428200,2635
68,54,14,-,455600,2637
1530,1301,229,1218,479300,2638
1519,867,652,1295,329000,2639
112,112,0,-,603700,2641
2371,2058,313,1196,463500,2642
0,0,0,-,-,2643
1485,1211,274,1255,334600,2644
4183,3564,619,1312,383100,2645
931,821,110,1271,520300,2646
54,45,9,-,"2,000,000+",2647
2788,2578,210,1901,354600,2648
6240,5447,793,1382,349500,2649
355,263,92,1218,792100,2650
0,0,0,-,-,2651
358,307,51,1063,542900,2652
2845,2276,569,890,637200,2653
1517,1219,298,1374,484400,2655
1760,1347,413,1307,600500,2657
431,409,22,-,580400,2659
2978,2271,707,1101,346000,2660
50,41,9,-,1094700,2663
4007,2895,1112,1293,334800,2664
283,244,39,-,400000,2666
1534,1340,194,1148,495700,2667
1175,942,233,1419,454300,2668
38,28,10,-,-,2669
679,483,196,1037,396700,2670
427,352,75,1155,411100,2671
133,98,35,-,897700,2672
3667,2878,789,1383,275000,2673
3035,2821,214,1401,372500,2675
1530,1420,110,1574,344100,2702
17378,11730,5648,1057,283100,2703
19,19,0,-,770800,2713
1290,1157,133,1006,352500,2715
1793,1574,219,1116,344100,2717
2339,1975,364,873,273100,2718
6491,4905,1586,921,274500,2719
13047,5186,7861,847,238800,2720
11005,3890,7115,762,237300,2721
6642,2052,4590,768,230200,2723
7820,2392,5428,744,241200,2724
956,743,213,951,258000,2725
6070,5004,1066,1095,273900,2726
1863,1471,392,1182,474100,2738
2597,2021,576,1129,428200,2739
18303,7327,10976,824,209500,2740
4051,3455,596,807,286200,2743
4598,1592,3006,793,224400,2744
10001,5848,4153,871,225900,2745
6219,1091,5128,786,209200,2746
6919,5330,1589,948,326400,2747
4693,3742,951,909,373600,2748
10226,6871,3355,1041,346300,2760
3560,2690,870,1361,332500,2762
628,556,72,1132,404800,2763
1465,1323,142,775,339900,2764
6458,5485,973,1112,338500,2766
5198,4264,934,1380,337100,2767
4114,3720,394,1214,388700,2769
1840,1682,158,1007,403300,2770
6004,5230,774,1093,329700,2771
6149,5302,847,937,280900,2777
2342,2207,135,-,357300,2779
19753,12039,7714,994,258100,2780
6306,5248,1058,1074,354300,2790
170,122,48,-,579400,2791
223,66,157,788,193000,2802
840,750,90,599,227100,2804
6111,5414,697,1352,418900,2806
429,318,111,814,1098000,2807
889,700,189,1063,241100,2808
8442,5507,2935,1060,314100,2809
402,389,13,-,314400,2812
3200,2772,428,1107,309800,2813
2903,2527,376,1059,268900,2814
76,76,0,-,336700,2815
13304,10161,3143,965,224800,2816
2161,1793,368,2003,333300,2817
7466,5504,1962,1054,392600,2818
2352,2033,319,1271,322600,2822
2006,1604,402,1008,293800,2825
261,236,25,-,233300,2826
814,764,50,2170,294300,2827
3151,2570,581,1178,267800,2828
2290,1785,505,890,270100,2830
1231,1077,154,1405,281000,2831
1718,1410,308,1083,272700,2832
415,321,94,660,262800,2833
2257,1890,367,1633,641800,2835
75,75,0,-,220600,2836
1611,1256,355,1308,494900,2837
1352,647,705,953,264800,2838
803,566,237,1232,155600,2839
10600,4333,6267,1204,425400,2840
0,0,0,-,-,2841
6773,3569,3204,1292,363900,2842
8927,6615,2312,975,319500,2852
3378,2972,406,942,316400,2857
226,128,98,1098,228600,2858
2473,1839,634,955,232600,2859
18379,6383,11996,868,179400,2860
9971,6153,3818,985,184300,2861
6309,1225,5084,838,148700,2863
13492,10064,3428,927,274400,2864
6315,4597,1718,1268,315100,2865
7114,5416,1698,1390,379200,2871
152,137,15,-,277400,2872
98,98,0,-,346200,2873
2210,2059,151,1625,430700,2874
191,124,67,-,281300,2875
130,0,130,1363,-,2876
6710,5248,1462,943,267900,2878
8418,6223,2195,1099,353100,2879
1042,669,373,1267,357800,2881
6039,4077,1962,1335,432700,2882
5014,2696,2318,957,283300,2885
12552,8313,4239,1122,224100,2886
8223,6307,1916,1050,206200,2888
11209,8273,2936,1119,199300,2889
9102,5722,3380,1052,295000,2891
1771,1451,320,1596,302100,2892
13086,6964,6122,972,189600,2893
327,310,17,-,238400,2894
16940,6084,10856,883,164600,2895
4430,3629,801,1011,285800,2896
666,492,174,1039,247700,2898
4620,834,3786,1007,325600,2903
12507,6021,6486,880,206200,2904
8741,3957,4784,961,192200,2905
10694,5100,5594,1254,415100,2906
9004,2481,6523,920,159100,2907
12232,5386,6846,997,179700,2908
14566,4219,10347,920,166700,2909
8314,5883,2431,1042,187300,2910
6621,3471,3150,979,202400,2911
0,0,0,-,-,2912
8769,4539,4230,946,205300,2914
7188,4680,2508,949,215100,2915
3660,2596,1064,952,235700,2916
4683,3635,1048,836,279200,2917
11623,7877,3746,999,221600,2919
14140,8779,5361,988,227800,2920
4474,3726,748,1281,348300,2921
4036,3717,319,1304,347900,3031
1982,1771,211,1486,310200,3032
1715,1578,137,1206,322400,3033
1527,1426,101,1650,280700,3034
1683,1645,38,-,336300,3036
1671,1483,188,1167,284800,3037
13095,8211,4884,1173,233800,3038
2569,2213,356,1188,273100,3042
658,613,45,1273,286500,3043
1715,1491,224,1532,260200,3044
5105,4134,971,1092,259600,3045
960,889,71,1047,291200,3046
642,501,141,773,223700,3047
1415,1187,228,903,214700,3048
2954,2720,234,1553,466200,3049
9054,7353,1701,1310,279700,3051
2983,2584,399,1220,308900,3052
8963,7804,1159,1410,306600,3053
10034,8771,1263,1542,273200,3054
6244,4000,2244,1147,246400,3055
864,786,78,1130,325200,3057
12155,4110,8045,1096,228100,3060
11340,8012,3328,1452,267400,3062
6975,4260,2715,1394,264800,3063
5804,3361,2443,1176,269000,3064
1914,1760,154,1182,300900,3070
1837,1621,216,1100,229900,3071
4631,4133,498,1158,340600,3076
4104,3355,749,1413,225400,3077
11413,8763,2650,1115,310200,3079
639,584,55,1158,271200,3082
504,460,44,1300,267100,3084
1649,1363,286,964,252500,3086
5010,4739,271,1949,420600,3087
1657,154,1503,920,212300,3101
13357,5174,8183,1148,208800,3102
13987,6369,7618,1040,198500,3103
13489,6465,7024,1069,250200,3104
5181,4052,1129,1234,241600,3106
4050,3026,1024,1190,221800,3109
7787,6728,1059,1685,394500,3110
78,72,6,-,368200,3215
933,766,167,910,212100,3216
850,494,356,845,180200,3217
317,265,52,-,223000,3218
2928,2633,295,854,190700,3220
867,749,118,1146,226600,3221
2283,1737,546,862,195100,3222
1378,1009,369,778,171100,3223
948,897,51,763,260700,3224
1241,1101,140,1087,185600,3225
413,359,54,1150,339900,3226
446,375,71,1238,293900,3227
2129,1877,252,1223,270600,3229
551,494,57,1034,179500,3230
108,93,15,-,319000,3231
50,45,5,-,356300,3233
1773,1410,363,1040,229300,3234
3797,2345,1452,843,164800,3235
900,853,47,1330,245700,3237
50,39,11,-,65400,3238
488,435,53,879,166700,3240
343,311,32,873,285800,3241
1795,1333,462,860,235700,3242
384,352,32,1554,186500,3243
3021,2668,353,1113,174000,3244
787,631,156,909,292600,3245
6967,3981,2986,914,186400,3246
3048,2703,345,1041,245400,3249
530,314,216,856,206500,3251
2752,2069,683,962,286500,3253
1714,1469,245,1275,325700,3254
875,820,55,905,283600,3255
925,794,131,913,217800,3256
1698,1398,300,995,361100,3257
976,890,86,1109,250800,3258
153,135,18,-,298300,3259
303,254,49,1319,281700,3260
1636,1419,217,998,246000,3261
427,288,139,763,197300,3262
1691,975,716,830,196400,3263
2256,1448,808,651,185300,3264
888,748,140,931,172500,3266
470,455,15,1031,215300,3268
1152,973,179,747,265600,3269
150,141,9,-,230600,3273
4419,3322,1097,1026,200700,3275
3261,2201,1060,912,169500,3276
1112,773,339,1019,245500,3278
334,283,51,750,146600,3279
529,502,27,1250,207900,3280
3158,2768,390,1436,242400,3281
346,295,51,1063,192600,3282
341,282,59,-,216700,3284
1056,948,108,1043,223500,3285
670,521,149,1276,292500,3287
1774,1676,98,1025,280600,3290
40,40,0,-,254500,3291
53,42,11,-,190400,3293
13178,6847,6331,1056,231200,3301
6145,4202,1943,1028,200800,3303
2752,2442,310,1138,316900,3304
2075,1762,313,1039,233700,3307
10336,5622,4714,989,185400,3431
1048,822,226,979,198400,3440
89,36,53,885,150000,3441
596,421,175,1034,166500,3442
199,151,48,-,258300,3443
578,477,101,831,276300,3444
303,243,60,1175,185500,3445
2407,1939,468,986,176200,3446
1010,862,148,1027,182500,3447
289,254,35,1175,191700,3448
779,659,120,1154,297700,3449
450,392,58,972,258900,3450
1698,1312,386,793,134500,3451
2094,1384,710,821,188600,3452
936,588,348,852,197600,3455
314,281,33,944,172600,3456
300,255,45,964,274300,3457
3132,2150,982,957,264200,3458
1816,1513,303,1173,236900,3461
560,465,95,772,241200,3462
420,382,38,1190,222600,3464
829,604,225,893,147200,3465
639,525,114,726,231800,3466
628,590,38,1107,256400,3467
2043,1470,573,1113,142900,3470
2799,1514,1285,679,162800,3561
3914,2229,1685,726,88300,3570
1066,736,330,698,153200,3574
14,14,0,-,825000,3575
1339,1083,256,662,155200,3576
185,147,38,700,227200,3579
545,453,92,979,347800,3580
1471,1129,342,567,152900,3581
1042,764,278,673,79600,3582
431,373,58,893,188300,3583
1499,1097,402,749,139900,3584
1050,843,207,772,155800,3585
277,256,21,765,306100,3586
707,608,99,743,149200,3588
416,314,102,625,93200,3590
550,450,100,467,156400,3592
209,181,28,818,240300,3593
289,234,55,823,195600,3595
168,127,41,571,74000,3597
1514,1000,514,864,131800,3598
177,164,13,983,176900,3601
1056,780,276,845,204100,3602
2164,1745,419,797,135400,3603
96,96,0,-,230000,3604
390,353,37,868,171800,3605
168,153,15,1229,167900,3607
1247,1000,247,916,234300,3608
263,184,79,788,123200,3609
271,235,36,765,185500,3740
1511,1179,332,1031,206600,3741
5652,3290,2362,910,132800,3743
611,546,65,984,273800,3745
104,101,3,-,285000,3746
2159,1578,581,1210,272400,3748
279,268,11,-,484700,3750
253,176,77,1017,262000,3751
290,229,61,1079,174600,3752
1238,1117,121,1191,245000,3753
149,0,149,935,-,3754
2789,1780,1009,1449,549000,3755
200,186,14,-,203400,3765
4250,2167,2083,1071,240300,3766
638,569,69,1396,424500,3768
152,138,14,-,320700,3770
328,294,34,758,187300,3771
3165,2276,889,880,160700,3773
811,665,146,1107,139300,3774
512,423,89,1140,308300,3777
326,279,47,1036,197300,3779
192,160,32,-,156300,3780
765,661,104,1642,284800,3781
1216,911,305,1289,321700,3782
1818,857,961,995,255300,3784
875,527,348,909,133400,3785
10327,5420,4907,1237,403500,3801
1333,1134,199,872,229500,3809
744,679,65,-,498800,3810
2734,2520,214,-,359900,3811
386,230,156,919,351200,3812
1317,1126,191,1003,164600,3813
1153,815,338,879,157500,3814
578,503,75,969,241500,3816
406,287,119,866,166600,3817
1764,1178,586,778,178900,3818
1604,1375,229,1282,265700,3819
13202,6992,6210,1095,249900,3820
570,496,74,1266,360600,3823
3308,1845,1463,1024,371900,3824
3375,3084,291,1345,283600,3825
1031,695,336,794,319500,3826
1173,1097,76,1982,355500,3827
875,806,69,-,240000,3830
161,121,40,980,290400,3832
8923,6661,2262,1205,313300,3833
2798,1903,895,965,204900,3835
573,523,50,1250,269500,3836
592,556,36,1146,253100,3837
588,475,113,794,240400,3838
1408,917,491,1041,184300,3839
1459,1224,235,2068,433100,3840
2592,2160,432,987,311900,3841
7108,5248,1860,1147,360200,3842
896,817,79,1615,470000,3844
613,419,194,880,199200,3845
435,349,86,893,364900,3846
198,144,54,-,-,3847
2404,2035,369,1260,273500,3848
580,506,74,1271,205500,3849
134,134,0,-,386200,3850
1545,1319,226,1029,199500,3851
176,176,0,-,211100,3852
253,227,26,-,299600,3853
390,321,69,2284,949200,3854
977,917,60,1159,240700,3855
566,513,53,1529,441600,3856
4022,2114,1908,1147,276500,3857
1793,1415,378,1108,306300,3858
1741,1189,552,991,234200,3860
1922,1603,319,1059,327000,3861
1722,1549,173,1790,411600,3862
716,634,82,-,193800,3864
3039,2523,516,1318,273800,3865
9116,6049,3067,975,168200,3867
2185,1541,644,1115,152800,3868
1001,735,266,1134,237800,3869
2244,1769,475,1647,668900,3870
79,79,0,-,-,3871
1250,1106,144,733,210200,3872
2168,1991,177,1395,309800,3873
3897,2575,1322,1079,270000,3874
443,342,101,788,262700,3875
4964,2845,2119,1035,180300,3878
605,492,113,1057,171200,3882
63,63,0,-,174100,3883
1378,1236,142,989,266600,3884
2797,2443,354,1552,406900,3885
898,571,327,785,165100,3886
752,658,94,1183,179600,3887
56,56,0,-,224300,3890
2852,2332,520,903,291900,3894
2966,2617,349,915,227100,3901
998,922,76,1289,395900,3902
2647,2191,456,924,341800,3903
3418,2138,1280,1404,285300,3904
1018,880,138,2265,428300,3905
1875,1563,312,841,265200,3906
634,519,115,1458,536200,3907
2865,2173,692,986,259300,3908
4441,3651,790,1044,409100,3909
159,71,88,-,328300,3910
26,26,0,-,-,3911
1059,905,154,1058,197700,4001
2948,2600,348,1008,219700,4002
163,135,28,-,423200,4003
9565,4991,4574,926,226600,4005
91,9,82,1125,-,4006
1204,1032,172,1250,212800,4008
2286,1724,562,919,157800,4009
595,532,63,1031,178500,4010
8505,5760,2745,938,236500,4011
1577,1177,400,790,212200,4015
223,196,27,1104,433300,4017
18,18,0,-,-,4019
589,432,157,625,190900,4020
2360,1868,492,1153,329800,4021
452,428,24,960,212600,4022
216,187,29,883,177400,4024
2157,1903,254,1033,193000,4027
716,585,131,1051,190400,4029
939,880,59,1055,209300,4030
3395,2572,823,1168,312100,4032
1243,996,247,720,184500,4037
5982,4973,1009,985,261600,4038
3125,2432,693,1065,220000,4039
1408,1202,206,846,177100,4040
603,505,98,858,156300,4041
2022,1757,265,924,197800,4042
4966,3776,1190,1007,301200,4043
3390,2877,513,1085,309400,4046
771,641,130,754,176200,4047
1235,1000,235,924,173600,4048
1262,1122,140,1045,184200,4049
120,96,24,-,373100,4050
391,356,35,683,202800,4051
1595,1432,163,1135,185800,4055
126,94,32,-,184500,4056
22,22,0,-,-,4057
1104,906,198,-,186900,4061
6555,5714,841,1036,237700,4062
315,161,154,326,296400,4063
4463,2986,1477,890,202400,4064
367,227,140,1104,464300,4066
557,439,118,989,154000,4068
628,553,75,981,281900,4069
2135,1851,284,930,263900,4071
7768,5245,2523,1035,245500,4072
6788,3864,2924,848,168300,4073
7624,6253,1371,1255,362600,4074
1054,977,77,980,200100,4076
1656,1303,353,967,360400,4079
1979,1395,584,859,181300,4083
2802,2538,264,1060,236400,4084
706,694,12,-,212700,4085
3796,2861,935,971,219700,4086
783,695,88,1349,216100,4087
579,508,71,832,160200,4088
4582,3835,747,799,278200,4090
336,303,33,1188,166600,4091
8031,4958,3073,964,225400,4092
3105,2579,526,964,231600,4093
540,468,72,857,191800,4095
3474,2627,847,1164,357900,4096
1386,1240,146,1292,325400,4097
9033,1687,7346,1032,323300,4101
7811,3720,4091,1053,266200,4102
13246,7741,5505,1165,264700,4103
4633,3950,683,1528,432400,4105
10915,6840,4075,1226,247600,4106
3700,3212,488,1191,415800,4107
405,351,54,1025,360700,4108
51,38,13,-,452600,4109
533,505,28,-,613800,4110
10262,5800,4462,758,155900,4210
178,169,9,425,123900,4216
1308,1057,251,473,182000,4217
591,539,52,1107,172100,4219
1144,1019,125,770,144500,4220
304,254,50,850,117400,4221
1592,1425,167,789,229000,4222
928,712,216,682,93100,4224
65,61,4,-,130500,4226
64,47,17,-,59700,4227
0,0,0,-,-,4228
113,98,15,-,155000,4231
52,52,0,-,48400,4234
1617,1378,239,1089,183400,4236
84,74,10,-,211100,4237
486,413,73,1000,190100,4238
1833,1519,314,554,130100,4239
15779,7971,7808,727,140100,4240
1808,1354,454,867,137600,4250
1834,1449,385,740,148500,4252
833,679,154,646,157200,4253
1428,774,654,593,84700,4254
238,201,37,1099,171200,4255
1196,930,266,723,123500,4256
986,824,162,584,74600,4257
915,833,82,850,191700,4258
1318,1109,209,794,167500,4259
2138,1756,382,1024,234000,4260
155,132,23,914,234400,4261
858,726,132,789,152600,4263
441,352,89,1115,172400,4265
29,29,0,-,188800,4267
1694,1265,429,713,129500,4268
2161,1760,401,870,141300,4270
0,0,0,-,-,4271
2368,1893,475,763,182500,4274
154,139,15,850,105400,4275
2403,1730,673,587,87700,4276
2699,2232,467,1012,161200,4280
1742,1178,564,626,141100,4281
2302,1828,474,921,186100,4282
442,395,47,764,233100,4284
178,154,24,907,155400,4285
15,0,15,-,-,4286
1358,1220,138,784,203400,4287
694,517,177,755,143400,4289
543,487,56,746,126600,4290
327,294,33,281,153800,4292
1600,1260,340,611,123500,4294
11427,6851,4576,713,150600,4330
739,663,76,863,172700,4342
16,16,0,-,-,4343
1401,1008,393,714,143200,4344
4666,3505,1161,740,155200,4345
852,612,240,757,125200,4346
1099,628,471,865,193200,4347
1192,1013,179,960,178400,4348
446,417,29,1179,162300,4349
1431,1247,184,763,183600,4350
1038,825,213,849,219400,4351
667,614,53,775,168400,4352
957,806,151,1022,150200,4353
631,578,53,1055,166400,4354
1019,855,164,965,197600,4355
1603,1199,404,859,155100,4357
1747,1541,206,751,164100,4358
135,112,23,-,110300,4359
209,188,21,883,161400,4360
1063,833,230,831,135000,4363
2497,1701,796,787,197400,4364
18924,10408,8516,810,157700,4401
291,264,27,696,131500,4406
73,62,11,775,108300,4408
460,411,49,596,110700,4410
634,537,97,914,150200,4411
3669,2386,1283,801,162000,4412
93,88,5,-,65000,4413
568,474,94,656,85100,4414
107,81,26,628,63900,4415
2307,1768,539,-,152500,4416
155,146,9,-,82500,4417
665,560,105,764,79800,4418
1046,889,157,979,161600,4419
288,196,92,1034,354800,4421
462,444,18,511,130200,4422
327,266,61,472,78200,4424
1964,1331,633,529,130300,4426
1045,905,140,684,131400,4427
1139,953,186,864,152200,4428
1838,1547,291,836,189800,4429
820,617,203,505,55800,4430
29,29,0,-,184800,4431
420,358,62,1111,146400,4434
449,426,23,600,119200,4435
467,378,89,630,122700,4438
798,610,188,644,158500,4441
13,13,0,-,190600,4442
1059,782,277,539,117600,4443
3500,2946,554,898,206800,4444
558,406,152,625,89100,4448
563,482,81,829,131100,4449
474,426,48,850,114200,4450
103,96,7,-,58800,4451
314,222,92,813,84200,4453
13,13,0,-,78800,4454
295,239,56,676,109800,4455
1057,893,164,937,157100,4456
2390,1625,765,643,98100,4457
413,317,96,408,80800,4459
535,476,59,629,61100,4460
1170,897,273,958,115500,4461
2306,1706,600,540,66000,4462
1297,939,358,692,71700,4463
249,189,60,414,108500,4464
4014,2583,1431,697,132500,4468
0,0,0,-,-,4469
316,287,29,715,86300,4471
932,774,158,910,179800,4472
3075,1608,1467,924,185900,4473
1492,1311,181,873,176600,4474
257,232,25,563,78800,4475
540,465,75,783,199800,4476
167,136,31,-,210900,4478
566,463,103,822,110300,4479
205,188,17,-,133300,4481
91,86,5,-,153000,4485
393,365,28,725,67900,4487
552,501,51,-,147200,4488
80,63,17,-,208800,4489
117,110,7,-,83000,4490
68,63,5,-,48900,4491
55,44,11,578,81300,4492
762,643,119,767,109900,4493
190,178,12,-,69500,4495
1609,1344,265,709,165900,4496
152,133,19,439,71300,4497
5105,3332,1773,839,178900,4530
347,293,54,1043,205900,4535
944,872,72,986,287700,4537
998,702,296,756,237700,4538
488,435,53,1065,182400,4539
21,21,0,-,475000,4541
928,549,379,786,260400,4543
306,298,8,-,647600,4544
391,357,34,1103,176100,4547
444,374,70,767,346700,4548
341,321,20,1036,223400,4551
792,575,217,919,277400,4553
409,324,85,935,405600,4554
715,606,109,902,218500,4555
562,466,96,817,258700,4556
72,72,0,-,312500,4558
1026,913,113,848,239000,4562
602,450,152,939,202000,4563
263,263,0,-,328400,4564
250,194,56,1132,394100,4568
0,0,0,-,-,4570
164,132,32,-,-,4571
2300,1656,644,493,175200,4572
211,179,32,1125,271600,4573
576,535,41,1175,150800,4574
36,36,0,-,850000,4575
300,265,35,840,416200,4576
2015,1243,772,707,189700,4578
1283,1042,241,980,216800,4579
6029,4323,1706,794,185800,4605
498,411,87,731,144500,4606
504,424,80,773,172100,4607
2337,1496,841,857,327400,4609
199,166,33,-,156300,4611
209,185,24,-,302900,4612
37,28,9,-,95000,4613
1199,837,362,710,240200,4614
325,295,30,980,240100,4616
342,298,44,733,275000,4617
1496,983,513,553,87300,4619
563,425,138,446,107600,4622
375,314,61,723,122700,4623
77,71,6,-,340300,4624
47,41,6,-,262500,4625
214,180,34,525,176900,4626
704,522,182,574,241000,4627
293,226,67,295,132800,4628
0,0,0,-,-,4629
558,453,105,864,128900,4630
640,469,171,578,110900,4631
830,683,147,947,145300,4634
6,4,2,-,-,4635
80,72,8,675,175000,4637
979,721,258,829,189500,4640
39,35,4,-,350000,4642
410,325,85,940,120200,4643
0,0,0,-,-,4644
15,8,7,-,466700,4645
31,22,9,-,350000,4646
295,236,59,763,114000,4648
557,400,157,701,124200,4649
118,118,0,-,-,4650
804,666,138,456,124600,4652
292,154,138,746,285000,4653
1351,870,481,633,114900,4654
371,293,78,877,146500,4655
150,120,30,631,150000,4657
653,511,142,717,111700,4658
517,453,64,992,434400,4660
228,121,107,913,410900,4662
510,403,107,888,156200,4664
551,497,54,463,107400,4666
591,418,173,494,91300,4667
635,427,208,296,77000,4668
90,90,0,-,211800,4669
240,223,17,1125,186500,4671
77,73,4,-,310000,4673
203,180,23,850,272800,4674
80,57,23,-,384500,4675
457,405,52,1101,185800,4676
125,105,20,1188,187500,4677
775,507,268,715,316800,4679
528,427,101,581,151400,4680
477,347,130,842,259800,4681
48,37,11,-,-,4683
710,588,122,850,208900,4684
179,142,37,642,236100,4685
66,63,3,-,82300,4686
137,114,23,1063,152800,4691
199,150,49,675,184800,4693
972,771,201,714,87600,4694
4158,2708,1450,530,98800,4730
788,637,151,552,84100,4732
115,97,18,-,104200,4733
321,254,67,688,104200,4734
258,233,25,300,86800,4735
4102,2737,1365,590,91500,4736
353,300,53,458,107100,4739
454,354,100,607,93300,4740
4,4,0,-,-,4741
1499,1069,430,338,88400,4742
1906,1430,476,642,119800,4743
408,358,50,527,103400,4745
216,165,51,381,57200,4746
547,472,75,400,94600,4747
763,443,320,639,73300,4750
1556,1105,451,540,91600,4756
1265,1091,174,585,138800,4757
544,384,160,346,101000,4758
314,237,77,475,99700,4760
221,190,31,756,150800,4761
227,194,33,713,111500,4762
296,221,75,-,82400,4763
15,15,0,-,114100,4764
510,412,98,552,93300,4765
152,122,30,713,93600,4766
180,168,12,-,134800,4768
4082,2339,1743,591,107000,4769
399,315,84,510,123100,4772
280,224,56,609,134600,4773
295,232,63,310,72700,4774
399,364,35,857,91400,4776
186,167,19,-,77300,4777
163,158,5,-,169400,4779
264,244,20,608,101300,4780
222,188,34,-,107400,4781
221,195,26,558,128100,4783
986,633,353,532,71700,4785
837,610,227,565,92400,4786
205,193,12,546,77900,4787
3453,1883,1570,767,165000,4841
2475,1828,647,829,309200,4843
638,577,61,817,234600,4847
324,281,43,828,311300,4848
1647,1420,227,927,240400,4849
45,45,0,-,243800,4851
22,16,6,775,442900,4852
228,191,37,940,246700,4853
703,592,111,1070,249500,4854
100,100,0,-,325000,4855
1393,1165,228,938,266500,4856
576,510,66,790,247800,4858
374,342,32,1071,226200,4859
720,691,29,881,228900,4860
1316,887,429,740,182100,4861
1549,1301,248,945,185400,4862
481,346,135,791,241200,4863
1521,1381,140,817,163300,4864
11455,6828,4627,704,133000,4901
803,683,120,865,138000,4910
946,747,199,613,82300,4911
356,299,57,400,95000,4912
3955,2729,1226,845,174500,4915
1000,949,51,-,196200,4917
167,117,50,-,197600,4918
768,658,110,466,82900,4920
657,582,75,746,122700,4921
478,409,69,599,110800,4922
242,219,23,613,93400,4923
909,674,235,797,118400,4924
38,35,3,-,155400,4925
38,38,0,-,-,4926
1417,1141,276,789,115600,4927
843,671,172,763,117600,4928
333,217,116,779,107600,4929
1789,1284,505,810,107500,4930
529,489,40,813,140400,4932
24,19,5,-,-,4933
74,74,0,-,203100,4936
2799,1796,1003,746,118400,4937
3737,2690,1047,672,143700,4938
444,434,10,-,102200,4939
0,0,0,-,-,4940
693,600,93,775,156700,4941
609,553,56,875,98800,4942
754,566,188,664,83600,4943
18,18,0,-,-,4944
476,372,104,568,124100,4945
632,559,73,779,178500,4947
368,316,52,672,143200,4949
1870,1303,567,705,109200,4950
491,431,60,1292,124300,4951
846,682,164,884,156400,4952
1392,1019,373,725,155100,4953
582,523,59,900,137900,4955
320,280,40,930,131800,4956
1659,1396,263,791,112400,4957
736,650,86,916,113800,4958
416,391,25,-,123800,4961
54,11,43,729,-,4962
2977,2517,460,773,155400,4963
70,46,24,-,350000,4964
887,755,132,969,100100,4965
722,605,117,467,103900,4966
1529,1159,370,660,114400,4967
530,442,88,786,136600,4969
644,500,144,473,249100,4970
789,733,56,470,130600,4971
576,484,92,738,155100,4973
1299,911,388,509,131400,4974
0,0,0,-,-,4975
4440,2978,1462,726,122000,4976
324,264,60,638,159400,4978
383,315,68,685,120600,4979
1162,993,169,835,156600,4981
244,161,83,463,142300,4982
634,515,119,683,116500,4983
254,204,50,-,108800,4984
30,25,5,-,85800,4985
682,576,106,841,127800,4986
414,341,73,846,152100,4987
790,550,240,888,164600,4988
1709,1342,367,806,172000,4989
42,42,0,-,-,4992
4493,3115,1378,1063,221000,5001
43,43,0,-,605000,5031
1005,776,229,809,194600,5032
1084,780,304,998,170700,5033
125,91,34,781,-,5034
317,239,78,1059,246900,5035
437,365,72,926,242200,5036
207,191,16,-,280100,5037
575,422,153,694,160600,5038
525,441,84,1049,167200,5039
247,222,25,650,163500,5040
151,127,24,1094,177400,5041
213,172,41,-,168800,5042
465,398,67,1088,292000,5043
883,704,179,981,235400,5045
466,370,96,531,146400,5046
1277,1067,210,930,213100,5048
58,31,27,-,160600,5050
691,553,138,980,173100,5051
82,39,43,-,233600,5052
190,178,12,1571,403700,5053
1252,911,341,1011,456700,5055
206,177,29,608,316700,5056
128,118,10,-,229400,5058
154,115,39,-,367200,5059
1915,1431,484,840,189900,5060
462,434,28,875,216500,5061
277,234,43,900,257400,5062
409,309,100,1148,221700,5065
100,96,4,-,300000,5067
1424,845,579,1020,197500,5068
200,165,35,1271,148800,5069
255,236,19,1125,342900,5070
57,57,0,-,-,5071
199,173,26,1583,244900,5072
458,409,49,889,233900,5075
157,117,40,934,160700,5076
545,440,105,878,223000,5077
296,261,35,1050,174000,5079
225,115,110,635,139100,5081
114,81,33,578,138400,5083
110,110,0,-,222200,5084
278,256,22,825,158300,5086
1973,1247,726,861,180300,5089
1493,1119,374,1146,381800,5091
1968,1053,915,793,148400,5101
82,56,26,-,165900,5141
294,224,70,817,211700,5142
1829,1412,417,1026,207000,5143
308,251,57,842,258200,5146
427,315,112,991,219800,5148
921,664,257,855,252300,5149
409,271,138,953,131500,5150
647,621,26,-,215000,5151
175,160,15,-,314600,5152
275,204,71,867,190000,5153
198,124,74,864,222600,5154
419,275,144,753,278000,5155
3783,2650,1133,830,147800,5156
482,351,131,793,157400,5158
260,209,51,929,357300,5161
5895,3684,2211,832,164100,5201
1517,1256,261,934,242800,5250
640,541,99,918,347600,5251
111,97,14,-,174300,5252
217,181,36,809,268400,5253
101,89,12,-,425000,5254
1862,1301,561,800,282200,5255
976,684,292,909,201300,5257
189,164,25,-,182100,5260
946,823,123,1025,158300,5261
912,751,161,876,244300,5262
7364,4368,2996,876,218500,5301
322,282,40,918,314100,5340
186,147,39,863,195200,5341
289,252,37,934,183800,5342
377,293,84,922,250500,5343
1065,908,157,999,230200,5345
2056,1601,455,950,206300,5346
315,258,57,663,156500,5350
381,356,25,870,207800,5352
388,285,103,970,214600,5353
845,649,196,784,231300,5354
285,243,42,893,205600,5355
460,317,143,669,281300,5356
79,73,6,-,171300,5358
238,206,32,1088,244200,5359
83,70,13,493,380000,5360
481,399,82,988,204900,5361
27,27,0,-,307100,5362
840,570,270,1029,240000,5363
12325,3504,8821,1198,330000,5401
8560,5099,3461,1416,299900,5403
3164,1184,1980,1117,221800,5404
0,0,0,-,-,5405
3997,2708,1289,994,242600,5408
0,0,0,-,-,5439
750,605,145,935,193200,5440
342,306,36,1018,204900,5441
174,154,20,938,146400,5442
2889,2150,739,957,234800,5443
659,545,114,954,240000,5444
1451,1331,120,1903,511100,5445
6830,4718,2112,1189,263100,5446
26,19,7,-,-,5447
379,363,16,888,218100,5448
1956,1472,484,804,199700,5450
8816,6203,2613,1196,287500,5452
1815,1450,365,1362,255800,5454
382,298,84,590,259500,5455
490,389,101,944,267900,5456
650,565,85,721,207900,5457
896,721,175,1021,290100,5458
728,579,149,1134,186900,5459
1821,1376,445,1079,300800,5461
744,675,69,1259,271900,5462
194,185,9,975,206300,5463
1357,894,463,1018,248500,5464
2121,1914,207,990,305300,5465
5278,4369,909,1172,246700,5468
272,208,64,1008,153500,5471
679,550,129,1048,254500,5472
628,506,122,1191,290800,5473
406,360,46,1090,292000,5474
1258,869,389,935,139600,5476
1780,1397,383,989,321300,5477
5825,3766,2059,977,207900,5478
0,0,0,-,-,5481
3223,2333,890,2021,402200,5482
536,433,103,797,219700,5483
35,35,0,-,112500,5485
721,574,147,1141,369400,5486
594,499,95,1362,218200,5487
2949,2177,772,881,219600,5488
1311,1183,128,1403,316200,5489
2463,1825,638,1059,233700,5491
297,239,58,928,160700,5492
663,605,58,1107,286700,5494
4113,3312,801,1400,330600,5495
5424,3514,1910,992,252400,5602
56,49,7,-,285400,5640
7093,4552,2541,826,173200,5641
427,353,74,909,200500,5647
189,162,27,-,278300,5648
184,184,0,-,156300,5649
496,402,94,994,265900,5650
663,573,90,696,246600,5651
320,272,48,1077,148400,5652
182,160,22,-,182200,5653
464,234,230,1032,113800,5654
1217,1034,183,861,182500,5655
1287,642,645,861,159500,5656
44,44,0,-,262500,5657
609,555,54,908,181900,5658
775,676,99,873,280800,5660
2470,1755,715,867,217400,5661
2208,1601,607,846,188500,5663
66,66,0,-,-,5664
888,661,227,961,220500,5667
289,252,37,1275,177800,5669
2148,1575,573,1027,389300,5672
1167,874,293,1023,354400,5673
701,570,131,732,353700,5674
483,436,47,860,165600,5675
2022,1467,555,939,254900,5676
959,730,229,866,255300,5677
74,53,21,-,-,5678
1407,1116,291,878,174000,5679
911,798,113,1067,201900,5680
182,175,7,-,197100,5681
527,451,76,1050,241700,5682
9057,5526,3531,796,168200,5701
115,110,5,-,172200,5730
312,198,114,1212,242200,5732
2589,1923,666,821,189700,5733
597,441,156,977,254300,5734
1550,1108,442,823,169100,5735
252,158,94,857,172700,5736
340,293,47,845,209000,5737
476,422,54,1050,233900,5738
554,431,123,1072,188200,5739
22,22,0,-,-,5740
262,239,23,636,231600,5742
1552,1192,360,881,156500,5743
228,162,66,1142,198200,5744
142,96,46,938,223100,5747
152,116,36,783,146700,5748
335,289,46,1250,289900,5751
3665,2275,1390,956,278600,5753
336,282,54,979,222300,5757
301,286,15,900,216300,5758
723,617,106,761,192000,5759
501,430,71,942,221600,5760
371,324,47,755,197900,5761
181,142,39,1021,204500,5762
1165,1019,146,1000,181700,5763
1286,953,333,832,173500,5764
692,536,156,958,154400,5765
265,212,53,1263,221800,5766
526,421,105,701,184000,5767
453,361,92,862,246300,5769
402,333,69,1112,226300,5770
321,284,37,858,210400,5772
934,731,203,889,185400,5773
452,422,30,747,168700,5774
217,168,49,770,154200,5775
293,249,44,718,281600,5776
1364,1164,200,764,160700,5777
247,199,48,995,236900,5778
3794,2436,1358,770,171700,5819
265,244,21,544,172200,5820
454,425,29,825,204800,5821
714,572,142,660,127500,5822
476,389,87,725,165100,5824
49,38,11,-,120800,5825
386,334,52,963,203800,5826
116,83,33,752,191300,5827
873,699,174,862,220600,5828
737,540,197,842,184000,5829
681,492,189,745,143600,5830
366,328,38,846,225700,5832
126,104,22,875,157100,5833
453,358,95,793,147900,5836
159,140,19,1292,115400,5837
327,281,46,-,151900,5839
187,162,25,425,297300,5841
186,153,33,875,127200,5842
936,680,256,806,126100,5843
507,448,59,653,149600,5845
513,337,176,648,132300,5846
342,228,114,954,162500,5847
74,51,23,-,-,5850
2570,1629,941,700,162800,5851
239,210,29,1191,178300,5853
3068,2011,1057,791,161000,5855
1024,887,137,825,182500,5857
190,175,15,575,110200,5858
710,521,189,793,146200,5859
1100,901,199,775,131400,5860
102,86,16,-,239300,5862
267,250,17,586,128600,5866
301,251,50,945,211700,5867
145,145,0,-,190500,5868
591,471,120,761,158600,5871
414,336,78,778,165400,5872
290,240,50,871,175900,5873
226,186,40,814,188200,5874
213,194,19,725,222000,5875
9,9,0,-,-,5901
100,70,30,702,112500,5902
382,310,72,680,123100,5903
116,75,41,854,65600,5904
348,311,37,1014,166100,5905
533,452,81,792,127300,5906
76,66,10,545,168200,5907
7112,6056,1056,1434,381300,6001
8613,6240,2373,1293,216800,6002
24460,15625,8835,984,195900,6010
3367,3171,196,999,333200,6013
2653,1850,803,1320,241700,6016
1163,734,429,981,182100,6018
4035,3188,847,1166,309900,6019
0,0,0,-,-,6020
111,96,15,-,256900,6021
41,41,0,-,-,6022
500,391,109,-,244500,6023
205,174,31,-,253900,6024
2125,1719,406,967,278500,6026
560,521,39,983,263700,6027
7122,4521,2601,1143,267200,6029
646,577,69,1071,339800,6031
7305,5085,2220,1484,337800,6032
11498,9011,2487,1319,337600,6033
2946,2643,303,1007,278000,6035
7743,6636,1107,1141,286600,6037
888,579,309,1071,404400,6039
14213,7899,6314,1113,196400,6040
9729,5639,4090,1414,173400,6042
1803,1610,193,970,287100,6043
11927,3335,8592,936,151000,6051
3111,1829,1282,1071,200500,6052
13345,6501,6844,1014,158100,6053
2413,2228,185,1025,299500,6057
696,559,137,827,340900,6058
0,0,0,-,-,6059
875,829,46,-,396000,6060
66,66,0,-,203600,6061
7722,5453,2269,990,212300,6062
1174,1064,110,1444,255400,6063
283,283,0,-,252900,6065
13105,6821,6284,1088,203500,6066
8599,5537,3062,1408,263000,6067
681,521,160,2024,631500,6068
1133,829,304,868,374400,6069
5949,4899,1050,1427,331800,6070
3466,3049,417,1253,317100,6071
2055,1849,206,1332,442700,6073
9847,8243,1604,1317,282200,6074
5009,3776,1233,976,203700,6076
3861,3295,566,1247,295400,6078
615,361,254,1068,204600,6081
16472,12464,4008,1130,185700,6082
5159,4771,388,1508,298100,6084
2938,2258,680,818,320100,6085
2149,1519,630,1058,174200,6088
1263,968,295,1139,306400,6089
381,314,67,-,318200,6090
52,43,9,-,330000,6091
1467,1324,143,2350,372600,6092
1171,1072,99,1455,300800,6093
10859,9163,1696,1207,220200,6095
5253,3888,1365,1252,191300,6096
5163,3455,1708,1034,170600,6098
1271,154,1117,1535,161400,6103
9613,1696,7917,900,240500,6105
13782,3046,10736,969,160700,6106
7295,6344,951,1566,378200,6107
8824,4331,4493,983,157300,6108
10843,8465,2378,1073,249300,6109
4951,3281,1670,1129,221700,6110
12394,9586,2808,1235,232700,6111
7296,2575,4721,1012,150800,6112
9698,2820,6878,998,169300,6114
5422,4414,1008,1454,370700,6117
10245,6999,3246,1096,164700,6118
6601,3401,3200,1297,302500,6119
4479,792,3687,851,147700,6120
0,0,0,-,-,6160
6536,2376,4160,839,142700,6226
1388,1309,79,-,315500,6231
1235,1079,156,831,273300,6232
3132,2338,794,946,227500,6234
899,833,66,1250,203500,6235
2086,1931,155,1104,259200,6237
4761,4233,528,1125,241100,6238
4588,3013,1575,905,177400,6239
2428,1903,525,1130,196000,6241
518,421,97,933,257900,6242
27,27,0,-,-,6243
1106,965,141,1107,220100,6247
2088,2009,79,1069,281900,6248
2847,2590,257,696,245600,6249
1803,1334,469,1224,226100,6250
722,619,103,690,246100,6254
1757,1170,587,1018,198800,6255
895,783,112,876,171700,6256
1788,1402,386,853,268100,6259
3942,2370,1572,840,187600,6260
288,232,56,-,183100,6262
113,15,98,833,-,6263
34,34,0,-,-,6264
223,169,54,-,162500,6266
3536,1681,1855,1227,256200,6268
6,6,0,-,-,6269
1484,1376,108,1175,213100,6277
1844,1335,509,933,234700,6278
2483,1641,842,1100,223700,6279
1158,861,297,1276,200900,6280
2635,2310,325,1120,265400,6281
437,383,54,-,205800,6282
10985,3832,7153,958,181300,6320
1287,884,403,1121,225300,6330
1839,1623,216,1266,221000,6331
205,152,53,764,167900,6332
2573,2135,438,1242,350500,6333
980,842,138,958,225700,6334
2578,2163,415,1148,242800,6335
25,20,5,-,316700,6336
3135,2442,693,1098,225100,6339
12132,4787,7345,1252,200200,6340
26,26,0,-,-,6350
6251,4824,1427,1092,201700,6351
30,30,0,-,-,6353
2323,1518,805,900,172700,6354
5436,4313,1123,1251,313400,6355
4714,3552,1162,1243,293700,6357
2117,1818,299,1083,276100,6359
15009,7907,7102,1048,163700,6360
1835,1610,225,1118,246900,6365
2630,2333,297,1077,216900,6370
4155,3433,722,1310,419100,6371
109,80,29,-,-,6373
2878,2119,759,700,176500,6374
1443,1332,111,1189,239100,6375
94,69,25,-,562500,6376
1117,970,147,992,205400,6377
2506,1888,618,1362,403400,6378
3732,2568,1164,855,262100,6379
1239,358,881,926,149600,6380
4049,3209,840,1089,185300,6382
1067,884,183,998,217200,6384
6412,5154,1258,1307,259000,6385
137,22,115,1106,-,6387
7,0,7,-,-,6389
73,49,24,-,1587500,6390
7402,4389,3013,1047,210500,6401
2466,2094,372,1294,253300,6403
12337,8631,3706,1335,293500,6405
294,185,109,-,238300,6409
10145,8786,1359,1242,332500,6410
1720,1345,375,1315,346800,6412
5451,4314,1137,1210,287900,6413
26,26,0,-,233300,6414
6220,4730,1490,1300,254200,6415
5819,4449,1370,1218,245600,6416
1892,1390,502,1167,271200,6417
5061,2933,2128,1084,203100,6418
2305,2141,164,1176,365400,6419
1618,1497,121,1332,274400,6420
2665,2412,253,1175,331300,6422
2289,2020,269,1002,291500,6423
4939,4341,598,1229,265800,6424
1617,1184,433,1006,464200,6426
8314,7167,1147,1424,393700,6437
1045,791,254,833,320900,6438
2005,1701,304,1299,309200,6441
1099,921,178,1197,335100,6442
6911,5958,953,1389,423300,6443
70,57,13,-,-,6444
2350,2113,237,1132,314300,6447
15551,9674,5877,1036,169700,6450
10719,5789,4930,962,177800,6451
1278,1180,98,1590,286400,6455
169,142,27,-,324300,6456
19054,10082,8972,1132,227000,6457
16451,11522,4929,1573,298300,6460
5614,5056,558,1598,325700,6461
90,90,0,-,225000,6467
6703,6142,561,1341,362400,6468
1133,907,226,994,265300,6469
5878,4987,891,1322,425300,6470
3144,2658,486,1096,259400,6471
2400,2162,238,1423,298900,6472
8906,7446,1460,1391,298700,6473
4354,3470,884,1514,381900,6475
4939,4361,578,1658,389800,6477
4510,4162,348,798,345400,6478
3995,3302,693,1079,267800,6479
3842,3210,632,1116,245800,6480
549,409,140,850,262500,6481
3962,3662,300,1647,379400,6482
6239,4494,1745,1068,246600,6483
16351,13262,3089,1422,345200,6484
7900,6768,1132,1547,326400,6488
12821,10574,2247,1056,279700,6489
18535,13522,5013,1090,270100,6492
3086,2439,647,1248,365000,6498
1541,85,1456,1483,290200,6510
21266,4422,16844,1220,218600,6511
11510,7498,4012,1213,208500,6512
14621,5554,9067,1078,184200,6513
10142,6264,3878,1312,195700,6514
6613,2628,3985,1171,217600,6515
19576,10750,8826,1158,194400,6516
6061,4015,2046,1119,252900,6517
6726,4419,2307,1612,252000,6518
5227,1290,3937,1122,167500,6519
1967,1800,167,1120,352700,6524
2931,2610,321,1220,471400,6525
9886,2778,7108,1119,193000,6604
8938,2626,6312,1176,219400,6605
15943,9890,6053,1253,173000,6606
2832,913,1919,1193,137000,6607
4395,1006,3389,1136,155500,6608
8553,3901,4652,1081,157100,6610
12427,10783,1644,1976,396900,6611
2805,2665,140,2227,641900,6612
12722,11133,1589,1488,268700,6614
7362,4726,2636,1204,218100,6615
1705,53,1652,502,97700,6702
8987,3664,5323,952,122800,6704
10031,3609,6422,1022,125200,6705
5077,2513,2564,913,119100,6706
11129,6306,4823,1016,137500,6708
3639,1125,2514,974,144400,6710
3367,2930,437,1160,297000,6712
5880,4947,933,1199,249600,6716
533,323,210,796,257700,6750
1289,1113,176,1250,327200,6751
715,630,85,1759,480300,6752
681,577,104,1813,398200,6754
370,326,44,-,321200,6755
1058,1016,42,-,350200,6756
883,657,226,1277,339800,6757
133,119,14,-,299200,6758
2443,1951,492,1109,352500,6759
2694,2482,212,874,345200,6762
733,610,123,897,328300,6763
11712,7811,3901,1035,182400,6770
10029,7874,2155,1218,290000,6776
614,552,62,1357,361900,6777
589,551,38,-,259900,6778
3360,2450,910,1061,193300,6779
838,731,107,1119,222100,6782
883,737,146,1241,629300,6783
1512,1321,191,2151,448400,6784
248,221,27,-,488800,6785
3895,3018,877,1044,193000,6786
3174,2422,752,953,207500,6787
14406,9628,4778,939,155500,6790
1937,1890,47,748,294400,6791
519,397,122,1216,807100,6793
385,298,87,1365,387200,6794
5142,4408,734,936,274500,6795
458,394,64,992,439400,6796
4139,3147,992,1227,353500,6798
7272,5685,1587,1325,338500,6801
6240,5175,1065,1594,371900,6804
2620,1831,789,1884,1094000,6807
18629,8616,10013,1452,265600,6810
11056,8627,2429,1448,330400,6811
5019,4727,292,2151,352200,6812
6858,5848,1010,2801,1461100,6820
11631,9876,1755,2108,680000,6824
7287,5897,1390,1669,468300,6825
9652,4975,4677,1800,1552800,6830
4996,3719,1277,2192,1156300,6831
7084,5552,1532,2081,1420000,6840
7698,4532,3166,1713,412400,6850
10469,7179,3290,1703,435800,6851
1467,1158,309,1967,1015900,6853
10796,5447,5349,1461,377400,6854
3389,1613,1776,1590,454900,6855
0,0,0,-,-,6856
2505,2073,432,2430,1458300,6870
8997,7598,1399,1630,655800,6877
2559,2084,475,2030,1463900,6878
10062,8477,1585,1901,1153900,6880
3473,3329,144,2759,878400,6883
1615,1363,252,2212,895400,6890
3426,2715,711,1609,592900,6896
6028,5163,865,2690,798700,6897
4052,641,3411,1587,298900,6901
25948,10622,15326,1762,413400,6902
4937,4679,258,3389,764100,6903
7639,5646,1993,2002,559600,6905
3481,2170,1311,1740,462700,6906
3372,2392,980,1546,472800,6907
4955,2504,2451,1390,267700,7001
24975,9486,15489,1221,320300,7002
18080,9391,8689,1333,322600,7003
2696,2407,289,2096,474300,7004
5495,4117,1378,1414,457600,7005
9606,7330,2276,1475,547800,7006
7950,4559,3391,1510,271900,7008
4451,3542,909,1483,465500,7009
10535,4967,5568,1392,443300,7010
12574,6068,6506,1373,298800,7011
4645,2476,2169,1414,352700,7012
9959,7106,2853,1335,357500,7013
1807,1371,436,1406,327800,7014
8654,6892,1762,1677,474200,7016
13066,3641,9425,1030,217300,7017
10585,2479,8106,1123,207300,7018
5746,1891,3855,2365,563800,7020
782,741,41,2286,824600,7021
5393,1824,3569,1384,354300,7022
2544,2228,316,2811,450200,7023
17013,9941,7072,1800,324000,7024
11329,4313,7016,1285,333900,7026
1773,1060,713,1499,369800,7027
2449,2304,145,1601,642700,7028
6635,1833,4802,1382,327400,7029
25132,8224,16908,2231,693400,7030
6248,3257,2991,1350,350600,7031
13568,6407,7161,1244,323400,7032
2828,2255,573,1415,346000,7033
3331,2119,1212,1211,332400,7034
3641,2789,852,1651,334100,7035
15166,8407,6759,1223,275300,7036
9994,8867,1127,2615,618400,7039
7987,6097,1890,1569,510300,7040
2520,1629,891,1708,765300,7041
10297,5101,5196,1600,518000,7042
4171,3335,836,1850,736800,7043
5139,4130,1009,1515,445100,7044
3942,3721,221,2375,588500,7045
1363,1264,99,1430,846800,7046
21900,8512,13388,1363,329400,7047
12245,2614,9631,1108,228700,7050
16281,11113,5168,1491,372400,7052
11166,5734,5432,1308,452400,7054
19672,4511,15161,1177,325600,7055
4676,1934,2742,1232,356800,7057
1886,1020,866,1648,613100,7058
5153,4758,395,1485,784900,7059
14850,5930,8920,1198,268300,7060
3992,2529,1463,1248,232500,7062
3995,2589,1406,1315,246000,7063
1339,1100,239,1477,286200,7064
11188,6541,4647,1322,266300,7065
5788,4585,1203,1404,428200,7066
6109,5416,693,1475,356100,7067
2341,1891,450,2319,500800,7068
1912,1551,361,1724,702300,7069
7101,4473,2628,1373,460900,7070
8442,4618,3824,1386,367700,7071
2321,1500,821,1260,375000,7072
3800,1380,2420,1444,389300,7073
977,779,198,1330,356700,7074
3252,2243,1009,1670,386600,7075
8714,7126,1588,1509,484200,7076
923,655,268,1292,286600,7077
4050,3693,357,2468,1364400,7078
5146,3555,1591,1658,577000,7079
7829,6495,1334,1812,333200,7080
6972,4459,2513,1673,433400,7081
1617,1526,91,2045,536700,7082
19239,14308,4931,1500,323000,7083
6461,2207,4254,1451,590500,7086
24194,4769,19425,1203,317900,7087
1223,762,461,1513,222800,7088
10367,8627,1740,1663,728000,7090
2438,2195,243,1858,636700,7092
24319,5904,18415,1296,312100,7093
7285,4066,3219,1597,448100,7094
7199,4081,3118,1648,278200,7095
5079,448,4631,786,244200,7102
11085,2697,8388,1021,181600,7103
18606,4441,14165,1059,265900,7104
16796,3664,13132,1161,309400,7105
11339,3536,7803,1053,196400,7106
12749,2729,10020,1039,230400,7107
8323,1445,6878,920,191100,7108
12493,6409,6084,1301,288700,7109
10831,7169,3662,1317,379000,7110
20403,5588,14815,1022,172000,7111
9582,2507,7075,1080,229500,7112
3460,480,2980,870,212900,7114
8557,2072,6485,1151,266100,7201
12999,3036,9963,1155,273000,7202
7528,4189,3339,1136,214300,7203
5087,2972,2115,1227,281000,7204
7271,4710,2561,1294,235300,7205
7844,1870,5974,1178,248700,7206
10981,2874,8107,1110,296200,7208
20926,5791,15135,2236,668300,7302
15750,4283,11467,1113,297500,7304
22280,8804,13476,1192,300700,7305
20216,4485,15731,1168,346100,7306
15774,4717,11057,1280,377300,7307
5776,894,4882,2872,727200,7310
238,0,238,2816,-,7311
2254,1925,329,1921,710600,7401
2883,1892,991,1612,297000,7403
6242,4772,1470,1386,440900,7405
6890,3858,3032,1572,353100,7407
11463,9178,2285,1629,409700,7410
2129,1580,549,1158,187800,7416
3758,3305,453,2564,955000,7417
766,724,42,-,282600,7418
3619,2772,847,1477,225700,7419
1598,1369,229,1474,261600,7420
2637,2315,322,1767,261900,7421
2320,2179,141,1183,216300,7422
1415,1340,75,2378,740300,7423
9556,6352,3204,1448,364300,7424
9505,7515,1990,1859,492400,7430
2604,1809,795,1711,498500,7432
925,810,115,1071,373800,7435
4311,3893,418,1688,456200,7436
4288,3956,332,1404,343600,7438
835,703,132,1483,219500,7439
1442,1241,201,1170,405000,7440
3952,2864,1088,1512,305000,7442
4747,3752,995,2111,420600,7444
5512,4788,724,1570,586600,7446
8344,6475,1869,1996,738300,7450
3781,3586,195,1705,631900,7452
3914,3770,144,1970,346200,7456
1829,1263,566,2112,338500,7457
3724,3265,459,2069,997700,7458
1240,1160,80,2015,263600,7460
6822,5723,1099,1154,278000,7461
2634,1852,782,1315,218500,7462
3574,3209,365,2006,440800,7463
2596,2186,410,1533,344900,7465
18129,14391,3738,1643,461600,7470
5951,5271,680,1480,293700,7480
5710,5249,461,1795,752900,7481
0,0,0,-,-,7495
10559,1642,8917,1091,241200,7501
4458,2142,2316,1327,229800,7502
5322,1599,3723,1201,247300,7503
3554,1241,2313,1286,280400,7504
1037,37,1000,1006,110900,7505
6963,4204,2759,1478,371700,7506
7562,4918,2644,1384,351400,7508
3460,2877,583,1596,377200,7512
3415,1038,2377,1311,248200,7513
6279,1671,4608,1184,219500,7514
6074,1324,4750,1150,211800,7522
4050,1069,2981,1139,235400,7524
18732,6270,12462,1390,298500,7601
2866,2009,857,1359,326900,7603
4239,2742,1497,1396,416800,7604
3338,1989,1349,1403,495900,7605
808,411,397,1406,391600,7606
3499,2201,1298,1460,380500,7607
41,0,41,1396,-,7608
533,430,103,-,"2,000,000+",7620
8760,5892,2868,1355,348400,7621
2756,2295,461,2081,658000,7624
2890,2408,482,2500,656300,7626
1686,1507,179,3029,685700,7627
6373,4577,1796,1203,365900,7628
2509,2087,422,1896,486100,7630
10613,5591,5022,1423,392200,7631
1814,1573,241,3259,1029400,7632
1625,1489,136,2036,597200,7640
1112,1052,60,"3,500+",661300,7641
3602,3092,510,1395,552100,7642
4308,1731,2577,1326,316600,7643
8927,3629,5298,1316,376200,7644
2858,2401,457,1747,615800,7645
5806,3637,2169,1424,413400,7646
1795,1549,246,1516,466600,7647
2133,1732,401,1732,631000,7648
2719,2393,326,1588,599700,7649
7516,2616,4900,1476,526600,7650
8310,7189,1121,1987,588800,7652
3299,2619,680,1420,585600,7656
3900,1892,2008,1555,436200,7657
4761,2588,2173,1325,340700,7660
3942,2945,997,1588,492100,7661
1993,1367,626,1597,374000,7662
5371,3643,1728,1551,372000,7663
13330,9840,3490,1421,396500,7666
4600,3573,1027,1807,807000,7670
9958,7561,2397,1749,575900,7675
3240,3056,184,2221,495900,7676
2009,1790,219,1772,790400,7677
9804,6536,3268,1517,401200,7701
1454,1338,116,2365,575600,7702
17,0,17,-,-,7703
1864,1682,182,2625,708100,7704
602,508,94,1163,708900,7711
16236,7388,8848,1196,396900,7712
3537,2612,925,1164,442400,7716
895,592,303,1496,867400,7717
2348,1906,442,1660,342500,7718
8463,6016,2447,1437,453900,7719
2120,962,1158,1361,507600,7720
1121,774,347,1277,270700,7721
3305,2969,336,1750,763200,7722
279,177,102,1208,1108900,7723
8920,5856,3064,1222,363600,7724
15303,13093,2210,1559,456000,7726
2679,1906,773,1044,428700,7727
19946,14717,5229,1667,365400,7728
5895,5143,752,1059,331200,7730
12621,11269,1352,1458,329400,7731
2787,1715,1072,1205,273100,7732
5758,4954,804,2045,647100,7733
5183,3145,2038,1201,217400,7734
6980,5068,1912,1158,257700,7735
1438,1272,166,1184,323200,7737
2077,1849,228,538,530100,7738
2099,1942,157,2308,595100,7739
12019,5341,6678,1290,356000,7740
5975,5726,249,2534,559300,7746
11771,8966,2805,1578,358200,7747
9617,7823,1794,1407,437500,7748
1409,1202,207,2393,739600,7750
6025,5467,558,2199,539600,7751
15583,9858,5725,1465,292000,7753
2196,1970,226,1375,387400,7755
1967,780,1187,1216,471700,7756
2101,1804,297,1250,453200,7757
1423,1261,162,1739,315800,7758
3179,2728,451,1836,940200,7760
3897,2465,1432,1488,618700,7762
2459,1885,574,1586,419700,7764
8061,4019,4042,1374,280700,7801
1252,1082,170,1179,294300,7803
28,28,0,-,-,7820
3469,3057,412,1381,309600,7821
268,250,18,-,316000,7822
3356,2299,1057,908,237700,7823
3402,3009,393,1421,339800,7825
2215,1770,445,1451,294600,7826
1616,1263,353,1040,207600,7827
5949,3020,2929,1164,328900,7828
2413,2262,151,1104,478700,7830
1323,1183,140,1177,312200,7832
67,35,32,-,172100,7833
6794,5756,1038,1634,406600,7834
4197,2759,1438,1421,395300,7836
1206,1007,199,1433,318400,7838
11477,7496,3981,1194,292400,7840
44,44,0,-,-,7842
4468,3661,807,1365,236400,7843
10,10,0,-,-,7846
667,626,41,1427,296400,7847
1739,1462,277,1188,334000,7848
3523,2940,583,1453,301600,7849
2096,1698,398,1183,278900,7850
30,27,3,-,344100,7851
1556,1339,217,984,350300,7852
4225,4009,216,1930,491000,7853
2160,1528,632,1948,332200,7856
1407,683,724,1191,265800,7857
9624,7295,2329,1168,263100,7860
1511,1281,230,770,256700,7863
699,663,36,-,297800,7865
8439,7058,1381,1433,347900,7866
9076,6763,2313,1435,522100,7869
14,5,9,-,-,7870
7039,6289,750,1236,371700,7871
3078,2769,309,1659,259800,7874
3660,3426,234,1400,384600,7876
271,219,52,-,335700,7878
89,89,0,-,407300,7880
4,4,0,-,150000,7881
5545,4118,1427,1137,250400,7882
3787,2340,1447,1441,292800,7885
8274,5726,2548,1779,859300,7901
9752,8060,1692,1991,667900,7920
3781,2892,889,2086,376300,7921
4107,3879,228,2375,606700,7922
2633,2254,379,1848,743800,7924
11,0,11,-,-,7926
1624,1084,540,2328,475700,7927
6466,5536,930,1865,809300,7928
2957,2779,178,1234,635800,7930
1068,894,174,2771,925900,7931
3966,2746,1220,2347,630500,7932
1201,1097,104,1706,504500,7933
558,490,68,1895,698000,7934
164,138,26,-,538500,7935
3697,3494,203,2281,584400,7936
0,0,0,-,-,7939
5464,3730,1734,1674,711800,7940
3159,2864,295,1230,738900,7945
1123,1031,92,3080,615000,7946
7002,5695,1307,2067,478500,7950
17839,11255,6584,1782,588500,7960
0,0,0,-,-,7961
56,56,0,-,340400,7970
4124,3445,679,1680,596000,7974
264,203,61,1419,-,7976
210,114,96,1385,484800,7977
191,179,12,-,652000,7979
815,642,173,1381,542500,7980
3517,3001,516,1874,493700,7981
367,282,85,1183,166900,8001
8517,5645,2872,1298,237400,8002
10820,9440,1380,1642,323300,8003
3945,3489,456,1354,191100,8004
9156,8007,1149,1551,249200,8005
201,169,32,1295,672300,8006
2034,1311,723,892,190800,8007
3563,3183,380,1273,805200,8008
5020,4303,717,1314,221400,8009
4324,2594,1730,1218,167600,8010
9,9,0,-,-,8011
14448,9625,4823,1131,204300,8012
189,136,53,-,181800,8014
6968,5466,1502,1223,165100,8015
12197,9017,3180,1046,233300,8016
366,317,49,2563,272800,8019
934,868,66,1134,275600,8020
18072,9459,8613,997,146400,8021
3593,3435,158,959,309500,8022
157,43,114,1293,103000,8023
766,719,47,2068,205200,8026
1922,1557,365,1136,178000,8027
6489,4449,2040,1183,195300,8028
1883,1385,498,776,165100,8029
4679,3202,1477,1190,125400,8030
4379,2670,1709,889,166800,8031
6193,4746,1447,1105,450200,8033
6972,5550,1422,1315,240800,8034
3037,2458,579,895,285900,8035
2194,1981,213,1058,290400,8036
8477,6514,1963,1194,235000,8037
35,28,7,-,170000,8038
32,32,0,-,227300,8039
319,285,34,-,367900,8041
58,44,14,-,-,8042
10879,7310,3569,1310,323400,8043
1063,713,350,872,165700,8045
10367,8256,2111,1602,162900,8046
4662,3333,1329,1282,311100,8048
2075,1444,631,988,163300,8049
9510,8018,1492,1652,276600,8050
4201,3302,899,1302,181200,8051
8482,3977,4505,1156,183000,8052
17456,13311,4145,1457,289200,8053
17281,13476,3805,1565,265900,8054
9979,8639,1340,1369,350600,8055
1469,1410,59,1380,367900,8056
7186,5943,1243,1231,506400,8057
2131,1611,520,978,166100,8059
8857,6591,2266,1202,230400,8060
890,807,83,2153,293300,8061
5447,4953,494,1098,343900,8062
1069,891,178,1071,149900,8063
18,18,0,-,-,8064
2950,2068,882,1351,170800,8065
3692,2172,1520,967,117000,8066
586,519,67,1202,234200,8067
2745,1677,1068,1000,188600,8068
4746,2435,2311,1046,149200,8069
4934,3629,1305,976,156000,8070
3554,2640,914,1120,184000,8071
130,130,0,-,202600,8072
55,55,0,-,305200,8073
0,0,0,-,-,8074
10884,7880,3004,1207,221200,8075
6880,6004,876,1539,271500,8077
3179,2166,1013,919,165300,8078
3886,2265,1621,932,176200,8079
13028,11452,1576,1438,258800,8080
16999,13863,3136,1312,205300,8081
3729,2776,953,981,187000,8083
2599,1978,621,962,182800,8084
6813,5722,1091,1663,288600,8085
3219,2358,861,1351,229300,8086
10595,8874,1721,1364,223900,8087
9261,8586,675,1389,258900,8088
1563,1287,276,954,192500,8089
2848,2608,240,1275,188500,8090
2107,1428,679,1066,177000,8091
1359,1131,228,1615,302300,8092
3557,2239,1318,979,154100,8093
14743,12561,2182,1018,199800,8094
15,15,0,-,-,8095
13749,9680,4069,1179,191500,8096
1145,1022,123,984,201400,8097
3362,2476,886,1017,262400,8098
2439,524,1915,754,83700,8102
4720,1890,2830,957,85000,8103
8573,3021,5552,854,69200,8104
8597,3965,4632,954,89700,8105
3965,2598,1367,939,204400,8106
5280,2731,2549,1013,184700,8107
7385,4887,2498,1290,265200,8108
8514,6100,2414,1052,171700,8109
5703,4390,1313,1126,137300,8110
3807,2552,1255,1372,197400,8201
779,722,57,1313,1105600,8202
4127,2997,1130,1263,351300,8203
7747,6087,1660,1057,293700,8204
10412,8114,2298,1221,202200,8205
6187,5087,1100,1330,264700,8210
99,94,5,1667,729700,8212
5071,3561,1510,1114,198800,8215
0,0,0,-,-,8217
2491,2145,346,1566,284100,8221
1725,1537,188,1446,280900,8223
187,166,21,-,253300,8224
2832,2573,259,1703,223800,8225
5262,3609,1653,1176,582100,8226
2012,1787,225,1161,307800,8230
6256,3444,2812,1043,150500,8232
14011,12228,1783,999,213700,8234
0,0,0,-,-,8240
393,368,25,1550,273700,8241
1243,851,392,1039,257100,8242
1020,913,107,1449,663000,8243
4504,2606,1898,1085,218500,8244
52,52,0,-,-,8246
469,427,42,1325,1146600,8247
97,97,0,-,-,8248
4260,3383,877,1267,176100,8251
6154,4182,1972,936,330500,8260
3019,2314,705,1057,262600,8270
13856,8134,5722,1059,163300,8302
548,433,115,1218,110900,8310
649,481,168,1285,167200,8311
3076,2416,660,1186,199600,8312
180,167,13,-,146300,8314
139,115,24,-,140400,8316
460,402,58,-,251600,8317
4495,3988,507,1133,213600,8318
421,418,3,-,240700,8319
0,0,0,-,-,8320
96,57,39,956,161500,8321
3703,3391,312,1275,209600,8322
233,188,45,1422,204300,8323
112,104,8,-,218200,8324
526,406,120,1351,149500,8326
160,139,21,-,149100,8327
468,459,9,-,164000,8328
124,99,25,-,283600,8329
10714,7965,2749,1450,204500,8330
13876,8978,4898,993,152400,8332
349,281,68,1415,270900,8340
999,388,611,846,182000,8341
1662,1529,133,1452,269300,8343
1833,1515,318,1309,175700,8344
229,188,41,956,144900,8345
222,191,31,-,120400,8346
83,68,15,-,138000,8348
727,648,79,1317,157300,8349
221,209,12,-,289300,8350
190,171,19,-,150400,8352
148,95,53,877,160500,8353
14453,8492,5961,1021,158200,8360
6425,5388,1037,1009,203300,8361
15272,4070,11202,872,165200,8401
3053,2506,547,1279,485700,8402
477,399,78,1729,830400,8403
4196,2611,1585,1166,268600,8406
2310,2120,190,1214,407700,8501
3561,2814,747,2133,653700,8502
6930,5156,1774,1207,276200,8505
1727,1621,106,2048,590300,8510
332,260,72,874,226100,8511
4116,2407,1709,1294,496100,8512
1880,1631,249,1140,377800,8514
1723,1596,127,1582,440600,8515
2314,1632,682,1019,209500,8518
9276,6475,2801,1378,289800,8520
1885,1596,289,1571,432300,8525
20183,17209,2974,1402,350300,8527
43,32,11,-,-,8528
3183,2218,965,1330,402200,8530
2394,2031,363,1239,332500,8533
4946,4365,581,1427,466800,8534
1545,1489,56,1261,616100,8535
7801,3356,4445,1515,469200,8536
17700,11819,5881,1740,640200,8540
1769,530,1239,1662,494700,8542
6507,5553,954,2094,629800,8550
1789,1661,128,1453,463600,8551
229,184,45,1792,508300,8553
1446,1186,260,1327,168000,8554
270,241,29,-,288600,8555
2518,2194,324,1556,674400,8558
2036,1716,320,1402,450200,8559
1342,1191,151,1841,389000,8560
115,98,17,-,326300,8561
1739,1061,678,1035,241100,8562
556,12,544,728,-,8608
4170,1029,3141,1084,83600,8609
11194,7328,3866,1138,193000,8610
8109,2559,5550,1090,89500,8611
13004,5790,7214,968,171900,8618
8597,6053,2544,1274,249600,8619
4138,3346,792,1088,260900,8620
3918,2597,1321,1309,266700,8628
3957,2678,1279,1206,115400,8629
8021,4859,3162,1144,176700,8638
878,5,873,2082,-,8640
1179,0,1179,1955,-,8641
11846,7867,3979,1581,302700,8648
6994,6220,774,1388,282800,8690
6000,5220,780,1668,383300,8691
23877,11624,12253,1463,322000,8701
226,208,18,-,562500,8720
7453,6113,1340,1498,278200,8721
3766,3162,604,1667,230600,8722
13062,10223,2839,1362,281600,8723
16462,14201,2261,1460,283900,8724
1780,1617,163,2138,630100,8730
7725,6872,853,1538,262900,8731
582,473,109,1615,412400,8732
937,615,322,1702,186200,8733
3262,2889,373,809,333200,8734
2015,1800,215,1145,637000,8735
4857,4247,610,1333,618300,8736
600,562,38,1441,1126100,8738
748,507,241,1634,253300,8740
960,876,84,1276,316700,8741
9980,7835,2145,1463,410200,8742
1369,1264,105,1113,933700,8750
1883,975,908,1273,447100,8751
1220,929,291,1291,634000,8752
23403,18320,5083,1443,288800,8753
10312,8827,1485,1318,272200,8755
16713,14663,2050,1439,162600,8757
3443,2932,511,1629,312700,8758
19295,16681,2614,1151,122600,8759
2593,2181,412,1771,409800,8801
1443,1321,122,1333,389500,8802
1047,940,107,1083,293300,8804
4119,2318,1801,1387,289300,8805
13254,10927,2327,1657,472900,8807
89,67,22,-,-,8808
2097,1516,581,1454,357600,8809
2888,2370,518,1821,410800,8810
4684,3770,914,1368,345000,8812
16487,13344,3143,1435,389300,8816
15657,8595,7062,1563,316200,8817
12902,9280,3622,1576,488200,8820
131,119,12,-,365000,8821
11727,9164,2563,1446,415500,8822
3594,2545,1049,1940,286800,8823
4080,3629,451,1317,429500,8824
1625,1255,370,1244,385000,8825
2162,1757,405,1289,342600,8826
1611,1425,186,676,373900,8827
887,710,177,1741,250700,8828
1468,1131,337,1212,259400,8829
6240,4445,1795,1727,297600,8830
20977,18379,2598,1294,338600,8831
1014,215,799,1383,261000,8832
3242,2868,374,1929,491200,8833
3785,2505,1280,1351,253800,8835
1303,1222,81,1414,612500,8836
6329,3274,3055,1344,326400,8837
5997,4804,1193,1659,390500,8840
13613,11496,2117,1704,423400,8844
4943,3527,1416,1364,300400,8846
3087,2804,283,1141,329400,8848
2913,2514,399,1556,349000,8850
6612,4444,2168,1610,388500,8852
1858,1483,375,1183,568700,8853
16043,10625,5418,1562,321300,8854
14986,10016,4970,1220,353200,8857
48,48,0,-,-,8858
8299,5266,3033,1256,305300,8859
16665,5310,11355,1306,255500,8861
4388,3205,1183,1369,299600,8863
11605,7404,4201,1026,194500,8865
1772,1577,195,1436,487800,8867
2938,1676,1262,1667,335200,8869
7430,4349,3081,1216,292300,8872
19854,13885,5969,1579,333700,8873
8047,5543,2504,1404,371700,8876
8913,5018,3895,1280,274500,8879
1578,908,670,1366,247900,8880
5574,3505,2069,1245,294000,8882
3339,2611,728,927,292400,8884
2487,2018,469,1211,310000,8886
510,409,101,1621,187100,8887
3764,3460,304,1425,458300,8889
7,0,7,-,-,8890
14893,2557,12336,1445,257400,8901
14249,8032,6217,1561,336100,8902
5608,2377,3231,1427,362600,8904
12431,3253,9178,2065,343400,10001
33540,4470,29070,963,665200,10002
26124,8605,17519,2298,1001200,10003
1659,635,1024,3235,1640600,10004
4374,859,3515,3226,1415400,10005
1794,306,1488,3229,1140400,10006
2731,968,1763,3394,"2,000,000+",10007
29728,1882,27846,1642,608300,10009
16390,4651,11739,2590,788200,10010
29128,10947,18181,2115,964200,10011
12041,2171,9870,2280,1669400,10012
11986,3138,8848,1571,"2,000,000+",10013
18229,5913,12316,2313,1089100,10014
28916,8319,20597,2550,775800,10016
9905,4320,5585,2309,637300,10017
5095,462,4633,3163,743600,10018
25428,5064,20364,2139,917700,10019
0,0,0,-,-,10020
24996,11252,13744,2149,1238500,10021
18049,9454,8595,2514,928400,10022
33693,14083,19610,2321,1124500,10023
28751,11343,17408,2174,1540500,10024
41910,12013,29897,1531,1021400,10025
15458,2352,13106,1163,835000,10026
23811,3237,20574,1193,689200,10027
25318,8723,16595,2329,1218300,10028
31690,2149,29541,923,693200,10029
12736,1471,11265,988,606500,10030
21959,2734,19225,1365,417000,10031
21222,1742,19480,1219,499600,10032
19652,2054,17598,1412,495800,10033
16095,1500,14595,1330,342600,10034
14428,1191,13237,866,592800,10035
16183,1565,14618,2151,976900,10036
9731,485,9246,1153,422100,10037
10210,2732,7478,2396,787400,10038
11210,1515,9695,931,458900,10039
16181,1679,14502,1362,394500,10040
4748,936,3812,2520,692000,10044
14844,5365,9479,2472,1548500,10065
2552,675,1877,3123,"2,000,000+",10069
11035,4933,6102,2280,1050600,10075
0,0,0,-,-,10103
0,0,0,-,-,10110
0,0,0,-,-,10111
0,0,0,-,-,10112
0,0,0,-,-,10115
0,0,0,-,-,10119
30691,10129,20562,2198,1022400,10128
0,0,0,-,-,10152
0,0,0,-,-,10153
0,0,0,-,-,10154
741,0,741,3011,-,10162
0,0,0,-,-,10165
0,0,0,-,-,10167
0,0,0,-,-,10168
0,0,0,-,-,10169
0,0,0,-,-,10170
0,0,0,-,-,10171
0,0,0,-,-,10172
0,0,0,-,-,10173
0,0,0,-,-,10174
0,0,0,-,-,10177
55,0,55,-,-,10199
0,0,0,-,-,10271
0,0,0,-,-,10278
18,0,18,-,-,10279
4560,1233,3327,3332,910500,10280
2231,192,2039,"3,500+",-,10282
14489,6587,7902,1291,454600,10301
6149,3616,2533,1325,377500,10302
8156,4954,3202,1009,333200,10303
14172,7441,6731,1034,471400,10304
14663,9671,4992,1292,440500,10305
20007,14183,5824,1361,480900,10306
5314,4038,1276,1198,662600,10307
10648,8826,1822,1664,494000,10308
11464,9841,1623,1389,570200,10309
8346,5113,3233,1237,451500,10310
0,0,0,-,-,10311
21382,18246,3136,1238,518000,10312
31362,23323,8039,1401,485300,10314
19123,2488,16635,1042,135600,10451
26126,702,25424,1139,238000,10452
27266,972,26294,1130,427200,10453
13167,687,12480,730,430200,10454
14401,1200,13201,974,330000,10455
30774,1756,29018,1019,345200,10456
24634,1438,23196,1154,376600,10457
27282,1060,26222,1222,383400,10458
16382,1875,14507,1020,389400,10459
20443,2155,18288,1053,412700,10460
18927,6162,12765,1373,451100,10461
29543,6600,22943,1342,300000,10462
28682,9219,19463,1326,287400,10463
1893,1248,645,1186,531800,10464
15994,9004,6990,1356,462100,10465
23704,9191,14513,1281,422700,10466
36732,5011,31721,1285,335400,10467
26338,2000,24338,1236,194000,10468
22450,11439,11011,1379,438900,10469
6076,2222,3854,1380,424400,10470
8598,4193,4405,1548,345500,10471
21887,3122,18765,1173,451900,10472
20935,6189,14746,964,381600,10473
3488,219,3269,1138,427800,10474
18759,8080,10679,1023,27600,10475
431,427,4,-,689600,10501
1957,1663,294,1440,649600,10502
120,120,0,-,573500,10503
2765,2484,281,2805,1012600,10504
329,179,150,1163,762000,10505
1868,1758,110,2409,989400,10506
2080,987,1093,1562,567600,10507
6851,5289,1562,1372,355400,10509
3567,2976,591,1568,718500,10510
745,567,178,1539,374300,10511
9335,7681,1654,1325,305100,10512
3953,3829,124,3444,959800,10514
2200,1709,491,1449,507900,10516
175,100,75,1766,400000,10517
412,394,18,-,766200,10518
98,98,0,-,556500,10519
5218,3229,1989,1373,534300,10520
3671,2217,1454,1850,644600,10522
2898,1438,1460,2185,441600,10523
1422,1295,127,1547,453600,10524
627,535,92,1649,496400,10526
253,253,0,-,620900,10527
4632,2676,1956,2169,753000,10528
5738,4569,1169,1816,410800,10530
1730,1480,250,1615,544700,10532
2623,2117,506,1569,702600,10533
143,48,95,1568,-,10535
3572,3215,357,1940,739000,10536
725,570,155,2014,244400,10537
5744,4644,1100,1847,976700,10538
8972,7620,1352,1402,377100,10541
7549,4487,3062,1884,624700,10543
0,0,0,-,-,10545
482,432,50,3278,688700,10546
2423,1757,666,1769,368200,10547
1356,938,418,1332,361500,10548
5900,4128,1772,1490,556700,10549
13410,3065,10345,1273,355900,10550
8359,4653,3706,1456,372100,10552
3385,1845,1540,1443,359400,10553
1727,1379,348,1637,580400,10560
10900,6435,4465,1557,399400,10562
9598,4537,5061,1374,284500,10566
6812,6079,733,1955,403700,10567
4116,3363,753,1759,668100,10570
12489,6554,5935,1556,522900,10573
1841,1671,170,3353,893900,10576
825,711,114,"3,500+",1085600,10577
258,189,69,2007,514500,10578
3175,2871,304,1643,392500,10579
6058,4645,1413,2157,1379800,10580
13746,11920,1826,1944,927800,10583
1163,754,409,1814,353100,10588
3722,3315,407,2610,467400,10589
2688,2428,260,2035,559400,10590
8742,4448,4294,1588,595200,10591
1580,1328,252,2200,621800,10594
2303,1618,685,1907,614100,10595
467,290,177,1806,314000,10596
351,351,0,-,881900,10597
10521,9209,1312,1383,436900,10598
5626,1896,3730,1710,363900,10601
6934,4389,2545,1648,418900,10603
3760,2130,1630,1840,663100,10604
7276,5397,1879,1613,637200,10605
5580,2515,3065,1747,552200,10606
2345,1820,525,1590,499700,10607
22535,6985,15550,1287,346200,10701
7457,3734,3723,1279,347600,10703
12283,6830,5453,1492,414100,10704
14260,4291,9969,1292,399200,10705
3179,2514,665,1793,666700,10706
3956,2547,1409,1734,570600,10707
8933,6730,2203,1668,412400,10708
3710,2864,846,1686,646100,10709
10118,6855,3263,1446,443000,10710
14439,5617,8822,1472,481600,10801
3947,3016,931,1825,771600,10803
4920,4731,189,2568,730800,10804
7549,3056,4493,1521,351200,10805
8739,6520,2219,1421,392800,10901
0,0,0,-,-,10910
0,0,0,-,-,10911
1607,1582,25,1413,514100,10913
127,127,0,-,357800,10914
36,36,0,-,-,10915
1323,1283,40,1565,331300,10916
532,399,133,1588,340100,10917
3885,3233,652,1475,305000,10918
500,477,23,-,241300,10919
2964,2480,484,1388,441800,10920
1382,1052,330,1366,274200,10921
599,427,172,1769,254600,10922
2595,1629,966,1458,339100,10923
4294,2978,1316,1235,325500,10924
1648,1210,438,1119,260300,10925
1306,693,613,1546,229300,10926
3641,1507,2134,1389,248200,10927
1760,936,824,1300,217800,10928
2796,2566,230,1330,312400,10930
312,206,106,1694,318200,10931
49,49,0,-,154600,10932
142,129,13,-,251100,10933
18287,11020,7267,1211,209800,10940
4790,3188,1602,1271,255700,10941
12596,8095,4501,1300,322200,10950
9031,4129,4902,1440,603000,10952
49,49,0,-,-,10953
8319,6252,2067,2069,387500,10954
10330,9249,1081,1407,495500,10956
998,871,127,1234,290700,10958
6161,2855,3306,1679,497300,10960
1762,1484,278,1100,471900,10962
962,735,227,1521,212900,10963
549,449,100,1835,692200,10964
5431,4375,1056,1375,450800,10965
1118,772,346,1880,581200,10968
474,394,80,1141,281100,10969
3562,2733,829,1646,329500,10970
715,526,189,1542,280200,10973
1113,874,239,1750,313100,10974
114,65,49,-,184600,10975
731,480,251,532,424400,10976
16126,7545,8581,1348,404500,10977
78,78,0,-,-,10979
4774,4024,750,1526,366100,10980
1975,1838,137,2256,474300,10983
887,839,48,2520,385400,10984
54,54,0,-,268600,10985
542,497,45,-,467900,10986
1337,1079,258,1515,474400,10987
315,255,60,1228,228700,10988
3460,2984,476,2161,412900,10989
7453,5820,1633,1048,339600,10990
3076,2552,524,935,263000,10992
1655,930,725,1174,240100,10993
2621,2448,173,1375,497900,10994
885,9,876,3119,-,10996
995,832,163,1295,319400,10998
9144,7394,1750,1634,552900,11001
12256,9821,2435,1768,386900,11003
5178,3674,1504,1492,523700,11004
1271,1176,95,-,656700,11005
7726,6427,1299,1683,463800,11010
1883,1536,347,1494,951500,11020
7949,5563,2386,1784,623400,11021
2836,2361,475,2295,893800,11023
2059,1785,274,1794,1644500,11024
6360,5627,733,1513,1274100,11030
12876,11500,1376,1878,611700,11040
0,0,0,-,-,11042
11058,7123,3935,2039,820500,11050
2581,1122,1459,1440,376600,11096
13169,2230,10939,1608,924200,11101
13072,1741,11331,1697,614000,11102
15665,2536,13129,1700,792600,11103
11619,2298,9321,1577,478100,11104
15363,4255,11108,1709,808700,11105
16992,3028,13964,1614,571400,11106
2954,291,2663,3187,797400,11109
28067,10403,17664,2410,915900,11201
27761,11278,16483,1306,447400,11203
23601,8748,14853,1375,825500,11204
16294,3925,12369,1420,715000,11205
31042,3274,27768,1068,655200,11206
33240,8440,24800,1178,470400,11207
32181,8377,23804,1260,466200,11208
29297,11028,18269,1510,753600,11209
22267,9906,12361,1353,623100,11210
39384,6484,32900,1789,1002900,11211
31454,4649,26805,953,425400,11212
25027,3903,21124,1236,776300,11213
31933,10629,21304,1360,711400,11214
28635,11611,17024,2216,1138500,11215
24079,5328,18751,1408,1073700,11216
17447,5217,12230,2015,1163200,11217
24866,9106,15760,1550,751100,11218
24430,6687,17743,1394,864700,11219
28083,7302,20781,1355,827800,11220
30871,6646,24225,1372,784600,11221
17256,3091,14165,1966,818200,11222
27958,9964,17994,1318,752200,11223
18725,5203,13522,822,386400,11224
24105,3777,20328,1395,776200,11225
36733,4564,32169,1365,580400,11226
15306,8443,6863,1416,864600,11228
30946,14601,16345,1319,608400,11229
30572,9090,21482,1360,770600,11230
15702,4919,10783,1749,1268600,11231
8812,2222,6590,1492,705600,11232
29345,6657,22688,1175,755900,11233
31835,21649,10186,1448,556500,11234
32269,12770,19499,1321,534300,11235
33282,16228,17054,1377,517700,11236
16740,1668,15072,1484,651800,11237
24547,7328,17219,1730,886100,11238
6764,215,6549,690,499400,11239
0,0,0,-,-,11351
20112,7781,12331,1440,498400,11354
27606,8316,19290,1392,573700,11355
7453,3298,4155,1656,626300,11356
14515,11239,3276,1763,678900,11357
13042,7207,5835,1601,752600,11358
0,0,0,-,-,11359
8583,6139,2444,2047,522000,11360
10026,5750,4276,1783,682500,11361
7151,5704,1447,1808,521500,11362
2661,2008,653,2080,809800,11363
13554,9993,3561,1753,538900,11364
15571,7373,8198,1557,661800,11365
4633,3269,1364,1746,729200,11366
14580,6802,7778,1366,479700,11367
28502,6175,22327,1572,532800,11368
10294,5609,4685,1503,567000,11369
7993,4082,3911,1628,671400,11370
0,0,0,-,-,11371
23814,7543,16271,1441,325000,11372
30285,8914,21371,1485,545500,11373
19416,7524,11892,1591,361400,11374
32857,16697,16160,1731,395100,11375
31400,9688,21712,1490,528700,11377
12604,6412,6192,1600,605300,11378
13504,8218,5286,1518,646300,11379
35126,11272,23854,1477,581900,11385
6270,5390,880,1531,432300,11411
11039,8206,2833,1441,427200,11412
12356,8768,3588,1664,446800,11413
10680,7453,3227,1576,504300,11414
8379,2999,5380,1540,348100,11415
7217,3124,4093,1489,524900,11416
9060,5451,3609,1514,481900,11417
10938,4761,6177,1461,522500,11418
12479,7351,5128,1554,481500,11419
13159,8799,4360,1553,478000,11420
11638,6460,5178,1612,477600,11421
9653,6399,3254,1722,438900,11422
9787,5672,4115,1411,475000,11423
0,0,0,-,-,11424
0,0,0,-,-,11425
6356,4832,1524,1729,542700,11426
7500,4499,3001,1399,488000,11427
5558,3832,1726,1487,472200,11428
7340,5280,2060,1401,434500,11429
0,0,0,-,-,11430
18547,6791,11756,1453,583900,11432
10519,4676,5843,1282,411500,11433
21462,10525,10937,1141,402400,11434
18874,6868,12006,1466,393300,11435
5581,4065,1516,1591,396600,11436
0,0,0,-,-,11451
7586,4979,2607,1627,476900,11501
2401,2340,61,1900,671500,11507
876,779,97,2817,750500,11509
10648,9238,1410,1833,387100,11510
1648,1162,486,1789,498400,11514
2165,1432,733,1872,499700,11516
3948,3010,938,2025,420100,11518
14086,9436,4650,1434,324800,11520
9423,8637,786,3154,776500,11530
9958,5140,4818,1768,492600,11542
4245,3763,482,1756,847400,11545
268,211,57,743,524200,11547
521,360,161,1925,673900,11548
0,0,0,-,-,11549
16451,7508,8943,1410,320000,11550
7074,6178,896,2024,431000,11552
6325,4633,1692,1500,330500,11553
12217,10741,1476,2332,432100,11554
0,0,0,-,-,11556
2689,2286,403,1620,558900,11557
2927,2103,824,1600,427900,11558
2694,2281,413,1686,815000,11559
2328,1782,546,1842,742500,11560
16017,9533,6484,1880,498600,11561
8062,5920,2142,1770,442700,11563
3166,3087,79,2000,444900,11565
11113,10584,529,2266,526200,11566
1079,1001,78,1394,"2,000,000+",11568
457,330,127,2197,780800,11569
10258,7326,2932,1630,608300,11570
10155,8953,1202,1413,460300,11572
4418,3257,1161,1833,296300,11575
4585,4106,479,2381,955200,11576
4300,3736,564,2218,800800,11577
1967,1424,543,2151,673000,11579
13302,11197,2105,1721,393900,11580
6854,5674,1180,1709,453000,11581
14082,10727,3355,1869,442600,11590
3567,3063,504,1843,596900,11596
3971,3407,564,2135,696600,11598
20594,4964,15630,1200,462500,11691
6815,2338,4477,1010,381900,11692
4845,2456,2389,1037,310800,11693
8468,4505,3963,1321,651300,11694
1365,1322,43,-,570900,11697
8519,5755,2764,1434,343000,11701
4982,3943,1039,1893,447800,11702
5305,4341,964,1952,345300,11703
12568,9111,3457,1728,347200,11704
2729,2254,475,1789,431600,11705
18534,13573,4961,1577,326700,11706
2500,2038,462,1545,536200,11709
11329,9973,1356,1636,475100,11710
3208,2027,1181,2119,329200,11713
7915,7117,798,1931,428200,11714
1575,1408,167,1750,415300,11715
3625,2665,960,1777,375700,11716
13694,10115,3579,1462,294900,11717
1144,1082,62,1244,498800,11718
1161,914,247,1352,414000,11719
8855,7242,1613,1904,343300,11720
2271,2138,133,1710,607100,11721
9371,6226,3145,1610,263100,11722
999,848,151,2887,1107400,11724
9823,9017,806,1744,472300,11725
5785,4335,1450,1580,298000,11726
11121,7127,3994,1982,299300,11727
8744,7119,1625,1593,358800,11729
4439,3851,588,2026,403800,11730
10044,8924,1120,1944,479500,11731
1456,1063,393,2293,631300,11732
5486,5119,367,2211,482800,11733
11479,9165,2314,1625,408100,11735
5243,4450,793,2025,351400,11738
293,293,0,-,636700,11739
3140,2565,575,537,549200,11740
9105,7291,1814,1899,365100,11741
4436,3634,802,1706,348700,11742
15108,13277,1831,1878,600400,11743
20696,17346,3350,1797,481600,11746
7048,6127,921,2307,623000,11747
960,871,89,1947,317400,11749
5038,4343,695,1440,371000,11751
2965,2448,517,1991,352800,11752
4282,3763,519,1862,800700,11753
6534,5305,1229,1504,444000,11754
4282,3684,598,1840,405100,11755
13499,12508,991,2065,378000,11756
14488,11367,3121,1558,347600,11757
18570,17001,1569,2050,461200,11758
7425,7209,216,2333,460400,11762
9420,7736,1684,1829,312800,11763
4100,3888,212,1445,434700,11764
231,206,25,2643,"2,000,000+",11765
4252,4011,241,864,450800,11766
5092,4517,575,1910,449400,11767
7830,6841,989,1786,637900,11768
3366,2844,522,1499,413100,11769
21,21,0,-,675000,11770
3669,2863,806,1738,818900,11771
17066,10625,6441,1435,313800,11772
7929,6243,1686,1816,353800,11776
3431,2422,1009,1826,524000,11777
4105,3389,716,1488,290600,11778
12485,9552,2933,1504,339300,11779
5468,5007,461,1858,499200,11780
5220,4024,1196,1825,440600,11782
7024,6380,644,2075,456500,11783
7741,6397,1344,1761,304900,11784
1900,1764,136,2510,415200,11786
11842,10404,1438,1621,484600,11787
5478,4378,1100,2071,468300,11788
2845,2633,212,1571,304200,11789
4466,4115,351,3280,455900,11790
8241,7635,606,2503,686000,11791
2837,2596,241,2648,427300,11792
10381,9735,646,1616,459000,11793
0,0,0,-,-,11794
7899,7463,436,1679,416800,11795
1185,939,246,1602,383500,11796
3009,2610,399,2631,845400,11797
3601,2645,956,1526,301100,11798
12680,10999,1681,1909,427500,11801
9556,8688,868,1741,566700,11803
1729,1580,149,300,562800,11804
9828,6722,3106,1456,307100,11901
445,382,63,1750,1483300,11930
11,0,11,-,-,11931
466,409,57,1300,975600,11932
3165,2759,406,2135,350000,11933
2547,2216,331,1654,371500,11934
1261,1111,150,1621,551300,11935
6617,5600,1017,1774,802300,11937
449,364,85,1673,625800,11939
1850,1533,317,1725,431400,11940
718,596,122,1304,497500,11941
1795,1610,185,1748,560500,11942
1829,1264,565,1324,484300,11944
5813,3950,1863,1717,466200,11946
176,176,0,-,659100,11947
350,350,0,-,539700,11948
5014,4071,943,1722,417500,11949
4425,3529,896,1990,235100,11950
4327,3170,1157,1793,210300,11951
1982,1717,265,1351,568800,11952
5252,3689,1563,1748,277000,11953
1380,1186,194,2302,890200,11954
1778,812,966,1764,384600,11955
117,83,34,1861,753300,11956
361,313,48,1721,803800,11957
355,302,53,-,606500,11958
327,251,76,1630,1046900,11959
319,310,9,-,817700,11960
5577,4701,876,1389,279300,11961
132,117,15,-,"2,000,000+",11962
2900,2353,547,1987,865400,11963
895,772,123,-,850000,11964
310,264,46,-,814400,11965
8054,6513,1541,2085,262500,11967
4448,3583,865,1878,890900,11968
139,119,20,-,-,11970
2556,2153,403,1463,563700,11971
460,336,124,1675,522300,11972
0,0,0,-,-,11973
84,76,8,-,1684800,11975
773,729,44,2790,1582900,11976
833,701,132,2188,785400,11977
1263,911,352,1934,642700,11978
1803,1352,451,2216,300700,11980
0,0,0,-,-,12007
197,189,8,-,225000,12008
2993,2449,544,1058,257100,12009
11571,7241,4330,781,112100,12010
1113,835,278,884,174300,12015
182,144,38,1010,261500,12017
2961,2531,430,870,214400,12018
5994,4894,1100,1077,283200,12019
13525,10051,3474,1149,227900,12020
284,242,42,929,147900,12022
805,734,71,623,182700,12023
0,0,0,-,-,12024
2272,1854,418,770,156100,12025
1471,1191,280,1086,268800,12027
335,285,50,983,162100,12028
426,360,66,1359,286000,12029
82,63,19,618,120300,12031
385,364,21,738,134100,12032
3074,2331,743,1058,216000,12033
320,243,77,878,86600,12035
94,85,9,-,114600,12036
1882,1375,507,1064,220800,12037
66,66,0,-,92900,12040
215,208,7,-,163200,12041
104,82,22,-,147100,12042
2910,1667,1243,798,149100,12043
216,121,95,928,137500,12045
395,366,29,-,201100,12046
9153,4372,4781,922,175900,12047
1489,1077,412,745,171400,12051
668,520,148,875,181500,12052
1312,1108,204,1288,221100,12053
6789,5012,1777,1107,264100,12054
746,658,88,970,208600,12056
835,761,74,1308,178200,12057
594,467,127,865,213600,12058
683,635,48,805,234300,12059
680,605,75,540,245900,12060
3766,2736,1030,1261,244100,12061
690,585,105,899,178000,12062
161,112,49,-,193300,12063
200,154,46,712,86900,12064
17836,12458,5378,1179,268600,12065
796,716,80,917,154200,12066
594,541,53,778,229600,12067
1177,1000,177,677,127000,12068
113,95,18,-,125300,12069
684,614,70,1067,112200,12070
146,108,38,-,120800,12071
998,829,169,819,112000,12072
1145,1051,94,1203,233600,12074
1115,929,186,1155,216100,12075
654,571,83,833,139100,12076
2713,2026,687,1296,291200,12077
9890,6356,3534,717,89900,12078
1402,1201,201,863,178100,12083
2112,552,1560,1212,269400,12084
167,25,142,1045,-,12085
716,654,62,850,154000,12086
316,272,44,-,122400,12087
64,54,10,-,-,12089
2459,1623,836,891,134800,12090
331,229,102,939,109400,12092
672,569,103,643,157600,12093
929,796,133,1092,175500,12094
4903,3412,1491,827,103700,12095
1100,886,214,977,238200,12106
85,70,15,-,258300,12108
7419,5058,2361,1228,242700,12110
65,59,6,-,-,12115
748,607,141,964,106100,12116
1389,1102,287,1003,144800,12117
6624,4386,2238,882,260300,12118
265,225,40,887,200700,12120
619,585,34,-,205300,12121
1995,1606,389,686,121900,12122
2135,1691,444,912,208200,12123
194,185,9,-,199700,12124
614,385,229,966,175600,12125
256,181,75,1103,206300,12130
29,24,5,-,171900,12131
103,65,38,-,290400,12132
1465,1131,334,828,164000,12134
288,266,22,-,357600,12136
648,563,85,917,186900,12137
1430,1151,279,794,158100,12138
48,44,4,-,187500,12139
682,588,94,639,208600,12140
2041,1247,794,863,177400,12143
8861,5099,3762,969,179000,12144
228,203,25,1260,241100,12147
1728,1420,308,976,340700,12148
981,685,296,767,152600,12149
299,272,27,-,145900,12150
355,296,59,1199,213900,12151
305,300,5,-,300000,12153
1082,922,160,823,190300,12154
733,555,178,681,117700,12155
392,340,52,724,303600,12156
1680,1373,307,782,160700,12157
2580,2085,495,1132,218800,12158
3340,2442,898,1089,340400,12159
320,276,44,1028,150500,12160
88,74,14,-,-,12161
77,66,11,775,152300,12164
77,63,14,1563,356300,12165
524,475,49,675,117200,12166
1124,766,358,622,142200,12167
921,737,184,713,144300,12168
83,83,0,-,168100,12169
1954,1601,353,1290,222100,12170
113,50,63,1067,159400,12172
791,593,198,1070,163900,12173
108,88,20,-,171900,12174
222,195,27,944,142700,12175
144,137,7,-,188300,12176
166,99,67,672,115600,12177
21551,9953,11598,962,172500,12180
6110,3305,2805,827,145500,12182
1247,485,762,818,130100,12183
2551,1985,566,866,229800,12184
826,718,108,833,210100,12185
2425,2170,255,1007,253800,12186
261,180,81,685,176000,12187
4616,3016,1600,958,215100,12188
8212,3201,5011,869,170500,12189
168,150,18,865,161700,12190
705,647,58,1093,160000,12192
723,634,89,945,179400,12193
50,50,0,-,86000,12194
71,51,20,-,227200,12195
1257,1099,158,868,222600,12196
817,683,134,980,127800,12197
2984,2398,586,863,198400,12198
4349,979,3370,824,98900,12202
13454,6681,6773,1081,207900,12203
3656,919,2737,1038,180200,12204
11149,7616,3533,1124,206900,12205
6226,1578,4648,940,103900,12206
934,80,854,540,156600,12207
9905,4883,5022,988,196600,12208
3974,2343,1631,1059,157900,12209
5355,933,4422,940,156100,12210
4082,3743,339,1204,290600,12211
0,0,0,-,-,12222
9783,7246,2537,1045,181500,12302
10283,7743,2540,915,177400,12303
8164,4976,3188,920,122200,12304
2196,417,1779,759,130800,12305
9058,6674,2384,948,162900,12306
1908,453,1455,745,81100,12307
4977,2432,2545,907,126000,12308
10456,8594,1862,1099,245800,12309
14531,8055,6476,1057,184300,12401
1348,1024,324,1103,255900,12404
193,130,63,682,222000,12405
419,209,210,815,187500,12406
69,69,0,-,237500,12407
362,282,80,1250,364100,12409
213,195,18,-,184400,12410
141,141,0,-,244500,12411
266,168,98,1188,224400,12412
997,595,402,890,149800,12413
4096,2468,1628,919,166400,12414
112,73,39,-,286500,12416
141,89,52,1309,-,12417
152,126,26,-,178000,12418
246,122,124,1064,250000,12419
126,107,19,-,-,12420
151,151,0,-,-,12421
103,101,2,-,180100,12422
425,305,120,906,200500,12423
139,110,29,932,179200,12424
65,65,0,-,131900,12427
2694,1550,1144,919,141500,12428
100,68,32,-,300000,12429
537,481,56,617,216400,12430
404,313,91,1128,175500,12431
192,132,60,1117,205000,12432
291,260,31,-,273300,12433
346,266,80,578,97500,12434
100,52,48,979,266700,12435
39,19,20,-,-,12436
9,9,0,-,-,12438
130,123,7,-,182200,12439
838,648,190,1238,277300,12440
34,34,0,-,-,12441
482,283,199,865,202000,12442
1520,1406,114,1356,228300,12443
205,183,22,746,244400,12444
1865,1402,463,1011,228900,12446
235,210,25,-,417600,12448
1242,762,480,1070,177800,12449
78,78,0,-,-,12450
457,338,119,975,150800,12451
103,96,7,-,151700,12452
142,90,52,-,360000,12453
121,107,14,1083,234800,12454
851,659,192,789,193100,12455
216,188,28,-,134100,12456
431,288,143,1141,262800,12457
953,655,298,608,112300,12458
124,124,0,-,-,12459
119,76,43,725,132100,12460
730,563,167,733,243600,12461
613,496,117,932,185900,12463
459,309,150,1037,227100,12464
92,86,6,-,246200,12465
1013,836,177,1175,211700,12466
413,355,58,492,180900,12468
265,258,7,-,158700,12469
183,139,44,952,149200,12470
113,16,97,1396,-,12471
626,406,220,1002,203800,12472
292,292,0,-,168900,12473
450,353,97,787,143800,12474
128,98,30,1583,192200,12475
7541,5301,2240,1047,215300,12477
326,321,5,-,160700,12480
561,487,74,-,249600,12481
182,158,24,-,43100,12482
175,97,78,-,101000,12483
1155,942,213,1016,291300,12484
685,452,233,671,248400,12485
567,541,26,-,229800,12486
1354,929,425,1222,190200,12487
135,113,22,-,-,12489
14,14,0,-,-,12490
668,573,95,1486,221600,12491
99,96,3,-,213900,12492
108,76,32,-,178700,12493
341,301,40,-,291300,12494
98,91,7,-,618600,12495
541,458,83,708,231500,12496
2372,1846,526,964,289900,12498
990,570,420,1148,273100,12501
447,350,97,1306,324500,12502
256,183,73,1320,346900,12503
42,12,30,1444,-,12504
81,64,17,-,463600,12507
7123,4095,3028,1345,262800,12508
64,64,0,-,-,12512
160,138,22,-,205000,12513
1127,1054,73,1301,344100,12514
552,395,157,1042,237300,12515
588,469,119,1065,263300,12516
212,93,119,739,239600,12517
2314,1397,917,1385,314200,12518
1026,718,308,1363,311500,12520
719,678,41,950,248900,12521
1915,1339,576,841,234600,12522
672,561,111,920,255300,12523
5950,4187,1763,1415,282500,12524
1080,765,315,1114,307500,12525
1502,1159,343,1057,295800,12526
0,0,0,-,-,12527
4969,3386,1583,1198,248000,12528
1005,764,241,1006,261000,12529
92,42,50,-,-,12530
1092,910,182,1600,291200,12531
8512,7667,845,1159,342000,12533
7705,4674,3031,889,194400,12534
4939,3512,1427,1073,221900,12538
2698,2489,209,1400,344500,12540
2313,1467,846,936,250900,12542
1382,861,521,1116,176700,12543
1965,1110,855,1123,374400,12545
1208,692,516,1156,245000,12546
1023,746,277,1372,221500,12547
528,430,98,960,252900,12548
3749,2826,923,1285,276900,12549
18991,10604,8387,1162,230500,12550
9323,6633,2690,1270,251600,12553
6340,4084,2256,1256,295100,12561
2433,1992,441,1241,310200,12563
2671,1957,714,1093,312500,12564
568,230,338,850,153100,12565
3885,2944,941,1143,250500,12566
1209,886,323,1144,260500,12567
4091,2804,1287,1381,270100,12569
2507,2253,254,1743,328500,12570
3895,2932,963,1125,295900,12571
3587,2495,1092,1333,365100,12572
108,90,18,-,-,12574
775,726,49,-,344900,12575
584,511,73,1897,294100,12577
861,716,145,1292,315800,12578
1644,1163,481,1025,249400,12580
986,767,219,1092,276900,12581
1350,1186,164,1203,368400,12582
933,621,312,1197,298800,12583
313,239,74,974,370200,12585
4069,2992,1077,1295,217200,12586
4779,3925,854,1123,247900,12589
12799,9376,3423,1348,284300,12590
482,321,161,686,253000,12592
1585,1155,430,924,248600,12594
16137,6234,9903,1110,209100,12601
15431,11679,3752,1265,251700,12603
6,6,0,-,-,12604
4162,1957,2205,900,126600,12701
542,444,98,998,204300,12719
46,11,35,-,-,12720
1995,1488,507,1129,233100,12721
63,63,0,-,-,12722
668,543,125,759,163400,12723
131,94,37,-,332900,12724
55,51,4,-,162500,12725
537,424,113,1069,201400,12726
765,540,225,1135,132800,12729
348,265,83,1143,167900,12732
319,143,176,787,152000,12733
355,234,121,-,161100,12734
32,28,4,-,-,12736
627,533,94,948,193900,12737
111,57,54,1071,206600,12738
752,556,196,1234,227300,12740
93,67,26,681,117500,12741
48,29,19,443,297500,12742
156,98,58,1178,241700,12743
105,62,43,705,180300,12745
366,324,42,1096,198500,12746
666,439,227,-,128900,12747
880,715,165,970,184700,12748
195,51,144,690,-,12749
95,70,25,1149,262500,12750
290,127,163,895,154700,12751
121,67,54,793,169300,12752
2414,1316,1098,823,124700,12754
1584,1100,484,1109,159700,12758
665,466,199,751,76300,12759
209,172,37,-,155800,12760
258,148,110,718,-,12762
227,167,60,824,173300,12763
743,581,162,675,189700,12764
352,253,99,-,231100,12765
194,141,53,-,165500,12766
59,55,4,-,150800,12767
269,210,59,-,156000,12768
96,68,28,-,105600,12769
97,89,8,-,193800,12770
5897,3705,2192,977,180500,12771
740,612,128,1161,225900,12775
936,798,138,695,178700,12776
376,343,33,1406,237200,12777
248,196,52,-,204200,12778
771,311,460,679,231900,12779
856,790,66,1088,169700,12780
113,113,0,-,-,12781
582,473,109,1077,164000,12783
14,8,6,-,-,12784
394,323,71,1109,181900,12785
163,108,55,-,219600,12786
118,113,5,-,125700,12787
747,621,126,850,144800,12788
877,452,425,886,115400,12789
1592,1280,312,1014,168100,12790
230,135,95,825,168600,12791
77,59,18,-,206300,12792
6488,3299,3189,843,151400,12801
3651,2361,1290,915,178600,12803
10639,7926,2713,1037,222500,12804
162,162,0,-,280800,12808
1346,1174,172,725,151000,12809
302,279,23,922,117900,12810
10,6,4,-,-,12811
43,37,6,-,151300,12812
649,461,188,793,310300,12814
467,408,59,844,220200,12815
1969,1415,554,801,166000,12816
1026,858,168,719,190800,12817
124,103,21,925,128800,12819
113,90,23,-,137500,12821
2359,1869,490,883,155700,12822
200,191,9,-,-,12823
443,387,56,867,287900,12824
1409,1086,323,837,154900,12827
3640,2718,922,893,141500,12828
6297,4924,1373,1032,238600,12831
2768,1919,849,650,118900,12832
1667,1436,231,817,240700,12833
2443,2019,424,840,194500,12834
1056,898,158,805,181700,12835
289,257,32,744,298500,12836
386,334,52,856,107900,12837
241,210,31,1074,169600,12838
5414,2858,2556,898,131600,12839
68,59,9,-,625000,12841
264,212,52,574,117000,12842
188,150,38,660,125000,12843
120,96,24,-,-,12844
2027,1611,416,917,253200,12845
1381,1173,208,1050,169700,12846
127,118,9,850,237500,12847
173,173,0,-,164800,12849
1190,908,282,1137,243600,12850
164,147,17,817,108900,12851
222,209,13,613,162500,12852
635,491,144,833,162300,12853
124,104,20,825,121900,12855
66,66,0,-,157500,12856
239,198,41,942,160000,12857
63,63,0,-,487500,12858
907,771,136,1395,199800,12859
282,239,43,-,139600,12860
288,258,30,895,163000,12861
5,5,0,-,-,12862
248,221,27,950,282300,12863
21,19,2,-,-,12864
1531,1316,215,913,138300,12865
17363,10579,6784,1281,340100,12866
630,513,117,703,211100,12870
1691,1247,444,925,176000,12871
21,17,4,-,-,12872
349,320,29,938,182700,12873
85,82,3,-,516700,12874
255,228,27,729,137500,12878
2093,1610,483,697,120300,12883
183,131,52,978,127000,12884
1949,1294,655,779,150300,12885
129,115,14,-,-,12886
1758,1291,467,808,110200,12887
13012,6951,6061,806,141500,12901
671,350,321,1270,141300,12903
553,427,126,802,83000,12910
6,6,0,-,-,12911
847,612,235,723,115700,12912
521,432,89,680,162300,12913
395,320,75,752,72400,12914
808,562,246,709,111000,12916
552,428,124,675,105300,12917
885,788,97,743,139400,12918
1252,941,311,726,103700,12919
1010,764,246,693,89400,12920
905,765,140,820,142600,12921
20,18,2,-,133300,12922
239,196,43,389,75800,12923
40,29,11,-,-,12924
993,771,222,596,85900,12926
128,106,22,686,96700,12927
765,555,210,817,130600,12928
304,219,85,798,103100,12929
295,228,67,781,92900,12930
481,369,112,786,173600,12932
25,25,0,-,-,12933
388,293,95,725,94400,12934
682,530,152,675,128100,12935
200,176,24,550,221100,12936
723,550,173,803,82600,12937
96,63,33,1090,106300,12939
575,501,74,1190,160900,12941
397,367,30,1175,273900,12942
195,101,94,1013,217700,12943
1632,1172,460,874,105900,12944
232,224,8,-,178100,12945
1833,1042,791,901,258500,12946
288,244,44,743,100000,12950
154,96,58,785,-,12952
4859,3272,1587,706,98700,12953
144,126,18,731,96000,12955
455,373,82,-,78600,12956
765,528,237,702,85400,12957
1026,891,135,-,116200,12958
540,482,58,-,89400,12959
406,319,87,-,136400,12960
115,85,30,-,108200,12961
2384,2004,380,841,153000,12962
59,21,38,783,260700,12964
205,182,23,-,79000,12965
1075,854,221,748,76900,12966
471,396,75,580,63100,12967
213,210,3,-,92400,12969
154,107,47,-,185600,12970
2287,1834,453,783,157600,12972
41,41,0,-,85900,12973
709,564,145,589,103300,12974
137,98,39,766,172600,12975
106,95,11,-,235900,12976
34,34,0,-,-,12977
127,78,49,-,131600,12978
1027,611,416,608,141500,12979
528,433,95,675,67200,12980
1027,906,121,569,111600,12981
3346,2012,1334,753,178100,12983
555,453,102,1141,103300,12985
2612,1828,784,632,119800,12986
113,113,0,-,161700,12987
456,412,44,781,180600,12989
1981,1495,486,783,118800,12992
693,542,151,753,157600,12993
917,731,186,876,141000,12996
533,419,114,856,227000,12997
198,177,21,-,-,12998
40,40,0,-,116700,13020
16813,10237,6576,745,127000,13021
0,0,0,-,-,13024
579,440,139,723,169100,13026
13860,10140,3720,888,157700,13027
456,349,107,901,-,13028
2902,2172,730,829,168100,13029
1585,1305,280,730,130900,13030
6216,4824,1392,947,155500,13031
4740,3400,1340,833,124800,13032
1389,1223,166,732,119800,13033
798,681,117,743,136400,13034
3163,2616,547,897,221600,13035
3639,2812,827,761,120100,13036
3364,2812,552,694,145700,13037
6544,5622,922,907,171800,13039
1002,807,195,763,97000,13040
4250,3843,407,1196,148500,13041
948,746,202,1031,125700,13042
1101,937,164,803,117100,13044
10514,6341,4173,757,119100,13045
123,55,68,-,-,13051
571,471,100,607,99100,13052
1848,1389,459,809,172800,13053
583,437,146,782,152000,13054
6164,4526,1638,850,120600,13057
1089,945,144,692,138200,13060
443,366,77,829,182700,13061
16,16,0,-,-,13062
733,644,89,868,176300,13063
76,63,13,738,-,13064
5168,3973,1195,1059,234000,13066
2170,1493,677,854,159900,13068
9236,6245,2991,775,85900,13069
347,270,77,729,107400,13071
301,253,48,694,85800,13072
2578,1988,590,850,143400,13073
1577,1236,341,798,87900,13074
881,844,37,1306,110200,13076
2698,1920,778,816,131400,13077
3830,3026,804,1125,199700,13078
1325,1085,240,626,116000,13080
430,382,48,692,172800,13081
1774,1486,288,767,133500,13082
756,605,151,678,114200,13083
1580,1244,336,942,152600,13084
36,33,3,-,251500,13087
10035,6029,4006,884,131700,13088
11994,8566,3428,970,153600,13090
984,854,130,813,121800,13092
878,637,241,663,107500,13101
20,20,0,-,-,13102
121,91,30,830,-,13103
5991,4803,1188,902,241900,13104
2480,2049,431,803,176700,13108
870,777,93,710,178400,13110
621,529,92,811,97800,13111
691,636,55,1021,143300,13112
94,74,20,760,105000,13113
2333,1800,533,731,109000,13114
95,66,29,-,96700,13115
1400,991,409,807,134200,13116
106,69,37,900,86300,13117
2123,1725,398,724,117800,13118
844,782,62,539,87500,13120
416,322,94,724,217600,13122
104,104,0,-,67100,13123
41,41,0,-,82500,13124
13715,9095,4620,764,107900,13126
1390,1158,232,779,103800,13131
1410,1210,200,846,115500,13132
59,46,13,636,82700,13134
2687,1826,861,710,117000,13135
199,166,33,383,67800,13136
0,0,0,-,-,13138
1759,1437,322,699,86800,13140
245,199,46,928,113200,13141
2578,1915,663,738,109800,13142
1021,826,195,644,89600,13143
621,465,156,658,79600,13144
691,566,125,714,107700,13145
811,693,118,871,83700,13146
438,336,102,1030,110400,13147
4501,3211,1290,778,109000,13148
3493,2954,539,1023,288400,13152
169,106,63,836,170800,13153
256,200,56,529,73200,13155
806,693,113,706,95300,13156
256,189,67,1059,96300,13157
590,443,147,697,112300,13158
2058,1683,375,928,170200,13159
755,565,190,820,136100,13160
233,120,113,841,122700,13162
143,125,18,650,128200,13163
851,773,78,792,174700,13164
4379,3160,1219,752,88300,13165
2217,1724,493,793,134400,13166
1283,1042,241,944,134200,13167
2518,131,2387,799,94000,13202
7066,2000,5066,765,104700,13203
7897,2317,5580,796,76800,13204
7069,3062,4007,780,77800,13205
7597,3881,3716,784,93800,13206
5329,3258,2071,880,86100,13207
8456,3742,4714,755,86500,13208
5651,4000,1651,831,118600,13209
7979,2220,5759,890,141000,13210
2441,1645,796,950,85700,13211
8891,6446,2445,864,118700,13212
2879,2107,772,814,162400,13214
5511,4471,1040,961,197800,13215
6224,5013,1211,932,130900,13219
3600,2325,1275,796,155300,13224
0,0,0,-,-,13290
43,43,0,-,269400,13301
632,549,83,693,77700,13302
427,375,52,923,159700,13303
655,542,113,908,167800,13304
106,83,23,-,120100,13305
1182,983,199,846,109400,13308
2327,1802,525,637,117100,13309
277,266,11,-,107900,13310
180,151,29,796,239100,13312
177,124,53,721,68500,13313
143,143,0,-,72600,13314
558,486,72,1000,125600,13315
2617,1904,713,693,113100,13316
1541,1073,468,728,98900,13317
490,459,31,780,135900,13318
328,176,152,805,84200,13319
833,681,152,862,165600,13320
479,298,181,736,82300,13321
410,264,146,751,123200,13322
4077,2973,1104,915,171800,13323
896,778,118,675,97600,13324
412,385,27,1050,102900,13325
2439,1804,635,874,267200,13326
778,644,134,615,121200,13327
606,523,83,541,134900,13328
1701,1224,477,659,84100,13329
62,62,0,-,427300,13331
1064,865,199,843,92900,13332
22,12,10,-,139300,13333
371,332,39,-,91600,13334
556,454,102,663,133700,13335
278,191,87,777,331100,13337
557,493,64,579,106400,13338
2328,1790,538,720,84800,13339
3100,2322,778,734,106000,13340
50,50,0,-,105000,13341
81,75,6,-,134700,13342
726,617,109,629,108100,13343
77,51,26,1345,130400,13345
1710,1236,474,879,200000,13346
573,467,106,883,170900,13348
4020,2207,1813,799,90400,13350
32,32,0,-,-,13352
8,3,5,-,-,13353
1439,1308,131,669,140200,13354
307,250,57,736,103800,13355
4271,2969,1302,654,81000,13357
34,30,4,-,330000,13360
277,250,27,694,100000,13361
57,57,0,-,-,13362
926,815,111,1191,129600,13363
67,54,13,-,62000,13364
3163,2314,849,619,94300,13365
3108,2349,759,678,141800,13367
436,346,90,708,98900,13368
792,648,144,526,87300,13402
1775,1439,336,810,176500,13403
65,65,0,-,79300,13404
297,270,27,833,103800,13406
2058,1466,592,705,89300,13407
895,761,134,785,127100,13408
898,755,143,820,88300,13409
93,72,21,679,84000,13410
1289,1053,236,662,87500,13411
6552,4879,1673,980,164500,13413
26,16,10,-,-,13415
920,737,183,505,118700,13416
1721,761,960,805,120500,13417
107,80,27,-,63300,13418
457,405,52,-,247500,13420
5319,3302,2017,743,113300,13421
938,676,262,849,125000,13424
837,636,201,680,97300,13425
631,406,225,465,100700,13428
642,560,82,900,139500,13431
655,514,141,727,87300,13433
108,101,7,-,93600,13435
39,35,4,-,212500,13436
171,156,15,538,107600,13437
1360,1192,168,759,127500,13438
1519,1149,370,750,143600,13439
16173,10121,6052,769,107400,13440
64,0,64,-,-,13441
27,27,0,-,136800,13450
1828,1377,451,669,85100,13452
260,210,50,724,79500,13454
1562,1298,264,915,160700,13456
951,703,248,904,146800,13459
1848,1307,541,676,106100,13460
1271,966,305,736,153200,13461
600,454,146,706,81800,13464
181,123,58,575,164200,13468
353,353,0,-,144800,13469
302,285,17,563,82900,13470
1248,1018,230,781,104600,13471
38,38,0,-,-,13472
257,243,14,-,113300,13473
6,3,3,-,-,13475
1379,1030,349,684,156700,13476
562,468,94,591,135800,13477
1073,912,161,698,121000,13478
1379,1024,355,674,114800,13480
102,88,14,1281,175000,13483
79,79,0,-,114700,13484
437,392,45,689,94300,13485
374,296,78,1052,104300,13486
56,46,10,-,87800,13488
272,236,36,-,103500,13489
709,518,191,647,185500,13490
1365,1118,247,641,114100,13491
4881,3805,1076,804,142100,13492
683,563,120,720,91100,13493
136,126,10,-,154300,13494
884,589,295,733,100400,13495
14238,6810,7428,700,99600,13501
12992,7836,5156,737,97500,13502
15299,7392,7907,844,143900,13601
95,0,95,1703,-,13602
3167,28,3139,1413,156600,13603
1846,1352,494,784,144700,13605
1089,768,321,862,149600,13606
640,393,247,699,131800,13607
576,426,150,808,112500,13608
970,647,323,978,166000,13612
1040,767,273,699,96400,13613
123,79,44,488,50800,13614
452,328,124,835,161100,13615
823,309,514,1179,88900,13616
3399,2342,1057,931,124700,13617
756,634,122,641,139300,13618
4170,2378,1792,897,135600,13619
788,576,212,937,108900,13620
218,185,33,-,92100,13621
919,735,184,1049,151500,13622
10,6,4,-,-,13623
2013,1534,479,852,161200,13624
786,672,114,692,140800,13625
923,659,264,881,127100,13626
90,58,32,1075,90000,13628
512,413,99,544,93700,13630
121,100,21,-,76500,13633
1530,1291,239,537,164600,13634
435,313,122,727,74500,13635
100,77,23,863,128900,13636
1721,459,1262,1219,180700,13637
149,114,35,1182,77400,13638
118,105,13,-,58200,13639
191,184,7,-,361500,13640
32,32,0,-,81100,13641
3777,2586,1191,718,93900,13642
10,0,10,-,-,13643
905,703,202,733,87100,13646
18,18,0,-,-,13647
914,764,150,688,88300,13648
673,572,101,597,174500,13650
82,70,12,-,350000,13651
676,523,153,613,76800,13652
896,772,124,698,88500,13654
1171,952,219,493,111300,13655
943,847,96,657,136800,13656
905,758,147,617,120900,13658
199,178,21,783,97100,13659
594,443,151,661,108800,13660
510,449,61,886,118800,13661
7094,5002,2092,754,84300,13662
128,108,20,920,95000,13664
340,275,65,799,114500,13665
94,84,10,-,31400,13666
1326,877,449,713,87400,13667
1445,1109,336,766,81200,13668
6115,4345,1770,642,79100,13669
188,161,27,818,82800,13670
297,186,111,830,69600,13672
915,543,372,688,153300,13673
31,8,23,-,-,13674
60,60,0,-,-,13675
5323,3341,1982,836,119600,13676
29,18,11,-,-,13677
124,49,75,660,-,13678
711,617,94,874,147600,13679
482,421,61,698,99800,13680
323,300,23,631,97600,13681
319,285,34,1375,155400,13682
443,397,46,488,82500,13684
1157,540,617,1120,267900,13685
215,186,29,665,101000,13687
386,261,125,533,72500,13690
1087,801,286,986,141900,13691
39,39,0,-,337000,13692
183,160,23,-,160000,13693
652,481,171,778,137500,13694
51,48,3,-,216700,13695
29,16,13,-,-,13696
770,686,84,817,84500,13697
1197,962,235,618,118000,13730
441,372,69,981,205000,13731
3011,2580,431,646,139200,13732
2129,1688,441,707,98400,13733
842,619,223,622,96100,13734
779,612,167,938,98900,13736
341,276,65,583,153100,13739
239,207,32,767,230600,13740
1394,1229,165,640,98200,13743
464,424,40,-,119700,13744
867,816,51,748,120300,13746
1478,1260,218,-,126800,13748
429,294,135,744,131300,13750
40,12,28,685,-,13751
311,260,51,906,169900,13752
1854,1255,599,761,167700,13753
1324,967,357,690,119200,13754
508,455,53,677,105100,13755
189,135,54,692,157900,13756
498,412,86,929,138300,13757
19027,12417,6610,756,125800,13760
70,49,21,-,79600,13774
718,597,121,719,160700,13775
232,173,59,641,121800,13776
141,132,9,-,135900,13777
2288,1783,505,663,129800,13778
403,394,9,-,109000,13780
289,246,43,1012,167500,13782
1124,827,297,618,104800,13783
40,30,10,1583,77800,13784
178,150,28,-,150700,13786
1366,839,527,573,101100,13787
399,289,110,731,134900,13788
7671,4463,3208,847,92500,13790
19,19,0,-,35500,13794
1463,1034,429,876,98600,13795
592,481,111,838,162300,13796
825,695,130,913,86300,13797
609,498,111,717,83100,13801
166,166,0,-,95500,13802
1504,1210,294,823,107200,13803
153,109,44,544,120800,13804
124,89,35,570,133800,13806
554,402,152,601,156800,13807
586,462,124,729,135500,13808
655,554,101,833,77700,13809
498,400,98,698,134000,13810
1625,1343,282,669,110300,13811
929,795,134,679,104400,13812
221,221,0,-,117900,13813
5574,3539,2035,661,88200,13815
7687,4526,3161,873,147900,13820
1303,1010,293,796,140700,13825
15,15,0,-,-,13826
5238,3729,1509,760,111600,13827
2292,1737,555,653,94900,13830
241,226,15,-,88000,13832
1602,1419,183,866,101200,13833
71,16,55,1570,-,13834
506,414,92,770,91300,13835
1864,1104,760,616,84000,13838
455,411,44,714,116300,13839
239,187,52,728,108400,13841
165,141,24,-,202300,13842
828,735,93,588,112300,13843
272,218,54,793,89600,13844
71,71,0,-,-,13845
158,155,3,-,144600,13846
25,18,7,-,75500,13847
1825,1525,300,748,96500,13849
8653,6679,1974,952,145900,13850
2605,1930,675,681,115200,13856
94,75,19,-,133500,13859
7,7,0,-,-,13860
156,143,13,-,159800,13861
1722,1380,342,692,106000,13862
284,215,69,900,77400,13863
447,287,160,883,136600,13864
2373,2182,191,616,113000,13865
8153,4788,3365,673,122100,13901
8,8,0,-,-,13902
7817,4932,2885,696,114000,13903
3810,2627,1183,696,95600,13904
11268,5535,5733,771,108700,13905
4047,2925,1122,781,138700,14001
4145,3514,631,763,173300,14004
718,560,158,644,128700,14005
4272,3458,814,814,110700,14006
504,364,140,801,132100,14008
2370,1860,510,633,112900,14009
2655,2120,535,652,122900,14011
914,748,166,608,119600,14012
735,648,87,830,93100,14013
9646,6099,3547,742,107900,14020
620,560,60,750,108900,14024
1452,1169,283,827,186100,14025
325,191,134,710,166900,14026
690,604,86,897,128500,14028
685,577,108,745,132000,14030
4039,3313,726,680,233300,14031
3054,2821,233,1364,331800,14032
770,638,132,709,259900,14033
733,670,63,546,101400,14034
22,6,16,-,-,14035
1990,1621,369,615,144300,14036
418,370,48,-,162300,14037
37,28,9,588,84200,14039
822,696,126,872,151200,14040
55,53,2,-,67700,14041
1560,1121,439,659,89100,14042
10966,7580,3386,828,126400,14043
2517,2106,411,813,132000,14047
6118,3900,2218,662,70700,14048
7800,6647,1153,1513,280200,14051
6890,5702,1188,769,218900,14052
585,436,149,765,120300,14054
654,563,91,613,180800,14055
3278,2759,519,702,169700,14057
745,606,139,810,117800,14058
4199,3575,624,797,245000,14059
152,133,19,-,74000,14060
142,104,38,988,103600,14061
1346,1171,175,631,88900,14062
5175,3536,1639,754,123800,14063
669,599,70,767,100700,14065
511,431,80,676,88400,14066
2074,1604,470,789,126100,14067
2673,1954,719,1022,236800,14068
286,271,15,-,176700,14069
2190,1495,695,654,88000,14070
8288,6697,1591,973,196300,14072
18060,13582,4478,875,168400,14075
1748,1465,283,762,163600,14080
1368,1003,365,708,98800,14081
236,200,36,744,156300,14082
2614,2553,61,1125,183500,14085
13063,10858,2205,783,200300,14086
420,365,55,756,123400,14091
4827,3860,967,841,173200,14092
20203,14556,5647,658,121800,14094
1165,948,217,800,95000,14098
673,575,98,773,117400,14101
438,392,46,-,230300,14102
4579,3339,1240,735,82300,14103
1810,1390,420,640,107600,14105
2209,1946,263,754,100700,14108
0,0,0,-,-,14109
1296,1021,275,700,127800,14111
18,0,18,-,-,14112
247,203,44,685,124600,14113
18805,13789,5016,702,139700,14120
1387,1135,252,744,99500,14125
259,194,65,806,125400,14126
12094,9138,2956,976,234200,14127
551,436,115,589,98300,14129
66,56,10,-,79400,14130
2049,1866,183,1089,151900,14131
2315,1903,412,794,154400,14132
48,40,8,-,112500,14134
75,29,46,-,93800,14135
1877,1555,322,742,91200,14136
737,617,120,717,76000,14138
892,805,87,591,193300,14139
3233,2250,983,625,143400,14141
442,363,79,808,113600,14143
715,611,104,847,158400,14145
18759,13342,5417,829,124100,14150
661,569,92,683,144000,14167
7,7,0,-,-,14168
48,48,0,-,"10,000-",14169
1051,906,145,678,175800,14170
791,701,90,917,113100,14171
1245,1039,206,739,138800,14172
156,73,83,688,87000,14173
2334,1933,401,797,169000,14174
5674,1336,4338,699,184700,14201
1756,479,1277,549,378600,14202
1079,6,1073,836,-,14203
4066,1348,2718,536,85500,14204
8883,5403,3480,673,73600,14206
9465,3210,6255,703,63900,14207
4282,1802,2480,756,63400,14208
3787,1016,2771,797,176900,14209
6057,2930,3127,748,73900,14210
9250,3663,5587,750,44400,14211
4615,2174,2441,655,61800,14212
9393,3015,6378,768,95900,14213
7978,3630,4348,845,171100,14214
16278,7381,8897,768,59800,14215
10507,5293,5214,868,165700,14216
10734,7182,3552,747,126600,14217
7823,4076,3747,667,96000,14218
5433,3477,1956,752,121200,14219
9907,6373,3534,726,101600,14220
23207,17258,5949,1197,215900,14221
6468,2258,4210,875,290500,14222
9886,8163,1723,811,131000,14223
17738,13710,4028,804,151000,14224
15224,10644,4580,777,101500,14225
12526,9103,3423,925,155500,14226
10392,6734,3658,886,128700,14227
9437,5034,4403,1042,176000,14228
6,0,6,-,-,14261
5526,2308,3218,613,56800,14301
16,0,16,-,-,14302
2560,1073,1487,660,59600,14303
12848,9572,3276,719,94100,14304
6979,4103,2876,684,77300,14305
4975,3433,1542,720,95400,14411
3025,2190,835,816,144500,14414
84,72,12,-,105400,14415
1384,1083,301,774,118800,14416
535,480,55,1169,141200,14418
7022,4379,2643,828,143700,14420
912,776,136,894,118600,14422
1858,1442,416,754,126000,14423
11856,8311,3545,919,188700,14424
4943,3371,1572,1083,156600,14425
826,661,165,629,87200,14427
3048,2541,507,1018,163200,14428
2311,1831,480,642,105700,14432
1539,1211,328,796,83000,14433
1209,1078,131,827,139400,14435
4116,3125,991,715,90800,14437
119,93,26,692,94200,14441
3397,1939,1458,919,103500,14445
17112,13422,3690,991,196600,14450
3312,1557,1755,937,178600,14454
7431,4497,2934,793,114700,14456
178,155,23,638,132300,14462
2799,2414,385,747,114600,14464
654,585,69,536,134600,14466
3925,2547,1378,965,141500,14467
6756,5545,1211,979,145600,14468
2484,2122,362,859,155000,14469
3208,2585,623,686,103500,14470
1019,773,246,928,188400,14471
3304,2536,768,884,237800,14472
129,124,5,-,324600,14475
940,756,184,761,115500,14476
549,473,76,695,127900,14477
255,242,13,-,189900,14478
78,78,0,-,77000,14479
366,225,141,844,124500,14480
780,599,181,834,112100,14481
3337,2373,964,761,116000,14482
1593,1225,368,700,152000,14485
157,147,10,-,118800,14486
2418,2040,378,886,160300,14487
2653,1981,672,807,84200,14489
4141,3344,797,766,165000,14502
778,593,185,901,94400,14504
2042,1695,347,827,119100,14505
476,476,0,-,244200,14506
469,387,82,759,137500,14507
1889,1265,624,747,89300,14510
207,134,73,-,113100,14511
1910,1628,282,649,147000,14512
5802,3774,2028,733,98000,14513
2680,1881,799,1129,160400,14514
930,772,158,922,99600,14516
1265,921,344,620,91100,14517
5051,3950,1101,822,161800,14519
963,676,287,717,96700,14521
4054,2862,1192,740,127000,14522
1010,844,166,767,117600,14525
8215,6896,1319,891,196700,14526
4787,3530,1257,767,141500,14527
38,38,0,-,-,14529
2179,1503,676,713,88200,14530
1632,1173,459,756,132100,14532
790,632,158,774,116500,14533
11765,10640,1125,1605,257800,14534
261,187,74,658,81200,14536
51,39,12,-,79300,14537
60,60,0,-,87100,14539
926,700,226,926,123700,14541
35,25,10,-,-,14542
1259,1119,140,1064,185200,14543
750,612,138,635,131800,14544
63,63,0,-,89600,14545
1893,1363,530,1080,137000,14546
1532,1298,234,902,110500,14548
46,34,12,513,202800,14549
655,491,164,620,79700,14550
2050,1636,414,748,89200,14551
558,463,95,903,114300,14555
6967,5634,1333,1112,163600,14559
812,749,63,797,132200,14560
1108,943,165,865,141200,14561
6014,4956,1058,1293,268400,14564
2158,2019,139,750,145400,14568
2643,1621,1022,566,114000,14569
558,487,71,1342,120300,14571
2139,1699,440,640,96700,14572
21334,16329,5005,1046,190600,14580
62,57,5,-,37500,14585
4322,3010,1312,1185,176500,14586
63,52,11,-,100900,14588
2869,2144,725,704,136300,14589
2151,1626,525,586,90500,14590
626,531,95,629,110600,14591
102,60,42,-,151600,14592
1598,0,1598,740,-,14604
4346,1000,3346,696,53400,14605
11590,6670,4920,859,107000,14606
9647,1646,8001,824,188700,14607
5071,1027,4044,787,91700,14608
17380,10424,6956,877,96600,14609
7014,4037,2977,899,160100,14610
6370,1931,4439,838,54900,14611
15151,10652,4499,882,138500,14612
4874,1820,3054,828,70400,14613
69,0,69,1542,-,14614
7049,3509,3540,875,90500,14615
11961,8291,3670,929,103500,14616
9548,8100,1448,879,130800,14617
8222,6356,1866,1139,197900,14618
5490,2736,2754,970,76800,14619
11302,3630,7672,913,144400,14620
12480,4322,8158,794,58000,14621
5623,4376,1247,914,111900,14622
8533,4707,3826,984,122900,14623
14105,11337,2768,1031,132800,14624
4361,3936,425,945,179600,14625
12638,8538,4100,1040,140900,14626
0,0,0,-,-,14627
16830,10125,6705,612,73500,14701
2618,1990,628,650,98600,14706
81,72,9,-,67700,14707
65,65,0,-,51400,14708
571,477,94,595,85600,14709
1293,1136,157,882,89400,14710
695,526,169,646,74100,14711
1321,1021,300,692,147900,14712
210,178,32,981,95400,14714
1130,800,330,698,59600,14715
862,562,300,573,75700,14716
269,232,37,644,120000,14717
761,600,161,709,106300,14718
1375,1109,266,571,84100,14719
323,157,166,653,41000,14720
56,46,10,-,-,14721
50,50,0,-,1009600,14722
411,348,63,771,82900,14723
826,697,129,585,111700,14724
581,451,130,617,79000,14726
2224,1857,367,643,80500,14727
478,420,58,-,103600,14728
408,316,92,684,91300,14729
524,450,74,685,228300,14731
52,52,0,-,73100,14732
1570,1078,492,605,79300,14733
1136,869,267,583,77200,14735
103,77,26,1021,96300,14736
1771,1476,295,617,76400,14737
1464,1259,205,849,89600,14738
1193,969,224,639,56100,14739
449,375,74,1163,95500,14740
727,650,77,763,118800,14741
78,69,9,-,95800,14742
776,678,98,766,69400,14743
459,320,139,647,108500,14744
855,733,122,503,86800,14747
256,169,87,574,96800,14748
2086,1484,602,690,128200,14750
153,115,38,-,99400,14752
483,393,90,767,63200,14753
264,206,58,572,77100,14754
1198,936,262,565,89400,14755
45,45,0,-,94600,14756
1284,1040,244,535,112400,14757
8073,4616,3457,628,78600,14760
686,531,155,609,94300,14767
387,336,51,708,99400,14769
1162,822,340,546,86500,14770
1531,1067,464,600,82400,14772
26,24,2,-,81800,14774
1029,869,160,558,81300,14775
301,238,63,768,71600,14777
0,0,0,-,-,14778
2713,1537,1176,647,73000,14779
791,628,163,705,90200,14781
902,678,224,712,79700,14782
125,104,21,738,76000,14783
364,309,55,765,87900,14784
2066,1490,576,671,84400,14787
32,32,0,-,-,14788
2021,1598,423,610,86400,14801
351,125,226,731,110900,14802
411,269,142,746,106100,14803
568,465,103,704,83700,14804
445,353,92,856,150600,14805
848,636,212,646,73800,14806
1193,927,266,746,89900,14807
221,192,29,756,68900,14808
907,666,241,724,87100,14809
5144,3232,1912,613,92000,14810
1214,1007,207,786,93000,14812
991,701,290,598,71600,14813
714,517,197,1056,167000,14814
365,338,27,642,120800,14815
202,193,9,-,95800,14816
912,625,287,894,157000,14817
921,793,128,842,155200,14818
276,222,54,941,84500,14819
316,274,42,475,91700,14820
1354,1193,161,704,98600,14821
434,375,59,700,71700,14822
1487,1137,350,566,80500,14823
221,182,39,856,88600,14824
321,271,50,857,105400,14825
790,674,116,713,85800,14826
96,96,0,-,87200,14827
8635,5530,3105,820,116100,14830
318,308,10,775,89500,14836
2149,1748,401,644,106400,14837
755,712,43,906,97800,14838
298,244,54,542,78400,14839
1341,1080,261,738,155300,14840
291,291,0,-,214200,14841
300,288,12,-,136800,14842
5298,3250,2048,642,82000,14843
8614,6359,2255,997,145600,14845
317,278,39,667,81800,14846
1051,789,262,618,114900,14847
24788,10793,13995,1159,239700,14850
0,0,0,-,-,14853
13,13,0,-,-,14854
311,266,45,513,98300,14855
112,83,29,-,-,14856
527,461,66,786,101400,14858
301,265,36,607,86200,14859
556,438,118,720,127300,14860
600,513,87,892,99000,14861
494,444,50,919,113300,14864
1203,788,415,686,109200,14865
2361,1788,573,843,147800,14867
532,374,158,648,118700,14869
4077,2845,1232,912,138200,14870
1984,1683,301,835,154000,14871
249,230,19,575,127000,14872
1000,894,106,596,100000,14873
107,100,7,-,83300,14874
187,148,39,673,119700,14877
244,231,13,850,139100,14878
873,741,132,719,96700,14879
651,540,111,706,69000,14880
136,70,66,-,220000,14881
1705,1293,412,1350,195900,14882
1895,1298,597,812,148300,14883
113,92,21,693,80000,14884
253,224,29,846,121000,14885
2982,2428,554,1066,193300,14886
601,508,93,817,101800,14889
1702,1239,463,673,126600,14891
3115,2101,1014,747,102900,14892
0,0,0,-,-,14893
470,427,43,850,90500,14894
4319,2880,1439,619,69500,14895
325,295,30,805,66000,14897
643,534,109,627,84000,14898
5216,2450,2766,707,77200,14901
3255,2129,1126,786,115200,14903
6392,3773,2619,769,72200,14904
3853,2600,1253,816,119300,14905
13477,10074,3403,701,131800,15001
5110,3299,1811,694,87900,15003
111,75,36,-,112500,15004
3995,3378,617,613,156400,15005
187,176,11,-,69800,15006
188,179,9,-,136600,15007
6552,4911,1641,646,183000,15009
11186,7621,3565,703,136300,15010
6584,5150,1434,777,144400,15012
1315,829,486,759,73700,15014
476,451,25,289,334700,15015
7347,5124,2223,867,171100,15017
349,292,57,726,85700,15018
717,526,191,706,121500,15019
102,48,54,-,75000,15020
3004,2385,619,761,138500,15021
4425,3317,1108,680,91900,15022
3668,2988,680,848,140400,15024
6790,4698,2092,904,140200,15025
1280,1079,201,887,183200,15026
1010,804,206,519,125400,15027
61,49,12,580,57100,15028
523,275,248,788,60900,15030
189,81,108,1000,80600,15031
1965,1124,841,622,58500,15033
909,568,341,506,63700,15034
987,612,375,738,73200,15035
4514,3881,633,750,118000,15037
131,105,26,-,101100,15038
3774,3164,610,965,157800,15042
769,705,64,682,159700,15043
10390,9537,853,1490,262600,15044
2097,1349,748,634,61600,15045
1019,841,178,804,139500,15046
53,53,0,-,-,15047
507,387,120,687,108100,15049
982,913,69,970,175600,15050
221,144,77,1058,83000,15051
1315,1144,171,761,135800,15052
51,40,11,-,87300,15053
141,94,47,848,76500,15054
677,538,139,636,179200,15055
543,334,209,804,77400,15056
5949,5176,773,794,214500,15057
1721,907,814,541,68700,15059
287,235,52,696,110500,15060
5364,3802,1562,637,132800,15061
3474,2538,936,611,77000,15062
4808,3665,1143,707,123300,15063
137,103,34,950,144500,15064
4925,3630,1295,669,107300,15065
5413,3471,1942,671,98800,15066
999,688,311,693,75500,15067
16325,11238,5087,706,130000,15068
4532,3182,1350,1073,174200,15071
9,9,0,-,-,15072
3611,2338,1273,697,88200,15074
68,45,23,-,176600,15075
454,295,159,760,84300,15076
62,41,21,719,97000,15077
160,110,50,-,90000,15078
181,124,57,587,90000,15081
99,48,51,-,119400,15082
339,281,58,708,90400,15083
4613,2857,1756,658,87200,15084
3256,2603,653,690,155200,15085
144,92,52,-,200000,15086
52,52,0,-,104300,15087
162,106,56,729,62000,15088
2926,2267,659,628,122300,15089
9004,7159,1845,1336,318300,15090
9996,7927,2069,1024,219100,15101
12326,10062,2264,957,180000,15102
3745,1623,2122,602,37700,15104
9235,5968,3267,798,125300,15106
16717,12094,4623,945,188800,15108
2254,890,1364,583,39600,15110
1428,617,811,633,61800,15112
6162,5414,748,884,179500,15116
8486,5000,3486,714,90000,15120
8585,6690,1895,618,97800,15122
3256,2434,822,838,179000,15126
4444,3366,1078,974,161000,15129
3691,2698,993,833,108500,15131
9911,5075,4836,644,48000,15132
2987,2369,618,750,74100,15133
2213,1528,685,745,126300,15135
9602,6012,3590,734,137500,15136
4644,3128,1516,754,79200,15137
3192,1907,1285,853,191200,15139
1528,698,830,682,63700,15140
596,451,145,1167,633200,15142
8436,6695,1741,1194,319100,15143
1886,1290,596,708,100100,15144
3267,1473,1794,618,61100,15145
12495,8401,4094,997,145900,15146
8212,5639,2573,741,95400,15147
1230,461,769,668,50900,15148
6194,3442,2752,1036,156000,15201
10039,5233,4806,754,133300,15202
5342,2113,3229,1163,200600,15203
3630,2256,1374,920,74600,15204
10330,6162,4168,853,121900,15205
14558,5875,8683,961,167300,15206
4887,3024,1863,748,93700,15207
4429,2203,2226,759,164000,15208
5674,4051,1623,816,148100,15209
11072,6541,4531,793,64000,15210
5524,2727,2797,950,119100,15211
13092,6827,6265,821,102000,15212
9993,2560,7433,952,163700,15213
6006,3674,2332,791,108000,15214
5403,3845,1558,832,216500,15215
10521,6438,4083,870,126500,15216
11719,5972,5747,1079,287800,15217
6792,3846,2946,823,142400,15218
5355,1416,3939,664,92900,15219
8065,4789,3276,973,162800,15220
16084,7589,8495,814,101800,15221
2526,453,2073,1642,358000,15222
3118,2076,1042,737,104400,15223
5593,2069,3524,870,150200,15224
600,298,302,768,86800,15225
6320,4505,1815,847,106200,15226
11739,8238,3501,715,119500,15227
7273,5284,1989,939,266000,15228
6023,4325,1698,892,146300,15229
6174,1686,4488,1123,361400,15232
1414,610,804,760,166700,15233
6267,4408,1859,835,130100,15234
15048,11495,3553,908,97200,15235
12440,9638,2802,864,151300,15236
18165,13877,4288,996,212700,15237
5302,4108,1194,983,328100,15238
8618,7088,1530,977,146000,15239
7646,6608,1038,1289,288200,15241
5589,4896,693,1090,200400,15243
0,0,0,-,-,15260
0,0,0,-,-,15290
20311,13800,6511,755,159000,15301
111,91,20,-,151800,15310
650,547,103,738,206000,15311
1460,1256,204,704,159700,15312
150,127,23,910,95400,15313
1623,1141,482,492,127200,15314
246,206,40,792,54200,15315
40,24,16,1125,44400,15316
15399,12429,2970,929,258200,15317
2360,1701,659,431,121000,15320
591,499,92,745,231600,15321
829,704,125,630,74100,15322
1781,1364,417,739,152200,15323
270,173,97,821,68900,15324
196,125,71,-,41700,15325
652,521,131,837,86300,15327
529,376,153,775,179500,15329
1940,1744,196,889,239900,15330
266,178,88,915,53900,15331
3633,3067,566,664,144100,15332
843,570,273,667,107900,15333
52,47,5,-,104800,15334
223,163,60,613,100900,15337
657,526,131,627,90700,15338
478,385,93,823,194900,15340
325,245,80,759,158400,15341
2163,1673,490,788,167800,15342
589,490,99,708,116100,15344
536,390,146,645,78800,15345
199,194,5,-,68200,15346
234,158,76,-,156000,15347
117,79,38,1024,115200,15348
680,493,187,836,152900,15349
153,109,44,864,53900,15350
340,188,152,687,26600,15351
384,318,66,613,117200,15352
46,36,10,-,171900,15353
553,467,86,482,119700,15357
317,216,101,-,81400,15358
73,53,20,750,99200,15359
702,598,104,733,170300,15360
71,41,30,-,89300,15361
316,260,56,685,122700,15362
211,124,87,1229,128500,15363
294,247,47,792,141000,15364
82,71,11,-,-,15366
3012,2764,248,1218,376900,15367
172,116,56,588,45700,15368
4929,3411,1518,668,145600,15370
648,507,141,713,159600,15376
214,168,46,850,150000,15377
57,20,37,-,-,15378
48,40,8,-,110000,15379
242,148,94,639,85300,15380
13359,9022,4337,670,110300,15401
525,443,82,656,55100,15410
279,229,50,840,141600,15411
210,181,29,725,84600,15412
251,195,56,-,49900,15413
3453,2418,1035,634,90400,15417
1505,736,769,568,109600,15419
86,65,21,-,-,15420
19,19,0,-,-,15421
88,47,41,-,-,15422
829,701,128,736,154300,15423
919,674,245,616,100000,15424
8164,5774,2390,570,100600,15425
474,362,112,814,86900,15427
771,671,100,837,95000,15428
135,91,44,615,92500,15429
139,125,14,-,66700,15430
1770,1459,311,627,83000,15431
212,148,64,663,77300,15432
262,213,49,-,169900,15433
99,83,16,533,72000,15434
215,175,40,857,88300,15435
1172,808,364,670,92200,15436
917,649,268,628,156100,15437
828,737,91,647,102900,15438
101,95,6,-,126600,15440
800,632,168,706,78700,15442
15,15,0,-,-,15443
169,154,15,-,-,15444
1154,943,211,727,106300,15445
153,133,20,-,102000,15446
21,21,0,-,-,15447
106,88,18,-,110700,15448
155,155,0,-,34700,15449
64,46,18,-,-,15450
465,410,55,-,94400,15451
72,58,14,-,47600,15454
165,127,38,-,-,15455
1149,928,221,694,88400,15456
969,807,162,-,82200,15458
622,465,157,645,113800,15459
39,34,5,-,76700,15460
1897,1239,658,685,83200,15461
190,190,0,-,22500,15462
17,17,0,-,-,15463
604,523,81,567,100400,15464
185,162,23,1018,67000,15466
58,49,9,-,38800,15467
924,677,247,755,90500,15468
887,697,190,678,93300,15469
309,261,48,633,176000,15470
65,14,51,-,-,15472
1681,1303,378,671,130000,15473
732,489,243,869,73400,15474
505,358,147,666,65800,15475
42,42,0,-,13500,15476
389,307,82,657,84200,15477
2431,1933,498,696,121900,15478
783,686,97,766,117900,15479
767,644,123,596,103500,15480
164,149,15,715,70800,15482
197,147,50,640,83600,15483
45,41,4,-,-,15484
943,843,100,555,123300,15486
189,167,22,-,70800,15489
251,181,70,-,99000,15490
52,52,0,-,70500,15492
6380,4541,1839,588,121000,15501
69,60,9,-,187500,15502
0,0,0,-,-,15510
112,100,12,-,75000,15520
663,566,97,769,125000,15521
4864,3767,1097,702,154800,15522
2096,1703,393,547,112100,15530
1569,1228,341,488,92600,15531
48,34,14,-,86300,15532
599,454,145,695,113900,15533
416,340,76,680,157400,15534
868,758,110,693,156800,15535
171,149,22,1047,142200,15536
3228,2381,847,658,120900,15537
294,261,33,544,119900,15538
218,186,32,-,127800,15539
110,92,18,-,112500,15540
1409,1286,123,636,122500,15541
453,362,91,681,81100,15542
52,52,0,-,61800,15544
1040,888,152,652,103000,15545
87,87,0,-,48300,15546
192,147,45,843,99300,15547
726,601,125,625,115600,15550
322,259,63,613,103200,15551
2293,1685,608,558,98000,15552
961,766,195,599,97100,15554
47,43,4,-,-,15555
1457,1136,321,598,112600,15557
825,624,201,568,114900,15558
805,688,117,639,147200,15559
69,55,14,767,94100,15560
90,69,21,658,127600,15561
58,50,8,-,142600,15562
1247,1071,176,703,102700,15563
23,19,4,475,112500,15564
24791,17894,6897,711,166000,15601
1564,1470,94,583,146700,15610
330,255,75,1551,-,15611
164,150,14,-,-,15612
5920,4899,1021,695,144400,15613
127,119,8,-,162700,15615
0,0,0,-,-,15616
153,130,23,750,83800,15617
1032,802,230,621,83900,15618
325,242,83,766,74400,15620
45,11,34,-,-,15621
587,459,128,319,147200,15622
263,221,42,809,152400,15623
99,70,29,-,93200,15624
14,14,0,-,-,15625
2526,2054,472,740,156700,15626
2802,2237,565,626,107400,15627
265,205,60,605,83600,15628
335,187,148,655,52400,15629
489,319,170,691,85200,15631
4003,2997,1006,745,211900,15632
252,119,133,842,108400,15633
138,86,52,661,53900,15634
65,65,0,-,-,15635
1423,1313,110,768,249200,15636
635,509,126,946,109700,15637
96,81,15,-,-,15638
875,643,232,563,171100,15639
220,214,6,-,99500,15640
236,207,29,532,85400,15641
18185,15232,2953,779,171200,15642
8390,6210,2180,746,115900,15644
59,39,20,-,96400,15646
100,84,16,-,-,15647
11134,8378,2756,711,147600,15650
153,119,34,716,116900,15655
4212,3405,807,626,126100,15656
4044,3270,774,695,172500,15658
171,171,0,-,123000,15660
223,135,88,914,85500,15661
76,76,0,-,-,15662
213,178,35,671,89200,15663
543,418,125,1008,130800,15665
6775,5231,1544,666,120900,15666
5214,4798,416,1214,237800,15668
1477,1224,253,626,152800,15670
283,283,0,-,121400,15671
1436,1027,409,805,185400,15672
580,461,119,580,99000,15673
334,266,68,1111,72900,15675
304,191,113,-,159600,15676
159,143,16,-,115300,15677
283,187,96,823,98500,15678
1229,1052,177,651,129500,15679
69,64,5,-,90000,15680
1865,1508,357,765,121600,15681
3553,2711,842,536,114800,15683
287,255,32,431,99800,15684
350,320,30,725,157000,15686
496,460,36,628,159800,15687
462,423,39,-,85800,15688
143,111,32,-,86400,15689
3772,2650,1122,622,77300,15690
41,41,0,-,-,15691
548,450,98,578,134500,15692
76,60,16,-,-,15693
192,168,24,-,75600,15695
188,156,32,700,79300,15696
1412,932,480,600,105900,15697
249,231,18,-,114300,15698
13226,7526,5700,738,149300,15701
83,66,17,-,109700,15710
182,164,18,775,80000,15711
74,50,24,697,72500,15712
156,156,0,-,-,15713
1982,1552,430,620,71500,15714
192,154,38,583,95000,15715
272,121,151,635,93600,15716
4167,3031,1136,686,125200,15717
93,74,19,755,49300,15721
954,814,140,613,86700,15722
13,13,0,-,-,15723
901,758,143,695,84700,15724
647,561,86,654,118700,15725
87,61,26,1068,64100,15727
1340,951,389,512,84800,15728
589,505,84,-,77600,15729
31,28,3,-,73300,15730
231,178,53,-,69800,15731
598,545,53,708,110500,15732
75,71,4,-,67300,15733
166,135,31,-,65700,15734
358,224,134,793,110300,15736
30,30,0,-,28600,15737
106,83,23,800,65500,15738
200,151,49,853,67400,15739
24,21,3,-,71700,15741
338,295,43,635,76500,15742
64,57,7,-,65000,15744
83,73,10,-,38500,15745
67,39,28,581,66500,15746
841,637,204,638,136600,15747
2820,2206,614,641,101700,15748
116,57,59,793,-,15750
17,0,17,-,-,15752
193,179,14,681,73800,15753
245,229,16,-,71900,15754
121,87,34,625,63100,15756
615,516,99,550,78100,15757
1103,896,207,755,119800,15759
56,39,17,-,56300,15760
66,29,37,796,125800,15761
354,323,31,635,145700,15762
87,84,3,-,151600,15764
693,584,109,668,147800,15765
5889,4275,1614,610,101600,15767
80,78,2,-,155200,15770
394,333,61,369,110600,15771
581,496,85,696,78600,15772
188,179,9,-,66600,15773
1025,903,122,611,143800,15774
359,286,73,-,79600,15775
25,22,3,-,103600,15776
58,58,0,-,57200,15777
60,51,9,888,55000,15778
181,144,37,542,85700,15779
71,68,3,-,68700,15780
42,42,0,-,91700,15781
57,34,23,-,70000,15783
30,29,1,-,81300,15784
7759,5670,2089,629,121300,15801
59,55,4,-,97900,15821
563,454,109,565,97300,15823
2240,1652,588,651,106700,15824
3676,2771,905,626,113500,15825
116,92,24,-,42900,15827
122,114,8,-,93500,15828
506,401,105,623,99100,15829
119,106,13,-,64000,15832
2025,1441,584,602,75500,15834
850,650,200,759,88800,15840
148,124,24,-,112500,15841
1376,1058,318,516,62800,15845
1523,1381,142,590,104400,15846
152,128,24,492,68200,15847
383,312,71,641,100700,15848
490,433,57,824,80500,15849
2768,2090,678,610,89000,15851
2852,2055,797,577,94300,15853
367,341,26,769,127700,15856
5739,4289,1450,601,117600,15857
484,430,54,617,113200,15860
68,60,8,700,78900,15861
118,100,18,822,52100,15863
656,551,105,630,92100,15864
614,392,222,679,75800,15865
101,86,15,875,83000,15866
585,469,116,611,106400,15868
541,478,63,488,83800,15870
2059,571,1488,452,26600,15901
5212,3259,1953,605,49400,15902
6394,4383,2011,776,133500,15904
8948,6756,2192,677,99600,15905
4919,3196,1723,515,48300,15906
2219,1909,310,558,84700,15909
339,301,38,823,109000,15920
48,44,4,-,57600,15921
74,61,13,-,153800,15922
619,522,97,493,82800,15923
430,397,33,800,74800,15924
74,52,22,1014,64300,15925
1131,990,141,580,79000,15926
519,470,49,-,70800,15927
782,596,186,875,159300,15928
32,14,18,-,83300,15929
54,54,0,-,-,15930
3630,2650,980,664,159300,15931
61,61,0,-,-,15934
1353,1143,210,650,101300,15935
637,545,92,650,79500,15936
284,229,55,590,82300,15937
967,822,145,604,90900,15938
656,522,134,678,167700,15940
933,905,28,575,128300,15942
1560,1280,280,574,71200,15943
1296,1088,208,491,109300,15944
46,46,0,-,67500,15945
2851,2343,508,467,93200,15946
209,158,51,639,88400,15948
221,205,16,583,72200,15949
211,200,11,-,-,15951
657,447,210,602,130500,15952
43,29,14,-,-,15953
940,718,222,576,95800,15954
923,870,53,-,102500,15955
1111,897,214,596,70700,15956
248,224,24,-,130600,15957
841,719,122,634,123900,15958
205,175,30,-,56000,15960
325,267,58,567,71600,15961
59,44,15,925,80000,15962
4706,3469,1237,619,101200,15963
17657,11614,6043,732,154400,16001
6052,5183,869,742,185900,16002
458,383,75,765,141100,16020
142,105,37,640,92300,16022
1989,1317,672,899,169500,16023
108,86,22,1063,128800,16024
2106,1813,293,662,157600,16025
97,75,22,1125,162500,16027
814,597,217,500,100200,16028
323,253,70,779,114700,16029
131,85,46,585,99200,16030
2621,1970,651,789,196600,16033
681,589,92,795,164500,16034
40,26,14,-,-,16035
86,72,14,825,87100,16036
1864,1557,307,1101,243500,16037
1375,1149,226,704,141700,16038
391,318,73,538,120000,16040
861,698,163,609,100300,16041
450,236,214,857,96000,16045
6135,4893,1242,1363,348900,16046
57,50,7,-,87100,16048
1256,993,263,647,109800,16049
612,512,100,700,99700,16050
1213,1027,186,622,140900,16051
1026,892,134,873,169200,16052
1860,1695,165,814,221300,16053
166,146,20,725,90000,16054
3311,2924,387,923,202700,16055
2132,1595,537,641,194900,16056
4777,2750,2027,706,165000,16057
3315,2785,530,1642,272300,16059
1032,925,107,671,161400,16061
3088,1960,1128,889,209600,16063
11834,9417,2417,1243,292700,16066
14214,9813,4401,622,86000,16101
2437,1765,672,728,94700,16102
6553,5070,1483,845,132600,16105
138,132,6,-,109300,16110
493,421,72,605,112500,16111
645,562,83,671,95500,16112
193,166,27,807,167100,16113
250,214,36,763,109500,16114
1226,1032,194,675,136000,16115
1117,960,157,592,93700,16116
7244,5395,1849,741,107500,16117
903,736,167,609,119300,16120
2070,1165,905,657,60900,16121
786,714,72,547,198900,16123
805,703,102,564,123800,16124
6892,5120,1772,634,112700,16125
5337,3988,1349,699,145000,16127
891,746,145,565,111100,16130
346,272,74,648,124300,16131
116,83,33,-,109000,16132
599,530,69,731,130400,16133
1597,1366,231,646,103500,16134
349,238,111,580,75000,16136
4493,3611,882,648,139300,16137
14,7,7,-,-,16140
706,605,101,648,84300,16141
2190,1668,522,690,174600,16142
1182,1047,135,478,130300,16143
1172,956,216,631,139600,16145
6029,3145,2884,588,63800,16146
7455,5361,2094,803,145000,16148
3020,2220,800,740,108800,16150
52,39,13,688,83000,16151
1052,841,211,679,124500,16153
1092,982,110,693,136800,16154
45,9,36,796,-,16155
1171,1006,165,709,155000,16156
1343,1129,214,564,100600,16157
1959,1566,393,701,127200,16159
395,300,95,638,73600,16160
374,257,117,653,54600,16161
7448,5328,2120,643,123900,16201
345,290,55,754,117500,16210
56,53,3,-,78300,16211
162,138,24,800,70500,16212
46,26,20,563,65000,16213
4271,1924,2347,628,137700,16214
42,36,6,-,118800,16217
380,363,17,370,133500,16218
946,801,145,611,90600,16222
90,79,11,-,83800,16223
463,367,96,702,99600,16224
3381,2450,931,676,94300,16226
209,173,36,725,80800,16228
2230,1669,561,705,154800,16229
162,116,46,653,78100,16230
1635,1289,346,589,107200,16232
474,403,71,825,152500,16233
498,424,74,625,126300,16235
76,76,0,-,92300,16236
177,127,50,652,86500,16238
507,412,95,697,86400,16239
599,430,169,537,119400,16240
1880,1342,538,549,95900,16242
106,98,8,-,73100,16244
97,53,44,639,61700,16245
106,78,28,725,67500,16246
1246,882,364,610,88400,16248
834,691,143,585,115200,16249
203,191,12,-,84600,16250
33,29,4,-,38100,16253
1278,1070,208,697,117300,16254
626,513,113,701,101300,16255
544,477,67,539,95400,16256
893,561,332,723,166600,16258
780,647,133,562,88900,16259
142,112,30,-,187500,16260
1106,908,198,766,118900,16262
119,107,12,-,55900,16263
6598,4766,1832,594,67300,16301
199,172,27,633,138100,16311
3,3,0,-,-,16312
719,610,109,695,70400,16313
2155,1797,358,659,115600,16314
2448,1892,556,680,149600,16316
524,477,47,740,87500,16317
562,537,25,650,128300,16319
39,28,11,-,61700,16321
39,37,2,-,55000,16322
6765,4762,2003,615,85600,16323
154,142,12,520,117100,16326
1196,1043,153,711,114400,16327
58,25,33,784,73000,16328
206,180,26,-,80700,16329
25,25,0,-,96300,16331
12,2,10,-,-,16332
142,131,11,-,50900,16333
131,119,12,950,124600,16334
11476,7019,4457,683,113300,16335
747,670,77,606,90000,16340
754,658,96,620,84700,16341
777,654,123,656,91800,16342
255,188,67,-,87100,16343
187,127,60,625,48100,16344
1486,1322,164,652,151700,16345
1416,962,454,647,106600,16346
942,767,175,453,85200,16347
964,753,211,576,105200,16350
694,539,155,489,86600,16351
106,96,10,783,70000,16352
1131,999,132,532,98200,16353
4537,3057,1480,575,84800,16354
564,471,93,584,118800,16360
13,13,0,-,-,16361
425,376,49,478,105300,16362
480,407,73,808,129900,16364
8006,5572,2434,602,95800,16365
88,78,10,363,78600,16370
1342,962,380,569,84600,16371
205,148,57,483,61500,16372
1359,1121,238,748,108000,16373
761,661,100,718,107700,16374
1747,1310,437,582,107900,16401
343,326,17,757,105200,16402
2371,1806,565,616,113200,16403
1290,1029,261,658,102900,16404
293,234,59,819,88200,16405
1257,1017,240,653,112700,16406
4472,2925,1547,683,98000,16407
612,559,53,675,116900,16410
614,483,131,876,133400,16411
4204,2878,1326,797,176600,16412
3297,2932,365,791,208200,16415
67,56,11,-,33200,16416
3067,2219,848,671,133600,16417
256,234,22,589,76500,16420
998,806,192,453,147100,16421
172,151,21,-,93200,16422
1786,1393,393,674,113100,16423
2046,1724,322,718,98800,16424
1501,1256,245,850,159100,16426
57,44,13,940,68300,16427
4986,3611,1375,723,154900,16428
2020,1683,337,599,123200,16433
933,767,166,667,113500,16434
698,565,133,721,109400,16435
232,191,41,-,128900,16436
3165,2496,669,654,103700,16438
387,330,57,775,140800,16440
3954,3333,621,657,169000,16441
1077,921,156,593,144500,16442
521,444,77,735,98700,16443
0,0,0,-,-,16444
1338,33,1305,374,-,16501
6869,2667,4202,706,73600,16502
5813,1979,3834,704,44400,16503
6299,4333,1966,826,87800,16504
7599,5623,1976,750,149000,16505
10016,6986,3030,891,170200,16506
3589,1068,2521,721,55600,16507
6867,4578,2289,720,96600,16508
12103,8227,3876,831,157600,16509
10016,7544,2472,744,121000,16510
4943,3002,1941,668,129400,16511
0,0,0,-,-,16546
0,0,0,-,-,16563
13455,9301,4154,649,104600,16601
12455,8035,4420,732,95500,16602
1028,875,153,629,134400,16611
563,501,62,650,126000,16613
57,44,13,-,74400,16616
1179,909,270,657,116400,16617
130,108,22,531,66700,16619
134,119,15,-,87500,16620
276,213,63,666,148300,16621
70,70,0,-,125000,16622
220,167,53,496,159900,16623
70,49,21,663,112500,16624
1551,1018,533,736,112800,16625
835,688,147,541,68600,16627
1903,1347,556,633,111300,16630
30,26,4,-,150000,16631
99,75,24,779,87500,16633
158,133,25,-,91500,16634
5242,4088,1154,825,154900,16635
301,288,13,775,174000,16636
959,669,290,785,125200,16637
13,11,2,-,106300,16638
618,554,64,720,92400,16639
322,297,25,800,106700,16640
1038,835,203,675,88900,16641
70,65,5,713,84200,16645
969,812,157,583,81000,16646
330,275,55,589,169000,16647
6204,4527,1677,729,186200,16648
753,614,139,643,117900,16650
1315,1022,293,567,83800,16651
5659,3920,1739,596,132500,16652
583,516,67,682,128100,16655
474,414,60,717,74400,16656
511,431,80,704,168200,16657
116,61,55,639,93800,16659
339,289,50,652,70600,16661
2204,1574,630,762,155800,16662
725,638,87,645,138400,16664
117,80,37,725,152500,16665
1256,1104,152,680,84900,16666
554,393,161,694,114100,16667
1448,1176,272,436,87000,16668
845,658,187,669,142500,16669
30,24,6,-,110000,16670
199,159,40,675,87300,16671
68,47,21,758,62800,16672
2201,1672,529,811,127100,16673
255,214,41,804,73300,16674
118,118,0,-,89200,16677
1078,848,230,675,97500,16678
335,281,54,514,69900,16679
177,150,27,861,101400,16680
19,14,5,-,-,16682
145,118,27,500,158300,16683
60,60,0,-,178600,16685
5408,3826,1582,649,122000,16686
192,184,8,638,157000,16689
145,129,16,840,153200,16691
277,225,52,625,70300,16692
1498,1175,323,634,117700,16693
61,61,0,-,68100,16694
426,347,79,648,150300,16695
0,0,0,-,-,16699
7334,4918,2416,633,79700,16701
498,428,70,654,76800,16720
58,48,10,725,-,16724
108,90,18,-,-,16725
266,226,40,588,83300,16726
52,40,12,-,-,16727
24,24,0,-,75000,16728
362,287,75,633,87900,16729
47,40,7,-,78000,16730
1022,842,180,608,82400,16731
150,133,17,-,74400,16732
89,76,13,625,65000,16733
118,98,20,-,61700,16734
2556,1883,673,626,70400,16735
570,490,80,675,88400,16738
455,336,119,634,55500,16740
1634,1191,443,704,89900,16743
119,119,0,-,62300,16744
220,208,12,675,87500,16745
497,402,95,794,78100,16746
1027,814,213,565,85900,16748
1646,1323,323,689,89000,16749
202,161,41,563,60300,16750
17841,7236,10605,1003,271900,16801
16,0,16,-,-,16802
10400,4777,5623,1079,287100,16803
373,323,50,786,155900,16820
124,124,0,-,-,16821
808,623,185,596,122700,16822
10982,8353,2629,847,180600,16823
83,83,0,-,-,16825
188,183,5,-,165400,16826
1831,1567,264,1069,289000,16827
1803,1517,286,950,222800,16828
269,245,24,631,126800,16829
5834,3933,1901,621,92200,16830
175,145,30,850,175800,16832
2214,1666,548,661,105300,16833
76,76,0,-,155800,16834
73,59,14,825,152500,16835
433,389,44,850,93900,16836
50,50,0,-,-,16837
735,642,93,753,89800,16838
245,227,18,-,69600,16839
209,178,31,-,91900,16840
2270,1915,355,762,159700,16841
396,337,59,1098,46100,16843
1063,927,136,811,163700,16844
297,260,37,569,87600,16845
165,140,25,-,86400,16847
168,115,53,682,126900,16848
179,168,11,-,157800,16849
354,309,45,-,207500,16851
131,103,28,617,151400,16852
93,25,68,680,-,16853
277,210,67,746,147100,16854
126,126,0,-,-,16855
1393,1223,170,1022,105500,16858
241,202,39,736,115700,16859
144,81,63,-,115100,16860
106,103,3,-,82300,16861
275,192,83,835,108300,16863
669,626,43,1208,195500,16865
3572,2410,1162,609,112100,16866
201,201,0,-,199600,16868
2653,2305,348,746,304200,16870
23,21,2,-,55800,16871
463,346,117,741,152200,16872
519,459,60,667,128400,16874
1482,1174,308,841,252900,16875
127,98,29,779,78800,16876
799,686,113,1177,200000,16877
774,696,78,617,93300,16878
170,129,41,966,72700,16879
986,877,109,-,83900,16881
155,116,39,668,141300,16882
4055,3151,904,769,153600,16901
143,125,18,1047,106700,16911
788,546,242,608,119300,16912
819,660,159,772,166300,16914
2260,1674,586,758,122500,16915
476,397,79,673,161900,16917
803,519,284,677,82800,16920
198,158,40,667,111800,16921
816,617,199,663,98900,16922
602,488,114,680,120700,16923
1255,1060,195,831,148100,16925
365,314,51,903,173900,16926
230,184,46,650,91400,16927
525,383,142,668,105700,16928
943,741,202,748,146300,16929
478,377,101,809,150400,16930
307,221,86,-,184400,16932
2755,1687,1068,723,159100,16933
532,435,97,788,193300,16935
741,582,159,785,125400,16936
80,66,14,-,143800,16937
268,221,47,880,163100,16938
133,91,42,1028,88400,16939
97,66,31,433,97000,16940
38,36,2,-,71300,16941
305,243,62,925,111200,16942
211,153,58,630,164400,16943
1010,738,272,794,116400,16946
1786,1298,488,667,146700,16947
582,423,159,525,115400,16948
1272,955,317,623,101000,16950
240,171,69,378,163500,17002
4256,3222,1034,847,181600,17003
1711,1197,514,566,155400,17004
139,109,30,688,108200,17005
342,280,62,696,147200,17006
2333,2000,333,765,250100,17007
854,567,287,733,85300,17009
66,0,66,-,-,17010
13586,9465,4121,1042,193600,17011
14169,8520,5649,894,183300,17013
7988,7174,814,873,219400,17015
342,138,204,2444,115500,17016
686,561,125,669,148600,17017
1786,1528,258,763,194400,17018
7003,5639,1364,863,214800,17019
3676,2822,854,790,169400,17020
380,293,87,625,140600,17021
11155,7402,3753,996,202200,17022
1339,953,386,637,134400,17023
724,612,112,817,181300,17024
7108,5200,1908,934,184900,17025
1404,1207,197,593,191900,17026
207,105,102,1163,170200,17027
1547,1352,195,934,179000,17028
75,64,11,-,47000,17029
338,267,71,683,121500,17030
3193,2665,528,679,167400,17032
6390,3562,2828,994,258700,17033
1111,546,565,871,97800,17034
370,283,87,580,112700,17035
9384,6891,2493,1051,236700,17036
345,256,89,854,144400,17037
3237,2411,826,861,185900,17038
32,32,0,-,-,17039
908,750,158,744,169000,17040
64,64,0,-,223800,17041
14699,9892,4807,864,165200,17042
2944,1472,1472,900,153000,17043
9138,5774,3364,674,94600,17044
1230,994,236,689,162900,17045
11567,7117,4450,751,138100,17046
894,680,214,683,180000,17047
1468,1133,335,739,106400,17048
1109,938,171,827,137800,17049
15219,11763,3456,1193,262100,17050
1962,1562,400,608,124800,17051
623,537,86,698,121500,17052
2084,1653,431,893,169200,17053
15692,10835,4857,1059,202800,17055
10,10,0,-,-,17056
9240,6463,2777,905,136800,17057
696,463,233,607,123100,17058
3178,2386,792,662,150500,17059
463,365,98,658,114500,17060
3045,2161,884,656,147800,17061
1565,1384,181,695,171400,17062
1428,1071,357,756,105400,17063
372,296,76,1099,252600,17064
1709,1266,443,875,178300,17065
2308,1497,811,611,81400,17066
5831,4799,1032,810,168600,17067
1567,1199,368,788,175100,17068
55,19,36,800,135900,17069
6884,5152,1732,845,176100,17070
53,45,8,825,83100,17071
107,54,53,-,-,17072
1943,1604,339,799,186200,17073
2908,2128,780,734,152600,17074
46,43,3,-,77500,17075
14,14,0,-,-,17076
34,18,16,-,-,17077
9071,6199,2872,986,193600,17078
99,92,7,783,95600,17080
234,151,83,278,106800,17081
1252,936,316,671,150000,17082
15,9,6,-,-,17083
1721,1431,290,736,164700,17084
896,647,249,769,152000,17086
945,834,111,883,180900,17087
357,233,124,919,158600,17088
2477,2215,262,808,162900,17090
452,255,197,1251,149800,17093
1013,748,265,634,137200,17094
332,283,49,871,67000,17097
981,720,261,675,85100,17098
534,411,123,708,90200,17099
1432,78,1354,784,162200,17101
3954,1217,2737,804,143200,17102
4784,1835,2949,824,77000,17103
7594,2942,4652,828,71000,17104
10530,5553,4977,975,152800,17109
10252,6131,4121,1013,160000,17110
12701,8177,4524,1063,169200,17111
14576,12226,2350,1088,212800,17112
3958,2411,1547,853,104600,17113
0,0,0,-,-,17120
10979,5326,5653,845,165900,17201
10932,8482,2450,995,200200,17202
65,42,23,-,128100,17210
180,159,21,769,165200,17211
264,243,21,-,167700,17212
204,165,39,618,143300,17213
455,284,171,689,181000,17214
94,77,17,725,164200,17215
87,65,22,-,154600,17217
115,105,10,-,133800,17219
189,113,76,425,185800,17220
246,170,76,814,119700,17221
4912,3821,1091,912,177000,17222
121,87,34,665,129400,17223
650,571,79,662,154300,17224
7156,5283,1873,958,195800,17225
416,353,63,836,160500,17228
529,436,93,543,134900,17229
2255,1580,675,644,143600,17233
325,124,201,1115,166700,17235
3359,2656,703,835,176700,17236
639,489,150,974,147800,17237
635,523,112,617,166100,17238
97,90,7,-,125000,17239
1252,983,269,893,192500,17240
4622,3640,982,873,167700,17241
592,429,163,575,119200,17243
906,751,155,1060,169800,17244
78,57,21,-,158900,17246
155,14,141,1318,-,17247
170,156,14,875,88500,17249
60,31,29,-,-,17250
53,43,10,-,139600,17251
1653,1308,345,719,146500,17252
123,95,28,705,100600,17253
43,43,0,-,-,17254
438,371,67,734,137500,17255
63,63,0,-,200800,17256
11126,7020,4106,887,169700,17257
447,384,63,594,107400,17260
0,0,0,-,-,17261
545,392,153,684,182500,17262
120,92,28,-,198400,17263
950,777,173,646,132500,17264
253,217,36,950,136700,17265
190,132,58,767,159600,17266
1122,917,205,850,179000,17267
11913,8119,3794,852,165400,17268
27,27,0,-,-,17270
103,86,17,-,168500,17271
243,205,38,-,14600,17272
1605,1423,182,1034,185600,17301
1018,810,208,1069,183300,17302
1118,876,242,843,195200,17304
93,58,35,1240,177500,17306
2305,1728,577,898,198200,17307
791,591,200,694,211600,17309
91,59,32,830,127100,17311
4501,3091,1410,914,157600,17313
2009,1577,432,963,191600,17314
10342,8686,1656,952,154800,17315
3087,2676,411,940,213000,17316
237,193,44,883,134100,17317
191,117,74,1185,124000,17318
4498,3676,822,1059,175400,17319
3034,2704,330,942,221400,17320
887,754,133,959,235100,17321
2240,2011,229,1131,179200,17322
1615,1368,247,796,185600,17324
10477,7417,3060,883,225000,17325
2798,2276,522,847,220400,17327
862,741,121,962,275500,17329
20975,15337,5638,893,175400,17331
2862,2280,582,958,240400,17339
4240,3408,832,891,211400,17340
19,19,0,-,-,17343
1548,980,568,823,151300,17344
3454,2434,1020,876,151600,17345
2352,2073,279,1104,171300,17347
2705,2516,189,1148,262600,17349
4946,3706,1240,1073,170200,17350
520,441,79,867,226300,17352
1424,1255,169,995,186800,17353
121,80,41,938,173800,17355
8417,6441,1976,992,175500,17356
2537,2257,280,1040,208400,17360
2476,1926,550,847,232900,17361
5051,4294,757,874,195200,17362
3591,3193,398,869,223900,17363
1478,1378,100,809,170500,17364
1032,933,99,820,210700,17365
2090,1751,339,830,150100,17366
3034,2469,565,806,154300,17368
2069,1784,285,874,154300,17370
100,76,24,-,138200,17371
1615,1226,389,880,204400,17372
6550,1654,4896,819,64900,17401
13642,9417,4225,1027,179800,17402
14748,9443,5305,918,156400,17403
13673,9529,4144,925,136900,17404
9201,7225,1976,1076,163200,17406
769,715,54,1135,187500,17407
9404,7143,2261,1064,170200,17408
1828,1011,817,952,184300,17501
1046,872,174,1151,180500,17502
515,335,180,950,322700,17505
30,14,16,-,-,17507
175,160,15,-,260900,17508
1322,949,373,898,232800,17509
7288,4573,2715,770,149400,17512
1792,1554,238,966,218100,17516
5839,4633,1206,879,193500,17517
477,367,110,1120,234500,17518
2157,1605,552,1003,244800,17519
1954,1612,342,1040,185100,17520
12778,8661,4117,886,179200,17522
1886,1481,405,878,232800,17527
1384,1014,370,896,284900,17529
1097,906,191,877,207200,17532
734,426,308,1156,275000,17535
793,666,127,631,314400,17536
2462,2026,436,732,227900,17538
3690,2433,1257,1011,218400,17540
17048,12254,4794,1115,230100,17543
8208,6436,1772,983,195900,17545
2708,1972,736,944,159100,17547
329,177,152,1057,197100,17550
4010,2473,1537,1193,174300,17551
8201,5684,2517,1032,188500,17552
3018,1794,1224,889,202700,17554
2169,1750,419,878,259500,17555
5207,3513,1694,979,233600,17557
1972,1608,364,947,141500,17560
1322,967,355,923,254300,17562
1204,899,305,836,212400,17563
978,843,135,1080,232400,17565
4045,3081,964,1059,223400,17566
2052,1768,284,1087,212500,17569
106,42,64,-,-,17570
1513,989,524,840,267100,17572
69,69,0,-,-,17576
2602,2128,474,807,194300,17578
2124,1669,455,1025,231100,17579
283,217,66,833,176800,17581
845,771,74,711,224100,17582
3868,2649,1219,1144,228700,17584
20609,14751,5858,1102,227900,17601
18940,9997,8943,946,169800,17602
25531,14685,10846,942,155400,17603
230,0,230,1547,-,17606
17706,9981,7725,773,130400,17701
4328,3133,1195,887,146600,17702
671,493,178,753,109300,17721
19,18,1,-,112500,17723
1891,1276,615,658,126300,17724
49,49,0,-,237500,17727
2087,1745,342,825,166900,17728
28,28,0,-,83300,17729
53,0,53,-,-,17730
113,108,5,-,405000,17731
2592,2026,566,750,160100,17737
21,19,2,-,121300,17739
4933,3631,1302,723,141400,17740
12,9,3,-,-,17742
1279,997,282,763,155700,17744
7187,4233,2954,738,137000,17745
1061,877,184,724,164700,17747
114,103,11,931,55900,17748
144,100,44,714,110400,17749
56,46,10,-,137500,17750
2583,2143,440,749,143200,17751
1705,1260,445,839,141800,17752
5046,4058,988,819,195800,17754
4377,3427,950,795,154300,17756
403,370,33,1070,174400,17758
280,264,16,-,107500,17760
221,177,44,850,131300,17762
72,68,4,-,77500,17763
914,666,248,567,54100,17764
412,318,94,740,150000,17765
64,44,20,720,91900,17767
160,139,21,-,156500,17768
1271,1113,158,841,161300,17771
962,807,155,598,166600,17772
551,452,99,717,170000,17774
124,103,21,713,161400,17776
3017,2223,794,713,157200,17777
40,34,6,667,75000,17778
106,25,81,-,-,17779
7004,4331,2673,649,122500,17801
790,644,146,725,166600,17810
509,355,154,674,122500,17812
778,586,192,847,140500,17813
1947,1633,314,753,153300,17814
11432,7081,4351,774,163400,17815
2334,1815,519,755,154600,17820
7610,5304,2306,749,184200,17821
0,0,0,-,-,17822
483,373,110,750,172900,17823
1764,1578,186,382,210900,17824
279,219,60,659,142200,17827
84,72,12,740,137500,17829
813,661,152,659,145800,17830
297,281,16,-,77900,17832
1583,962,621,667,92500,17834
113,75,38,824,96600,17835
73,56,17,860,125000,17836
6603,4359,2244,721,208400,17837
233,221,12,-,56800,17840
1736,1392,344,688,123800,17841
3284,2527,757,674,158500,17842
3828,3067,761,740,172000,17844
714,557,157,815,158300,17845
1564,1251,313,715,163800,17846
4816,3378,1438,628,137400,17847
331,228,103,499,33800,17850
3705,2410,1295,630,45600,17851
1141,886,255,634,162900,17853
413,324,89,915,143200,17855
1235,907,328,741,158700,17856
3116,2370,746,821,136900,17857
1134,973,161,838,155900,17859
932,831,101,769,192600,17860
58,53,5,-,115400,17861
170,78,92,682,132800,17862
724,539,185,688,173400,17864
39,36,3,-,78600,17865
3426,2491,935,630,68300,17866
49,39,10,1375,215900,17867
484,433,51,803,196600,17868
5544,3837,1707,772,169300,17870
4273,2665,1608,598,59300,17872
859,478,381,666,158600,17876
544,468,76,906,181300,17878
45,14,31,828,80000,17880
626,513,113,615,75400,17881
93,56,37,753,60000,17884
88,77,11,-,154000,17885
499,188,311,962,134000,17886
141,141,0,-,67300,17887
127,110,17,638,77700,17888
918,796,122,755,205800,17889
9838,7124,2714,665,85200,17901
175,163,12,-,80400,17920
2802,2163,639,626,89600,17921
1926,1749,177,965,173100,17922
205,156,49,492,79300,17923
162,129,33,788,83100,17925
655,454,201,753,108500,17929
203,133,70,787,75000,17930
2146,1633,513,807,75700,17931
46,34,12,-,-,17933
184,173,11,-,28300,17934
650,523,127,678,26000,17935
306,251,55,593,112500,17936
912,760,152,794,128900,17938
319,257,62,639,168000,17941
60,60,0,-,118500,17943
57,52,5,-,106300,17944
76,68,8,-,154900,17945
83,45,38,-,45900,17946
1910,1262,648,768,30600,17948
109,101,8,-,37200,17949
116,116,0,-,106800,17951
103,97,6,-,72100,17952
217,160,57,731,67200,17953
1967,1358,609,572,57500,17954
162,152,10,-,86100,17957
584,458,126,626,52400,17959
1678,1504,174,689,181200,17960
2798,2166,632,666,165200,17961
3540,2875,665,729,150700,17963
292,236,56,492,151500,17964
904,689,215,723,77000,17965
1053,904,149,603,124800,17967
99,80,19,779,117900,17968
1377,925,452,681,66800,17970
4755,3577,1178,684,123900,17972
139,82,57,628,160300,17974
2690,1823,867,642,40700,17976
121,66,55,757,115000,17978
100,100,0,-,114800,17979
1261,1048,213,678,86700,17980
1067,838,229,587,69900,17981
219,196,23,-,85000,17982
630,395,235,707,120400,17983
539,474,65,977,157300,17985
2066,1742,324,1325,197000,18011
6703,4961,1742,998,196700,18013
4374,3666,708,1075,203600,18014
11151,5868,5283,952,158300,18015
0,0,0,-,-,18016
15457,10826,4631,1149,229700,18017
13327,6915,6412,1002,165500,18018
7723,6761,962,1298,247900,18020
327,168,159,646,127300,18030
3904,2461,1443,1498,308000,18031
3848,2502,1346,905,153400,18032
2993,2479,514,1312,288700,18034
33,33,0,-,201500,18035
5214,4565,649,873,290300,18036
3064,2425,639,947,194500,18037
1154,1032,122,-,206900,18038
6326,5812,514,981,261800,18040
1930,1447,483,985,222600,18041
15141,8197,6944,1023,146300,18042
10327,8456,1871,1226,233600,18045
17,17,0,-,-,18046
7461,5263,2198,1055,202000,18049
1426,1275,151,1429,297100,18051
11070,6954,4116,1119,182400,18052
789,675,114,921,228700,18053
1669,1369,300,942,271800,18054
4793,3490,1303,1093,214700,18055
331,325,6,-,32300,18056
3599,3063,536,941,168200,18058
447,438,9,-,262300,18059
10266,8614,1652,1347,254000,18062
297,246,51,-,195800,18063
9584,7341,2243,979,248800,18064
2330,2046,284,1128,247400,18066
7430,5668,1762,995,198000,18067
0,0,0,-,-,18068
2923,2543,380,1101,290300,18069
371,292,79,-,162000,18070
3864,2923,941,791,161600,18071
2502,1840,662,1000,172200,18072
3701,3199,502,1120,258600,18073
2193,2068,125,1169,265700,18074
1189,769,420,899,178400,18076
948,772,176,1168,311500,18077
2953,2361,592,1061,290300,18078
215,215,0,-,137500,18079
4529,3525,1004,877,180100,18080
137,91,46,-,247500,18081
168,117,51,990,191800,18083
399,302,97,935,196300,18085
230,173,57,-,175900,18086
203,102,101,986,168400,18087
3262,2799,463,1007,195400,18088
2304,1689,615,851,216800,18091
1213,1084,129,1317,297900,18092
1563,156,1407,698,70000,18101
16093,4983,11110,920,93600,18102
17853,11142,6711,1052,164600,18103
16279,11662,4617,1276,224700,18104
0,0,0,-,-,18105
3039,2249,790,1339,260000,18106
6803,3192,3611,997,124800,18109
0,0,0,-,-,18195
9869,5321,4548,801,94300,18201
4793,2887,1906,767,119900,18202
2768,2212,556,1394,147200,18210
549,462,87,923,216200,18211
83,60,23,-,125000,18212
794,746,48,625,139400,18214
499,371,128,812,82000,18216
1015,670,345,630,49300,18218
632,454,178,828,146500,18219
151,145,6,-,43300,18220
145,82,63,-,-,18221
3570,3323,247,687,178900,18222
93,93,0,-,-,18223
2523,1879,644,708,82500,18224
91,91,0,-,24200,18225
3567,2932,635,805,166200,18229
43,37,6,-,88800,18230
195,113,82,825,83800,18231
1668,1064,604,695,49000,18232
93,93,0,-,119900,18234
7721,6135,1586,791,153900,18235
1426,993,433,741,84200,18237
210,129,81,866,-,18239
1571,1182,389,703,97400,18240
342,192,150,756,99100,18241
76,76,0,-,47800,18242
119,91,28,775,99200,18244
161,129,32,-,92500,18245
99,43,56,960,-,18246
241,173,68,788,113000,18248
1562,1381,181,933,198600,18249
1200,879,321,827,98100,18250
18,0,18,-,-,18251
4637,3009,1628,729,85100,18252
388,299,89,835,92700,18254
1758,1437,321,769,131300,18255
157,102,55,821,82000,18256
9669,6600,3069,1158,167800,18301
5900,5123,777,1280,153200,18302
629,485,144,986,159400,18321
876,672,204,1013,176000,18322
72,72,0,-,390000,18323
3471,2845,626,1379,126700,18324
686,591,95,930,198300,18325
1541,1122,419,748,177600,18326
245,137,108,1138,185100,18327
2665,2379,286,1228,157500,18328
2794,2440,354,1031,170000,18330
232,200,32,-,130600,18331
838,647,191,-,187500,18332
146,146,0,-,214400,18333
1569,1297,272,1308,154100,18334
313,189,124,1227,168200,18335
1635,1126,509,1024,203900,18336
5430,4517,913,1115,232000,18337
76,76,0,-,324000,18340
270,173,97,-,112900,18342
1584,1289,295,1168,234500,18343
1407,850,557,874,150800,18344
806,652,154,991,140600,18346
1183,1041,142,1047,157200,18347
74,74,0,-,341200,18349
664,576,88,805,231700,18350
188,102,86,962,150000,18351
291,291,0,-,212300,18352
4095,3677,418,845,192000,18353
334,282,52,-,193500,18354
461,320,141,1524,234400,18355
38,38,0,-,202500,18356
60,39,21,-,-,18357
9575,6509,3066,981,205300,18360
417,312,105,1458,152700,18370
265,209,56,-,181500,18371
1007,878,129,842,183600,18372
3008,2340,668,774,174600,18403
1022,880,142,987,217300,18405
5783,3718,2065,698,109400,18407
8796,7039,1757,994,230700,18411
121,48,73,583,207100,18413
2139,1853,286,868,201300,18414
558,478,80,840,239500,18415
433,375,58,575,216500,18417
1741,1422,319,785,169300,18419
26,21,5,-,126600,18420
2019,1526,493,661,134100,18421
2042,1842,200,1081,152400,18424
501,439,62,1129,153500,18425
1940,1610,330,886,165300,18426
54,25,29,-,-,18427
4725,3809,916,1184,189300,18428
3,3,0,-,-,18430
4805,3418,1387,800,179800,18431
2691,2188,503,750,158200,18433
1619,1151,468,826,141100,18434
384,368,16,-,253900,18435
4804,4089,715,938,186100,18436
82,66,16,769,200000,18437
464,442,22,-,251900,18438
202,160,42,906,182100,18439
80,70,10,-,151200,18441
176,133,43,919,174300,18443
5234,4383,851,827,217000,18444
986,804,182,832,193700,18445
1344,1112,232,697,167500,18446
4405,2919,1486,771,150400,18447
338,291,47,-,302700,18451
2263,1636,627,867,170100,18452
404,360,44,1039,192100,18453
8,4,4,-,-,18454
34,27,7,-,136000,18455
158,107,51,825,169600,18456
72,62,10,-,223000,18457
1127,937,190,838,219800,18458
5,5,0,-,-,18459
95,90,5,-,162500,18460
144,140,4,675,128400,18461
146,129,17,540,143100,18462
98,96,2,-,172700,18463
513,464,49,1355,205700,18464
594,504,90,821,181800,18465
5367,4144,1223,1254,119400,18466
81,62,19,-,192600,18469
820,707,113,762,210500,18470
261,242,19,-,341700,18471
1557,1180,377,685,186200,18472
231,185,46,718,108200,18473
532,80,452,396,91100,18503
8785,4942,3843,777,103400,18504
8587,4597,3990,746,102900,18505
2077,1618,459,648,162700,18507
5328,2782,2546,808,96000,18508
4837,2447,2390,798,124200,18509
4526,1785,2741,761,118400,18510
5320,3730,1590,749,139200,18512
2194,1271,923,778,120400,18517
3702,2258,1444,828,152200,18518
2030,1154,876,775,127000,18519
101,88,13,1563,322200,18602
8209,5821,2388,737,120400,18603
1679,1551,128,888,158500,18610
6265,4869,1396,898,192700,18612
1086,833,253,559,157200,18614
740,601,139,847,186800,18615
253,188,65,578,150000,18616
769,487,282,611,74800,18617
1616,1267,349,1082,175600,18618
132,111,21,1313,123400,18619
2072,1829,243,918,150200,18621
73,54,19,-,-,18622
1062,797,265,741,143300,18623
181,172,9,-,237800,18624
164,115,49,668,205000,18625
193,184,9,719,206100,18626
97,83,14,725,95000,18628
653,546,107,937,169900,18629
1195,883,312,772,168700,18630
540,380,160,931,138900,18631
233,172,61,809,84400,18632
5689,3552,2137,653,83600,18634
1525,1157,368,788,145500,18635
495,399,96,850,116700,18636
7444,4881,2563,797,120800,18640
2760,2072,688,713,104700,18641
1874,1411,463,780,128300,18642
5203,3605,1598,736,135800,18643
3207,2452,755,716,159900,18644
3701,2251,1450,713,81700,18651
76,76,0,-,163900,18653
2411,1992,419,746,170100,18655
849,734,115,808,163400,18656
4862,3777,1085,828,164900,18657
1430,1255,175,711,155500,18660
2107,1809,298,850,145600,18661
955,76,879,600,162500,18701
15445,8605,6840,807,86400,18702
13520,8241,5279,792,124000,18704
6383,4264,2119,719,93800,18705
6928,4769,2159,672,86200,18706
5914,5449,465,654,198900,18707
3362,2910,452,792,172600,18708
1484,841,643,561,88700,18709
3457,2529,928,738,170400,18801
2370,1846,524,520,135100,18810
682,613,69,955,205200,18812
64,56,8,700,119400,18814
62,54,8,-,122100,18816
91,70,21,933,163200,18817
576,467,109,548,180400,18818
559,318,241,783,145200,18821
1462,1029,433,805,123600,18822
107,67,40,525,115200,18823
627,498,129,775,169300,18824
38,35,3,-,221200,18825
637,533,104,695,222400,18826
117,79,38,-,164600,18828
300,248,52,775,154600,18829
264,206,58,789,151100,18830
531,418,113,800,142700,18831
751,577,174,771,144900,18832
835,683,152,694,154600,18833
1416,1113,303,821,174400,18834
1201,991,210,924,152200,18837
4817,3320,1497,691,131500,18840
116,110,6,-,122500,18842
126,102,24,-,123800,18843
759,608,151,798,177100,18844
120,105,15,975,171300,18845
353,330,23,938,228100,18846
2282,1741,541,704,117100,18847
3597,2529,1068,731,155200,18848
939,728,211,736,133300,18850
286,238,48,725,119900,18851
1675,1399,276,713,170100,18853
600,461,139,797,149300,18854
10440,7345,3095,1402,411400,18901
7663,6903,760,1630,475800,18902
70,70,0,-,-,18912
40,40,0,-,833300,18913
7650,6685,965,1309,367100,18914
251,195,56,2120,294800,18915
887,440,447,1112,315900,18917
178,165,13,-,305600,18920
303,283,20,-,403800,18923
2320,2120,200,-,468000,18925
3245,3078,167,1750,434500,18929
1158,986,172,1269,389500,18930
160,147,13,-,386300,18932
18,18,0,-,-,18935
0,0,0,-,-,18936
6122,5038,1084,1559,574900,18938
11186,9359,1827,1588,474300,18940
1383,1123,260,1078,381400,18942
9348,7383,1965,1191,303200,18944
2255,2074,181,1309,421100,18947
59,59,0,-,378800,18950
13580,10787,2793,1091,256000,18951
3112,3048,64,1391,437200,18954
616,409,207,1083,237300,18955
4801,3703,1098,1160,288500,18960
134,98,36,1100,289100,18962
5349,4052,1297,1042,275800,18964
14320,12171,2149,1476,352900,18966
5865,4246,1619,1041,273500,18969
302,228,74,931,227500,18970
1562,1351,211,1405,391300,18972
16518,12023,4495,1387,310300,18974
7325,6038,1287,1340,400200,18976
1653,1524,129,-,607100,18977
241,202,39,-,519800,18980
6223,5180,1043,1159,257700,19001
12097,9096,3001,1302,421400,19002
5607,3497,2110,1352,315900,19003
3886,3068,818,1484,509200,19004
8035,6242,1793,1141,392600,19006
8019,4301,3718,977,191100,19007
7252,6352,900,1292,353500,19008
228,127,101,1240,450000,19009
7347,4665,2682,1528,626700,19010
2319,2026,293,1188,234700,19012
12300,4279,8021,825,68600,19013
7868,6821,1047,1036,231800,19014
6511,4913,1598,998,163800,19015
75,64,11,-,436400,19017
9787,6029,3758,1018,154300,19018
21738,12150,9588,1181,263300,19020
3713,2618,1095,1023,194000,19021
1327,546,781,964,102200,19022
7304,3970,3334,1031,91100,19023
2079,1713,366,2207,439700,19025
11930,7736,4194,1085,185400,19026
8533,4959,3574,1093,277600,19027
1445,907,538,1027,144100,19029
4571,3362,1209,1099,247700,19030
1715,1310,405,1335,347800,19031
2393,1658,735,1223,108800,19032
3149,2402,747,1284,211100,19033
1968,1576,392,1173,492700,19034
1501,1305,196,1683,899300,19035
5318,3777,1541,1020,131700,19036
11131,9402,1729,1174,284400,19038
7734,5549,2185,1197,278400,19040
2592,1659,933,1717,649700,19041
992,702,290,1103,175600,19043
6675,4055,2620,1266,277500,19044
7131,4928,2203,1187,340100,19046
12932,9541,3391,1276,353000,19047
10991,6597,4394,931,144900,19050
9776,7876,1900,1134,290200,19053
6085,4532,1553,1140,233500,19054
4809,4071,738,1062,204700,19055
5543,3930,1613,1202,247200,19056
6193,4462,1731,1107,215900,19057
3827,3649,178,1941,430600,19060
7702,4850,2852,1042,181900,19061
14799,10582,4217,1297,379400,19063
8559,7838,721,1278,310200,19064
1695,1587,108,2643,643900,19066
19690,15796,3894,1262,367000,19067
2849,2091,758,955,228700,19070
4098,3144,954,1458,538100,19072
7885,6196,1689,1456,423800,19073
2055,1554,501,958,165600,19074
2789,2399,390,1033,324700,19075
2683,1742,941,994,189600,19076
4368,3167,1201,932,179600,19078
3516,2393,1123,1028,109100,19079
3309,2772,537,1176,284200,19081
14135,6696,7439,945,112500,19082
12902,11341,1561,1111,319000,19083
1868,1724,144,2441,818200,19085
4189,3729,460,1338,333200,19086
12033,9257,2776,1510,560800,19087
7055,5153,1902,1218,255300,19090
1521,981,540,793,167900,19094
2961,1478,1483,1477,312500,19095
5438,4114,1324,1540,518300,19096
2978,890,2088,1933,440100,19102
15097,4915,10182,1708,511000,19103
16368,3571,12797,969,123800,19104
6519,3125,3394,1772,474600,19106
7371,1582,5789,1273,368100,19107
0,0,0,-,-,19109
23930,13795,10135,989,172500,19111
0,0,0,-,-,19112
54,31,23,-,162500,19113
12988,8059,4929,1091,189700,19114
13767,7841,5926,963,235200,19115
12664,7537,5127,1000,238900,19116
4435,2023,2412,1489,504000,19118
11930,7651,4279,983,257400,19119
23206,13862,9344,1002,97800,19120
11980,3826,8154,792,86500,19121
6505,2774,3731,819,171200,19122
7519,2405,5114,1347,343200,19123
22667,12226,10441,878,99900,19124
10109,6330,3779,1182,223800,19125
5783,3365,2418,911,153900,19126
2529,1117,1412,1524,235700,19127
16068,9441,6627,1355,244000,19128
4387,2200,2187,1315,214700,19129
13278,5607,7671,1450,371300,19130
17446,8299,9147,986,114200,19131
13756,6759,6997,836,51600,19132
8907,3782,5125,725,56100,19133
19830,10372,9458,905,86000,19134
11945,7608,4337,953,117300,19135
12610,7512,5098,874,146300,19136
3045,2357,688,1008,145900,19137
11334,8242,3092,954,121300,19138
16643,6789,9854,870,79100,19139
18459,8634,9825,845,63000,19140
12666,6528,6138,833,107200,19141
9678,5077,4601,930,81000,19142
25508,12258,13250,897,90200,19143
17544,6963,10581,923,132700,19144
18329,11092,7237,1008,178100,19145
16967,9164,7803,1209,303200,19146
17079,9310,7769,1264,362800,19147
19610,12905,6705,1054,181900,19148
18950,11569,7381,1123,132300,19149
9551,6978,2573,1028,161300,19150
11899,7839,4060,989,131200,19151
13142,8319,4823,982,189600,19152
5437,3011,2426,1099,138700,19153
12426,9649,2777,1191,197900,19154
2632,1962,670,1434,392600,19301
1012,713,299,1059,235000,19310
2781,2215,566,1150,361500,19311
4366,3759,607,1607,619700,19312
102,73,29,-,221800,19316
3608,2945,663,1606,492600,19317
87,87,0,-,380900,19319
20232,14545,5687,1174,234700,19320
1920,1653,267,1138,302900,19330
2778,1777,1001,1454,572000,19333
18026,14565,3461,1213,335800,19335
6859,4182,2677,1503,375700,19341
7284,5169,2115,1919,438300,19342
2678,2270,408,1536,397700,19343
4226,3199,1027,1141,249000,19344
0,0,0,-,-,19345
8525,6045,2480,1144,391800,19348
4127,3748,379,1314,382900,19350
2828,2534,294,1056,344600,19352
9805,7411,2394,1608,473600,19355
260,69,191,1169,165200,19358
2082,1712,370,912,222800,19362
5619,4125,1494,1036,267400,19363
2595,1896,699,967,205900,19365
0,0,0,-,-,19367
608,375,233,1627,259100,19372
947,840,107,1247,566600,19373
368,186,182,1065,338200,19374
8,0,8,-,-,19375
20464,14611,5853,1407,385400,19380
20120,14271,5849,1334,421100,19382
0,0,0,-,-,19383
4867,3703,1164,945,314300,19390
16216,7174,9042,1102,173100,19401
18071,13080,4991,1349,272000,19403
2293,1250,1043,1067,212000,19405
10311,6249,4062,1409,305000,19406
7154,5573,1581,1750,436300,19422
5178,4815,363,1761,481600,19425
12366,10950,1416,1406,351700,19426
7834,4376,3458,1485,317200,19428
33,33,0,-,-,19435
373,97,276,-,372800,19436
366,366,0,-,902600,19437
9520,7223,2297,1412,336000,19438
7389,5272,2117,987,283800,19440
0,0,0,-,-,19442
4370,3232,1138,1590,397200,19444
22069,14123,7946,1303,326600,19446
749,595,154,-,207700,19453
11421,8814,2607,1333,319900,19454
283,229,54,-,294000,19456
22,22,0,-,-,19457
16309,11977,4332,1238,303500,19460
5971,4508,1463,1459,344900,19462
18186,11875,6311,959,169800,19464
6692,5237,1455,1081,282900,19465
10059,7259,2800,1325,261100,19468
6,0,6,-,-,19472
5810,5052,758,1115,322300,19473
367,332,35,-,228000,19474
4240,3117,1123,861,283200,19475
0,0,0,-,-,19477
248,21,227,2211,-,19492
448,247,201,841,188400,19501
555,380,175,948,171600,19503
1987,1739,248,891,271200,19504
1427,1129,298,947,215500,19505
2766,2423,343,839,213700,19506
1090,946,144,736,187200,19507
6006,5162,844,883,180300,19508
3261,2765,496,1150,189300,19510
33,33,0,-,188300,19511
7131,5303,1828,903,196600,19512
5642,4748,894,1309,241800,19518
0,0,0,-,-,19519
2337,1941,396,813,289600,19520
5420,4819,601,901,177500,19522
146,146,0,-,147000,19523
5644,5070,574,1166,306000,19525
4617,3483,1134,823,156200,19526
1320,1127,193,1067,253100,19529
4816,3027,1789,959,194600,19530
2370,1920,450,895,199200,19533
729,576,153,1064,208900,19534
5,5,0,-,-,19535
249,165,84,829,123500,19536
15,15,0,-,-,19538
1875,1529,346,1280,208400,19539
4409,3723,686,893,239100,19540
1726,1481,245,949,225300,19541
0,0,0,-,-,19542
2203,1797,406,964,266800,19543
54,49,5,-,157300,19544
286,164,122,847,163000,19545
1739,1431,308,1136,232700,19547
121,77,44,975,84500,19549
124,85,39,-,148900,19550
1872,1529,343,837,184700,19551
173,121,52,795,157900,19554
1388,1074,314,899,161800,19555
142,88,54,825,147800,19559
3293,2661,632,1188,146500,19560
1147,580,567,670,153200,19562
70,24,46,-,153600,19564
3436,2665,771,891,178900,19565
2000,1517,483,812,171600,19567
11283,3965,7318,785,70900,19601
6271,2104,4167,724,52400,19602
8196,3886,4310,910,72600,19604
7406,6344,1062,995,151600,19605
13396,10625,2771,1025,170100,19606
9661,6146,3515,1029,153200,19607
8120,6588,1532,1188,235400,19608
4031,3382,649,1188,158600,19609
6236,4471,1765,1245,239600,19610
3852,1920,1932,771,110500,19611
14089,10970,3119,1423,273100,19701
19444,11976,7468,1293,245000,19702
5852,3100,2752,1036,214500,19703
689,483,206,1059,186300,19706
5955,5183,772,1775,431100,19707
13369,11722,1647,1215,330000,19709
0,0,0,-,-,19710
19401,12362,7039,1192,294700,19711
11829,7402,4427,1084,209500,19713
0,0,0,-,-,19716
0,0,0,-,-,19717
21551,14830,6721,1113,190300,19720
297,269,28,1094,322900,19730
67,60,7,-,165800,19731
28,28,0,-,-,19732
89,89,0,-,-,19733
4091,3814,277,1380,328800,19734
17,0,17,-,-,19735
26,0,26,-,-,19736
6124,1570,4554,844,144400,19801
10465,5297,5168,933,155400,19802
8520,7296,1224,1290,356300,19803
6947,4832,2115,1122,194200,19804
14841,7956,6885,1046,175100,19805
5156,2681,2475,1128,306500,19806
2981,2210,771,1356,741300,19807
15374,11911,3463,1204,256300,19808
6031,3834,2197,1159,235700,19809
9819,8056,1763,1153,334900,19810
13988,7594,6394,1161,180600,19901
0,0,0,-,-,19902
12938,8593,4345,1075,211700,19904
1288,1256,32,-,598600,19930
114,97,17,-,187500,19931
3744,2924,820,718,211500,19933
5218,4188,1030,1249,230400,19934
122,53,69,862,-,19936
3102,2571,531,1167,231500,19938
2703,2479,224,1109,275800,19939
2077,1593,484,809,186200,19940
957,645,312,964,178200,19941
4676,3852,824,1103,206600,19943
332,304,28,983,717400,19944
2583,2044,539,1133,229400,19945
1974,1411,563,1122,176900,19946
6695,4523,2172,912,220000,19947
2533,2060,473,983,211800,19950
791,702,89,1555,309900,19951
3952,2751,1201,880,208700,19952
1692,1449,243,863,219500,19953
548,461,87,1145,221100,19954
11,9,2,-,-,19955
5675,4094,1581,832,173300,19956
11569,9779,1790,1331,346300,19958
2528,2100,428,832,189400,19960
4042,3230,812,970,245500,19962
8178,5498,2680,985,212200,19963
369,295,74,691,271400,19964
11784,9538,2246,982,204000,19966
607,498,109,1489,325200,19967
4782,3924,858,1055,284000,19968
3809,3108,701,1296,346100,19970
6761,5752,1009,1260,413600,19971
9527,7041,2486,899,181900,19973
4176,3243,933,1076,336100,19975
8575,6465,2110,1099,230600,19977
293,253,40,956,210200,19979
19292,6858,12434,2021,659700,20001
27479,10818,16661,1558,609300,20002
12829,5970,6859,2037,766900,20003
1295,515,780,2597,546900,20004
8137,1831,6306,1885,489900,20005
563,37,526,1760,231900,20006
11888,6411,5477,1897,961100,20007
15767,6192,9575,1940,776000,20008
27380,10149,17231,1794,618600,20009
12621,4537,8084,1510,617300,20010
24166,12797,11369,1213,534600,20011
6078,3706,2372,1248,607200,20012
6473,4437,2036,1679,961600,20015
13477,9369,4108,1925,923500,20016
7724,4464,3260,1529,477600,20017
7938,4683,3255,999,484200,20018
23813,8155,15658,993,275600,20019
21143,6617,14526,1055,293600,20020
7811,3038,4773,1531,397200,20024
14766,3110,11656,1086,259900,20032
4058,1448,2610,1922,383500,20036
6320,2413,3907,2155,637900,20037
0,0,0,-,-,20045
0,0,0,-,-,20052
0,0,0,-,-,20053
0,0,0,-,-,20057
0,0,0,-,-,20064
6521,5796,725,2162,508600,20105
2028,1809,219,1024,360500,20106
13206,5718,7488,1625,266600,20109
14400,9761,4639,1460,324500,20110
10210,7086,3124,1593,332700,20111
8072,7642,430,2282,458300,20112
2385,1640,745,1386,437000,20115
1136,724,412,895,542200,20117
2,0,2,-,-,20118
1513,1184,329,1454,395200,20119
13574,10027,3547,1843,476800,20120
9759,6075,3684,1787,373100,20121
5061,4638,423,2180,677200,20124
242,218,24,-,745500,20129
123,103,20,-,606300,20130
5702,4944,758,1380,511100,20132
1320,1086,234,1133,394100,20135
8597,7755,842,2276,430700,20136
497,463,34,1500,533300,20137
96,48,48,-,-,20139
2181,2017,164,1475,465600,20141
341,293,48,-,687500,20143
376,312,64,1154,471900,20144
22097,15618,6479,1846,498800,20147
14880,11928,2952,2038,587900,20148
6839,5662,1177,1758,503700,20151
10571,9225,1346,2205,530100,20152
11144,9462,1682,2205,468200,20155
1444,1335,109,1659,565900,20158
12431,9070,3361,1825,364300,20164
11285,9111,2174,1873,505700,20165
3942,2265,1677,1826,392600,20166
7655,6975,680,2328,533700,20169
13387,8998,4389,1849,472300,20170
17014,10294,6720,1891,613200,20171
11581,9082,2499,1621,487700,20175
17258,12724,4534,1665,495600,20176
2474,2161,313,1814,456000,20180
2756,2525,231,1375,470800,20181
310,182,128,-,546700,20184
5648,3917,1731,1242,391500,20186
5820,5164,656,1808,435700,20187
8658,4130,4528,1842,461700,20190
11581,8012,3569,1767,470300,20191
5412,3787,1625,1916,626000,20194
680,654,26,-,748700,20197
967,739,228,890,387800,20198
0,0,0,-,-,20202
0,0,0,-,-,20204
0,0,0,-,-,20228
0,0,0,-,-,20230
0,0,0,-,-,20240
0,0,0,-,-,20245
0,0,0,-,-,20260
0,0,0,-,-,20307
304,16,288,2000,-,20317
0,0,0,-,-,20319
0,0,0,-,-,20373
0,0,0,-,-,20390
0,0,0,-,-,20405
0,0,0,-,-,20418
0,0,0,-,-,20427
0,0,0,-,-,20506
0,0,0,-,-,20510
0,0,0,-,-,20520
0,0,0,-,-,20535
0,0,0,-,-,20540
0,0,0,-,-,20551
0,0,0,-,-,20553
0,0,0,-,-,20560
0,0,0,-,-,20565
0,0,0,-,-,20566
0,0,0,-,-,20593
8980,6923,2057,1803,280400,20601
10073,6219,3854,1539,237300,20602
10944,8219,2725,1823,324000,20603
181,163,18,-,256300,20606
3847,3503,344,1716,392600,20607
284,233,51,1272,306900,20608
436,327,109,-,291000,20609
484,382,102,859,335600,20611
187,187,0,-,256500,20612
4643,4186,457,1580,358300,20613
150,150,0,-,370800,20615
2265,1861,404,1719,272400,20616
268,268,0,-,414700,20617
215,142,73,1309,367700,20618
5213,3101,2112,1547,280100,20619
546,456,90,1400,234200,20620
403,333,70,1679,362800,20621
1621,1405,216,1071,332300,20622
850,840,10,-,306400,20623
506,397,109,1422,319400,20624
253,243,10,-,306500,20625
182,158,24,-,513500,20626
116,98,18,-,-,20628
126,76,50,-,552100,20629
114,94,20,-,270000,20630
117,87,30,-,280300,20632
2686,1719,967,1244,250700,20634
3949,3382,567,1472,365900,20636
1885,1661,224,-,405100,20637
4706,4362,344,1886,433400,20639
3634,2765,869,1543,222500,20640
350,304,46,-,359300,20645
7281,5937,1344,1374,356200,20646
5208,3964,1244,1057,365600,20650
9441,5092,4349,1345,252700,20653
6911,5804,1107,1496,230900,20657
328,238,90,1455,263700,20658
7926,6924,1002,1240,294600,20659
26,0,26,-,-,20660
1139,1042,97,1242,283600,20662
1277,895,382,1348,316500,20664
236,184,52,1120,259500,20667
363,0,363,1935,-,20670
335,231,104,1381,538500,20674
818,760,58,2296,319100,20675
1353,1101,252,1908,337700,20676
832,748,84,1115,425200,20677
4353,3329,1024,923,342400,20678
262,154,108,1419,321600,20680
548,418,130,1007,306200,20684
2283,2003,280,1676,338100,20685
17,17,0,-,-,20686
210,170,40,-,355800,20687
843,442,401,2252,453100,20688
674,668,6,-,397200,20689
312,234,78,1324,400000,20690
447,391,56,-,380100,20692
346,286,60,1706,409500,20693
2855,2327,528,1879,314800,20695
0,0,0,-,-,20701
8935,5560,3375,1572,329900,20705
12830,8180,4650,1581,278600,20706
12109,7148,4961,1501,300300,20707
9684,3510,6174,1429,323900,20708
3630,895,2735,1310,227100,20710
2436,2195,241,1146,333400,20711
3845,892,2953,1208,335500,20712
2032,1329,703,1671,296800,20714
8884,8015,869,2224,322800,20715
8602,6146,2456,1791,293400,20716
7676,6992,684,2258,391600,20720
9612,8560,1052,2127,387200,20721
1763,1233,530,1310,247400,20722
11604,8079,3525,1760,407700,20723
6613,4532,2081,1839,309200,20724
3482,2638,844,1696,329800,20732
1010,918,92,1754,332900,20733
12366,11014,1352,1920,286700,20735
3106,2889,217,1280,441100,20736
5954,2932,3022,1232,247800,20737
9517,4332,5185,1504,300300,20740
0,0,0,-,-,20742
14284,9433,4851,1271,211800,20743
18662,14583,4079,1538,308900,20744
10576,4400,6176,1284,227700,20745
11211,4337,6874,1397,211800,20746
15228,7857,7371,1313,226100,20747
14596,7886,6710,1310,249100,20748
856,753,103,1236,350500,20751
2460,2209,251,1771,446600,20754
2715,41,2674,2152,-,20755
188,166,22,-,487000,20758
1625,1467,158,"3,500+",678000,20759
795,0,795,2450,-,20762
817,366,451,1462,341100,20763
1558,1335,223,1865,287700,20764
185,99,86,1113,405600,20765
2120,1989,131,2261,429200,20769
9681,4517,5164,1591,202000,20770
16073,13345,2728,1811,306400,20772
17846,14182,3664,1772,311400,20774
1180,1026,154,1739,463200,20776
1160,1160,0,-,694900,20777
735,648,87,-,512600,20778
414,395,19,-,490400,20779
3770,2103,1667,1335,305800,20781
10996,4771,6225,1467,300900,20782
12148,5274,6874,1363,277700,20783
9583,5756,3827,1372,236900,20784
13999,6687,7312,1451,235900,20785
3716,2851,865,1550,298200,20794
99,91,8,2750,898000,20812
13060,7019,6041,1950,759100,20814
12960,8107,4853,2117,985700,20815
6090,5022,1068,2314,939700,20816
13281,11209,2072,1976,893300,20817
829,751,78,2313,884900,20818
8723,7694,1029,1805,468200,20832
2473,2329,144,1927,599600,20833
1966,1610,356,1755,490200,20837
94,87,7,-,591300,20838
24,24,0,-,-,20839
2804,2604,200,2514,603400,20841
690,585,105,1188,656000,20842
19753,11250,8503,2044,592400,20850
4933,2850,2083,1735,368000,20851
20577,9292,11285,1869,497200,20852
9802,8322,1480,1412,454500,20853
16594,15255,1339,2752,911900,20854
5042,4265,777,1816,504500,20855
867,623,244,1094,758300,20860
568,568,0,-,639500,20861
117,117,0,-,804100,20862
4945,3610,1335,1840,334600,20866
239,223,16,-,771100,20868
6199,5317,882,2164,462500,20871
4255,3632,623,1567,381300,20872
21816,13846,7970,1680,314300,20874
9068,6112,2956,1778,386400,20876
12950,5495,7455,1564,344100,20877
22635,15902,6733,1808,571000,20878
8331,5572,2759,1704,319900,20879
205,185,20,1500,451800,20880
4371,4105,266,1897,577600,20882
11792,8041,3751,1544,296300,20886
7027,5715,1312,1613,613600,20895
327,306,21,-,823200,20896
183,11,172,846,-,20899
12214,8548,3666,1552,433800,20901
16605,10565,6040,1788,392100,20902
7409,2877,4532,1506,355300,20903
20543,11176,9367,1714,396700,20904
5808,5230,578,1735,475100,20905
25137,16459,8678,1703,333400,20906
20180,6499,13681,1709,556000,20910
9382,3918,5464,1218,518400,20912
9614,6055,3559,1044,224700,21001
760,0,760,1834,-,21005
11485,9226,2259,1312,247500,21009
129,0,129,-,-,21010
7724,6703,1021,1843,449200,21012
1682,1648,34,-,431800,21013
14012,10842,3170,1184,312700,21014
10245,8878,1367,1474,335500,21015
2678,1802,876,1454,185400,21017
1143,1019,124,1163,382800,21028
3309,3066,243,2386,681000,21029
10129,4593,5536,1227,375600,21030
0,0,0,-,-,21031
3121,2671,450,1248,444000,21032
1325,1145,180,885,272300,21034
2709,2581,128,3264,642400,21035
708,648,60,-,718200,21036
8103,6868,1235,1781,410700,21037
8420,6260,2160,1154,165100,21040
13917,12199,1718,1705,585500,21042
16876,11461,5415,1647,474700,21043
17952,10677,7275,1714,396700,21044
15008,10709,4299,1490,347100,21045
6224,4009,2215,1701,371500,21046
4288,3974,314,1052,378100,21047
3621,3366,255,1254,354400,21048
6568,5820,748,1489,347600,21050
119,119,0,-,370800,21051
87,80,7,-,282800,21052
1085,975,110,1650,369500,21053
4227,3525,702,1817,393300,21054
83,83,0,-,1120500,21056
1651,1413,238,1375,464500,21057
13085,9548,3537,1251,264500,21060
20966,11633,9333,1294,247200,21061
213,194,19,-,325000,21071
5513,4636,877,904,283100,21074
11695,7851,3844,1712,348700,21075
6961,4749,2212,2005,370000,21076
147,147,0,-,339300,21077
7499,5238,2261,1025,288900,21078
233,206,27,-,356100,21082
2574,2346,228,1192,372400,21084
6238,4983,1255,1132,272700,21085
1913,1835,78,2365,408800,21087
3742,3177,565,1432,313100,21090
15333,12312,3021,1241,367600,21093
3976,3458,518,936,319300,21102
1794,1713,81,2179,539500,21104
0,0,0,-,-,21105
6484,5238,1246,1677,442400,21108
1734,1586,148,1417,515500,21111
13411,8918,4493,1793,317100,21113
9763,7591,2172,1857,375200,21114
22819,12172,10647,1452,281900,21117
2534,2260,274,1629,454700,21120
21639,18538,3101,1580,328400,21122
5083,4229,854,1445,332600,21128
115,22,93,878,-,21130
2605,2404,201,1112,560500,21131
949,890,59,1365,367400,21132
11334,7734,3600,1165,237200,21133
12877,9304,3573,1220,288600,21136
1268,1178,90,1655,469200,21140
11691,9096,2595,1444,364200,21144
9609,8788,821,1658,528300,21146
2212,1675,537,1336,396700,21152
127,95,32,-,825000,21153
2019,1819,200,868,351100,21154
982,769,213,1365,367800,21155
143,137,6,-,329700,21156
13854,10001,3853,1041,312900,21157
7496,6064,1432,1441,322800,21158
1008,799,209,861,302600,21160
1891,1747,144,1304,376900,21161
1372,1297,75,1804,369700,21162
2521,2229,292,1885,470800,21163
9269,1106,8163,1108,209500,21201
8611,1845,6766,1034,238300,21202
7689,3824,3865,1607,442500,21204
5217,1826,3391,913,53200,21205
19309,11203,8106,960,153700,21206
18423,11348,7075,1100,182500,21207
15132,10222,4910,1404,254600,21208
11525,7003,4522,1308,314300,21209
5175,3181,1994,1329,444300,21210
7561,4084,3477,1250,221600,21211
12477,8540,3937,1132,281600,21212
11238,5807,5431,1079,94300,21213
7771,5852,1919,1047,180300,21214
22032,10860,11172,969,124300,21215
10831,5303,5528,987,90200,21216
13652,4450,9202,875,124800,21217
18443,8810,9633,1034,158600,21218
3486,2721,765,1327,286100,21219
15128,9517,5611,1166,201800,21220
16155,9111,7044,1043,194300,21221
20581,13161,7420,1082,146300,21222
8401,2836,5565,941,72800,21223
19380,11288,8092,1417,201700,21224
11996,5933,6063,903,166500,21225
2312,1834,478,1309,237700,21226
12097,7663,4434,1120,207600,21227
18433,13698,4735,1352,306700,21228
17934,9504,8430,1018,127400,21229
14928,7810,7118,1453,266100,21230
7471,2945,4526,1321,290700,21231
28647,17500,11147,1265,218600,21234
15153,10281,4872,1294,242700,21236
11244,7184,4060,1202,218100,21237
11843,6305,5538,1117,149600,21239
0,0,0,-,-,21240
13196,6499,6697,1310,200000,21244
0,0,0,-,-,21250
0,0,0,-,-,21251
0,0,0,-,-,21252
8054,5019,3035,1306,343900,21286
16066,9922,6144,1638,463600,21401
267,22,245,2046,-,21402
12988,8088,4900,1668,452100,21403
183,183,0,-,1014500,21405
7571,6683,888,1786,424800,21409
16146,10716,5430,687,124800,21502
885,706,179,670,215800,21520
572,417,155,704,85300,21521
62,46,16,-,144100,21522
95,86,9,-,87700,21523
291,226,65,-,147500,21524
191,166,25,854,110000,21529
816,723,93,898,155600,21530
830,653,177,552,158500,21531
5522,3509,2013,735,137100,21532
1542,1207,335,560,164000,21536
189,149,40,675,73800,21538
1059,768,291,543,89600,21539
44,29,15,594,25600,21540
652,464,188,846,236500,21541
267,154,113,713,78600,21542
76,67,9,-,134700,21543
787,673,114,776,113000,21545
5867,4502,1365,620,162100,21550
636,522,114,-,118500,21555
692,604,88,904,113700,21557
1121,941,180,533,242400,21561
1315,982,333,609,83600,21562
10447,6700,3747,1099,309500,21601
222,163,59,994,299100,21607
158,122,36,931,184100,21610
178,178,0,-,500000,21612
7350,4060,3290,869,194200,21613
3628,3058,570,1089,365900,21617
2586,1856,730,1688,349800,21619
5052,3296,1756,887,251000,21620
391,286,105,1025,179500,21622
609,487,122,1192,267100,21623
79,59,20,-,297100,21624
1015,852,163,1283,304700,21625
57,48,9,-,-,21626
11,11,0,-,-,21627
224,159,65,-,-,21628
3605,2754,851,1039,219700,21629
1020,863,157,1078,223800,21631
2295,1436,859,796,160200,21632
114,114,0,-,350000,21634
812,670,142,895,245700,21635
444,355,89,972,195600,21636
1946,1547,399,1748,420500,21638
1611,1042,569,796,163800,21639
537,491,46,1125,213700,21640
40,21,19,1000,172500,21641
2263,1780,483,931,152800,21643
25,25,0,-,265000,21644
476,429,47,-,324000,21645
108,75,33,-,433900,21647
114,96,18,-,124200,21648
567,439,128,1227,160500,21649
108,88,20,-,209600,21650
1120,839,281,988,225700,21651
77,57,20,-,506600,21652
47,47,0,-,285500,21653
546,383,163,997,797500,21654
1934,1556,378,1065,208300,21655
301,286,15,1750,303800,21657
1433,1243,190,1564,393200,21658
515,461,54,821,187200,21659
1462,1021,441,907,232200,21660
1123,774,349,1061,222800,21661
231,204,27,-,711500,21662
1635,1314,321,996,458200,21663
184,138,46,1214,133300,21664
113,113,0,-,434400,21665
4598,3893,705,1497,370900,21666
120,110,10,-,235400,21667
668,527,141,561,221000,21668
94,84,10,-,480000,21669
380,316,64,1333,326700,21671
83,76,7,-,-,21672
1431,1006,425,1076,336500,21673
55,55,0,-,94200,21675
204,159,45,1375,450000,21676
150,139,11,-,381300,21677
726,640,86,1095,198900,21678
136,125,11,-,281600,21679
15664,10346,5318,1276,295800,21701
15705,9892,5813,1417,284000,21702
13237,8531,4706,1531,265800,21703
5236,4330,906,2077,455200,21704
0,0,0,-,-,21705
1921,1430,491,1723,418800,21710
389,308,81,776,172000,21711
3797,3064,733,1293,268600,21713
55,24,31,-,-,21714
1953,1416,537,864,219900,21716
25,11,14,-,-,21717
63,46,17,1083,357100,21718
431,347,84,833,194900,21719
2021,1522,499,898,241200,21722
321,305,16,-,615500,21723
1810,1326,484,855,261800,21727
364,364,0,-,263000,21733
360,186,174,720,143100,21734
669,669,0,-,835200,21737
1117,1067,50,-,686900,21738
22847,12456,10391,826,172700,21740
13235,8678,4557,1039,223100,21742
0,0,0,-,-,21746
1494,1070,424,723,158700,21750
2273,2077,196,1450,468600,21754
2020,1884,136,1084,364400,21755
1328,1220,108,895,292200,21756
1192,905,287,1220,272900,21757
1917,1612,305,1464,253300,21758
65,54,11,-,318200,21762
253,211,42,-,202000,21766
432,236,196,745,169800,21767
3979,3511,468,1361,390800,21769
1858,1761,97,1223,399000,21770
9917,9119,798,1637,408100,21771
1978,1851,127,1029,341000,21773
4509,4161,348,1961,373200,21774
1978,1469,509,1149,318500,21776
635,588,47,-,356700,21777
406,322,84,1283,263500,21778
358,358,0,-,298500,21779
534,428,106,1385,272700,21780
14,14,0,-,-,21781
1538,1368,170,788,244900,21782
3256,2778,478,952,235900,21783
13607,11913,1694,1192,378200,21784
3856,3139,717,1093,271700,21787
4680,3536,1144,984,253100,21788
42,35,7,-,325000,21790
2037,1580,457,1053,313200,21791
3633,2939,694,1444,283200,21793
828,820,8,-,667600,21794
3791,2365,1426,955,203300,21795
2866,2569,297,1321,546800,21797
750,609,141,855,329600,21798
10787,6026,4761,873,197600,21801
0,0,0,-,-,21802
15055,7549,7506,1122,164900,21804
261,261,0,-,200300,21810
9979,7924,2055,1266,262700,21811
955,904,51,-,355900,21813
181,100,81,-,220000,21814
2009,1247,762,588,122200,21817
436,406,30,868,162000,21821
776,580,196,-,215400,21822
51,47,4,-,111700,21824
1898,1205,693,1375,166900,21826
189,153,36,-,186100,21829
1310,1093,217,956,161800,21830
142,119,23,-,-,21835
1149,900,249,1309,175000,21837
746,645,101,639,132200,21838
135,96,39,-,167200,21840
442,315,127,804,252800,21841
5189,3807,1382,1053,294500,21842
1323,1076,247,963,168800,21849
1102,876,226,993,154200,21850
2785,1714,1071,859,148100,21851
3716,1963,1753,709,151000,21853
322,244,78,-,115300,21856
304,234,70,890,146900,21861
12,12,0,-,-,21862
1748,1286,462,768,184500,21863
244,191,53,-,144400,21864
175,142,33,-,298500,21865
27,27,0,-,137500,21866
10,10,0,-,-,21867
430,357,73,833,154000,21869
753,628,125,671,155800,21871
224,138,86,662,241700,21872
790,591,199,1125,141800,21874
2609,1707,902,1051,164400,21875
0,0,0,-,-,21890
6452,4732,1720,1147,249600,21901
0,0,0,-,-,21902
2292,1426,866,1015,227300,21903
2339,2005,334,869,227700,21904
3875,2937,938,1066,241500,21911
397,279,118,845,379300,21912
363,202,161,754,171200,21913
304,174,130,1175,235200,21914
1130,789,341,1136,254700,21915
0,0,0,-,-,21916
860,740,120,1153,244000,21917
1348,1231,117,739,237400,21918
1115,1023,92,944,318600,21919
136,115,21,-,163500,21920
16236,11205,5031,1150,227800,21921
83,16,67,-,-,21930
18984,12765,6219,1676,542400,22003
14664,12130,2534,2149,493500,22015
6226,5198,1028,2108,375600,22025
4723,2950,1773,1497,287900,22026
609,538,71,3469,914400,22027
19357,11753,7604,1932,581200,22030
12760,6332,6428,1977,531800,22031
9851,8381,1470,2313,586300,22032
15096,9555,5541,1874,485700,22033
0,0,0,-,-,22035
5858,5587,271,"3,500+",814300,22039
10798,4632,6166,1605,387600,22041
12420,7451,4969,1795,498300,22042
9012,5279,3733,1852,631000,22043
5320,2661,2659,1437,561800,22044
6586,4713,1873,1904,711300,22046
2702,343,2359,2667,600600,22060
5796,5572,224,3089,1085500,22066
11375,8157,3218,1933,472100,22079
10477,8794,1683,3158,999700,22101
10589,5318,5271,1950,882800,22102
6662,5660,1002,1897,758100,22124
396,275,121,1769,390600,22125
1294,54,1240,1799,204200,22134
9062,5419,3643,1992,451600,22150
5498,4605,893,2243,471900,22151
10362,8409,1953,2174,466200,22152
10183,8924,1259,2247,513500,22153
3380,1646,1734,1019,418000,22172
8340,6310,2030,1930,689000,22180
5206,4420,786,1911,762600,22181
9069,7178,1891,2247,856400,22182
0,0,0,-,-,22185
22366,13923,8443,1659,297900,22191
19808,14651,5157,1748,336800,22192
23469,18379,5090,1647,316900,22193
19063,6293,12770,2136,671100,22201
13719,3291,10428,2132,645800,22202
11932,4075,7857,2034,589700,22203
22396,8715,13681,1615,486500,22204
6711,5398,1313,1782,813900,22205
10288,4682,5606,1917,429300,22206
11865,9605,2260,1970,924300,22207
7548,2595,4953,1973,658800,22209
58,0,58,3172,-,22211
1371,988,383,2439,801300,22213
0,0,0,-,-,22214
5827,3736,2091,1891,772700,22301
8067,4311,3756,1782,430800,22302
6902,3026,3876,1770,390500,22303
21304,8662,12642,1629,350600,22304
6825,2617,4208,1669,618200,22305
11813,5619,6194,1432,436800,22306
4504,3513,991,1713,543800,22307
4458,4040,418,3094,666500,22308
11526,7358,4168,1537,430800,22309
11437,8762,2675,1969,460700,22310
7907,1383,6524,1556,519400,22311
11507,5821,5686,1729,445700,22312
17629,8473,9156,1924,673800,22314
10686,7957,2729,2140,465300,22315
10582,3829,6753,1183,346500,22401
10388,8131,2257,1393,291700,22405
8990,6625,2365,1336,360300,22406
19616,14654,4962,1433,269700,22407
9997,7402,2595,1476,277800,22408
1245,810,435,903,159200,22427
83,83,0,-,231400,22432
116,94,22,-,-,22433
981,818,163,841,167600,22435
233,164,69,802,251700,22436
380,281,99,-,135900,22437
152,114,38,-,125000,22438
3669,2719,950,1024,226500,22443
177,0,177,1664,-,22448
605,468,137,816,192500,22454
679,557,122,1137,144100,22460
661,504,157,777,183700,22469
2463,1993,470,748,273800,22473
159,144,15,-,165500,22476
362,218,144,771,299000,22480
1495,1053,442,790,239500,22482
8938,7026,1912,1136,301300,22485
422,368,54,-,261800,22488
1758,1435,323,922,253300,22503
145,133,12,-,241000,22504
5420,5051,369,1440,248000,22508
13,13,0,-,-,22509
529,478,51,1085,260600,22511
945,753,192,850,195400,22514
2614,1966,648,1159,203000,22520
102,68,34,-,-,22529
25,17,8,-,-,22530
974,812,162,1263,238000,22534
203,158,45,1054,190300,22535
42,42,0,-,-,22538
1108,1055,53,-,376600,22539
752,665,87,1115,193000,22542
6157,5270,887,1344,201700,22546
100,66,34,-,-,22548
6417,5655,762,1106,286200,22551
4786,3732,1054,1534,306200,22553
17584,13173,4411,1654,344100,22554
9366,7360,2006,1656,333100,22556
2714,1752,962,878,197200,22560
1165,978,187,1101,214800,22567
2410,1589,821,807,193000,22572
890,720,170,805,214300,22576
1183,921,262,902,248100,22578
33,33,0,-,-,22579
2053,1575,478,983,180300,22580
11032,5282,5750,1018,231900,22601
10699,8193,2506,1137,257900,22602
5683,4279,1404,1058,218000,22603
737,666,71,-,279500,22610
3323,2360,963,1106,336100,22611
973,742,231,1046,340900,22620
293,250,43,1158,194000,22623
1055,838,217,1141,238500,22624
1302,1127,175,1171,238700,22625
320,224,96,1099,462100,22627
11724,8652,3072,944,240500,22630
898,782,116,471,251900,22637
229,144,85,1366,696200,22639
229,165,64,-,393800,22640
167,167,0,-,219800,22641
1765,1632,133,1545,220400,22642
103,103,0,-,245000,22643
920,725,195,878,214600,22644
1605,1272,333,833,270600,22645
89,89,0,-,346600,22646
313,250,63,-,218900,22650
589,517,72,775,295500,22652
462,430,32,-,236800,22654
7506,5649,1857,1151,244000,22655
1183,1074,109,1184,233500,22656
4253,2969,1284,982,210600,22657
788,540,248,789,184000,22660
637,507,130,1222,275000,22663
3591,2239,1352,789,222100,22664
12072,8271,3801,1121,257800,22701
445,307,138,1271,238300,22709
11,11,0,-,-,22711
2953,2291,662,1204,280400,22712
526,420,106,1674,285400,22713
296,271,25,1184,325000,22714
445,315,130,812,266100,22715
317,260,57,714,518200,22716
243,212,31,-,273700,22718
108,85,23,-,225000,22719
257,245,12,-,432200,22720
99,99,0,-,-,22722
65,65,0,-,276200,22723
763,675,88,1908,358200,22724
286,209,77,942,231500,22726
2340,1591,749,724,246600,22727
1158,932,226,1179,351200,22728
70,70,0,-,314300,22729
60,33,27,-,-,22730
7,7,0,-,-,22731
47,47,0,-,328800,22732
358,294,64,1153,318100,22733
1057,711,346,1150,245000,22734
868,790,78,1395,311000,22735
247,247,0,-,236100,22736
1003,752,251,1353,253000,22737
518,400,118,1024,298500,22738
507,317,190,1030,340600,22740
44,33,11,-,-,22741
625,562,63,1448,296600,22742
117,108,9,-,274100,22743
437,329,108,786,376500,22747
95,63,32,1167,669100,22749
13233,6398,6835,953,260700,22801
11224,5546,5678,815,184900,22802
0,0,0,-,-,22807
309,263,46,1037,214000,22810
244,216,28,-,227600,22811
3415,2289,1126,850,217700,22812
3659,2588,1071,740,187300,22815
107,98,9,-,-,22820
1923,1594,329,704,212500,22821
2519,1938,581,866,196200,22824
4196,3141,1055,811,175300,22827
697,538,159,872,154200,22830
350,298,52,743,158500,22831
456,362,94,1325,224500,22832
402,387,15,-,244200,22834
4513,3122,1391,817,179400,22835
1727,1318,409,1287,252000,22840
1168,885,283,893,245500,22841
2023,1425,598,861,175100,22842
936,795,141,883,195600,22843
2045,1278,767,749,222400,22844
9,9,0,-,-,22845
899,732,167,1271,304300,22846
386,341,45,869,251600,22847
2050,1581,469,801,154100,22849
349,290,59,1112,174000,22850
2358,1507,851,721,159400,22851
1689,1047,642,763,158800,22853
14905,7924,6981,1208,340200,22901
10358,5127,5231,1151,274700,22902
14645,6299,8346,1189,355200,22903
59,0,59,920,-,22904
7248,4456,2792,1335,318600,22911
1578,1248,330,929,281400,22920
788,667,121,-,182800,22922
2176,1558,618,1347,287600,22923
154,97,57,1066,292700,22931
3244,2459,785,1309,366000,22932
350,284,66,-,214900,22935
1920,1774,146,1107,367800,22936
754,668,86,978,179100,22937
556,382,174,-,270500,22938
2184,1500,684,1329,270400,22939
496,421,75,1398,310000,22940
3530,2745,785,892,226700,22942
113,81,32,-,295800,22943
71,71,0,-,-,22946
1632,1325,307,1058,560600,22947
68,68,0,-,424100,22948
592,330,262,448,184400,22949
822,613,209,1086,175100,22952
1150,991,159,588,392400,22958
642,546,96,1000,266200,22959
3780,2201,1579,857,211900,22960
6394,5551,843,1247,232200,22963
113,80,33,-,-,22964
769,547,222,947,211500,22967
3925,3303,622,1021,231300,22968
508,339,169,891,226300,22969
688,494,194,668,174100,22971
148,106,42,-,-,22972
2336,1810,526,800,221500,22973
1577,1351,226,1289,287500,22974
241,137,104,765,239600,22976
13277,8899,4378,837,185700,22980
15,0,15,-,-,22989
3875,3235,640,810,208600,23002
395,329,66,869,100900,23004
6228,4252,1976,1059,268600,23005
2293,2093,200,1419,216900,23009
353,324,29,-,321400,23011
1474,1280,194,1086,288400,23015
100,100,0,-,-,23021
512,360,152,820,157200,23022
186,155,31,-,258300,23023
3241,2834,407,1007,238700,23024
121,90,31,-,440000,23025
511,367,144,1028,177000,23027
1943,1553,390,772,170900,23030
117,71,46,-,213900,23032
497,431,66,1107,276300,23035
686,498,188,1227,175000,23038
423,403,20,-,284600,23039
1702,1333,369,726,134100,23040
839,633,206,1045,347400,23043
73,73,0,-,-,23045
722,587,135,1213,337800,23047
356,356,0,-,261700,23050
315,192,123,1173,190400,23055
175,175,0,-,-,23056
12489,9363,3126,1474,418600,23059
13814,10475,3339,1234,279600,23060
8319,6688,1631,943,228400,23061
1167,684,483,1074,236100,23062
1597,1299,298,1084,192000,23063
111,74,37,-,-,23064
723,634,89,1006,200400,23065
82,82,0,-,328600,23066
103,103,0,-,175300,23068
1068,938,130,1173,231500,23069
188,170,18,-,351100,23070
713,648,65,852,252000,23071
4648,3516,1132,1044,229300,23072
3775,1962,1813,1036,128500,23075
308,249,59,-,282400,23076
107,85,22,-,209800,23079
799,650,149,724,167600,23083
554,463,91,1179,251000,23084
251,235,16,-,130800,23085
1306,1171,135,976,202900,23086
2046,1737,309,1093,281200,23089
55,45,10,-,217500,23091
284,245,39,857,324200,23092
5055,3783,1272,874,193600,23093
1139,1002,137,1346,290600,23102
2146,1936,210,1052,464500,23103
436,375,61,-,180900,23106
78,78,0,-,221100,23108
1027,815,212,847,226300,23109
259,172,87,-,197500,23110
14317,11400,2917,1153,238100,23111
19554,15210,4344,1361,249700,23112
9488,7784,1704,1337,437500,23113
6967,5551,1416,1585,300700,23114
55,55,0,-,99800,23115
10510,9197,1313,1330,304900,23116
3874,3150,724,966,273200,23117
185,185,0,-,-,23119
3032,2901,131,1767,384100,23120
789,595,194,556,113200,23123
1677,1458,219,792,265000,23124
134,134,0,-,121500,23125
100,83,17,-,149400,23126
372,257,115,1125,156200,23128
238,211,27,-,465100,23129
130,110,20,-,303500,23130
257,237,20,-,-,23138
9304,8242,1062,1017,263600,23139
2386,2125,261,886,225800,23140
2517,2147,370,1064,256600,23141
1208,1027,181,1170,341100,23146
787,678,109,827,145900,23148
1117,749,368,765,229000,23149
5115,3701,1414,970,166500,23150
499,402,97,773,324500,23153
670,581,89,-,140200,23156
0,0,0,-,-,23160
76,67,9,-,144800,23161
42,31,11,-,-,23163
2701,2265,436,1216,292100,23168
456,397,59,740,223000,23169
0,0,0,-,-,23173
873,616,257,658,257900,23175
171,171,0,-,218100,23176
210,149,61,-,193400,23177
222,192,30,-,169100,23180
2134,1599,535,891,215200,23181
17433,12199,5234,1204,338400,23185
0,0,0,-,-,23187
17211,12158,5053,1281,323900,23188
2563,2326,237,977,314100,23192
2698,241,2457,1019,233700,23219
13128,4260,8868,1049,274500,23220
7382,3797,3585,1150,388300,23221
9703,4974,4729,965,137900,23222
21211,8963,12248,945,155300,23223
14055,4910,9145,925,115300,23224
17988,7886,10102,974,204500,23225
6979,5313,1666,1374,349400,23226
11721,6300,5421,895,231000,23227
14866,7285,7581,1113,172600,23228
12904,8925,3979,1064,319300,23229
3103,1504,1599,1079,192000,23230
13728,9343,4385,1002,182200,23231
12231,7917,4314,1322,344700,23233
15824,8794,7030,1020,162000,23234
13047,9301,3746,1299,225700,23235
9792,8508,1284,1316,214800,23236
8237,5529,2708,1109,166000,23237
10818,6822,3996,1117,292700,23238
0,0,0,-,-,23250
7614,2666,4948,1169,209200,23294
495,292,203,751,180800,23301
90,41,49,-,-,23302
441,341,100,-,130600,23303
20,20,0,-,-,23304
369,250,119,917,193800,23306
226,75,151,696,-,23307
761,565,196,864,86700,23308
1913,1277,636,882,192500,23310
69,15,54,-,-,23313
3268,2116,1152,1172,300400,23314
556,523,33,863,224700,23315
176,99,77,883,180500,23316
22738,14097,8641,1360,249700,23320
12683,9632,3051,1206,254200,23321
20524,17664,2860,1555,341200,23322
13302,10327,2975,1186,251400,23323
8695,4199,4496,968,168400,23324
6316,4192,2124,1113,214100,23325
1523,1165,358,875,235100,23336
298,167,131,-,220800,23337
293,119,174,638,-,23347
1517,998,519,657,126600,23350
85,85,0,-,396600,23354
556,443,113,831,183600,23356
337,228,109,-,212000,23357
43,22,21,-,-,23358
411,278,133,731,144500,23359
68,68,0,-,-,23389
190,190,0,-,139300,23395
20,14,6,-,-,23398
106,89,17,870,-,23401
411,396,15,-,229100,23405
232,126,106,-,74200,23407
53,21,32,-,-,23408
63,45,18,-,-,23409
687,510,177,821,146400,23410
372,256,116,702,110600,23413
88,28,60,-,-,23414
548,330,218,949,75500,23415
155,101,54,-,-,23416
1631,1242,389,917,255900,23417
435,264,171,807,203000,23418
1048,567,481,694,121000,23420
1451,698,753,796,137000,23421
85,32,53,-,244400,23422
155,126,29,881,205900,23423
40,28,12,-,208800,23426
96,82,14,738,112500,23427
6914,5349,1565,1043,275200,23430
615,566,49,1058,314500,23432
529,453,76,1055,339500,23433
18378,11521,6857,1025,217000,23434
10972,8123,2849,1442,283300,23435
396,374,22,-,283000,23436
1676,1456,220,749,208400,23437
632,508,124,744,250000,23438
215,200,15,-,89700,23440
59,32,27,-,-,23441
372,288,84,824,86200,23442
19992,10047,9945,1272,427100,23451
22509,13840,8669,1259,245200,23452
12403,8567,3836,1257,235100,23453
22512,14701,7811,1329,295600,23454
19759,11756,8003,1430,298000,23455
17694,15541,2153,1793,338900,23456
1629,1331,298,1242,376600,23457
274,0,274,1757,-,23459
0,0,0,-,-,23460
0,0,0,-,-,23461
25266,13716,11550,1340,210100,23462
27224,18959,8265,1361,259700,23464
190,163,27,975,113100,23480
16,16,0,-,-,23486
2225,1688,537,888,181600,23487
163,92,71,-,217000,23488
7941,4255,3686,1176,191900,23502
13610,5553,8057,1019,193200,23503
7658,2514,5144,787,176000,23504
11763,3891,7872,982,230900,23505
3350,1332,2018,1208,409300,23507
6254,2919,3335,1142,312000,23508
5146,2975,2171,1106,188000,23509
3779,839,2940,1257,310500,23510
197,0,197,1752,-,23511
11547,5666,5881,1062,154500,23513
2354,546,1808,1044,254400,23517
12002,6585,5417,1020,214000,23518
2554,954,1600,761,174400,23523
0,0,0,-,-,23551
10519,5501,5018,953,196400,23601
16192,8995,7197,1078,213200,23602
1295,589,706,1128,170100,23603
785,19,766,1631,-,23604
5830,2531,3299,971,143000,23605
11237,5152,6085,1059,244300,23606
8689,3239,5450,828,119800,23607
16004,8397,7607,1039,187500,23608
206,0,206,2591,-,23651
5378,3532,1846,1031,160700,23661
4590,3824,766,1208,326100,23662
5105,2877,2228,1102,154500,23663
4004,2650,1354,1146,212600,23664
1358,26,1332,1696,-,23665
21788,11062,10726,1128,191600,23666
15699,9586,6113,1010,196800,23669
1309,817,492,981,250400,23690
30,5,25,1750,-,23691
7303,5883,1420,1402,324700,23692
8892,6355,2537,1432,350700,23693
1452,1197,255,1672,375200,23696
9091,6122,2969,1096,166500,23701
4205,1628,2577,987,135600,23702
9741,6508,3233,1134,213800,23703
7491,2779,4712,940,144000,23704
5938,2773,3165,905,167200,23707
5,0,5,-,-,23708
0,0,0,-,-,23709
1352,31,1321,1685,220300,23801
15162,7680,7482,915,137500,23803
7467,4404,3063,965,161500,23805
0,0,0,-,-,23806
714,592,122,663,108900,23821
2385,1482,903,754,141600,23824
646,420,226,550,128900,23827
107,85,22,722,144900,23828
382,340,42,440,159400,23829
432,393,39,557,205400,23830
13652,9580,4072,1248,225000,23831
11913,10284,1629,1310,221700,23832
852,691,161,913,185800,23833
9812,6615,3197,1020,170000,23834
4944,3581,1363,1337,226100,23836
1772,1263,509,759,191300,23837
5803,5525,278,1738,334500,23838
298,242,56,925,152300,23839
864,809,55,1250,149800,23840
1382,1153,229,975,187900,23841
2395,1969,426,774,220500,23842
286,195,91,-,121900,23843
260,130,130,-,84000,23844
226,162,64,-,-,23845
446,361,85,819,163300,23846
5113,2998,2115,720,107800,23847
467,441,26,-,135800,23850
5507,3209,2298,866,172000,23851
417,290,127,-,117900,23856
249,147,102,-,184000,23857
10898,5983,4915,884,132700,23860
870,625,245,696,197600,23866
967,662,305,804,97700,23867
2065,1347,718,603,108200,23868
1110,818,292,926,140600,23872
389,291,98,919,161900,23874
4184,2721,1463,1131,212400,23875
122,115,7,-,86700,23876
419,316,103,607,171400,23878
267,220,47,-,78500,23879
893,611,282,639,220200,23881
843,693,150,930,113800,23882
822,712,110,989,223700,23883
9,9,0,-,-,23884
973,794,179,947,199800,23885
169,111,58,-,216300,23887
1037,569,468,773,121300,23888
271,238,33,975,83800,23889
1617,1075,542,936,148400,23890
0,0,0,-,-,23891
123,123,0,-,149300,23893
148,92,56,-,174000,23894
221,185,36,-,-,23897
828,764,64,1117,246100,23898
146,118,28,825,125000,23899
5734,3533,2201,857,168300,23901
0,0,0,-,-,23909
249,214,35,-,147600,23915
1133,878,255,425,120700,23917
1031,861,170,869,213400,23919
1291,1006,285,832,121100,23920
711,517,194,711,116600,23921
1073,608,465,761,133200,23922
1062,932,130,537,141500,23923
2224,1608,616,552,110000,23924
1721,1345,376,678,187300,23927
2292,1510,782,832,133300,23930
137,55,82,-,-,23934
2397,1781,616,748,136900,23936
633,374,259,673,101000,23937
186,162,24,-,86200,23938
595,508,87,-,124300,23942
30,30,0,-,-,23943
1331,915,416,733,121500,23944
1455,914,541,642,115300,23947
1265,824,441,783,107500,23950
106,98,8,-,144800,23952
655,514,141,857,99100,23954
1230,896,334,803,154800,23958
560,392,168,593,77400,23959
559,442,117,-,113400,23960
243,166,77,-,102200,23962
78,78,0,-,-,23963
472,364,108,646,86700,23964
842,568,274,758,186000,23966
384,325,59,489,86200,23967
242,201,41,-,-,23968
3104,1679,1425,728,152000,23970
1643,1077,566,667,114500,23974
53,14,39,-,-,23976
329,31,298,954,765600,24011
12016,6817,5199,803,133900,24012
3157,1477,1680,820,83300,24013
7526,5101,2425,825,172900,24014
6877,3845,3032,775,170600,24015
4150,1131,3019,746,123900,24016
9376,4846,4530,805,108600,24017
16151,11114,5037,961,220700,24018
11121,8637,2484,1008,180800,24019
36,0,36,-,-,24020
1269,1013,256,752,117400,24053
2647,2189,458,569,94800,24054
5370,3941,1429,547,88300,24055
76,61,15,-,99100,24058
379,326,53,-,217700,24059
18185,7549,10636,1034,297400,24060
1887,1638,249,802,185900,24064
2910,2356,554,745,189900,24065
2181,1761,420,742,153500,24066
936,733,203,764,180900,24067
839,681,158,758,108600,24069
635,546,89,818,239800,24070
431,407,24,-,164300,24072
12765,8453,4312,881,190600,24073
481,317,164,585,157300,24076
344,278,66,910,166400,24077
3029,1709,1320,651,111400,24078
757,543,214,597,149300,24079
252,174,78,631,118000,24082
1367,1034,333,991,282200,24083
4405,3280,1125,675,147100,24084
870,783,87,573,145800,24085
107,79,28,-,73200,24086
1532,1243,289,705,116200,24087
1568,1275,293,709,118600,24088
1034,839,195,733,81000,24089
1834,1555,279,1060,260900,24090
3245,2581,664,702,189700,24091
1178,911,267,710,141100,24092
60,42,18,700,162500,24093
1996,1695,301,927,181500,24095
2612,2286,326,847,200000,24101
704,624,80,326,158100,24102
1384,1213,171,672,270600,24104
140,120,20,-,191400,24105
12939,8701,4238,636,96100,24112
650,553,97,541,116000,24120
4628,3998,630,936,256500,24121
649,623,26,-,134700,24122
1938,1476,462,746,94900,24124
1767,1226,541,552,160700,24127
891,789,102,814,184200,24128
9,9,0,-,-,24130
26,0,26,-,-,24131
249,60,189,488,66100,24132
980,822,158,489,88200,24133
2049,1597,452,679,122700,24134
1377,1124,253,748,126300,24136
1280,1090,190,583,218600,24137
737,621,116,977,187800,24138
234,234,0,-,156400,24139
8781,5420,3361,743,169700,24141
0,0,0,-,-,24142
489,263,226,584,126700,24147
3244,2560,684,604,111400,24148
1343,1184,159,1138,201800,24149
364,289,75,667,125900,24150
8207,5671,2536,740,138300,24151
14628,10608,4020,930,185200,24153
204,109,95,772,156300,24161
887,524,363,704,171500,24162
590,395,195,563,113000,24165
121,87,34,-,100800,24167
146,97,49,-,85200,24168
3644,2705,939,493,123200,24171
1155,1041,114,-,110600,24174
3127,2789,338,842,249500,24175
601,591,10,-,414200,24176
7670,5425,2245,789,166700,24179
1765,1651,114,679,224100,24184
246,230,16,-,137500,24185
7132,4172,2960,698,108900,24201
4757,3947,810,718,136600,24202
7301,4696,2605,686,138500,24210
4080,3429,651,709,198000,24211
1122,753,369,540,53100,24216
146,108,38,-,56900,24217
4184,2762,1422,639,114200,24219
286,270,16,-,80300,24220
229,211,18,-,116000,24221
2533,1876,657,576,79600,24224
677,566,111,498,70000,24225
552,467,85,706,86000,24226
2520,1985,535,581,78200,24228
3337,2084,1253,598,82200,24230
1276,880,396,610,104300,24236
409,287,122,742,63900,24237
77,77,0,-,82900,24239
674,535,139,773,95000,24243
2172,1623,549,366,86600,24244
343,228,115,470,72200,24245
270,131,139,-,84800,24246
964,794,170,418,94900,24248
593,519,74,-,79300,24250
3344,2612,732,558,92900,24251
1439,912,527,394,63300,24256
721,577,144,482,111900,24258
2118,1676,442,494,82800,24260
2436,1536,900,531,88200,24263
315,230,85,610,31500,24265
3588,2574,1014,550,129900,24266
111,79,32,625,126300,24269
291,202,89,-,79300,24270
1038,842,196,597,114400,24271
284,180,104,-,80200,24272
2740,1545,1195,559,75600,24273
2296,1470,826,534,85100,24277
1875,1399,476,676,78800,24279
352,310,42,-,157000,24280
1042,772,270,603,79300,24281
305,223,82,463,50500,24282
1003,744,259,437,84800,24283
784,509,275,619,108400,24290
202,182,20,-,78600,24292
3667,2483,1184,675,108600,24293
6105,4109,1996,628,111600,24301
772,545,227,826,74700,24311
777,552,225,655,89800,24312
310,269,41,-,64700,24313
667,521,146,-,83800,24314
1216,954,262,668,118900,24315
0,0,0,-,-,24316
1565,1351,214,579,105800,24317
273,253,20,-,-,24318
2859,2124,735,619,118500,24319
61,39,22,-,-,24322
354,267,87,-,137500,24323
637,585,52,-,162000,24324
377,254,123,528,110000,24325
561,501,60,-,104500,24326
846,757,89,-,98200,24328
1234,925,309,552,89900,24330
7183,5286,1897,626,102300,24333
2185,1679,506,736,135400,24340
3827,2812,1015,508,119700,24343
743,523,220,641,179900,24347
1705,1225,480,481,97900,24348
565,468,97,-,76500,24350
256,150,106,-,56600,24351
464,389,75,-,109700,24352
5985,3987,1998,575,97200,24354
2287,1915,372,674,107300,24360
2083,1750,333,704,120900,24361
638,541,97,-,111900,24363
275,253,22,-,116800,24366
2164,1657,507,660,131800,24368
2727,2075,652,544,73400,24370
308,251,57,582,87400,24374
685,496,189,470,75800,24375
160,144,16,-,138900,24377
526,481,45,731,93100,24378
1115,970,145,-,153600,24380
1654,1239,415,567,111000,24381
5938,4252,1686,639,156700,24382
15201,9583,5618,822,183600,24401
36,36,0,-,-,24411
11,11,0,-,-,24412
85,80,5,-,184400,24413
16,16,0,-,-,24415
3452,2516,936,746,123000,24416
1699,1509,190,829,219800,24421
2560,1758,802,678,98000,24422
5961,4691,1270,630,104100,24426
660,441,219,528,136100,24430
1017,890,127,702,97500,24431
128,83,45,-,189600,24432
34,23,11,-,152500,24433
853,720,133,696,221900,24435
328,260,68,-,225000,24437
464,376,88,783,160900,24439
1171,886,285,1127,172000,24440
2604,2029,575,910,170900,24441
46,35,11,-,-,24442
1310,941,369,508,147400,24445
113,95,18,638,65000,24448
5709,3898,1811,786,265100,24450
126,93,33,-,-,24457
209,178,31,-,137500,24458
237,237,0,-,239900,24459
613,477,136,393,168100,24460
67,46,21,-,237500,24464
717,572,145,570,198600,24465
844,787,57,531,226900,24467
702,547,155,691,194300,24471
839,520,319,679,272500,24472
462,366,96,-,273300,24473
181,162,19,-,74900,24474
88,88,0,-,216100,24476
4451,3263,1188,961,203100,24477
661,575,86,842,298500,24479
2002,1580,422,837,186800,24482
266,210,56,828,178100,24483
250,234,16,-,140000,24484
132,132,0,-,131300,24485
1342,929,413,1000,237800,24486
141,106,35,-,165400,24487
10179,4795,5384,755,114400,24501
16121,8690,7431,912,163000,24502
7731,5582,2149,860,232600,24503
3882,2076,1806,773,133700,24504
2159,1461,698,669,120400,24517
1034,876,158,559,78900,24520
3853,3200,653,713,172000,24521
3744,2810,934,714,152800,24522
8137,5862,2275,772,170200,24523
577,544,33,483,175900,24526
1328,1095,233,629,129200,24527
1297,868,429,753,97100,24528
765,577,188,1019,149400,24529
543,407,136,577,95400,24530
3349,2448,901,654,120000,24531
570,443,127,720,127500,24534
76,76,0,-,170500,24536
2023,1791,232,675,157700,24538
78,53,25,-,-,24539
13734,8135,5599,668,103400,24540
12195,7074,5121,658,108100,24541
1595,1144,451,735,123600,24549
3187,2647,540,702,156000,24550
9353,7633,1720,929,251400,24551
632,479,153,796,114200,24553
1593,1316,277,666,110600,24554
882,622,260,646,143400,24555
1176,995,181,828,238200,24556
3510,2706,804,596,97400,24557
2664,2023,641,593,124200,24558
187,153,34,-,158800,24562
2454,1766,688,683,104900,24563
409,322,87,512,89000,24565
521,439,82,847,86400,24566
398,349,49,-,107300,24569
6,0,6,-,-,24570
835,725,110,664,140900,24571
6456,4721,1735,745,143800,24572
1481,1256,225,808,155900,24574
1939,1556,383,695,94000,24577
396,318,78,658,222700,24578
498,445,53,1292,120300,24579
222,163,59,-,102600,24580
44,44,0,-,-,24581
2303,1715,588,864,111700,24586
3780,2955,825,717,144500,24588
1037,863,174,563,124800,24589
2913,2033,880,1000,187100,24590
5337,3566,1771,663,117300,24592
745,592,153,633,155000,24593
653,448,205,739,112000,24594
46,26,20,-,-,24595
427,360,67,870,123900,24597
646,506,140,707,123900,24598
349,298,51,-,113500,24599
14,14,0,-,-,24601
299,270,29,-,85900,24602
355,333,22,-,55200,24603
132,94,38,670,40400,24604
3695,2792,903,638,100200,24605
66,58,8,-,-,24606
140,124,16,-,129200,24607
2922,2279,643,671,107100,24609
105,76,29,545,-,24612
292,243,49,-,66500,24613
3061,2297,764,619,78100,24614
1095,993,102,661,47100,24620
425,316,109,536,62100,24622
105,81,24,-,65900,24628
2703,2166,537,685,98500,24630
835,509,326,638,67300,24631
215,183,32,-,86700,24634
237,150,87,350,60700,24635
1489,1243,246,759,116000,24637
1265,967,298,727,75500,24639
2448,1603,845,644,82200,24641
319,263,56,332,56600,24646
1142,874,268,616,77900,24649
2126,1593,533,621,115900,24651
1163,955,208,710,80000,24656
133,96,37,768,76500,24657
8279,5577,2702,639,79800,24701
638,488,150,690,115800,24712
134,128,6,-,86500,24714
191,176,15,539,61000,24715
185,185,0,-,17900,24716
13,13,0,-,-,24719
40,32,8,550,109600,24724
251,167,84,-,-,24726
87,46,41,-,-,24729
106,91,15,-,62900,24731
287,228,59,-,102100,24733
211,185,26,680,57900,24736
50,11,39,-,-,24737
104,80,24,-,125000,24738
12842,9158,3684,652,110300,24740
1064,791,273,480,63500,24747
1435,1071,364,527,55400,24801
236,200,36,570,50600,24808
251,209,42,-,22400,24811
96,73,23,-,-,24813
280,206,74,544,41600,24815
80,80,0,-,-,24816
325,268,57,634,37900,24817
370,314,56,622,67500,24818
303,239,64,-,91300,24822
170,135,35,-,59300,24823
48,48,0,-,-,24826
511,405,106,-,76300,24827
337,259,78,409,20400,24828
76,50,26,-,26000,24830
67,60,7,-,56000,24831
162,141,21,-,56300,24834
215,189,26,-,41900,24836
729,636,93,726,53600,24839
33,20,13,-,-,24843
635,510,125,500,46200,24844
101,73,28,-,-,24845
23,23,0,-,-,24846
102,102,0,-,-,24847
68,54,14,-,24000,24848
86,86,0,-,160700,24849
265,180,85,588,28200,24850
225,213,12,-,57200,24851
168,131,37,-,-,24853
85,35,50,835,-,24854
375,274,101,696,71300,24857
131,131,0,-,79900,24860
60,18,42,-,-,24861
287,259,28,-,-,24862
89,83,6,-,40500,24866
177,138,39,-,45900,24867
523,382,141,550,32100,24868
217,149,68,-,-,24869
1181,960,221,804,61700,24870
84,63,21,-,46900,24871
269,269,0,-,24800,24872
247,162,85,-,54800,24873
1235,1003,232,717,81300,24874
228,155,73,487,-,24878
280,280,0,-,19000,24879
84,45,39,-,-,24880
169,127,42,-,39800,24881
101,101,0,-,48800,24882
110,100,10,-,20600,24884
10,10,0,-,-,24887
39,39,0,-,46000,24888
575,455,120,522,33200,24892
138,132,6,-,-,24894
31,31,0,-,-,24898
4464,2859,1605,767,172700,24901
1935,1434,501,614,89900,24910
271,257,14,-,123500,24915
284,258,26,-,131300,24916
799,603,196,541,104700,24918
108,88,20,-,65700,24920
205,173,32,-,138700,24924
315,200,115,773,190500,24925
103,94,9,-,109000,24927
528,437,91,-,111000,24931
195,164,31,-,170500,24934
228,228,0,-,99200,24935
587,517,70,-,156300,24938
352,269,83,806,84500,24941
179,140,39,-,138900,24944
149,149,0,-,180700,24945
525,384,141,719,113700,24946
690,562,128,-,129000,24951
1619,1329,290,610,122800,24954
118,118,0,-,215100,24957
16,16,0,-,-,24962
1608,1218,390,621,108700,24963
664,573,91,460,108100,24966
2030,1407,623,670,105600,24970
152,129,23,-,100300,24974
508,433,75,-,151400,24976
227,164,63,-,-,24977
209,136,73,-,79400,24981
1130,955,175,436,105800,24983
91,82,9,-,313000,24984
2198,1508,690,656,91500,24986
305,283,22,-,143900,24991
0,0,0,-,-,25002
1057,768,289,813,111900,25003
68,62,6,-,-,25005
218,209,9,-,59900,25007
59,43,16,-,59100,25008
458,427,31,-,57100,25009
248,170,78,598,87500,25011
1772,1390,382,633,92600,25015
234,168,66,737,-,25019
94,29,65,617,-,25021
177,163,14,-,-,25022
147,91,56,489,108400,25024
62,62,0,-,-,25025
154,119,35,-,-,25028
106,106,0,-,52300,25030
264,157,107,-,67100,25031
789,659,130,475,88200,25033
381,309,72,619,47400,25035
92,65,27,-,-,25036
334,267,67,689,59000,25039
206,178,28,-,88100,25040
526,424,102,430,107100,25043
101,77,24,-,86200,25044
1997,1581,416,662,101000,25045
63,47,16,-,47500,25047
33,33,0,-,57700,25048
186,152,34,-,64200,25049
95,73,22,-,81700,25051
1722,1140,582,806,82500,25053
151,129,22,-,70800,25054
155,155,0,-,58300,25057
207,196,11,-,68900,25059
199,143,56,-,34600,25060
279,247,32,-,59500,25061
77,77,0,-,46800,25062
665,565,100,540,86200,25063
4504,2552,1952,785,93300,25064
423,373,50,675,87400,25067
622,490,132,771,140200,25070
4618,3606,1012,724,120500,25071
290,201,89,-,42900,25075
144,95,49,475,-,25076
380,380,0,-,105200,25081
536,405,131,670,170500,25082
257,244,13,-,80200,25083
398,234,164,598,63900,25085
276,244,32,703,86200,25086
67,59,8,-,-,25088
88,70,18,-,68200,25090
93,93,0,-,50400,25093
62,47,15,-,53900,25102
60,41,19,-,46500,25103
245,164,81,393,54000,25106
256,208,48,-,55300,25107
207,151,56,-,84400,25108
200,174,26,-,92400,25109
205,162,43,837,75000,25110
259,194,65,-,67900,25111
0,0,0,-,-,25112
313,280,33,-,93600,25113
172,98,74,828,74300,25114
47,47,0,-,45900,25115
323,307,16,-,72600,25118
66,39,27,-,64200,25119
240,78,162,-,-,25121
1392,1141,251,657,79600,25123
608,513,95,-,74500,25124
315,256,59,-,71200,25125
12,12,0,-,-,25126
1373,953,420,596,89900,25130
45,45,0,-,-,25132
363,252,111,385,85000,25133
126,98,28,-,57600,25134
688,258,430,495,72000,25136
150,150,0,-,123900,25139
503,409,94,-,42500,25140
71,49,22,-,97500,25141
178,142,36,-,70700,25142
3512,2454,1058,798,105200,25143
184,162,22,-,50000,25148
124,115,9,-,50200,25149
122,103,19,-,46700,25152
259,212,47,-,93100,25154
116,103,13,-,-,25156
1994,1659,335,883,125500,25159
44,44,0,-,-,25160
172,151,21,-,86000,25161
164,126,38,685,105800,25162
499,416,83,-,99400,25164
305,247,58,673,124200,25165
940,861,79,-,109700,25168
201,153,48,-,-,25169
175,96,79,-,46500,25173
215,208,7,-,35000,25174
9621,7102,2519,702,103100,25177
42,42,0,-,-,25180
502,449,53,615,53400,25181
19,19,0,-,-,25183
0,0,0,-,-,25185
416,267,149,564,88600,25186
287,239,48,-,56100,25187
244,171,73,588,33000,25193
17,0,17,-,-,25201
515,449,66,366,121500,25202
28,10,18,-,-,25203
63,33,30,-,24100,25204
204,191,13,-,68400,25205
204,148,56,-,51200,25206
349,298,51,-,53300,25208
510,362,148,526,49500,25209
71,71,0,-,"10,000-",25211
2442,2153,289,826,174200,25213
204,161,43,-,55100,25214
381,312,69,603,78300,25234
467,349,118,608,60200,25235
725,616,109,904,131500,25239
668,609,59,-,118800,25241
242,165,77,925,87500,25243
200,200,0,-,61100,25244
256,243,13,-,156300,25245
274,198,76,663,73200,25247
1113,1043,70,-,174400,25248
114,96,18,-,123500,25251
503,473,30,-,143900,25252
836,678,158,455,98700,25253
240,231,9,-,120300,25259
675,498,177,492,73800,25260
100,77,23,-,-,25261
383,365,18,-,104000,25262
111,69,42,-,-,25264
649,501,148,648,77400,25265
263,203,60,279,82100,25266
252,221,31,-,49600,25267
307,268,39,-,64300,25268
323,289,34,543,103200,25270
3828,2581,1247,644,120700,25271
795,768,27,-,124400,25275
3258,2296,962,496,84800,25276
167,158,9,-,126700,25285
555,440,115,448,121900,25286
299,287,12,-,54700,25287
1558,325,1233,575,139900,25301
6795,4005,2790,699,112600,25302
3158,2161,997,718,143300,25303
3365,2147,1218,744,186500,25304
0,0,0,-,-,25305
2983,1880,1103,844,78500,25306
5454,4093,1361,664,121900,25309
4934,2491,2443,676,104800,25311
6304,4338,1966,782,96400,25312
5154,3765,1389,838,135600,25313
5852,4744,1108,859,202700,25314
1450,986,464,718,70800,25315
2585,2098,487,687,88500,25320
5946,2800,3146,946,148900,25401
4821,4074,747,1157,228900,25403
8428,5744,2684,988,160600,25404
4648,3558,1090,870,166400,25405
5349,4311,1038,716,197800,25411
3304,2671,633,1072,174000,25413
6865,5232,1633,966,252800,25414
4250,3348,902,959,188200,25419
1571,1372,199,810,193700,25420
703,559,144,847,128700,25422
4919,4017,902,1173,228200,25425
5580,4641,939,980,191100,25427
4708,4003,705,1013,163800,25428
3155,2416,739,855,226200,25430
110,86,24,-,88000,25431
78,53,25,-,76200,25432
985,667,318,705,97900,25434
117,94,23,-,165400,25437
2598,1506,1092,1012,175700,25438
698,552,146,923,208000,25442
2797,2035,762,1052,288700,25443
106,75,31,-,291000,25444
504,387,117,1442,339000,25446
523,439,84,-,106600,25501
505,394,111,-,74400,25502
514,385,129,643,100100,25503
5380,3781,1599,789,145300,25504
136,105,31,-,-,25505
1972,1402,570,486,68900,25506
336,243,93,816,101500,25507
3914,3056,858,645,104100,25508
1959,1468,491,802,133800,25510
372,316,56,-,69100,25511
377,302,75,-,105000,25512
1424,1059,365,650,86100,25514
903,766,137,561,82200,25515
771,544,227,531,59700,25517
633,513,120,-,65000,25520
303,250,53,-,108100,25521
1163,767,396,535,87200,25523
1153,963,190,578,62300,25524
8495,6872,1623,837,188000,25526
330,259,71,619,73100,25529
2150,1523,627,655,102500,25530
103,58,45,421,-,25534
956,857,99,-,114800,25535
689,599,90,946,108200,25537
77,56,21,-,33500,25540
3979,2926,1053,713,149900,25541
1785,1582,203,781,155600,25545
479,393,86,-,101800,25547
3492,2756,736,523,83800,25550
662,487,175,827,117500,25555
634,467,167,458,39100,25557
648,601,47,-,119100,25559
3081,2485,596,944,208500,25560
393,336,57,769,158600,25564
235,216,19,-,73200,25565
274,267,7,-,107700,25567
2402,1635,767,545,93300,25570
817,677,140,736,84100,25571
400,338,62,-,109400,25573
2180,1402,778,691,93000,25601
514,415,99,805,87400,25606
449,300,149,-,58000,25607
452,383,69,529,55600,25608
323,223,100,809,55100,25611
282,250,32,-,137500,25617
828,619,209,611,52800,25621
92,92,0,-,102500,25624
483,363,120,601,83400,25625
129,98,31,-,64900,25628
248,192,56,773,65000,25630
164,103,61,-,73800,25632
130,57,73,589,57000,25634
570,435,135,605,110800,25635
343,232,111,547,73600,25637
371,314,57,-,102300,25638
178,140,38,-,104000,25639
191,148,43,-,152100,25644
505,407,98,615,76800,25646
324,176,148,597,104200,25647
623,469,154,713,106600,25649
167,167,0,-,67200,25650
402,330,72,-,75800,25651
569,408,161,701,89700,25652
155,90,65,-,97800,25653
81,71,10,-,59000,25654
2740,1748,992,615,84100,25661
253,214,39,-,62700,25666
465,400,65,-,33700,25669
2234,1745,489,662,91600,25670
526,373,153,708,69000,25671
162,125,37,-,-,25672
1196,817,379,525,74700,25674
477,387,90,434,75000,25676
698,511,187,264,75500,25678
123,123,0,-,81300,25688
119,106,13,-,77300,25690
473,296,177,621,57600,25692
92,57,35,-,68000,25696
38,38,0,-,-,25699
9840,5318,4522,696,122400,25701
3144,1851,1293,613,76800,25702
2017,485,1532,735,65600,25703
6677,4510,2167,689,97700,25704
9331,5981,3350,787,123900,25705
13640,9491,4149,694,114000,25801
83,83,0,-,56700,25810
31,13,18,-,-,25811
698,550,148,668,82700,25812
2535,1818,717,735,100900,25813
394,310,84,-,-,25817
216,42,174,703,-,25818
213,177,36,-,69400,25820
999,799,200,-,82000,25823
950,861,89,-,130300,25825
156,156,0,-,53300,25826
949,816,133,716,95000,25827
711,613,98,648,87900,25831
1646,1342,304,942,172500,25832
241,158,83,-,57500,25836
107,107,0,-,129800,25837
300,106,194,-,-,25839
3473,2905,568,757,105400,25840
169,160,9,-,116200,25841
371,289,82,-,138700,25843
540,358,182,533,108400,25844
216,182,34,-,43200,25845
148,129,19,-,158500,25846
118,104,14,-,95700,25848
110,110,0,-,-,25849
13,0,13,-,-,25853
420,348,72,883,126900,25854
12,12,0,-,-,25855
29,15,14,-,-,25857
38,38,0,-,-,25862
127,127,0,-,101300,25864
528,455,73,1043,80600,25865
173,173,0,-,85900,25868
14,14,0,-,-,25870
311,211,100,734,66300,25871
243,243,0,-,116000,25873
245,222,23,-,-,25875
40,40,0,-,-,25876
357,329,28,-,99900,25878
111,98,13,-,-,25879
2725,1852,873,515,87300,25880
856,681,175,606,66300,25882
4744,3501,1243,638,96100,25901
50,45,5,-,40900,25902
174,151,23,-,92300,25904
198,150,48,-,89000,25906
20,20,0,-,-,25907
50,50,0,-,-,25908
21,11,10,-,-,25911
95,95,0,-,109700,25913
76,41,35,-,14200,25915
68,39,29,-,-,25916
814,711,103,831,99100,25917
1930,1702,228,725,154100,25918
83,65,18,-,-,25920
909,554,355,728,57200,25921
84,60,24,-,-,25922
223,200,23,-,-,25928
143,121,22,-,93600,25932
10,3,7,-,-,25936
539,512,27,-,94400,25938
66,66,0,-,26500,25942
2656,1831,825,691,111400,25951
305,205,100,668,57400,25958
1493,1122,371,486,89400,25962
471,421,50,630,74600,25969
394,304,90,622,160500,25971
77,51,26,-,46700,25972
1142,973,169,472,75200,25976
91,91,0,-,72500,25977
257,177,80,610,141500,25978
353,277,76,594,116800,25979
200,126,74,615,49500,25981
567,359,208,538,78300,25984
240,173,67,725,101000,25985
85,72,13,-,-,25989
16933,11785,5148,658,119900,26003
234,176,58,773,50300,26030
702,431,271,486,65100,26031
187,148,39,557,112500,26032
997,912,85,831,98000,26033
2110,1427,683,713,89200,26034
940,832,108,645,105800,26035
158,139,19,-,206100,26036
2783,2131,652,575,86100,26037
1300,1098,202,654,166000,26038
299,217,82,531,145200,26039
812,525,287,720,74700,26040
6093,4841,1252,609,96200,26041
2504,2125,379,545,96400,26047
720,429,291,607,37900,26050
526,430,96,902,115900,26055
46,46,0,-,-,26056
1033,834,199,938,122500,26059
788,646,142,695,142700,26060
9064,6125,2939,689,95700,26062
3853,2946,907,577,95500,26070
211,149,62,535,113400,26074
146,126,20,817,51400,26075
12523,7507,5016,677,86900,26101
7144,4906,2238,715,122500,26104
5122,3759,1363,705,132800,26105
580,527,53,596,109000,26133
432,301,131,554,97100,26134
299,296,3,-,-,26136
235,206,29,-,74000,26137
56,31,25,-,-,26138
130,120,10,-,-,26141
1005,758,247,635,122200,26142
2022,1639,383,512,88400,26143
311,256,55,430,95700,26146
830,611,219,722,86100,26147
108,90,18,-,82200,26148
802,660,142,651,95100,26149
2385,1926,459,833,168100,26150
269,219,50,-,78300,26151
32,4,28,-,-,26152
3023,2442,581,691,111900,26155
1224,936,288,745,88000,26159
346,320,26,-,88900,26160
167,167,0,-,-,26161
3034,2222,812,759,102300,26164
359,348,11,-,99600,26167
230,213,17,-,114700,26169
2277,1801,476,649,108700,26170
1353,1041,312,620,99000,26175
163,130,33,-,80700,26178
943,791,152,818,122800,26180
2541,2242,299,734,156500,26181
893,746,147,781,140300,26184
2733,2412,321,786,148800,26187
7536,5416,2120,674,129700,26201
203,203,0,-,83400,26202
55,55,0,-,-,26203
1328,983,345,575,88700,26205
1359,901,458,437,58800,26206
375,348,27,-,62000,26208
102,37,65,924,-,26209
19,19,0,-,-,26215
142,52,90,-,-,26217
1060,998,62,-,89000,26218
232,173,59,-,73000,26222
110,97,13,-,83400,26224
18,18,0,-,-,26228
39,39,0,-,27300,26230
607,532,75,-,74700,26234
16,16,0,-,-,26236
233,184,49,-,63700,26237
368,269,99,-,86600,26238
5742,3492,2250,595,122300,26241
1812,1400,412,576,93200,26250
1522,992,530,688,145000,26253
137,82,55,-,-,26254
494,468,26,762,87300,26257
23,23,0,-,-,26259
689,572,117,658,208900,26260
1097,802,295,542,42200,26261
142,142,0,-,223900,26263
218,196,22,558,79500,26264
67,44,23,-,-,26266
72,62,10,-,193300,26267
18,18,0,-,-,26268
429,315,114,526,100400,26269
257,214,43,717,89200,26270
161,147,14,675,113100,26271
275,210,65,617,90000,26273
219,143,76,493,60700,26275
107,107,0,-,55700,26276
257,249,8,-,63200,26278
682,520,162,621,63400,26280
14,14,0,-,-,26282
676,546,130,1018,119900,26283
200,200,0,-,82000,26285
1342,1056,286,481,90300,26287
1514,1092,422,589,75000,26288
54,54,0,-,-,26291
282,218,64,-,95600,26292
242,208,34,-,73700,26293
457,411,46,-,84300,26294
42,42,0,-,-,26296
51,51,0,-,126300,26298
11862,7645,4217,702,89200,26301
288,261,27,-,95000,26320
132,121,11,-,-,26321
180,108,72,740,71500,26323
125,105,20,480,64600,26325
21,21,0,-,-,26327
6025,4542,1483,945,199900,26330
600,450,150,563,83200,26335
472,404,68,485,78100,26337
311,225,86,380,86300,26338
65,53,12,-,177600,26339
100,76,24,-,98900,26342
127,90,37,-,114700,26343
392,351,41,-,105500,26346
817,636,181,640,136400,26347
47,22,25,-,-,26348
21,21,0,-,-,26349
1391,808,583,541,97400,26351
4285,3312,973,571,89600,26354
97,97,0,-,30200,26361
1332,977,355,584,102800,26362
13,13,0,-,-,26366
329,225,104,674,80800,26369
316,272,44,-,167600,26372
505,468,37,736,139300,26374
256,184,72,-,62400,26376
167,144,23,-,88500,26377
1628,1304,324,767,161100,26378
269,269,0,-,74100,26384
1514,1361,153,634,126600,26385
876,708,168,725,86700,26386
179,130,49,-,-,26404
441,397,44,-,-,26405
1115,975,140,865,163400,26408
393,302,91,798,89200,26410
222,160,62,-,130000,26411
239,221,18,-,63400,26412
1207,943,264,415,87700,26415
3306,2135,1171,529,115000,26416
467,376,91,679,102600,26419
56,50,6,-,-,26421
167,79,88,904,-,26422
77,77,0,-,71000,26424
502,435,67,566,63300,26425
2637,2238,399,708,106900,26426
132,110,22,-,-,26430
2354,1897,457,655,103300,26431
72,58,14,-,62500,26435
91,49,42,-,88600,26436
160,140,20,260,75000,26437
105,72,33,-,45500,26438
450,340,110,643,97400,26440
133,133,0,-,92800,26443
1373,1249,124,592,74100,26444
538,371,167,634,68500,26447
577,538,39,-,89200,26448
292,252,40,796,128600,26451
3694,2426,1268,647,91600,26452
1361,1172,189,498,113600,26456
8290,5043,3247,763,164900,26501
14882,5070,9812,845,203700,26505
12104,8935,3169,855,230100,26508
750,593,157,706,75000,26519
405,405,0,-,150500,26520
82,65,17,611,94100,26521
2002,1662,340,719,160100,26525
990,594,396,664,76700,26534
2012,1448,564,669,120800,26537
994,811,183,775,103700,26541
1026,918,108,584,105100,26542
62,19,43,-,-,26543
1078,899,179,687,113700,26547
17052,12288,4764,768,125700,26554
522,441,81,738,128500,26559
103,86,17,-,-,26560
230,188,42,-,-,26562
245,154,91,-,50000,26563
281,205,76,754,80800,26568
1340,1205,135,638,96000,26570
839,689,150,638,67700,26571
61,61,0,-,43300,26572
274,203,71,758,63400,26574
301,203,98,528,92500,26575
255,242,13,-,84200,26576
284,212,72,-,54800,26581
1745,1416,329,518,83200,26582
179,165,14,-,141500,26585
112,112,0,-,85200,26586
162,120,42,-,-,26587
1094,900,194,696,130800,26588
245,216,29,875,94100,26590
499,464,35,525,121800,26591
1816,1414,402,574,104900,26601
397,361,36,-,100200,26610
79,52,27,-,272400,26611
65,65,0,-,93100,26615
69,69,0,-,87300,26617
141,127,14,-,165100,26619
282,201,81,541,-,26621
478,363,115,636,169800,26623
1115,911,204,502,94900,26624
158,95,63,-,-,26627
177,164,13,-,51700,26629
99,73,26,-,-,26631
196,162,34,-,104200,26636
38,31,7,-,-,26638
4049,3005,1044,570,110800,26651
183,128,55,-,46400,26656
179,147,32,-,67000,26660
471,432,39,-,123100,26662
183,183,0,-,79000,26676
432,362,70,575,156300,26678
850,722,128,1035,151100,26679
127,105,22,-,80900,26680
518,469,49,-,95200,26681
74,64,10,-,90600,26684
245,238,7,-,48500,26690
151,111,40,-,17400,26691
2004,1569,435,498,140100,26704
274,226,48,-,117300,26705
104,83,21,623,83800,26707
780,631,149,601,155000,26710
1085,787,298,775,165700,26711
227,141,86,-,-,26714
262,238,24,-,104000,26716
424,243,181,445,76900,26717
1271,960,311,701,157700,26719
49,49,0,-,-,26720
364,267,97,619,146100,26722
5259,3876,1383,621,122200,26726
151,151,0,-,151400,26731
401,343,58,-,100200,26739
509,455,54,-,181800,26743
331,151,180,438,48900,26750
2396,1626,770,707,153200,26753
324,312,12,-,168300,26755
2849,1897,952,605,135000,26757
238,175,63,-,159900,26761
681,458,223,660,116800,26763
1720,1415,305,442,92000,26764
322,204,118,775,78900,26767
382,318,64,589,95000,26801
517,323,194,547,122400,26802
262,243,19,-,86800,26804
1245,1036,209,543,133200,26807
383,228,155,660,-,26808
189,140,49,-,260700,26810
576,487,89,561,148200,26812
152,123,29,529,108800,26814
343,314,29,-,144900,26815
142,112,30,-,-,26817
362,282,80,690,78500,26818
155,72,83,-,201400,26823
704,634,70,572,187500,26833
2867,1760,1107,745,114300,26836
312,261,51,-,155800,26845
2670,1999,671,564,126200,26847
669,554,115,678,127200,26851
340,242,98,616,152000,26852
275,219,56,616,143800,26855
132,96,36,-,-,26865
281,234,47,-,170000,26866
336,270,66,475,107900,26884
5781,5057,724,870,228900,27006
859,784,75,558,113900,27007
998,956,42,-,173000,27009
2302,1679,623,625,126500,27011
10592,8730,1862,822,215000,27012
2402,1807,595,685,117000,27013
304,168,136,887,85100,27014
534,431,103,465,123100,27016
3492,2469,1023,626,120600,27017
3138,2533,605,644,157300,27018
1643,1435,208,570,122100,27019
2454,1844,610,621,122500,27020
7412,5745,1667,707,136200,27021
485,409,76,608,162500,27022
5197,4370,827,845,205500,27023
1117,901,216,689,128500,27024
4586,3743,843,698,118100,27025
1861,1066,795,580,92400,27027
9803,7161,2642,717,142100,27028
15090,10531,4559,603,111500,27030
4589,4160,429,1068,182900,27040
3145,2303,842,575,153800,27041
296,212,84,-,-,27042
2687,2021,666,623,128100,27043
3674,2736,938,760,135600,27045
965,821,144,456,84700,27046
482,413,69,1063,116300,27047
3127,2675,452,567,119100,27048
1624,1385,239,827,138500,27050
3107,2286,821,784,132300,27051
4267,3078,1189,658,131900,27052
1265,1036,229,759,127700,27053
913,793,120,774,113300,27054
5699,4500,1199,662,127100,27055
8829,2990,5839,670,126200,27101
15590,8092,7498,832,156700,27103
12717,7601,5116,846,257100,27104
14755,7173,7582,712,97200,27105
19510,10619,8891,806,182200,27106
17254,11852,5402,777,123700,27107
0,0,0,-,-,27109
0,0,0,-,-,27110
15313,9568,5745,849,131400,27127
32,18,14,-,85000,27201
8893,4131,4762,643,104400,27203
13100,10058,3042,739,124600,27205
1295,1058,237,534,139800,27207
685,591,94,750,122700,27208
1504,1114,390,709,90400,27209
577,556,21,-,132000,27212
3783,3179,604,770,160200,27214
18189,10304,7885,821,165000,27215
14179,8891,5288,780,108700,27217
1094,676,418,538,85200,27229
761,627,134,886,193200,27231
1391,1241,150,749,151000,27233
1848,1462,386,1097,253600,27235
3669,2913,756,638,114100,27239
763,596,167,549,92000,27242
1777,1481,296,730,179100,27243
4887,3405,1482,1058,174300,27244
1610,1069,541,804,99600,27248
4902,4036,866,811,148400,27249
901,713,188,770,156700,27252
12615,9011,3604,724,144100,27253
2775,2164,611,720,125200,27258
9043,3168,5875,716,80500,27260
8612,4574,4038,820,156400,27262
8794,5708,3086,707,117900,27263
19834,13132,6702,939,169900,27265
10001,7825,2176,976,250100,27278
1266,1014,252,653,140500,27281
6835,4930,1905,1034,185600,27282
1283,1156,127,853,165500,27283
22124,15827,6297,801,166400,27284
9974,6173,3801,639,89700,27288
656,552,104,782,116900,27291
15560,9981,5579,664,121100,27292
15213,11238,3975,678,141200,27295
4024,2945,1079,699,145300,27298
2055,1438,617,709,106800,27299
3311,2872,439,838,151000,27301
11861,8183,3678,861,177300,27302
683,548,135,691,95700,27305
2706,2125,581,644,109600,27306
2391,2247,144,-,332400,27310
1540,1176,364,571,84800,27311
8974,7159,1815,875,308300,27312
2479,2270,209,804,162000,27313
499,434,65,629,118700,27314
820,694,126,588,108600,27315
2523,1699,824,684,115700,27316
6558,4798,1760,631,112800,27317
15801,10685,5116,691,114900,27320
2538,1969,569,488,99800,27325
1331,948,383,594,109300,27326
14322,9126,5196,751,142200,27330
10876,7627,3249,910,150700,27332
35,0,35,-,-,27340
2097,1859,238,719,108700,27341
634,544,90,1283,128300,27343
6897,4238,2659,674,144300,27344
2175,1867,308,829,136900,27349
2528,2071,457,638,133500,27350
942,797,145,587,150100,27355
1121,801,320,587,104000,27356
3089,2537,552,819,158700,27357
5280,4571,709,844,304900,27358
18310,11700,6610,682,125800,27360
5795,4779,1016,730,122900,27370
3255,2156,1099,548,115000,27371
3727,3311,416,772,233700,27376
3339,2434,905,893,158400,27377
2111,1341,770,462,105000,27379
7094,2758,4336,754,102500,27401
7713,4027,3686,854,178800,27403
18803,8764,10039,742,106800,27405
24113,13312,10801,808,121900,27406
19823,9364,10459,854,136100,27407
8220,5883,2337,871,222800,27408
8240,2649,5591,848,138800,27409
24333,14932,9401,967,214400,27410
12010,8443,3567,887,228600,27455
7293,5334,1959,805,159000,27501
14016,11211,2805,1338,312600,27502
1305,1167,138,2041,262100,27503
5442,3866,1576,747,123500,27504
2313,1600,713,758,127700,27505
720,504,216,632,142600,27507
457,329,128,669,102100,27508
1590,847,743,875,134400,27509
7151,2337,4814,1013,292500,27510
13760,9258,4502,1056,239400,27511
17861,11262,6599,1143,300000,27513
9938,4791,5147,1144,449200,27514
15194,10075,5119,1203,357500,27516
10805,7249,3556,1213,388000,27517
8374,5682,2692,1232,392800,27518
19163,14301,4862,1405,393800,27519
14492,10481,4011,996,160200,27520
2234,1425,809,817,128700,27521
4559,3710,849,988,156700,27522
4116,2827,1289,1189,358300,27523
4758,3106,1652,742,140300,27524
5591,4175,1416,806,143300,27525
16108,12495,3613,1038,229900,27526
7566,6231,1335,1637,222000,27527
18279,12440,5839,1040,180600,27529
15741,9080,6661,642,132100,27530
0,0,0,-,-,27531
13131,7005,6126,895,145400,27534
6336,2732,3604,647,92600,27536
8940,6350,2590,713,103200,27537
7918,6817,1101,1212,306300,27539
12198,10251,1947,1399,278800,27540
1460,1150,310,1019,221900,27541
3604,2329,1275,777,112200,27542
1920,1346,574,775,107500,27544
9592,6963,2629,1067,168600,27545
6846,4446,2400,796,143300,27546
9965,6975,2990,774,125000,27549
701,547,154,1077,133600,27551
830,599,231,678,69500,27553
266,112,154,692,84800,27555
67,33,34,673,79400,27556
2717,1763,954,655,97800,27557
815,666,149,932,190400,27559
12595,5802,6793,1313,312200,27560
764,632,132,920,239200,27562
1994,1287,707,558,78600,27563
9816,6706,3110,724,124900,27565
264,140,124,613,126900,27568
3098,1954,1144,812,98200,27569
2087,1754,333,783,313300,27571
2796,2511,285,737,188400,27572
4459,2157,2302,653,107800,27573
5861,4949,912,722,111500,27574
6332,4064,2268,818,121000,27576
9046,5680,3366,808,144700,27577
1312,1108,204,829,154300,27581
193,32,161,482,86000,27582
2795,2554,241,881,121000,27583
23114,18016,5098,1079,295700,27587
2954,2111,843,586,86300,27589
7367,5626,1741,845,160900,27591
5703,4739,964,872,178000,27592
6622,5441,1181,851,187200,27596
8516,6299,2217,860,150300,27597
4215,1051,3164,889,313500,27601
20096,12050,8046,1052,205000,27603
18176,10217,7959,1039,170200,27604
3159,1093,2066,1194,349600,27605
18192,6498,11694,1003,263700,27606
8729,4518,4211,1106,397600,27607
4845,3429,1416,1132,556500,27608
15510,7991,7519,1052,289500,27609
25377,14779,10598,992,153900,27610
17775,9584,8191,1123,319400,27612
17572,11862,5710,1043,326500,27613
12504,9279,3225,1227,380300,27614
18207,12513,5694,1105,298100,27615
18811,11645,7166,1078,189000,27616
9088,4160,4928,1223,269500,27617
9464,2792,6672,757,228500,27701
19701,12043,7658,1025,178000,27703
14583,7953,6630,913,149200,27704
20198,9479,10719,994,257100,27705
20646,9252,11394,1011,236600,27707
379,315,64,1125,203700,27709
8354,7756,598,1275,213700,27712
22993,12731,10262,1096,232000,27713
7909,3895,4014,683,86400,27801
7761,5033,2728,732,139200,27803
11731,7120,4611,841,131400,27804
1553,1148,405,701,86000,27805
1027,852,175,671,63900,27806
2451,1573,878,711,119800,27807
901,797,104,741,171100,27808
1889,1451,438,670,98200,27809
1901,1271,630,684,123500,27810
1094,743,351,679,88800,27812
281,181,100,674,82800,27813
792,744,48,-,99200,27814
889,683,206,626,113600,27816
3096,2264,832,823,132100,27817
562,452,110,939,62600,27818
135,103,32,650,62700,27819
1010,743,267,629,90600,27820
165,80,85,549,-,27821
3325,2644,681,684,118800,27822
3145,2069,1076,742,58900,27823
617,359,258,818,119900,27824
27,7,20,838,-,27825
149,120,29,-,-,27826
19,18,1,-,102500,27827
3504,2281,1223,707,116900,27828
704,479,225,697,101400,27829
1966,1414,552,692,88000,27830
1372,980,392,736,68000,27831
1353,925,428,750,73100,27832
22908,9312,13596,754,112100,27834
2371,1942,429,713,155400,27837
1131,846,285,863,76600,27839
187,128,59,535,57000,27840
12,10,2,-,40000,27841
715,605,110,-,312500,27842
415,337,78,940,65800,27843
1167,832,335,687,79400,27844
912,646,266,620,102900,27845
1270,985,285,588,81300,27846
299,202,97,693,45200,27847
670,466,204,784,79200,27849
3266,2425,841,677,154400,27850
1897,1529,368,693,100300,27851
1164,951,213,680,90400,27852
219,137,82,-,77300,27853
2397,1419,978,666,73600,27855
6231,4602,1629,736,135500,27856
468,357,111,900,81600,27857
22632,10112,12520,845,169300,27858
811,562,249,684,79600,27860
25,25,0,-,47200,27861
312,215,97,877,99700,27862
4803,3630,1173,938,124800,27863
1986,1244,742,635,79800,27864
811,720,91,1086,101400,27865
390,209,181,951,102600,27866
971,719,252,733,61000,27869
10739,6307,4432,702,101000,27870
1730,1202,528,688,70400,27871
226,139,87,-,39400,27872
201,108,93,-,105800,27873
1682,1190,492,634,75400,27874
199,119,80,-,165100,27875
629,456,173,761,91200,27876
892,388,504,674,74600,27878
138,114,24,800,134200,27879
1369,923,446,486,147200,27880
39,20,19,737,-,27881
2940,1996,944,655,89800,27882
1233,893,340,720,84900,27883
478,461,17,-,74600,27884
413,329,84,630,68100,27885
8491,5225,3266,686,88000,27886
872,635,237,644,78500,27888
10747,7028,3719,705,133900,27889
1057,455,602,646,85000,27890
2069,1442,627,781,86600,27891
5829,3968,1861,680,98800,27892
15356,6921,8435,721,96800,27893
8398,5970,2428,889,168800,27896
656,361,295,509,87900,27897
14801,9031,5770,865,158600,27909
4540,2900,1640,723,91100,27910
399,257,142,964,224000,27915
362,284,78,1319,220400,27916
268,149,119,949,144000,27917
461,335,126,-,156000,27919
526,290,236,940,319100,27920
1826,1332,494,1181,207600,27921
359,308,51,734,82000,27922
296,211,85,-,204800,27923
1487,1360,127,-,79600,27924
1553,1129,424,704,113100,27925
581,451,130,1047,143100,27926
437,342,95,-,437000,27927
805,544,261,750,91000,27928
746,670,76,-,276400,27929
5169,3492,1677,765,122300,27932
692,499,193,567,123700,27935
471,386,85,785,200000,27936
1645,1291,354,906,156700,27937
560,397,163,785,133200,27938
1009,733,276,964,171300,27939
206,197,9,-,223000,27941
423,369,54,937,65800,27942
268,200,68,-,381100,27943
5243,3908,1335,863,177100,27944
443,434,9,-,117800,27946
517,466,51,-,246300,27947
4769,3281,1488,1127,244500,27948
3256,2806,450,1324,422100,27949
807,728,79,1055,195200,27950
417,227,190,962,123100,27953
3065,2160,905,968,260800,27954
153,131,22,-,-,27956
548,431,117,-,127600,27957
4026,3544,482,1564,273500,27958
1300,813,487,1293,327700,27959
217,111,106,743,331700,27960
3055,1738,1317,625,85200,27962
317,224,93,1196,287300,27964
265,204,61,-,182100,27965
311,189,122,-,251100,27966
132,112,20,645,55000,27967
77,28,49,-,-,27968
1228,911,317,714,84300,27970
44,44,0,-,378600,27972
554,397,157,1016,264500,27973
449,367,82,1007,224500,27974
1414,1293,121,-,209400,27976
106,59,47,921,171800,27978
607,484,123,690,136500,27979
829,666,163,-,132800,27980
720,385,335,1018,223900,27981
23,13,10,-,-,27982
3396,2395,1001,687,85500,27983
150,80,70,850,120500,27985
475,308,167,679,88500,27986
10469,6958,3511,714,124600,28001
437,369,68,804,142200,28006
278,244,34,728,65000,28007
568,386,182,677,82100,28009
8631,5955,2676,867,188800,28012
4846,2882,1964,722,110900,28016
0,0,0,-,-,28017
1971,1565,406,667,111200,28018
0,0,0,-,-,28019
822,661,161,929,79800,28020
5251,3933,1318,753,130900,28021
5661,4180,1481,784,148700,28023
20219,13614,6605,837,162800,28025
22810,16458,6352,906,207000,28027
11592,8315,3277,1241,289100,28031
1164,717,447,876,142100,28032
1275,1031,244,722,126800,28033
6279,4410,1869,700,124100,28034
6009,4866,1143,1098,388600,28036
8048,6471,1577,828,306800,28037
31,17,14,-,87900,28039
3118,2426,692,724,106800,28040
8440,5117,3323,618,106100,28043
12377,6849,5528,828,96600,28052
15185,7609,7576,840,128900,28054
12786,10218,2568,845,164400,28056
1089,833,256,753,151600,28071
476,335,141,590,168400,28072
2040,1331,709,645,87500,28073
6203,5521,682,1558,274100,28075
110,77,33,-,-,28076
191,101,90,646,77700,28077
21875,16205,5670,1268,280900,28078
12635,10661,1974,1290,208200,28079
3038,2445,593,708,141200,28080
9962,6145,3817,809,135900,28081
9390,5463,3927,889,124500,28083
9903,6939,2964,693,118600,28086
1054,813,241,876,132400,28088
26,22,4,-,159400,28089
3367,2649,718,709,103000,28090
816,620,196,538,88200,28091
15609,11091,4518,692,132400,28092
2503,1999,504,787,165600,28097
1252,879,373,724,119900,28098
334,214,120,839,232000,28101
35,31,4,-,75400,28102
4036,2954,1082,880,167600,28103
10728,9756,972,1200,312800,28104
17147,12360,4787,1206,242600,28105
2664,2342,322,855,211200,28107
35,20,15,-,-,28108
51,24,27,-,115000,28109
18297,12728,5569,935,175700,28110
9173,6800,2373,888,156100,28112
2634,1968,666,639,83400,28114
13483,9582,3901,870,195100,28115
15112,10965,4147,1139,393100,28117
1173,699,474,700,62500,28119
8127,6162,1965,810,155400,28120
2374,1959,415,887,174300,28124
870,708,162,828,211900,28125
2827,2375,452,672,155400,28127
2979,2237,742,721,113000,28128
2207,1820,387,675,143900,28129
893,653,240,795,128100,28133
4356,2295,2061,1096,200800,28134
1715,1287,428,674,101000,28135
1120,995,125,720,153000,28137
3760,2871,889,721,115000,28138
8155,6165,1990,672,137300,28139
9491,5134,4357,762,123800,28144
10683,8243,2440,750,144000,28146
8974,6089,2885,759,139900,28147
10733,7081,3652,695,113900,28150
9302,5982,3320,703,117900,28152
1095,592,503,925,96700,28159
1241,750,491,621,83100,28160
1958,1533,425,714,152600,28163
5878,4825,1053,755,164400,28164
3576,2845,731,862,171400,28166
980,844,136,-,133300,28167
3768,3102,666,664,125300,28168
62,31,31,609,110900,28169
4639,2848,1791,731,97000,28170
17254,15510,1744,1133,373100,28173
2820,1878,942,816,146700,28174
6958,2340,4618,1421,280400,28202
8193,2590,5603,1340,508200,28203
3536,946,2590,1202,405100,28204
19859,8432,11427,923,221100,28205
4811,1655,3156,835,100700,28206
3776,2869,907,1195,900800,28207
14227,4765,9462,868,97200,28208
10593,5676,4917,1079,341800,28209
20579,11026,9553,1076,296700,28210
12633,7611,5022,1104,440200,28211
16004,5593,10411,937,134000,28212
15895,7779,8116,945,156700,28213
14018,10373,3645,1090,142100,28214
20945,12204,8741,1037,146600,28215
19911,10634,9277,1079,135400,28216
10531,3212,7319,1035,116900,28217
15892,11345,4547,1155,346600,28226
19815,13554,6261,1028,171100,28227
0,0,0,-,-,28244
15950,5603,10347,1119,162900,28262
29707,18129,11578,1203,173900,28269
13072,9122,3950,1322,337000,28270
14474,6980,7494,1171,173900,28273
26695,18754,7941,1411,338500,28277
9176,6678,2498,1327,253100,28278
0,0,0,-,-,28280
0,0,0,-,-,28282
6860,2415,4445,652,90500,28301
13207,5903,7304,854,133400,28303
14353,7961,6392,972,113800,28304
2789,1452,1337,855,190300,28305
15159,9396,5763,916,152900,28306
4840,55,4785,1205,163300,28307
30,0,30,1141,-,28308
0,0,0,-,-,28310
14485,6909,7576,840,155200,28311
7225,4926,2299,702,125400,28312
23124,10055,13069,958,128800,28314
4891,3115,1776,791,145600,28315
1739,1472,267,541,93000,28318
4089,2690,1399,600,81000,28320
1316,976,340,735,172200,28323
195,161,34,825,80900,28325
7208,4026,3182,1339,151000,28326
6299,5285,1014,737,171900,28327
9889,6201,3688,648,94700,28328
217,126,91,-,59800,28330
116,68,48,669,109200,28332
3886,2652,1234,675,70600,28333
9727,6283,3444,701,112100,28334
4112,2815,1297,716,99300,28337
1981,1484,497,659,75900,28338
2887,1910,977,788,90500,28339
3898,2574,1324,517,68200,28340
1502,936,566,767,91000,28341
71,55,16,890,117500,28342
535,367,168,634,66900,28343
1234,949,285,736,86900,28344
4966,3173,1793,618,76400,28345
524,335,189,751,69300,28347
12305,8509,3796,900,143500,28348
1235,952,283,678,108600,28349
67,67,0,-,-,28350
1873,1369,504,661,72000,28351
9298,5272,4026,668,88400,28352
1886,1510,376,948,162500,28356
1065,783,282,618,94600,28357
13351,7527,5824,677,88600,28358
4904,3425,1479,629,80600,28360
443,277,166,800,57700,28363
5117,3713,1404,581,67200,28364
6083,4057,2026,703,86700,28365
2239,1637,602,601,85400,28366
34,11,23,655,132800,28367
1063,802,261,620,63200,28369
2386,1733,653,810,87100,28371
4551,2895,1656,598,81600,28372
1059,706,353,886,138800,28373
7797,6665,1132,1557,308500,28374
54,32,22,675,75000,28375
14802,9878,4924,922,147200,28376
4214,2588,1626,585,68800,28377
10514,6943,3571,644,87000,28379
2847,1958,889,638,86500,28382
2932,2183,749,553,65600,28383
4012,2851,1161,595,69800,28384
982,678,304,536,84900,28385
1868,1338,530,628,64200,28386
6878,3857,3021,916,261500,28387
8437,4024,4413,938,128500,28390
2257,1702,555,732,118300,28391
590,474,116,692,106000,28392
849,492,357,576,76800,28393
2153,1486,667,953,163600,28394
843,664,179,748,121600,28395
1021,748,273,659,83600,28396
2853,1538,1315,651,77800,28398
888,752,136,663,103700,28399
10350,3694,6656,859,150100,28401
17836,5567,12269,899,234600,28403
13448,7949,5499,994,210600,28405
13102,10542,2560,1195,273800,28409
14564,11171,3393,1168,260500,28411
17236,9896,7340,990,204500,28412
1330,887,443,828,151900,28420
508,444,64,743,99200,28421
3291,2587,704,744,207100,28422
899,674,225,780,89600,28423
31,11,20,669,-,28424
3946,2718,1228,774,136300,28425
2956,1848,1108,1160,328400,28428
2885,2216,669,822,156100,28429
819,679,140,631,66900,28430
3035,2237,798,524,79100,28431
633,434,199,585,94100,28432
2083,1586,497,626,102300,28433
507,354,153,-,142600,28434
945,826,119,683,89800,28435
747,544,203,801,101100,28436
700,570,130,631,72000,28438
512,388,124,-,57400,28439
1277,769,508,571,77200,28441
735,518,217,632,86300,28442
8183,6887,1296,1052,244200,28443
913,758,155,932,88800,28444
2940,2086,854,1133,225800,28445
527,429,98,569,133400,28447
430,277,153,-,-,28448
823,611,212,1534,435100,28449
989,721,268,839,175700,28450
14064,10737,3327,1046,171400,28451
371,251,120,913,58800,28452
1208,868,340,610,66900,28453
880,651,229,1193,127500,28454
824,693,131,690,115600,28455
1525,1182,343,747,106500,28456
3951,3277,674,900,168100,28457
2552,1717,835,690,84600,28458
4249,2725,1524,1157,207800,28460
8631,6975,1656,904,282600,28461
5394,4224,1170,785,138700,28462
3385,2328,1057,606,81000,28463
1145,762,383,806,74600,28464
3487,2749,738,1085,278600,28465
4072,3055,1017,611,100200,28466
4852,4504,348,1136,190800,28467
2396,1942,454,986,262000,28468
2807,2442,365,898,331800,28469
5115,3616,1499,791,158900,28470
7466,5029,2437,617,93000,28472
1865,1583,282,595,107400,28478
2345,1825,520,843,174100,28479
1165,730,435,1499,778700,28480
7896,3583,4313,675,83900,28501
8785,5809,2976,804,107200,28504
811,695,116,-,90800,28508
734,566,168,820,189800,28510
261,182,79,1032,163000,28511
1612,1189,423,978,371000,28512
4080,2679,1401,590,107400,28513
917,564,353,633,78700,28515
5094,3509,1585,837,192900,28516
3173,2304,869,718,115000,28518
153,104,49,-,162100,28519
148,124,24,-,154800,28520
1003,806,197,799,125300,28521
975,703,272,636,109700,28523
161,140,21,-,130500,28524
1054,830,224,821,73300,28525
1223,696,527,704,66800,28526
501,442,59,588,139700,28527
225,169,56,-,78100,28528
724,523,201,691,121900,28529
2613,1610,1003,724,85700,28530
578,493,85,742,203300,28531
8191,3868,4323,1004,141800,28532
19,0,19,-,-,28533
57,26,31,-,132900,28537
790,481,309,806,77000,28538
5915,3660,2255,962,138900,28539
17336,9253,8083,894,147000,28540
1956,28,1928,1235,-,28543
2416,571,1845,1066,106100,28544
17376,8549,8827,920,156300,28546
2085,8,2077,1315,-,28547
5816,4034,1782,768,107400,28551
50,50,0,-,-,28552
145,133,12,-,232500,28553
94,94,0,-,51700,28554
1902,1347,555,919,131300,28555
423,338,85,-,229200,28556
6897,4463,2434,890,236300,28557
11575,7458,4117,789,151700,28560
16195,10981,5214,892,188200,28562
8717,6349,2368,856,159200,28570
1310,1074,236,800,268800,28571
2576,1695,881,589,90200,28572
885,633,252,663,115200,28573
6345,4587,1758,1071,142700,28574
238,194,44,1281,298500,28575
117,111,6,-,139600,28577
2218,1549,669,612,89600,28578
242,182,60,774,213000,28579
4135,2938,1197,645,89200,28580
123,123,0,-,334000,28581
797,695,102,-,205400,28582
107,90,17,725,78600,28583
4901,3551,1350,1042,228300,28584
1518,1185,333,569,85400,28585
3036,2214,822,555,101900,28586
168,91,77,673,99000,28587
74,40,34,-,187500,28589
9477,6872,2605,865,170000,28590
1758,1396,362,1367,363600,28594
20524,13178,7346,719,163300,28601
11338,7578,3760,700,132200,28602
3132,2314,818,861,230200,28604
1516,1070,446,869,365000,28605
667,530,137,492,96200,28606
12371,6260,6111,799,255500,28607
2275,1921,354,677,137700,28609
3849,2983,866,819,115600,28610
490,386,104,-,62500,28611
4795,3690,1105,588,98700,28612
8497,6160,2337,722,136900,28613
804,638,166,507,114400,28615
63,53,10,-,164100,28616
969,599,370,494,157900,28617
1113,869,244,830,191300,28618
652,444,208,682,102100,28619
4009,2609,1400,674,125600,28621
987,760,227,1026,101500,28622
668,552,116,732,123500,28623
653,556,97,-,90700,28624
14831,11208,3623,776,143000,28625
1071,1000,71,910,194300,28626
457,352,105,644,128200,28627
160,93,67,759,106700,28628
0,0,0,-,-,28629
7986,5737,2249,679,119100,28630
382,344,38,-,180900,28631
1796,1444,352,810,111800,28634
1365,1100,265,1009,95500,28635
1918,1416,502,621,112900,28636
711,507,204,644,124300,28637
4756,3350,1406,624,119700,28638
2122,1365,757,557,167700,28640
2336,1625,711,539,103900,28642
1498,1206,292,659,118400,28643
502,429,73,-,106900,28644
18448,12921,5527,637,110700,28645
179,137,42,-,328800,28646
22,22,0,-,-,28647
372,352,20,-,158900,28649
4352,3243,1109,717,122200,28650
3055,2346,709,600,111400,28651
0,0,0,-,-,28652
1494,1343,151,563,126700,28654
21186,15073,6113,648,119900,28655
4015,3028,987,676,140900,28657
10363,7026,3337,731,120300,28658
8627,5915,2712,636,116700,28659
763,648,115,710,168400,28660
66,39,27,-,-,28662
238,200,38,-,217900,28663
1056,855,201,683,122100,28665
71,23,48,-,-,28666
196,123,73,779,77500,28667
121,115,6,-,313600,28668
1213,933,280,690,111200,28669
1202,926,276,540,135700,28670
229,147,82,589,158200,28671
16,16,0,-,-,28672
2489,2112,377,1159,283500,28673
2981,2100,881,590,116200,28675
1608,1239,369,624,128100,28676
13456,8425,5031,716,124200,28677
2314,1820,494,715,149500,28678
745,513,232,722,226000,28679
9426,7204,2222,630,133800,28681
550,398,152,637,472300,28682
588,468,120,657,106300,28683
967,702,265,1042,169800,28684
790,674,116,652,85800,28685
698,610,88,560,130800,28689
3497,2658,839,621,122600,28690
1631,1341,290,771,210900,28692
798,574,224,857,144000,28693
3342,2498,844,705,146400,28694
5793,4143,1650,623,163800,28697
930,802,128,747,165500,28698
1408,1114,294,650,218300,28701
193,164,29,-,215900,28702
7940,4937,3003,1084,221000,28704
2839,2242,597,643,142800,28705
69,54,15,-,-,28707
176,145,31,-,126600,28708
880,690,190,686,182400,28709
5753,3794,1959,771,223400,28711
8541,6193,2348,713,220400,28712
3422,2461,961,667,140100,28713
7073,5219,1854,617,149400,28714
10149,7467,2682,738,202400,28715
7287,5243,2044,707,157200,28716
689,472,217,768,277600,28717
159,126,33,-,183700,28718
2960,2051,909,626,110300,28719
60,36,24,682,225000,28720
4319,2920,1399,715,175000,28721
2841,1759,1082,817,212300,28722
3488,1426,2062,656,232200,28723
14,5,9,-,-,28725
1330,562,768,756,155500,28726
1505,1271,234,-,184600,28729
3475,2817,658,783,240700,28730
3546,2863,683,915,236600,28731
7183,5745,1438,1004,217100,28732
7,0,7,-,-,28733
12127,8922,3205,737,153200,28734
169,105,64,574,221900,28735
295,215,80,936,375600,28736
9685,7316,2369,811,243900,28739
376,339,37,-,150400,28740
1888,1252,636,867,483500,28741
1049,853,196,782,224700,28742
881,527,354,656,159800,28743
238,204,34,-,305200,28745
1118,905,213,911,285200,28746
931,766,165,689,167100,28747
4787,3660,1127,742,172700,28748
13,13,0,-,-,28749
1772,1533,239,820,187400,28751
12035,8346,3689,643,110000,28752
4151,3105,1046,693,164200,28753
3635,2703,932,683,191800,28754
1745,1365,380,766,168200,28756
51,51,0,-,425000,28757
3120,2442,678,842,248400,28759
3252,2431,821,649,133300,28761
2786,2139,647,609,107100,28762
1255,941,314,739,179200,28763
444,376,68,1005,199400,28766
3037,2463,574,749,226500,28768
3123,2623,500,510,116100,28771
435,433,2,-,156800,28772
1326,1103,223,839,250700,28773
510,408,102,1188,385400,28774
129,86,43,-,255200,28775
3580,2903,677,484,156100,28777
3898,2848,1050,811,164300,28778
7681,5624,2057,780,198600,28779
424,302,122,673,210400,28781
3256,2499,757,972,250800,28782
703,378,325,645,122500,28783
3151,2492,659,791,235900,28785
9573,6550,3023,752,173500,28786
8462,6778,1684,804,226600,28787
2303,1596,707,907,156900,28789
1271,1126,145,855,182600,28790
6449,4885,1564,850,214900,28791
14559,9077,5482,780,167500,28792
6677,2423,4254,822,296600,28801
15900,7933,7967,1112,252800,28803
8740,5845,2895,1078,338400,28804
9277,5685,3592,870,249700,28805
17788,10691,7097,939,191700,28806
2080,1635,445,511,107200,28901
574,465,109,925,133400,28902
4137,3094,1043,710,172800,28904
1271,1081,190,647,149000,28905
8405,6715,1690,736,163900,28906
483,394,89,-,142800,28909
792,617,175,488,75900,29001
2364,1759,605,858,77900,29003
3987,2891,1096,699,111700,29006
943,757,186,638,75000,29009
4374,2922,1452,652,74000,29010
692,533,159,443,130300,29014
639,474,165,612,59300,29015
7279,6164,1115,1352,245600,29016
1173,997,176,571,87400,29018
8888,6938,1950,696,123600,29020
760,659,101,538,122600,29030
488,371,117,727,82800,29031
1689,1426,263,807,73600,29032
5557,3250,2307,920,124800,29033
8664,7977,687,1241,285000,29036
331,227,104,-,94200,29037
842,689,153,714,79900,29038
1421,1121,300,803,84400,29039
3788,2817,971,715,117300,29040
1800,1045,755,696,58400,29042
2055,1582,473,613,94200,29044
9321,7376,1945,1070,154200,29045
80,80,0,-,-,29046
1522,1249,273,596,83800,29047
2006,1546,460,926,105300,29048
267,234,33,-,113300,29051
712,532,180,730,49800,29052
6671,4702,1969,864,77400,29053
3459,2964,495,752,166700,29054
1605,1259,346,700,64900,29055
875,692,183,569,68300,29056
1679,1356,323,674,97900,29058
2186,1516,670,600,70000,29059
5159,3879,1280,1058,114500,29061
56,24,32,-,80000,29062
14011,11299,2712,1244,170400,29063
234,185,49,-,89400,29065
3579,2499,1080,721,94700,29067
1935,1466,469,629,74200,29069
5961,4944,1017,657,141500,29070
21632,17235,4397,1070,217600,29072
17399,13984,3415,873,136400,29073
64,64,0,-,316700,29074
995,822,173,663,201000,29075
6290,5303,987,647,132700,29078
10,0,10,-,-,29079
1026,762,264,487,62400,29080
497,379,118,710,69800,29081
194,190,4,-,53300,29082
1107,954,153,672,72600,29101
6970,5184,1786,633,105300,29102
471,351,120,738,85500,29104
427,303,124,711,70100,29105
1097,918,179,665,57800,29107
7752,4943,2809,716,79700,29108
580,481,99,532,87600,29111
1604,1286,318,592,67700,29112
486,394,92,586,54400,29113
681,530,151,800,68200,29114
10469,5541,4928,655,88400,29115
0,0,0,-,-,29117
6360,4403,1957,708,142200,29118
21,14,7,-,-,29122
3049,2501,548,760,85600,29123
978,737,241,1070,73400,29125
870,788,82,689,141200,29126
3634,3044,590,791,169400,29127
1829,1583,246,680,79800,29128
1125,815,310,585,105100,29129
2411,1997,414,814,171400,29130
295,266,29,575,94200,29133
3338,2629,709,614,89100,29135
723,571,152,565,74100,29137
3759,2489,1270,671,80800,29138
2034,1540,494,692,95200,29142
369,285,84,992,63700,29145
670,571,99,663,72200,29146
0,0,0,-,-,29147
2957,2315,642,511,89100,29148
15477,8449,7028,747,117700,29150
627,0,627,1142,-,29152
6062,4272,1790,841,93000,29153
11291,8038,3253,810,133000,29154
3328,2525,803,741,86300,29160
4124,2970,1154,734,87200,29161
1171,875,296,548,102400,29162
722,482,240,-,76800,29163
1980,1431,549,675,83700,29164
361,310,51,1025,88900,29166
1386,1114,272,755,67300,29168
11041,5465,5576,864,139700,29169
8435,6446,1989,911,131700,29170
3645,2544,1101,793,113900,29172
209,154,55,-,84500,29175
1296,1037,259,641,54800,29178
5574,3933,1641,707,104100,29180
8049,2134,5915,1009,162200,29201
171,92,79,1521,282600,29202
15033,7116,7917,840,93900,29203
7160,3986,3174,813,133500,29204
10695,5316,5379,858,252700,29205
8146,5254,2892,1031,245600,29206
0,0,0,-,-,29207
0,0,0,-,-,29208
13565,8376,5189,956,142400,29209
16413,5967,10446,858,121600,29210
12056,8451,3605,1051,168400,29212
20532,11254,9278,976,145600,29223
0,0,0,-,-,29225
17353,12133,5220,1217,167600,29229
13817,7449,6368,821,126900,29301
6724,5126,1598,843,149700,29302
8639,4160,4479,710,90900,29303
6700,2827,3873,725,97600,29306
8103,4822,3281,795,134400,29307
9893,7475,2418,832,147200,29316
215,197,18,-,42100,29320
1239,941,298,780,60100,29321
3201,2772,429,810,148100,29322
5192,4266,926,693,115900,29323
140,76,64,-,35000,29324
5513,3543,1970,730,87300,29325
96,52,44,1577,-,29329
3170,2142,1028,687,93300,29330
72,72,0,-,50700,29331
953,783,170,670,76400,29332
248,138,110,752,59400,29333
4914,3470,1444,899,160200,29334
1764,1508,256,820,70300,29335
13,13,0,-,-,29338
7297,5339,1958,624,83100,29340
7500,4819,2681,722,134400,29341
131,105,26,678,77100,29346
11674,9723,1951,821,142400,29349
540,391,149,438,51500,29351
1716,1376,340,584,84900,29353
388,361,27,-,81200,29355
3550,2854,696,679,150100,29356
8203,5294,2909,689,97300,29360
236,121,115,723,42100,29364
4042,3562,480,880,150700,29365
46,46,0,-,-,29368
5258,4748,510,900,172200,29369
382,353,29,920,106500,29370
1536,1146,390,648,80300,29372
162,131,31,1285,29000,29373
1398,1064,334,715,133500,29374
28,9,19,783,-,29375
2695,2220,475,813,149500,29376
492,224,268,580,56100,29377
68,0,68,683,-,29378
7462,4800,2662,640,78400,29379
1731,1545,186,702,88800,29384
2775,1880,895,788,121500,29385
5903,4404,1499,660,107000,29388
3765,1871,1894,1517,986600,29401
8510,3197,5313,1220,388200,29403
467,0,467,1500,-,29404
10203,4261,5942,909,138400,29405
12495,4508,7987,954,140400,29406
14973,8401,6572,1034,273900,29407
5,0,5,-,-,29409
8376,5305,3071,1042,216000,29410
16539,11505,5034,1329,297100,29412
17228,10706,6522,1205,241600,29414
10009,4983,5026,964,150500,29418
8324,5496,2828,1162,186100,29420
0,0,0,-,-,29423
0,0,0,-,-,29424
642,585,57,844,138800,29426
1199,1114,85,925,302400,29429
2467,2022,445,836,140900,29431
1281,998,283,340,71300,29432
208,176,32,725,134100,29434
1696,1477,219,813,77300,29435
1707,1206,501,760,91200,29436
1035,847,188,915,114300,29437
1117,1003,114,883,326700,29438
1178,712,466,1010,575700,29439
10479,7639,2840,746,130000,29440
20771,13829,6942,1094,164700,29445
393,373,20,-,86400,29446
826,574,252,917,106000,29448
3266,2692,574,683,195000,29449
1307,1080,227,699,97200,29450
1927,1630,297,1976,801400,29451
193,171,22,-,74800,29452
448,343,105,798,98500,29453
9273,7616,1657,1263,341400,29455
10626,6947,3679,1154,156500,29456
1109,904,205,865,128200,29458
13334,10349,2985,848,178200,29461
22043,13909,8134,1485,436900,29464
13360,11497,1863,1688,426500,29466
782,464,318,576,81100,29468
457,440,17,-,273300,29469
1717,1184,533,831,259000,29470
579,545,34,696,86700,29471
2644,2145,499,895,121100,29472
876,706,170,679,78500,29474
883,727,156,536,79400,29475
2538,1931,607,774,105200,29477
2470,1753,717,634,105700,29479
674,598,76,681,54900,29481
800,672,128,2293,1575900,29482
29706,22296,7410,993,189800,29483
19697,13472,6225,1163,199800,29485
1100,937,163,1015,288000,29487
8591,5756,2835,720,95500,29488
5189,3691,1498,1607,484300,29492
54,43,11,-,77700,29493
18767,11235,7532,787,168500,29501
9704,6921,2783,865,149000,29505
7149,4081,3068,666,93000,29506
4013,3127,886,644,78600,29510
1958,1312,646,740,151000,29511
6122,3831,2291,555,67700,29512
340,252,88,739,54200,29516
463,345,118,641,67100,29518
110,104,6,-,63000,29519
5386,3491,1895,581,94400,29520
794,533,261,533,56300,29525
16287,11784,4503,878,160100,29526
9706,6853,2853,762,135700,29527
890,760,130,491,95800,29530
8304,5445,2859,666,87000,29532
5702,3354,2348,557,75300,29536
1878,1502,376,663,65700,29540
3303,2787,516,844,114100,29541
173,128,45,-,137000,29543
1969,1439,530,769,135600,29544
580,377,203,656,92400,29545
979,691,288,550,75800,29546
1248,794,454,559,59000,29547
12272,8528,3744,651,103600,29550
3268,2607,661,654,73900,29554
2078,1495,583,563,95800,29555
5036,3421,1615,578,66700,29556
4801,3046,1755,653,80100,29560
956,621,335,492,80600,29563
311,215,96,676,45700,29564
2606,1954,652,535,65200,29565
7948,6123,1825,837,170800,29566
175,147,28,631,40400,29567
5947,4725,1222,1000,161900,29568
6496,4772,1724,765,98400,29569
1353,944,409,453,58100,29570
5209,3516,1693,580,86700,29571
4660,3264,1396,874,277500,29572
4265,3130,1135,450,72800,29574
8187,6034,2153,941,203300,29575
14069,11753,2316,1134,205700,29576
13393,7166,6227,898,171700,29577
15504,10202,5302,1091,205400,29579
524,440,84,758,60600,29580
1947,1463,484,538,93400,29581
7904,5802,2102,1016,260800,29582
1919,1539,380,627,73100,29583
1005,709,296,707,53800,29584
6976,5543,1433,1152,333100,29585
16993,12008,4985,931,169400,29588
838,613,225,647,51900,29590
2039,1432,607,615,67700,29591
324,233,91,521,44000,29592
747,439,308,668,51800,29593
35,27,8,-,87500,29594
922,698,224,721,56600,29596
5319,1799,3520,831,290900,29601
14219,9094,5125,821,152000,29605
17243,8220,9023,993,202300,29607
11874,7164,4710,770,185500,29609
11331,5811,5520,763,86700,29611
0,0,0,-,-,29613
88,3,85,482,-,29614
16998,9086,7912,951,224200,29615
10872,6125,4747,743,125800,29617
4966,3841,1125,655,100500,29620
16142,11111,5031,865,172300,29621
6444,3025,3419,637,68500,29624
12365,7999,4366,803,133300,29625
4856,3753,1103,788,115600,29626
7113,5145,1968,651,108900,29627
1005,636,369,620,48200,29628
6717,3057,3660,686,126100,29630
5814,2543,3271,982,232400,29631
48,0,48,808,-,29634
568,541,27,575,174400,29635
1148,910,238,756,87500,29638
372,261,111,736,110700,29639
12119,8370,3749,741,121300,29640
12327,10053,2274,842,174300,29642
903,826,77,625,275000,29643
7405,5534,1871,808,147800,29644
3656,2778,878,759,88100,29645
10602,5903,4699,668,102300,29646
10498,6740,3758,741,152500,29649
13346,9317,4029,1039,220800,29650
17473,13234,4239,769,160800,29651
1765,1518,247,638,113800,29653
3834,2932,902,683,89600,29654
2799,2260,539,588,85400,29655
6030,4877,1153,779,106900,29657
182,182,0,-,88400,29658
47,26,21,753,-,29659
2124,1674,450,675,100000,29661
6172,4263,1909,914,151700,29662
893,752,141,580,153000,29664
91,28,63,-,36700,29665
2662,2171,491,753,89900,29666
102,92,10,870,107600,29667
4608,3620,988,715,113300,29669
3724,2485,1239,678,143100,29670
6814,5433,1381,687,125200,29671
5382,4073,1309,809,235300,29672
10425,7720,2705,788,151700,29673
2517,2254,263,-,265700,29676
9091,5811,3280,766,143000,29678
11242,8917,2325,1077,175900,29680
19915,17242,2673,1057,222600,29681
1491,1223,268,613,149500,29682
92,80,12,-,76500,29683
1532,1179,353,671,87600,29684
701,673,28,-,-,29685
347,235,112,561,152400,29686
15919,11422,4497,834,157000,29687
1654,1383,271,768,184500,29689
7933,6265,1668,694,148200,29690
4445,3143,1302,630,103500,29691
1877,1350,527,674,59700,29692
5980,4286,1694,651,117900,29693
2010,1445,565,894,206900,29696
5156,3716,1440,737,121100,29697
3723,2605,1118,656,73500,29702
1470,1255,215,719,148100,29704
7601,5395,2206,612,90300,29706
11353,10494,859,1350,292900,29707
12302,9969,2333,1259,314600,29708
2759,2246,513,641,80300,29709
13436,10489,2947,1001,206400,29710
848,704,144,927,89900,29712
1133,917,216,761,89600,29714
11599,8898,2701,1012,237800,29715
501,467,34,694,117400,29717
1557,1190,367,606,74900,29718
17179,12087,5092,717,120200,29720
7,0,7,-,-,29724
621,452,169,841,130400,29726
600,436,164,578,58100,29727
3893,2390,1503,706,94700,29728
782,653,129,-,98800,29729
21874,12544,9330,893,140900,29730
23220,15917,7303,946,177700,29732
0,0,0,-,-,29733
905,855,50,658,79400,29741
1016,851,165,743,105400,29742
373,197,176,629,158700,29743
11706,9198,2508,698,157200,29745
10910,6453,4457,757,126100,29801
16577,12969,3608,922,198000,29803
2305,1986,319,704,145000,29805
1162,796,366,736,87400,29809
1817,1153,664,604,39300,29810
4266,3057,1209,660,84300,29812
438,209,229,742,57600,29816
1729,1297,432,565,65200,29817
675,488,187,570,51500,29819
561,432,129,563,120200,29821
2446,1728,718,551,116000,29824
71,58,13,419,53100,29826
1238,854,384,632,63200,29827
350,224,126,337,71000,29828
4218,3121,1097,775,143500,29829
1705,1418,287,705,87400,29831
2009,1266,743,602,101100,29832
765,452,313,755,58000,29834
2951,2215,736,514,136800,29835
189,161,28,-,51000,29836
162,143,19,-,162500,29838
158,158,0,-,67400,29840
13052,8383,4669,777,140500,29841
2809,1832,977,704,89500,29842
504,392,112,681,65400,29843
64,61,3,-,-,29844
467,337,130,689,69300,29845
1913,1410,503,761,87200,29847
262,235,27,420,99500,29848
146,77,69,523,-,29849
107,86,21,-,37500,29850
2816,2123,693,747,89600,29851
2572,1802,770,599,79900,29853
1060,891,169,648,85600,29856
5901,5012,889,797,188300,29860
0,0,0,-,-,29899
5937,3400,2537,987,197300,29902
0,0,0,-,-,29904
16,0,16,2136,-,29905
8569,3935,4634,1022,139100,29906
5089,3948,1141,1255,248000,29907
9255,8416,839,1558,288100,29909
15045,10700,4345,1320,282900,29910
556,454,102,550,75700,29911
0,0,0,-,-,29912
201,190,11,-,548400,29915
548,487,61,-,105900,29916
1523,1143,380,511,64100,29918
4207,3443,764,1127,215100,29920
81,64,17,513,46700,29921
289,216,73,-,55000,29922
154,128,26,692,47300,29923
1771,1180,591,541,103100,29924
10871,8557,2314,1202,437000,29926
3183,1768,1415,1002,150500,29927
7790,6158,1632,1227,578700,29928
440,366,74,630,73900,29929
67,44,23,636,45000,29932
445,341,104,831,120200,29934
1857,540,1317,1106,168400,29935
5038,3556,1482,835,135500,29936
178,168,10,-,-,29939
1445,1159,286,647,108200,29940
278,197,81,365,-,29941
207,173,34,-,203800,29943
1578,1153,425,549,72400,29944
2067,1666,401,692,56200,29945
2791,1599,1192,763,306600,30002
22152,16795,5357,1359,400900,30004
13260,9081,4179,1449,418000,30005
10804,5634,5170,985,157400,30008
6477,3912,2565,1389,315700,30009
4728,3675,1053,1074,155100,30011
9372,5001,4371,920,116400,30012
9465,6285,3180,1019,176600,30013
13560,8061,5499,874,159100,30014
18064,12717,5347,1175,124300,30016
7364,6541,823,1328,259700,30017
14134,11942,2192,1637,242300,30019
7192,1657,5535,901,136600,30021
24134,17096,7038,1395,389800,30022
23732,20492,3240,1561,327500,30024
3361,2603,758,958,190900,30025
8376,7252,1124,1153,260100,30028
11800,7204,4596,1005,402400,30030
17841,8082,9759,938,107000,30032
13194,7822,5372,1181,288300,30033
16265,9918,6347,986,114700,30034
8313,4237,4076,1031,105700,30035
14252,7075,7177,1091,123800,30038
14497,10812,3685,1337,166400,30039
23931,19651,4280,1247,295600,30040
22355,18855,3500,1287,340000,30041
28171,19740,8431,1265,200000,30043
26909,17031,9878,1210,162800,30044
11777,10010,1767,1476,193600,30045
12648,6821,5827,992,156700,30046
20643,15622,5021,1188,198200,30047
21231,17028,4203,1209,176900,30052
4062,3273,789,1009,161900,30054
1076,911,165,969,160800,30055
827,700,127,730,120500,30056
20013,11381,8632,1104,117300,30058
13452,5682,7770,975,143400,30060
23407,18332,5075,1306,305500,30062
18068,14729,3339,1115,270100,30064
20163,15959,4204,1235,242400,30066
20046,7794,12252,1124,320300,30067
12166,10399,1767,1230,392300,30068
184,54,130,684,65700,30070
7474,3545,3929,1101,170300,30071
371,266,105,913,177000,30072
19559,15919,3640,1333,388500,30075
16694,9978,6716,1208,307800,30076
11156,8496,2660,1275,184800,30078
1201,486,715,935,128900,30079
25061,11499,13562,1135,269100,30080
11504,7406,4098,1200,248800,30082
19711,9002,10709,977,116200,30083
14261,9378,4883,1121,198100,30084
14333,11517,2816,1212,180000,30087
10099,5551,4548,1091,108800,30088
14530,6857,7673,1126,332000,30092
17976,5550,12426,1058,126500,30093
11718,9228,2490,1136,158500,30094
25562,10736,14826,1232,196900,30096
16232,11615,4617,1455,395200,30097
19741,15136,4605,1319,236900,30101
14658,10381,4277,1076,172100,30102
5900,4101,1799,803,131100,30103
1624,1162,462,889,104300,30104
737,645,92,757,145700,30105
8055,4412,3643,1082,138800,30106
5068,4456,612,1018,216100,30107
2879,1919,960,712,92600,30108
4878,3340,1538,700,124100,30110
2419,1910,509,714,125100,30113
18846,12920,5926,999,255700,30114
13662,11481,2181,1214,272500,30115
8654,6485,2169,900,128600,30116
13295,6561,6734,810,143100,30117
0,0,0,-,-,30118
14593,9519,5074,882,157100,30120
8497,4675,3822,943,143400,30121
9275,4177,5098,1089,124000,30122
1193,887,306,719,130200,30124
8862,5500,3362,686,101600,30125
15174,10723,4451,1134,207000,30126
22338,18353,3985,1232,182000,30127
13505,9749,3756,980,185200,30132
14881,9355,5526,971,135600,30134
21861,16700,5161,1083,164500,30135
645,420,225,830,118400,30137
1444,1054,390,802,120100,30139
8421,6267,2154,1095,162100,30141
8568,6453,2115,797,218500,30143
20285,11281,9004,1211,192700,30144
2577,2255,322,1009,167000,30145
1659,1103,556,720,104700,30147
256,239,17,-,139200,30148
46,0,46,1031,-,30149
15093,11098,3995,1222,260700,30152
6505,4119,2386,806,110200,30153
16911,13188,3723,1101,150200,30157
13454,7849,5605,661,132000,30161
0,0,0,-,-,30164
15097,8623,6474,787,137000,30165
9353,4152,5201,979,119100,30168
1096,929,167,762,105500,30170
1260,1041,219,806,158000,30171
2085,1375,710,732,102300,30173
2046,1601,445,883,162800,30175
2748,1631,1117,638,107100,30176
555,489,66,658,151400,30177
1123,929,194,809,170800,30178
6586,5141,1445,885,119700,30179
12872,9307,3565,1019,154600,30180
1027,768,259,585,113000,30182
1974,1638,336,1220,218400,30183
2468,2101,367,934,163000,30184
1445,1125,320,994,111800,30185
2922,2607,315,1081,167400,30187
23495,17937,5558,1320,221900,30188
13904,10771,3133,1355,230700,30189
4441,2913,1528,633,134200,30204
1082,925,157,709,238700,30205
1216,1108,108,1017,160300,30206
11094,6571,4523,1117,155300,30213
10824,8855,1969,1157,214100,30214
12432,10865,1567,1173,260600,30215
861,558,303,855,76300,30216
3566,2437,1129,669,100100,30217
580,560,20,900,100600,30218
1893,1268,625,1027,136500,30220
1618,953,665,512,88300,30222
13653,7708,5945,822,114000,30223
9533,6246,3287,925,140100,30224
13431,9858,3573,1121,150100,30228
3453,2272,1181,795,110600,30230
7997,6100,1897,773,136100,30233
765,489,276,953,97200,30234
16186,8666,7520,941,121500,30236
12084,6995,5089,1059,97100,30238
10531,6245,4286,791,152300,30240
8607,4341,4266,897,119000,30241
8158,6436,1722,1184,159600,30248
0,0,0,-,-,30250
861,499,362,801,115500,30251
14533,12334,2199,1280,192300,30252
19125,11151,7974,1098,166500,30253
854,669,185,628,150900,30256
1630,1305,325,708,125900,30257
1023,832,191,944,123700,30258
1109,916,193,976,186000,30259
7969,3851,4118,964,88100,30260
22025,13689,8336,955,183000,30263
12846,9656,3190,1266,208000,30265
3451,2320,1131,965,138700,30268
13437,10041,3396,1380,318800,30269
4960,3751,1209,1154,94600,30273
12561,5073,7488,925,79600,30274
0,0,0,-,-,30275
5412,4649,763,1104,224600,30276
7738,6907,831,1198,225600,30277
23732,14881,8851,1117,147200,30281
30,23,7,-,-,30284
251,200,51,-,72100,30285
8748,5478,3270,627,86400,30286
3317,2353,964,869,94100,30288
76,62,14,739,357100,30289
2921,2466,455,1188,266500,30290
8342,2842,5500,935,106100,30291
1765,1539,226,759,179100,30292
1201,943,258,642,76300,30293
13977,10855,3122,1093,137300,30294
1575,1151,424,700,146200,30295
9049,5618,3431,1153,100000,30296
8883,3575,5308,864,63500,30297
1261,298,963,1030,149000,30303
12001,6837,5164,1356,577200,30305
11022,6323,4699,1349,612300,30306
8884,5021,3863,1197,483300,30307
11168,3249,7919,1298,274900,30308
14400,6814,7586,1316,328700,30309
11309,4513,6796,939,122600,30310
14361,5363,8998,816,114300,30311
11424,3950,7474,1104,263700,30312
2189,674,1515,999,225500,30313
7282,2196,5086,882,84800,30314
12286,4110,8176,817,124400,30315
13183,8191,4992,1173,233200,30316
5548,3473,2075,979,303000,30317
21677,7990,13687,1101,223200,30318
19336,11031,8305,1448,475700,30319
0,0,0,-,-,30322
14393,5625,8768,1358,347300,30324
3680,1191,2489,1765,305100,30326
9178,7084,2094,1463,877000,30327
16437,9580,6857,1358,385100,30328
11463,2829,8634,1303,312700,30329
23605,11769,11836,962,154300,30331
0,0,0,-,-,30332
0,0,0,-,-,30334
88,9,79,1096,-,30336
5585,1602,3983,840,172000,30337
14219,9079,5140,1441,444900,30338
12263,3875,8388,1332,332300,30339
9375,4331,5044,1012,184500,30340
12749,5808,6941,1169,283400,30341
12669,6409,6260,1287,584100,30342
13128,5287,7841,1005,116500,30344
9982,5099,4883,1243,382600,30345
3033,111,2922,1560,290600,30346
26120,14074,12046,953,140800,30349
17060,5907,11153,1159,451700,30350
6277,2037,4240,875,97400,30354
5202,2977,2225,1057,281300,30360
1901,644,1257,1684,215000,30363
5022,3048,1974,616,74100,30401
583,398,185,673,107900,30410
898,485,413,433,52900,30411
24,23,1,-,117500,30412
645,499,146,633,85100,30413
2398,1895,503,782,122000,30415
4040,2677,1363,670,86700,30417
421,327,94,365,58700,30420
1404,987,417,524,83000,30421
46,20,26,638,-,30423
536,459,77,692,89100,30425
247,151,96,711,59400,30426
4170,2954,1216,621,113100,30427
929,651,278,605,62700,30428
66,47,19,759,-,30429
1872,1059,813,568,70200,30434
4493,2874,1619,602,78700,30436
20,11,9,-,-,30438
3960,2355,1605,611,91200,30439
713,521,192,598,75200,30441
2948,1980,968,547,65100,30442
1208,747,461,610,59400,30445
441,357,84,630,67400,30446
21,21,0,-,65000,30448
49,29,20,700,67900,30449
902,652,250,821,74400,30450
18,15,3,-,176600,30451
549,478,71,913,86700,30452
2667,1475,1192,553,64400,30453
225,197,28,-,68600,30454
207,160,47,663,77500,30455
757,600,157,565,81100,30456
2331,1629,702,562,70500,30457
15909,6334,9575,776,140400,30458
0,0,0,-,-,30460
5463,3578,1885,819,147400,30461
24,17,7,644,102500,30464
4566,3259,1307,610,79100,30467
152,105,47,342,159100,30470
1861,1276,585,529,59600,30471
1037,805,232,521,77400,30473
6455,3810,2645,595,110100,30474
0,0,0,-,-,30475
1052,600,452,526,71400,30477
9629,3860,5769,841,163200,30501
8449,4528,3921,941,170000,30504
15383,11970,3413,1058,221600,30506
7978,5695,2283,903,140400,30507
2380,1848,532,701,111200,30510
1313,986,327,649,129500,30511
8325,6434,1891,724,199900,30512
4955,3660,1295,689,189600,30513
789,667,122,795,75600,30516
4685,4004,681,1071,234900,30517
16911,12505,4406,1125,224700,30518
14133,10849,3284,1492,227400,30519
1736,1190,546,671,123200,30520
1807,1390,417,536,112100,30521
479,450,29,-,159000,30522
4982,4079,903,793,170800,30523
3066,2113,953,678,158500,30525
1619,1284,335,1081,197500,30527
9536,7052,2484,777,157500,30528
4085,2553,1532,733,123000,30529
2201,1678,523,818,132500,30530
3772,2681,1091,716,141900,30531
9678,6468,3210,918,186100,30533
10397,8363,2034,870,211200,30534
2693,2007,686,768,153700,30535
3399,2673,726,851,195200,30536
585,469,116,425,191500,30537
1111,868,243,730,85100,30538
7361,5263,2098,715,157700,30540
620,517,103,860,190700,30541
12583,9886,2697,1118,207200,30542
1476,1277,199,897,141600,30543
325,238,87,570,204900,30545
3193,2666,527,757,207300,30546
1198,950,248,642,159700,30547
6461,5746,715,1013,289800,30548
8447,6538,1909,796,190000,30549
661,542,119,988,194300,30552
3187,2081,1106,733,143200,30553
2743,2143,600,863,146700,30554
931,659,272,366,148400,30555
1915,1554,361,779,93800,30557
1968,1475,493,846,120900,30558
1965,1555,410,991,220300,30559
2068,1833,235,995,175900,30560
496,359,137,680,77100,30562
2037,1703,334,763,129900,30563
1330,1021,309,725,158800,30564
1604,1348,256,764,136400,30565
2647,1824,823,962,140000,30566
1086,819,267,1131,215200,30567
741,538,203,-,156500,30568
1791,1470,321,1055,220900,30571
426,343,83,-,156700,30572
52,43,9,-,277900,30573
442,321,121,646,125800,30575
848,755,93,658,169200,30576
7659,5104,2555,685,101800,30577
9,0,9,-,-,30581
1780,1390,390,772,192800,30582
9315,3198,6117,800,93500,30601
0,0,0,-,-,30602
16250,5200,11050,812,170100,30605
17656,8048,9608,875,211300,30606
3386,2096,1290,873,149400,30607
0,0,0,-,-,30609
553,400,153,860,167900,30619
4259,3572,687,1170,159500,30620
1888,1700,188,859,289500,30621
4551,3095,1456,1078,243700,30622
65,59,6,-,-,30623
1142,862,280,635,75800,30624
886,698,188,914,224700,30625
1020,842,178,418,92800,30627
2250,1951,299,693,136600,30628
1784,1287,497,751,111800,30629
873,613,260,563,110800,30630
593,408,185,550,76100,30631
3393,2583,810,667,111300,30633
801,663,138,563,104600,30634
5882,4267,1615,663,79600,30635
825,752,73,1036,156600,30641
5015,3615,1400,691,362000,30642
6173,4622,1551,698,125500,30643
2617,1763,854,807,145300,30646
1203,999,204,751,103600,30648
4380,3252,1128,783,237800,30650
8949,5293,3656,904,163200,30655
5646,4279,1367,980,210200,30656
374,244,130,719,80600,30660
3468,2185,1283,615,103000,30662
1089,762,327,580,182300,30663
17,15,2,-,-,30664
20,12,8,-,32500,30665
3421,2571,850,900,143200,30666
371,294,77,733,98200,30667
659,541,118,553,76600,30668
1325,854,471,734,73300,30669
3034,1941,1093,710,83800,30673
6728,5700,1028,949,241100,30677
543,466,77,469,135000,30678
14052,9554,4498,947,147200,30680
2552,1839,713,846,138700,30683
14419,8503,5916,702,131400,30701
11765,7922,3843,697,111400,30705
6294,4688,1606,734,109500,30707
88,63,25,-,82800,30708
2593,2038,555,629,164400,30710
1374,1190,184,694,86200,30711
9662,5100,4562,731,158800,30720
18135,11099,7036,696,110100,30721
1675,1304,371,754,143300,30725
0,0,0,-,-,30726
7584,5268,2316,650,115800,30728
774,663,111,725,66200,30730
952,711,241,498,107800,30731
737,525,212,789,92900,30733
1368,1018,350,842,147500,30734
2241,1732,509,711,113200,30735
15557,12658,2899,773,154900,30736
1559,1321,238,1194,140800,30738
2059,1649,410,921,168800,30739
3291,2667,624,747,142700,30740
11158,7366,3792,772,89400,30741
3104,1661,1443,667,119600,30742
408,270,138,851,163900,30746
5501,3688,1813,570,78000,30747
1306,1063,243,876,280300,30750
17,17,0,-,-,30751
3361,2325,1036,665,126500,30752
2609,1718,891,633,51000,30753
3245,2391,854,688,121000,30755
71,20,51,-,82900,30756
919,698,221,-,100700,30757
2006,1626,380,648,183100,30802
278,227,51,469,78800,30803
994,726,268,740,87300,30805
35,29,6,-,62800,30807
1456,1127,329,674,85900,30808
13831,11572,2259,1390,249000,30809
714,522,192,606,61300,30810
0,0,0,-,-,30812
13744,10218,3526,1193,175800,30813
2485,1943,542,816,119500,30814
13992,9714,4278,973,108200,30815
791,613,178,496,138900,30816
3319,2344,975,732,120500,30817
238,172,66,-,113600,30818
432,333,99,679,63200,30820
331,293,38,628,76100,30821
296,236,60,-,-,30822
578,509,69,586,46700,30823
6634,3809,2825,645,112800,30824
1841,1170,671,613,60400,30828
4968,3435,1533,561,94000,30830
1229,765,464,485,79800,30833
6483,1921,4562,656,64900,30901
245,245,0,-,194300,30903
10174,4644,5530,763,107800,30904
997,4,993,1367,-,30905
19490,11082,8408,875,85200,30906
18357,13492,4865,978,154000,30907
17400,9128,8272,851,153000,30909
0,0,0,-,-,30912
933,678,255,459,56700,31001
1074,799,275,513,61900,31002
29,29,0,-,-,31003
6079,4677,1402,1128,164700,31005
2019,1389,630,629,83300,31006
410,353,57,230,63000,31007
7384,5441,1943,917,134100,31008
489,396,93,518,65400,31009
282,240,42,543,78500,31011
564,378,186,392,52900,31012
4379,3141,1238,610,95200,31014
7746,4382,3364,660,86300,31015
624,486,138,620,81500,31016
665,486,179,565,80000,31017
475,389,86,742,70600,31018
785,561,224,640,92100,31019
653,494,159,823,65400,31020
10126,5684,4442,596,119200,31021
577,454,123,593,108800,31022
5572,3552,2020,612,84300,31023
8175,6378,1797,710,162100,31024
381,371,10,-,189600,31025
3426,2223,1203,639,60300,31027
2508,1915,593,943,149000,31028
5674,4240,1434,703,153200,31029
6092,3655,2437,627,102100,31030
2279,1673,606,669,75400,31031
5402,4158,1244,817,146700,31032
775,630,145,583,86800,31033
444,368,76,667,83200,31035
4140,2649,1491,701,118100,31036
1399,823,576,705,62700,31037
217,193,24,-,179100,31038
0,0,0,-,-,31039
269,199,70,596,69600,31041
570,474,96,813,67300,31042
1134,838,296,471,59700,31044
19,19,0,-,-,31045
1280,1212,68,344,159500,31046
4962,4031,931,1174,190900,31047
643,475,168,644,71800,31049
343,206,137,-,-,31050
55,37,18,267,41300,31051
3098,2731,367,845,150800,31052
537,395,142,640,59400,31054
2213,1269,944,553,71800,31055
860,557,303,544,68000,31057
576,480,96,623,81400,31058
772,620,152,651,63700,31060
15802,8722,7080,703,116600,31061
0,0,0,-,-,31062
1905,1241,664,558,69400,31063
3513,2507,1006,793,123700,31064
449,355,94,454,67100,31065
443,353,90,535,157100,31066
97,87,10,-,70600,31067
1400,890,510,561,44800,31068
7151,4408,2743,828,145100,31069
352,248,104,435,117500,31070
503,393,110,475,68100,31071
565,434,131,442,74400,31072
950,759,191,838,69600,31075
1312,985,327,444,66700,31076
588,434,154,554,72900,31077
1150,753,397,610,69700,31078
835,648,187,640,83800,31079
24,24,0,-,-,31081
3755,2500,1255,625,87300,31082
130,96,34,498,60000,31083
27,27,0,-,-,31084
412,315,97,925,108500,31085
3021,2256,765,704,78200,31087
20999,13697,7302,922,134800,31088
1856,1085,771,681,73600,31089
335,242,93,541,75000,31090
1320,923,397,486,82000,31091
2701,1816,885,581,88700,31092
11036,5563,5473,801,90200,31093
466,340,126,581,98900,31094
2478,1650,828,515,66400,31096
548,463,85,850,102900,31097
1016,5,1011,1194,-,31098
3291,768,2523,599,80200,31201
11726,5836,5890,736,89100,31204
9195,3851,5344,703,63400,31206
4,4,0,-,-,31207
13967,7416,6551,916,185900,31210
6302,3766,2536,722,100400,31211
0,0,0,-,-,31213
5836,4751,1085,859,134900,31216
6110,3758,2352,702,69900,31217
5598,3534,2064,946,155100,31220
1753,704,1049,700,110600,31301
3346,2455,891,818,140200,31302
843,643,200,870,182700,31303
0,0,0,-,-,31304
2423,1707,716,775,119700,31305
292,282,10,-,139200,31307
2676,2020,656,960,119600,31308
388,285,103,727,90500,31309
6657,5775,882,935,161200,31312
15839,7121,8718,999,124900,31313
0,0,0,-,-,31314
2433,9,2424,1276,-,31315
3988,2863,1125,853,131900,31316
143,143,0,-,136700,31318
3204,2308,896,1045,129500,31320
2581,2007,574,721,135900,31321
9490,5663,3827,1238,202100,31322
585,488,97,723,79000,31323
8890,6103,2787,1390,252800,31324
7488,5064,2424,1065,174900,31326
142,142,0,-,354300,31327
1441,967,474,1222,497000,31328
3404,2259,1145,887,118900,31329
3442,2816,626,951,118300,31331
8031,2541,5490,948,283800,31401
11719,5258,6461,962,114800,31404
13965,7246,6719,1065,192800,31405
13452,7902,5550,1028,173600,31406
4823,3011,1812,1179,177500,31407
3091,1188,1903,892,120400,31408
0,0,0,-,-,31409
9895,7277,2618,1251,255100,31410
4147,3853,294,1362,489500,31411
4468,1708,2760,806,82500,31415
21910,10810,11100,1047,158400,31419
6123,3237,2886,628,80600,31501
7757,5713,2044,690,87200,31503
3454,2322,1132,511,75900,31510
840,612,228,505,101600,31512
5847,4214,1633,559,74800,31513
5381,4127,1254,651,98900,31516
340,265,75,524,84600,31518
1367,1026,341,560,67600,31519
9238,4246,4992,751,88000,31520
7493,5550,1943,1484,379200,31522
5395,4449,946,833,160600,31523
0,0,0,-,-,31524
11298,6477,4821,930,142100,31525
306,236,70,1061,350000,31527
254,215,39,-,66300,31532
5922,3251,2671,592,100100,31533
4136,3021,1115,651,112700,31535
2922,2093,829,542,84100,31537
5101,3439,1662,557,77000,31539
1018,789,229,524,68000,31542
1664,1323,341,503,60300,31543
333,244,89,-,74500,31544
5705,3293,2412,592,108200,31545
2423,1613,810,658,114900,31546
101,0,101,1411,-,31547
7595,4517,3078,944,153100,31548
834,563,271,629,38900,31549
329,235,94,-,62800,31550
368,218,150,549,102100,31551
299,276,23,-,60000,31552
1766,1339,427,618,74800,31553
1888,1475,413,613,62800,31554
1073,899,174,575,85000,31555
31,23,8,-,-,31556
1204,920,284,660,81200,31557
8198,4676,3522,976,176000,31558
1118,828,290,563,114800,31560
20,20,0,-,-,31561
741,615,126,575,78200,31562
507,382,125,754,101000,31563
870,771,99,841,168200,31565
1384,1256,128,494,71000,31566
320,193,127,626,112500,31567
344,295,49,-,103500,31568
2115,1634,481,825,144500,31569
11572,5220,6352,653,80900,31601
13178,5457,7721,805,139500,31602
8003,4987,3016,977,154600,31605
1204,957,247,648,86400,31606
3874,2566,1308,714,104700,31620
826,623,203,657,65400,31622
42,39,3,-,62100,31623
481,411,70,475,56800,31624
381,326,55,-,102700,31625
1427,1048,379,752,105600,31626
119,83,36,628,102500,31627
254,138,116,2042,-,31629
182,110,72,392,44800,31630
170,165,5,-,44800,31631
4371,3251,1120,1100,156800,31632
2091,1480,611,430,62400,31634
2347,1252,1095,611,95300,31635
3895,2609,1286,685,132500,31636
1128,824,304,673,78400,31637
438,288,150,708,62500,31638
4047,2759,1288,570,85900,31639
668,532,136,728,104800,31641
1567,1146,421,522,62100,31642
3572,2630,942,667,96900,31643
1927,1210,717,693,113400,31645
1313,784,529,815,57800,31647
413,271,142,611,59800,31648
488,460,28,429,97100,31649
1210,972,238,369,55400,31650
0,0,0,-,-,31698
0,0,0,-,-,31699
7379,2468,4911,636,76200,31701
10910,4860,6050,693,70900,31705
10905,4565,6340,798,112500,31707
6190,3066,3124,706,108500,31709
356,219,137,657,75900,31711
484,315,169,607,71300,31712
2258,1544,714,510,78000,31714
975,793,182,702,76100,31716
3425,1977,1448,627,72000,31719
129,89,40,648,77900,31720
7901,5750,2151,889,170900,31721
169,112,57,535,60000,31722
3417,2083,1334,665,90100,31730
572,464,108,664,107900,31733
370,263,107,1052,99300,31735
803,587,216,604,91300,31738
165,80,85,859,89000,31743
1153,789,364,572,74600,31744
76,53,23,379,-,31747
909,581,328,631,75200,31749
6996,4269,2727,626,81200,31750
292,292,0,-,94600,31756
4180,2991,1189,847,147200,31757
8508,5940,2568,899,147500,31763
491,386,105,729,87900,31764
1128,816,312,553,84600,31765
7778,4188,3590,707,82300,31768
1866,1169,697,540,77200,31771
181,145,36,-,147000,31772
1461,1141,320,819,137300,31773
2315,1590,725,530,67300,31774
1097,912,185,564,63500,31775
987,812,175,560,83200,31778
3120,1902,1218,600,90000,31779
853,639,214,770,65500,31780
784,509,275,749,74800,31781
357,333,24,675,84700,31783
255,180,75,641,102600,31784
605,402,203,633,91600,31787
3574,2334,1240,603,119200,31788
396,296,100,704,109600,31789
663,410,253,647,64000,31790
4731,2915,1816,711,92200,31791
9247,5108,4139,808,143900,31792
3276,2505,771,631,152600,31793
10287,5243,5044,649,111000,31794
742,591,151,761,68200,31795
495,368,127,676,95000,31796
278,212,66,-,51100,31798
1322,1138,184,756,126300,31801
2112,1423,689,492,83000,31803
2094,1918,176,1218,229600,31804
1019,660,359,564,68200,31805
1862,1298,564,648,111300,31806
1089,933,156,1094,196100,31807
2447,2269,178,1202,235800,31808
120,91,29,530,57900,31810
2132,1828,304,1060,215500,31811
251,195,56,-,81900,31812
139,88,51,-,-,31814
803,574,229,477,57900,31815
2165,1173,992,616,87700,31816
3787,3254,533,1321,264100,31820
58,58,0,-,43100,31821
2317,1679,638,844,146000,31822
333,303,30,-,133400,31823
694,541,153,393,32500,31824
1024,749,275,484,61300,31825
946,650,296,781,100000,31826
883,660,223,481,55100,31827
354,326,28,-,270100,31829
828,520,308,813,98500,31830
1311,1182,129,833,164000,31831
112,87,25,-,71900,31832
2918,1851,1067,785,125100,31833
436,368,68,503,-,31836
2919,612,2307,594,144400,31901
7108,2383,4725,684,60700,31903
13103,6398,6705,853,165400,31904
3589,7,3582,1486,-,31905
8711,3621,5090,744,123400,31906
20036,11076,8960,884,110000,31907
15092,7609,7483,1050,160700,31909
10292,8116,2176,1500,255800,32003
1853,1485,368,691,83100,32008
1217,1068,149,1194,158400,32009
4999,4115,884,775,170800,32011
7045,5930,1115,907,118500,32024
7533,4569,2964,836,115900,32025
0,0,0,-,-,32026
1792,1428,364,1306,179800,32033
15074,11444,3630,1141,310700,32034
3887,3339,548,873,101400,32038
2465,2104,361,829,117300,32040
9032,6723,2309,984,180700,32043
764,615,149,-,71500,32044
3341,2576,765,885,135500,32046
2720,1824,896,575,72500,32052
1088,835,253,874,67600,32053
3476,2471,1005,604,108100,32054
6165,4215,1950,803,117700,32055
1210,935,275,785,102100,32058
974,849,125,778,83700,32059
8093,5884,2209,779,105300,32060
104,84,20,-,188000,32061
757,684,73,434,87500,32062
4512,3115,1397,734,152100,32063
2354,1196,1158,645,88700,32064
12373,9135,3238,1208,185100,32065
1753,1383,370,534,110500,32066
19383,14768,4615,1170,153600,32068
1263,949,314,709,114800,32071
120,120,0,-,61400,32072
15574,10058,5516,1046,166800,32073
239,20,219,1336,92500,32079
9535,7128,2407,1172,352300,32080
4374,3574,800,1689,371300,32081
12745,10339,2406,1400,489400,32082
492,310,182,738,100500,32083
12861,8226,4635,971,187800,32084
11586,8626,2960,1132,214000,32086
1468,1125,343,805,75500,32087
5619,3497,2122,817,86300,32091
11984,10424,1560,1708,270200,32092
910,786,124,-,70700,32094
3784,2905,879,1180,257900,32095
1015,762,253,508,93000,32096
6578,5282,1296,1206,185100,32097
1109,893,216,1133,130100,32102
2916,1980,936,758,116900,32110
2849,2091,758,583,86200,32112
1942,1536,406,963,84500,32113
13528,4192,9336,852,97300,32114
9823,5214,4609,935,89300,32117
9024,5737,3287,911,219500,32118
10021,6140,3881,992,131900,32119
1598,1318,280,1679,215600,32124
12777,9611,3166,1119,172900,32127
7854,6692,1162,1522,252300,32128
9722,6458,3264,1102,130900,32129
1945,1532,413,1004,167700,32130
1736,1270,466,792,127700,32131
3302,2570,732,875,132600,32132
25,25,0,-,-,32133
3050,2530,520,791,68600,32134
3721,3036,685,1070,234000,32136
16689,13339,3350,1225,226800,32137
452,432,20,-,70000,32139
548,490,58,-,60800,32140
7379,5955,1424,1039,148700,32141
1875,1510,365,849,83200,32145
174,130,44,-,22400,32147
4043,2802,1241,706,62100,32148
106,64,42,825,169300,32157
15267,12509,2758,1007,174900,32159
30152,28919,1233,1586,261400,32162
16303,11512,4791,1175,186000,32164
11549,8978,2571,1012,208500,32168
5448,4207,1241,1321,348000,32169
22123,17208,4915,1032,203300,32174
7090,5281,1809,1143,214800,32176
10138,6595,3543,711,87800,32177
3333,2606,727,725,66700,32179
1240,976,264,706,118300,32180
857,734,123,913,92500,32181
733,568,165,539,141500,32187
2557,2207,350,860,68900,32189
371,269,102,621,115100,32190
329,239,90,629,110500,32193
1229,1069,160,1306,121300,32195
1793,187,1606,600,117000,32202
3825,1070,2755,944,152600,32204
13074,6145,6929,897,146700,32205
6767,2801,3966,788,78700,32206
14740,7081,7659,897,157200,32207
12336,7022,5314,922,76100,32208
13207,6182,7025,768,56300,32209
23548,12417,11131,943,118000,32210
13258,5842,7416,854,118100,32211
248,0,248,1605,-,32212
15592,7469,8123,1039,152200,32216
8377,4358,4019,886,181400,32217
21429,13228,8201,1036,157600,32218
4115,3354,761,916,131600,32219
4627,3696,931,958,133700,32220
10050,7487,2563,1260,155200,32221
3304,2322,982,1214,174800,32222
9566,7893,1673,1156,257900,32223
15868,9322,6546,1279,284300,32224
19956,13946,6010,1284,211700,32225
5544,4625,919,1641,209100,32226
411,4,407,1574,-,32227
0,0,0,-,-,32228
9518,5510,4008,1140,254200,32233
2183,1624,559,869,107000,32234
21611,12839,8772,1060,122700,32244
20148,10777,9371,1180,166200,32246
12378,8408,3970,1283,343500,32250
4624,2248,2376,896,60100,32254
20410,7535,12875,1173,263200,32256
15517,9449,6068,1054,194900,32257
12186,8483,3703,1377,226300,32258
15732,13557,2175,1805,336500,32259
2924,2003,921,1243,381400,32266
11913,6198,5715,993,157500,32277
12947,4146,8801,978,149700,32301
21112,10373,10739,1017,148000,32303
16535,2187,14348,915,90500,32304
7789,4805,2984,836,100000,32305
10318,5672,4646,1054,220200,32308
12391,9741,2650,1110,252700,32309
5662,2719,2943,841,96500,32310
8139,5054,3085,1179,194900,32311
12683,10376,2307,1261,293300,32312
5333,4837,496,1445,250600,32317
1512,1028,484,692,139200,32320
1616,1182,434,577,57400,32321
1132,901,231,735,128900,32322
155,124,31,-,49000,32323
1673,1061,612,663,81200,32324
9616,7734,1882,857,147800,32327
1274,1025,249,884,157300,32328
280,149,131,781,76000,32330
1613,1337,276,685,76900,32331
526,338,188,604,60300,32332
4735,3630,1105,750,119800,32333
765,611,154,586,139600,32334
557,496,61,-,96400,32336
3896,2791,1105,685,93000,32340
1277,963,314,903,137600,32343
5023,3830,1193,772,120100,32344
800,593,207,877,108100,32346
2880,2519,361,665,86000,32347
3664,2843,821,707,75900,32348
559,497,62,811,117400,32350
6206,4165,2041,617,88200,32351
2383,1828,555,733,88600,32352
100,84,16,1028,152500,32355
46,46,0,-,-,32356
785,689,96,818,146500,32358
732,477,255,929,113600,32359
84,77,7,-,82000,32361
0,0,0,-,-,32399
9323,4622,4701,858,128500,32401
810,0,810,1562,-,32403
14384,9375,5009,951,155100,32404
12496,7098,5398,1002,171500,32405
4503,2389,2114,1283,219400,32407
7408,4612,2796,1080,223000,32408
3618,3014,604,907,159100,32409
506,386,120,1241,220800,32410
6288,4561,1727,1030,237600,32413
849,734,115,641,78500,32420
1814,1497,317,697,68100,32421
425,375,50,784,79200,32423
1968,1576,392,642,86600,32424
4672,3412,1260,664,95200,32425
349,296,53,739,76800,32426
406,337,69,810,81500,32427
5585,4320,1265,764,117500,32428
420,366,54,-,90000,32430
1615,1208,407,659,85000,32431
0,0,0,-,-,32432
6306,4439,1867,762,104800,32433
2883,2098,785,727,129900,32435
304,203,101,-,77500,32437
1397,1282,115,464,74500,32438
3953,2914,1039,970,208500,32439
2015,1411,604,649,110400,32440
1431,1046,385,629,133500,32442
1264,997,267,681,88500,32443
8085,6001,2084,1039,197100,32444
475,332,143,719,86200,32445
3968,2668,1300,696,146200,32446
0,0,0,-,-,32447
3890,2536,1354,463,86100,32448
231,213,18,-,73400,32449
1723,1308,415,680,87400,32455
3356,2403,953,1161,186600,32456
6356,4917,1439,1411,377700,32459
1463,1090,373,644,90800,32460
23,23,0,-,-,32461
1395,1051,344,603,91000,32462
65,37,28,625,67500,32463
1836,1592,244,449,79200,32464
2237,1758,479,847,93100,32465
2017,1827,190,898,122400,32466
4323,2240,2083,788,120500,32501
1452,795,657,988,139600,32502
11984,7416,4568,888,153600,32503
9199,5159,4040,968,163800,32504
10926,5501,5425,876,63000,32505
14117,7673,6444,1038,116700,32506
12952,7339,5613,943,151000,32507
505,0,505,1256,-,32508
0,0,0,-,-,32509
0,0,0,-,-,32511
16816,8411,8405,982,137400,32514
14320,10724,3596,1066,127100,32526
0,0,0,-,-,32530
2154,1883,271,1065,176700,32531
10190,8449,1741,1066,162400,32533
6144,4360,1784,1059,112500,32534
1818,1168,650,693,77300,32535
8459,5465,2994,1043,192400,32536
9400,6654,2746,956,153800,32539
8088,4957,3131,1457,358900,32541
658,0,658,1442,-,32542
311,0,311,1436,-,32544
14518,6834,7684,1025,174500,32547
9502,5363,4139,994,175900,32548
3866,2732,1134,1208,360400,32550
3974,3165,809,1413,394900,32561
9770,7460,2310,1182,233800,32563
1034,848,186,1159,168600,32564
2089,1647,442,909,114600,32565
14019,10843,3176,1288,228000,32566
1309,1067,242,740,121900,32567
1038,846,192,938,150600,32568
4915,3367,1548,1052,179800,32569
11658,8058,3600,899,139200,32570
12210,9368,2842,1020,177200,32571
1747,1522,225,713,137600,32577
12436,9461,2975,1168,268500,32578
4360,2940,1420,1178,269200,32579
1497,957,540,1127,213100,32580
8558,6505,2053,986,134700,32583
7628,2163,5465,838,147800,32601
1718,331,1387,839,266600,32603
10107,7183,2924,1208,183000,32605
9160,4825,4335,1220,205900,32606
11911,4065,7846,929,205700,32607
19357,7730,11627,975,226700,32608
6894,3993,2901,879,98300,32609
5,0,5,-,-,32612
5572,4238,1334,1012,167700,32615
391,214,177,722,86300,32616
1491,1226,265,595,133800,32617
2871,2355,516,730,157000,32618
2037,1726,311,763,88600,32619
2131,1536,595,642,74300,32621
371,320,51,779,116000,32622
680,505,175,774,138100,32625
3639,2763,876,672,93000,32626
1333,944,389,703,80100,32628
149,149,0,-,274500,32631
81,70,11,-,46500,32639
4317,3524,793,738,109300,32640
4715,2804,1911,846,95900,32641
4339,3600,739,916,159600,32643
184,168,16,-,160300,32648
5745,4385,1360,937,191400,32653
5473,4347,1126,900,105600,32656
104,85,19,1125,99000,32658
229,173,56,900,108100,32664
2670,2128,542,869,136100,32666
1720,1258,462,728,236200,32667
2044,1709,335,948,153500,32668
4662,3955,707,973,194900,32669
4550,3578,972,577,67700,32680
31,31,0,-,-,32681
48,42,6,-,-,32683
1871,1338,533,586,151300,32686
142,142,0,-,-,32692
4405,3451,954,678,88100,32693
838,603,235,535,119200,32694
4692,3708,984,752,136400,32696
102,8,94,805,180000,32697
9633,4992,4641,1120,162200,32701
1151,768,383,2181,63400,32702
17678,10842,6836,1094,168500,32703
14371,9332,5039,1143,162400,32707
16702,12493,4209,1247,242000,32708
818,724,94,-,168900,32709
15659,12429,3230,1287,227000,32712
8297,6960,1337,1078,184600,32713
14829,6978,7851,1185,188000,32714
12478,8570,3908,921,177600,32720
14210,9756,4454,1008,161800,32724
16693,12930,3763,1123,143100,32725
8657,5451,3206,846,145600,32726
2500,988,1512,1068,142400,32730
1760,1727,33,-,302400,32732
2038,1792,246,1160,129400,32735
3370,3050,320,1030,258200,32736
14994,11252,3742,1154,140000,32738
1516,1261,255,985,156200,32744
16676,10674,6002,1397,289500,32746
9033,6357,2676,1195,220100,32750
8481,5854,2627,1280,284400,32751
4038,3613,425,821,161700,32754
11303,7884,3419,1036,205800,32757
1228,902,326,833,160100,32759
8996,5599,3397,1110,114400,32763
1202,1083,119,986,214800,32764
21128,14752,6376,1384,270300,32765
5134,4517,617,1696,322500,32766
1063,845,218,850,93500,32767
19336,11541,7795,1143,185900,32771
11056,6531,4525,1053,124600,32773
3966,3316,650,1309,215400,32776
9082,6824,2258,944,135400,32778
10777,8772,2005,1384,310400,32779
15260,10602,4658,904,151200,32780
4315,3143,1172,727,132600,32784
11015,7534,3481,1153,437700,32789
20657,9590,11067,1130,209600,32792
8202,6143,2059,952,126700,32796
1294,1208,86,1061,78800,32798
7394,1679,5715,1233,314200,32801
9497,5162,4335,1235,266300,32803
7722,4887,2835,1169,305500,32804
7706,2529,5177,778,115200,32805
11265,6589,4676,1107,242600,32806
11820,5372,6448,1080,138100,32807
18106,7092,11014,960,97400,32808
9275,4833,4442,973,150100,32809
13447,6845,6602,1099,128400,32810
15429,3751,11678,1080,86800,32811
14144,7938,6206,1080,213600,32812
3165,1431,1734,1807,440000,32814
11528,6337,5191,1193,202100,32817
16968,9283,7685,1037,155500,32818
10142,6481,3661,1290,317300,32819
2836,2490,346,1305,255000,32820
7232,2888,4344,1312,191500,32821
22469,8764,13705,1104,117800,32822
13039,8768,4271,1434,204200,32824
20407,12632,7775,1201,198600,32825
7646,4075,3571,1121,161500,32826
3498,2184,1314,1653,284700,32827
21327,13508,7819,1457,251700,32828
6230,4756,1474,1424,217100,32829
5,0,5,-,-,32830
25,25,0,-,-,32831
8170,5267,2903,1591,322500,32832
3271,2556,715,891,235000,32833
16879,6759,10120,1299,223400,32835
7145,4758,2387,1273,427700,32836
17084,9648,7436,1379,222100,32837
18160,4044,14116,1033,126700,32839
10722,5035,5687,918,134200,32901
6012,4881,1131,1248,329400,32903
11824,9265,2559,1257,199500,32904
9508,4986,4522,930,111100,32905
14883,11669,3214,1125,141000,32907
3996,3237,759,1267,147800,32908
10760,8493,2267,1004,147800,32909
5380,3206,2174,864,228800,32920
5925,2308,3617,746,88800,32922
440,0,440,1417,-,32925
8365,6472,1893,970,145500,32926
9401,8045,1356,1027,134100,32927
7155,4763,2392,1135,313800,32931
7132,6093,1039,1377,225100,32934
17006,10064,6942,968,141400,32935
11349,8608,2741,1209,274200,32937
15694,12890,2804,1381,262000,32940
1776,1282,494,744,150700,32948
956,910,46,1114,311500,32949
1683,1562,121,886,258900,32950
5310,4442,868,1535,329700,32951
8432,6902,1530,1114,270300,32952
9861,7247,2614,955,245300,32953
15167,11475,3692,1224,207700,32955
10839,8930,1909,995,171100,32958
8364,4742,3622,864,158100,32960
9025,7283,1742,968,135400,32962
7181,6653,528,1518,609500,32963
7934,5872,2062,1037,123100,32966
7604,5723,1881,965,204200,32967
4615,4288,327,1287,253800,32968
82,82,0,-,59500,32970
4662,4133,529,842,84900,32976
201,134,67,2175,322600,33001
6561,3121,3440,1248,190900,33004
18421,9570,8851,1190,202700,33009
15108,4680,10428,981,213800,33010
23929,11160,12769,1105,206400,33012
9543,5454,4089,1102,220900,33013
14119,6094,8025,1236,243400,33014
21075,10986,10089,1347,241300,33015
14948,8180,6768,1328,199400,33016
14004,10279,3725,1592,249400,33018
6880,5076,1804,1582,427400,33019
18546,6143,12403,1050,196100,33020
18255,11829,6426,1303,254600,33021
20500,13523,6977,1235,187200,33023
23426,15739,7687,1327,220100,33024
24198,11355,12843,1405,215500,33025
11307,9253,2054,1668,251100,33026
21138,16783,4355,1456,307000,33027
8054,6149,1905,1961,373600,33028
12773,11261,1512,2612,379100,33029
9011,3431,5580,1039,195100,33030
1925,1652,273,1299,381900,33031
12314,6714,5600,1204,221100,33032
15375,8391,6984,1252,197000,33033
4894,1810,3084,1058,113200,33034
4390,1830,2560,1455,167700,33035
1519,1245,274,1397,635100,33036
4630,3484,1146,1443,422100,33037
106,106,0,-,236700,33039
13160,5853,7307,1739,499000,33040
3002,2275,727,1822,486900,33042
2023,1531,492,1675,368100,33043
3910,2230,1680,1319,403700,33050
349,223,126,1313,566800,33051
9072,4247,4825,857,141400,33054
11368,8591,2777,1315,179200,33055
9860,6224,3636,1182,164700,33056
12867,5557,7310,1106,238000,33060
12053,8637,3416,1336,342100,33062
22261,15313,6948,1387,166400,33063
20480,13071,7409,1258,172700,33064
17886,8908,8978,1312,260800,33065
8673,7082,1591,1193,122000,33066
8714,6125,2589,1641,434400,33067
16131,9313,6818,1366,165800,33068
10453,5144,5309,1274,154000,33069
2175,1487,688,1631,487300,33070
12879,8209,4670,1525,353900,33071
11338,6384,4954,1694,304200,33073
11501,9192,2309,2344,481700,33076
0,0,0,-,-,33101
273,232,41,-,"2,000,000+",33109
47,0,47,2174,-,33122
20893,5212,15681,1004,214400,33125
18026,6140,11886,1228,185000,33126
10096,2828,7268,961,183900,33127
3113,169,2944,773,180100,33128
6210,3018,3192,1829,488800,33129
12767,1939,10828,1096,288000,33130
9417,3035,6382,2252,473700,33131
6389,1668,4721,1964,483100,33132
13628,6466,7162,1434,628600,33133
16304,8650,7654,1376,475700,33134
14517,2854,11663,998,262300,33135
5830,791,5039,824,173700,33136
10039,2659,7380,1616,339900,33137
12447,5689,6758,949,415700,33138
20882,7237,13645,1426,398800,33139
9181,5342,3839,1632,621200,33140
17739,5391,12348,1273,323600,33141
18983,5000,13983,901,156800,33142
12274,6599,5675,1321,563400,33143
9175,5362,3813,1320,281200,33144
11555,5664,5891,1413,340200,33145
4077,3083,994,2179,868300,33146
14189,6520,7669,1007,139800,33147
4367,3105,1262,2448,1218200,33149
9733,2934,6799,864,174200,33150
6272,3428,2844,1805,592500,33154
14518,10378,4140,1447,335900,33155
10991,7800,3191,1664,812100,33156
19426,13023,6403,1150,287900,33157
2110,1976,134,2338,667000,33158
19617,10704,8913,1503,296300,33160
15904,6162,9742,1076,213800,33161
12927,6959,5968,1110,182800,33162
16079,10768,5311,1378,287900,33165
7908,3773,4135,1261,341600,33166
5706,3093,2613,1108,172700,33167
6701,4740,1961,1299,171800,33168
11777,6180,5597,1142,181700,33169
3823,2247,1576,1011,253000,33170
13687,6076,7611,1462,158700,33172
10977,7733,3244,1466,307000,33173
9667,5582,4085,1264,253700,33174
15655,11703,3952,1556,281400,33175
17152,11638,5514,1371,376700,33176
14600,10529,4071,1425,236600,33177
14891,7767,7124,2028,373800,33178
15886,9501,6385,1228,154600,33179
14729,9816,4913,1868,377700,33180
7435,2832,4603,1192,247100,33181
3769,3305,464,1786,315700,33182
11630,7370,4260,1440,233800,33183
6104,4612,1492,1443,238600,33184
7954,6758,1196,2205,348900,33185
21383,14387,6996,1676,278900,33186
5127,4576,551,1955,329300,33187
7943,4677,3266,1158,244400,33189
4608,1917,2691,1304,246000,33190
14402,9102,5300,1459,260100,33193
1563,1274,289,1818,345400,33194
13948,9254,4694,1804,300500,33196
7675,3687,3988,1965,570700,33301
9329,3418,5911,1225,395000,33304
6466,3988,2478,1348,395800,33305
1752,1113,639,1044,479300,33306
15485,10612,4873,1340,377700,33308
12974,7870,5104,1239,170500,33309
22430,9141,13289,1085,140600,33311
17769,10070,7699,1259,239500,33312
19653,8287,11366,1122,117800,33313
8768,3802,4966,1322,165300,33314
6029,3206,2823,1361,289300,33315
5077,3132,1945,1110,560000,33316
12456,9268,3188,1290,285500,33317
18181,11711,6470,1218,120500,33319
19836,14496,5340,1396,162600,33321
16111,12957,3154,1632,151900,33322
7038,4929,2109,1936,302000,33323
19217,10707,8510,1609,219000,33324
9099,6974,2125,1618,301400,33325
10847,7422,3425,1827,355900,33326
6609,5210,1399,2617,528800,33327
10166,7828,2338,1514,341300,33328
4612,4218,394,2657,506800,33330
7578,6484,1094,2332,473400,33331
3210,2870,340,2362,598100,33332
12280,6635,5645,1125,261600,33334
11425,6077,5348,1457,203800,33351
11588,4482,7106,1223,228100,33401
4236,1905,2331,1185,172400,33403
10002,5460,4542,1091,147900,33404
7021,4070,2951,1139,262000,33405
8580,5505,3075,1246,185300,33406
10719,4576,6143,1086,163600,33407
9025,6986,2039,1319,349600,33408
11116,4788,6328,1204,154600,33409
14869,9785,5084,1516,296200,33410
24028,17610,6418,1362,267700,33411
5320,4648,672,1947,348000,33412
5099,3249,1850,1439,232300,33413
19617,14423,5194,1751,349700,33414
16516,9280,7236,1129,114400,33415
14246,8261,5985,1099,71100,33417
16864,13338,3526,1693,381600,33418
9361,5614,3747,1534,183300,33426
13682,9804,3878,1604,270500,33428
7249,2254,4995,616,102000,33430
7576,5235,2341,1573,380400,33431
10269,6469,3800,1583,586800,33432
18180,12503,5677,1755,287600,33433
9694,8087,1607,1103,235000,33434
13441,7735,5706,1423,160400,33435
17401,12600,4801,1419,220400,33436
18402,15978,2424,1462,275400,33437
84,78,6,-,112500,33438
6467,4147,2320,795,71600,33440
11029,5377,5652,1179,211900,33441
13692,9090,4602,1589,131400,33442
8257,4313,3944,1270,277200,33444
13655,8439,5216,1540,203500,33445
12932,11040,1892,1109,272800,33446
3802,3590,212,1913,417400,33449
9854,8112,1742,1050,250600,33455
21197,15051,6146,1513,346900,33458
11310,4729,6581,1048,199400,33460
14912,7079,7833,1156,128400,33461
12124,7159,4965,1175,200200,33462
18184,12596,5588,1274,174800,33463
19875,17141,2734,1204,286700,33467
6805,5823,982,1350,356800,33469
7881,7105,776,1805,306600,33470
2086,1563,523,709,67000,33471
7940,7247,693,2142,279400,33472
3540,2998,542,2848,564800,33473
2735,1048,1687,563,96100,33476
7356,6002,1354,1614,385200,33477
4506,4403,103,1857,371700,33478
5615,4804,811,1668,943000,33480
6051,4203,1848,1660,544700,33483
14332,11098,3234,1304,137600,33484
9097,7286,1811,1441,399100,33486
9168,7179,1989,1798,386700,33487
540,257,283,819,83400,33493
9701,8403,1298,1779,370400,33496
5165,4879,286,2646,404500,33498
50,45,5,-,267900,33503
10310,6175,4135,1118,160000,33510
21972,10746,11226,1209,186600,33511
3819,3091,728,697,93300,33513
690,406,284,816,87100,33514
184,138,46,628,65000,33521
6371,4287,2084,786,113000,33523
7249,5252,1997,783,141600,33525
4753,3521,1232,889,220600,33527
4942,3193,1749,1024,165200,33534
1939,1502,437,780,85000,33538
3846,2742,1104,773,70900,33540
8868,6953,1915,954,69300,33541
9792,6901,2891,815,69400,33542
8944,7177,1767,1413,208200,33543
9304,6572,2732,1474,241200,33544
5814,4294,1520,1510,198100,33545
7916,6556,1360,1772,316900,33547
2545,2262,283,1354,346500,33548
6858,5278,1580,1047,220300,33549
7958,7238,720,1301,361800,33556
8688,5947,2741,1037,329300,33558
6663,3843,2820,1174,176100,33559
9683,5269,4414,915,122200,33563
6085,4791,1294,948,157500,33565
7035,5096,1939,959,191600,33566
3692,2766,926,730,173700,33567
9617,7742,1875,1345,201400,33569
9311,6712,2599,892,158200,33570
7613,6433,1180,1574,260400,33572
12630,10031,2599,1801,162500,33573
2061,1829,232,740,183000,33576
18564,9919,8645,1198,181200,33578
10390,8065,2325,1687,207400,33579
9258,7099,2159,1128,160600,33584
480,399,81,781,164000,33585
3989,2674,1315,813,101300,33592
12663,10256,2407,1353,176800,33594
9893,8546,1347,1618,260400,33596
2843,2411,432,791,106800,33597
5453,4164,1289,817,221800,33598
7865,3084,4781,1551,305300,33602
8467,4440,4027,984,165100,33603
14951,7443,7508,939,140100,33604
7041,2539,4502,920,93700,33605
8030,3566,4464,1342,505600,33606
10644,4159,6485,1257,144500,33607
8476,4468,4008,1141,347200,33609
16005,6773,9232,971,99300,33610
14838,8321,6517,1103,257700,33611
18487,6304,12183,887,127700,33612
14335,4272,10063,852,158200,33613
18484,7232,11252,961,152300,33614
17479,9406,8073,1059,155800,33615
6519,3027,3492,1292,187100,33616
18006,6666,11340,967,147400,33617
11423,7446,3977,1078,273000,33618
13156,6005,7151,1119,102100,33619
11,0,11,-,-,33620
563,0,563,2135,-,33621
15017,9641,5376,1225,212400,33624
10180,6845,3335,1263,208500,33625
11371,7440,3931,1485,347700,33626
10454,8308,2146,1245,492300,33629
7568,4620,2948,1249,162400,33634
7120,4342,2778,1361,164700,33635
6258,2391,3867,1103,146000,33637
24218,13572,10646,1302,284500,33647
8629,3017,5612,859,344500,33701
13070,8111,4959,981,157600,33702
10694,8096,2598,1345,208200,33703
7372,5241,2131,978,364800,33704
10546,5762,4784,1033,177100,33705
8513,6154,2359,1155,397600,33706
12349,8329,4020,1041,185800,33707
8310,6063,2247,1167,282700,33708
10886,7943,2943,931,111000,33709
13341,10084,3257,985,177500,33710
7224,4137,3087,1140,151000,33711
9366,4857,4509,985,163300,33712
12724,8231,4493,1102,149400,33713
7999,4947,3052,971,89000,33714
3769,3327,442,1606,375300,33715
8882,1561,7321,1212,206500,33716
0,0,0,-,-,33744
9300,4856,4444,962,174200,33755
13356,7811,5545,910,182600,33756
7785,4383,3402,1253,164700,33759
6600,3054,3546,1038,120800,33760
8951,7323,1628,994,160200,33761
2652,1939,713,1342,229800,33762
9416,6561,2855,1061,115800,33763
11353,8028,3325,1120,171800,33764
5899,2695,3204,1005,152300,33765
4111,3305,806,1725,431500,33767
11686,6505,5181,1034,166000,33770
13867,7641,6226,981,82000,33771
9934,7297,2637,1116,191500,33772
7263,5266,1997,1009,172900,33773
8237,5827,2410,1008,203300,33774
5115,4640,475,1462,268400,33776
7115,5598,1517,1233,167200,33777
6003,4669,1334,1040,141800,33778
10179,5994,4185,898,136000,33781
9455,6884,2571,1148,137300,33782
3002,2054,948,1204,426600,33785
778,680,98,2479,591300,33786
12271,6193,6078,804,78700,33801
12015,7378,4637,996,133100,33803
9018,4223,4795,950,79900,33805
10886,7511,3375,1057,154100,33809
17503,13149,4354,1105,142900,33810
7782,5548,2234,1001,166500,33811
4484,3593,891,1146,180800,33812
12766,10446,2320,1149,206700,33813
5395,3027,2368,734,26600,33815
10923,7906,3017,844,133400,33823
9082,6437,2645,757,82800,33825
907,804,103,1026,162700,33827
9437,6176,3261,820,113600,33830
1754,1140,614,731,77600,33834
8882,6671,2211,1211,169100,33837
1183,683,500,847,115200,33838
1037,686,351,842,112700,33839
2980,2220,760,738,88200,33841
3457,2697,760,680,70900,33843
11760,7519,4241,875,113200,33844
37,35,2,-,-,33847
186,116,70,-,54600,33848
335,291,44,-,96700,33849
3087,2039,1048,918,102300,33850
348,332,16,1096,119600,33851
8301,6801,1500,751,120300,33852
4225,2077,2148,758,114900,33853
160,70,90,614,38500,33854
0,0,0,-,-,33855
215,0,215,537,-,33856
893,538,355,554,110200,33857
4219,2901,1318,860,89900,33859
7979,6091,1888,971,122100,33860
248,190,58,-,83900,33865
205,205,0,-,107300,33867
3809,3119,690,867,101300,33868
8728,5614,3114,674,78000,33870
6922,5367,1555,875,84000,33872
4357,2659,1698,688,85300,33873
4631,3940,691,895,124200,33875
2000,1734,266,982,99200,33876
134,42,92,-,-,33877
13648,8937,4711,870,106300,33880
12680,8599,4081,838,88500,33881
11945,8424,3521,1112,168300,33884
1463,1189,274,713,77100,33890
3097,1842,1255,1408,181300,33896
6345,4607,1738,1439,150900,33897
6314,4878,1436,871,113400,33898
8876,3728,5148,838,171300,33901
10508,8155,2353,870,96300,33903
13854,10472,3382,1069,222100,33904
11385,7169,4216,994,146000,33905
9546,4140,5406,1060,148300,33907
17557,12371,5186,1376,253100,33908
10445,6302,4143,1149,173400,33909
7905,6622,1283,1302,265800,33912
8271,6983,1288,1486,289600,33913
14735,11025,3710,1193,270800,33914
8169,2961,5208,943,94400,33916
12471,10145,2326,824,92100,33917
14047,10342,3705,1184,195700,33919
1958,1730,228,859,263900,33920
321,268,53,-,925700,33921
1656,1348,308,959,174200,33922
49,36,13,-,-,33924
10908,9278,1630,1589,305900,33928
371,326,45,-,-,33930
5623,4762,861,1097,321600,33931
6229,4347,1882,746,87700,33935
8130,5020,3110,920,114800,33936
104,104,0,-,-,33944
0,0,0,-,-,33945
1184,1040,144,1592,416200,33946
4100,3470,630,1172,233000,33947
6826,5524,1302,976,163800,33948
11210,9157,2053,966,280000,33950
13739,9647,4092,953,131900,33952
2986,2669,317,985,214900,33953
3599,2843,756,1312,193800,33954
4376,3935,441,1066,235500,33955
1637,1457,180,1089,197600,33956
3678,3117,561,1443,720500,33957
329,289,40,1089,168800,33960
0,0,0,-,-,33965
4343,3065,1278,1052,256000,33966
8231,6082,2149,1232,206400,33967
7284,5014,2270,1089,148100,33971
4453,3025,1428,1079,162200,33972
3811,790,3021,963,195300,33973
4580,2846,1734,1117,145800,33974
4614,2960,1654,1117,133300,33976
5796,4256,1540,834,140800,33980
4530,3795,735,1209,231300,33981
4117,3440,677,839,113200,33982
5849,4765,1084,993,201000,33983
11404,7974,3430,1087,201300,33990
7484,5659,1825,1435,231600,33991
8056,6206,1850,1359,199300,33993
0,0,0,-,-,34101
5555,3925,1630,1180,968600,34102
6126,4810,1316,1319,695600,34103
10467,7250,3217,1139,242100,34104
7688,5359,2329,1526,438500,34105
8014,6461,1553,1358,692700,34108
11148,6824,4324,1357,387700,34109
10901,8431,2470,1567,377100,34110
12201,9177,3024,1034,214300,34112
8177,5611,2566,1232,259400,34113
7251,6074,1177,1205,237000,34114
9620,5092,4528,1168,228600,34116
4664,4314,350,1529,276400,34117
12767,9691,3076,1460,433300,34119
10156,8623,1533,1581,311100,34120
7139,6095,1044,1156,475700,34134
18232,14223,4009,1217,261900,34135
114,16,98,-,-,34137
119,119,0,-,143800,34138
177,157,20,788,118400,34139
144,100,44,-,-,34140
17,3,14,-,-,34141
6701,2727,3974,773,137300,34142
8515,7310,1205,1595,598200,34145
1817,1691,126,1929,413800,34201
9193,7095,2098,1816,419300,34202
14093,10282,3811,1038,190500,34203
12686,7243,5443,954,126100,34205
15023,8499,6524,948,72500,34207
12339,6932,5407,1021,161800,34208
14484,10621,3863,1171,215900,34209
7262,4245,3017,1103,200000,34210
3191,2868,323,1675,377000,34211
6942,5605,1337,1558,339100,34212
262,221,41,-,831100,34215
416,381,35,1148,858600,34216
2761,2041,720,1211,546800,34217
8349,7573,776,1724,258200,34219
15392,12091,3301,1055,151600,34221
5182,4015,1167,1011,95100,34222
8667,7098,1569,938,220000,34223
7459,5957,1502,929,152800,34224
3835,3555,280,1435,720700,34228
3407,2859,548,1191,428400,34229
14425,8907,5518,1114,226300,34231
13538,9236,4302,1345,207600,34232
7797,5911,1886,1440,249000,34233
8698,4566,4132,952,117800,34234
6473,4954,1519,1347,217200,34235
7003,4251,2752,1030,655700,34236
6960,3552,3408,1074,137900,34237
9886,7465,2421,1581,354700,34238
6912,4864,2048,1245,263300,34239
3954,3704,250,1542,399400,34240
5727,4962,765,1609,340100,34241
3860,3293,567,1531,690500,34242
13399,9926,3473,1472,266000,34243
1815,1678,137,1262,307300,34251
10053,6695,3358,678,81500,34266
80,51,29,-,-,34268
1863,1637,226,871,126800,34269
9229,7491,1738,1053,283700,34275
9741,7412,2329,1179,192000,34285
6264,5130,1134,1407,165300,34286
11122,8100,3022,1037,140500,34287
4419,3569,850,1216,181900,34288
1563,572,991,1185,192200,34289
2126,1767,359,1354,182000,34291
7814,6046,1768,1429,296700,34292
17457,14773,2684,1258,222100,34293
6561,4754,1807,796,103000,34420
4025,3049,976,709,109200,34428
3765,3163,602,962,118200,34429
3473,2903,570,788,109100,34431
5505,4640,865,892,133100,34432
2725,2403,322,829,128200,34433
2961,2403,558,1153,137500,34434
3591,2966,625,698,89700,34436
6535,5780,755,825,161400,34442
0,0,0,-,-,34445
7632,6782,850,954,136000,34446
4780,3739,1041,774,77200,34448
1388,942,446,504,80000,34449
5072,3685,1387,738,116900,34450
4933,3942,991,834,108200,34452
4418,3478,940,899,102600,34453
4232,3325,907,705,161100,34461
7929,6299,1630,853,145400,34465
7924,4644,3280,833,98600,34470
9586,6311,3275,883,170700,34471
10499,7569,2930,946,100200,34472
6742,5221,1521,998,148300,34473
6730,3187,3543,999,131600,34474
4068,1969,2099,692,79400,34475
9693,8665,1028,853,144200,34476
5128,3616,1512,842,99400,34479
6679,4806,1873,795,141700,34480
9769,8825,944,926,115100,34481
7479,5772,1707,778,141300,34482
1548,947,601,853,213400,34484
4139,3208,931,794,58100,34488
11817,10342,1475,930,165600,34491
279,210,69,1012,159400,34498
9267,6436,2831,794,100900,34601
2614,2121,493,928,140000,34602
3989,3382,607,898,145900,34604
11723,8819,2904,931,119000,34606
4043,3317,726,969,194500,34607
13208,9366,3842,991,124600,34608
15419,12301,3118,1111,152600,34609
5051,4020,1031,997,138300,34610
8142,6968,1174,950,94700,34613
2596,2346,250,1036,143200,34614
2118,1796,322,1644,223500,34637
8484,6868,1616,1422,241700,34638
9606,7791,1815,1264,233900,34639
10538,6521,4017,891,95200,34652
14609,8941,5668,989,94300,34653
8854,6728,2126,1031,150200,34654
16595,13116,3479,1161,214700,34655
42,34,8,-,-,34661
15450,11073,4377,896,125200,34667
19363,11857,7506,949,83100,34668
4990,4071,919,987,137600,34669
8810,6321,2489,1132,222400,34677
53,36,17,-,146400,34679
355,355,0,-,406300,34681
13367,10078,3289,1183,261200,34683
13167,8758,4409,1299,181600,34684
7295,5481,1814,1317,334600,34685
2839,2536,303,1625,343600,34688
10624,7526,3098,845,185400,34689
5394,3428,1966,1007,70100,34690
8575,5700,2875,998,81100,34691
7295,5935,1360,1249,241700,34695
18237,12155,6082,1057,179500,34698
896,686,210,956,104600,34705
21224,16528,4696,1309,217000,34711
7266,3781,3485,1175,171400,34714
5669,3717,1952,1226,219600,34715
5682,4500,1182,953,156900,34731
1363,1195,168,1286,278100,34734
6104,4994,1110,1310,174200,34736
979,810,169,1147,211500,34737
170,134,36,-,93200,34739
15205,4535,10670,1056,151200,34741
11779,7552,4227,1244,161700,34743
15738,9678,6060,1202,196800,34744
12766,8455,4311,1407,187100,34746
7147,3370,3777,1406,300000,34747
17577,12666,4911,894,150200,34748
1783,1430,353,1001,121900,34753
1238,1018,220,1057,253800,34756
10311,7065,3246,1207,164200,34758
11633,8679,2954,1243,173100,34759
290,223,67,973,208200,34760
15349,10338,5011,1267,223900,34761
230,230,0,-,77600,34762
8159,5278,2881,985,141800,34769
5265,4689,576,1139,269500,34771
8659,7220,1439,1397,210800,34772
994,755,239,1113,180000,34773
13482,11715,1767,871,277900,34785
13908,10026,3882,1756,438800,34786
21956,15547,6409,1137,292800,34787
7810,6520,1290,1004,76400,34788
421,406,15,-,167000,34797
1438,1257,181,1075,177600,34945
2258,1488,770,815,80300,34946
3991,1500,2491,949,99800,34947
4048,3305,743,1200,270000,34949
5915,2439,3476,792,84200,34950
6982,5938,1044,949,101600,34951
16892,11559,5333,1190,123800,34952
21593,17509,4084,1344,184600,34953
2153,1433,720,824,81700,34956
10772,8326,2446,1103,234200,34957
5663,3651,2012,693,87100,34972
9779,7654,2125,780,90900,34974
1805,1067,738,998,230500,34981
10036,6912,3124,1014,104400,34982
13795,10723,3072,1376,164100,34983
5512,4511,1001,1342,167000,34984
11362,8692,2670,1347,228300,34986
3361,2413,948,1766,267000,34987
11919,10299,1620,1526,347900,34990
6961,4210,2751,1061,170000,34994
5598,4621,977,1176,275200,34996
17670,13629,4041,1109,236900,34997
4533,3544,989,905,155700,35004
2663,1943,720,921,94300,35005
1084,897,187,819,84200,35006
8979,7232,1747,978,165000,35007
8312,5640,2672,630,104600,35010
15,8,7,-,-,35013
1698,1470,228,981,86700,35014
6381,4786,1595,580,130600,35016
820,640,180,708,124100,35019
10018,5142,4876,731,67400,35020
8137,6556,1581,893,173000,35022
8333,6167,2166,867,114800,35023
2845,2014,831,575,115100,35031
17,14,3,-,73300,35032
1233,1049,184,615,115100,35033
1081,773,308,778,62800,35034
389,389,0,-,126300,35035
129,28,101,243,81300,35036
6275,5139,1136,993,145300,35040
2211,1589,622,634,120600,35042
3671,3440,231,1556,231900,35043
2994,1848,1146,537,95800,35044
5748,4113,1635,682,113500,35045
1935,1532,403,674,121400,35046
1288,1088,200,593,125600,35049
3102,2415,687,626,150600,35051
19,0,19,-,-,35052
924,840,84,891,164200,35053
1655,1450,205,604,169800,35054
7837,4881,2956,627,126300,35055
4773,3915,858,732,147900,35057
3577,2674,903,677,123300,35058
161,138,23,-,45200,35060
417,270,147,1003,76800,35061
2928,2511,417,766,113300,35062
1303,1179,124,799,81200,35063
4514,2616,1898,721,97100,35064
3315,2261,1054,948,149100,35068
94,68,26,779,103800,35070
6316,5034,1282,960,166400,35071
1855,1521,334,498,80300,35072
956,760,196,802,85400,35073
0,0,0,-,-,35074
4951,3711,1240,649,106000,35077
722,598,124,730,161600,35078
3197,2935,262,646,128200,35079
6261,5730,531,1188,183400,35080
0,0,0,-,-,35082
1294,1009,285,721,104600,35083
3270,2551,719,731,83700,35085
956,560,396,689,95600,35087
793,653,140,594,89800,35089
1028,945,83,872,190700,35091
5571,4343,1228,812,162700,35094
2988,2409,579,866,107800,35096
648,541,107,782,111600,35097
451,438,13,-,87800,35098
6044,5193,851,728,194800,35111
136,122,14,-,-,35112
3075,2619,456,1096,192900,35114
5405,3670,1735,751,124500,35115
1718,1410,308,853,153600,35116
2019,1806,213,726,158900,35117
1110,914,196,744,129400,35118
78,51,27,-,-,35119
5009,4165,844,688,145400,35120
5710,3840,1870,695,131600,35121
9292,7699,1593,1062,186600,35124
4405,2822,1583,712,120500,35125
7600,6383,1217,978,145600,35126
3745,3306,439,1162,154400,35127
4291,3104,1187,795,169100,35128
1232,956,276,479,76300,35130
1507,1135,372,607,122400,35131
1366,1274,92,522,123400,35133
792,581,211,745,184500,35135
786,638,148,281,118300,35136
77,71,6,-,20300,35139
1236,1139,97,608,162900,35143
3616,3243,373,684,176800,35146
2177,1888,289,1284,184400,35147
995,686,309,522,103000,35148
181,141,40,-,114700,35149
6971,4455,2516,596,93900,35150
2838,2435,403,713,98600,35151
10087,6654,3433,569,90900,35160
1316,1091,225,658,105500,35171
1226,797,429,668,74400,35172
9430,8508,922,1102,229300,35173
2008,1720,288,633,117500,35175
349,234,115,715,64100,35176
1331,1163,168,615,87400,35178
3310,2749,561,705,132300,35179
5164,4444,720,589,139600,35180
310,297,13,-,77300,35183
1652,1276,376,713,86400,35184
2013,1699,314,931,170600,35186
3,3,0,-,-,35187
1110,882,228,837,115000,35188
1574,294,1280,562,201600,35203
4397,1506,2891,577,63000,35204
9489,2601,6888,765,182300,35205
6722,3458,3264,809,78300,35206
3514,1977,1537,549,60400,35207
5426,2806,2620,861,71700,35208
12335,5847,6488,954,326200,35209
5961,4026,1935,917,140000,35210
11437,5222,6215,775,79400,35211
4859,2169,2690,576,132100,35212
5559,4230,1329,1335,530600,35213
7307,5258,2049,782,102500,35214
18078,9897,8181,850,100300,35215
15117,8097,7020,1005,274400,35216
4889,2731,2158,697,76800,35217
2928,1210,1718,759,65200,35218
1828,1206,622,828,65100,35221
4077,2254,1823,730,231100,35222
4152,3568,584,1616,490000,35223
2079,1296,783,781,64100,35224
13344,10552,2792,1200,265200,35226
4083,2490,1593,867,68400,35228
0,0,0,-,-,35229
864,119,745,1213,185900,35233
1977,925,1052,592,61300,35234
8191,5683,2508,980,119800,35235
21757,15215,6542,1097,347400,35242
7724,4708,3016,1210,352400,35243
12609,8636,3973,1121,293600,35244
189,63,126,659,83800,35254
11118,3740,7378,781,110600,35401
8105,4145,3960,881,133000,35404
17060,9691,7369,851,169400,35405
6576,5152,1424,1042,341400,35406
403,351,52,579,67900,35441
1857,1356,501,550,93400,35442
611,360,251,608,34300,35443
1415,1121,294,806,107600,35444
730,602,128,854,123000,35446
1146,838,308,403,96600,35447
1104,910,194,870,170700,35452
3785,3205,580,775,138400,35453
1172,982,190,948,117200,35456
0,0,0,-,-,35457
174,133,41,-,170100,35458
444,361,83,525,66200,35459
362,274,88,625,97900,35460
849,771,78,-,134100,35461
1771,1176,595,611,79200,35462
704,615,89,-,128100,35463
268,143,125,310,-,35464
2165,1655,510,517,103500,35466
66,34,32,-,-,35469
1753,901,852,583,106500,35470
6104,4099,2005,867,175400,35473
2238,1841,397,770,126000,35474
5398,4755,643,768,186700,35475
2829,1357,1472,760,134000,35476
53,53,0,-,-,35477
423,359,64,1644,181500,35480
1457,970,487,429,79700,35481
1358,1017,341,995,114700,35490
3693,2249,1444,578,91500,35501
3473,2639,834,729,117000,35503
5076,3927,1149,610,147000,35504
1041,777,264,365,90200,35540
1444,1308,136,439,147300,35541
461,431,30,720,82000,35542
441,316,125,541,62200,35543
240,168,72,574,27300,35544
59,52,7,-,30000,35545
1484,1266,218,296,88200,35546
707,549,158,400,65000,35548
1438,995,443,547,61500,35549
2367,1833,534,618,74300,35550
332,311,21,275,52600,35552
1596,1320,276,482,67900,35553
462,374,88,529,59100,35554
3869,2788,1081,573,86800,35555
6,6,0,-,-,35559
1837,1357,480,518,106200,35563
925,730,195,578,97600,35564
5321,4147,1174,543,72000,35565
4742,3389,1353,522,90900,35570
351,288,63,618,74400,35571
508,467,41,-,195800,35572
743,640,103,361,103200,35574
433,342,91,490,75800,35575
1377,1039,338,445,85200,35576
6,6,0,-,-,35577
2190,1900,290,542,88700,35578
1367,1073,294,462,70000,35579
1383,1150,233,615,71600,35580
2019,1553,466,753,84200,35581
1649,1184,465,441,84200,35582
134,120,14,800,49100,35584
515,383,132,-,128900,35585
1824,1375,449,393,85700,35586
299,289,10,-,54700,35587
1899,1398,501,360,73300,35592
650,541,109,463,84100,35593
2738,2019,719,546,108900,35594
12393,7515,4878,647,98300,35601
13050,9068,3982,647,168200,35603
785,616,169,479,157300,35610
9678,5977,3701,634,123300,35611
7621,6805,816,810,175400,35613
2743,2091,652,690,107700,35614
109,91,18,-,-,35615
1605,1309,296,702,84400,35616
849,558,291,422,78200,35618
1694,1435,259,658,105300,35619
3240,2629,611,765,125000,35620
1253,1073,180,495,109600,35621
2655,2190,465,731,87600,35622
14890,6654,8236,642,108900,35630
8260,6980,1280,821,138900,35633
3972,3482,490,736,177400,35634
9210,7385,1825,647,135200,35640
1465,1344,121,548,115400,35643
5322,4506,816,631,160800,35645
1857,1410,447,483,100700,35646
409,336,73,384,117600,35647
1256,1030,226,563,119200,35648
34,34,0,-,400000,35649
5265,3956,1309,537,119700,35650
461,347,114,733,104400,35651
3514,2729,785,718,135400,35652
3667,2366,1301,581,84700,35653
2865,1977,888,550,98200,35654
4045,2370,1675,657,91600,35660
6744,5314,1430,815,145400,35661
2570,2113,457,633,119300,35670
899,596,303,572,79000,35671
2353,1902,451,568,98500,35672
2726,2286,440,549,125300,35673
7070,5066,2004,675,105600,35674
744,589,155,844,101300,35677
1956,1514,442,734,143300,35739
1435,966,469,478,89100,35740
1323,998,325,946,275800,35741
788,653,135,418,107100,35744
84,69,15,-,153700,35745
259,229,30,-,-,35746
2139,1584,555,612,151600,35747
2700,2231,469,602,176600,35748
8088,6913,1175,1149,181400,35749
4918,3876,1042,801,126000,35750
85,64,21,-,212500,35751
966,809,157,828,87500,35752
1816,1403,413,549,152700,35754
259,179,80,448,169900,35755
4890,4401,489,1316,224300,35756
5895,5073,822,1063,199000,35757
18208,12111,6097,919,233800,35758
2942,2706,236,1153,188100,35759
1893,1485,408,752,126100,35760
4894,4303,591,854,154400,35761
6519,6066,453,1179,274400,35763
203,172,31,675,90000,35764
1483,1158,325,525,91800,35765
55,41,14,-,129200,35766
4497,3034,1463,620,99800,35768
4020,3008,1012,638,143500,35769
1387,974,413,683,114400,35771
1789,1235,554,533,82800,35772
4807,3715,1092,846,119300,35773
82,75,7,-,73000,35774
417,332,85,-,108500,35775
1334,1100,234,613,86900,35776
9839,6604,3235,832,258600,35801
10128,5966,4162,822,231700,35802
11125,8968,2157,895,180100,35803
9180,2861,6319,609,75300,35805
10343,4873,5470,945,235200,35806
330,5,325,1318,-,35808
11387,7311,4076,847,85500,35810
10837,8650,2187,810,164100,35811
6517,1419,5098,682,83600,35816
3750,1945,1805,951,230400,35824
0,0,0,-,-,35896
7540,4866,2674,603,112300,35901
6503,4075,2428,679,91600,35903
5258,4199,1059,635,68700,35904
2401,1915,486,592,127400,35905
4149,2620,1529,762,159900,35906
3247,2798,449,865,158500,35907
7424,4684,2740,676,104500,35950
4338,2951,1387,652,95000,35951
2691,2121,570,588,91000,35952
2657,2166,491,701,107000,35953
4359,3221,1138,673,86100,35954
3256,2679,577,662,109200,35956
5705,3571,2134,628,100200,35957
1545,1152,393,621,125700,35958
1995,1538,457,561,104700,35959
4158,3227,931,549,145200,35960
2489,1683,806,635,85900,35961
3141,2219,922,675,84800,35962
481,360,121,-,92600,35963
1470,1099,371,685,96200,35966
6177,4187,1990,609,112000,35967
1571,1165,406,580,132600,35968
1949,1431,518,692,92000,35971
415,330,85,-,107400,35972
1185,1041,144,815,88800,35973
641,334,307,642,86900,35974
172,142,30,-,-,35975
6825,5126,1699,624,165100,35976
1830,1508,322,605,89000,35978
678,516,162,-,132800,35979
1735,1350,385,613,78500,35980
673,485,188,277,95300,35981
1473,1142,331,732,159900,35983
764,619,145,858,171700,35984
3142,2224,918,591,116300,35986
969,751,218,593,83500,35987
751,545,206,636,95200,35988
1329,1043,286,608,92700,35989
30,14,16,950,-,35990
913,694,219,539,83400,36003
502,421,81,473,90100,36005
423,359,64,474,168200,36006
922,674,248,439,88700,36009
1656,1178,478,499,81600,36010
225,206,19,-,422000,36013
1439,935,504,529,78000,36016
649,447,202,436,54200,36017
364,278,86,769,161800,36020
4385,3833,552,748,170700,36022
2011,1583,428,736,145200,36024
1388,892,496,903,148400,36025
437,313,124,-,198600,36026
6111,3431,2680,618,109500,36027
693,583,110,395,108300,36028
345,307,38,-,156000,36029
190,156,34,-,80000,36030
84,79,5,-,66300,36031
889,652,237,573,58900,36032
1381,978,403,575,69900,36033
330,296,34,529,50500,36034
563,484,79,638,114600,36035
766,640,126,662,94000,36036
4489,3019,1470,622,92000,36037
18,18,0,-,156300,36038
75,56,19,-,82700,36039
1474,925,549,635,62600,36040
455,405,50,-,69900,36041
579,511,68,583,79100,36042
1445,1170,275,1049,175800,36043
576,548,28,-,87900,36046
470,382,88,-,103700,36047
513,394,119,560,65700,36048
2206,1480,726,523,77500,36049
832,665,167,832,86000,36051
157,144,13,-,561500,36052
703,497,206,447,78300,36053
5823,4060,1763,809,138800,36054
3559,3277,282,1082,288500,36064
7950,4834,3116,1122,169700,36066
10351,7910,2441,793,129800,36067
863,749,114,595,103400,36069
155,114,41,583,95000,36071
880,634,246,670,85400,36075
4857,3458,1399,671,139800,36078
3299,2444,855,699,131800,36079
791,724,67,-,196200,36080
6180,2815,3365,592,120800,36081
0,0,0,-,-,36082
3428,2189,1239,570,76900,36083
1303,551,752,645,81000,36088
2645,1949,696,675,80300,36089
1451,1115,336,541,79200,36091
7441,5306,2135,859,138200,36092
3896,3495,401,1272,237600,36093
2888,914,1974,698,73500,36104
3996,2516,1480,835,64300,36105
6245,3526,2719,974,158200,36106
3101,1336,1765,800,68900,36107
7520,4275,3245,595,64500,36108
10118,7253,2865,937,117300,36109
4320,2283,2037,820,58200,36110
4841,2712,2129,829,144200,36111
0,0,0,-,-,36112
274,0,274,1572,-,36113
269,0,269,1348,-,36115
17198,8611,8587,859,104500,36116
22287,13151,9136,974,179600,36117
7234,4351,2883,578,66700,36201
6970,4700,2270,849,148600,36203
202,126,76,800,214400,36205
4486,3323,1163,643,94400,36206
8288,5871,2417,764,143600,36207
1788,1494,294,906,120500,36250
1905,1311,594,417,88800,36251
355,318,37,-,132900,36255
652,550,102,660,89600,36256
558,451,107,543,164100,36258
1581,1168,413,601,118400,36260
507,395,112,535,82300,36262
218,118,100,600,85700,36263
3306,2412,894,573,116500,36264
7697,4651,3046,624,148700,36265
1975,1302,673,596,111600,36266
12,12,0,-,-,36267
2362,1991,371,768,117000,36268
482,388,94,547,78300,36269
2283,1896,387,678,97100,36271
5331,4248,1083,495,79100,36272
1249,981,268,654,132900,36273
4350,3124,1226,603,81900,36274
892,675,217,494,78100,36276
1993,1534,459,826,102700,36277
1863,1362,501,707,134900,36278
961,901,60,-,153300,36279
1461,1149,312,746,90500,36280
14049,8595,5454,721,112600,36301
11678,6941,4737,692,142700,36303
6128,4222,1906,942,179500,36305
2566,2073,493,496,92200,36310
1098,943,155,494,75200,36311
2266,1741,525,659,98400,36312
90,67,23,-,140300,36313
199,179,20,575,122700,36314
739,613,126,646,156300,36316
248,201,47,493,64300,36317
581,472,109,677,70500,36318
806,621,185,739,77900,36319
1351,1098,253,607,88400,36320
620,481,139,809,91400,36321
3463,1962,1501,708,106400,36322
2921,2062,859,634,89100,36323
14119,8567,5552,831,168200,36330
2308,1487,821,438,107900,36340
505,456,49,625,75700,36343
2179,1502,677,620,107200,36344
3223,2602,621,619,141800,36345
552,427,125,586,92600,36346
2696,1647,1049,641,125200,36350
1386,1032,354,713,106900,36351
1875,1497,378,747,151000,36352
672,593,79,533,105200,36353
7664,5011,2653,635,109000,36360
1246,0,1246,1197,-,36362
352,282,70,779,86800,36370
273,198,75,794,109300,36371
182,167,15,-,67900,36373
339,309,30,-,108500,36374
2766,2031,735,739,80200,36375
826,687,139,700,86200,36376
2939,2143,796,573,84500,36401
4109,2889,1220,658,108900,36420
3940,2998,942,588,107300,36421
433,319,114,542,40900,36425
6090,4188,1902,572,94300,36426
749,603,146,382,65500,36432
134,122,12,-,84000,36435
203,162,41,-,61500,36436
241,151,90,936,149300,36439
1509,1167,342,564,86500,36441
1211,856,355,506,86000,36442
335,212,123,-,64800,36444
1766,1174,592,640,93300,36445
153,105,48,-,80500,36446
1811,1302,509,563,122200,36451
950,683,267,595,76500,36453
17,17,0,-,-,36454
111,86,25,625,60000,36455
507,384,123,379,58200,36456
3663,2085,1578,500,118000,36460
4002,2836,1166,588,91100,36467
77,22,55,-,-,36470
441,244,197,518,77000,36471
7,7,0,-,-,36473
1250,1103,147,518,74000,36474
893,685,208,542,64100,36475
9,8,1,-,-,36476
1624,1113,511,522,66600,36477
612,407,205,664,91900,36480
137,58,79,-,34200,36481
281,259,22,-,78600,36482
172,167,5,-,77600,36483
5965,3991,1974,603,107900,36502
607,445,162,1147,119300,36505
7287,5009,2278,662,130700,36507
625,378,247,720,73200,36509
250,215,35,-,113100,36511
25,25,0,-,-,36512
252,153,99,-,-,36513
992,778,214,754,129000,36518
2021,1760,261,782,118300,36521
2567,1804,763,760,108300,36522
1044,713,331,847,87500,36523
482,413,69,658,88100,36524
701,466,235,789,119300,36525
12665,9319,3346,1108,196400,36526
5620,4026,1594,1235,285100,36527
551,484,67,979,240500,36528
103,103,0,-,219400,36529
2721,2147,574,834,167900,36530
12248,9819,2429,1079,245900,36532
11973,8205,3768,773,164900,36535
178,178,0,-,21300,36538
289,235,54,-,-,36539
213,158,55,-,54400,36540
5112,4596,516,1074,107800,36541
6706,4026,2680,1034,242400,36542
62,62,0,-,93200,36543
4057,3084,973,871,108300,36544
3631,2428,1203,593,103000,36545
420,378,42,-,110200,36548
2093,1910,183,940,121100,36549
186,142,44,-,-,36550
3043,2465,578,936,145000,36551
1062,999,63,440,93000,36553
358,316,42,862,257300,36555
235,143,92,-,48200,36556
1298,1157,141,484,70900,36558
50,33,17,-,-,36559
1316,959,357,658,65400,36560
2982,2274,708,1178,337000,36561
450,426,24,-,102200,36562
41,41,0,-,-,36564
4981,3552,1429,755,133600,36567
58,58,0,-,-,36568
257,215,42,-,58500,36569
5249,3834,1415,929,138200,36571
2262,1899,363,872,150000,36572
365,332,33,-,155900,36574
7391,5974,1417,881,144000,36575
1613,1196,417,911,163200,36576
465,430,35,728,256100,36578
470,389,81,547,127300,36579
1874,1428,446,699,147100,36580
57,43,14,-,"10,000-",36581
8917,6625,2292,713,123600,36582
295,244,51,-,172200,36583
275,233,42,-,105300,36584
299,244,55,483,-,36585
3193,2864,329,920,117000,36587
0,0,0,-,-,36590
649,103,546,443,194000,36602
2733,991,1742,579,82300,36603
4036,2245,1791,817,156100,36604
10079,5777,4302,816,77800,36605
7921,3995,3926,836,99600,36606
2593,1347,1246,755,109400,36607
14876,8063,6813,862,159500,36608
11352,5097,6255,802,143500,36609
4100,2084,2016,698,48800,36610
2049,1124,925,898,75500,36611
1660,782,878,731,59900,36612
4282,3357,925,837,99700,36613
0,0,0,-,-,36615
8,0,8,-,-,36616
5053,2771,2282,874,72800,36617
6596,5262,1334,858,110100,36618
5725,4510,1215,878,130300,36619
0,0,0,-,-,36688
7893,5136,2757,941,151900,36693
18736,12650,6086,1032,182600,36695
8832,5299,3533,654,92700,36701
5224,2689,2535,608,76000,36703
340,246,94,780,-,36720
141,84,57,-,90000,36722
82,40,42,-,-,36723
1709,1009,700,481,88200,36726
6,6,0,-,-,36727
136,106,30,-,-,36728
3258,1953,1305,493,133600,36732
394,351,43,-,71900,36736
250,228,22,-,93600,36738
433,363,70,574,54800,36740
735,589,146,807,105500,36742
2619,1561,1058,470,85500,36744
1215,853,362,600,81200,36748
297,251,46,-,97100,36749
988,722,266,500,110000,36750
216,170,46,660,-,36751
498,448,50,-,117400,36752
8,0,8,-,-,36753
170,120,50,-,-,36754
1723,1222,501,600,80700,36756
517,427,90,390,79600,36758
725,609,116,-,62800,36759
378,291,87,826,59200,36761
71,57,14,-,55000,36763
518,453,65,1018,61400,36765
16,11,5,-,-,36766
686,496,190,504,43600,36767
347,278,69,692,39700,36768
967,634,333,563,72700,36769
186,99,87,606,105100,36773
352,282,70,647,54100,36775
550,442,108,-,94400,36776
992,859,133,706,60800,36782
342,286,56,455,65000,36783
2856,1712,1144,532,126500,36784
532,407,125,756,62300,36785
1024,735,289,484,53900,36786
118,83,35,-,52300,36790
453,375,78,-,101000,36792
98,85,13,-,58800,36793
9963,5851,4112,680,159900,36801
6861,5290,1571,790,106800,36804
15294,7706,7588,869,250500,36830
9834,3877,5957,851,99100,36832
0,0,0,-,-,36849
1049,854,195,370,60000,36850
826,625,201,745,111600,36852
3258,2599,659,796,157400,36853
6078,3929,2149,806,109400,36854
578,470,108,544,113700,36855
2427,2017,410,1468,195600,36856
138,113,25,611,90300,36858
8,8,0,-,-,36859
696,541,155,530,62500,36860
1300,1098,202,672,131300,36861
2469,1656,813,576,78300,36862
4774,3317,1457,671,96500,36863
13,13,0,-,-,36865
1698,1367,331,601,74900,36866
9394,4746,4648,831,136800,36867
8060,4692,3368,769,107200,36869
7443,5375,2068,844,136900,36870
539,439,100,-,90200,36871
3029,2606,423,1053,157200,36874
1462,1100,362,880,126800,36875
4803,3338,1465,860,145600,36877
742,630,112,613,214100,36879
182,110,72,507,35600,36901
1526,1080,446,505,97700,36904
702,576,126,712,79700,36907
795,713,82,320,83500,36908
11,0,11,-,-,36910
911,683,228,593,75600,36912
9,9,0,-,-,36913
282,170,112,-,58500,36915
376,323,53,475,67200,36916
725,604,121,507,55700,36919
373,355,18,563,73500,36921
214,183,31,-,63800,36922
1257,849,408,605,49100,36925
1652,1410,242,1438,244700,37010
988,757,231,757,116300,37012
35376,19056,16320,1041,167900,37013
955,905,50,838,559600,37014
6526,4758,1768,925,161700,37015
439,355,84,784,194900,37016
857,673,184,1086,67800,37018
255,212,43,601,100000,37019
2013,1651,362,693,158400,37020
2163,1830,333,797,135100,37022
535,421,114,865,139800,37023
2043,1762,281,678,139000,37025
892,677,215,665,118100,37026
19468,16466,3002,1438,552400,37027
402,342,60,-,135400,37028
2463,2187,276,759,226300,37029
2920,1894,1026,536,134700,37030
1607,1463,144,914,173300,37031
1606,1234,372,1015,190000,37032
2983,2141,842,629,119600,37033
2776,2325,451,1010,160900,37034
1366,1183,183,717,160400,37035
2177,1633,544,678,137100,37036
2673,2300,373,881,183300,37037
17844,10205,7639,877,158700,37040
27938,14817,13121,957,133300,37042
17971,12445,5526,910,200100,37043
1764,1581,183,1270,449300,37046
827,668,159,758,116900,37047
2334,1978,356,984,216600,37048
1355,1059,296,867,202000,37049
549,443,106,497,120400,37050
1382,1195,187,896,120100,37051
1020,851,169,1050,165300,37052
10071,6641,3430,758,153600,37055
345,227,118,736,145100,37057
2958,2037,921,592,131400,37058
512,383,129,739,107500,37059
870,736,134,924,200900,37060
1640,1259,381,664,95200,37061
4076,3224,852,1008,212900,37062
20633,16185,4448,1282,394700,37064
18699,12600,6099,941,224200,37066
11337,6897,4440,1529,427600,37067
7014,6215,799,2051,443700,37069
12681,8685,3996,1018,201100,37072
5321,4031,1290,917,183400,37073
2749,2009,740,653,131000,37074
24276,17632,6644,1135,252900,37075
16693,9418,7275,1081,193600,37076
223,157,66,556,100700,37078
899,617,282,720,116700,37079
2979,2296,683,863,176500,37080
2404,1944,460,1063,217200,37082
5814,4265,1549,614,112800,37083
1945,1596,349,787,208600,37085
10750,7553,3197,1166,144700,37086
17006,11519,5487,863,222300,37087
5597,4280,1317,1071,217600,37090
8536,5613,2923,711,116300,37091
927,615,312,606,155200,37095
2354,1883,471,557,89200,37096
950,749,201,608,72800,37097
2185,1930,255,1069,103000,37098
2312,1739,573,574,110200,37101
13028,8695,4333,624,110300,37110
16652,7084,9568,919,149800,37115
338,252,86,679,332600,37118
20899,17218,3681,1311,268600,37122
6465,4993,1472,1002,198000,37127
18737,12715,6022,1179,213600,37128
20608,14578,6030,1034,200900,37129
21893,9693,12200,913,195500,37130
0,0,0,-,-,37132
1084,884,200,762,106100,37134
3997,3707,290,1590,398300,37135
1161,1060,101,573,82200,37137
9402,7162,2240,1086,191600,37138
25,25,0,-,-,37140
446,353,93,1188,164800,37141
718,558,160,568,161200,37142
1519,1293,226,871,197600,37143
1116,947,169,700,113500,37144
825,660,165,568,117200,37145
2490,1971,519,1076,191400,37146
8335,6144,2191,835,144900,37148
991,851,140,691,169800,37149
1978,1473,505,579,105300,37150
174,142,32,540,153400,37151
2189,1961,228,977,259900,37153
12031,7562,4469,761,132200,37160
23,15,8,-,106300,37165
5289,3406,1883,629,138500,37166
21274,13777,7497,956,178400,37167
253,253,0,-,-,37171
10796,7515,3281,831,164000,37172
11703,9175,2528,1336,257700,37174
392,340,52,-,118500,37175
822,665,157,672,91300,37178
4902,4324,578,1659,302300,37179
1297,1014,283,753,143800,37180
628,479,149,700,132400,37181
1236,996,240,688,176600,37183
2259,1838,421,992,182600,37184
3351,2568,783,658,100000,37185
3429,2514,915,736,120600,37186
2648,1999,649,754,149600,37187
5517,4696,821,932,184500,37188
1387,1112,275,1055,200700,37189
3407,2508,899,636,164400,37190
1404,1162,242,766,151600,37191
437,204,233,1453,281800,37201
7694,1602,6092,1368,342300,37203
5789,3293,2496,1310,467900,37204
10983,7767,3216,1341,530200,37205
11013,5569,5444,853,301900,37206
14421,8359,6062,860,145000,37207
7401,2529,4872,821,246100,37208
15576,7245,8331,1084,294400,37209
7053,2112,4941,751,155600,37210
30080,14504,15576,994,209900,37211
6967,2655,4312,1183,511100,37212
11,0,11,-,-,37213
13822,8179,5643,1109,167600,37214
9956,7754,2202,1414,610400,37215
8050,5418,2632,1075,239500,37216
12857,5325,7532,957,157300,37217
5445,3678,1767,875,160800,37218
811,233,578,1561,408900,37219
2302,2095,207,1768,446000,37220
17260,11954,5306,1286,264900,37221
763,21,742,913,-,37228
0,0,0,-,-,37240
0,0,0,-,-,37243
0,0,0,-,-,37246
438,369,69,544,76800,37301
1797,1391,406,743,279800,37302
9644,6610,3034,676,140100,37303
318,265,53,808,45000,37305
887,760,127,688,129000,37306
1999,1494,505,652,114900,37307
1137,1017,120,589,165500,37308
881,651,230,817,109800,37309
1788,1575,213,589,166300,37310
10411,4857,5554,698,127600,37311
13195,8435,4760,864,185700,37312
508,402,106,363,100600,37313
0,0,0,-,-,37315
1174,765,409,690,119100,37317
745,511,234,542,79600,37318
7079,4809,2270,651,113600,37321
3370,2708,662,690,116900,37322
12129,9376,2753,824,129900,37323
2236,1323,913,660,115900,37324
682,562,120,812,126700,37325
158,85,73,588,91500,37326
4396,3292,1104,670,147300,37327
568,438,130,567,94000,37328
2232,1828,404,668,124200,37329
2930,2424,506,825,122100,37330
2973,2125,848,619,98700,37331
897,730,167,647,118700,37332
228,202,26,-,68800,37333
9376,6529,2847,719,128900,37334
1040,829,211,766,94000,37335
1655,1447,208,-,171200,37336
657,500,157,435,61300,37337
1333,900,433,621,94600,37338
837,712,125,628,81800,37339
245,183,62,811,111900,37340
4295,3527,768,869,152700,37341
1402,1133,269,678,112000,37342
16790,12908,3882,861,175600,37343
881,658,223,687,101700,37345
3281,2551,730,686,124500,37347
351,253,98,611,154400,37348
749,679,70,1667,534500,37350
140,32,108,1150,-,37351
1266,1044,222,634,195300,37352
1894,1503,391,855,163500,37353
6921,5234,1687,570,125000,37354
10214,6955,3259,726,131900,37355
903,577,326,651,172600,37356
2007,1668,339,647,119100,37357
324,286,38,617,112000,37359
565,510,55,930,173500,37360
610,468,142,729,164400,37361
1403,1031,372,673,111900,37362
14644,11234,3410,1021,223000,37363
375,326,49,623,56600,37365
332,288,44,836,150000,37366
3924,2853,1071,619,124400,37367
417,382,35,-,88200,37369
1915,1599,316,512,134000,37370
1094,922,172,735,146100,37373
907,798,109,872,144000,37374
1068,812,256,902,256000,37375
164,146,18,-,111400,37376
5616,4695,921,1173,338200,37377
11151,9183,1968,710,165200,37379
2634,1688,946,554,110500,37380
3718,2859,859,627,131800,37381
3112,2678,434,565,116800,37385
1314,968,346,446,78900,37387
10680,6995,3685,696,132200,37388
629,545,84,669,121600,37391
35,25,10,-,79200,37394
59,46,13,-,111200,37396
3773,2867,906,702,112700,37397
6034,4393,1641,588,144600,37398
2182,96,2086,321,328600,37402
1356,419,937,907,327800,37403
5057,2356,2701,729,121300,37404
7360,4045,3315,1034,253600,37405
5683,2582,3101,694,106000,37406
3430,1148,2282,727,67500,37407
849,332,517,702,298100,37408
1101,747,354,770,161800,37409
1571,444,1127,615,75100,37410
7208,4409,2799,785,115300,37411
8720,4722,3998,828,126200,37412
10804,6151,4653,853,157300,37415
6408,4027,2381,823,136100,37416
2645,1951,694,686,198500,37419
19734,11357,8377,1036,183000,37421
15302,8617,6685,699,145300,37601
16450,8367,8083,750,151800,37604
0,0,0,-,-,37614
9116,6354,2762,757,194300,37615
2040,1762,278,808,118300,37616
5438,4625,813,634,154700,37617
5319,4134,1185,652,138700,37618
16500,11903,4597,653,120000,37620
1534,1200,334,674,103000,37640
3808,3081,727,637,112700,37641
6249,4829,1420,626,128100,37642
13930,9668,4262,624,115700,37643
2007,1462,545,693,140600,37645
5070,3547,1523,618,123700,37650
1663,1334,329,625,142300,37656
422,324,98,541,127800,37657
1868,1399,469,579,120400,37658
11135,9062,2073,780,157700,37659
17472,10612,6860,626,120000,37660
6090,4829,1261,742,169400,37663
11436,8278,3158,665,152300,37664
2488,1516,972,673,94500,37665
178,112,66,-,107800,37680
2516,1892,624,615,142400,37681
69,27,42,-,-,37682
4896,3843,1053,523,128300,37683
3301,2625,676,687,153200,37686
1943,1691,252,509,104700,37687
460,383,77,525,116700,37688
1515,1363,152,738,127500,37690
263,162,101,475,106000,37691
2003,1464,539,622,160300,37692
803,594,209,633,125000,37694
3190,2245,945,831,128100,37701
1626,1320,306,779,171400,37705
2651,2170,481,593,109400,37708
1597,1175,422,691,151200,37709
385,360,25,-,63100,37710
1983,1432,551,541,98000,37711
612,413,199,694,96100,37713
1722,1181,541,670,111900,37714
301,244,57,432,58800,37715
10735,7354,3381,716,154200,37716
67,28,39,-,-,37719
4979,4192,787,970,152400,37721
2355,1858,497,520,124100,37722
366,318,48,676,104500,37723
1163,661,502,699,98300,37724
6586,5371,1215,801,165600,37725
801,679,122,522,95900,37726
917,760,157,546,117900,37727
610,520,90,540,61400,37729
0,0,0,-,-,37730
247,247,0,-,59900,37731
104,68,36,-,91300,37732
40,40,0,-,-,37733
2322,2021,301,830,190800,37737
2400,1541,859,773,186300,37738
2350,1998,352,689,183800,37742
9962,7291,2671,563,125100,37743
7063,4504,2559,610,134100,37745
6914,5024,1890,661,110600,37748
2422,1876,546,724,123400,37752
298,194,104,461,130100,37753
1934,1632,302,878,116200,37754
1322,805,517,487,81400,37755
1227,879,348,430,72800,37756
3717,2687,1030,614,132500,37757
4520,2670,1850,673,136600,37760
1291,782,509,388,83600,37762
6168,4988,1180,744,167100,37763
3474,2550,924,733,165500,37764
194,189,5,-,102200,37765
7622,5241,2381,590,82900,37766
2188,1468,720,542,88500,37769
999,854,145,579,110600,37770
6042,3934,2108,748,136100,37771
4936,3985,951,906,235100,37772
7765,6476,1289,702,223500,37774
4952,3114,1838,696,215100,37777
1274,939,335,613,100100,37779
10727,7283,3444,765,173100,37801
12375,10080,2295,833,201600,37803
9277,6854,2423,818,161500,37804
1153,838,315,706,133600,37806
3700,2659,1041,642,117500,37807
862,728,134,765,102700,37809
649,535,114,591,116100,37810
1510,1301,209,588,109300,37811
6816,4454,2362,661,107200,37813
13024,8056,4968,755,141100,37814
2181,1552,629,575,92800,37818
292,191,101,606,101800,37819
2973,2372,601,641,124200,37820
8739,5435,3304,598,102000,37821
3784,2563,1221,498,108100,37825
1962,1633,329,723,136700,37826
532,396,136,815,216200,37828
741,642,99,677,94400,37829
12289,7660,4629,762,153500,37830
3976,3118,858,719,112700,37840
3833,2561,1272,571,106800,37841
1650,1339,311,766,148400,37843
244,122,122,-,76700,37845
1791,1419,372,619,108200,37846
953,776,177,584,73200,37847
103,91,12,-,99400,37848
10048,8044,2004,847,170700,37849
22,22,0,-,32000,37851
978,783,195,532,95800,37852
1528,1111,417,738,137000,37853
5119,3917,1202,630,104400,37854
8047,5979,2068,567,110400,37857
1567,1206,361,613,138200,37860
3238,2458,780,594,110100,37861
8655,4853,3802,757,184400,37862
2750,1481,1269,760,155200,37863
8349,6622,1727,845,166700,37865
638,537,101,604,221800,37866
2069,1559,510,400,89400,37869
2057,1503,554,665,102000,37870
3729,2657,1072,818,135300,37871
664,523,141,647,109400,37872
1818,1328,490,559,92300,37873
5385,3702,1683,677,112700,37874
12434,9365,3069,767,167100,37876
3385,2888,497,721,137600,37877
192,187,5,-,103100,37878
4385,3164,1221,623,103200,37879
1264,1012,252,726,183800,37880
862,752,110,448,115300,37881
1176,964,212,786,207600,37882
2464,2005,459,621,167700,37885
1729,1360,369,716,174400,37886
1898,1297,601,672,92900,37887
1142,984,158,705,110100,37888
2820,2080,740,562,144000,37890
1308,999,309,645,117000,37891
804,570,234,577,83000,37892
1431,302,1129,899,340500,37902
7195,2739,4456,887,176500,37909
10201,4990,5211,801,121300,37912
8475,5464,3011,814,119200,37914
2616,436,2180,437,80100,37915
2584,51,2533,787,225000,37916
11127,5178,5949,740,99700,37917
17456,12168,5288,793,155600,37918
13064,7079,5985,863,285900,37919
17040,10632,6408,787,127700,37920
10495,6355,4140,843,124800,37921
13198,11039,2159,1246,317500,37922
12899,7278,5621,976,192500,37923
4782,3658,1124,707,140200,37924
11266,8299,2967,1051,212600,37931
6904,5072,1832,1182,232400,37932
9788,8680,1108,1154,317100,37934
6441,5703,738,870,176800,37938
1707,1138,569,650,103700,38001
13036,11151,1885,1324,232600,38002
3458,2964,494,1194,195000,38004
1799,1124,675,770,109200,38006
23,23,0,-,-,38007
3497,2372,1125,593,88400,38008
3416,2704,712,952,141900,38011
5558,3124,2434,634,106400,38012
868,583,285,574,121700,38015
18646,9524,9122,1128,165600,38016
18871,14723,4148,1247,299300,38017
13646,8743,4903,1186,165400,38018
6181,3487,2694,683,118100,38019
16,16,0,-,-,38021
1901,1350,551,921,132600,38023
11088,6422,4666,666,101400,38024
2649,2464,185,1186,323700,38028
0,0,0,-,-,38029
215,83,132,814,103400,38030
1075,784,291,598,86400,38034
186,19,167,389,-,38036
630,466,164,653,69400,38037
595,457,138,869,86200,38039
1980,1228,752,680,82900,38040
1056,612,444,606,77200,38041
357,203,154,635,102800,38042
312,266,46,534,107800,38044
29,19,10,-,-,38046
37,28,9,-,-,38047
1475,1147,328,819,95200,38049
197,137,60,772,94600,38050
1648,1225,423,591,82300,38052
10101,6854,3247,903,135300,38053
41,0,41,1927,-,38054
1428,1078,350,660,138500,38057
3481,2402,1079,856,144600,38058
3002,2299,703,715,100900,38059
3860,3517,343,1299,170400,38060
255,230,25,-,121000,38061
6651,3692,2959,637,87000,38063
1113,896,217,605,261200,38066
580,527,53,442,121700,38067
4152,2817,1335,640,156000,38068
921,714,207,632,76600,38069
127,101,26,-,-,38070
1265,941,324,757,88200,38075
344,283,61,800,227500,38076
50,31,19,-,-,38077
1225,691,534,546,74300,38079
1149,731,418,560,78200,38080
7123,2103,5020,1236,248900,38103
12323,4180,8143,766,199700,38104
3178,383,2795,688,87900,38105
9241,4440,4801,721,51800,38106
6686,2939,3747,771,88000,38107
6421,2685,3736,757,48300,38108
16523,10120,6403,859,68600,38109
17029,7783,9246,812,96800,38111
6499,3143,3356,786,122100,38112
10013,4396,5617,739,55500,38114
16969,3671,13298,854,89500,38115
14577,7196,7381,824,94300,38116
10739,8592,2147,1111,187200,38117
12911,5979,6932,890,71200,38118
9767,5268,4499,1009,171000,38119
6331,4586,1745,1112,305200,38120
9094,4610,4484,905,71000,38122
13934,8592,5342,1122,156500,38125
2086,290,1796,582,43600,38126
14338,6654,7684,886,58200,38127
15737,6694,9043,893,83500,38128
0,0,0,-,-,38131
0,0,0,-,-,38132
7537,5601,1936,1219,152800,38133
15190,7182,8008,960,119600,38134
10501,8669,1832,1301,168200,38135
9877,7911,1966,1292,281600,38138
5542,5298,244,2323,389400,38139
7629,5237,2392,1216,94000,38141
0,0,0,-,-,38152
4160,3005,1155,632,93400,38201
770,587,183,673,75200,38220
1353,1181,172,594,72600,38221
1202,1002,200,666,112000,38222
288,236,52,486,103100,38224
2366,1738,628,575,83000,38225
130,130,0,-,74000,38226
1206,894,312,616,83900,38229
1620,1221,399,621,77500,38230
687,569,118,644,78700,38231
770,608,162,523,86100,38232
1123,874,249,580,81100,38233
150,109,41,560,98800,38235
246,215,31,775,90900,38236
6231,3560,2671,623,122000,38237
993,716,277,618,72300,38240
380,326,54,297,96300,38241
8404,6053,2351,618,105500,38242
1107,813,294,634,91400,38251
364,293,71,732,103700,38253
19,14,5,-,-,38254
998,603,395,536,76000,38255
1320,1215,105,769,97900,38256
1881,1385,496,553,88400,38257
590,371,219,587,74600,38258
275,184,91,581,75600,38259
1503,1122,381,670,86800,38260
6682,4121,2561,589,101800,38261
13147,6829,6318,735,86900,38301
20021,12777,7244,939,153000,38305
2311,1827,484,617,89800,38310
369,336,33,-,108300,38311
1136,1006,130,698,111100,38313
1327,1053,274,599,71700,38315
1151,926,225,589,91400,38316
979,735,244,614,65600,38317
147,72,75,-,73800,38318
4495,3215,1280,638,89100,38320
914,694,220,657,81800,38321
1194,914,280,767,108100,38326
168,125,43,613,62500,38327
229,189,40,567,74000,38328
1330,1034,296,602,97500,38329
1753,1286,467,600,67600,38330
457,433,24,500,83700,38332
93,86,7,-,84000,38333
770,687,83,725,88100,38334
498,403,95,730,91600,38337
298,207,91,597,95000,38339
4510,3287,1223,675,109400,38340
939,767,172,598,79700,38341
583,436,147,574,57200,38342
6268,4298,1970,730,94000,38343
3076,2321,755,592,95900,38344
807,646,161,831,91100,38345
120,31,89,911,-,38347
369,294,75,553,89400,38348
6782,4841,1941,624,101900,38351
246,199,47,-,112400,38352
2322,1732,590,1038,169400,38355
1062,879,183,645,88400,38356
1084,804,280,616,101700,38357
4506,3323,1183,681,108500,38358
167,133,34,542,88300,38359
409,345,64,720,114500,38361
436,335,101,1107,87000,38362
2249,1659,590,536,89800,38363
10,0,10,-,-,38365
701,590,111,744,133400,38366
1195,903,292,641,99000,38367
807,623,184,684,80700,38368
656,508,148,575,78200,38369
313,241,72,435,71700,38370
384,314,70,600,77300,38371
6740,4685,2055,595,120900,38372
833,605,228,534,100600,38374
3523,2277,1246,583,102700,38375
67,56,11,-,102100,38376
523,399,124,667,97300,38379
231,188,43,627,85000,38380
538,343,195,651,108100,38381
3672,2340,1332,629,92000,38382
113,98,15,-,87500,38387
709,586,123,685,85400,38388
397,347,50,582,91700,38390
424,297,127,692,108700,38391
236,236,0,-,88700,38392
22332,14580,7752,825,159500,38401
773,625,148,497,115100,38425
1008,759,249,586,128600,38449
1171,930,241,453,99800,38450
1627,1371,256,729,169300,38451
490,449,41,-,106300,38452
136,136,0,-,181700,38453
393,314,79,-,145000,38454
68,64,4,-,112500,38455
1389,1132,257,671,111500,38456
289,228,61,538,77800,38457
168,154,14,-,48700,38459
461,332,129,736,80600,38460
496,411,85,810,112100,38461
3912,2998,914,566,91900,38462
1046,870,176,556,94600,38463
9049,6231,2818,623,109500,38464
1986,1680,306,698,99400,38468
1564,1252,312,618,98400,38469
162,141,21,-,140100,38471
1225,1048,177,630,104300,38472
408,302,106,643,97100,38473
3023,2179,844,608,103600,38474
192,166,26,-,107400,38475
440,376,64,-,247800,38476
1162,984,178,470,122600,38477
6943,4419,2524,641,132500,38478
420,341,79,573,71200,38481
624,527,97,1138,177300,38482
2107,1636,471,658,103100,38483
2506,1919,587,561,95300,38485
316,268,48,-,90600,38486
449,304,145,877,157700,38487
1017,839,178,610,135300,38488
16947,8394,8553,675,154300,38501
393,393,0,-,-,38504
0,0,0,-,-,38505
11393,8859,2534,734,161700,38506
671,613,58,557,84700,38541
8,0,8,-,-,38542
245,188,57,609,100000,38543
2810,2189,621,669,144200,38544
641,428,213,538,144700,38545
770,664,106,649,135200,38547
299,217,82,-,135100,38548
1601,1254,347,459,142400,38549
1700,1171,529,412,104500,38551
86,70,16,-,140000,38552
1033,779,254,765,86000,38553
424,333,91,651,111200,38554
8133,4977,3156,677,137300,38555
5067,3713,1354,468,102800,38556
4594,4042,552,870,205600,38558
472,398,74,708,123800,38559
469,415,54,575,114400,38560
2502,1945,557,507,93500,38562
1260,911,349,629,146900,38563
193,137,56,-,83600,38564
456,447,9,-,55400,38565
205,199,6,-,166400,38567
861,655,206,524,89900,38568
78,78,0,-,-,38569
3974,2847,1127,491,112900,38570
5683,4544,1139,638,131900,38571
4776,4252,524,667,118500,38572
812,752,60,-,156100,38573
3219,2308,911,547,138800,38574
468,371,97,628,107900,38575
542,376,166,717,92900,38577
62,49,13,768,145800,38578
339,268,71,828,104500,38579
619,521,98,-,126600,38580
1436,1269,167,584,95900,38581
561,516,45,1078,136600,38582
8947,7267,1680,643,109700,38583
1494,1187,307,428,83100,38585
571,476,95,634,113500,38587
334,255,79,536,134400,38588
74,38,36,-,-,38589
847,678,169,495,82500,38601
1218,967,251,525,68200,38603
5659,4074,1585,698,89000,38606
1027,748,279,489,75000,38610
5818,4625,1193,684,133500,38611
6605,3287,3318,602,71300,38614
249,142,107,318,65700,38617
4539,3501,1038,730,98900,38618
2061,1230,831,614,75900,38619
1246,1057,189,779,70500,38620
574,352,222,600,45800,38621
257,139,118,575,-,38622
92,71,21,-,40300,38623
483,361,122,545,76800,38625
537,347,190,527,144100,38626
366,276,90,-,63500,38627
730,510,220,429,113200,38629
128,116,12,-,21400,38630
475,223,252,519,62300,38631
9507,8087,1420,977,189700,38632
718,584,134,527,74600,38633
5714,3884,1830,704,97200,38635
9550,5589,3961,1013,103000,38637
414,195,219,400,47100,38639
800,696,104,628,172300,38641
807,718,89,488,74300,38642
1000,407,593,495,52500,38643
81,46,35,-,33700,38644
519,290,229,647,73700,38645
1165,840,325,588,58800,38646
291,291,0,-,76700,38647
1397,1064,333,666,77600,38650
2680,2286,394,1070,185200,38651
5998,4142,1856,727,106300,38652
18218,14806,3412,1134,188300,38654
16920,9942,6978,933,206600,38655
780,720,60,933,74000,38658
1012,798,214,715,95700,38659
758,688,70,-,102900,38661
4477,3101,1376,572,86500,38663
1349,159,1190,794,130000,38664
854,704,150,-,85300,38665
2587,1948,639,614,66600,38666
4986,3535,1451,705,137200,38668
339,239,100,768,41300,38670
13824,8252,5572,1021,120800,38671
4481,3943,538,1526,198000,38672
301,261,40,644,122700,38673
339,339,0,-,80600,38674
2183,1181,1002,694,102800,38676
34,0,34,-,-,38677
2180,1419,761,860,139500,38680
2163,1707,456,399,61700,38683
516,506,10,-,127000,38685
9047,4641,4406,677,81300,38701
14,0,14,-,-,38702
4662,2624,2038,710,69600,38703
0,0,0,-,-,38704
282,199,83,659,54000,38720
420,331,89,719,52400,38721
142,85,57,583,61800,38722
41,41,0,-,-,38723
283,161,122,562,48500,38725
203,132,71,611,37500,38726
827,614,213,738,141300,38730
57,10,47,-,-,38731
6452,3360,3092,714,118700,38732
164,132,32,720,66700,38736
1102,552,550,500,62500,38737
42,0,42,-,-,38738
113,80,33,628,48800,38740
341,188,153,-,84200,38744
46,16,30,-,93300,38745
168,72,96,575,55500,38746
1426,843,583,500,73400,38748
9,3,6,-,-,38749
3911,2196,1715,695,73200,38751
544,368,176,591,103100,38753
549,345,204,543,84800,38754
2387,1408,979,711,68700,38756
347,262,85,904,121000,38759
345,139,206,637,68100,38760
787,445,342,592,67600,38761
935,408,527,463,81000,38762
127,74,53,766,110300,38764
18,18,0,-,-,38765
13,13,0,-,-,38767
41,5,36,-,-,38768
701,310,391,469,65600,38769
1032,492,540,603,88900,38771
35,35,0,-,49700,38772
1251,772,479,638,81600,38773
760,421,339,494,67900,38774
553,297,256,506,62800,38778
97,42,55,287,90000,38781
11520,6730,4790,782,127900,38801
7047,3997,3050,731,145600,38804
5181,3718,1463,612,110800,38821
3026,2124,902,557,108200,38824
1775,1413,362,1037,168000,38826
1303,998,305,561,108200,38827
1581,1191,390,699,94700,38828
6796,4935,1861,579,90000,38829
1031,709,322,565,55600,38833
11221,7662,3559,613,99700,38834
416,320,96,-,67700,38838
1050,766,284,541,69600,38841
4360,3300,1060,661,97000,38843
72,69,3,-,-,38844
920,784,136,713,88900,38846
1291,1057,234,593,71900,38847
261,247,14,-,70300,38848
2161,1797,364,805,110500,38849
1042,777,265,492,66300,38850
2896,2088,808,637,63600,38851
3669,2792,877,551,97300,38852
1762,1382,380,662,87400,38855
619,552,67,-,107500,38856
1415,1215,200,633,133100,38857
2559,1979,580,571,86800,38858
342,298,44,-,86000,38859
2346,1701,645,590,65700,38860
918,784,134,679,100000,38862
7163,4930,2233,674,103900,38863
692,538,154,757,81900,38864
1778,1472,306,583,80500,38865
4334,3329,1005,526,145600,38866
2009,1431,578,624,84300,38868
169,103,66,795,102900,38869
1015,764,251,673,98400,38870
629,505,124,780,118500,38871
1100,890,210,588,72700,38873
595,449,146,563,100400,38876
1051,771,280,608,67000,38878
301,66,235,661,85300,38879
7152,4616,2536,646,99900,38901
160,139,21,-,67700,38913
239,205,34,758,58000,38914
1569,1116,453,479,76300,38915
2058,1332,726,577,63900,38916
1317,987,330,495,100200,38917
283,213,70,-,60800,38920
1592,1150,442,475,66600,38921
1307,1057,250,543,74700,38922
462,380,82,-,90500,38923
280,163,117,452,37200,38924
1303,963,340,526,75100,38925
429,313,116,676,53100,38927
99,53,46,625,32900,38928
574,427,147,836,80100,38929
8258,4303,3955,522,84700,38930
630,543,87,688,100400,38940
1413,543,870,611,69100,38941
42,42,0,-,-,38943
174,127,47,617,-,38944
9,0,9,-,-,38945
92,64,28,683,46900,38946
180,167,13,555,106300,38947
972,790,182,445,42900,38948
118,95,23,-,128500,38949
210,180,30,-,79400,38950
492,415,77,531,55200,38951
165,106,59,-,132100,38952
149,149,0,-,94600,38953
370,262,108,563,58300,38954
270,151,119,-,83700,38957
0,0,0,-,-,38958
331,222,109,-,91600,38961
45,25,20,-,-,38962
484,380,104,605,65500,38963
33,21,12,-,-,38964
3519,2566,953,638,92900,38965
348,185,163,740,47900,38966
2929,2073,856,656,97000,38967
2125,1222,903,646,67400,39038
827,614,213,864,85500,39039
1289,981,308,677,79300,39040
1330,1091,239,706,128800,39041
14027,11691,2336,955,163900,39042
1374,1239,135,-,91300,39044
564,505,59,-,84500,39045
10060,6140,3920,794,149500,39046
14691,12309,2382,1303,190600,39047
5966,4313,1653,658,83900,39051
115,97,18,-,"10,000-",39054
9365,6346,3019,963,164600,39056
783,606,177,539,77400,39057
3979,3159,820,743,96000,39059
0,0,0,-,-,39061
198,142,56,636,83300,39062
1209,690,519,580,57800,39063
1657,1262,395,484,90500,39066
541,482,59,278,41600,39067
1808,1167,641,429,61900,39069
2132,1685,447,733,169900,39071
7235,5879,1356,790,140300,39073
5541,4076,1465,694,66000,39074
315,279,36,320,86500,39078
476,281,195,490,66600,39079
394,358,36,-,67700,39082
3530,2589,941,699,86900,39083
450,392,58,-,39200,39086
25,17,8,-,-,39088
4988,3102,1886,514,85800,39090
1042,890,152,535,80000,39092
1442,1185,257,612,86600,39094
2605,1667,938,568,54500,39095
461,241,220,586,47700,39096
278,169,109,517,44000,39097
619,544,75,766,62500,39108
15315,14390,925,1372,261300,39110
3086,2256,830,625,88300,39111
156,52,104,240,-,39113
3503,2947,556,719,78600,39114
16,9,7,-,-,39115
765,636,129,1031,113200,39116
3978,2895,1083,719,80300,39117
1932,1637,295,640,86700,39119
11339,7052,4287,603,93300,39120
999,706,293,778,85700,39140
180,155,25,-,55900,39144
1834,1464,370,776,131400,39145
793,630,163,631,65100,39146
652,615,37,-,98100,39149
2128,1357,771,614,67300,39150
486,395,91,616,59700,39152
1382,1136,246,667,78900,39153
3399,2814,585,858,168900,39154
156,156,0,-,-,39156
10662,5074,5588,1061,181200,39157
1306,770,536,479,67600,39159
1033,866,167,584,56300,39160
29,24,5,-,-,39162
198,135,63,269,69300,39166
0,0,0,-,-,39167
2595,2007,588,538,88300,39168
962,415,547,331,53600,39169
3796,3495,301,732,184800,39170
117,58,59,-,-,39174
1697,1409,288,683,82400,39175
763,533,230,395,72800,39176
57,26,31,-,128100,39177
417,312,105,-,118200,39179
12832,8357,4475,718,114700,39180
5778,3575,2203,681,129700,39183
1297,1007,290,603,61200,39189
2761,2409,352,720,112500,39191
463,372,91,791,66600,39192
0,0,0,-,-,39193
6147,3557,2590,613,78100,39194
273,10,263,1121,-,39201
3446,930,2516,785,190700,39202
1892,900,992,680,48600,39203
5918,2313,3605,743,70600,39204
10002,4628,5374,848,98400,39206
11407,7313,4094,869,122000,39208
9744,4604,5140,779,63700,39209
9917,6296,3621,1011,163300,39211
11441,7052,4389,899,88900,39212
8373,4396,3977,680,63800,39213
1730,824,906,873,198400,39216
0,0,0,-,-,39217
2445,1516,929,926,129900,39218
3436,1659,1777,1126,195600,39232
0,0,0,-,-,39269
4801,3563,1238,1151,140200,39272
10403,6157,4246,679,80500,39301
8280,5581,2699,860,147600,39305
6205,3761,2444,658,71400,39307
0,0,0,-,-,39309
475,395,80,946,109500,39320
483,483,0,-,55600,39322
619,514,105,665,68900,39323
2500,2191,309,579,124100,39325
163,153,10,-,91800,39326
1495,1098,397,544,110000,39327
1894,1312,582,348,64500,39328
999,913,86,725,134300,39330
510,472,38,384,81300,39332
1133,1110,23,-,75100,39335
521,424,97,-,56900,39336
748,686,62,474,103600,39337
1294,1080,214,594,66000,39338
5870,4214,1656,672,85700,39339
2492,1696,796,546,60400,39341
555,167,388,808,134700,39342
2521,1886,635,579,77300,39345
986,728,258,658,83200,39346
724,567,157,551,97300,39347
300,253,47,-,33300,39348
9024,6395,2629,666,78100,39350
216,204,12,-,86100,39352
1005,855,150,716,73600,39354
2675,2134,541,630,76500,39355
237,182,55,-,200800,39356
607,411,196,263,57000,39358
139,88,51,595,98300,39359
1367,1120,247,548,53700,39360
540,446,94,525,53900,39361
1310,1060,250,806,64800,39362
558,384,174,625,49100,39363
977,761,216,-,81300,39364
2682,2095,587,598,80300,39365
433,410,23,-,53000,39366
5780,4607,1173,502,85400,39367
16396,6811,9585,735,94800,39401
15706,10149,5557,959,187200,39402
0,0,0,-,-,39406
1100,895,205,755,80200,39421
1876,1607,269,682,72700,39422
1055,919,136,716,63400,39423
854,610,244,576,105800,39425
6453,5303,1150,925,140900,39426
536,452,84,526,67400,39427
3509,2686,823,668,73600,39428
6205,4846,1359,629,88500,39429
4527,3501,1026,759,117900,39437
1685,1462,223,619,72400,39439
7759,4410,3349,680,88500,39440
8150,6545,1605,604,87800,39443
1230,926,304,620,74400,39451
8950,7299,1651,705,107700,39452
3395,2629,766,564,97700,39455
414,357,57,802,162500,39456
1328,1026,302,572,80300,39459
348,348,0,-,74200,39461
464,352,112,548,88900,39462
959,911,48,-,117900,39464
7478,5593,1885,878,145600,39465
10009,7156,2853,730,125000,39466
4621,3941,680,672,110200,39470
2252,1650,602,578,82400,39474
4996,3710,1286,863,149300,39475
2898,2495,403,585,96700,39476
265,222,43,703,86100,39477
843,656,187,527,88900,39478
2058,1754,304,686,114300,39479
1140,944,196,692,114300,39480
602,497,105,-,115100,39481
3806,3298,508,782,136900,39482
2407,2087,320,715,79300,39483
9263,3416,5847,812,86900,39501
19844,12763,7081,895,140500,39503
7449,3671,3778,822,155600,39507
7781,5124,2657,817,147200,39520
3497,2964,533,883,172100,39525
3347,1378,1969,794,105400,39530
7655,2251,5404,824,144600,39531
13972,8584,5388,972,168000,39532
0,0,0,-,-,39534
3754,1347,2407,951,108600,39540
6040,3836,2204,885,125600,39553
3276,2908,368,881,119600,39556
7093,4458,2635,941,136800,39560
888,678,210,690,113000,39561
6280,5303,977,786,119900,39562
5206,3700,1506,869,88500,39563
14311,10324,3987,975,154500,39564
6639,5620,1019,937,161400,39565
3963,2409,1554,776,118700,39567
5263,3994,1269,848,173000,39571
496,475,21,-,110500,39572
2931,2509,422,766,120100,39573
5038,4434,604,869,153500,39574
2365,1382,983,762,139800,39576
3432,2352,1080,675,115300,39577
4355,2082,2273,739,103300,39581
8296,5882,2414,689,102600,39601
2722,2249,473,674,108800,39629
369,187,182,429,55500,39630
1244,931,313,534,69900,39631
462,392,70,223,48800,39633
128,84,44,-,67600,39635
1255,999,256,486,59200,39638
1396,1241,155,1354,111100,39641
418,320,98,1017,109500,39643
2035,1751,284,737,80900,39645
326,326,0,-,-,39647
7879,4463,3416,662,91900,39648
2898,2352,546,723,78100,39652
1000,784,216,869,80900,39653
1971,1482,489,697,101500,39654
267,229,38,-,52800,39656
750,589,161,660,106600,39657
1104,828,276,608,67100,39661
602,538,64,-,87400,39662
1149,741,408,1032,93000,39663
938,751,187,812,97300,39664
537,488,49,580,75600,39665
3548,2832,716,674,114200,39666
4810,4354,456,557,89600,39667
329,295,34,-,84500,39668
1546,1329,217,591,72800,39669
5119,2551,2568,655,112200,39701
8408,5505,2903,785,120600,39702
5506,2950,2556,901,166400,39705
4248,3028,1220,615,75400,39730
1436,989,447,334,103100,39735
123,61,62,490,66400,39736
58,58,0,-,105200,39737
922,704,218,563,64500,39739
2039,1624,415,715,146500,39740
651,581,70,959,79300,39741
608,510,98,493,76000,39743
2154,1459,695,532,77800,39744
263,239,24,768,-,39745
1245,1063,182,627,117400,39746
796,646,150,535,58500,39747
888,664,224,668,78700,39750
523,466,57,738,86200,39751
1164,1013,151,504,85400,39752
327,304,23,-,69600,39755
782,621,161,1039,56500,39756
16562,8128,8434,792,167700,39759
11,11,0,-,-,39760
19,0,19,-,-,39762
1191,946,245,972,96000,39766
307,257,50,-,67000,39767
732,607,125,754,102800,39769
38,33,5,-,77500,39771
635,479,156,670,67400,39772
6201,4111,2090,724,91800,39773
626,513,113,498,77900,39776
816,531,285,423,50800,39813
658,425,233,730,57400,39815
3724,1823,1901,623,98200,39817
4129,2364,1765,732,140100,39819
2993,1959,1034,691,84800,39823
192,143,49,-,77400,39824
496,270,226,606,155000,39825
172,106,66,710,68300,39826
1511,1028,483,809,117500,39827
5181,3072,2109,765,111900,39828
993,740,253,678,85700,39834
110,78,32,-,169500,39836
2471,1688,783,635,89700,39837
1834,938,896,594,63400,39840
327,270,57,575,34900,39841
2902,1623,1279,646,108500,39842
3006,2045,961,727,85700,39845
775,514,261,527,52500,39846
900,516,384,341,52600,39851
942,686,256,667,66400,39854
439,332,107,525,100000,39859
514,298,216,598,87400,39861
593,402,191,578,76500,39862
167,128,39,556,77500,39866
193,157,36,-,100200,39867
828,529,299,463,77800,39870
157,107,50,817,66900,39877
40,26,14,933,133300,39885
694,467,227,461,80200,39886
1339,1062,277,706,68500,39897
735,597,138,1035,147500,40003
11682,8781,2901,719,149000,40004
1951,1445,506,692,116400,40006
50,50,0,-,-,40007
1328,1058,270,727,150400,40008
385,314,71,706,68900,40009
168,118,50,-,343700,40010
968,795,173,638,120600,40011
177,147,30,763,100700,40012
1950,1717,233,686,161500,40013
6949,6017,932,942,281900,40014
1566,881,685,766,122800,40019
53,49,4,-,133600,40020
348,340,8,-,301400,40022
1888,1749,139,1206,306900,40023
20,20,0,-,1000000,40025
1955,1781,174,1129,297800,40026
7631,5837,1794,818,217000,40031
5140,3534,1606,625,106800,40033
92,56,36,-,-,40036
1036,894,142,630,106400,40037
118,100,18,531,96000,40040
282,66,216,1150,-,40041
1500,1080,420,777,126000,40045
624,616,8,-,163800,40046
7653,6618,1035,780,171900,40047
0,0,0,-,-,40048
0,0,0,-,-,40049
621,317,304,714,119300,40050
1779,1280,499,667,127100,40051
217,179,38,-,89900,40052
714,566,148,850,217300,40055
1256,1200,56,1308,192600,40056
1443,972,471,744,121600,40057
43,30,13,-,88800,40058
7107,6437,670,1425,429800,40059
428,330,98,597,120500,40060
94,82,12,-,88500,40062
0,0,0,-,-,40063
11168,7143,4025,784,174400,40065
2064,1625,439,866,234100,40067
729,632,97,640,161400,40068
3291,2367,924,600,115200,40069
194,194,0,-,148300,40070
5627,4719,908,632,200100,40071
461,312,149,1035,122600,40075
963,829,134,976,173600,40076
164,154,10,-,176600,40077
911,750,161,589,94700,40078
427,341,86,975,122500,40104
853,658,195,715,169900,40107
4487,3521,966,711,159600,40108
789,757,32,1015,150900,40109
22,0,22,-,-,40110
588,427,161,270,64800,40111
210,198,12,-,110100,40115
1002,739,263,720,142500,40117
3562,2318,1244,865,104300,40118
735,655,80,911,130400,40119
2451,21,2430,1135,-,40121
245,174,71,-,67500,40140
846,714,132,-,115400,40142
2302,1713,589,574,107400,40143
597,497,100,554,124300,40144
191,159,32,-,123700,40145
1550,1118,432,617,85400,40146
1533,1142,391,783,133600,40150
393,393,0,-,142900,40152
430,174,256,635,64100,40155
324,269,55,1027,89000,40157
9082,4806,4276,749,126500,40160
78,38,40,-,-,40161
2187,1834,353,726,194600,40162
13167,10013,3154,790,167300,40165
188,177,11,-,-,40170
102,92,10,-,45000,40171
5289,3997,1292,877,151000,40175
355,339,16,-,103900,40176
613,429,184,707,101800,40177
192,143,49,1142,137000,40178
2678,196,2482,341,282000,40202
8683,1312,7371,518,78800,40203
7151,3343,3808,878,194300,40204
10479,7739,2740,881,271600,40205
9691,4997,4694,822,209300,40206
13727,9646,4081,1005,292000,40207
6015,1456,4559,766,85100,40208
98,21,77,679,55800,40209
5371,2158,3213,606,59600,40210
8829,3462,5367,738,66500,40211
6601,2865,3736,727,61700,40212
6850,4047,2803,796,112000,40213
17650,9041,8609,769,126700,40214
7914,3318,4596,788,79100,40215
16904,10835,6069,704,113000,40216
5915,3680,2235,838,146300,40217
13602,6683,6919,809,135100,40218
15657,8723,6934,760,129100,40219
14393,9282,5111,947,173300,40220
9952,5757,4195,967,258000,40222
9435,6937,2498,1090,259400,40223
6455,5499,956,871,155100,40228
14175,10679,3496,975,132000,40229
0,0,0,-,-,40231
12495,8805,3690,1153,261100,40241
4588,3223,1365,1049,195800,40242
4563,3133,1430,1087,213900,40243
12035,9994,2041,1210,333900,40245
10423,7613,2810,798,124000,40258
14232,10752,3480,924,121700,40272
101,40,61,950,522700,40280
14708,11566,3142,945,171500,40291
15813,12404,3409,980,203500,40299
149,100,49,631,68100,40310
2708,1933,775,608,88800,40311
2134,1425,709,653,76900,40312
1138,573,565,681,79700,40313
147,147,0,-,69700,40316
1258,990,268,543,76200,40322
17706,11929,5777,853,176200,40324
437,371,66,736,80900,40328
7994,5640,2354,613,141500,40330
13,13,0,-,-,40334
4866,3471,1395,581,79400,40336
1973,1521,452,600,89700,40337
0,0,0,-,-,40339
8490,6567,1923,708,142300,40342
324,286,38,628,68800,40346
1086,797,289,843,204200,40347
236,132,104,546,81500,40348
81,81,0,-,-,40350
7419,4548,2871,654,131700,40351
8488,5448,3040,700,125900,40353
16168,10245,5923,821,166900,40356
355,338,17,-,91600,40358
2502,1715,787,617,98800,40359
2481,1572,909,612,94100,40360
7459,4774,2685,732,143700,40361
19,19,0,-,-,40363
1176,1040,136,628,196400,40370
1239,1008,231,636,76200,40371
748,642,106,725,180500,40372
700,489,211,681,95500,40374
31,31,0,-,-,40376
1336,986,350,795,149600,40379
2611,1876,735,697,91100,40380
9151,6424,2727,717,201400,40383
1108,834,274,774,86800,40385
861,728,133,659,82200,40387
2332,1294,1038,739,166000,40390
14273,9508,4765,726,141000,40391
1101,755,346,604,76800,40402
9131,6260,2871,713,135500,40403
0,0,0,-,-,40404
1364,899,465,622,80900,40409
1627,1358,269,424,80800,40419
9142,5713,3429,694,156500,40422
0,0,0,-,-,40434
2074,1742,332,613,99100,40437
890,705,185,763,87900,40440
526,348,178,517,77100,40442
5717,4567,1150,684,144600,40444
305,245,60,463,74800,40445
3392,2421,971,511,74200,40447
34,17,17,-,-,40448
3926,3030,896,549,88700,40456
470,372,98,813,47400,40460
1348,925,423,718,153900,40461
552,538,14,-,88100,40464
723,504,219,723,96500,40468
689,550,139,570,54500,40472
23016,12552,10464,688,164900,40475
41,26,15,-,-,40481
4484,3357,1127,621,110900,40484
937,814,123,374,94500,40486
1598,1348,250,719,87400,40489
12258,7035,5223,887,331000,40502
12342,8344,3998,917,182900,40503
11514,3879,7635,705,142400,40504
10992,6257,4735,732,115500,40505
0,0,0,-,-,40506
1271,235,1036,616,321900,40507
9515,2316,7199,745,109300,40508
16348,10035,6313,983,237900,40509
340,269,71,881,401300,40510
12374,7791,4583,946,147700,40511
4207,3397,810,1138,344000,40513
5996,4847,1149,1218,198000,40514
14609,9234,5375,1007,215300,40515
1311,893,418,924,168900,40516
16193,6028,10165,858,133300,40517
21211,13288,7923,735,142600,40601
0,0,0,-,-,40604
11587,7503,4084,573,109600,40701
2015,1587,428,699,94100,40729
1462,1043,419,496,56300,40734
334,226,108,-,88700,40737
1118,815,303,516,90900,40740
9021,6003,3018,633,119500,40741
89,65,24,-,211700,40743
6663,4947,1716,702,112900,40744
847,766,81,584,62200,40759
185,128,57,-,-,40763
5994,3915,2079,600,70400,40769
519,381,138,444,59400,40771
195,187,8,-,55600,40801
1049,636,413,637,92900,40806
159,123,36,596,52300,40807
24,24,0,-,81300,40808
505,360,145,428,56200,40810
178,124,54,544,47900,40813
468,338,130,797,59000,40815
15,0,15,-,-,40816
23,14,9,-,-,40818
227,204,23,-,71600,40819
298,266,32,-,28500,40820
1648,967,681,415,49800,40823
162,63,99,581,-,40824
263,205,58,528,48300,40826
374,266,108,-,65300,40827
1286,975,311,551,52500,40828
82,30,52,-,-,40829
82,73,9,-,40500,40830
2186,1198,988,419,76800,40831
95,95,0,-,52100,40840
132,122,10,-,90000,40843
58,28,30,-,27100,40844
235,217,18,-,42100,40845
142,142,0,-,60200,40847
172,132,40,-,70400,40849
443,229,214,532,56000,40854
342,247,95,655,56800,40855
285,250,35,-,64100,40856
151,120,31,-,90500,40858
205,190,15,-,49400,40862
245,216,29,-,33900,40863
185,128,57,548,77000,40865
486,408,78,-,76000,40868
148,141,7,-,49000,40870
889,742,147,715,69200,40873
207,165,42,-,34400,40874
480,387,93,522,34100,40902
189,134,55,681,42300,40903
4517,2728,1789,626,81600,40906
117,54,63,532,-,40913
103,46,57,555,68000,40914
321,246,75,595,118100,40915
112,81,31,-,-,40921
174,153,21,-,53600,40923
130,102,28,-,55400,40927
1163,829,334,530,67300,40935
105,72,33,-,53200,40939
196,169,27,-,45400,40940
152,43,109,496,-,40941
250,178,72,-,82900,40943
103,77,26,-,-,40946
311,227,84,498,88300,40949
278,137,141,550,90900,40953
147,96,51,-,37900,40958
6568,4548,2020,530,58100,40962
28,17,11,-,-,40964
5317,2908,2409,530,86400,40965
496,349,147,520,43900,40972
3913,2801,1112,439,50800,40977
20,20,0,-,-,40979
133,112,21,-,41700,40982
138,96,42,-,61500,40983
195,104,91,-,-,40988
46,46,0,-,29100,40995
144,91,53,860,-,40997
6147,5348,799,847,196000,41001
970,699,271,572,112200,41002
978,634,344,712,96800,41003
1673,1218,455,606,103000,41004
8536,6541,1995,1013,181500,41005
1610,1256,354,776,123700,41006
1623,1396,227,809,217400,41007
2665,1589,1076,593,120600,41008
1366,1133,233,707,113500,41010
11890,5011,6879,718,171800,41011
2822,1255,1567,733,83100,41014
8160,5413,2747,713,118700,41015
2471,1625,846,752,100100,41016
15284,11235,4049,815,198700,41017
10421,6430,3991,926,119100,41018
2240,1511,729,797,137300,41030
6014,4161,1853,571,139800,41031
659,629,30,-,152900,41033
356,324,32,577,115200,41034
4023,2796,1227,673,127400,41035
1152,855,297,549,87400,41039
2752,1839,913,706,87100,41040
2935,1808,1127,580,106900,41041
20475,13073,7402,940,151200,41042
649,554,95,674,130700,41043
374,310,64,747,112500,41044
535,402,133,784,115000,41045
377,329,48,638,77300,41046
4821,4182,639,1188,217800,41048
883,689,194,710,93600,41049
9848,8421,1427,989,168200,41051
37,24,13,-,-,41052
776,647,129,625,113400,41055
5524,3374,2150,625,118800,41056
914,805,109,675,173000,41059
0,0,0,-,-,41062
1224,1100,124,648,146000,41063
775,584,191,488,92900,41064
8751,4155,4596,768,124700,41071
2560,1808,752,748,130500,41073
2138,1249,889,844,102100,41074
6636,4587,2049,857,224600,41075
7173,5438,1735,943,163600,41076
700,627,73,1029,262000,41080
480,366,114,510,96900,41083
318,200,118,643,84100,41085
1016,869,147,579,135600,41086
6717,6157,560,1681,255900,41091
1211,1062,149,784,177300,41092
1141,919,222,564,83600,41093
5361,3990,1371,944,195800,41094
1343,751,592,706,104900,41095
2399,1592,807,702,130600,41097
658,464,194,696,84500,41098
0,0,0,-,-,41099
7576,4601,2975,656,98300,41101
7948,5769,2179,716,121200,41102
468,447,21,-,113800,41121
417,305,112,465,81200,41124
3783,3087,696,569,117500,41129
125,107,18,-,63800,41132
63,52,11,-,-,41135
3254,2240,1014,779,95900,41139
690,602,88,469,51700,41141
38,38,0,-,-,41142
5229,3933,1296,564,105200,41143
3866,3108,758,632,92700,41144
148,57,91,725,64100,41146
226,207,19,-,52900,41149
237,141,96,318,43000,41159
4747,3809,938,574,72800,41164
456,378,78,-,86100,41166
905,781,124,685,101700,41168
2171,1603,568,675,140100,41169
1643,1173,470,608,97100,41171
467,296,171,388,89300,41174
2021,1531,490,725,97700,41175
3248,2391,857,422,69800,41179
411,329,82,575,52800,41180
654,551,103,763,101000,41183
823,586,237,696,67400,41189
68,68,0,-,160700,41201
326,220,106,-,78800,41203
195,138,57,-,-,41204
238,164,74,-,46800,41214
422,342,80,611,104900,41216
762,612,150,764,58800,41219
1023,935,88,779,91300,41222
1921,1414,507,554,87600,41224
125,125,0,-,63900,41226
4475,3439,1036,552,83000,41230
408,210,198,667,64700,41231
292,183,109,682,71500,41232
236,218,18,-,91500,41234
235,192,43,-,106800,41238
2518,1404,1114,597,121800,41240
476,385,91,359,57400,41250
134,114,20,-,48800,41254
410,323,87,543,95800,41255
1112,905,207,687,110300,41256
199,143,56,626,70300,41257
312,138,174,-,120300,41260
353,271,82,-,60600,41262
175,88,87,662,-,41263
146,94,52,-,120000,41264
588,461,127,811,92600,41265
275,207,68,958,55400,41267
259,212,47,-,71400,41268
74,65,9,-,108900,41271
221,124,97,505,-,41274
2483,1580,903,529,62200,41301
2719,1876,843,588,67000,41311
1783,1239,544,315,69400,41314
41,35,6,-,-,41317
415,303,112,586,66500,41332
4310,3063,1247,484,52900,41339
460,327,133,402,41500,41348
314,270,44,-,63800,41352
168,141,27,-,51200,41360
134,75,59,453,60200,41365
14,14,0,-,-,41366
76,54,22,-,-,41367
193,170,23,-,51800,41385
16,5,11,-,-,41390
16,16,0,-,-,41397
185,154,31,675,56000,41408
191,98,93,-,-,41421
446,344,102,564,73000,41425
290,208,82,-,51800,41464
4572,3241,1331,551,72500,41465
3680,2616,1064,550,78600,41472
9735,6081,3654,689,100500,41501
240,145,95,-,210700,41503
329,250,79,703,104500,41512
172,135,37,-,68400,41513
1415,761,654,740,69500,41514
47,47,0,-,40500,41517
507,424,83,642,83200,41519
2193,1844,349,537,67600,41522
76,76,0,-,-,41524
54,27,27,-,-,41526
356,275,81,677,135600,41527
360,291,69,-,68800,41528
406,366,40,843,77900,41531
116,111,5,-,-,41534
184,152,32,-,106800,41535
2013,1488,525,438,63400,41537
18,18,0,-,-,41538
575,505,70,692,92600,41539
97,81,16,-,52700,41540
92,86,6,-,55000,41543
324,276,48,645,55700,41544
294,219,75,-,-,41547
366,271,95,701,63300,41548
894,848,46,-,93500,41553
428,326,102,577,62900,41554
284,189,95,-,77500,41555
735,580,155,656,76500,41557
320,246,74,564,38000,41558
77,50,27,-,37500,41559
109,109,0,-,107200,41560
1215,785,430,608,67000,41562
168,115,53,-,45000,41563
372,329,43,555,86300,41564
338,235,103,-,47000,41566
82,82,0,-,43300,41567
379,364,15,-,-,41568
197,176,21,-,37600,41571
1480,1225,255,677,88800,41572
355,256,99,637,69500,41601
369,295,74,-,59000,41602
634,442,192,806,63900,41603
215,175,40,-,79400,41604
278,278,0,-,107400,41605
435,340,95,-,36500,41606
213,198,15,544,-,41607
92,51,41,-,24700,41612
280,213,67,-,-,41615
287,214,73,839,-,41616
96,87,9,-,81800,41619
69,69,0,-,93900,41621
86,73,13,-,108700,41622
607,426,181,605,84500,41630
469,389,80,-,87800,41631
222,171,51,-,107000,41632
1182,821,361,680,72100,41635
368,206,162,709,59600,41636
404,342,62,699,57200,41640
287,185,102,552,95800,41642
27,12,15,-,-,41643
558,426,132,239,-,41645
661,478,183,575,74200,41647
1026,539,487,524,70600,41649
164,137,27,-,38200,41650
4190,2679,1511,567,101700,41653
379,288,91,-,58600,41655
175,157,18,-,56300,41659
230,184,46,-,88300,41660
245,194,51,-,-,41663
363,211,152,817,46900,41666
235,184,51,-,48700,41667
232,148,84,666,36700,41669
6708,4908,1800,623,79400,41701
139,139,0,-,-,41712
58,58,0,-,-,41713
142,142,0,-,80500,41714
497,440,57,494,82600,41719
249,174,75,634,33200,41721
542,432,110,656,51900,41722
594,455,139,-,70800,41723
71,56,15,-,-,41725
326,250,76,1027,78100,41727
19,0,19,-,-,41729
425,379,46,375,54400,41731
63,40,23,-,44300,41735
45,37,8,-,-,41739
406,332,74,621,66000,41740
183,175,8,-,-,41745
202,130,72,-,-,41746
1305,1069,236,518,78600,41749
99,86,13,-,87000,41751
107,91,16,-,143500,41754
98,67,31,-,70600,41759
5,5,0,-,-,41760
0,0,0,-,-,41762
268,161,107,541,38100,41763
264,206,58,-,61700,41764
70,70,0,-,55600,41766
96,82,14,-,-,41772
623,470,153,606,40700,41773
964,745,219,652,64700,41774
25,20,5,-,-,41775
471,408,63,518,62200,41776
356,290,66,623,59700,41777
213,207,6,400,110400,41804
189,160,29,-,50000,41810
140,125,15,-,62400,41812
404,319,85,-,51000,41815
112,86,26,-,83200,41817
178,161,17,-,53800,41819
166,148,18,-,61800,41821
842,594,248,369,49800,41822
576,330,246,507,39300,41824
285,148,137,-,54300,41825
320,312,8,-,61700,41826
328,258,70,432,82700,41828
407,303,104,517,69000,41831
153,131,22,-,79200,41832
225,137,88,-,46700,41833
154,124,30,-,76900,41834
340,296,44,-,53600,41835
479,322,157,577,41300,41836
507,430,77,664,58500,41837
218,200,18,-,64500,41838
592,400,192,591,52400,41839
392,274,118,610,43500,41840
337,244,93,-,44800,41843
458,247,211,317,39300,41844
118,97,21,-,-,41845
225,206,19,-,33000,41847
0,0,0,-,-,41848
31,31,0,-,-,41849
313,257,56,-,87900,41855
3244,2311,933,541,74900,41858
186,131,55,-,67200,41859
40,25,15,-,"10,000-",41861
377,341,36,-,58300,41862
12674,8079,4595,755,156400,42001
11972,7642,4330,651,117000,42003
758,744,14,-,135800,42020
677,476,201,638,75100,42021
93,93,0,-,259700,42022
918,737,181,609,94400,42023
503,348,155,485,97900,42024
8165,6506,1659,637,127600,42025
798,678,120,614,143100,42027
258,225,33,-,100700,42028
2585,1960,625,706,115100,42029
1140,932,208,482,75100,42031
82,54,28,927,53300,42032
412,348,64,648,104300,42035
504,488,16,-,128600,42036
34,29,5,-,-,42037
2031,1528,503,544,142200,42038
753,621,132,-,104200,42039
314,265,49,836,125700,42040
1903,1187,716,544,73300,42041
1597,1288,309,687,138900,42044
920,674,246,664,97300,42045
143,82,61,-,-,42047
857,642,215,831,105500,42048
576,476,100,630,110800,42049
1108,696,412,527,50900,42050
1349,1161,188,687,87000,42051
2127,1872,255,791,127200,42053
320,315,5,-,151900,42054
1091,1030,61,640,103000,42055
666,512,154,538,112700,42056
951,848,103,-,126300,42058
0,0,0,-,-,42060
26,26,0,-,-,42061
3304,2698,606,518,89600,42064
9195,6145,3050,650,101900,42066
197,197,0,-,102200,42069
11943,6739,5204,676,138200,42071
474,397,77,482,127500,42076
721,557,164,-,76200,42078
572,527,45,-,108400,42079
938,664,274,447,105200,42081
637,536,101,800,128600,42082
134,89,45,-,-,42083
38,9,29,-,-,42084
373,327,46,565,81300,42085
1709,1275,434,595,147000,42086
894,715,179,650,69900,42087
969,794,175,691,75600,42088
21179,9999,11180,747,117300,42101
43,8,35,-,-,42102
8426,5435,2991,803,216800,42103
13468,8525,4943,793,185800,42104
962,643,319,614,81300,42120
1865,1732,133,950,188500,42122
242,226,16,-,128100,42123
9,9,0,-,-,42124
2605,1666,939,586,101300,42127
2837,2107,730,468,83100,42129
111,80,31,-,-,42130
626,504,122,655,113500,42133
6638,4192,2446,809,131400,42134
395,298,97,650,74700,42140
12279,8028,4251,690,121300,42141
82,63,19,-,-,42151
137,86,51,782,-,42153
178,148,30,686,111400,42154
117,100,17,-,140900,42156
149,120,29,563,62300,42157
719,598,121,621,168600,42159
674,525,149,777,80600,42160
47,0,47,-,-,42163
6236,4537,1699,658,115300,42164
960,814,146,596,74900,42166
3454,2435,1019,511,75800,42167
583,519,64,741,118100,42170
2600,2071,529,674,120900,42171
948,671,277,631,94200,42202
242,162,80,837,110500,42204
2118,1573,545,674,110800,42206
578,491,87,566,78300,42207
1845,1462,383,620,86700,42210
5595,4579,1016,644,126800,42211
236,189,47,641,143300,42214
429,377,52,727,116100,42215
1334,1047,287,721,78500,42217
2548,1857,691,609,97300,42220
4559,16,4543,1317,-,42223
299,265,34,-,113600,42232
1056,591,465,567,120000,42234
262,202,60,822,111900,42236
16577,8871,7706,712,117900,42240
118,76,42,719,67700,42254
1771,1459,312,692,98100,42256
429,373,56,568,89600,42259
4204,3030,1174,516,89500,42261
3086,805,2281,868,110300,42262
275,186,89,532,169100,42265
789,620,169,607,140700,42266
212,148,64,493,109800,42273
934,714,220,573,140200,42274
259,171,88,940,75000,42275
5898,3743,2155,640,109200,42276
140,110,30,-,88700,42280
115,92,23,-,-,42285
437,265,172,755,127600,42286
18273,11215,7058,726,127600,42301
15777,10315,5462,741,125200,42303
3360,2284,1076,543,91200,42320
73,65,8,-,-,42321
11,11,0,-,-,42322
307,238,69,774,73200,42323
408,378,30,370,74700,42324
859,680,179,557,80800,42325
156,156,0,-,81800,42326
1550,1288,262,684,111200,42327
519,446,73,694,81900,42328
3347,2442,905,567,82700,42330
87,66,21,-,"10,000-",42332
473,346,127,-,100700,42333
777,665,112,615,63000,42337
11,11,0,-,-,42338
316,310,6,-,74400,42339
621,450,171,561,86300,42343
289,238,51,-,67200,42344
4068,3149,919,555,106200,42345
2320,1745,575,541,103400,42347
1837,1486,351,598,126800,42348
459,382,77,575,80600,42349
608,510,98,604,88200,42350
1623,1232,391,667,98700,42351
888,643,245,415,89500,42352
81,70,11,546,59000,42354
762,707,55,623,123400,42355
0,0,0,-,-,42356
188,161,27,-,88000,42361
2123,1892,231,842,175500,42366
314,237,77,661,77400,42367
487,453,34,-,79600,42368
93,78,15,625,62700,42369
0,0,0,-,-,42370
162,154,8,-,123100,42371
709,570,139,549,90700,42372
141,124,17,-,152100,42374
2228,1875,353,763,119900,42376
1128,981,147,640,137600,42378
1065,831,234,532,82400,42404
1266,941,325,628,136700,42406
2710,1960,750,497,60200,42408
917,713,204,502,87100,42409
587,326,261,734,46900,42410
684,560,124,615,90000,42411
1237,1114,123,1014,160100,42413
15411,8837,6574,667,128200,42420
10601,6660,3941,730,121900,42431
399,311,88,-,139100,42436
2911,1962,949,612,103200,42437
370,291,79,709,45000,42440
642,462,180,604,104500,42441
1281,995,286,585,100400,42442
4449,3330,1119,530,92500,42445
1600,1112,488,494,54300,42450
352,276,76,-,73500,42451
925,770,155,821,142900,42452
230,190,40,814,71300,42453
1057,695,362,702,95700,42455
630,517,113,482,89500,42456
454,376,78,-,110800,42458
1699,1199,500,505,79500,42459
523,336,187,662,54100,42461
433,355,78,840,89000,42462
33,33,0,-,29200,42463
648,551,97,554,92300,42464
7143,4159,2984,620,87600,42501
9201,6751,2450,688,138200,42503
181,160,21,-,38800,42516
1135,869,266,826,97500,42518
1480,1104,376,609,63000,42519
563,428,135,459,70700,42528
309,178,131,770,89000,42533
3953,2979,974,505,83200,42539
289,282,7,-,50800,42541
2280,1783,497,658,101400,42544
2102,1520,582,529,120500,42553
231,162,69,-,56400,42565
205,174,31,-,104100,42566
2448,1677,771,848,90600,42567
3806,2672,1134,478,66200,42602
13,5,8,-,-,42603
2122,1673,449,483,104100,42629
63,0,63,-,-,42631
7745,5511,2234,541,80100,42633
598,482,116,418,65800,42634
1237,849,388,543,63700,42635
0,0,0,-,-,42638
4910,3531,1379,553,81600,42642
1287,970,317,598,59300,42647
972,752,220,587,68900,42649
1999,1266,733,554,65000,42653
20301,12759,7542,779,169800,42701
546,402,144,635,125300,42712
782,592,190,517,94300,42713
104,104,0,-,90000,42715
603,516,87,778,119600,42716
2747,1992,755,385,91800,42717
9659,6142,3517,621,118400,42718
1340,1068,272,610,105900,42721
217,206,11,-,120800,42722
1821,1561,260,808,154400,42724
1856,1399,457,614,107800,42726
6146,4624,1522,530,92800,42728
595,377,218,721,116800,42729
43,43,0,-,67900,42731
701,513,188,801,96700,42732
424,330,94,-,104000,42733
821,693,128,846,136000,42740
133,114,19,-,106800,42741
3677,2682,995,529,77200,42743
681,533,148,485,75900,42746
3469,2504,965,697,105400,42748
2058,1405,653,448,89900,42749
267,210,57,618,65000,42753
6157,4130,2027,563,102800,42754
1142,895,247,729,88900,42757
38,30,8,-,74300,42758
51,44,7,-,-,42762
270,206,64,523,81100,42764
2404,1774,630,492,94100,42765
880,695,185,624,115400,42776
417,354,63,618,90900,42782
962,734,228,697,97300,42784
98,80,18,-,163800,42788
1029,892,137,1500,194200,43001
2137,1454,683,1226,166200,43002
1014,725,289,792,137500,43003
9774,7346,2428,978,177600,43004
75,75,0,-,189400,43005
257,215,42,878,127500,43006
1045,703,342,704,102200,43008
834,675,159,1021,204700,43009
94,69,25,880,105200,43010
2878,2325,553,712,192600,43011
322,278,44,725,148900,43013
1284,887,397,662,152600,43014
19854,13864,5990,933,198800,43015
14954,8238,6716,1167,288200,43016
14929,10510,4419,1188,340600,43017
3179,2651,528,705,144400,43019
3940,3697,243,1214,369200,43021
1102,806,296,889,217700,43022
4041,3440,601,1050,299000,43023
2088,1616,472,676,181000,43025
23420,16573,6847,1031,209200,43026
3162,2692,470,959,147300,43028
179,144,35,559,166300,43029
57,57,0,-,-,43030
5081,4030,1051,905,207600,43031
9,9,0,-,-,43032
113,78,35,675,101100,43033
8783,7054,1729,1098,310300,43035
120,72,48,625,84200,43036
120,70,50,761,76700,43037
11903,8417,3486,955,192300,43040
1859,1408,451,809,127100,43044
693,578,115,990,170200,43045
1487,1154,333,868,174300,43046
11764,7702,4062,734,130000,43050
9924,6933,2991,1311,343800,43054
24572,15010,9562,745,129300,43055
7101,5527,1574,883,149000,43056
1002,781,221,822,132500,43060
1594,1459,135,1049,263400,43061
10427,8400,2027,1072,188500,43062
4926,4227,699,899,252300,43064
14801,13460,1341,1125,331500,43065
552,522,30,810,209300,43066
564,539,25,1350,176900,43067
21201,12499,8702,958,144700,43068
61,61,0,-,61500,43070
741,617,124,836,173600,43071
2234,1812,422,681,118300,43072
4531,3727,804,1131,255800,43074
3498,2870,628,841,158100,43076
146,88,58,735,114300,43077
8310,5523,2787,675,125900,43078
1736,1363,373,650,155700,43080
24234,15396,8838,1105,197800,43081
11792,10633,1159,1254,309100,43082
246,216,30,794,123000,43084
10363,7270,3093,1141,247500,43085
120,87,33,663,82100,43101
1652,1269,383,840,167300,43102
3847,3149,698,769,167000,43103
2871,2413,458,930,185700,43105
654,436,218,774,85700,43106
1152,902,250,880,131700,43107
34,28,6,-,93800,43109
14465,8660,5805,981,166900,43110
121,121,0,-,92200,43111
1645,1425,220,787,240400,43112
9398,6367,3031,783,149000,43113
582,410,172,598,154300,43115
502,447,55,1079,188000,43116
59,34,25,-,101400,43117
10299,7139,3160,958,149300,43119
24779,18044,6735,994,161100,43123
5541,3290,2251,962,152300,43125
187,126,61,1170,114100,43126
96,55,41,-,108600,43127
992,612,380,724,87200,43128
23476,15370,8106,802,143000,43130
1721,1320,401,527,127100,43135
273,196,77,875,208800,43136
930,776,154,830,125700,43137
7201,5100,2101,600,124000,43138
7743,5239,2504,808,160300,43140
56,28,28,719,52900,43142
2183,1504,679,707,149600,43143
176,122,54,498,63400,43144
841,613,228,788,123600,43145
3109,2736,373,893,193500,43146
13946,11592,2354,1173,212200,43147
805,570,235,713,155200,43148
931,847,84,793,164900,43149
818,665,153,703,141600,43150
106,71,35,870,92900,43151
350,238,112,659,87100,43152
347,270,77,696,153400,43153
1202,891,311,895,153000,43154
959,781,178,855,150100,43155
70,60,10,-,94000,43156
209,138,71,1014,103200,43157
118,118,0,-,67000,43158
9056,5440,3616,705,112800,43160
2679,2037,642,760,140600,43162
786,567,219,821,133100,43164
12412,2122,10290,983,240700,43201
9445,2778,6667,938,208300,43202
3571,959,2612,703,89400,43203
16548,7789,8759,883,103500,43204
5400,1995,3405,699,136000,43205
10182,4771,5411,947,150200,43206
17792,10319,7473,858,87500,43207
11808,6709,5099,859,244300,43209
335,0,335,623,-,43210
8443,3300,5143,819,54200,43211
11313,4025,7288,1047,335700,43212
13919,4835,9084,845,109000,43213
12347,7739,4608,959,245500,43214
9188,1797,7391,1149,272400,43215
751,39,712,895,28900,43217
11555,5450,6105,884,95300,43219
11710,6537,5173,999,305500,43220
13568,10046,3522,1192,275100,43221
1413,393,1020,680,64300,43222
8526,3820,4706,767,74600,43223
17312,7923,9389,754,87600,43224
9463,4534,4929,841,79300,43227
21369,9791,11578,864,121500,43228
20861,8470,12391,828,127100,43229
23542,14703,8839,1076,183300,43230
7908,3791,4117,944,139400,43231
18748,7383,11365,810,97200,43232
18177,10446,7731,1092,229600,43235
1982,613,1369,1190,193900,43240
20215,12988,7227,720,89100,43302
1097,921,176,834,122400,43310
7595,4805,2790,774,119800,43311
1145,1019,126,811,137300,43314
2635,2055,580,718,137100,43315
2388,1742,646,598,118400,43316
46,32,14,843,-,43317
1557,1290,267,744,135300,43318
412,412,0,-,181000,43319
632,503,129,820,113100,43320
107,88,19,725,113700,43321
140,109,31,718,84500,43322
306,272,34,675,128200,43323
1276,1097,179,781,157000,43324
5371,3816,1555,609,95500,43326
47,27,20,609,67500,43330
2247,1791,456,706,103000,43331
720,564,156,608,92800,43332
229,168,61,-,-,43333
2189,1859,330,908,159200,43334
0,0,0,-,-,43336
497,466,31,1292,113300,43337
3741,2897,844,584,154900,43338
646,518,128,729,121700,43340
377,308,69,847,83300,43341
1107,965,142,836,134800,43342
458,349,109,542,130300,43343
2189,1806,383,826,141600,43344
301,247,54,761,140900,43345
580,496,84,771,120700,43347
879,574,305,581,104100,43348
4155,2770,1385,617,116700,43351
591,454,137,738,135200,43356
1616,1270,346,596,160700,43357
1061,898,163,732,118600,43358
334,275,59,548,114600,43359
652,514,138,763,186900,43360
13584,6237,7347,697,175200,43402
5,0,5,-,-,43403
735,577,158,837,108300,43406
266,262,4,-,116900,43407
97,88,9,775,85300,43408
3956,2856,1100,728,111600,43410
1725,1484,241,1087,159800,43412
515,454,61,855,106500,43413
1261,979,282,657,136300,43416
12435,8279,4156,675,110100,43420
1694,1305,389,722,121000,43430
1750,1386,364,773,114600,43431
525,508,17,-,161400,43432
47,47,0,-,104000,43433
24,22,2,-,66700,43434
481,429,52,625,121600,43435
187,119,68,820,107000,43437
103,99,4,-,298900,43438
44,44,0,-,63900,43439
2516,2054,462,810,186800,43440
435,330,105,861,112100,43442
756,623,133,740,154900,43443
521,494,27,-,140000,43445
47,46,1,-,250000,43446
1322,1208,114,781,138900,43447
3265,2477,788,769,141000,43449
1435,1054,381,792,167300,43450
434,325,109,925,147100,43451
6278,4611,1667,646,150900,43452
141,115,26,950,420600,43456
560,442,118,729,104700,43457
189,152,37,618,92000,43458
2683,2076,607,685,128900,43460
473,373,100,843,110300,43462
9,0,9,-,-,43463
491,389,102,-,93600,43464
2401,1789,612,722,113100,43465
837,660,177,829,116400,43466
31,20,11,-,70000,43467
120,108,12,-,94300,43468
1146,901,245,710,141900,43469
318,236,82,675,107600,43501
2515,1815,700,665,146800,43502
473,437,36,980,154800,43504
31,20,11,583,103600,43505
6261,4592,1669,702,100300,43506
455,404,51,1274,134300,43511
11319,8374,2945,696,119700,43512
3244,2726,518,661,132900,43515
1087,759,328,856,105700,43516
1619,1335,284,641,112100,43517
1020,887,133,702,118900,43518
107,68,39,726,84300,43519
1115,797,318,646,90600,43521
1319,1161,158,783,162900,43522
10,10,0,-,-,43523
537,425,112,592,99200,43524
387,345,42,954,168200,43525
2340,1954,386,738,107900,43526
779,657,122,627,95200,43527
6264,4675,1589,914,186400,43528
105,78,27,838,50000,43529
142,65,77,-,105600,43531
1473,1264,209,778,140700,43532
675,522,153,588,139200,43533
688,573,115,639,89700,43534
278,241,37,821,121000,43535
64,64,0,-,205800,43536
11283,8289,2994,789,168500,43537
560,415,145,541,131300,43540
50,50,0,-,86700,43541
1417,1308,109,-,267000,43542
3243,2604,639,648,88900,43543
5859,4265,1594,671,132000,43545
71,57,14,-,-,43547
258,228,30,586,105000,43548
509,426,83,590,119600,43549
15859,10654,5205,974,203100,43551
65,50,15,-,103100,43553
1005,666,339,784,94500,43554
113,92,21,-,100000,43555
667,552,115,660,108500,43556
949,803,146,734,122300,43557
5235,4591,644,791,147900,43558
12204,9726,2478,844,193300,43560
193,136,57,903,134200,43565
3097,2644,453,1126,192600,43566
5018,3602,1416,759,136400,43567
1094,918,176,630,116600,43569
1288,948,340,647,99500,43570
2697,2267,430,819,213600,43571
4378,629,3749,390,34800,43604
10278,4553,5725,663,39800,43605
9963,5219,4744,747,121800,43606
8964,4360,4604,696,57000,43607
4999,2602,2397,726,39800,43608
8736,3831,4905,690,48600,43609
1708,863,845,724,50100,43610
7907,5122,2785,714,82200,43611
12009,6607,5402,776,67500,43612
13833,8773,5060,762,93800,43613
14420,7989,6431,719,118400,43614
17922,9541,8381,767,100200,43615
8549,6012,2537,667,142600,43616
2737,2370,367,904,208600,43617
2886,2240,646,779,136400,43619
2562,773,1789,516,89500,43620
9127,5574,3553,693,127400,43623
23016,14474,8542,684,111300,43701
28,6,22,-,-,43711
2657,2210,447,484,102200,43713
763,638,125,578,93100,43716
92,81,11,613,68900,43717
1171,954,217,635,114100,43718
1076,857,219,651,108000,43719
533,468,65,909,114100,43720
28,0,28,-,-,43721
124,115,9,-,59800,43722
2075,1308,767,640,82100,43723
2801,2232,569,634,96500,43724
8212,5459,2753,660,108600,43725
443,402,41,-,91300,43727
561,432,129,607,89200,43728
834,761,73,581,102600,43730
2081,1471,610,572,79600,43731
664,564,100,425,115600,43732
0,0,0,-,-,43733
629,496,133,681,127500,43734
172,105,67,522,73200,43735
21,20,1,-,90000,43736
36,21,15,632,81500,43738
800,669,131,773,151100,43739
103,79,24,867,104600,43740
529,429,100,-,126200,43746
424,330,94,942,89000,43747
1006,762,244,594,111600,43748
1002,831,171,-,113600,43749
73,73,0,-,-,43750
599,447,152,442,114900,43754
721,570,151,1087,108900,43755
2235,1531,704,588,94100,43756
1223,979,244,711,100500,43758
32,19,13,625,33800,43759
687,521,166,1017,159200,43760
26,26,0,-,-,43761
1741,1259,482,765,159200,43762
3234,2074,1160,595,90600,43764
599,461,138,610,71300,43766
367,347,20,-,134200,43767
134,61,73,1054,85900,43768
659,549,110,720,89900,43771
808,675,133,683,91700,43772
1352,1080,272,635,122800,43773
1847,1440,407,498,77000,43777
410,361,49,676,108100,43778
396,332,64,850,95800,43779
830,739,91,545,122700,43780
218,165,53,744,57000,43782
1798,1506,292,745,146900,43783
16,12,4,-,-,43786
1254,1029,225,576,95100,43787
245,202,43,541,145800,43788
2237,1526,711,572,89600,43793
310,292,18,850,112900,43802
971,683,288,643,189400,43804
46,8,38,-,-,43805
328,261,67,656,80200,43811
7904,5251,2653,584,90700,43812
1600,1326,274,608,134400,43821
1891,1460,431,749,136400,43822
1292,1092,200,723,147700,43824
2336,1739,597,670,161300,43830
2988,2231,757,716,88600,43832
51,45,6,-,76300,43836
617,547,70,699,93600,43837
475,413,62,867,121500,43840
180,119,61,524,-,43842
416,350,66,574,171300,43843
1466,1206,260,731,115600,43844
1800,1420,380,617,86400,43845
817,666,151,945,84000,43901
27,13,14,-,-,43902
820,667,153,534,108000,43903
56,19,37,-,-,43905
3437,2305,1132,638,88300,43906
2358,1793,565,600,92100,43907
609,482,127,745,92000,43908
1282,1170,112,786,138400,43910
2731,1917,814,581,83900,43912
616,339,277,641,68900,43913
50,43,7,-,101600,43914
510,441,69,574,117500,43915
1489,1333,156,614,79900,43917
9210,6009,3201,613,79300,43920
114,13,101,-,-,43925
104,74,30,490,60000,43926
42,42,0,-,61600,43927
9,9,0,-,-,43928
312,209,103,645,99300,43930
142,114,28,-,150700,43931
337,287,50,625,89700,43932
736,675,61,-,90100,43933
198,180,18,-,65200,43934
3649,2460,1189,610,79300,43935
2295,1873,422,620,78500,43938
170,151,19,960,83800,43939
59,52,7,-,115000,43940
1127,925,202,448,95800,43942
1276,1044,232,545,90100,43943
871,698,173,827,99600,43944
1229,886,343,608,106300,43945
935,737,198,678,119300,43946
2081,1646,435,665,96500,43947
187,156,31,421,76000,43948
5267,4277,990,757,154100,43950
32,32,0,-,-,43951
7207,3876,3331,618,82800,43952
4813,3323,1490,737,114900,43953
168,99,69,668,65000,43961
32,27,5,-,78300,43962
600,344,256,635,85800,43963
3811,2685,1126,585,94400,43964
0,0,0,-,-,43967
2671,1849,822,584,73300,43968
25,25,0,-,-,43970
487,275,212,580,77700,43971
47,47,0,-,219300,43972
942,755,187,590,89700,43973
35,33,2,-,83100,43974
634,527,107,723,94900,43976
875,682,193,797,72800,43977
212,122,90,599,76300,43983
35,23,12,-,75000,43985
849,658,191,709,90500,43986
998,744,254,656,95200,43988
8513,7027,1486,886,153700,44001
1695,1202,493,645,87800,44003
13151,7935,5216,680,88100,44004
595,417,178,1282,158800,44010
7957,6637,1320,1177,282100,44011
9389,7723,1666,1188,243600,44012
7167,4935,2232,807,134700,44017
2327,1749,578,870,174200,44021
6877,6005,872,1338,356600,44022
6590,6117,473,1100,298800,44023
9262,7645,1617,742,228200,44024
4438,4191,247,1085,224300,44026
3352,3110,242,963,196400,44028
5904,4297,1607,669,95700,44030
501,456,45,806,94400,44032
26864,16412,10452,748,104100,44035
12609,10898,1711,1060,170500,44039
1140,1101,39,-,452600,44040
6011,4104,1907,664,119700,44041
4433,3838,595,850,173600,44044
193,118,75,962,131700,44045
827,672,155,729,188600,44046
3424,2833,591,640,130700,44047
853,629,224,611,109200,44048
88,70,18,758,95400,44049
2348,1948,400,761,165700,44050
11571,6224,5347,685,75300,44052
7985,5258,2727,682,131900,44053
5004,4034,970,948,125700,44054
7488,3656,3832,722,64600,44055
4647,4282,365,879,207200,44056
7357,5686,1671,886,134500,44057
25194,20894,4300,916,169400,44060
3940,2957,983,668,169700,44062
689,619,70,1163,198500,44064
1735,1443,292,896,198100,44065
8204,6878,1326,991,188400,44067
12987,9721,3266,901,151500,44070
1808,1587,221,1013,262300,44072
3876,2543,1333,815,169800,44074
1655,1119,536,719,141000,44076
22099,15790,6309,842,160500,44077
82,44,38,-,115700,44080
2569,2291,278,880,173500,44081
578,464,114,627,148500,44082
1231,1078,153,855,132500,44084
1166,998,168,888,143000,44085
959,849,110,820,174600,44086
8496,6263,2233,1090,214800,44087
6563,5015,1548,932,148000,44089
4720,3417,1303,729,166700,44090
7739,5425,2314,838,126600,44092
418,390,28,938,130600,44093
16280,10461,5819,921,183200,44094
14429,10610,3819,849,122000,44095
740,709,31,-,176300,44099
0,0,0,-,-,44101
19094,6373,12721,716,68000,44102
7198,2255,4943,577,50600,44103
8741,2510,6231,459,46500,44104
15349,7323,8026,735,49300,44105
10995,3222,7773,750,161400,44106
24746,10868,13878,762,147900,44107
9498,4309,5189,682,57400,44108
17411,8053,9358,701,75100,44109
9018,3273,5745,661,53600,44110
17672,10011,7661,748,86500,44111
9825,3861,5964,646,61200,44112
9441,2409,7032,863,176600,44113
3858,226,3632,876,63500,44114
3966,319,3647,571,100800,44115
9183,6612,2571,890,233700,44116
4942,1982,2960,677,92000,44117
15428,9130,6298,951,147800,44118
5675,2969,2706,790,80200,44119
15902,6972,8930,765,91100,44120
13785,8945,4840,896,96500,44121
13259,8553,4706,1203,236000,44122
7932,4212,3720,780,76300,44123
17220,11439,5781,952,152700,44124
11582,7569,4013,927,75200,44125
7126,5236,1890,768,155100,44126
1829,628,1201,637,33900,44127
12687,6493,6194,821,66300,44128
11665,8047,3618,828,107500,44129
22238,14149,8089,807,127600,44130
8325,7699,626,1139,181900,44131
6638,2907,3731,836,82900,44132
12623,9180,3443,911,199300,44133
15875,12172,3703,870,109700,44134
11787,7041,4746,703,78800,44135
10329,7615,2714,959,200400,44136
9485,5550,3935,918,68000,44137
9337,7553,1784,999,156800,44138
8784,7295,1489,1271,279600,44139
6078,5584,494,985,230400,44140
5572,4723,849,1575,266900,44141
7535,5812,1723,899,114100,44142
10772,7703,3069,811,191000,44143
9629,5607,4022,728,90100,44144
13694,10024,3670,1126,250900,44145
13942,7589,6353,822,106200,44146
7483,6248,1235,840,229200,44147
7499,6894,605,1135,205500,44149
2520,2064,456,964,168500,44201
7803,6558,1245,1492,248300,44202
16646,11456,5190,760,105000,44203
16865,13533,3332,879,172700,44212
800,716,84,563,172200,44214
899,720,179,874,150200,44215
3566,3290,276,809,155400,44216
1451,1226,225,768,133000,44217
13155,7457,5698,820,112200,44221
7631,5854,1777,788,148500,44223
16363,10920,5443,989,177500,44224
3514,3065,449,808,147400,44230
3624,3046,578,717,145700,44231
2923,2923,0,-,312500,44233
1302,1157,145,731,180800,44234
583,483,100,-,211500,44235
9212,8091,1121,1869,322700,44236
16173,8275,7898,807,155500,44240
6761,4810,1951,1102,145400,44241
0,0,0,-,-,44243
504,370,134,833,102800,44250
399,361,38,1075,227100,44251
1044,941,103,955,209000,44253
2083,1441,642,628,140700,44254
3000,2298,702,801,156700,44255
24276,19298,4978,872,204900,44256
4903,3999,904,824,150700,44260
2013,1596,417,738,156800,44262
1176,929,247,996,245600,44264
0,0,0,-,-,44265
13446,9478,3968,783,121100,44266
3358,2217,1141,729,128400,44270
1952,1536,416,949,167100,44272
2886,2433,453,732,173900,44273
89,89,0,-,177300,44274
1249,1043,206,804,161100,44275
604,516,88,671,146900,44276
7195,5650,1545,766,165000,44278
1767,1560,207,1434,272900,44280
12625,9741,2884,869,177700,44281
11,11,0,-,-,44285
2386,2178,208,974,296200,44286
2749,2313,436,715,123100,44287
1390,832,558,790,105500,44288
6228,3671,2557,827,77400,44301
2546,935,1611,610,87600,44302
3547,1946,1601,726,160400,44303
1474,154,1320,771,83800,44304
9548,5486,4062,752,71500,44305
8922,4005,4917,708,62700,44306
3145,864,2281,624,62400,44307
268,8,260,619,-,44308
10301,4066,6235,737,66700,44310
2861,623,2238,670,43400,44311
13518,9933,3585,789,97800,44312
11905,6877,5028,811,155400,44313
8189,4342,3847,732,63500,44314
9697,7242,2455,840,145100,44319
8836,4984,3852,704,76800,44320
6268,4572,1696,994,223300,44321
7421,5901,1520,1285,240500,44333
1191,1041,150,855,163800,44401
1312,1083,229,593,150400,44402
1745,1512,233,649,115700,44403
576,497,79,620,106000,44404
3364,2175,1189,651,61200,44405
8787,7577,1210,689,193100,44406
4326,3222,1104,622,146000,44408
7495,6081,1414,752,137700,44410
760,643,117,958,152500,44411
1005,799,206,638,168200,44412
2921,2368,553,835,90400,44413
657,550,107,710,116500,44417
550,488,62,518,126100,44418
6768,4660,2108,594,92900,44420
962,764,198,681,124300,44423
6233,4901,1332,640,103000,44425
475,415,60,728,109100,44427
1279,1116,163,628,119400,44428
1174,849,325,766,121600,44429
1461,1093,368,681,81400,44430
1816,1513,303,784,103300,44431
4413,3245,1168,679,104500,44432
1478,1219,259,630,104800,44436
1919,1591,328,715,94800,44437
1883,1295,588,635,60900,44438
76,24,52,942,-,44439
1999,1563,436,644,131400,44440
637,606,31,-,125000,44441
1638,1401,237,589,134500,44442
595,595,0,-,159100,44443
4225,2927,1298,679,111600,44444
1479,1162,317,675,126100,44445
8909,4997,3912,670,83400,44446
541,455,86,-,155100,44449
689,553,136,715,117700,44450
1247,951,296,603,162900,44451
1251,934,317,685,163600,44452
348,291,57,-,96900,44454
716,672,44,649,120600,44455
10563,7562,3001,657,122400,44460
1471,1335,136,792,139800,44470
4334,3185,1149,727,72400,44471
1513,1190,323,914,131600,44473
4006,3417,589,620,118300,44481
10864,6675,4189,684,85800,44483
9703,6831,2872,667,124800,44484
7012,3735,3277,649,50900,44485
380,228,152,708,77200,44490
984,930,54,725,149200,44491
15,15,0,-,-,44493
3941,2149,1792,754,31300,44502
543,0,543,244,-,44503
1925,906,1019,706,67700,44504
7672,4440,3232,581,71800,44505
1065,739,326,660,16900,44506
2076,929,1147,632,23400,44507
5175,2930,2245,672,46500,44509
936,407,529,646,-,44510
8961,6314,2647,652,80200,44511
14614,9632,4982,677,116100,44512
9619,7876,1743,858,144800,44514
11876,7307,4569,684,99000,44515
13921,8832,5089,706,102700,44601
2219,1701,518,648,183700,44606
69,69,0,-,108000,44607
885,646,239,708,108100,44608
1574,1364,210,639,129700,44609
59,59,0,-,253900,44610
717,645,72,490,142100,44611
2152,1579,573,759,162100,44612
745,516,229,716,96900,44613
5031,3905,1126,790,155900,44614
4079,3054,1025,695,134300,44615
2318,1745,573,693,168600,44618
662,587,75,748,154100,44620
1818,1184,634,698,87600,44621
7290,5013,2277,823,137800,44622
1358,1209,149,525,182700,44624
645,492,153,720,171700,44625
1155,932,223,799,116700,44626
1518,1256,262,408,241900,44627
398,347,51,625,112800,44628
1012,778,234,710,115200,44629
3640,2757,883,754,176500,44632
823,711,112,647,227900,44633
910,712,198,669,152700,44634
1141,828,313,676,149400,44637
536,362,174,574,165900,44638
88,64,24,775,78900,44640
8223,6235,1988,737,145800,44641
1318,1089,229,709,133400,44643
2130,1589,541,689,141400,44644
892,709,183,839,146300,44645
18928,13180,5748,714,132300,44646
7657,5714,1943,722,110500,44647
277,221,56,-,119400,44651
16,16,0,-,-,44652
230,160,70,832,83300,44653
6010,4375,1635,665,206200,44654
1259,1074,185,659,117800,44656
3956,2838,1118,677,113700,44657
50,41,9,-,110200,44659
55,49,6,1125,86900,44661
3570,2952,618,685,122300,44662
10273,6560,3713,764,128400,44663
1022,866,156,813,158300,44666
5311,3794,1517,756,132400,44667
527,471,56,895,141200,44669
62,62,0,-,85600,44670
128,108,20,-,-,44671
1958,1135,823,600,82700,44672
889,737,152,1056,110500,44675
1656,1333,323,609,123900,44676
969,707,262,773,138500,44677
134,77,57,-,110000,44678
1812,1320,492,827,156000,44680
2464,1825,639,680,200300,44681
414,293,121,636,87500,44682
3373,2355,1018,688,78800,44683
10189,8492,1697,840,180000,44685
13,7,6,-,-,44687
1178,916,262,645,107300,44688
229,171,58,727,114800,44689
71,51,20,-,162500,44690
18065,12164,5901,722,147200,44691
19,19,0,-,58300,44693
633,542,91,425,111800,44695
100,89,11,675,229000,44697
369,295,74,572,108400,44699
537,7,530,284,-,44702
3738,1268,2470,691,56200,44703
1550,731,819,542,58600,44704
7279,4046,3233,629,65500,44705
7155,5202,1953,750,97600,44706
3736,1853,1883,480,77500,44707
10917,7245,3672,851,118900,44708
8481,4994,3487,676,114000,44709
4066,2215,1851,752,74800,44710
4010,2395,1615,720,98300,44714
5301,3532,1769,768,216700,44718
15960,11370,4590,835,168200,44720
5583,4664,919,772,163900,44721
2391,2057,334,827,110600,44730
365,304,61,627,152700,44802
426,311,115,496,112300,44804
12704,8479,4225,739,123100,44805
890,693,197,643,89900,44807
163,116,47,782,99200,44809
5026,3669,1357,660,114800,44811
3363,2734,629,697,133300,44813
1016,896,120,743,160800,44814
294,240,54,582,79400,44815
16,16,0,-,-,44816
530,458,72,654,123300,44817
952,759,193,574,92700,44818
7498,5140,2358,666,92600,44820
1014,827,187,612,133500,44822
1475,1234,241,688,152700,44824
37,34,3,-,71900,44825
686,597,89,-,134600,44826
2996,2142,854,646,91100,44827
20,13,7,-,-,44828
7819,5519,2300,628,78900,44830
6969,5017,1952,603,83800,44833
923,721,202,744,103400,44836
1531,1215,316,700,116500,44837
100,86,14,642,95000,44838
5370,4076,1294,822,175500,44839
962,800,162,815,152600,44840
247,214,33,689,83300,44841
2178,1474,704,646,116900,44842
851,694,157,747,139100,44843
209,164,45,747,102500,44844
1191,970,221,858,160300,44846
1343,1057,286,694,127300,44847
950,714,236,801,98400,44849
22,15,7,-,-,44850
1804,1367,437,646,107800,44851
536,449,87,583,156100,44853
678,494,184,742,93500,44854
451,364,87,649,123100,44855
135,123,12,975,102300,44856
9540,6386,3154,700,132900,44857
676,570,106,728,122900,44859
31,31,0,-,61400,44861
1396,1145,251,527,128700,44864
1098,782,316,689,95100,44865
717,586,131,1021,159900,44866
917,811,106,867,115000,44867
16833,10199,6634,694,106400,44870
114,93,21,775,82200,44874
5819,3904,1915,691,104400,44875
965,788,177,825,146600,44878
1010,979,31,-,124600,44880
0,0,0,-,-,44881
1180,1008,172,705,103000,44882
10915,7522,3393,704,111200,44883
335,275,60,638,103400,44887
2736,2320,416,746,167800,44889
4268,2952,1316,660,106200,44890
0,0,0,-,-,44901
1792,765,1027,516,44600,44902
9451,6790,2661,707,116600,44903
5660,4057,1603,676,146600,44904
4742,3475,1267,689,78500,44905
7232,4383,2849,676,85900,44906
6729,3737,2992,632,88300,44907
285,115,170,699,82500,45001
5128,3805,1323,815,216400,45002
213,148,65,939,99400,45003
12396,8703,3693,802,136100,45005
24610,17627,6983,853,177500,45011
21059,14986,6073,807,148100,45013
17208,10755,6453,884,150400,45014
4607,2838,1769,823,89100,45015
7625,6156,1469,786,148800,45030
134,82,52,731,104500,45032
108,99,9,-,56500,45033
483,409,74,1329,248800,45034
12000,8318,3682,845,205600,45036
9125,7356,1769,1224,207100,45039
19867,15719,4148,1331,256500,45040
17,0,17,-,-,45041
10564,7714,2850,879,135300,45042
19988,11817,8171,775,160000,45044
3297,2579,718,1123,165400,45050
0,0,0,-,-,45051
1533,1341,192,652,227600,45052
1122,1112,10,-,254400,45053
1097,1054,43,-,221300,45054
8497,3890,4607,788,198100,45056
241,174,67,869,115700,45062
1093,996,97,1050,149000,45064
1880,1518,362,934,184100,45065
8705,7553,1152,1099,233500,45066
5114,3564,1550,888,138300,45067
4290,3673,617,889,236200,45068
18736,14672,4064,1220,220100,45069
72,55,17,769,58600,45070
1029,550,479,566,86700,45101
8683,6219,2464,802,154100,45102
12425,8738,3687,805,161900,45103
4614,3681,933,673,124000,45106
3627,2727,900,757,136800,45107
136,136,0,-,222900,45111
26,22,4,-,112500,45112
1462,1183,279,835,180900,45113
81,73,8,-,88800,45115
1405,1120,285,888,149200,45118
1178,860,318,676,118200,45120
3537,2368,1169,620,119300,45121
3871,3178,693,886,120600,45122
3530,2189,1341,612,99100,45123
1668,1359,309,809,107100,45130
94,75,19,815,83100,45131
142,89,53,553,64600,45132
9258,6312,2946,703,118400,45133
1795,1403,392,667,123800,45135
20658,16218,4440,1083,232600,45140
1444,1107,337,761,112800,45142
1869,1283,586,564,89000,45144
9,9,0,-,-,45145
487,319,168,738,108600,45146
67,49,18,-,78400,45147
539,385,154,1021,104200,45148
12901,9401,3500,828,175500,45150
4108,3397,711,1125,198600,45152
679,608,71,848,147100,45153
3320,2553,767,687,135200,45154
124,99,25,746,72500,45155
29,23,6,-,99000,45156
3589,2921,668,692,166200,45157
131,81,50,725,76100,45158
1352,1004,348,727,115500,45159
425,156,269,465,118000,45160
1002,815,187,791,183000,45162
91,62,29,775,69400,45164
38,7,31,-,-,45166
1534,1020,514,657,137300,45167
636,482,154,690,98800,45168
1809,1220,589,656,99900,45169
2277,1844,433,777,151000,45171
61,48,13,-,81800,45172
788,744,44,2313,503600,45174
3497,2491,1006,772,139300,45176
9065,5658,3407,710,139500,45177
7915,2092,5823,1024,358000,45202
1492,273,1219,295,173600,45203
2534,862,1672,683,68200,45204
6996,2316,4680,721,68100,45205
6010,1914,4096,659,193400,45206
2233,882,1351,721,82000,45207
8985,5547,3438,949,367600,45208
5947,2374,3573,864,247700,45209
15887,7565,8322,695,106700,45211
10125,4404,5721,737,132000,45212
5687,3109,2578,670,158000,45213
3528,742,2786,598,70200,45214
12587,6918,5669,821,146400,45215
3860,1804,2056,798,76700,45216
3068,1692,1376,710,107200,45217
1579,1122,457,863,120400,45218
6147,1086,5061,843,104500,45219
6436,1897,4539,753,248100,45220
5596,2300,3296,675,119200,45223
9348,5634,3714,686,115100,45224
3987,585,3402,494,56400,45225
2526,1442,1084,934,301300,45226
8584,4150,4434,875,135400,45227
6132,1513,4619,586,127900,45229
11876,8428,3448,727,164900,45230
16005,10925,5080,838,107100,45231
2562,493,2069,397,82300,45232
5813,4831,982,683,201500,45233
11040,6744,4296,922,143000,45236
9288,4189,5099,745,100600,45237
18843,10828,8015,654,119200,45238
11773,7365,4408,820,116000,45239
10193,6526,3667,961,121200,45240
10008,7519,2489,959,207100,45241
8843,7103,1740,1172,300000,45242
5508,5067,441,1200,406300,45243
10345,8172,2173,867,243900,45244
8318,5740,2578,877,165400,45245
6053,3252,2801,1000,133300,45246
9473,7401,2072,899,190800,45247
9775,8354,1421,870,143000,45248
5400,3477,1923,1166,329100,45249
8777,6527,2250,972,116700,45251
1896,1830,66,1019,186400,45252
8735,6201,2534,1046,196400,45255
29,29,0,-,-,45301
1438,1244,194,738,188800,45302
951,683,268,663,91200,45303
2702,2083,619,719,126700,45304
4406,3527,879,976,207600,45305
917,722,195,606,148600,45306
132,100,32,683,78800,45307
1594,1262,332,680,106900,45308
5343,4052,1291,768,147700,45309
111,108,3,-,104300,45310
2274,1816,458,717,130400,45311
503,438,65,1065,170700,45312
1426,1023,403,698,193100,45314
1565,1280,285,710,163300,45315
45,38,7,1031,108300,45316
357,268,89,696,123500,45317
2127,1629,498,727,146500,45318
143,112,31,631,125000,45319
6002,4369,1633,664,119000,45320
351,277,74,920,92900,45321
8656,6811,1845,839,117000,45322
2187,1720,467,740,133100,45323
17041,8180,8861,816,118700,45324
974,872,102,842,154100,45325
338,291,47,943,119400,45326
3569,2899,670,887,155300,45327
212,130,82,750,80000,45328
327,247,80,813,88100,45330
9844,6565,3279,662,108500,45331
288,252,36,778,111800,45332
478,358,120,735,165600,45333
855,582,273,688,99900,45334
2583,1953,630,779,143200,45335
61,51,10,1075,106300,45336
698,607,91,675,164600,45337
2043,1676,367,735,137600,45338
534,424,110,760,141700,45339
251,243,8,-,149700,45340
1598,1226,372,755,82700,45341
15632,9863,5769,893,144700,45342
6034,4620,1414,763,108500,45344
2470,1654,816,702,101400,45345
810,635,175,848,89700,45346
1753,1354,399,687,97900,45347
365,282,83,836,159000,45348
139,86,53,834,102000,45349
30,26,4,-,128100,45350
84,73,11,713,151300,45351
96,65,31,616,58800,45352
62,62,0,-,162500,45353
206,154,52,825,79300,45354
10150,6515,3635,734,93300,45356
126,106,20,642,98100,45358
710,576,134,586,130800,45359
189,136,53,684,59000,45360
118,92,26,847,102300,45361
444,407,37,665,145100,45362
594,512,82,778,172600,45363
11747,7485,4262,743,125900,45365
1862,1337,525,611,123900,45368
1367,1118,249,790,157400,45369
962,870,92,838,255700,45370
7849,5861,1988,810,178300,45371
137,82,55,720,88200,45372
14037,9251,4786,787,150600,45373
6875,4321,2554,685,143500,45377
139,124,15,733,71700,45378
1917,1533,384,662,149600,45380
2079,1631,448,765,128700,45381
442,334,108,771,99800,45382
2840,2055,785,670,132300,45383
102,88,14,-,115700,45384
15753,11017,4736,737,134500,45385
2528,1808,720,892,226400,45387
259,232,27,575,169300,45388
192,144,48,696,77700,45389
1273,761,512,633,77800,45390
4424,1596,2828,630,57600,45402
5893,2401,3492,682,52500,45403
4164,1925,2239,707,59700,45404
8234,2940,5294,662,60400,45405
9051,4388,4663,688,60000,45406
2920,1723,1197,981,160600,45409
7104,3236,3868,715,69200,45410
8969,5520,3449,698,111100,45414
5616,3602,2014,770,121000,45415
2370,1627,743,937,65200,45416
12066,6310,5756,693,49900,45417
648,528,120,678,115100,45418
6624,4639,1985,739,157700,45419
11762,6471,5291,696,82400,45420
19432,14079,5353,900,118000,45424
7041,3054,3987,735,79200,45426
0,0,0,-,-,45428
11628,8032,3596,862,144000,45429
2855,2443,412,1079,171100,45430
12070,6118,5952,1081,138000,45431
6393,4651,1742,790,120700,45432
570,29,541,1286,-,45433
4663,4235,428,1114,204100,45434
3955,2204,1751,825,83700,45439
8993,5915,3078,875,171800,45440
8065,4755,3310,805,104300,45449
12788,9707,3081,927,231200,45458
12342,8805,3537,915,199100,45459
6354,5450,904,773,164800,45502
14262,8593,5669,752,114000,45503
6657,4265,2392,798,118900,45504
8263,3998,4265,644,71900,45505
5354,2779,2575,709,70600,45506
20938,14080,6858,736,122500,45601
1816,1304,512,619,92500,45612
1066,826,240,788,131100,45613
1798,1452,346,654,104700,45614
584,475,109,688,83400,45616
146,54,92,-,-,45617
4,4,0,-,-,45618
2990,2174,816,790,111500,45619
360,270,90,1055,98800,45620
140,81,59,-,48200,45621
74,74,0,-,-,45622
1141,909,232,788,95400,45623
0,0,0,-,-,45624
1958,1543,415,689,127700,45628
981,763,218,595,90800,45629
45,33,12,-,-,45630
6184,4388,1796,684,113300,45631
686,519,167,691,83400,45634
41,41,0,-,-,45636
8540,5887,2653,637,88500,45638
6344,4179,2165,804,103100,45640
0,0,0,-,-,45642
1840,1514,326,714,150800,45644
1022,821,201,766,84000,45645
162,162,0,-,92500,45646
994,879,115,496,101900,45647
4497,3567,930,677,112400,45648
213,139,74,-,69400,45650
2258,1539,719,574,89900,45651
1400,1143,257,523,115300,45652
1622,1344,278,575,143300,45653
452,390,62,-,96100,45654
2677,1979,698,660,89200,45656
825,515,310,576,76400,45657
949,729,220,594,100400,45658
930,733,197,839,86700,45659
2847,2037,810,629,110300,45660
2729,1836,893,546,95100,45661
12576,6590,5986,565,79700,45662
2430,1929,501,601,77100,45663
3944,3047,897,780,138100,45669
116,91,25,653,118800,45671
551,467,84,905,102800,45672
138,59,79,919,-,45673
109,51,58,625,-,45674
383,248,135,-,91800,45678
995,708,287,792,116700,45679
4877,3258,1619,694,115000,45680
600,566,34,704,130200,45681
863,662,201,752,87200,45682
859,717,142,701,112500,45684
427,292,135,550,135000,45685
1333,976,357,697,91500,45686
211,116,95,1015,68400,45688
5831,3673,2158,717,116000,45690
3332,2483,849,579,88700,45692
3404,2134,1270,572,98500,45693
4562,3545,1017,648,144600,45694
271,208,63,782,81800,45695
706,597,109,-,121300,45696
1806,1491,315,525,122900,45697
131,88,43,629,71400,45698
10926,4988,5938,794,168300,45701
2252,1739,513,636,124700,45710
388,314,74,696,146900,45711
4077,3106,971,681,115300,45714
964,739,225,620,107300,45715
184,155,29,764,71700,45716
431,212,219,661,58800,45719
14,14,0,-,-,45721
1454,1205,249,769,91900,45723
871,846,25,-,135300,45724
212,196,16,-,54500,45727
521,504,17,-,150400,45729
1783,1287,496,644,77800,45732
199,140,59,-,-,45734
622,547,75,693,122000,45735
174,98,76,708,63700,45740
301,220,81,561,82500,45741
1243,1028,215,718,152700,45742
684,650,34,-,116100,45743
1121,890,231,596,122000,45744
566,478,88,842,104300,45745
207,186,21,768,53200,45746
11120,7209,3911,669,130800,45750
1548,1123,425,583,67600,45760
774,565,209,708,79100,45761
3096,1833,1263,713,80200,45764
506,368,138,472,123400,45766
1019,807,212,386,112000,45767
725,546,179,539,124600,45768
2623,1913,710,554,103800,45769
266,246,20,-,56400,45770
1307,1010,297,549,83100,45771
697,640,57,719,92700,45772
29,29,0,-,-,45773
508,449,59,857,123300,45775
288,228,60,629,153100,45776
283,189,94,986,101200,45778
291,237,54,583,85500,45779
1322,602,720,724,108700,45780
169,106,63,593,62900,45782
1303,1011,292,522,151600,45784
1312,1159,153,677,116800,45786
37,37,0,-,-,45787
468,447,21,673,173600,45788
76,76,0,-,-,45789
8752,5012,3740,645,77100,45801
6197,3225,2972,606,61800,45804
9286,5699,3587,761,112400,45805
4373,3451,922,747,126700,45806
4919,3900,1019,717,146000,45807
141,106,35,805,72500,45808
59,54,5,-,95000,45809
2553,1536,1017,759,123300,45810
791,568,223,644,71500,45812
1487,1177,310,626,104200,45813
1138,894,244,843,147200,45814
151,122,29,584,93400,45816
2591,2001,590,721,160600,45817
104,67,37,983,81000,45819
182,160,22,639,92200,45820
529,478,51,869,92800,45821
8026,5717,2309,694,137600,45822
178,136,42,543,205600,45826
760,717,43,690,159100,45827
2380,1945,435,610,144700,45828
2292,1941,351,761,119300,45830
1239,1046,193,727,113800,45831
1125,984,141,863,109700,45832
4147,3093,1054,772,117400,45833
206,192,14,589,118200,45835
552,461,91,619,97500,45836
22,22,0,-,22500,45838
24043,15581,8462,753,147900,45840
323,245,78,822,152400,45841
1458,1216,242,650,98000,45843
1267,1073,194,658,164100,45844
1114,1013,101,631,204400,45845
1452,1273,179,519,161600,45846
406,343,63,820,100300,45849
1255,1051,204,628,160700,45850
256,183,73,623,102800,45851
520,355,165,701,173800,45853
166,122,44,858,87500,45854
66,58,8,750,92000,45855
1889,1496,393,758,127900,45856
1128,857,271,722,146600,45858
183,143,40,650,60500,45859
874,659,215,601,189500,45860
85,72,13,-,45000,45861
587,487,100,693,100400,45862
480,397,83,745,99800,45863
85,71,14,810,103500,45864
1882,1549,333,662,175500,45865
78,51,27,788,92100,45866
444,394,50,718,114800,45867
266,248,18,735,157500,45868
1872,1572,300,673,174200,45869
66,50,16,-,75300,45870
755,533,222,730,163300,45871
1476,984,492,635,90400,45872
829,676,153,731,90600,45873
908,760,148,665,81100,45874
4493,3474,1019,610,174600,45875
315,241,74,708,154200,45876
839,681,158,654,128300,45877
2518,1748,770,626,90600,45879
1104,884,220,594,86400,45880
490,403,87,929,133700,45881
1112,897,215,666,110000,45882
1262,1048,214,640,210900,45883
39,8,31,-,-,45884
5371,3931,1440,718,141100,45885
215,160,55,715,62900,45886
1635,1237,398,743,104300,45887
76,67,9,1275,76500,45888
501,485,16,963,168900,45889
209,181,28,750,91200,45890
6225,4366,1859,658,104100,45891
284,231,53,538,105100,45894
7361,5678,1683,659,130000,45895
736,639,97,938,126800,45896
25,25,0,-,-,45897
382,336,46,691,73200,45898
62,56,6,-,57500,45899
4146,3193,953,759,91400,46001
6980,5400,1580,886,97800,46011
8094,5485,2609,801,96100,46012
7914,5217,2697,742,83800,46013
7010,3106,3904,707,46300,46016
2335,1791,544,786,91100,46017
1198,1008,190,692,143300,46030
853,761,92,939,153500,46031
19266,13086,6180,1180,307600,46032
13487,12141,1346,1250,332800,46033
2739,2266,473,888,163000,46034
404,331,73,772,96000,46035
4736,3277,1459,737,77200,46036
14494,11868,2626,1334,296900,46037
16585,11823,4762,1188,200100,46038
231,194,37,-,98300,46039
4075,3494,581,893,195500,46040
8535,5872,2663,702,97400,46041
1153,922,231,707,97600,46044
44,44,0,-,82300,46045
50,0,50,-,-,46047
815,659,156,935,99200,46048
424,325,99,633,99400,46049
734,575,159,806,108400,46050
1206,966,240,834,113800,46051
9353,6631,2722,784,136500,46052
4175,3866,309,1148,225800,46055
929,803,126,808,143800,46056
486,322,164,674,118800,46057
800,663,137,809,124800,46058
14554,10107,4447,1054,186400,46060
13177,10541,2636,986,208600,46062
202,152,50,760,57900,46063
5283,4448,835,863,161100,46064
1220,976,244,774,161400,46065
1167,1065,102,804,117400,46068
2978,2234,744,747,165200,46069
831,688,143,688,107900,46070
1388,1153,235,754,165300,46071
3579,2773,806,751,103200,46072
11289,9226,2063,1142,263300,46074
2445,1779,666,1324,205800,46075
615,499,116,671,78500,46076
9859,8403,1456,1301,368500,46077
53,31,22,1104,97500,46103
409,389,20,-,110200,46104
709,555,154,760,127200,46105
2301,1806,495,1039,202400,46106
5103,3054,2049,788,98200,46107
198,163,35,-,193600,46110
80,49,31,-,86400,46111
13311,10318,2993,1073,185300,46112
5510,4086,1424,1112,143900,46113
799,614,185,625,124500,46115
216,195,21,-,133300,46117
1934,1520,414,986,148700,46118
2057,1594,463,686,129900,46120
2111,1848,263,728,160300,46121
5887,4462,1425,876,181300,46122
12580,10524,2056,1149,192000,46123
3226,2221,1005,742,95300,46124
5,0,5,-,-,46125
2001,1690,311,811,154800,46126
92,82,10,-,58400,46127
852,726,126,865,120600,46128
946,792,154,534,174700,46130
11844,8222,3622,851,134400,46131
323,252,71,939,115000,46133
6879,4399,2480,785,116200,46135
15754,11086,4668,864,155700,46140
11265,8400,2865,858,169700,46142
20836,13699,7137,970,179400,46143
78,68,10,-,66700,46144
83,19,64,927,-,46146
1198,975,223,858,166600,46147
2004,1465,539,749,112900,46148
738,609,129,785,169100,46149
384,316,68,830,116300,46150
11726,8685,3041,760,155300,46151
75,33,42,-,-,46155
578,487,91,987,96300,46156
1341,1168,173,841,165900,46157
8560,6605,1955,841,157600,46158
2578,2227,351,815,153000,46160
1141,861,280,748,139500,46161
245,197,48,-,155400,46162
4507,4160,347,820,201900,46163
1732,1568,164,1090,168100,46164
613,527,86,900,174500,46165
742,517,225,985,117300,46166
2287,2078,209,925,204800,46167
12819,8966,3853,1015,181100,46168
671,651,20,-,107400,46171
960,710,250,954,109000,46172
4141,2753,1388,689,98400,46173
235,143,92,793,68000,46175
11098,7406,3692,793,116000,46176
389,336,53,836,160500,46180
1739,1489,250,952,213300,46181
626,503,123,731,113800,46182
15,15,0,-,-,46183
4734,4094,640,1183,117800,46184
715,619,96,1029,139700,46186
12711,5500,7211,807,71800,46201
9403,2565,6838,936,248700,46202
14498,7811,6687,823,82700,46203
3760,706,3054,1130,316300,46204
11360,5664,5696,843,162600,46205
8504,3880,4624,785,112800,46208
9782,4685,5097,856,119600,46214
1278,316,962,1019,203400,46216
12474,9065,3409,1050,137000,46217
11721,5243,6478,842,59100,46218
15834,8656,7178,813,103400,46219
16743,10375,6368,976,206700,46220
9719,5833,3886,858,104200,46221
11859,4900,6959,838,61700,46222
13685,4684,9001,758,105700,46224
2360,1092,1268,848,72500,46225
17975,8372,9603,810,86300,46226
22759,10273,12486,798,126500,46227
5689,4445,1244,882,154300,46228
10946,6526,4420,930,113300,46229
3451,3111,340,1266,124700,46231
9841,7954,1887,1138,152900,46234
11817,5473,6344,722,104900,46235
10230,8658,1572,1266,179600,46236
15005,10186,4819,947,140200,46237
9836,8324,1512,1023,152900,46239
9437,4315,5122,958,211100,46240
10578,6089,4489,827,76200,46241
9355,4000,5355,953,183400,46250
15147,6674,8473,842,115600,46254
10619,7360,3259,860,196300,46256
3644,3487,157,1270,196600,46259
13166,6511,6655,871,181500,46260
10787,4999,5788,924,137000,46268
2954,2610,344,1200,295100,46278
3454,2353,1101,1198,169300,46280
103,103,0,-,350000,46290
317,267,50,863,490400,46301
5187,4117,1070,890,186300,46303
9428,7226,2202,973,186800,46304
22876,19217,3659,1006,199900,46307
5239,4309,930,814,162200,46310
7927,7166,761,1356,220600,46311
10160,4627,5533,687,73900,46312
7150,4919,2231,892,135400,46319
4906,2060,2846,720,71400,46320
8697,7607,1090,1110,222700,46321
9473,7508,1965,1091,156600,46322
8104,5305,2799,943,92100,46323
8355,5407,2948,943,90300,46324
3854,2426,1428,842,82900,46327
343,314,29,-,124500,46340
3699,3206,493,671,167500,46341
11534,8881,2653,911,131100,46342
63,55,8,943,88600,46345
485,335,150,665,64300,46346
1798,1545,253,957,166800,46347
456,356,100,975,117200,46348
1160,1073,87,725,156300,46349
17345,12603,4742,706,144200,46350
6308,5278,1030,1028,178600,46356
17705,11394,6311,755,108800,46360
397,348,49,-,144900,46365
2209,1780,429,606,105100,46366
15354,10539,4815,898,147500,46368
1164,1003,161,859,173200,46371
5270,5107,163,928,284200,46373
353,302,51,767,167100,46374
9489,7783,1706,980,222800,46375
95,68,27,900,77000,46376
132,93,39,-,96100,46377
122,122,0,-,114200,46379
64,37,27,-,186500,46381
706,706,0,-,170400,46382
16108,10444,5664,915,193300,46383
14527,12424,2103,991,206200,46385
1219,1111,108,779,146100,46390
2157,1849,308,660,173200,46391
2973,2400,573,810,165500,46392
124,57,67,-,110600,46393
4880,3077,1803,841,120400,46394
2659,1126,1533,507,63000,46402
5798,3101,2697,744,96200,46403
6802,4060,2742,773,69000,46404
3935,2821,1114,920,83000,46405
3963,2072,1891,792,56400,46406
4662,1877,2785,703,50300,46407
6347,3788,2559,812,71300,46408
2884,1371,1513,912,59400,46409
15424,9698,5726,1016,131800,46410
1270,952,318,772,97300,46501
11,11,0,-,-,46502
1343,1055,288,525,124200,46504
3503,2521,982,708,163600,46506
3361,2663,698,791,163700,46507
60,60,0,-,70900,46508
1518,1203,315,625,118900,46510
1647,1323,324,756,152100,46511
16429,11513,4916,836,128100,46514
11666,6599,5067,726,111600,46516
9125,5748,3377,704,125100,46517
891,762,129,782,138200,46524
11718,7769,3949,770,133900,46526
8375,6148,2227,806,163900,46528
10669,9705,964,1188,218800,46530
582,492,90,927,115200,46531
694,584,110,759,103300,46532
4217,3174,1043,682,108900,46534
1156,898,258,840,155200,46536
171,140,31,725,76700,46537
1461,1276,185,806,214600,46538
970,797,173,665,94200,46539
3797,3337,460,844,197700,46540
1535,1169,366,589,121100,46542
881,746,135,829,243200,46543
12760,8464,4296,735,106100,46544
11236,5207,6029,745,115700,46545
4342,3202,1140,708,157600,46550
2578,2093,485,570,151700,46552
1096,986,110,754,156100,46553
1990,1689,301,631,136600,46554
1237,890,347,765,174500,46555
233,7,226,751,-,46556
4468,3765,703,887,151300,46561
2012,1614,398,752,141500,46562
8927,6624,2303,701,127200,46563
2428,2077,351,679,251500,46565
3707,2869,838,823,179300,46567
401,320,81,-,137500,46570
1322,1085,237,693,266300,46571
1327,1009,318,772,158400,46573
3566,3017,549,692,113900,46574
8558,6006,2552,763,134700,46580
5115,3659,1456,865,158400,46582
1703,1009,694,846,171700,46590
42,42,0,-,85000,46595
2214,503,1711,552,76700,46601
3566,1970,1596,800,52500,46613
12344,9109,3235,652,123400,46614
5495,3410,2085,770,83500,46615
2097,1140,957,852,75900,46616
3684,2469,1215,1013,131700,46617
7560,5279,2281,753,74900,46619
10240,6702,3538,797,110000,46628
2798,2232,566,599,126500,46635
6416,4189,2227,850,128500,46637
3200,2542,658,723,121600,46701
928,780,148,706,111600,46702
7319,5167,2152,766,147800,46703
16,16,0,-,-,46704
710,517,193,476,95900,46705
7644,5707,1937,690,135300,46706
1590,1327,263,610,143000,46710
2565,1910,655,537,138900,46711
5958,4408,1550,597,118800,46714
1702,1378,324,801,93400,46721
3121,2637,484,693,146200,46723
9412,7743,1669,709,147200,46725
446,385,61,-,136300,46730
247,201,46,538,178500,46731
1135,637,498,862,102700,46732
7639,5743,1896,613,112800,46733
3320,2810,510,781,145500,46737
3363,2435,928,672,95600,46738
1289,1039,250,626,135600,46740
1426,1268,158,656,163400,46741
1376,1139,237,592,168200,46742
770,718,52,-,156800,46743
849,716,133,748,140900,46745
1659,1194,465,913,128300,46746
1068,990,78,692,132000,46747
1749,1579,170,972,182100,46748
10596,7798,2798,678,99600,46750
6252,4414,1838,675,114500,46755
155,155,0,-,93600,46759
527,393,134,740,97400,46760
3830,3072,758,605,139400,46761
737,715,22,-,180300,46763
522,488,34,967,118200,46764
1831,1680,151,1013,201400,46765
363,280,83,775,130600,46766
2688,2039,649,701,94300,46767
1121,936,185,686,120900,46770
0,0,0,-,-,46771
808,752,56,843,159000,46772
1252,1116,136,678,115700,46773
6292,4953,1339,856,112000,46774
582,496,86,756,90400,46776
2336,1972,364,716,122700,46777
848,703,145,761,108400,46779
300,280,20,725,93700,46781
2504,2309,195,675,175200,46783
827,654,173,734,139000,46784
490,432,58,833,141800,46785
28,28,0,-,-,46786
1537,1317,220,565,110800,46787
1120,1036,84,722,180400,46788
392,353,39,925,139900,46791
1548,1223,325,913,107100,46792
1744,1414,330,704,113000,46793
689,551,138,904,103400,46794
2436,2057,379,923,174200,46795
1333,1137,196,794,110600,46797
580,523,57,1026,120100,46798
99,80,19,775,-,46799
4562,1478,3084,642,66000,46802
3470,1417,2053,654,44000,46803
11926,8489,3437,852,161000,46804
9163,5030,4133,673,85500,46805
8775,4866,3909,764,51700,46806
6587,4101,2486,748,83100,46807
8159,4593,3566,676,82000,46808
3917,2325,1592,605,85900,46809
4192,3765,427,965,285900,46814
10688,7799,2889,752,123100,46815
7501,3748,3753,642,80600,46816
7706,6519,1187,873,136500,46818
4086,2904,1182,762,102300,46819
12329,7776,4553,823,122900,46825
14039,10010,4029,831,126000,46835
8253,7432,821,1072,217300,46845
16256,11058,5198,664,91600,46901
15766,10316,5450,714,106300,46902
1183,921,262,661,105900,46910
530,483,47,948,92500,46911
449,411,38,-,153800,46913
551,456,95,631,118500,46914
270,208,62,542,114400,46915
682,584,98,560,113300,46917
1057,858,199,648,111500,46919
410,398,12,-,143900,46920
11,11,0,-,-,46922
3201,2497,704,703,128800,46923
660,557,103,810,94700,46926
1809,1493,316,581,93800,46928
1123,822,301,587,105900,46929
30,23,7,731,71300,46930
73,49,24,788,62300,46931
1373,1196,177,771,106300,46932
2594,1759,835,785,82400,46933
2207,1808,399,821,133800,46936
1212,991,221,815,84400,46938
801,651,150,568,82800,46939
1057,905,152,668,95000,46940
397,354,43,608,105700,46941
84,50,34,-,113300,46943
16,16,0,-,-,46946
10705,7546,3159,651,81300,46947
245,211,34,700,86000,46950
730,660,70,688,117400,46951
8205,5658,2547,673,96700,46952
8450,5131,3319,680,73900,46953
253,182,71,544,63200,46957
281,262,19,-,85200,46958
296,149,147,703,-,46959
411,299,112,765,95300,46960
77,53,24,-,-,46961
3490,2342,1148,744,97900,46962
48,19,29,446,-,46967
17,17,0,-,-,46968
8851,5760,3091,712,79400,46970
726,593,133,727,99900,46974
5686,4352,1334,649,99400,46975
740,615,125,690,104400,46978
1757,1535,222,736,157000,46979
934,726,208,735,99800,46982
108,79,29,-,141300,46984
603,411,192,739,123400,46985
671,564,107,597,100300,46986
403,348,55,677,107300,46987
362,277,85,531,78100,46988
1298,994,304,637,142700,46989
209,201,8,-,111700,46990
700,550,150,784,68500,46991
7012,5105,1907,660,95000,46992
1039,897,142,800,94300,46994
2713,2130,583,691,96700,46996
83,75,8,-,47500,46998
4117,3148,969,719,157700,47001
435,257,178,692,77100,47003
4591,3520,1071,678,171700,47006
118,58,60,-,-,47010
293,261,32,-,104700,47011
4047,3060,987,726,150300,47012
317,286,31,900,139300,47016
208,189,19,-,164500,47017
1570,1115,455,839,152500,47018
482,270,212,874,154300,47020
1168,1062,106,888,214000,47022
617,505,112,883,103700,47023
1210,937,273,663,105900,47024
8474,6413,2061,730,167100,47025
724,693,31,-,147300,47030
2114,1678,436,763,151100,47031
1119,1027,92,964,130400,47032
48,35,13,890,79000,47034
100,100,0,-,-,47035
314,294,20,645,220600,47036
1674,1282,392,756,121800,47037
601,461,140,725,120400,47038
2190,1741,449,720,129900,47040
2516,2209,307,821,159800,47041
1699,1280,419,592,124200,47042
2388,1722,666,639,112000,47043
2218,1894,324,744,179000,47060
2695,1980,715,800,84600,47102
19,19,0,-,-,47104
1709,1482,227,889,154700,47106
808,598,210,540,110400,47108
193,193,0,-,121400,47110
5906,4447,1459,735,158700,47111
6032,4511,1521,687,156900,47112
105,79,26,1519,154500,47114
1045,888,157,426,133000,47115
245,236,9,-,64800,47116
1513,1392,121,781,126400,47117
1176,991,185,525,88000,47118
4142,3931,211,890,246500,47119
251,199,52,820,94500,47120
3785,3380,405,796,200100,47122
43,43,0,-,-,47123
1573,1460,113,763,196500,47124
607,488,119,918,101000,47125
1644,1327,317,859,158100,47126
8208,4404,3804,783,103000,47129
18189,12284,5905,820,131700,47130
383,335,48,941,179400,47135
1653,1545,108,800,166800,47136
567,490,77,638,83700,47137
1898,1799,99,477,123900,47138
1019,759,260,675,96700,47140
575,531,44,-,151300,47141
416,412,4,-,98300,47142
1017,905,112,695,184200,47143
719,593,126,656,99900,47145
360,271,89,791,148700,47147
19166,11837,7329,783,133300,47150
30,19,11,-,104200,47160
1167,965,202,876,144500,47161
272,247,25,-,114400,47162
617,586,31,-,124500,47163
1773,1454,319,661,122400,47164
2453,1918,535,686,123200,47165
591,526,65,-,109600,47166
5849,4302,1547,653,109100,47167
5524,3778,1746,782,106900,47170
6404,5318,1086,996,169500,47172
361,334,27,-,84700,47175
447,385,62,-,120900,47177
17357,11591,5766,944,139400,47201
10423,7931,2492,800,163000,47203
1983,1425,558,729,131300,47220
522,366,156,787,91300,47223
240,202,38,-,86300,47224
77,67,10,1050,73600,47226
868,775,93,725,121500,47227
1173,890,283,710,90400,47229
610,543,67,760,99100,47230
338,307,31,905,131700,47231
1173,987,186,870,112100,47232
633,550,83,771,147500,47234
491,459,32,-,101500,47235
8570,5809,2761,793,130600,47240
2033,1385,648,784,114500,47243
284,252,32,833,108900,47244
1628,1339,289,761,122600,47246
74,54,20,1013,103900,47247
9079,6219,2860,735,125800,47250
724,602,122,697,82100,47260
91,65,26,900,87000,47263
496,404,92,715,114200,47264
7767,5621,2146,725,100300,47265
195,171,24,-,97700,47270
766,596,170,922,97600,47272
681,626,55,788,133400,47273
12006,8429,3577,746,125000,47274
276,228,48,965,98800,47280
509,424,85,829,132100,47281
147,121,26,682,95400,47282
1288,967,321,806,119500,47283
11158,7223,3935,696,57900,47302
10405,5100,5305,689,77800,47303
13351,9163,4188,816,115300,47304
1728,650,1078,602,43300,47305
3,0,3,-,-,47306
1532,1167,365,617,87100,47320
70,49,21,740,69600,47324
192,144,48,1012,94000,47325
677,524,153,656,104500,47326
1823,1336,487,678,83100,47327
2097,1656,441,915,115500,47330
9275,6408,2867,693,82300,47331
1294,1079,215,810,121800,47334
290,218,72,596,66500,47335
1312,959,353,628,67300,47336
68,48,20,596,65000,47337
1092,858,234,817,81900,47338
218,199,19,725,79900,47339
1180,978,202,639,85300,47340
902,660,242,736,104800,47341
1128,889,239,594,79400,47342
37,29,8,1083,85000,47344
537,407,130,706,107600,47345
1554,1302,252,639,98500,47346
3918,3030,888,618,72600,47348
135,120,15,825,76400,47351
381,331,50,856,94400,47352
2201,1610,591,826,120000,47353
465,381,84,600,95600,47354
1178,918,260,754,86000,47355
2242,1843,399,731,126200,47356
337,271,66,808,84600,47357
382,349,33,731,89000,47358
1310,925,385,628,73700,47359
489,443,46,493,118800,47360
84,68,16,763,88800,47361
11204,7772,3432,693,90200,47362
23,23,0,-,-,47367
1218,1037,181,642,88100,47368
569,426,143,719,82400,47369
4769,3448,1321,667,95800,47371
1057,850,207,585,66500,47373
18465,11580,6885,668,96600,47374
634,472,162,574,74700,47380
69,33,36,558,50600,47381
108,58,50,642,44400,47382
1160,1008,152,615,144900,47383
679,564,115,746,92600,47384
604,476,128,739,95600,47385
467,444,23,632,128800,47386
288,230,58,760,127400,47387
109,87,22,594,87400,47388
2192,1607,585,533,68400,47390
535,479,56,-,138200,47393
3441,2526,915,668,82300,47394
2776,2170,606,684,133100,47396
17839,9851,7988,984,227400,47401
14400,8211,6189,852,144600,47403
9677,5151,4526,813,155500,47404
4,4,0,-,-,47405
0,0,0,-,-,47406
8856,3148,5708,907,193000,47408
153,66,87,803,59400,47420
11277,8603,2674,698,119500,47421
3676,3072,604,591,108100,47424
315,252,63,515,109900,47427
3484,2907,577,801,144500,47429
622,530,92,-,105700,47431
1976,1443,533,713,89900,47432
1617,1261,356,667,129500,47433
0,0,0,-,-,47434
561,445,116,690,112100,47436
82,82,0,-,150600,47437
1641,1268,373,684,79100,47438
3953,3030,923,580,85000,47441
427,300,127,661,92300,47443
4218,3394,824,542,104000,47446
3151,2454,697,866,193200,47448
124,117,7,588,81700,47449
497,330,167,538,91600,47451
1916,1415,501,544,111500,47452
296,235,61,1026,68000,47453
2969,2192,777,638,85800,47454
33,33,0,-,-,47455
558,437,121,915,106300,47456
52,42,10,-,69500,47457
9,9,0,-,-,47458
1396,1217,179,697,133100,47459
4604,3597,1007,681,120500,47460
1546,1294,252,718,147900,47462
84,51,33,357,72100,47464
189,144,45,603,89000,47465
23,23,0,-,-,47467
613,553,60,-,224000,47468
714,535,179,478,101800,47469
713,560,153,913,108400,47470
1035,860,175,514,98400,47471
6858,4710,2148,695,101200,47501
1687,1136,551,614,58800,47512
974,873,101,567,109300,47513
92,85,7,-,-,47514
368,346,22,-,151400,47515
457,388,69,431,96700,47516
250,247,3,-,180300,47519
1275,840,435,574,89100,47520
225,214,11,-,156100,47521
113,78,35,604,56700,47522
1334,1022,312,519,114900,47523
208,140,68,663,-,47524
157,133,24,-,183800,47525
616,552,64,660,119900,47527
194,137,57,638,42200,47528
412,307,105,583,69100,47529
303,293,10,-,135100,47531
1719,1426,293,718,159400,47532
264,195,69,-,57500,47535
0,0,0,-,-,47536
393,369,24,819,114600,47537
473,331,142,822,99300,47541
3806,2718,1088,591,119100,47542
8538,6734,1804,674,161100,47546
285,269,16,-,130400,47550
346,335,11,-,136300,47551
106,106,0,-,-,47552
3140,2455,685,606,128300,47553
680,523,157,746,132700,47557
1219,1083,136,638,180000,47558
646,493,153,494,105500,47561
1626,1175,451,561,149800,47562
580,535,45,-,151300,47564
2471,2019,452,538,101700,47567
270,210,60,491,88900,47568
89,89,0,-,-,47574
460,360,100,-,202800,47575
136,100,36,-,89400,47576
501,463,38,-,149600,47577
349,311,38,792,103400,47578
971,825,146,543,165100,47579
146,146,0,-,181300,47580
1591,1347,244,548,102500,47581
76,70,6,708,60000,47584
202,146,56,672,-,47585
4528,3426,1102,537,110300,47586
240,210,30,650,78300,47588
269,250,19,-,69500,47590
10183,6196,3987,667,102200,47591
47,39,8,-,-,47596
348,272,76,612,78300,47597
1272,1013,259,702,73100,47598
5779,4748,1031,707,125000,47601
2013,1411,602,887,119500,47610
560,463,97,440,96000,47611
337,261,76,814,81500,47612
1146,1038,108,555,143300,47613
749,524,225,813,82900,47615
96,55,41,380,34300,47616
699,592,107,736,125600,47619
5322,3999,1323,689,134900,47620
13959,10942,3017,894,179000,47630
832,702,130,776,153000,47631
1126,883,243,739,121400,47633
838,710,128,717,99400,47634
2262,1658,604,744,113000,47635
480,406,74,759,159000,47637
1335,1212,123,632,167600,47638
1537,1387,150,665,218400,47639
423,407,16,-,79700,47640
1682,1225,457,705,134700,47648
661,567,94,887,83200,47649
36,18,18,936,66000,47654
1943,1465,478,660,88300,47660
1394,1209,185,595,114000,47665
729,602,127,758,60000,47666
4796,3387,1409,649,97700,47670
69,61,8,-,105200,47683
184,102,82,550,250000,47708
8074,4524,3550,645,92700,47710
13160,9936,3224,812,126200,47711
10507,6720,3787,807,130800,47712
4446,1958,2488,673,62400,47713
13607,8127,5480,755,87400,47714
13102,6409,6693,811,142500,47715
6932,5846,1086,842,161300,47720
6320,5821,499,1227,201800,47725
13623,7645,5978,722,118000,47802
8666,5764,2902,881,110200,47803
4722,2736,1986,707,63900,47804
5058,3918,1140,717,107000,47805
4814,1590,3224,693,50600,47807
0,0,0,-,-,47809
428,382,46,721,69200,47832
443,420,23,-,129600,47833
7760,5837,1923,705,110100,47834
0,0,0,-,-,47836
489,348,141,346,91000,47837
658,476,182,632,76000,47838
675,550,125,642,117900,47840
921,711,210,576,83300,47841
4275,2905,1370,646,77600,47842
213,189,24,430,111200,47846
421,348,73,634,84000,47847
648,574,74,783,73500,47848
156,135,21,-,115900,47849
991,846,145,608,87300,47850
56,22,34,763,74000,47853
270,270,0,-,134600,47854
205,151,54,722,58900,47855
133,115,18,920,69700,47857
220,205,15,-,112500,47858
290,258,32,936,70600,47859
149,127,22,633,33300,47860
269,235,34,763,106700,47861
613,412,201,590,72200,47862
104,73,31,-,-,47863
87,83,4,-,33700,47865
246,246,0,-,86400,47866
1287,988,299,950,94600,47868
57,11,46,-,-,47869
108,82,26,1036,83500,47871
2930,2116,814,567,106600,47872
1255,1050,205,808,75900,47874
0,0,0,-,-,47876
1313,1001,312,726,74300,47879
15,15,0,-,-,47880
154,117,37,735,61600,47881
3442,2244,1198,694,91700,47882
76,67,9,-,43600,47884
3561,2796,765,664,85200,47885
1975,300,1675,698,142400,47901
6843,3320,3523,783,83700,47904
17008,10286,6722,818,152000,47905
23812,10689,13123,893,201300,47906
0,0,0,-,-,47907
16427,10473,5954,836,132100,47909
17,13,4,-,-,47916
179,134,45,833,103400,47917
2502,1829,673,654,97800,47918
930,858,72,678,163100,47920
404,316,88,729,67100,47921
597,405,192,652,83300,47922
1408,1093,315,796,116400,47923
87,87,0,-,-,47924
79,70,9,-,67600,47925
497,444,53,740,113100,47926
839,643,196,769,72600,47928
303,251,52,693,101300,47929
481,373,108,660,119100,47930
2123,1671,452,640,116200,47932
11299,7485,3814,647,127000,47933
646,579,67,908,126900,47940
523,372,151,744,120600,47941
289,251,38,700,79800,47942
308,145,163,1013,167400,47943
1497,1007,490,647,90300,47944
855,707,148,541,117000,47946
576,381,195,621,80900,47948
500,422,78,829,88800,47949
325,208,117,876,115700,47950
938,584,354,735,100200,47951
1237,1024,213,699,102000,47952
883,728,155,794,117900,47954
376,278,98,690,84800,47955
744,576,168,690,85600,47957
75,59,16,617,65400,47958
993,743,250,650,85800,47959
6219,4847,1372,725,120100,47960
809,624,185,766,104600,47963
47,41,6,438,68100,47964
237,183,54,900,87900,47965
157,154,3,-,44000,47966
240,190,50,1089,93300,47967
396,356,40,775,123600,47968
52,34,18,1000,73800,47969
748,533,215,801,115200,47970
712,599,113,694,89700,47971
509,370,139,625,88200,47974
328,244,84,716,96300,47975
934,647,287,696,113000,47977
4238,2994,1244,744,137100,47978
441,393,48,665,110300,47980
320,258,62,817,208600,47981
91,83,8,850,58000,47982
92,45,47,-,71400,47983
1652,1329,323,632,91100,47987
471,408,63,683,101500,47989
709,604,105,747,111600,47990
398,320,78,782,82100,47991
612,587,25,-,155000,47992
1495,1165,330,707,110800,47993
134,100,34,710,63300,47994
634,510,124,668,113700,47995
45,38,7,719,88600,47997
5308,4373,935,920,144600,48001
1205,1129,76,1089,192200,48002
2324,2062,262,938,184200,48003
2021,1834,187,788,189100,48005
1510,1401,109,821,163600,48006
9117,6892,2225,1481,488700,48009
1585,1222,363,850,139800,48014
3539,1769,1770,688,72600,48015
5680,4093,1587,858,166500,48017
12439,7911,4528,1058,69100,48021
954,922,32,650,158500,48022
2021,1677,344,983,184600,48023
5796,5229,567,1293,387700,48025
6043,4359,1684,755,138800,48026
1251,1124,127,1014,162800,48027
546,531,15,1125,299500,48028
7244,3600,3644,961,61100,48030
754,706,48,921,165200,48032
7574,3201,4373,1090,127500,48033
7240,1491,5749,1089,172500,48034
14474,8422,6052,918,124200,48035
9156,6500,2656,787,128700,48036
20076,12491,7585,960,173100,48038
3237,2609,628,840,140300,48039
4205,3348,857,812,129400,48040
1752,1388,364,773,174300,48041
10491,10329,162,1545,264400,48042
6827,3808,3019,721,95900,48043
19125,17368,1757,1147,253900,48044
11423,7802,3621,857,179500,48045
15673,12402,3271,883,203800,48047
2691,2133,558,940,122200,48048
2203,2022,181,998,164600,48049
563,514,49,1070,244500,48050
6303,5317,986,956,168100,48051
2921,2534,387,902,198400,48054
5927,4442,1485,856,154100,48059
16429,9174,7255,793,91600,48060
3383,2815,568,691,188300,48062
1564,1271,293,915,226300,48063
1521,1418,103,1018,204300,48064
4174,3535,639,896,243600,48065
19956,12483,7473,955,79100,48066
12299,8214,4085,1138,219100,48067
1035,992,43,1336,332900,48069
2328,2272,56,1658,349500,48070
12816,7306,5510,923,110500,48071
6643,5460,1183,1093,188200,48072
16196,10811,5385,991,204000,48073
3548,3199,349,812,123900,48074
9220,5223,3997,1000,136000,48075
9790,7100,2690,1153,160100,48076
4917,4125,792,697,170800,48079
10522,7573,2949,986,119600,48080
8849,7347,1502,987,132400,48081
7258,6110,1148,1030,123100,48082
9224,5587,3637,1061,212400,48083
6520,3113,3407,1189,321700,48084
8620,7853,767,1407,279800,48085
8957,7250,1707,906,133000,48088
12355,6570,5785,948,63300,48089
11755,7645,4110,930,78400,48091
10390,7849,2541,931,134800,48092
10217,7776,2441,849,125600,48093
7564,6325,1239,1158,276400,48094
2054,1865,189,835,313000,48095
1598,1475,123,940,247900,48096
2030,1533,497,703,126900,48097
7004,6384,620,1237,388600,48098
10819,9139,1680,978,116800,48101
23429,15775,7654,1276,326800,48103
16436,6174,10262,1284,341200,48104
14722,7042,7680,1247,351900,48105
10862,5583,5279,972,257900,48108
0,0,0,-,-,48109
16674,11486,5188,907,156600,48111
7632,7142,490,1040,270600,48114
11097,9113,1984,987,251000,48116
3897,3531,366,913,166700,48117
5063,4085,978,1119,254800,48118
2255,863,1392,1037,160300,48120
3734,1952,1782,845,61700,48122
11863,9324,2539,1033,130000,48124
7734,5641,2093,1053,74000,48125
12851,6965,5886,988,124400,48126
12694,9119,3575,1004,131000,48127
3928,3248,680,1361,157300,48128
5752,5110,642,1145,319800,48130
2976,2219,757,831,166900,48131
2227,1894,333,1000,124400,48133
7910,6359,1551,785,174300,48134
10681,8701,1980,1037,98400,48135
2000,1918,82,1243,226700,48137
4157,3813,344,1082,275600,48138
43,43,0,-,141100,48139
1225,1110,115,691,185500,48140
9130,4145,4985,834,47000,48141
0,0,0,-,-,48143
3892,3478,414,1017,177900,48144
1273,1190,83,950,163800,48145
14265,9808,4457,848,68800,48146
10237,8694,1543,1111,156300,48150
12539,10106,2433,997,200900,48152
14331,12937,1394,1024,196800,48154
598,438,160,456,119000,48157
2964,2549,415,724,218800,48158
916,806,110,962,153900,48159
4497,3670,827,890,178300,48160
10570,7714,2856,750,118800,48161
11528,8030,3498,756,142000,48162
3103,2965,138,1171,220000,48164
2859,2184,675,1307,256400,48165
4296,3648,648,1045,125700,48166
8908,6476,2432,1177,305000,48167
8204,7428,776,1438,429000,48168
8296,7548,748,974,230000,48169
16597,12718,3879,891,292900,48170
4663,3752,911,864,163700,48173
11575,8226,3349,867,81100,48174
8378,7099,1279,852,295600,48176
46,36,10,-,95000,48177
12644,11252,1392,980,270300,48178
1415,1103,312,1088,183400,48179
23706,15436,8270,870,86300,48180
8518,7332,1186,876,169000,48182
17560,12792,4768,784,149200,48183
6724,3739,2985,754,76600,48184
21601,11994,9607,851,120400,48185
13543,9021,4522,922,103000,48186
18278,12925,5353,998,235400,48187
14887,12227,2660,1295,245400,48188
5525,4440,1085,969,196600,48189
53,53,0,-,-,48190
1558,1286,272,1335,168100,48191
11166,7959,3207,767,100900,48192
6274,4071,2203,796,140300,48193
12692,8163,4529,830,103200,48195
25262,12861,12401,945,186000,48197
15937,9063,6874,893,104600,48198
8338,647,7691,566,263600,48201
7540,2020,5520,663,92100,48202
9891,4075,5816,641,38400,48203
9535,4953,4582,757,32100,48204
12974,4792,8182,956,30800,48205
6218,2859,3359,703,49800,48206
11609,2781,8828,832,92500,48207
4101,1431,2670,613,56700,48208
9956,4937,5019,671,43300,48209
8971,4902,4069,731,33200,48210
2081,801,1280,741,33700,48211
10805,6036,4769,733,52700,48212
8087,3958,4129,678,30500,48213
9849,3893,5956,687,51900,48214
4895,2126,2769,743,56400,48215
2320,889,1431,671,93600,48216
2860,1736,1124,765,48100,48217
2870,1614,1256,658,34200,48218
19214,9981,9233,848,46100,48219
11273,6996,4277,941,144300,48220
15325,9747,5578,874,71500,48221
9847,5509,4338,818,62400,48223
14210,7985,6225,945,44300,48224
5489,3138,2351,1059,75200,48225
4045,498,3547,1294,235900,48226
15386,8152,7234,868,45400,48227
19265,9412,9853,844,33300,48228
3499,2031,1468,839,40500,48229
6454,5059,1395,1064,348200,48230
0,0,0,-,-,48233
12643,6824,5819,837,35200,48234
17745,10181,7564,917,52100,48235
11318,10049,1269,1249,265100,48236
12088,6789,5299,1047,104000,48237
10274,5089,5185,773,41200,48238
13569,9975,3594,1101,79300,48239
6722,4768,1954,1168,71700,48240
0,0,0,-,-,48242
0,0,0,-,-,48243
5468,4845,623,1626,467600,48301
6364,5511,853,994,473800,48302
6379,5845,534,1354,363100,48304
9604,8891,713,964,386500,48306
17864,11740,6124,1218,259000,48307
11188,8947,2241,1280,290900,48309
14944,10478,4466,1089,180000,48310
13507,9632,3875,913,166100,48312
13293,9539,3754,975,173500,48313
8279,6271,2008,1059,220900,48314
10723,9261,1462,1092,262500,48315
10785,8529,2256,977,245800,48316
11625,7051,4574,1002,166800,48317
2406,1639,767,935,175500,48320
12303,9132,3171,1762,277400,48322
6454,5930,524,1676,339100,48323
6477,5787,690,1249,301900,48324
9404,4346,5058,1078,147200,48326
9335,6329,3006,841,162400,48327
11030,6775,4255,837,138300,48328
9727,8299,1428,1273,163700,48329
8443,6737,1706,1468,296400,48331
7838,4742,3096,1212,231300,48334
10738,4366,6372,1083,260400,48335
10873,7319,3554,879,173800,48336
9895,4042,5853,824,56000,48340
6828,3046,3782,830,75600,48341
6495,2441,4054,746,57200,48342
8969,6500,2469,1057,208000,48346
8645,8177,468,1338,306900,48348
2693,2446,247,867,230600,48350
2489,2143,346,726,220800,48353
3266,2990,276,1016,217300,48356
3185,2909,276,902,226200,48357
3616,2568,1048,1110,247700,48359
4463,3766,697,1102,269900,48360
6018,4979,1039,949,235100,48362
2077,2012,65,-,365000,48363
1681,1548,133,1116,284400,48367
628,564,64,-,362200,48370
8892,7484,1408,940,236500,48371
5112,4549,563,1866,420300,48374
8542,5801,2741,1400,256700,48375
7659,3659,4000,1099,265600,48377
2702,2596,106,1636,285900,48380
5504,4215,1289,1059,274900,48381
8354,7781,573,1361,281000,48382
4761,4306,455,1182,231300,48383
6879,6117,762,1013,221600,48386
10369,7644,2725,1076,202400,48390
7174,3979,3195,716,219900,48393
0,0,0,-,-,48397
599,527,72,761,99800,48401
48,48,0,-,-,48411
2002,1795,207,741,167000,48412
2951,2244,707,627,106900,48413
966,840,126,974,125700,48414
3795,3112,683,798,136700,48415
1854,1563,291,616,120400,48416
1014,925,89,975,115100,48417
1480,1310,170,748,166900,48418
1009,837,172,747,106100,48419
9001,7141,1860,659,112200,48420
2462,2279,183,952,130400,48421
2576,1961,615,707,101500,48422
14076,9302,4774,706,135600,48423
397,323,74,567,105100,48426
1115,863,252,645,89500,48427
1876,1655,221,1043,224500,48428
3807,2886,921,695,105700,48429
14727,11451,3276,1008,196900,48430
303,268,35,889,103300,48432
10260,8858,1402,797,129300,48433
34,28,6,-,92500,48434
734,670,64,575,110300,48435
1438,1302,136,863,160300,48436
267,190,77,573,93800,48437
2485,2351,134,1255,210200,48438
19509,14005,5504,796,163600,48439
96,57,39,-,212500,48440
1722,1380,342,518,94700,48441
8034,6537,1497,953,172400,48442
3400,2477,923,763,161100,48444
506,418,88,612,82300,48445
12145,9598,2547,758,143200,48446
1138,953,185,794,93600,48449
2359,2051,308,662,129800,48450
5205,4762,443,784,187400,48451
1990,1499,491,622,101900,48453
470,441,29,833,103900,48454
3065,2666,399,822,246300,48455
311,294,17,538,97800,48456
3001,2651,350,662,110100,48457
7919,5143,2776,739,57500,48458
921,757,164,632,136300,48460
2941,2450,491,805,148300,48461
4832,4423,409,981,242100,48462
1788,1629,159,761,120600,48463
788,729,59,900,123100,48464
266,215,51,713,128100,48465
594,488,106,675,87300,48466
1116,971,145,638,133700,48467
545,504,41,604,93800,48468
612,494,118,540,144600,48469
348,282,66,634,97000,48470
2256,1575,681,616,90900,48471
662,562,100,847,102600,48472
8903,7574,1329,916,133000,48473
1071,901,170,660,111200,48475
202,191,11,1025,92500,48476
138,11,127,755,-,48502
11435,6273,5162,718,43000,48503
10992,6445,4547,777,33100,48504
8469,4620,3849,684,22400,48505
11518,7475,4043,711,47500,48506
13111,7798,5313,707,59800,48507
3618,3182,436,933,88800,48509
3035,2060,975,824,83400,48519
3848,2313,1535,705,46200,48529
8287,4960,3327,757,80100,48532
0,0,0,-,-,48551
0,0,0,-,-,48553
0,0,0,-,-,48554
14378,9044,5334,710,42300,48601
12234,7303,4931,711,50300,48602
11847,7678,4169,846,124900,48603
4107,2836,1271,852,81300,48604
682,299,383,608,45600,48607
5127,4538,589,732,125600,48609
1427,1246,181,750,92200,48610
2596,2071,525,767,133100,48611
3994,3309,685,626,98500,48612
414,355,59,829,109300,48613
557,468,89,808,93800,48614
1211,948,263,620,82700,48615
2987,2469,518,666,105500,48616
3317,2525,792,652,121100,48617
2133,1715,418,620,96800,48618
265,244,21,850,107400,48619
523,428,95,614,107200,48621
2505,2164,341,684,109900,48622
4721,4019,702,933,162900,48623
6658,5652,1006,584,108400,48624
5386,4388,998,586,72800,48625
2319,2066,253,720,139900,48626
33,32,1,-,-,48627
880,812,68,775,122100,48628
3270,2541,729,634,111400,48629
17,17,0,-,-,48630
1677,1486,191,642,132600,48631
2112,1830,282,754,85500,48632
95,90,5,-,127200,48633
1907,1795,112,583,122600,48634
765,660,105,742,100300,48635
390,373,17,-,86000,48636
1245,1099,146,788,107500,48637
5562,3805,1757,759,114900,48638
13377,9615,3762,704,145000,48640
13154,9709,3445,820,142900,48642
1945,1522,423,717,81500,48647
537,487,50,788,113800,48649
3062,2692,370,775,105000,48650
2364,1927,437,725,112300,48651
661,583,78,900,106400,48652
4677,4079,598,712,108400,48653
938,820,118,532,89500,48654
2455,2037,418,663,113600,48655
1756,1534,222,655,63500,48656
3384,2975,409,697,126300,48657
2106,1570,536,536,84900,48658
1050,884,166,646,86400,48659
4497,3535,962,680,110100,48661
664,586,78,958,94600,48662
0,0,0,-,-,48667
606,497,109,927,71800,48701
1487,1259,228,569,106400,48703
293,245,48,575,90900,48705
16620,13161,3459,668,104600,48706
10934,7602,3332,602,74600,48708
0,0,0,-,-,48710
452,399,53,616,85800,48720
232,229,3,-,110900,48721
1330,1145,185,725,93700,48722
4942,3783,1159,667,93500,48723
220,186,34,-,71900,48724
1098,871,227,540,116100,48725
2309,1904,405,641,98900,48726
456,414,42,980,109800,48727
132,123,9,-,103400,48728
586,548,38,798,96600,48729
2210,1566,644,604,107500,48730
685,512,173,615,84400,48731
4916,3357,1559,659,108900,48732
706,616,90,763,82600,48733
3250,2457,793,634,189500,48734
451,373,78,692,75300,48735
618,543,75,688,77900,48737
586,516,70,625,121900,48738
1972,1784,188,588,109500,48739
1060,884,176,712,108300,48740
818,678,140,627,99700,48741
801,699,102,575,97100,48742
51,46,5,-,73800,48743
1744,1467,277,806,108600,48744
548,465,83,900,86500,48745
3303,2878,425,736,123700,48746
594,557,37,-,114400,48747
895,776,119,607,89300,48748
477,428,49,709,86700,48749
3972,2935,1037,655,84600,48750
365,323,42,561,76100,48754
1392,1132,260,600,115000,48755
1979,1613,366,630,58600,48756
1550,1346,204,639,112500,48757
1421,1132,289,659,76000,48759
529,454,75,812,93900,48760
444,376,68,418,69200,48761
513,500,13,925,121300,48762
2021,1759,262,758,109500,48763
321,290,31,775,79400,48765
525,451,74,725,83800,48766
833,754,79,736,96000,48767
3853,3014,839,674,104300,48768
776,682,94,583,79300,48770
5112,3271,1841,620,92200,48801
664,566,98,692,91900,48806
347,289,58,788,86000,48807
2441,1894,547,928,176100,48808
4073,3088,985,698,112500,48809
1221,911,310,636,98400,48811
8061,6255,1806,708,137400,48813
935,820,115,791,158400,48815
25,19,6,-,79000,48816
2433,1668,765,838,110800,48817
1052,856,196,729,95600,48818
1010,902,108,930,158900,48819
6535,5226,1309,886,209100,48820
2398,2227,171,838,172800,48821
1056,1018,38,843,170600,48822
19890,8399,11491,933,191900,48823
0,0,0,-,-,48825
6270,5054,1216,782,151400,48827
1274,886,388,632,91100,48829
1391,1062,329,772,111000,48831
574,515,59,699,105700,48832
777,633,144,849,117800,48834
1075,924,151,704,152000,48835
5048,4211,837,868,168800,48836
8137,6526,1611,811,168200,48837
7395,5388,2007,702,123400,48838
5707,3624,2083,784,176700,48840
288,267,21,878,109600,48841
9001,6386,2615,846,154800,48842
17198,13024,4174,1016,228000,48843
347,289,58,646,93100,48845
6240,4300,1940,812,107500,48846
2368,1791,577,810,101200,48847
2986,2672,314,808,170300,48848
2340,1888,452,686,126700,48849
1684,1361,323,608,99800,48850
839,676,163,722,104200,48851
62,41,21,740,48300,48852
259,200,59,568,90000,48853
7345,5805,1540,979,163300,48854
5587,4998,589,1145,222600,48855
397,246,151,667,80500,48856
1055,848,207,833,122300,48857
17224,8755,8469,737,136500,48858
607,450,157,662,100800,48860
573,482,91,655,123000,48861
9088,5692,3396,986,239000,48864
783,555,228,813,97100,48865
1913,1596,317,641,119200,48866
11338,7974,3364,678,102700,48867
63,40,23,-,72900,48870
790,640,150,767,119400,48871
2680,2091,589,821,135800,48872
480,428,52,623,136400,48873
34,34,0,-,93300,48874
3822,3138,684,855,145900,48875
1629,1245,384,834,126400,48876
948,810,138,767,81200,48877
579,495,84,575,116300,48878
6794,5318,1476,774,150600,48879
2446,1706,740,629,90600,48880
2354,1973,381,548,145500,48881
2712,2256,456,645,115200,48883
1701,1434,267,727,105800,48884
348,292,56,488,110800,48885
770,657,113,667,84900,48886
2407,1970,437,672,112900,48888
552,467,85,838,100100,48889
829,699,130,675,140700,48890
1134,893,241,673,126300,48891
1710,1423,287,900,134400,48892
2085,1819,266,726,129300,48893
624,556,68,669,168100,48894
4507,3632,875,786,210400,48895
89,76,13,-,49200,48896
544,440,104,647,146500,48897
10245,6778,3467,798,94300,48906
15738,8520,7218,846,77200,48910
16131,8368,7763,766,87100,48911
7799,3466,4333,852,95900,48912
3827,1952,1875,858,76100,48915
14547,8294,6253,873,143700,48917
0,0,0,-,-,48921
1468,84,1384,701,111500,48933
8583,4426,4157,791,89000,49001
8484,5671,2813,704,145500,49002
6380,4790,1590,900,114200,49004
10204,3967,6237,814,126800,49006
4226,1201,3025,716,61400,49007
6702,3943,2759,739,153800,49008
18741,12195,6546,819,218800,49009
6788,5337,1451,848,129700,49010
812,713,99,626,110100,49011
1375,1185,190,796,178600,49012
1964,1520,444,680,94700,49013
8241,6058,2183,788,117700,49014
11078,7405,3673,860,117900,49015
8862,6660,2202,777,98700,49017
2495,2098,397,783,123800,49021
13134,7294,5840,686,96000,49022
11622,7991,3631,875,166700,49024
946,722,224,766,116300,49026
45,32,13,744,94000,49027
2517,1917,600,688,101200,49028
570,513,57,592,107400,49029
829,668,161,646,88500,49030
2980,2155,825,708,136200,49031
1110,895,215,630,121800,49032
666,595,71,780,182100,49033
1073,920,153,690,147100,49034
8970,6335,2635,722,109500,49036
8647,4453,4194,639,66300,49037
3947,2871,1076,757,130400,49038
1351,933,418,726,118700,49040
1945,1490,455,626,109200,49042
830,526,304,704,99400,49043
1994,1519,475,670,105700,49045
3411,2938,473,813,149400,49046
6289,4515,1774,594,110500,49047
9933,6098,3835,799,100600,49048
647,605,42,700,122800,49050
910,825,85,858,155900,49051
368,296,72,683,112500,49052
2720,2144,576,652,152100,49053
2355,2007,348,700,120200,49055
1369,1168,201,844,81900,49056
2210,1607,603,670,84100,49057
7659,5996,1663,811,131900,49058
663,545,118,518,299600,49060
616,554,62,1007,130800,49061
1410,1141,269,618,128300,49064
2549,2156,393,712,135500,49065
243,207,36,814,125500,49066
1719,1491,228,878,128300,49067
6226,4643,1583,721,140400,49068
1028,925,103,706,133500,49070
3452,3083,369,865,194600,49071
1216,1022,194,725,135300,49072
1952,1457,495,805,113700,49073
54,0,54,486,-,49074
46,24,22,-,84700,49075
1455,1151,304,766,145700,49076
3667,2900,767,699,135300,49078
5239,4026,1213,684,139400,49079
6047,5009,1038,753,152500,49080
2262,1900,362,747,100400,49082
2975,2509,466,731,218000,49083
8,0,8,-,-,49084
10307,7760,2547,794,195200,49085
2355,2163,192,692,200300,49087
1450,1300,150,1104,184300,49088
662,505,157,694,82700,49089
6045,4326,1719,711,163300,49090
7904,5656,2248,721,109600,49091
788,615,173,775,102600,49092
7273,5383,1890,709,118900,49093
1622,1268,354,641,89900,49094
876,739,137,848,198000,49095
1187,1014,173,838,124600,49096
4254,3629,625,722,166700,49097
2365,1824,541,645,109900,49098
2263,1680,583,636,119800,49099
1301,1086,215,842,161900,49101
543,399,144,900,187500,49102
3588,2071,1517,685,158500,49103
0,0,0,-,-,49104
2243,1721,522,749,177600,49106
4214,3037,1177,633,125200,49107
1354,1166,188,797,124700,49111
3877,3310,567,856,152800,49112
768,641,127,781,131900,49113
230,230,0,-,385000,49115
115,115,0,-,396300,49116
1708,1341,367,906,293200,49117
57,47,10,-,85200,49119
14942,10871,4071,679,113200,49120
1103,953,150,819,185300,49125
469,399,70,728,131700,49126
4434,3459,975,884,185400,49127
1478,1169,309,780,157300,49128
310,283,27,-,366300,49129
630,523,107,939,283800,49130
15673,11537,4136,737,144400,49201
8557,4456,4101,713,68800,49202
15677,10411,5266,823,95500,49203
1018,821,197,713,144500,49220
14651,10209,4442,747,113000,49221
5185,3616,1569,662,74600,49224
473,403,70,719,89900,49227
2178,1723,455,852,133000,49228
1211,1090,121,667,175900,49229
4401,3889,512,734,171700,49230
944,757,187,766,133300,49232
1086,936,150,735,157200,49233
1152,1060,92,826,191200,49234
816,662,154,695,117900,49235
1883,1615,268,756,152700,49236
1130,940,190,741,133800,49237
634,469,165,833,124900,49238
3506,3162,344,900,210900,49240
969,861,108,744,133900,49241
5661,3823,1838,664,104500,49242
1826,1344,482,695,95300,49245
1363,1264,99,665,159500,49246
2273,1804,469,831,101800,49247
305,254,51,906,109600,49248
1589,1372,217,772,156300,49249
2433,1959,474,742,104500,49250
2273,1947,326,833,129400,49251
1036,737,299,673,102100,49252
1270,1156,114,680,182300,49253
1378,1107,271,805,112000,49254
722,578,144,869,85500,49255
1583,1196,387,786,86900,49256
900,819,81,1065,121600,49259
88,68,20,-,-,49261
490,354,136,661,80400,49262
29,21,8,-,-,49263
721,664,57,873,148800,49264
2129,1879,250,839,191600,49265
1269,1046,223,684,107500,49266
1524,1273,251,920,177400,49267
492,367,125,633,100200,49268
2219,1888,331,693,125600,49269
2144,1881,263,852,171300,49270
768,644,124,746,117200,49271
1044,974,70,709,172500,49272
1297,1035,262,754,113500,49274
345,324,21,972,120100,49276
1421,1241,180,914,135100,49277
331,271,60,975,122700,49279
143,120,23,845,-,49282
1175,895,280,571,158800,49283
1212,942,270,849,106000,49284
2138,1779,359,692,160600,49285
5845,4579,1266,798,148300,49286
803,749,54,692,194800,49287
527,407,120,631,74900,49288
79,51,28,907,51700,49289
6763,6377,386,1396,358900,49301
2938,2797,141,1013,252900,49302
342,300,42,740,116000,49303
1566,1153,413,566,78700,49304
910,746,164,633,89800,49305
3892,3711,181,696,214100,49306
7001,4038,2963,642,124900,49307
731,599,132,777,84500,49309
1100,985,115,636,115400,49310
124,110,14,525,83300,49312
8081,7034,1047,919,228100,49315
8080,6997,1083,1067,232700,49316
564,516,48,800,146100,49318
6313,5394,919,755,145300,49319
44,44,0,-,63100,49320
6816,4213,2603,814,159100,49321
482,382,100,768,110000,49322
3514,3306,208,839,176800,49323
662,587,75,740,147000,49325
1695,1479,216,722,120800,49326
3112,2482,630,716,120500,49327
1456,1281,175,648,149000,49328
3028,2640,388,744,114300,49329
1828,1538,290,748,141700,49330
6485,5315,1170,925,189500,49331
1183,1013,170,593,101200,49332
4234,3556,678,979,175600,49333
151,151,0,-,162700,49335
1530,1315,215,754,97300,49336
4950,4054,896,750,112600,49337
698,583,115,823,104600,49338
810,709,101,791,134400,49339
1061,838,223,538,105500,49340
12712,11596,1116,934,223900,49341
704,543,161,711,113800,49342
2101,1770,331,725,129700,49343
1337,1111,226,811,170500,49344
5095,4226,869,756,161900,49345
2344,2210,134,817,161900,49346
505,424,81,747,101100,49347
4596,3530,1066,815,162800,49348
3065,2517,548,671,87300,49349
6631,3251,3380,917,184200,49401
586,493,93,800,106400,49402
950,879,71,923,225500,49403
3023,2520,503,704,155400,49404
574,511,63,688,121000,49405
405,312,93,1115,345300,49406
3773,3204,569,738,143000,49408
822,667,155,758,94600,49410
621,586,35,763,132700,49411
4417,3531,886,586,121100,49412
2612,2360,252,932,153900,49415
12395,9790,2605,843,177800,49417
10770,8203,2567,822,180400,49418
2752,2579,173,991,191700,49419
2350,1734,616,657,102300,49420
2286,1964,322,740,88700,49421
16582,11412,5170,829,156800,49423
17783,13361,4422,894,174800,49424
1334,1066,268,795,106000,49425
12406,11191,1215,907,204900,49426
10080,8573,1507,844,168200,49428
7548,5563,1985,707,148600,49431
6,6,0,-,-,49434
1333,1245,88,740,172900,49435
669,603,66,577,167900,49436
2769,2259,510,702,128100,49437
686,119,567,534,113600,49440
15406,10482,4924,788,112600,49441
15087,9858,5229,691,73400,49442
9949,7056,2893,743,84700,49444
8134,7378,756,824,137300,49445
967,871,96,723,111100,49446
1478,1373,105,770,192800,49448
1169,1018,151,738,217600,49449
997,589,408,718,116800,49450
2109,1862,247,650,133500,49451
678,600,78,668,86300,49452
1163,963,200,700,299200,49453
1679,1377,302,695,116800,49454
1861,1391,470,712,103900,49455
7848,6185,1663,827,192200,49456
3757,3248,509,766,123400,49457
48,43,5,-,116400,49458
503,406,97,747,82000,49459
2998,2804,194,970,219400,49460
3561,2916,645,689,153000,49461
9843,8653,1190,882,181500,49464
15593,6091,9502,868,133600,49503
15189,9197,5992,859,126400,49504
13150,8559,4591,885,133700,49505
12242,9042,3200,926,223700,49506
12151,6882,5269,896,95100,49507
14996,8805,6191,909,148700,49508
9964,6797,3167,761,99600,49509
7540,3146,4394,862,183000,49512
11315,6180,5135,863,130800,49519
11299,8961,2338,930,180300,49525
8798,6009,2789,859,173800,49534
4028,2254,1774,852,154900,49544
12866,8580,4286,989,265700,49546
11979,8123,3856,835,89500,49548
8711,6508,2203,678,101100,49601
98,88,10,-,62900,49611
529,479,50,1031,150600,49612
292,268,24,683,168300,49613
1044,967,77,893,134600,49614
1682,1439,243,650,200800,49615
738,583,155,614,140500,49616
1284,1191,93,596,183100,49617
278,254,24,917,105600,49618
401,348,53,900,107600,49619
1017,843,174,938,129500,49620
1372,1243,129,1183,223200,49621
1126,952,174,597,129200,49622
412,388,24,825,82900,49623
462,422,40,825,107900,49625
167,161,6,-,81300,49626
77,66,11,-,-,49627
74,71,3,-,114700,49628
1034,810,224,799,226600,49629
649,583,66,517,273700,49630
2413,1922,491,542,94500,49631
450,361,89,772,97400,49632
1567,1373,194,727,107800,49633
22,22,0,-,81700,49634
1480,1275,205,675,217600,49635
201,201,0,-,712200,49636
1369,1217,152,949,137200,49637
352,302,50,503,95600,49638
868,728,140,768,97000,49639
627,589,38,861,181300,49640
346,253,93,463,68100,49642
2562,2304,258,872,164800,49643
912,864,48,625,92900,49644
614,536,78,750,93600,49645
3524,2627,897,691,101400,49646
955,897,58,781,356000,49648
2219,1939,280,871,151900,49649
1151,1092,59,879,174200,49650
3315,2654,661,783,106600,49651
811,683,128,831,260400,49653
317,259,58,925,396500,49654
1213,1079,134,742,102600,49655
572,511,61,739,81700,49656
1328,1072,256,697,122700,49657
2621,2258,363,721,86900,49659
5631,4359,1272,686,123700,49660
2232,1791,441,727,105500,49663
860,764,96,768,235300,49664
1662,1381,281,606,83900,49665
69,69,0,-,-,49666
250,207,43,825,83800,49667
1322,1026,296,788,91000,49668
937,841,96,675,291300,49670
28,28,0,-,225000,49674
414,353,61,604,208800,49675
1473,1270,203,695,168400,49676
2877,2249,628,620,86100,49677
479,439,40,742,113300,49679
701,592,109,732,102800,49680
1644,1354,290,604,268700,49682
780,668,112,708,114200,49683
16619,12247,4372,962,213500,49684
14058,10593,3465,914,213800,49686
985,880,105,679,121900,49688
584,537,47,645,97800,49689
2802,2279,523,1050,233300,49690
483,314,169,691,159600,49701
354,273,81,682,102700,49705
1835,1483,352,697,125000,49706
9970,7458,2512,572,94000,49707
1617,1437,180,510,94900,49709
219,160,59,509,134100,49710
3462,2821,641,766,164500,49712
871,755,116,880,144400,49713
1292,1088,204,490,122900,49715
342,321,21,950,216800,49716
86,86,0,-,363600,49717
312,275,37,1000,119500,49718
649,511,138,565,170300,49719
3974,3048,926,679,178700,49720
6241,5019,1222,667,118500,49721
142,117,25,-,153300,49722
404,375,29,829,139100,49724
330,310,20,563,99000,49725
550,485,65,530,160600,49726
3018,2556,462,684,131100,49727
115,95,20,775,118000,49728
657,555,102,808,130700,49729
817,739,78,778,118800,49730
879,756,123,873,109200,49733
7970,6183,1787,776,141200,49735
233,216,17,595,110000,49736
4142,3210,932,742,101000,49738
3232,2783,449,952,236000,49740
332,308,24,600,111600,49743
355,338,17,547,99700,49744
465,379,86,731,130200,49745
1491,1268,223,580,96900,49746
820,705,115,675,138200,49747
83,72,11,544,100000,49748
1864,1499,365,619,148700,49749
889,803,86,779,131600,49751
233,181,52,-,83700,49752
891,845,46,517,104500,49753
884,740,144,772,145100,49755
1697,1484,213,811,101100,49756
447,189,258,576,378000,49757
726,689,37,763,119100,49759
320,293,27,1225,122300,49760
343,301,42,914,119400,49762
104,27,77,639,-,49764
1678,1487,191,585,89000,49765
906,716,190,520,94200,49766
190,159,31,-,129000,49768
686,522,164,865,101300,49769
7471,4918,2553,809,190800,49770
754,651,103,763,126000,49774
50,47,3,-,157500,49775
808,687,121,600,100100,49776
830,806,24,890,183000,49777
1989,1673,316,528,85800,49779
681,611,70,919,101500,49780
1839,1209,630,578,124200,49781
272,242,30,619,202800,49782
7963,4917,3046,692,108300,49783
1067,444,623,647,78300,49788
132,106,26,419,125000,49791
122,103,19,-,165600,49793
858,671,187,670,100200,49795
208,161,47,784,-,49796
868,775,93,813,107200,49799
4720,3724,996,655,117800,49801
2764,1878,886,650,89000,49802
145,132,13,-,135900,49805
216,207,9,825,182300,49806
1394,1216,178,589,128800,49807
125,112,13,-,178100,49808
388,334,54,588,110500,49812
560,506,54,705,94200,49814
165,140,25,469,74000,49815
296,281,15,754,131300,49816
244,227,17,664,152200,49817
433,407,26,813,139800,49818
9,9,0,-,39200,49819
141,99,42,520,146100,49820
602,534,68,632,97400,49821
94,79,15,-,113100,49822
85,80,5,-,150000,49825
89,74,15,-,137500,49826
407,341,66,672,116100,49827
7748,5419,2329,556,97700,49829
336,328,8,970,111800,49831
148,126,22,-,164200,49833
78,74,4,-,121700,49834
405,374,31,1050,120100,49835
381,355,26,408,123400,49836
3991,3504,487,538,112600,49837
235,207,28,994,122300,49838
166,131,35,586,180400,49839
270,248,22,700,135000,49840
2897,1857,1040,642,117000,49841
449,340,109,538,86000,49847
45,45,0,-,129800,49848
5093,4044,1049,576,104500,49849
48,41,7,588,86300,49852
529,492,37,665,114300,49853
2613,2081,532,630,107400,49854
12431,7375,5056,763,182000,49855
5741,4238,1503,561,90400,49858
254,240,14,-,145000,49861
1493,1195,298,622,112600,49862
69,69,0,-,41700,49863
41,34,7,-,57100,49864
3147,2500,647,624,143800,49866
1695,1314,381,718,77000,49868
1636,1242,394,821,94600,49870
207,176,31,588,62800,49871
73,59,14,764,109400,49872
50,50,0,-,152500,49873
337,251,86,495,98800,49874
463,423,40,715,86100,49876
8,7,1,-,-,49877
1500,1325,175,566,135000,49878
458,422,36,525,69400,49879
451,404,47,658,97400,49880
121,99,22,850,121300,49881
50,47,3,-,56400,49883
124,112,12,-,-,49884
881,801,80,775,152400,49885
246,205,41,844,81300,49886
1109,921,188,616,105400,49887
220,202,18,800,113000,49891
804,725,79,623,150900,49892
722,645,77,560,124300,49893
266,244,22,-,103300,49894
282,257,25,-,166200,49895
604,446,158,444,113400,49896
118,114,4,-,52000,49901
73,69,4,325,39600,49902
56,41,15,335,67900,49903
601,528,73,843,129900,49905
894,632,262,525,110900,49908
161,155,6,-,108100,49910
1204,934,270,389,66100,49911
449,400,49,525,97500,49912
2764,2149,615,517,68100,49913
206,170,36,688,44000,49915
1056,888,168,691,156400,49916
92,87,5,725,50300,49917
50,41,9,-,232500,49918
94,88,6,-,84000,49919
1891,1624,267,573,92400,49920
169,87,82,1278,131000,49921
295,225,70,763,115400,49922
207,185,22,380,76800,49925
209,195,14,830,56500,49927
76,74,2,-,55300,49929
2688,1601,1087,666,122700,49930
3148,1301,1847,690,155000,49931
322,282,40,720,65700,49934
2858,2172,686,469,75200,49935
3509,2682,827,501,65300,49938
105,76,29,-,58700,49942
1115,942,173,493,118000,49945
1598,1299,299,564,90400,49946
264,252,12,-,135700,49947
234,217,17,-,60300,49948
650,555,95,396,110300,49950
47,43,4,-,132300,49952
1244,1034,210,509,68100,49953
157,152,5,-,55400,49955
360,346,14,850,149000,49958
167,124,43,475,46800,49959
77,70,7,-,51400,49960
41,39,2,-,61700,49961
105,105,0,-,122500,49962
380,307,73,571,75300,49963
196,195,1,-,90500,49965
216,200,16,-,86700,49967
935,768,167,532,63800,49968
574,480,94,550,154800,49969
119,113,6,-,88900,49970
223,213,10,570,42700,49971
254,218,36,850,260900,50001
613,442,171,821,122000,50002
2798,2293,505,695,239600,50003
361,317,44,750,96700,50005
689,520,169,575,100000,50006
161,161,0,-,171100,50007
393,319,74,416,58000,50008
7037,5185,1852,924,194300,50009
14588,7644,6944,842,186800,50010
0,0,0,-,-,50011
7,0,7,-,-,50012
12311,3999,8312,955,245900,50014
590,447,143,678,78900,50020
10444,7704,2740,1155,204200,50021
3835,2539,1296,650,112900,50022
13280,10244,3036,937,218900,50023
1475,1122,353,668,69900,50025
276,233,43,633,83500,50026
127,96,31,608,64500,50027
665,514,151,938,133100,50028
232,193,39,660,52100,50029
133,133,0,-,-,50032
8,4,4,-,-,50033
155,122,33,568,86000,50034
2492,2132,360,1028,220600,50035
6896,5173,1723,721,123500,50036
50,50,0,-,119600,50038
137,117,20,597,226300,50039
34,34,0,-,-,50041
126,108,18,525,75000,50042
374,272,102,514,75600,50044
573,481,92,918,162800,50046
2283,1851,432,766,161800,50047
325,262,63,775,71500,50048
2755,2022,733,663,87500,50049
327,242,85,539,62900,50050
119,79,40,388,75800,50051
62,56,6,-,78300,50052
1137,919,218,645,134500,50054
326,243,83,867,146600,50055
532,427,105,810,127000,50056
95,95,0,-,93000,50057
785,636,149,622,106400,50058
1058,857,201,568,88100,50060
653,606,47,881,361000,50061
274,207,67,600,108900,50062
927,735,192,694,199800,50063
79,66,13,-,105500,50064
311,201,110,-,70800,50065
81,65,16,908,85000,50066
113,87,26,638,49000,50067
130,122,8,-,-,50068
405,330,75,689,133100,50069
633,545,88,667,141900,50070
485,405,80,570,70200,50071
936,728,208,809,202800,50072
460,350,110,900,157200,50073
197,176,21,-,341300,50074
328,247,81,847,92100,50075
691,554,137,506,66900,50076
80,56,24,1264,38600,50078
11,8,3,-,93300,50101
48,48,0,-,58600,50102
186,156,30,450,76300,50103
37,26,11,-,64000,50104
339,279,60,690,194900,50105
360,274,86,600,96600,50106
469,351,118,613,68800,50107
207,163,44,475,69000,50108
1200,1070,130,1017,250500,50109
5107,3872,1235,959,222000,50111
4681,2995,1686,722,151500,50112
1125,811,314,620,98000,50115
100,99,1,-,64200,50116
62,48,14,-,216700,50117
385,379,6,1125,120800,50118
146,103,43,725,-,50119
139,129,10,-,97500,50120
519,429,90,539,96500,50122
341,268,73,413,68800,50123
1451,1189,262,912,193000,50124
7805,5559,2246,770,174200,50125
2887,2153,734,714,98400,50126
8,8,0,-,-,50127
166,127,39,563,102800,50128
2077,1493,584,585,110200,50129
624,517,107,758,108100,50130
8205,6001,2204,1133,248400,50131
98,81,17,725,53100,50132
175,122,53,590,73200,50133
260,185,75,687,201900,50134
626,526,100,752,119400,50135
182,137,45,669,87700,50136
4974,3554,1420,640,109400,50138
494,433,61,638,121800,50139
1013,547,466,562,91500,50140
197,164,33,570,98000,50141
367,271,96,693,125200,50142
247,193,54,532,140300,50143
1114,728,386,508,79600,50144
199,193,6,488,105500,50146
140,118,22,481,60000,50147
183,153,30,589,108700,50148
381,317,64,719,136900,50149
445,397,48,653,83300,50150
241,215,26,956,124000,50151
334,249,85,665,143300,50153
175,139,36,913,119200,50154
148,101,47,763,73000,50155
1881,1580,301,759,149400,50156
340,274,66,682,90000,50157
11747,8054,3693,682,103400,50158
192,127,65,684,121100,50160
758,645,113,807,159200,50161
520,390,130,692,118200,50162
393,260,133,590,68200,50163
207,155,52,457,85600,50164
60,58,2,-,-,50165
637,561,76,690,133400,50166
244,193,51,667,127000,50167
304,254,50,685,167700,50168
1002,629,373,783,160200,50169
1154,971,183,615,139100,50170
1112,869,243,709,173700,50171
350,261,89,910,126200,50173
597,504,93,775,86300,50174
3353,2506,847,680,145300,50201
193,157,36,486,78300,50206
852,724,128,742,132500,50207
8061,5646,2415,728,116000,50208
666,602,64,748,205000,50210
4984,3892,1092,813,206100,50211
1309,1055,254,774,128600,50212
2821,1862,959,751,105000,50213
316,234,82,-,220800,50214
1049,886,163,741,213900,50216
290,205,85,646,67000,50217
77,57,20,933,66400,50218
5128,3372,1756,879,196100,50219
3468,2149,1319,756,96400,50220
184,182,2,-,160000,50222
281,208,73,475,107400,50223
1207,924,283,627,154500,50225
1988,1754,234,1163,253600,50226
9,8,1,-,26700,50227
1053,797,256,783,146100,50228
313,303,10,-,289700,50229
446,363,83,402,111400,50230
71,57,14,750,107600,50231
164,122,42,792,127300,50232
562,500,62,914,152100,50233
242,222,20,550,116100,50234
174,135,39,883,82300,50235
612,504,108,661,161300,50236
1259,1134,125,580,244900,50237
474,421,53,643,85000,50238
35,22,13,-,44000,50239
1145,950,195,928,193000,50240
195,154,41,625,133000,50242
78,71,7,694,99200,50243
689,572,117,758,167400,50244
282,211,71,580,99500,50246
922,756,166,655,142300,50247
1758,1244,514,763,175900,50248
523,411,112,792,111200,50249
923,704,219,710,105600,50250
525,397,128,725,127800,50251
76,66,10,-,171300,50252
102,102,0,-,121300,50254
37,37,0,-,44200,50255
175,145,30,-,96900,50256
403,316,87,834,125000,50257
405,327,78,541,71400,50258
921,789,132,994,196300,50261
172,158,14,1094,71300,50262
9219,6895,2324,1124,233200,50263
186,142,44,-,64600,50264
13391,8803,4588,897,189400,50265
13080,7247,5833,1057,237800,50266
441,314,127,717,59100,50268
245,190,55,1024,78800,50271
52,44,8,-,51800,50272
3331,2506,825,782,163000,50273
115,70,45,625,75000,50274
271,222,49,581,133700,50275
902,692,210,767,170300,50276
182,126,56,579,94200,50277
322,258,64,663,122400,50278
4293,446,3847,821,290400,50309
13186,8779,4407,849,147900,50310
5745,2878,2867,723,143000,50311
7607,4527,3080,793,200400,50312
6543,4678,1865,883,105300,50313
3947,1625,2322,757,88600,50314
14183,9012,5171,787,113600,50315
5668,3255,2413,793,88800,50316
14541,10134,4407,877,113800,50317
0,0,0,-,-,50319
7647,5198,2449,862,153900,50320
3408,2023,1385,866,195800,50321
12982,9318,3664,885,185200,50322
4864,4572,292,1473,330500,50323
2160,1568,592,867,181000,50324
6539,5199,1340,893,251800,50325
4266,3269,997,1019,199100,50327
13041,8596,4445,708,114700,50401
130,105,25,450,74400,50420
1335,980,355,587,92100,50421
1154,904,250,553,86600,50423
618,513,105,535,67600,50424
24,17,7,-,54100,50426
4147,2988,1159,644,168900,50428
208,153,55,557,59000,50430
85,69,16,494,55000,50431
128,93,35,546,60800,50432
128,123,5,-,114400,50433
175,140,35,575,88200,50434
281,245,36,666,103700,50435
2394,1793,601,535,105000,50436
1726,1350,376,622,145900,50438
88,76,12,-,48700,50439
221,162,59,475,97500,50440
2195,1542,653,706,86800,50441
152,131,21,675,143800,50444
208,159,49,568,122300,50446
537,398,139,607,64200,50447
297,249,48,575,89200,50448
326,219,107,541,61100,50449
1294,863,431,608,106600,50450
230,190,40,742,53200,50451
370,239,131,621,105100,50452
235,202,33,628,122800,50453
40,40,0,-,87100,50454
173,166,7,642,125000,50455
754,530,224,563,87100,50456
159,141,18,721,81600,50457
936,809,127,637,104700,50458
1281,1010,271,670,114000,50459
170,156,14,-,190600,50460
2398,1945,453,565,116700,50461
226,180,46,750,98800,50464
95,67,28,650,34200,50465
587,506,81,595,101200,50466
43,38,5,581,112500,50467
631,516,115,481,150000,50468
601,520,81,445,132500,50469
117,80,37,595,60800,50470
285,209,76,592,85400,50471
941,773,168,540,132400,50472
128,122,6,-,58500,50473
651,547,104,597,98300,50475
338,283,55,560,77400,50476
108,92,16,538,66000,50477
387,303,84,731,82300,50478
279,205,74,523,72600,50479
347,302,45,727,61500,50480
368,313,55,789,147300,50482
286,240,46,477,93300,50483
174,143,31,483,61400,50484
11532,7470,4062,632,98900,50501
448,346,102,538,72600,50510
3240,2273,967,675,146400,50511
684,510,174,584,80000,50514
115,89,26,425,45300,50515
254,219,35,494,91300,50516
450,348,102,509,88000,50517
162,139,23,730,111200,50518
259,206,53,492,73100,50519
42,37,5,-,-,50520
106,59,47,-,-,50521
350,317,33,591,73800,50522
265,178,87,786,72400,50523
244,175,69,746,115700,50524
1558,1098,460,676,89000,50525
101,84,17,-,60000,50527
136,83,53,650,63600,50528
347,279,68,735,83100,50529
466,342,124,535,115000,50530
119,97,22,-,101700,50531
344,259,85,488,121900,50532
1742,1145,597,626,83800,50533
443,296,147,598,83500,50535
1831,1341,490,625,117500,50536
238,178,60,522,72700,50538
224,189,35,661,65900,50539
399,336,63,484,75200,50540
365,290,75,561,77500,50541
411,324,87,658,68400,50542
612,490,122,541,99400,50543
165,121,44,525,67500,50544
91,88,3,-,85700,50545
127,111,16,-,60800,50546
2552,1747,805,549,127800,50548
45,32,13,-,101700,50551
767,584,183,579,68100,50554
105,97,8,421,54200,50556
354,268,86,673,83100,50557
264,241,23,536,66500,50558
129,90,39,583,57500,50559
267,179,88,665,49500,50560
168,123,45,471,44600,50561
172,144,28,719,61300,50562
1167,897,270,575,97300,50563
178,150,28,617,51800,50565
176,153,23,544,115300,50566
132,110,22,619,115900,50567
645,506,139,625,101000,50568
323,255,68,544,72700,50569
83,64,19,1054,82500,50570
182,147,35,417,77000,50571
35,31,4,-,41700,50573
985,769,216,530,82400,50574
451,342,109,489,61000,50575
142,103,39,429,92500,50576
178,150,28,472,58700,50577
303,223,80,525,42000,50578
998,761,237,574,75500,50579
388,231,157,610,47000,50581
128,103,25,663,61500,50582
1251,891,360,660,89200,50583
530,415,115,734,93300,50585
128,115,13,745,83000,50586
4381,2589,1792,691,132300,50588
400,330,70,754,53900,50590
153,127,26,1075,88200,50591
18,18,0,-,22500,50593
98,74,24,565,88200,50594
3916,2720,1196,653,99500,50595
546,411,135,653,125200,50597
394,332,62,565,88700,50598
189,140,49,491,85000,50599
1101,858,243,537,86300,50601
632,452,180,527,104800,50602
233,194,39,450,77100,50603
801,673,128,615,118300,50604
120,72,48,639,-,50605
307,241,66,556,84000,50606
175,153,22,525,120500,50607
194,162,32,713,116700,50609
150,114,36,666,77300,50611
169,156,13,-,234300,50612
16270,10652,5618,847,186300,50613
4365,2923,1442,558,107100,50616
983,717,266,605,119400,50619
19,17,2,-,-,50620
645,462,183,698,130400,50621
1283,1092,191,611,200600,50622
668,539,129,648,191200,50624
442,357,85,595,61200,50625
678,558,120,639,160600,50626
1264,953,311,552,96200,50627
487,402,85,550,86100,50628
817,710,107,695,146000,50629
813,657,156,604,97300,50630
466,414,52,567,84400,50632
165,138,27,904,86000,50633
350,275,75,556,147500,50634
663,524,139,539,99100,50635
824,690,134,496,97800,50636
1424,1119,305,564,122500,50638
566,399,167,607,98100,50641
201,149,52,734,108900,50642
1077,939,138,791,193000,50643
3565,2679,886,733,144800,50644
456,376,80,428,102600,50645
816,721,95,587,218300,50647
1571,1311,260,596,168400,50648
347,273,74,670,86600,50650
1370,1125,245,683,136400,50651
45,33,12,725,47500,50652
235,186,49,546,83300,50653
167,138,29,350,132500,50654
316,271,45,575,88800,50655
991,810,181,499,115800,50658
2324,1803,521,698,118300,50659
504,401,103,713,124000,50660
2954,2020,934,655,82700,50662
38,38,0,-,49500,50664
1240,999,241,569,148900,50665
409,343,66,589,124300,50666
301,271,30,475,174200,50667
451,415,36,525,142200,50668
984,777,207,617,131900,50669
900,747,153,582,139100,50670
89,72,17,-,76900,50671
259,197,62,584,98500,50672
69,55,14,775,85600,50673
1513,1297,216,604,127000,50674
989,709,280,840,124100,50675
867,707,160,555,105300,50676
4586,3601,985,692,177200,50677
511,442,69,486,88800,50680
195,173,22,706,86200,50681
669,525,144,489,125900,50682
13051,8579,4472,722,150000,50701
8388,5332,3056,744,113300,50702
7724,4411,3313,739,74300,50703
3443,2350,1093,771,108700,50707
3965,2675,1290,610,99100,50801
706,527,179,642,102800,50830
966,768,198,613,78800,50833
45,45,0,-,95000,50835
135,110,25,421,54000,50836
156,134,22,800,-,50837
22,22,0,-,-,50839
199,165,34,703,64400,50840
1117,862,255,477,85300,50841
40,38,2,-,76700,50842
206,150,56,600,78500,50843
303,234,69,721,69100,50845
422,320,102,547,76800,50846
49,43,6,-,37300,50847
159,132,27,613,63300,50848
1122,863,259,483,98500,50849
876,594,282,498,93200,50851
300,215,85,558,80300,50853
1054,795,259,615,90500,50854
125,111,14,-,162500,50857
330,271,59,580,90200,50858
262,209,53,730,71300,50859
90,79,11,446,-,50860
111,104,7,765,101100,50861
66,53,13,750,46900,50862
95,58,37,708,65000,50863
915,672,243,565,68600,50864
935,737,198,630,117500,51001
1163,853,310,700,115100,51002
678,573,105,727,135800,51003
434,355,79,668,87600,51004
641,540,101,593,108200,51005
430,336,94,471,63200,51006
204,188,16,725,157500,51007
61,55,6,-,93800,51008
72,61,11,475,55500,51009
169,136,33,900,78600,51010
33,25,8,-,-,51011
2902,1988,914,565,96300,51012
199,163,36,688,88300,51014
519,471,48,536,82300,51016
113,94,19,488,56000,51018
341,285,56,471,98200,51019
265,225,40,525,70300,51020
270,218,52,591,106300,51022
1226,989,237,600,89800,51023
754,629,125,781,193200,51024
859,695,164,628,100100,51025
318,274,44,-,131600,51026
530,416,114,770,113300,51027
867,655,212,617,147200,51028
153,138,15,344,82500,51029
644,564,80,504,172400,51030
5010,3787,1223,683,156000,51031
188,135,53,675,57800,51033
810,638,172,548,89900,51034
801,618,183,605,112300,51035
307,270,37,-,211300,51036
180,130,50,530,77500,51037
715,624,91,724,150000,51038
1009,757,252,729,153000,51039
1614,953,661,579,97300,51040
2361,1906,455,665,164700,51041
108,79,29,600,105800,51044
796,637,159,671,108900,51046
303,256,47,500,70000,51047
251,169,82,625,73600,51048
226,204,22,325,51700,51049
1024,803,221,579,149400,51050
35,25,10,400,55000,51051
367,273,94,648,149000,51052
439,365,74,586,82500,51053
2107,1656,451,891,226500,51054
602,481,121,694,151100,51055
140,118,22,767,71400,51056
377,288,89,608,63000,51058
286,219,67,542,63900,51060
189,167,22,400,118800,51061
218,168,50,700,107100,51062
483,371,112,681,92300,51063
423,44,379,446,207700,51101
5899,3608,2291,765,84900,51103
8512,5376,3136,824,135200,51104
3814,1757,2057,648,70000,51105
10616,7218,3398,777,131900,51106
2007,1704,303,805,137500,51108
1206,762,444,719,94200,51109
82,0,82,743,-,51111
2560,1628,932,560,144500,51201
118,109,9,575,99000,51230
144,97,47,563,98800,51231
317,247,70,673,80400,51232
507,460,47,789,121300,51234
506,435,71,725,136200,51235
680,555,125,834,87500,51237
487,438,49,539,113600,51238
1068,915,153,692,155200,51239
780,567,213,906,162500,51240
683,614,69,650,194500,51241
83,79,4,-,101100,51242
372,278,94,818,71800,51243
32,30,2,-,56700,51244
559,380,179,620,89600,51245
1337,1121,216,527,141000,51246
1837,1377,460,665,164000,51247
807,661,146,561,107300,51248
1395,1006,389,613,99100,51249
2735,2115,620,732,213700,51250
5603,3706,1897,661,127500,51301
637,447,190,791,224600,51331
251,187,64,-,132900,51333
2927,2260,667,739,91300,51334
429,344,85,635,97100,51338
21,14,7,556,32500,51341
536,396,140,549,82400,51342
167,111,56,734,187500,51343
176,132,44,432,85000,51345
947,728,219,663,79000,51346
653,568,85,808,136000,51347
244,202,42,823,77800,51350
1944,1532,412,680,184000,51351
441,367,74,627,81700,51354
446,368,78,1045,328000,51355
234,190,44,663,84200,51357
542,395,147,500,82300,51358
4030,3192,838,772,187200,51360
79,70,9,740,82100,51363
312,235,77,900,81900,51364
117,108,9,672,86700,51365
120,104,16,-,68700,51366
5234,3875,1359,603,151300,51401
326,307,19,950,130400,51430
191,163,28,581,76300,51431
245,185,60,514,70900,51433
356,283,73,617,125300,51436
412,335,77,633,62700,51439
128,121,7,-,106600,51440
219,180,39,650,88800,51441
3270,2208,1062,640,104500,51442
686,530,156,581,122800,51443
103,84,19,625,85400,51444
1265,864,401,374,113700,51445
260,195,65,618,65600,51446
107,90,17,623,105200,51447
219,168,51,586,80000,51448
934,759,175,574,82600,51449
707,604,103,527,144800,51450
57,51,6,-,34800,51451
305,268,37,558,73000,51453
588,479,109,425,85300,51454
988,759,229,549,107500,51455
612,538,74,646,77800,51458
34,29,5,-,48300,51459
515,393,122,575,81500,51461
481,393,88,669,82300,51462
222,183,39,744,124300,51463
336,284,52,497,86000,51465
392,336,56,497,94500,51466
294,268,26,-,98900,51467
13899,8178,5721,838,99400,51501
14758,10345,4413,809,179600,51503
1356,1060,296,1079,110700,51510
95,73,22,563,45600,51520
817,627,190,716,141600,51521
175,145,30,609,77000,51523
474,393,81,700,151600,51525
691,634,57,1304,234100,51526
195,173,22,542,103100,51527
347,247,100,587,70400,51528
754,517,237,577,92500,51529
282,227,55,677,114500,51530
287,236,51,654,129500,51531
312,215,97,562,76600,51532
359,233,126,642,108900,51533
3321,2488,833,731,190800,51534
734,591,143,725,94900,51535
175,159,16,-,77600,51536
2943,2184,759,703,115900,51537
149,135,14,975,102700,51540
136,117,19,838,106900,51541
400,353,47,1167,235100,51542
239,173,66,565,72600,51543
319,252,67,716,85200,51544
141,115,26,563,33100,51545
1117,889,228,746,130100,51546
173,153,20,1058,201000,51548
230,189,41,665,166900,51549
68,64,4,550,70000,51550
714,590,124,850,158200,51551
130,106,24,625,130000,51552
427,328,99,669,141800,51553
76,71,5,-,112500,51554
2146,1478,668,689,128500,51555
182,158,24,917,113500,51556
384,343,41,625,131600,51557
208,180,28,620,64000,51558
659,531,128,735,157900,51559
798,585,213,633,127400,51560
573,500,73,931,176900,51561
152,133,19,830,211300,51562
275,202,73,831,113700,51563
214,175,39,525,67500,51564
171,133,38,560,120500,51565
2968,1963,1005,647,85100,51566
435,331,104,705,119900,51570
211,184,27,-,121800,51571
229,196,33,442,61900,51572
435,335,100,742,100300,51573
569,469,100,857,177300,51575
760,642,118,776,191100,51576
510,361,149,865,109400,51577
28,23,5,-,65000,51578
968,728,240,708,125800,51579
2468,1677,791,657,88900,51601
89,89,0,-,72700,51630
114,85,29,689,87000,51631
2717,1976,741,615,98000,51632
171,140,31,719,93300,51636
93,77,16,492,54600,51637
563,454,109,650,77800,51638
372,251,121,603,78300,51639
660,482,178,610,83100,51640
135,106,29,-,206400,51645
360,288,72,600,77100,51646
65,56,9,-,-,51647
110,94,16,725,151100,51648
121,108,13,625,98600,51649
155,130,25,658,55400,51650
673,495,178,584,100900,51652
631,429,202,675,122100,51653
161,132,29,943,155000,51654
21,17,4,-,75000,51656
17446,10953,6493,741,127100,52001
6583,4721,1862,887,210800,52002
5361,4567,794,817,182700,52003
170,111,59,725,85500,52030
2090,1758,332,682,152500,52031
614,583,31,590,185200,52032
1283,939,344,685,163200,52033
437,391,46,506,111000,52035
464,416,48,666,115000,52037
220,182,38,750,200000,52038
353,345,8,525,227600,52039
2403,2021,382,712,164700,52040
668,609,59,683,139700,52041
618,527,91,513,151400,52042
996,707,289,698,99400,52043
51,33,18,-,-,52044
910,758,152,738,172300,52045
955,773,182,820,167600,52046
279,225,54,670,117900,52047
154,109,45,653,128100,52048
614,449,165,619,103300,52049
185,145,40,625,98500,52050
1432,1045,387,587,154400,52052
417,373,44,472,152000,52053
356,295,61,680,170600,52054
3271,2601,670,572,123600,52057
3687,2731,956,627,104900,52060
382,301,81,657,139100,52064
418,346,72,950,129600,52065
37,26,11,656,86700,52066
1543,1363,180,552,252800,52068
603,479,124,549,122200,52069
422,354,68,608,140400,52070
85,70,15,544,139600,52072
500,443,57,789,251500,52073
140,131,9,450,132100,52074
933,684,249,667,107200,52076
154,117,37,625,100400,52077
262,231,31,544,130300,52078
374,298,76,580,160900,52079
5123,3863,1260,688,184400,52101
834,648,186,544,145200,52132
242,214,28,819,107400,52133
150,120,30,582,63300,52134
331,299,32,520,102900,52135
2504,1909,595,612,124700,52136
313,262,51,575,-,52140
590,472,118,548,96800,52141
576,413,163,613,104800,52142
564,529,35,400,138100,52144
434,390,44,767,161400,52146
462,412,50,393,93800,52147
770,595,175,641,137200,52151
403,347,56,392,124500,52154
596,503,93,517,111600,52155
234,210,24,875,112000,52156
869,634,235,549,141400,52157
128,102,26,605,102800,52158
1006,792,214,799,118600,52159
402,308,94,391,119400,52160
616,536,80,609,137700,52161
1248,807,441,665,105400,52162
154,131,23,550,71900,52163
141,124,17,567,107800,52164
328,265,63,450,149000,52165
50,45,5,-,80500,52166
105,90,15,746,77900,52168
153,128,25,525,92800,52169
227,195,32,483,107400,52170
343,269,74,519,158600,52171
2701,2131,570,550,123400,52172
1510,1064,446,574,100300,52175
561,452,109,573,150700,52201
351,301,50,550,176300,52202
824,746,78,525,185000,52203
3415,2538,877,704,138800,52205
890,823,67,568,234600,52206
173,145,28,569,82500,52207
1304,1027,277,543,94000,52208
430,367,63,579,141000,52209
250,190,60,827,121900,52210
1126,831,295,726,140200,52211
119,84,35,834,46700,52212
1511,1315,196,742,188800,52213
1424,1192,232,583,190800,52214
303,284,19,500,117400,52215
556,423,133,566,107700,52216
253,208,45,588,87300,52217
700,583,117,667,142300,52218
92,67,25,655,92500,52219
144,144,0,-,142100,52220
113,110,3,-,119400,52221
246,210,36,300,86300,52222
549,479,70,663,173500,52223
832,696,136,635,152200,52224
127,122,5,-,74600,52225
1005,873,132,720,221900,52227
1193,1110,83,1203,212200,52228
287,229,58,638,76600,52229
83,73,10,742,108800,52231
80,57,23,769,87500,52232
3046,1864,1182,788,146600,52233
367,240,127,948,150000,52235
280,280,0,-,170700,52236
612,499,113,669,142500,52237
14879,7845,7034,986,176000,52240
8012,4279,3733,892,225700,52241
0,0,0,-,-,52242
9156,6041,3115,1046,218300,52245
10325,4349,5976,894,239300,52246
1922,1404,518,743,179100,52247
721,569,152,690,111200,52248
392,310,82,732,119400,52249
238,204,34,435,77400,52251
1324,1093,231,725,185100,52253
374,270,104,525,78300,52254
595,460,135,732,115500,52255
98,88,10,-,178100,52257
1539,1112,427,643,109700,52301
16507,12772,3735,664,164000,52302
238,192,46,667,271400,52305
696,574,122,813,125000,52306
94,54,40,-,-,52307
76,68,8,275,68600,52308
174,163,11,521,84700,52309
2643,1992,651,643,141400,52310
42,29,13,596,55000,52312
121,95,26,725,116100,52313
1810,1460,350,765,211300,52314
512,396,116,531,151200,52315
606,474,132,725,109400,52316
7679,5429,2250,1151,218500,52317
355,298,57,644,134700,52318
530,396,134,736,92900,52320
174,121,53,652,77600,52321
1097,1010,87,936,157800,52322
371,263,108,702,70900,52323
726,658,68,986,208000,52324
371,318,53,580,146100,52325
215,166,49,913,93800,52326
1215,1027,188,946,227200,52327
1050,998,52,1335,285000,52328
359,317,42,621,153300,52329
298,225,73,487,119400,52330
809,668,141,787,192400,52332
2493,2230,263,735,296300,52333
59,59,0,-,235200,52334
336,276,60,633,70700,52335
922,825,97,771,153700,52336
288,206,82,682,97500,52337
1291,1182,109,1089,282700,52338
1431,884,547,685,86100,52339
1239,808,431,982,229800,52340
465,399,66,763,303800,52341
1316,975,341,728,97300,52342
549,477,72,625,153300,52345
502,383,119,535,170700,52346
592,446,146,657,94000,52347
34,34,0,-,56700,52348
3048,2504,544,604,152000,52349
503,481,22,623,210000,52351
551,505,46,556,154300,52352
3812,2373,1439,866,128600,52353
175,147,28,-,168200,52354
123,106,17,829,81700,52355
955,773,182,719,155500,52356
1448,1273,175,809,171000,52358
101,73,28,-,65000,52359
1953,1381,572,523,162900,52361
373,302,71,541,85900,52362
941,246,695,614,118600,52401
16928,11953,4975,808,144800,52402
9777,7505,2272,719,142200,52403
16392,10774,5618,721,132800,52404
10761,7978,2783,801,140400,52405
2829,2803,26,-,297000,52411
12063,8543,3520,702,80600,52501
517,419,98,632,118300,52530
2453,1806,647,656,91700,52531
475,377,98,833,83400,52533
140,113,27,788,71700,52534
405,333,72,566,82500,52535
416,345,71,486,118300,52536
2620,2133,487,623,114400,52537
566,368,198,627,94400,52540
143,128,15,-,106300,52542
104,70,34,-,89600,52543
3338,2246,1092,595,75600,52544
40,35,5,-,48300,52548
285,271,14,-,82600,52549
201,151,50,239,57500,52550
205,198,7,-,123500,52551
363,303,60,660,152300,52552
694,568,126,638,119900,52553
599,510,89,628,59800,52554
163,148,15,667,65800,52555
5171,3341,1830,664,114200,52556
0,0,0,-,-,52557
149,127,22,-,112500,52560
349,249,100,578,95700,52561
603,353,250,653,76700,52563
752,564,188,536,100000,52565
79,69,10,-,55000,52566
317,268,49,785,100000,52567
328,298,30,1059,104500,52569
298,269,29,745,72500,52570
661,564,97,717,103900,52571
403,294,109,633,74700,52572
45,45,0,-,118100,52573
334,269,65,571,57900,52574
254,205,49,810,103800,52576
6174,4164,2010,630,112600,52577
278,240,38,376,77000,52580
125,90,35,-,80000,52581
140,120,20,-,110500,52583
188,155,33,738,86100,52584
409,300,109,906,94100,52585
192,154,38,-,106300,52586
9,9,0,-,-,52588
426,337,89,517,66000,52590
1268,1015,253,609,106100,52591
70,60,10,567,104200,52593
119,111,8,-,75000,52594
153,92,61,635,81200,52595
12530,8897,3633,783,98100,52601
249,162,87,662,155600,52619
342,277,65,583,113800,52620
272,192,80,740,87000,52621
726,610,116,667,141000,52623
126,109,17,-,85000,52624
1029,768,261,659,124700,52625
559,462,97,565,74600,52626
5165,3801,1364,645,88300,52627
202,153,49,800,57800,52630
5181,3611,1570,634,75700,52632
335,205,130,724,109300,52635
1008,751,257,605,114800,52637
209,163,46,775,134200,52638
819,675,144,630,112700,52639
530,431,99,626,104300,52640
4668,3157,1511,692,121200,52641
163,135,28,775,136700,52644
1417,1109,308,680,94200,52645
123,103,20,800,87900,52646
92,67,25,631,87100,52647
347,289,58,645,109600,52649
336,285,51,-,164900,52650
266,216,50,378,76700,52651
1315,1055,260,576,118700,52653
580,410,170,530,98000,52654
1764,1273,491,758,103300,52655
1077,916,161,555,159000,52656
29,21,8,640,122500,52657
369,354,15,-,146500,52658
560,414,146,603,96000,52659
52,52,0,-,60600,52660
37,32,5,-,86000,52701
404,281,123,750,120800,52720
303,254,49,545,117600,52721
14594,11216,3378,908,207700,52722
1852,1743,109,863,223300,52726
168,120,48,-,176900,52727
423,352,71,483,118300,52728
350,292,58,700,126200,52729
2249,1798,451,626,123000,52730
311,268,43,622,149000,52731
11394,7998,3396,666,99700,52732
142,129,13,-,81800,52737
1433,953,480,577,102400,52738
186,105,81,806,91500,52739
2934,2254,680,755,163100,52742
270,209,61,871,160800,52745
412,357,55,-,172900,52746
769,590,179,840,159300,52747
3499,2680,819,762,211800,52748
354,326,28,686,160000,52749
215,206,9,1031,162200,52750
400,302,98,687,142900,52751
210,181,29,939,101300,52752
2054,1751,303,896,237400,52753
611,553,58,694,161300,52754
746,560,186,598,165500,52755
743,686,57,895,257400,52756
88,79,9,825,91300,52757
73,60,13,645,135000,52758
171,151,20,-,102200,52760
11892,8447,3445,831,124300,52761
159,130,29,761,129800,52765
372,346,26,675,117700,52766
81,64,17,-,-,52767
633,545,88,632,190500,52768
242,201,41,722,171100,52769
2188,1718,470,647,148200,52772
1038,808,230,624,143500,52773
48,38,10,730,86400,52774
1668,1168,500,699,133300,52776
452,375,77,788,98800,52777
1781,1365,416,666,139500,52778
661,6,655,734,-,52801
3784,2483,1301,777,74600,52802
8851,5464,3387,768,123700,52803
10799,7257,3542,758,116200,52804
10859,7344,3515,775,138200,52806
6326,3500,2826,743,260000,52807
770,674,96,704,188100,53001
943,780,163,910,236700,53002
66,60,6,-,145600,53003
1306,1105,201,907,206400,53004
7617,6708,909,1596,285300,53005
708,537,171,877,188000,53006
902,418,484,767,172000,53007
3022,2518,504,822,198800,53010
885,760,125,778,197100,53011
7402,5822,1580,856,310600,53012
1304,1016,288,750,191800,53013
3275,2438,837,702,152400,53014
1031,914,117,811,159600,53015
129,101,28,717,104400,53016
2126,2065,61,1194,299800,53017
3150,2414,736,1268,370300,53018
764,681,83,700,171200,53019
1592,1297,295,796,219300,53020
1969,1578,391,831,235500,53021
7679,6052,1627,1061,251500,53022
525,467,58,832,183900,53023
7024,4983,2041,926,248900,53024
9031,6663,2368,825,215400,53027
7896,6293,1603,1025,360000,53029
0,0,0,-,-,53031
1856,1254,602,852,148300,53032
2116,2028,88,1101,263400,53033
689,492,197,910,172100,53034
985,806,179,925,178600,53035
1120,870,250,1025,238500,53036
3874,2976,898,1023,223400,53037
1606,1217,389,956,207000,53038
1663,1234,429,697,163700,53039
3105,2535,570,906,216800,53040
2870,2356,514,699,156000,53042
946,858,88,909,230100,53044
8508,7052,1456,1464,337200,53045
498,425,73,900,168000,53046
15,15,0,-,187500,53047
1438,813,625,826,164300,53048
1125,1006,119,775,227400,53049
2705,1879,826,707,143300,53050
15074,11381,3693,997,241700,53051
620,525,95,543,171100,53057
1397,936,461,1153,373500,53058
746,626,120,658,244900,53059
2122,1683,439,647,125700,53061
631,575,56,759,174600,53063
885,737,148,709,182200,53065
13547,10778,2769,964,288000,53066
313,299,14,-,296500,53069
1850,1530,320,724,173200,53070
10635,7833,2802,1142,287200,53072
6256,4310,1946,701,182300,53073
5432,3674,1758,878,197100,53074
1364,1048,316,768,196300,53075
1354,1195,159,1259,335100,53076
684,620,64,925,272800,53078
612,539,73,638,163300,53079
2390,1674,716,745,204600,53080
17983,11016,6967,672,111300,53081
8062,5933,2129,768,163100,53083
4986,3542,1444,730,162000,53085
3284,2579,705,902,252200,53086
195,132,63,719,126000,53088
7313,5885,1428,998,285800,53089
8649,6511,2138,920,187500,53090
831,673,158,652,163300,53091
8589,6870,1719,1124,361300,53092
788,713,75,764,182400,53093
7569,4719,2850,809,159900,53094
11916,8373,3543,847,201400,53095
2044,1850,194,1207,368600,53097
4661,3218,1443,891,166900,53098
1491,1385,106,1127,246000,53103
2127,1826,301,983,252800,53104
11487,8623,2864,931,209900,53105
1309,1252,57,844,206400,53108
7656,4405,3251,802,152000,53110
992,733,259,1036,164700,53114
6354,4143,2211,845,164600,53115
2829,2383,446,1249,292100,53118
2032,1819,213,1076,281400,53119
3900,3124,776,903,226600,53120
7288,5142,2146,860,199500,53121
2293,2142,151,955,362200,53122
802,702,100,950,365400,53125
2716,2244,472,1052,270200,53126
3120,2393,727,1060,160700,53128
5943,4138,1805,948,210200,53129
3103,1876,1227,1066,218600,53130
13498,10350,3148,1037,242400,53132
628,560,68,946,243800,53137
1052,890,162,990,196700,53139
11723,5346,6377,827,124700,53140
12217,9300,2917,987,173900,53142
8774,4862,3912,886,127600,53143
9812,5316,4496,894,182200,53144
3161,2942,219,1103,249100,53146
7037,4661,2376,919,215000,53147
7421,6207,1214,899,282700,53149
9521,7974,1547,1117,280100,53150
13403,9796,3607,1181,251000,53151
900,795,105,832,252500,53153
14466,8644,5822,1046,221700,53154
1205,928,277,754,189300,53156
6265,5194,1071,1063,215500,53158
389,166,223,1021,167200,53167
3355,2704,651,1060,172500,53168
893,650,243,775,205000,53170
8614,5083,3531,811,158500,53172
2610,1938,672,979,164200,53177
1141,866,275,913,215000,53178
2512,2020,492,1270,173700,53179
2848,2134,714,872,198600,53181
3409,2527,882,898,209200,53182
1057,838,219,950,292200,53183
1596,1045,551,840,203900,53184
7167,6285,882,984,250300,53185
13928,7655,6273,898,192000,53186
14471,9480,4991,933,228200,53188
9898,7887,2011,986,275000,53189
6434,3098,3336,732,190700,53190
1248,950,298,981,246200,53191
51,51,0,-,-,53192
61,43,18,775,180400,53195
15443,3363,12080,947,240700,53202
909,125,784,1375,256600,53203
12951,3368,9583,762,74200,53204
3413,1004,2409,577,74100,53205
8165,2739,5426,792,46700,53206
16535,9478,7057,890,157100,53207
11993,4443,7550,749,129600,53208
18691,8794,9897,856,90800,53209
9812,3604,6208,851,95400,53210
14290,5880,8410,1005,323100,53211
13012,3696,9316,848,129700,53212
11509,6898,4611,984,230600,53213
15858,7940,7918,834,131000,53214
19135,8932,10203,783,101200,53215
13133,5944,7189,849,86200,53216
11717,8877,2840,1266,340600,53217
14036,6137,7899,885,79900,53218
14978,9432,5546,758,138600,53219
11470,6939,4531,842,153800,53220
15839,9302,6537,864,146800,53221
11264,7417,3847,866,140700,53222
12180,6386,5794,884,128700,53223
8109,3957,4152,968,140000,53224
9701,3794,5907,882,121000,53225
8180,4970,3210,1049,226000,53226
11008,5163,5845,852,156000,53227
6339,3509,2830,1120,197500,53228
4431,179,4252,678,64500,53233
4730,2355,2375,736,151000,53235
0,0,0,-,-,53295
13386,9578,3808,876,153700,53402
10450,5241,5209,809,109300,53403
5572,2525,3047,782,99700,53404
10035,6435,3600,918,119500,53405
10932,7636,3296,828,185900,53406
55,55,0,-,-,53501
1013,772,241,709,174400,53502
822,622,200,842,173000,53503
830,642,188,623,154200,53504
160,137,23,1050,184200,53505
485,337,148,706,103400,53506
808,694,114,856,235600,53507
2181,1788,393,885,223300,53508
595,442,153,714,156000,53510
19164,12109,7055,792,102800,53511
973,747,226,740,227400,53515
935,806,129,855,189000,53516
736,622,114,900,269600,53517
590,481,109,594,138500,53518
2707,2054,653,737,144500,53520
1468,1279,189,1061,242200,53521
424,361,63,589,149700,53522
2176,1766,410,970,245600,53523
1493,1088,405,805,147600,53525
274,206,68,710,122900,53526
3723,3096,627,1135,280200,53527
2491,1868,623,951,289700,53528
847,640,207,940,264100,53529
1775,1257,518,722,124700,53530
1739,1344,395,846,239700,53531
5679,4470,1209,955,234200,53532
2985,2026,959,817,180600,53533
4893,3550,1343,776,172900,53534
3476,2439,1037,803,196400,53536
318,225,93,768,98600,53537
7376,5080,2296,847,178600,53538
108,81,27,-,60600,53540
375,294,81,488,156100,53541
696,525,171,564,137500,53543
314,259,55,775,202300,53544
9942,6157,3785,806,135200,53545
12348,9056,3292,851,146000,53546
7384,5014,2370,773,134700,53548
4069,2740,1329,769,167600,53549
413,367,46,936,162000,53550
3491,2364,1127,1000,199200,53551
225,173,52,517,104500,53553
412,324,88,825,129800,53554
3643,2769,874,880,271500,53555
1190,965,225,700,133800,53556
157,119,38,725,114800,53557
4671,3841,830,1024,255400,53558
2237,1558,679,962,207000,53559
1560,1204,356,830,234600,53560
777,662,115,1078,276100,53561
10997,6570,4427,1075,355200,53562
4282,3242,1040,827,185000,53563
2012,1500,512,754,183500,53565
6546,4265,2281,738,145400,53566
474,367,107,761,145400,53569
1079,834,245,676,169700,53570
61,61,0,-,181000,53571
3989,2837,1152,940,286600,53572
1345,1053,292,685,112600,53573
1497,1294,203,775,199000,53574
6064,4674,1390,855,267300,53575
888,675,213,943,155900,53576
591,457,134,625,177000,53577
2644,1938,706,1070,250700,53578
727,525,202,848,166800,53579
219,163,56,669,103500,53580
4423,3142,1281,596,133300,53581
478,400,78,773,163200,53582
2508,1824,684,682,217900,53583
863,561,302,771,152900,53585
901,647,254,590,115500,53586
504,402,102,613,134800,53587
1782,1381,401,795,203100,53588
7925,6102,1823,945,222600,53589
15704,9817,5887,1043,244500,53590
9128,6829,2299,1171,351100,53593
2237,1823,414,750,175600,53594
7159,5671,1488,997,322100,53597
999,728,271,1194,266000,53598
23,16,7,-,107500,53599
53,53,0,-,-,53702
16041,2364,13677,1092,318300,53703
20524,11326,9198,984,192900,53704
11796,5796,6000,1051,320800,53705
75,0,75,970,-,53706
20946,13219,7727,1053,279800,53711
10129,2713,7416,899,169400,53713
7162,4175,2987,944,177700,53714
5106,814,4292,1281,270700,53715
8086,5791,2295,961,218300,53716
6127,3079,3048,1088,309400,53717
5969,3674,2295,1228,229100,53718
13645,6857,6788,1136,243900,53719
2268,765,1503,1146,447100,53726
0,0,0,-,-,53792
368,306,62,535,99500,53801
23,21,2,-,86400,53802
543,434,109,651,113900,53803
534,421,113,571,114200,53804
2005,1459,546,598,115400,53805
750,594,156,525,105600,53806
1871,1481,390,637,166100,53807
482,335,147,639,139800,53808
1520,1142,378,624,124100,53809
135,118,17,425,125000,53810
1264,969,295,738,174700,53811
2320,1549,771,611,145500,53813
257,220,37,1000,156700,53816
67,53,14,769,85000,53817
5486,3067,2419,815,168100,53818
981,822,159,558,148500,53820
3372,2384,988,626,129000,53821
165,128,37,367,158300,53825
485,358,127,534,116700,53826
85,68,17,725,143800,53827
6113,3930,2183,729,150500,53901
1498,925,573,677,88400,53910
505,409,96,1254,206900,53911
8937,5454,3483,786,163600,53913
9478,6200,3278,811,145000,53916
1054,872,182,632,158400,53919
201,177,24,931,162500,53920
391,333,58,738,186700,53922
704,590,114,765,165300,53923
589,466,123,653,158700,53924
3215,2312,903,824,190400,53925
528,453,75,670,153100,53926
43,34,9,-,95000,53928
1101,808,293,599,121400,53929
518,423,95,750,154000,53930
100,67,33,773,101000,53931
1002,732,270,1033,193500,53932
1277,900,377,728,170900,53933
1942,1605,337,646,102600,53934
107,87,20,750,120400,53935
625,558,67,858,89500,53936
396,326,70,758,165200,53937
112,90,22,725,106500,53939
1167,1015,152,747,179600,53941
374,271,103,699,162500,53943
859,707,152,766,147800,53944
1737,1384,353,726,160800,53946
73,59,14,575,114600,53947
3301,2457,844,784,130700,53948
2643,2165,478,629,148100,53949
2014,1561,453,740,126900,53950
904,662,242,681,151400,53951
1381,1164,217,744,139600,53952
114,84,30,775,115000,53953
2845,2365,480,784,181200,53954
2468,1946,522,794,216800,53955
1294,981,313,727,153500,53956
5310,3693,1617,793,152600,53959
1436,1152,284,914,177300,53960
336,282,54,845,172200,53961
5144,3507,1637,702,133300,53963
1436,1088,348,741,151500,53964
4429,3182,1247,756,162700,53965
973,760,213,618,115100,53968
133,97,36,900,158100,53969
3205,2618,587,750,160800,54001
2550,1851,699,945,177900,54002
378,329,49,1007,232800,54003
976,762,214,713,138900,54004
1206,991,215,581,156700,54005
298,255,43,806,143100,54006
468,377,91,600,174700,54007
1047,816,231,963,170500,54009
8,0,8,-,-,54010
2634,2076,558,746,184900,54011
1345,1047,298,940,171900,54013
850,745,105,1013,182200,54014
1308,1021,287,901,185300,54015
12347,9354,2993,1154,281700,54016
6662,4955,1707,869,199100,54017
2851,2162,689,835,188500,54020
2565,2022,543,957,226300,54021
8165,5189,2976,852,231900,54022
1531,1234,297,970,220800,54023
2130,1619,511,731,179300,54024
2651,2035,616,871,230100,54025
783,648,135,741,209800,54026
361,339,22,1047,183200,54027
955,740,215,824,167600,54028
515,480,35,-,273000,54082
1081,983,98,856,182200,54101
455,386,69,572,114500,54102
216,202,14,867,117500,54103
553,495,58,767,121800,54104
1966,1666,300,682,166500,54106
1368,1096,272,586,155000,54107
2021,1619,402,713,141100,54110
926,791,135,770,158800,54111
1040,799,241,618,125500,54112
1332,1178,154,842,168700,54113
2478,2027,451,669,140200,54114
17343,11613,5730,878,202300,54115
254,214,40,775,112100,54119
120,101,19,480,112500,54120
1360,1113,247,399,145600,54121
114,99,15,531,123900,54123
1542,1197,345,661,112600,54124
270,205,65,457,84000,54125
1385,1136,249,775,190400,54126
29,7,22,-,-,54127
635,523,112,613,118100,54128
1245,1077,168,652,171000,54129
10275,7436,2839,814,159500,54130
1050,720,330,464,117300,54135
2686,1807,879,711,142000,54136
474,444,30,818,160600,54137
423,359,64,725,160100,54138
1282,1070,212,705,150800,54139
3995,2688,1307,790,142300,54140
857,799,58,806,170800,54141
6977,4770,2207,719,99700,54143
641,597,44,666,154200,54149
347,160,187,514,50000,54150
1511,1319,192,575,92600,54151
3070,2255,815,666,113900,54153
2374,1693,681,623,147100,54154
2897,2181,716,722,203200,54155
703,583,120,668,100400,54156
2426,1595,831,673,126500,54157
581,538,43,735,146000,54159
103,82,21,725,130600,54160
1253,1033,220,628,143200,54161
3435,2604,831,692,186900,54162
3037,2232,805,646,172600,54165
7350,5094,2256,616,128300,54166
1054,1029,25,850,231400,54169
1415,1241,174,677,176800,54170
1348,1331,17,-,225900,54171
1639,1396,243,1085,233600,54173
1368,1115,253,683,123400,54174
461,424,37,663,178800,54175
1394,1105,289,572,129100,54177
1229,955,274,928,177600,54180
2165,1622,543,644,127700,54201
677,563,114,981,305500,54202
742,635,107,685,184900,54204
764,690,74,632,157100,54205
49,41,8,-,119600,54207
2424,2006,418,755,195400,54208
601,507,94,902,300700,54209
418,341,77,777,259600,54210
147,130,17,581,388900,54211
517,472,45,895,355800,54212
541,465,76,743,145400,54213
102,69,33,635,134200,54214
2722,2079,643,612,146500,54216
2819,2308,511,763,187300,54217
17223,12053,5170,647,116100,54220
625,544,81,675,181500,54227
1128,933,195,680,142700,54228
1912,1697,215,895,190700,54229
1851,1607,244,527,161900,54230
334,247,87,582,116100,54232
834,645,189,876,313500,54234
8064,5944,2120,755,173000,54235
6556,4758,1798,647,101800,54241
897,768,129,727,157800,54245
409,360,49,715,298700,54246
913,793,120,650,158500,54247
9152,6145,3007,762,147000,54301
12752,6192,6560,689,111400,54302
11791,5401,6390,674,113500,54303
12311,7583,4728,719,130100,54304
0,0,0,-,-,54307
13813,9186,4627,829,192500,54311
14808,12270,2538,857,212900,54313
13168,8755,4413,707,138100,54401
10542,6895,3647,691,146000,54403
1137,786,351,542,113300,54405
1370,1121,249,745,183700,54406
604,542,62,733,202500,54407
443,372,71,600,137200,54408
5707,4009,1698,635,97500,54409
866,792,74,548,152100,54410
1887,1656,231,651,143200,54411
866,718,148,655,164000,54412
74,57,17,488,105500,54413
1308,1078,230,664,136800,54414
713,550,163,588,104000,54416
15,15,0,-,79000,54417
395,337,58,644,128700,54418
479,379,100,612,154700,54420
1243,945,298,646,124200,54421
411,322,89,596,95000,54422
894,833,61,723,206200,54423
694,652,42,633,164400,54424
767,593,174,660,111500,54425
1651,1392,259,698,154700,54426
470,357,113,684,142600,54427
490,400,90,544,162200,54428
58,46,12,538,112500,54430
753,626,127,623,128100,54433
877,756,121,714,142000,54435
816,680,136,720,118500,54436
1101,865,236,559,121000,54437
1191,1066,125,663,158000,54440
353,334,19,975,190100,54441
433,387,46,785,166200,54442
863,733,130,663,185500,54443
1138,837,301,653,124100,54446
206,166,40,641,84300,54447
1725,1472,253,658,181400,54448
11646,7877,3769,672,153500,54449
149,99,50,663,63400,54450
4949,3755,1194,663,137900,54451
8203,6153,2050,639,124700,54452
539,424,115,706,135300,54454
7039,5910,1129,793,165900,54455
2541,1942,599,596,119200,54456
3513,3042,471,823,121300,54457
31,23,8,629,112500,54458
562,510,52,708,105400,54459
967,782,185,659,102500,54460
187,164,23,733,119300,54462
271,234,37,713,193800,54463
287,277,10,533,164000,54465
1200,995,205,596,143300,54466
5823,3636,2187,825,173300,54467
691,559,132,682,98800,54469
852,662,190,541,129900,54470
717,678,39,-,196200,54471
1072,926,146,721,167900,54473
1762,1202,560,689,124100,54474
701,622,79,558,155900,54475
7621,4652,2969,810,151000,54476
1509,1261,248,651,140200,54479
578,400,178,675,107800,54480
11467,6469,4998,695,141200,54481
3912,3146,766,812,181300,54482
1971,1649,322,598,160100,54484
136,122,14,644,163900,54485
931,768,163,558,116400,54486
4469,3757,712,705,168700,54487
450,366,84,548,126400,54488
664,555,109,543,134700,54489
373,312,61,583,132500,54490
740,607,133,608,110400,54491
257,235,22,550,141100,54493
11803,9010,2793,780,128200,54494
3423,2006,1417,692,96300,54495
871,705,166,688,121200,54498
1225,903,322,585,132800,54499
8383,6780,1603,768,142700,54501
566,493,73,616,124000,54511
444,393,51,644,229900,54512
204,174,30,625,115200,54513
831,709,122,607,145000,54514
218,197,21,625,90300,54515
59,58,1,-,227800,54517
648,578,70,914,219400,54519
1898,1316,582,460,124800,54520
3741,2915,826,746,188400,54521
255,231,24,444,157500,54524
124,77,47,565,55500,54525
350,292,58,653,89200,54526
435,368,67,583,87100,54527
510,486,24,625,193300,54529
367,340,27,695,81500,54530
569,545,24,975,228600,54531
1223,826,397,512,80800,54534
100,81,19,631,53000,54536
210,199,11,525,119100,54537
1537,989,548,576,195600,54538
579,536,43,768,188400,54539
480,410,70,570,200000,54540
480,347,133,577,125600,54541
225,210,15,465,89700,54542
437,364,73,696,348100,54545
536,399,137,528,80200,54546
748,550,198,669,221800,54547
2175,1855,320,825,233100,54548
305,255,50,529,77600,54550
2162,1570,592,538,114000,54552
482,398,84,807,206800,54554
2298,1755,543,700,142900,54555
599,476,123,602,88300,54556
472,451,21,921,306900,54557
1057,835,222,768,204400,54558
362,252,110,348,117600,54559
279,223,56,792,156900,54560
0,0,0,-,-,54561
951,831,120,725,253300,54562
320,271,49,782,132700,54563
189,183,6,-,126100,54564
32,28,4,-,90000,54565
612,489,123,573,143000,54566
2507,1721,786,680,166800,54568
20217,10841,9376,832,149800,54601
6529,3420,3109,687,130800,54603
735,549,186,715,153100,54610
470,341,129,677,108400,54611
1862,1271,591,795,147500,54612
834,688,146,663,113800,54613
1141,910,231,696,164700,54614
4042,2866,1176,661,126900,54615
1036,758,278,647,122900,54616
834,702,132,884,141900,54618
1209,998,211,718,161200,54619
513,423,90,940,178800,54621
902,759,143,788,146000,54622
838,720,118,794,159900,54623
650,567,83,700,158000,54624
116,74,42,588,140400,54625
568,469,99,615,149700,54626
742,582,160,488,159000,54627
393,349,44,675,150800,54628
1120,874,246,754,173500,54629
1711,1265,446,768,160900,54630
709,621,88,600,121600,54631
450,403,47,611,169700,54632
1680,1300,380,623,141000,54634
743,573,170,779,140900,54635
5081,4000,1081,877,203000,54636
107,71,36,-,91500,54637
583,464,119,604,137900,54638
992,759,233,615,150800,54639
2,2,0,-,-,54641
823,646,177,750,151900,54642
2,2,0,-,-,54643
570,472,98,771,204400,54644
32,24,8,483,75000,54645
1671,1335,336,877,114000,54646
580,450,130,688,132800,54648
9906,7171,2735,864,185900,54650
533,441,92,547,117000,54651
377,306,71,655,138200,54652
336,248,88,850,141200,54653
35,35,0,-,95000,54654
705,535,170,639,150300,54655
7167,5251,1916,813,145100,54656
127,100,27,625,112500,54657
1115,887,228,785,183200,54658
546,420,126,653,151900,54659
6380,3917,2463,840,149300,54660
1574,1268,306,707,172800,54661
639,515,124,649,108900,54664
3566,2456,1110,666,149600,54665
1144,840,304,842,154500,54666
1856,1447,409,815,144900,54667
3090,2397,693,898,193800,54669
556,468,88,755,164900,54670
16106,9445,6661,789,181400,54701
17627,10984,6643,844,145300,54703
3111,2026,1085,790,157600,54720
579,472,107,676,133700,54721
1436,1118,318,692,157700,54722
500,401,99,692,156400,54723
2998,2293,705,704,156400,54724
1162,935,227,785,125800,54725
701,547,154,725,124100,54726
2040,1655,385,711,145700,54727
2596,2178,418,672,163600,54728
13473,9119,4354,840,167600,54729
1957,1678,279,679,172500,54730
277,232,45,586,116000,54731
1225,909,316,641,113100,54732
475,393,82,735,155800,54733
320,285,35,748,156100,54734
1700,1296,404,577,140500,54736
234,210,24,850,163200,54737
1239,1021,218,727,196600,54738
1861,1444,417,895,178700,54739
818,624,194,663,150900,54740
628,505,123,600,133900,54741
1724,1429,295,690,169000,54742
908,793,115,690,183100,54745
295,229,66,700,122700,54746
1077,696,381,735,148600,54747
583,491,92,641,129400,54748
487,380,107,745,171800,54749
417,363,54,754,189200,54750
9620,5480,4140,765,161700,54751
777,576,201,651,126000,54754
2937,2187,750,744,158700,54755
405,315,90,600,163700,54756
1374,1163,211,755,179500,54757
1897,1470,427,707,145500,54758
640,519,121,668,151400,54759
122,51,71,751,145800,54760
454,327,127,690,154100,54761
516,431,85,709,129800,54762
467,388,79,620,159400,54763
2,2,0,-,-,54765
664,563,101,663,132200,54766
1342,1116,226,935,175200,54767
1711,1236,475,746,124100,54768
284,257,27,563,212000,54769
822,663,159,733,158000,54770
1538,1220,318,600,121100,54771
429,317,112,697,133900,54772
1340,972,368,673,145900,54773
2989,2216,773,658,148600,54801
555,390,165,715,103100,54805
4842,3165,1677,662,122200,54806
965,782,183,759,168800,54810
2013,1317,696,544,113200,54812
239,202,37,684,162300,54813
1165,800,365,555,161600,54814
1041,890,151,720,176700,54817
1116,893,223,581,114700,54819
354,287,67,725,160600,54820
632,559,73,652,181300,54821
1828,1433,395,798,146600,54822
947,736,211,750,156000,54824
312,279,33,750,186800,54826
148,142,6,-,162500,54827
363,273,90,408,142700,54828
2294,1838,456,633,158400,54829
1483,1316,167,686,172900,54830
191,127,64,554,160800,54832
430,361,69,725,124600,54835
405,382,23,1295,165300,54836
1625,1293,332,619,136900,54837
556,471,85,675,177100,54838
119,104,15,-,145800,54839
1982,1566,416,721,134000,54840
129,115,14,750,91300,54841
56,53,3,-,155800,54842
5220,3721,1499,630,174700,54843
114,105,9,-,184700,54844
37,35,2,-,139100,54845
202,183,19,588,101600,54846
1032,886,146,813,176500,54847
2624,1763,861,679,97100,54848
783,654,129,756,186700,54849
106,93,13,1042,211400,54850
1830,1418,412,697,155600,54853
415,364,51,775,169200,54854
244,222,22,917,161100,54855
693,636,57,813,142700,54856
24,11,13,-,-,54857
761,501,260,627,126200,54858
850,668,182,769,159600,54859
55,23,32,314,-,54861
110,96,14,1031,120000,54862
548,461,87,959,172700,54864
256,227,29,425,129900,54865
249,142,107,723,80800,54867
6915,4855,2060,683,154500,54868
697,638,59,1000,211000,54870
1264,1019,245,631,145900,54871
1301,973,328,822,137000,54872
1359,1156,203,649,173700,54873
1486,1358,128,994,162800,54874
492,404,88,739,134200,54875
644,485,159,582,171700,54876
13264,7747,5517,745,126800,54880
613,555,58,825,156000,54888
1108,797,311,641,146300,54889
1510,1185,325,681,159400,54891
1778,1388,390,720,164900,54893
420,341,79,855,157500,54895
765,648,117,727,141200,54896
13886,7091,6795,764,122600,54901
10053,6321,3732,669,116700,54902
8981,6885,2096,778,195300,54904
843,724,119,656,134100,54909
10523,6119,4404,751,136600,54911
8146,5805,2341,881,252700,54913
13022,8031,4991,756,146800,54914
17049,11996,5053,764,165300,54915
470,422,48,693,114700,54921
521,423,98,722,129900,54922
3784,2728,1056,724,131400,54923
223,166,57,780,212100,54927
132,117,15,-,121400,54928
3759,2817,942,695,125300,54929
673,557,116,630,123000,54930
121,109,12,-,144600,54931
482,457,25,1263,190400,54932
142,62,80,686,88300,54933
174,95,79,-,123900,54934
17596,10446,7150,708,125000,54935
7376,5885,1491,871,178800,54937
1753,1582,171,792,194800,54940
1145,895,250,676,193300,54941
3532,3161,371,1020,230200,54942
841,708,133,668,133000,54943
3343,2902,441,737,208300,54944
1551,1201,350,590,158400,54945
0,0,0,-,-,54946
1081,1001,80,879,184600,54947
117,95,22,789,121300,54948
1420,1116,304,655,142700,54949
1180,979,201,619,122500,54950
11243,7494,3749,755,144100,54952
18394,12930,5464,785,159600,54956
1186,1082,104,606,152100,54960
5764,4124,1640,707,154000,54961
501,435,66,596,151600,54962
2719,2112,607,811,166000,54963
377,341,36,1008,229000,54964
572,542,30,688,163600,54965
750,582,168,661,135900,54966
182,125,57,580,106300,54967
1265,976,289,644,124100,54968
1214,892,322,633,109500,54970
4483,2993,1490,733,135300,54971
590,522,68,658,172000,54974
629,535,94,772,184900,54977
604,542,62,769,174300,54979
51,30,21,-,154500,54980
6581,4629,1952,727,146800,54981
3026,2368,658,685,144500,54982
1856,1509,347,732,148400,54983
1367,1113,254,689,148600,54984
0,0,0,-,-,54985
2148,1747,401,646,196700,54986
1157,1099,58,1350,459400,55001
1088,807,281,1278,232800,55003
1562,1471,91,-,222100,55005
1565,1202,363,825,138800,55006
887,795,92,850,142200,55007
5830,4592,1238,953,182000,55008
3201,2567,634,890,245100,55009
3658,3562,96,1422,247200,55011
728,637,91,960,225500,55012
2628,2193,435,800,257200,55013
9682,8457,1225,1309,228600,55014
11880,10264,1616,1295,236600,55016
294,279,15,1438,197000,55017
349,325,24,1347,267700,55018
716,673,43,-,222900,55019
1207,1191,16,1864,355400,55020
11160,7943,3217,829,167400,55021
12002,10401,1601,1134,240200,55024
9162,7160,2002,1083,259800,55025
166,160,6,-,290600,55026
1147,942,205,928,219600,55027
30,30,0,-,86300,55029
495,440,55,775,153600,55030
732,661,71,955,282100,55031
1302,1245,57,-,239900,55032
11724,9027,2697,917,232900,55033
42,33,9,1025,59000,55036
1936,1314,622,752,136300,55037
7809,6979,830,1397,266700,55038
4832,3961,871,1037,185900,55040
3357,2584,773,885,192400,55041
3292,3138,154,938,423300,55042
1465,1305,160,1097,245200,55043
18493,15832,2661,1401,332400,55044
3006,2625,381,986,228400,55045
1831,1596,235,1500,211000,55046
1021,928,93,1473,415600,55047
880,745,135,630,167000,55049
3835,3024,811,759,150800,55051
804,701,103,855,164300,55052
399,368,31,1115,210200,55053
794,714,80,-,303400,55054
1433,852,581,947,193100,55055
5009,4341,668,903,197000,55056
8088,5826,2262,821,245500,55057
11691,8618,3073,741,160100,55060
3609,2883,726,737,166800,55063
436,408,28,1025,258700,55065
7917,5467,2450,830,178300,55066
10398,8852,1546,1224,245600,55068
1775,1325,450,797,174300,55069
2663,2296,367,993,200600,55070
2073,1623,450,1049,176600,55071
1262,933,329,828,129200,55072
1228,1142,86,886,347400,55073
862,740,122,965,198000,55074
8087,5309,2778,938,177600,55075
8889,6424,2465,1118,214100,55076
5189,3208,1981,1007,358500,55077
3220,2953,267,960,225400,55079
995,932,63,1337,230400,55080
13485,10905,2580,1161,329100,55082
679,534,145,816,199200,55084
173,154,19,892,206400,55085
122,122,0,-,138900,55087
655,581,74,1335,398800,55088
731,651,80,917,278400,55089
128,110,18,-,166000,55090
3993,3534,459,1214,224500,55092
4596,910,3686,1179,192600,55101
9187,3891,5296,935,200000,55102
5013,1798,3215,765,166200,55103
16954,8566,8388,888,213100,55104
10572,7125,3447,969,335100,55105
17879,9737,8142,924,152000,55106
5318,2835,2483,940,173800,55107
6387,3117,3270,993,266600,55108
13220,8684,4536,983,206800,55109
16329,12803,3526,1092,239100,55110
20,0,20,625,-,55111
17227,11657,5570,990,233000,55112
17869,11555,6314,999,238700,55113
1574,372,1202,1104,236100,55114
3519,2958,561,1202,338100,55115
11218,5882,5336,997,309300,55116
16066,8638,7428,937,185800,55117
11832,7906,3926,942,237700,55118
15236,9591,5645,937,177400,55119
1836,1484,352,1154,352300,55120
3675,1640,2035,1126,233000,55121
13369,9522,3847,1136,243900,55122
9524,7406,2118,1217,321600,55123
19655,15535,4120,1303,243100,55124
16335,13003,3332,1394,283300,55125
11226,9226,2000,1233,265500,55126
7566,6439,1127,1292,287000,55127
11612,8774,2838,1073,212900,55128
8763,7217,1546,1743,385500,55129
5440,1890,3550,829,157400,55130
84,50,34,1047,230000,55150
0,0,0,-,-,55155
4562,3555,1007,1108,233600,55301
2929,2540,389,564,223600,55302
17986,13241,4745,1066,228700,55303
16272,14954,1318,1509,277700,55304
9829,5368,4461,1338,315700,55305
6279,4127,2152,1209,264500,55306
1331,987,344,632,149300,55307
3254,2821,433,974,222600,55308
6220,5493,727,937,203200,55309
592,555,37,619,96500,55310
13764,12256,1508,1511,353600,55311
600,517,83,638,129200,55312
8674,6680,1994,1010,229600,55313
455,363,92,560,129000,55314
1823,1681,142,2176,327800,55315
8976,7703,1273,1182,227100,55316
7827,6650,1177,1260,360600,55317
10229,7442,2787,1132,268400,55318
1891,1752,139,1054,240500,55319
1896,1603,293,855,216800,55320
1853,1367,486,743,180200,55321
1236,1114,122,1035,269800,55322
494,422,72,908,257700,55324
1671,1402,269,671,226900,55325
1325,1294,31,1613,276800,55327
3429,2851,578,842,279900,55328
809,618,191,715,150000,55329
13307,11077,2230,1011,228600,55330
7002,5874,1128,994,521500,55331
746,576,170,715,103200,55332
317,235,82,525,84800,55333
1134,819,315,655,141300,55334
686,552,134,678,100700,55335
3008,2418,590,829,161500,55336
18372,11765,6607,1148,230900,55337
421,397,24,900,161800,55338
394,333,61,699,200400,55339
2749,2547,202,1463,433400,55340
1041,980,61,586,284900,55341
798,652,146,757,102700,55342
11757,5364,6393,1066,234000,55343
7103,2288,4815,1303,243300,55344
8898,7206,1692,1246,348100,55345
6201,5521,680,1564,329100,55346
11278,10137,1141,1594,398400,55347
1601,1179,422,792,198900,55349
7826,5657,2169,808,158300,55350
3243,2351,892,1070,271000,55352
1337,1196,141,648,207300,55353
1011,877,134,539,167600,55354
3943,2921,1022,765,152100,55355
2099,1719,380,1109,585700,55356
1145,1032,113,615,379500,55357
2017,1683,334,741,211900,55358
2283,1919,364,885,344600,55359
934,864,70,1163,234300,55360
6951,5541,1410,956,212700,55362
1657,1345,312,824,181800,55363
6381,5170,1211,971,336300,55364
219,129,90,581,85800,55366
371,308,63,777,210800,55367
969,634,335,660,207600,55368
15235,12104,3131,1379,239300,55369
298,268,30,1014,218400,55370
6176,4954,1222,838,181000,55371
11895,10361,1534,1142,319900,55372
2135,1700,435,933,208200,55373
5088,4367,721,1215,308400,55374
1572,1379,193,823,298500,55375
5228,4550,678,1079,248800,55376
9985,8353,1632,1291,291500,55378
14738,11189,3549,1180,258300,55379
839,692,147,525,166000,55381
1409,1280,129,950,230700,55382
1011,257,754,1094,421400,55384
547,425,122,714,112300,55385
2522,2359,163,894,411900,55386
4775,3878,897,961,296500,55387
2163,1729,434,644,223000,55388
1023,868,155,550,159000,55389
944,798,146,885,217000,55390
6756,5348,1408,1380,554400,55391
1163,910,253,704,155200,55395
886,706,180,729,128200,55396
1011,780,231,1021,213000,55397
5391,4840,551,1136,214200,55398
6256,2337,3919,1622,325700,55401
313,0,313,1383,-,55402
11082,2291,8791,929,291800,55403
12042,1675,10367,791,219400,55404
7402,2771,4631,958,347900,55405
15275,10140,5135,946,220500,55406
14791,8349,6442,991,201900,55407
15208,3750,11458,1037,280000,55408
4811,2967,1844,1029,253300,55409
8532,6776,1756,1258,396900,55410
9535,4195,5340,935,144700,55411
8557,5022,3535,1057,143000,55412
6518,2594,3924,1057,236900,55413
11532,1983,9549,1017,295000,55414
1748,624,1124,1543,422900,55415
16134,8089,8045,1242,337000,55416
11026,8861,2165,1057,249000,55417
13197,8927,4270,943,220100,55418
10472,8279,2193,1169,333500,55419
8745,5548,3197,1052,203700,55420
11455,6826,4629,960,170400,55421
12626,8915,3711,1105,212100,55422
15117,9074,6043,1022,211800,55423
3478,3178,300,1144,666100,55424
3984,2007,1977,1036,208500,55425
12247,7425,4822,1117,239600,55426
9608,6753,2855,1010,231800,55427
12040,7031,5009,959,188100,55428
10143,5407,4736,986,163400,55429
7678,4819,2859,1020,149800,55430
7970,5392,2578,1296,248500,55431
12135,7681,4454,974,182500,55432
13514,9487,4027,1067,181400,55433
11359,9618,1741,1139,185900,55434
6996,3273,3723,1356,258300,55435
5642,4382,1260,1334,484400,55436
7887,5587,2300,1105,264400,55437
7247,5525,1722,1287,293700,55438
3486,3119,367,1189,508300,55439
7843,4382,3461,1146,326000,55441
5479,4293,1186,1461,330800,55442
11022,8486,2536,1141,238300,55443
5089,4494,595,1104,195900,55444
3996,3506,490,1411,207800,55445
9237,7222,2015,1421,381100,55446
8627,6456,2171,1329,330100,55447
10472,8700,1772,1229,202500,55448
9979,8789,1190,1442,287000,55449
9,9,0,-,-,55450
3401,375,3026,628,124400,55454
0,0,0,-,-,55455
33,33,0,-,212500,55601
115,102,13,-,132500,55602
290,252,38,627,133000,55603
1659,1313,346,703,266200,55604
366,175,191,661,119900,55605
125,110,15,-,343300,55606
72,67,5,-,192000,55607
126,126,0,-,521700,55609
336,233,103,-,266400,55612
105,91,14,-,191400,55613
1151,1008,143,719,109000,55614
108,98,10,710,292900,55615
3330,2547,783,652,182500,55616
225,210,15,917,197600,55702
317,283,34,543,134800,55703
406,328,78,408,132600,55704
1371,1145,226,594,81100,55705
855,697,158,673,76300,55706
1343,1155,188,749,165000,55707
371,246,125,523,72400,55708
1577,1379,198,850,165500,55709
615,575,40,328,172500,55710
207,171,36,858,153000,55711
240,222,18,775,157300,55712
510,429,81,-,78000,55713
172,123,49,764,63100,55716
161,156,5,-,242200,55717
1277,1047,230,713,174700,55718
2500,1913,587,546,88400,55719
6561,4954,1607,707,153800,55720
1409,1306,103,728,203800,55721
480,337,143,682,125200,55722
981,842,139,694,162000,55723
362,346,16,875,162200,55724
80,77,3,-,365600,55725
461,345,116,915,173900,55726
2897,2260,637,527,171600,55731
688,640,48,1071,115100,55732
1734,1615,119,895,230500,55733
2675,1934,741,703,123300,55734
716,633,83,563,163200,55735
672,545,127,442,122200,55736
217,208,9,-,108000,55738
1574,1365,209,658,118500,55741
160,152,8,-,201300,55742
8724,6434,2290,669,165400,55744
7181,5139,2042,556,106600,55746
697,535,162,596,134800,55748
200,170,30,1054,163000,55749
961,880,81,679,67600,55750
675,633,42,886,136000,55751
184,172,12,525,150000,55752
428,376,52,809,59300,55753
143,132,11,720,162500,55756
321,293,28,908,153500,55757
61,52,9,-,58900,55758
1516,1204,312,635,197500,55760
264,237,27,-,127300,55763
265,162,103,398,73300,55764
355,298,57,577,106400,55765
9,9,0,-,212500,55766
1344,985,359,731,153600,55767
1311,840,471,400,150000,55768
1037,809,228,751,133300,55769
752,596,156,628,126400,55771
35,15,20,655,67500,55772
678,645,33,747,154300,55775
1522,1395,127,958,213300,55779
75,67,8,-,157100,55780
348,343,5,-,309100,55781
194,180,14,483,70500,55782
984,916,68,725,168400,55783
56,49,7,-,129200,55784
101,97,4,-,152700,55785
179,143,36,538,87800,55786
267,224,43,776,164100,55787
939,732,207,869,223700,55790
4820,2923,1897,610,93800,55792
279,249,30,715,134100,55793
585,480,105,842,151700,55795
627,572,55,1087,166700,55797
265,231,34,650,172400,55798
1343,424,919,504,316000,55802
7418,6283,1135,1073,212500,55803
5738,4940,798,1125,204400,55804
4713,1470,3243,758,117600,55805
4257,1741,2516,731,111200,55806
4309,3057,1252,714,116600,55807
2610,1741,869,787,121100,55808
3578,3145,433,755,154100,55810
10949,7562,3387,985,194500,55811
3545,1656,1889,850,204100,55812
0,0,0,-,-,55814
22282,14944,7338,1010,187300,55901
10266,7367,2899,1061,286200,55902
10195,7223,2972,812,156100,55904
0,0,0,-,-,55905
7539,6012,1527,799,238700,55906
576,493,83,558,133800,55909
512,412,100,775,170800,55910
11365,7958,3407,726,113700,55912
1405,1175,230,715,151400,55917
370,301,69,543,113400,55918
462,376,86,488,165500,55919
2919,2577,342,952,227000,55920
2049,1589,460,623,156300,55921
354,287,67,427,116200,55922
1826,1417,409,758,208700,55923
537,463,74,696,139300,55924
433,402,31,817,207200,55925
293,225,68,492,156700,55926
1547,1193,354,674,155700,55927
467,394,73,879,172100,55929
167,152,15,838,104600,55931
803,635,168,596,182700,55932
89,77,12,750,112500,55933
1224,1035,189,655,200100,55934
341,294,47,640,200000,55935
687,547,140,668,146100,55936
776,616,160,594,140800,55939
1090,872,218,572,166200,55940
402,323,79,743,156100,55941
1323,1081,242,671,166500,55943
2797,2315,482,647,178400,55944
523,470,53,900,175800,55945
1328,1028,300,790,165100,55946
3210,2622,588,777,200700,55947
719,603,116,565,174600,55949
65,46,19,-,72700,55950
651,515,136,600,110600,55951
924,702,222,625,166000,55952
334,261,73,695,126700,55953
584,496,88,716,100500,55954
925,852,73,708,270700,55955
786,670,116,781,221400,55956
266,216,50,675,190800,55957
880,772,108,663,151600,55959
1259,1165,94,700,289900,55960
172,151,21,833,114900,55961
319,264,55,624,170000,55962
2013,1542,471,937,222000,55963
1722,1458,264,630,154600,55964
1094,827,267,561,151100,55965
396,368,28,857,202700,55967
49,36,13,-,162500,55968
407,356,51,694,173300,55969
373,324,49,775,122100,55970
1158,924,234,646,163100,55971
1838,1455,383,603,193100,55972
98,87,11,1150,166300,55973
912,697,215,631,112000,55974
1796,1497,299,637,130300,55975
3017,2417,600,849,184300,55976
75,65,10,-,172900,55977
343,286,57,681,190400,55979
1740,1381,359,690,186200,55981
170,161,9,-,171600,55982
673,529,144,694,158800,55983
738,596,142,860,144300,55985
13818,8929,4889,686,152300,55987
400,339,61,545,114800,55990
544,448,96,736,269400,55991
2066,1568,498,689,197800,55992
18622,10322,8300,881,183400,56001
6119,4427,1692,819,188100,56003
9082,6387,2695,671,109200,56007
572,480,92,663,120200,56009
496,388,108,602,136400,56010
3078,2711,367,817,225300,56011
1983,1418,565,519,102800,56013
297,239,58,725,68900,56014
387,354,33,529,100400,56016
651,577,74,706,200300,56017
351,293,58,588,113500,56019
42,41,1,-,71000,56020
433,359,74,867,198500,56021
22,22,0,-,30000,56022
235,186,49,569,80500,56023
1227,821,406,1239,181800,56024
190,172,18,638,108300,56025
780,649,131,798,173500,56026
351,276,75,570,51800,56027
529,456,73,725,241500,56028
320,287,33,713,96900,56029
5293,3630,1663,646,134000,56031
109,87,22,738,58100,56032
169,138,31,491,65000,56033
167,142,25,725,152800,56034
153,120,33,504,133900,56035
776,678,98,615,111400,56036
613,524,89,688,170300,56037
358,313,45,712,109500,56039
448,372,76,644,152100,56041
284,238,46,688,106600,56042
218,197,21,375,94500,56043
866,746,120,743,190000,56044
389,345,44,575,110700,56045
38,28,10,960,98000,56046
57,51,6,-,95000,56047
1536,1339,197,675,158000,56048
610,525,85,630,205500,56050
298,242,56,812,57700,56051
308,279,29,913,234000,56052
378,337,41,636,116600,56054
1617,1296,321,819,164800,56055
37,36,1,-,58000,56056
1564,1206,358,680,166500,56057
2297,1726,571,615,167300,56058
171,136,35,475,65000,56060
1306,898,408,716,113600,56062
1202,1029,173,675,283600,56063
1063,826,237,626,146700,56065
423,359,64,588,121100,56068
1766,1409,357,870,175800,56069
4446,3670,776,918,269400,56071
890,713,177,533,128900,56072
7032,5439,1593,595,146100,56073
805,673,132,663,178800,56074
76,67,9,917,60400,56075
183,150,33,1063,142200,56078
285,235,50,631,146500,56080
2368,1820,548,637,97600,56081
4752,3345,1407,895,177000,56082
386,347,39,372,85000,56083
2222,1788,434,571,136100,56085
1260,998,262,578,103800,56087
784,607,177,619,97700,56088
79,63,16,544,48300,56089
288,215,73,900,118200,56090
143,125,18,694,98600,56091
4917,3720,1197,669,153300,56093
1262,985,277,743,186000,56096
1548,1227,321,566,95900,56097
877,639,238,617,87400,56098
2497,1966,531,646,98900,56101
704,578,126,527,115700,56110
177,150,27,475,110700,56111
98,85,13,764,84500,56113
126,107,19,725,77200,56114
563,467,96,589,124000,56115
316,220,96,758,169400,56116
125,100,25,725,89100,56117
172,159,13,463,129500,56118
376,325,51,558,128400,56119
368,317,51,800,65200,56120
266,231,35,650,65000,56121
258,177,81,840,87900,56122
224,198,26,1054,111700,56123
35,35,0,-,35500,56125
158,128,30,700,50000,56127
821,674,147,775,116000,56128
323,258,65,525,73100,56129
962,784,178,809,112600,56131
217,183,34,700,177100,56132
220,175,45,544,89100,56134
506,381,125,558,83700,56136
494,384,110,655,90000,56137
356,307,49,593,111100,56138
177,161,16,529,122100,56139
25,21,4,-,49200,56140
135,119,16,550,98300,56141
432,333,99,597,77300,56142
1929,1406,523,659,133500,56143
497,409,88,675,90500,56144
233,196,37,585,57400,56145
35,32,3,-,61300,56146
83,63,20,632,87400,56147
532,415,117,525,131000,56149
1119,904,215,727,106000,56150
343,310,33,631,117600,56151
597,475,122,610,96100,56152
106,95,11,-,56900,56153
144,126,18,1047,81700,56155
2414,1715,699,638,150400,56156
310,266,44,800,116200,56157
193,166,27,514,143800,56158
1205,833,372,686,81800,56159
85,73,12,388,69200,56160
150,136,14,850,81300,56161
94,91,3,-,71500,56162
2389,1631,758,520,106500,56164
145,131,14,708,121600,56165
86,79,7,-,106700,56166
322,253,69,613,88300,56167
333,276,57,738,117000,56168
264,233,31,660,114600,56169
273,232,41,639,81400,56170
757,556,201,711,96500,56171
1386,1101,285,485,109300,56172
145,111,34,598,105500,56173
141,117,24,590,54600,56174
1241,958,283,545,95800,56175
431,350,81,555,76300,56176
21,21,0,-,71000,56177
735,580,155,615,92400,56178
481,357,124,485,82900,56180
440,368,72,608,94400,56181
576,483,93,496,76400,56183
244,218,26,625,87000,56185
157,121,36,478,111500,56186
5075,3232,1843,687,135500,56187
8895,5638,3257,745,151500,56201
100,81,19,738,138800,56207
1008,657,351,537,69600,56208
893,742,151,650,154100,56209
1,1,0,-,-,56210
195,166,29,663,78100,56211
200,172,28,525,67500,56212
322,253,69,663,79400,56214
1983,1255,728,670,117300,56215
280,250,30,913,114500,56216
216,197,19,771,124600,56218
439,344,95,733,84000,56219
1191,934,257,477,102100,56220
281,215,66,339,82900,56221
803,587,216,688,127700,56222
585,443,142,619,88800,56223
116,109,7,-,99200,56224
317,235,82,758,89100,56225
97,90,7,-,113900,56226
81,74,7,-,102300,56227
425,349,76,773,91400,56228
725,573,152,635,160100,56229
324,278,46,625,97100,56230
145,128,17,950,117200,56231
1060,815,245,542,101800,56232
223,179,44,850,98900,56235
148,129,19,-,87500,56236
225,189,36,508,73600,56237
219,202,17,713,144700,56239
435,327,108,549,106100,56240
1673,1215,458,586,126400,56241
663,495,168,722,128000,56243
518,401,117,635,125300,56244
252,202,50,650,91000,56245
373,291,82,467,79500,56248
133,119,14,-,64200,56249
345,295,50,588,149100,56251
492,353,139,625,117400,56252
490,453,37,750,172600,56253
141,124,17,529,90000,56255
1163,886,277,538,81300,56256
253,229,24,-,51400,56257
5946,3502,2444,675,158200,56258
355,294,61,658,89300,56260
274,215,59,508,85000,56262
229,200,29,437,110300,56263
875,731,144,684,114100,56264
3230,2089,1141,584,111900,56265
623,519,104,525,89500,56266
2569,1616,953,735,171600,56267
445,384,61,593,72400,56270
471,403,68,675,116400,56271
1954,1653,301,783,212100,56273
59,59,0,-,187500,56274
109,84,25,-,77500,56276
1296,871,425,696,132000,56277
1235,860,375,540,104600,56278
479,424,55,645,179200,56279
211,174,37,625,115000,56280
243,199,44,741,142300,56281
611,468,143,728,145800,56282
2560,1823,737,708,112300,56283
848,715,133,583,89000,56284
449,358,91,661,88000,56285
33,31,2,-,56400,56287
2010,1780,230,751,268000,56288
287,269,18,-,233100,56289
180,157,23,564,118800,56291
219,194,25,625,93800,56292
501,398,103,567,126900,56293
36,32,4,-,52000,56294
112,102,10,842,75000,56295
982,794,188,547,81800,56296
357,292,65,457,88200,56297
12052,6352,5700,839,183700,56301
10686,6759,3927,726,145300,56303
6928,3347,3581,748,144800,56304
1949,1631,318,611,190700,56307
11296,7731,3565,770,219000,56308
537,432,105,743,167900,56309
2071,1885,186,740,214500,56310
294,233,61,750,115100,56311
978,758,220,734,159900,56312
31,22,9,1146,80000,56313
437,385,52,867,171400,56314
656,569,87,595,177200,56315
578,492,86,610,134200,56316
449,418,31,432,222400,56318
559,500,59,800,192300,56319
3244,2820,424,860,208800,56320
0,0,0,-,-,56321
256,189,67,562,89000,56323
458,416,42,756,194400,56324
89,73,16,863,124000,56325
642,546,96,647,154500,56326
311,302,9,830,276900,56327
72,47,25,719,103100,56328
2667,2282,385,668,180600,56329
645,568,77,925,170500,56330
802,717,85,763,197000,56331
637,602,35,740,257300,56332
2644,1984,660,649,190700,56334
105,98,7,-,97000,56335
653,582,71,530,227200,56336
680,641,39,913,177500,56338
464,348,116,579,123400,56339
935,792,143,579,188300,56340
1235,1057,178,635,163300,56342
424,392,32,642,164600,56343
6153,4357,1796,695,158000,56345
2711,2116,595,668,138200,56347
347,296,51,613,146300,56349
214,197,17,-,154300,56350
2297,1811,486,796,157500,56352
3488,2795,693,720,154400,56353
592,537,55,690,198600,56354
243,212,31,928,171200,56355
116,109,7,-,133000,56356
407,375,32,950,216800,56357
1284,1113,171,891,172700,56358
1420,959,461,665,143200,56359
1633,1356,277,639,164700,56360
937,790,147,667,141500,56361
2390,1935,455,712,174400,56362
63,28,35,836,125000,56363
2139,1791,348,712,172300,56364
2411,2181,230,649,181600,56367
1726,1611,115,660,224900,56368
272,122,150,673,166700,56369
43,34,9,792,116700,56371
1199,990,209,630,192000,56373
3227,2492,735,717,183600,56374
322,288,34,692,168100,56375
130,116,14,213,125000,56376
7186,4694,2492,957,200100,56377
3051,2182,869,594,169800,56378
6882,4637,2245,735,168300,56379
1041,821,220,590,151600,56381
556,498,58,511,189500,56382
166,83,83,679,121200,56384
348,287,61,600,140500,56385
292,235,57,518,190200,56386
3339,1265,2074,846,154300,56387
36,32,4,-,115000,56389
12325,8611,3714,731,178100,56401
3226,2275,951,977,200800,56425
4218,3449,769,690,188300,56431
786,658,128,771,164000,56433
96,88,8,533,143800,56434
1102,991,111,725,155100,56435
29,26,3,-,150000,56436
544,417,127,679,96700,56437
1103,959,144,657,141900,56438
526,427,99,606,117400,56440
1581,1080,501,850,118900,56441
1088,945,143,874,316700,56442
601,542,59,925,213500,56443
1395,1209,186,653,229300,56444
611,493,118,568,122500,56446
459,419,40,1066,251000,56447
146,137,9,-,286300,56448
684,643,41,-,202100,56449
459,369,90,925,129900,56450
924,811,113,639,247700,56452
346,297,49,715,132400,56453
747,579,168,752,133000,56455
21,17,4,633,159400,56456
158,134,24,767,171300,56458
1323,1163,160,718,176400,56461
1745,1470,275,750,148700,56464
852,802,50,979,239600,56465
1394,1081,313,691,155800,56466
1088,974,114,769,233300,56467
1929,1723,206,854,281000,56468
553,498,55,683,162500,56469
4507,3387,1120,607,189700,56470
3231,2683,548,738,217000,56472
1451,1257,194,815,173500,56473
1830,1418,412,659,150100,56474
643,538,105,729,149600,56475
1097,923,174,685,130600,56477
2247,1653,594,660,126400,56479
793,665,128,590,136000,56481
2873,2066,807,694,120500,56482
1581,1187,394,714,180700,56484
7281,5404,1877,745,203700,56501
967,732,235,476,94200,56510
803,708,95,638,201100,56511
1412,1144,268,658,169600,56514
1360,1191,169,689,284000,56515
102,90,12,375,95000,56516
92,82,10,850,84300,56517
139,119,20,920,166100,56518
102,73,29,830,93800,56519
1793,1281,512,506,121900,56520
285,245,40,700,121000,56521
181,158,23,950,80000,56522
217,171,46,605,141100,56523
288,257,31,733,244200,56524
38,38,0,-,112500,56525
318,274,44,525,131700,56527
715,640,75,807,231900,56528
1653,1219,434,571,179100,56529
905,746,159,643,91700,56531
121,111,10,-,153800,56533
493,451,42,958,203700,56534
527,424,103,483,160300,56535
185,167,18,466,163800,56536
8171,5647,2524,657,158100,56537
838,680,158,704,121000,56540
8,8,0,-,-,56541
1213,859,354,755,132900,56542
90,83,7,-,151100,56543
2026,1683,343,728,178300,56544
295,266,29,542,102200,56545
104,100,4,-,166700,56546
955,830,125,594,193400,56547
354,266,88,635,100600,56548
1861,1546,315,853,216700,56549
197,171,26,650,82900,56550
868,681,187,626,152200,56551
172,148,24,463,121200,56552
93,91,2,-,116100,56553
1090,977,113,641,238200,56554
459,341,118,639,104200,56556
1058,680,378,594,83100,56557
16576,10362,6214,842,184600,56560
17,17,0,-,-,56565
156,78,78,333,107700,56566
1256,973,283,664,144500,56567
67,58,9,-,105900,56568
512,387,125,414,107500,56569
461,411,50,889,174800,56570
796,727,69,861,236300,56571
2046,1728,318,518,211400,56572
2741,2039,702,687,189000,56573
85,83,2,-,104800,56574
311,245,66,492,124800,56575
317,264,53,850,226200,56576
2,2,0,-,-,56577
271,260,11,775,256300,56578
509,441,68,685,110800,56579
508,490,18,700,173100,56580
101,91,10,-,66600,56581
46,46,0,-,60000,56583
560,447,113,688,89200,56584
420,337,83,850,126100,56585
821,731,90,725,221300,56586
557,492,65,700,221000,56587
215,205,10,658,241100,56588
759,584,175,496,119700,56589
128,102,26,721,84600,56590
51,40,11,363,82500,56591
173,150,23,650,95000,56592
0,0,0,-,-,56593
198,191,7,488,161400,56594
13463,8999,4464,787,171300,56601
1869,1343,526,698,124100,56621
1127,872,255,606,158100,56623
132,95,37,642,68100,56626
149,107,42,486,48100,56627
808,664,144,725,185300,56628
76,68,8,-,160000,56629
842,636,206,570,113400,56630
1686,1155,531,579,108600,56633
607,506,101,508,122700,56634
1989,1643,346,624,155100,56636
72,65,7,1000,156300,56637
218,198,20,917,177800,56639
144,112,32,320,153600,56641
334,303,31,542,106300,56644
180,153,27,558,142000,56646
352,295,57,833,153500,56647
4132,3115,1017,623,108700,56649
299,263,36,488,124600,56650
229,192,37,692,114300,56651
207,197,10,756,160600,56652
561,463,98,780,111600,56653
70,64,6,-,125000,56654
781,669,112,393,250300,56655
159,148,11,-,217600,56657
0,0,0,-,-,56658
29,29,0,-,152500,56659
116,102,14,-,108700,56660
363,300,63,534,93300,56661
275,254,21,-,263800,56662
73,73,0,-,93500,56663
238,96,142,469,82500,56666
228,206,22,-,188800,56667
42,27,15,-,157800,56668
159,152,7,775,161800,56669
341,177,164,517,48400,56670
861,411,450,576,64000,56671
961,800,161,628,180600,56672
301,257,44,846,153300,56673
633,579,54,713,152800,56676
502,461,41,875,140700,56678
72,68,4,-,168800,56680
121,97,24,640,167000,56681
280,255,25,864,173800,56683
106,89,17,550,88800,56684
46,39,7,-,120800,56685
360,344,16,-,75400,56686
24,24,0,-,105000,56687
65,60,5,-,142500,56688
5510,4044,1466,695,142200,56701
266,220,46,531,99200,56710
0,0,0,-,-,56711
418,363,55,609,96700,56713
505,418,87,678,105500,56714
138,126,12,317,125000,56715
3493,2404,1089,696,133000,56716
12,12,0,-,45000,56720
4057,2861,1196,724,194100,56721
152,128,24,763,156300,56722
351,280,71,721,179600,56723
66,56,10,-,107100,56724
379,334,45,683,132400,56725
634,534,100,515,108200,56726
303,265,38,529,101300,56727
612,499,113,664,84200,56728
53,52,1,-,38300,56729
28,20,8,950,-,56731
504,346,158,583,85300,56732
174,163,11,675,58300,56733
191,155,36,413,45900,56734
301,254,47,540,90000,56735
443,390,53,690,245000,56736
399,340,59,445,104200,56737
568,497,71,483,143100,56738
0,0,0,-,-,56741
367,322,45,475,88900,56742
228,192,36,484,116300,56744
273,232,41,496,107600,56748
1001,815,186,633,124500,56750
2228,1750,478,739,153500,56751
255,213,42,592,150800,56754
43,43,0,-,58600,56755
263,237,26,681,127500,56756
356,284,72,538,82000,56757
157,139,18,-,101300,56758
93,85,8,-,117200,56759
160,121,39,756,96300,56760
179,157,22,950,119000,56761
1068,784,284,618,115100,56762
1939,1459,480,691,123700,56763
726,573,153,544,103800,57001
385,300,85,676,153400,57002
714,654,60,856,171100,57003
1422,952,470,689,156400,57004
4193,3194,999,921,216100,57005
9798,5209,4589,728,177700,57006
200,184,16,-,173600,57010
521,372,149,503,132500,57012
1733,1362,371,673,165100,57013
598,459,139,472,105900,57014
335,300,35,477,132300,57015
305,288,17,913,169400,57016
617,495,122,752,198600,57017
595,501,94,703,142700,57018
497,460,37,1114,195000,57020
100,93,7,-,-,57021
1802,1462,340,834,176600,57022
187,166,21,625,88000,57024
1196,968,228,631,156400,57025
467,327,140,647,137800,57026
24,15,9,-,65800,57027
1352,897,455,552,106800,57028
841,622,219,572,90300,57029
1109,926,183,717,217100,57030
348,275,73,575,127400,57031
2626,2326,300,822,203400,57032
1916,1523,393,875,211400,57033
345,296,49,510,138600,57034
435,375,60,800,134000,57035
300,270,30,725,89100,57036
398,276,122,532,120400,57037
635,585,50,408,212100,57038
1324,1019,305,761,145200,57039
158,143,15,588,87600,57040
40,40,0,-,152800,57041
3370,2266,1104,541,151800,57042
572,446,126,690,96700,57043
492,385,107,434,66000,57045
328,273,55,674,114000,57046
118,73,45,596,72900,57047
464,358,106,399,150000,57048
2845,1721,1124,885,237500,57049
110,103,7,-,-,57050
126,97,29,592,46400,57051
97,72,25,530,162500,57052
705,591,114,683,158200,57053
221,193,28,633,83500,57054
505,441,64,941,266800,57055
90,84,6,-,62500,57057
778,558,220,689,121300,57058
607,433,174,507,66700,57059
31,26,5,-,57500,57061
478,351,127,533,89300,57062
381,297,84,689,97200,57063
2046,1547,499,942,216200,57064
178,124,54,623,104500,57065
723,497,226,560,87700,57066
145,128,17,1288,254500,57067
591,526,65,775,170000,57068
4464,2059,2405,745,155500,57069
664,414,250,633,113500,57070
1195,932,263,752,169100,57071
236,192,44,761,117900,57072
275,216,59,769,104200,57073
423,371,52,736,264700,57075
168,152,16,-,164700,57076
538,489,49,788,153100,57077
7880,4907,2973,614,147000,57078
14203,9786,4417,739,163200,57103
11513,4424,7089,655,108600,57104
9642,6393,3249,822,166500,57105
18717,11476,7241,847,182500,57106
3959,2877,1082,799,160800,57107
8451,6052,2399,974,287900,57108
6619,4440,2179,854,231700,57110
0,0,0,-,-,57117
0,0,0,-,-,57197
10917,7074,3843,741,172200,57201
886,678,208,593,126100,57212
260,246,14,425,150000,57213
25,23,2,-,58300,57214
535,469,66,650,111000,57216
116,92,24,478,78800,57217
125,90,35,-,133300,57218
259,203,56,524,88300,57219
272,226,46,613,142300,57220
277,195,82,490,88000,57221
489,394,95,625,147100,57223
78,57,21,560,-,57224
861,623,238,504,85700,57225
850,597,253,482,143000,57226
127,121,6,-,216100,57227
727,613,114,384,115700,57231
136,120,16,758,89000,57232
63,51,12,-,71000,57233
537,465,72,656,101900,57234
330,275,55,705,158100,57235
65,59,6,-,-,57236
288,252,36,432,-,57237
238,165,73,512,121600,57238
113,104,9,-,184100,57239
413,329,84,589,137900,57241
118,94,24,-,184100,57242
304,224,80,696,108000,57243
58,52,6,-,113600,57245
91,82,9,-,57800,57246
137,106,31,-,317000,57247
361,269,92,908,129000,57248
447,357,90,428,123200,57249
88,71,17,-,78300,57251
2093,1733,360,665,132900,57252
165,120,45,625,42000,57255
46,39,7,-,47000,57256
187,119,68,485,111000,57257
59,56,3,-,73300,57258
180,155,25,469,109000,57259
376,306,70,625,110000,57260
166,149,17,536,90800,57261
1914,1029,885,575,91200,57262
196,147,49,516,76500,57263
123,103,20,538,102800,57264
87,81,6,-,95000,57265
242,175,67,502,84100,57266
198,170,28,517,102500,57268
140,136,4,-,148800,57269
333,179,154,512,55000,57270
69,68,1,-,120000,57271
90,81,9,460,-,57272
489,331,158,474,79000,57273
1282,921,361,525,99300,57274
443,359,84,588,145800,57276
273,232,41,667,87600,57278
524,438,86,586,117400,57279
8086,4729,3357,723,152000,57301
512,447,65,975,118900,57311
266,228,38,683,88000,57312
545,397,148,479,80900,57313
350,258,92,593,86700,57314
454,385,69,527,75300,57315
249,175,74,494,68300,57317
330,241,89,647,106100,57319
172,136,36,575,66700,57321
150,110,40,706,108300,57322
122,86,36,492,101900,57323
155,118,37,636,152800,57324
1392,883,509,552,170100,57325
507,406,101,618,97700,57328
127,91,36,594,116300,57329
209,182,27,466,80800,57330
146,124,22,546,147200,57331
253,228,25,713,111400,57332
374,267,107,695,112000,57334
147,117,30,531,67500,57335
66,62,4,-,153600,57337
409,153,256,448,47000,57339
131,108,23,-,101400,57340
53,44,9,-,-,57341
221,199,22,-,75300,57342
52,50,2,-,77700,57344
528,444,84,627,77500,57345
41,9,32,433,-,57346
234,205,29,720,150700,57348
614,498,116,614,66600,57349
6577,4198,2379,585,98500,57350
346,291,55,392,111300,57353
500,341,159,763,92800,57355
574,399,175,492,54900,57356
29,28,1,-,-,57358
367,289,78,597,102100,57359
52,16,36,555,-,57361
993,618,375,556,116400,57362
368,273,95,674,120600,57363
10,10,0,-,-,57364
257,207,50,650,157800,57365
926,717,209,638,112300,57366
98,70,28,640,204500,57367
461,340,121,660,97500,57368
987,671,316,631,120500,57369
291,207,84,672,66300,57370
69,52,17,-,67500,57371
232,181,51,-,127900,57373
128,121,7,-,80800,57374
296,247,49,638,74100,57375
427,378,49,508,48800,57376
39,38,1,-,-,57379
1127,712,415,460,102700,57380
226,168,58,509,88600,57381
636,430,206,476,74400,57382
337,241,96,675,71300,57383
407,368,39,525,117300,57384
497,320,177,498,75300,57385
85,76,9,775,81400,57386
13816,8664,5152,679,160200,57401
40,37,3,-,-,57420
52,32,20,-,111100,57421
126,105,21,432,80800,57422
97,86,11,500,72500,57424
26,22,4,-,109600,57426
281,243,38,-,137500,57427
252,222,30,375,57600,57428
40,27,13,-,45000,57429
917,684,233,636,108500,57430
155,141,14,-,67500,57432
123,104,19,524,95000,57433
191,173,18,386,95000,57434
103,95,8,-,79200,57435
188,158,30,614,59500,57436
699,576,123,555,54700,57437
559,424,135,638,86900,57438
60,60,0,-,-,57439
163,140,23,475,68700,57440
233,213,20,625,114500,57441
772,610,162,602,102200,57442
728,555,173,806,168100,57445
160,151,9,392,57200,57446
183,158,25,444,39100,57448
94,94,0,-,210700,57449
255,219,36,517,82800,57450
857,697,160,621,164600,57451
113,96,17,817,46000,57452
234,198,36,625,85000,57454
34,33,1,-,59200,57455
313,242,71,553,59100,57456
34,34,0,-,-,57457
123,84,39,606,70000,57460
145,121,24,740,93900,57461
129,116,13,433,88300,57465
90,68,22,-,108700,57466
117,97,20,535,54400,57467
165,94,71,631,65000,57468
1483,984,499,572,82800,57469
37,22,15,-,-,57470
256,212,44,541,105400,57471
365,301,64,644,71900,57472
63,63,0,-,97000,57473
75,70,5,-,87600,57474
46,42,4,-,82000,57475
168,131,37,713,116300,57476
51,44,7,-,74000,57477
205,170,35,775,169200,57479
161,140,21,-,84000,57481
7211,4770,2441,632,177200,57501
56,40,16,-,50000,57520
73,50,23,-,-,57521
209,162,47,682,100000,57522
450,307,143,511,80900,57523
345,261,84,532,78700,57528
141,107,34,-,60600,57529
61,61,0,-,58800,57531
1232,998,234,728,166500,57532
864,637,227,548,66400,57533
142,116,26,-,-,57534
137,108,29,438,54200,57536
38,31,7,-,-,57537
90,81,9,675,72100,57538
25,21,4,-,-,57540
63,23,40,570,-,57541
322,229,93,397,48600,57543
216,177,39,758,103100,57544
53,51,2,-,-,57547
387,125,262,535,44300,57548
762,521,241,543,74700,57551
237,198,39,-,104200,57552
28,28,0,-,-,57553
1216,567,649,435,35400,57555
296,219,77,433,83500,57559
139,83,56,398,17000,57560
16,14,2,-,141700,57562
71,30,41,395,-,57563
418,347,71,561,159300,57564
285,126,159,479,-,57566
702,559,143,662,84800,57567
285,245,40,640,71100,57568
109,93,16,-,65600,57569
524,202,322,423,-,57570
2,2,0,-,-,57571
470,196,274,388,-,57572
60,47,13,-,84200,57574
103,57,46,-,75000,57576
274,66,208,529,58000,57577
438,303,135,538,48900,57579
1820,1325,495,560,97400,57580
32,29,3,-,40800,57584
75,48,27,342,50000,57585
1654,1147,507,688,84400,57601
191,153,38,644,74600,57620
66,11,55,513,-,57621
84,34,50,563,-,57622
310,200,110,585,57800,57623
1183,623,560,566,59500,57625
362,267,95,558,83700,57626
14,14,0,-,-,57630
178,163,15,-,125800,57631
270,238,32,-,80000,57632
149,101,48,500,72500,57633
46,46,0,-,119100,57634
51,21,30,350,-,57636
841,626,215,589,96500,57638
83,28,55,453,62500,57639
81,40,41,-,250000,57640
131,94,37,508,40000,57641
558,243,315,442,54800,57642
123,103,20,-,-,57644
72,62,10,725,85000,57645
101,100,1,-,63800,57646
162,138,24,425,62900,57648
89,55,34,280,75000,57649
9,0,9,-,-,57650
56,37,19,-,99000,57651
106,58,48,575,50000,57652
296,215,81,541,73500,57656
82,66,16,638,65000,57657
106,51,55,375,41300,57658
30,24,6,-,80000,57660
28,12,16,-,133300,57661
18364,10530,7834,766,151700,57701
14633,11318,3315,952,235600,57702
6045,5026,1019,865,167900,57703
1001,5,996,996,-,57706
140,43,97,625,87300,57714
129,87,42,530,58800,57716
3246,2377,869,680,143100,57717
2751,2427,324,986,172000,57718
2924,1982,942,879,175100,57719
328,224,104,625,112500,57720
106,103,3,-,28100,57722
76,62,14,-,90000,57724
115,92,23,-,156300,57725
2591,2006,585,872,220500,57730
1056,683,373,603,163400,57732
580,442,138,681,59700,57735
69,64,5,725,107100,57738
36,0,36,-,-,57741
875,830,45,738,289300,57744
1008,793,215,579,224400,57745
2758,2122,636,591,146900,57747
114,85,29,369,129200,57748
77,64,13,-,112500,57750
366,303,63,442,248500,57751
392,216,176,559,17100,57752
1810,1225,585,751,130100,57754
46,38,8,-,73000,57755
144,92,52,420,25700,57756
55,27,28,-,-,57758
80,80,0,-,-,57759
473,374,99,659,83100,57760
471,426,45,919,153900,57761
322,286,36,844,93400,57762
129,103,26,563,81000,57763
429,242,187,473,25800,57764
78,70,8,-,110700,57766
60,47,13,-,159700,57767
1528,1351,177,1102,224700,57769
1151,554,597,517,23000,57770
470,252,218,616,22300,57772
84,64,20,329,-,57773
88,77,11,-,107500,57775
0,0,0,-,-,57776
97,97,0,-,-,57779
23,13,10,-,195800,57780
20,19,1,-,-,57782
6917,4238,2679,743,221600,57783
4025,2849,1176,530,166600,57785
161,137,24,-,110600,57787
172,114,58,-,133300,57788
388,292,96,675,116700,57790
103,90,13,-,64000,57791
61,61,0,-,189800,57792
939,803,136,805,202100,57793
94,11,83,544,-,57794
0,0,0,-,-,57799
12,12,0,-,183300,58001
17,17,0,-,-,58002
121,101,20,870,188400,58004
311,301,10,-,267200,58005
190,127,63,669,157200,58006
45,36,9,-,187500,58007
99,89,10,-,162500,58008
6,6,0,-,-,58009
177,155,22,436,152700,58011
986,792,194,692,196800,58012
66,58,8,-,-,58013
115,102,13,-,152300,58015
57,48,9,-,137500,58016
145,120,25,525,72100,58017
130,127,3,-,203400,58018
146,126,20,543,181000,58021
620,450,170,675,103300,58027
43,43,0,-,104700,58029
261,230,31,533,85800,58030
202,173,29,825,83100,58031
319,225,94,567,110600,58032
167,152,15,375,115000,58033
132,113,19,-,52800,58035
105,105,0,-,152800,58036
145,123,22,425,165600,58038
531,306,225,720,116500,58040
630,569,61,421,92100,58041
497,472,25,1307,220400,58042
63,59,4,-,98800,58043
899,629,270,568,155900,58045
273,221,52,553,95000,58046
1651,1597,54,760,343100,58047
179,157,22,663,149000,58048
191,168,23,-,123200,58049
652,564,88,592,263600,58051
241,193,48,619,181900,58052
545,429,116,629,57200,58053
1375,910,465,568,135500,58054
80,71,9,-,-,58056
38,36,2,-,155000,58057
37,29,8,-,61700,58058
506,448,58,952,186000,58059
548,416,132,733,113400,58060
144,127,17,383,120200,58061
65,61,4,-,-,58062
142,104,38,777,-,58063
193,153,40,575,104500,58064
13,13,0,-,32200,58065
121,103,18,400,75400,58067
171,128,43,1090,118800,58068
54,47,7,-,98300,58069
201,171,30,445,129700,58071
3627,2293,1334,666,125300,58072
3994,2410,1584,634,130300,58075
0,0,0,-,-,58076
265,240,25,481,189700,58077
13567,9252,4315,859,228700,58078
170,170,0,-,219400,58079
369,319,50,694,126700,58081
13378,6688,6690,689,183100,58102
23775,9142,14633,759,175300,58103
17039,8385,8654,955,272200,58104
0,0,0,-,-,58105
18322,8985,9337,826,218400,58201
0,0,0,-,-,58202
7509,2700,4809,761,157200,58203
728,2,726,1381,-,58204
0,0,0,-,-,58205
189,139,50,545,66500,58210
293,205,88,465,79900,58212
141,115,26,-,160900,58214
52,41,11,-,52500,58216
355,295,60,1035,164800,58218
14,14,0,-,164300,58219
954,714,240,592,115200,58220
123,112,11,475,70000,58222
100,100,0,-,112500,58223
25,25,0,-,-,58224
439,351,88,475,105200,58225
242,202,40,705,86000,58227
378,260,118,750,128100,58228
45,31,14,-,68300,58229
340,275,65,585,65700,58230
170,149,21,-,66300,58231
103,86,17,-,135000,58233
182,144,38,696,100000,58235
2264,1554,710,638,91600,58237
70,63,7,-,-,58238
4,4,0,-,-,58239
507,403,104,569,131700,58240
76,73,3,-,-,58241
278,260,18,700,68800,58243
55,53,2,-,109200,58244
1100,857,243,546,112700,58249
111,95,16,-,75000,58250
825,594,231,639,154000,58251
239,185,54,564,72800,58254
304,274,30,857,180100,58256
893,543,350,645,129300,58257
133,126,7,1063,144200,58258
192,135,57,608,82300,58259
92,89,3,-,97900,58260
534,442,92,736,105800,58261
29,22,7,-,-,58262
198,163,35,-,113800,58265
81,61,20,-,69600,58266
563,457,106,661,134200,58267
121,106,15,495,64800,58269
861,669,192,698,84200,58270
292,233,59,595,86500,58271
116,97,19,480,86300,58272
119,114,5,425,73600,58273
385,287,98,459,114200,58274
291,251,40,826,136900,58275
242,189,53,633,73700,58276
81,78,3,-,85700,58277
730,677,53,686,216600,58278
49,49,0,-,-,58281
690,482,208,526,81000,58282
4439,2569,1870,563,159400,58301
45,30,15,-,111900,58311
2093,1438,655,354,83800,58316
94,94,0,-,60000,58317
1715,1331,384,684,164200,58318
41,34,7,-,-,58321
19,19,0,-,23900,58323
633,444,189,533,89000,58324
14,11,3,-,-,58325
125,116,9,-,204500,58327
1001,772,229,335,67900,58329
141,118,23,610,46400,58330
58,55,3,-,108200,58331
173,153,20,519,83200,58332
409,121,288,364,47500,58335
29,28,1,-,-,58338
16,4,12,-,-,58339
1181,939,242,614,105800,58341
32,23,9,-,60800,58343
428,273,155,527,105900,58344
62,48,14,-,65000,58345
317,239,78,511,73100,58346
347,278,69,495,100000,58348
203,151,52,485,109600,58351
207,155,52,-,71700,58352
39,22,17,-,-,58353
28,28,0,-,56700,58355
809,507,302,618,85000,58356
110,91,19,-,81300,58357
115,78,37,-,-,58361
9,9,0,-,-,58362
52,50,2,-,55000,58363
121,97,24,439,55800,58365
466,315,151,537,85400,58366
648,410,238,577,102000,58367
1716,1216,500,660,117300,58368
421,352,69,413,79400,58369
389,230,159,379,54300,58370
49,48,1,-,43300,58372
240,200,40,393,72500,58374
137,91,46,625,52500,58377
97,37,60,542,164600,58379
216,177,39,475,63900,58380
127,114,13,708,137500,58381
90,75,15,-,143800,58382
261,217,44,450,87200,58384
77,67,10,1094,100800,58385
60,55,5,-,83800,58386
7738,4733,3005,689,153200,58401
0,0,0,-,-,58402
0,0,0,-,-,58405
510,416,94,542,82300,58413
73,70,3,-,271900,58415
194,140,54,338,75000,58416
178,146,32,838,66900,58418
121,113,8,-,159700,58420
1207,929,278,590,140200,58421
75,57,18,-,143800,58422
23,20,3,-,158300,58423
124,119,5,-,87800,58424
575,419,156,440,116000,58425
70,64,6,-,137500,58426
112,90,22,-,-,58428
186,129,57,630,-,58429
48,48,0,-,105000,58430
60,58,2,-,213600,58431
450,322,128,444,115600,58433
771,537,234,492,94900,58436
364,267,97,686,72100,58438
68,68,0,-,83600,58439
46,36,10,-,70000,58440
165,135,30,-,89000,58441
214,200,14,494,75200,58442
101,75,26,-,69300,58443
101,80,21,475,67500,58444
84,65,19,817,-,58445
142,99,43,446,57800,58448
84,73,11,-,57900,58451
16,8,8,-,-,58452
183,117,66,450,62100,58454
146,125,21,756,64600,58455
267,215,52,524,78800,58456
485,339,146,517,105700,58458
115,102,13,496,46300,58460
208,155,53,834,70400,58461
349,259,90,-,59400,58463
103,93,10,-,98800,58464
149,111,38,660,81300,58466
240,184,56,575,85800,58467
186,164,22,754,123300,58472
1140,798,342,644,118300,58474
92,72,20,-,-,58475
111,95,16,525,143800,58476
82,66,16,-,92500,58477
56,40,16,435,32500,58478
92,87,5,-,127700,58479
139,111,28,675,87700,58480
111,98,13,-,206000,58481
456,310,146,493,124300,58482
132,108,24,415,84300,58483
21,19,2,-,-,58484
101,87,14,420,123900,58486
178,143,35,344,81700,58487
99,87,12,392,67300,58488
102,80,22,1125,72900,58490
217,181,36,708,91900,58492
125,91,34,-,83600,58494
644,464,180,523,77500,58495
93,55,38,425,50800,58496
107,82,25,1067,100000,58497
13382,7641,5741,813,219500,58501
13588,10117,3471,985,314200,58503
11182,8093,3089,769,233200,58504
0,0,0,-,-,58505
112,97,15,642,128000,58520
241,225,16,-,344600,58521
1625,1289,336,716,199500,58523
39,36,3,-,140600,58524
146,43,103,486,74200,58528
285,234,51,669,63700,58529
454,402,52,520,161600,58530
184,173,11,-,225600,58531
107,81,26,880,111300,58532
477,395,82,500,86100,58533
271,221,50,804,83300,58535
650,236,414,398,108700,58538
1200,927,273,664,145600,58540
203,161,42,653,69200,58541
121,109,12,675,90800,58542
259,237,22,608,88400,58544
1544,1325,219,878,172100,58545
109,96,13,-,122500,58549
817,632,185,431,120600,58552
11429,7848,3581,874,217700,58554
382,364,18,736,248500,58558
86,83,3,-,206600,58559
66,54,12,483,112500,58560
497,386,111,706,91800,58561
184,168,16,375,103400,58562
909,750,159,689,148500,58563
40,40,0,-,53800,58564
133,116,17,-,157100,58565
50,45,5,-,83800,58566
201,138,63,638,51800,58568
40,38,2,-,65700,58569
148,117,31,875,137500,58570
240,224,16,482,129400,58571
118,109,9,531,169300,58572
249,222,27,675,81200,58573
424,303,121,723,115900,58575
412,346,66,698,165000,58576
868,716,152,820,200000,58577
576,473,103,489,171500,58579
109,93,16,900,162500,58580
128,93,35,750,38600,58581
10548,6262,4286,930,250300,58601
49,37,12,820,156300,58620
651,440,211,673,121600,58621
730,541,189,950,165400,58622
961,682,279,530,173200,58623
131,96,35,1073,161100,58625
149,120,29,846,156700,58626
73,65,8,-,181300,58627
274,211,63,1358,214400,58630
520,393,127,694,116100,58631
95,55,40,-,121100,58632
86,74,12,-,230800,58634
357,267,90,817,176700,58636
513,417,96,770,99600,58638
827,606,221,538,163300,58639
634,496,138,1031,191100,58640
52,48,4,-,308700,58641
124,84,40,-,250000,58642
101,71,30,605,49200,58643
136,75,61,908,179700,58645
527,414,113,808,95200,58646
453,382,71,820,154500,58647
144,89,55,536,73200,58649
169,135,34,615,86300,58650
254,206,48,493,103200,58651
481,435,46,746,164400,58652
315,277,38,646,112900,58653
114,84,30,-,102800,58654
206,164,42,880,215000,58655
197,179,18,538,172000,58656
13585,8523,5062,921,215800,58701
0,0,0,-,-,58702
9362,5570,3792,970,215500,58703
1564,27,1537,1596,-,58704
0,0,0,-,-,58705
0,0,0,-,-,58707
249,211,38,664,114400,58710
136,105,31,-,-,58711
58,57,1,-,75800,58712
10,10,0,-,-,58713
81,75,6,-,189600,58716
354,310,44,463,179600,58718
249,194,55,668,109700,58721
649,482,167,1234,179700,58722
114,99,15,383,112500,58723
130,105,25,1196,115300,58725
102,88,14,-,85000,58727
622,473,149,830,164100,58730
117,95,22,1125,121600,58731
117,113,4,-,178800,58733
126,116,10,-,118300,58734
137,133,4,-,260300,58735
275,226,49,606,64400,58736
73,73,0,-,60700,58737
276,201,75,832,180200,58740
306,256,50,825,132100,58741
51,44,7,-,70000,58744
585,464,121,719,120600,58746
79,65,14,-,212500,58748
210,163,47,813,164200,58750
83,44,39,485,110500,58752
38,25,13,-,267500,58755
82,70,12,371,160700,58756
205,107,98,400,113100,58757
107,106,1,-,88000,58758
328,274,54,-,154800,58759
129,97,32,1063,130400,58760
401,324,77,738,129900,58761
114,96,18,600,110000,58762
1169,686,483,632,154700,58763
221,178,43,-,-,58765
115,105,10,-,216100,58768
85,65,20,625,152800,58769
486,301,185,783,161100,58770
257,214,43,875,161600,58771
74,56,18,694,72000,58772
329,270,59,1006,167000,58773
65,16,49,455,110700,58775
92,55,37,1091,67300,58776
92,91,1,-,-,58778
193,133,60,577,109200,58779
284,259,25,908,187500,58781
211,173,38,465,153100,58782
183,158,25,497,130000,58783
1141,802,339,759,188500,58784
505,395,110,1337,213900,58785
83,78,5,-,113700,58787
539,456,83,428,81300,58788
141,108,33,738,71700,58789
745,577,168,656,184300,58790
127,120,7,-,162200,58792
254,185,69,527,98300,58793
58,42,16,-,117500,58794
111,77,34,-,-,58795
12136,6149,5987,913,260500,58801
103,99,4,-,126600,58830
193,155,38,1011,235200,58831
32,11,21,475,-,58833
67,64,3,-,160400,58835
71,49,22,1075,-,58838
206,199,7,-,406500,58843
43,17,26,-,152100,58844
124,99,25,625,165200,58845
117,93,24,-,122800,58847
345,278,67,674,210900,58849
699,471,228,899,209600,58852
102,57,45,610,108000,58853
2844,1427,1417,1162,225500,58854
57,38,19,1142,168200,58856
607,500,107,864,243800,59001
81,49,32,1060,-,59002
404,183,221,546,102400,59003
378,249,129,700,173900,59006
101,84,17,742,168600,59007
226,186,40,786,158700,59008
64,33,31,-,166300,59010
1331,987,344,707,231300,59011
82,51,31,-,-,59012
49,32,17,-,225000,59013
675,515,160,671,187200,59014
164,156,8,575,162500,59015
275,158,117,713,97600,59016
211,186,25,325,265900,59018
1665,1347,318,769,237900,59019
30,24,6,-,262500,59020
474,301,173,486,75900,59022
176,104,72,406,123100,59024
21,8,13,133,-,59025
93,68,25,-,144100,59026
330,247,83,888,304100,59027
234,158,76,700,334400,59028
305,268,37,722,143300,59029
683,352,331,683,327800,59030
75,57,18,-,-,59031
202,165,37,578,152600,59032
111,98,13,-,300000,59033
1779,1038,741,754,134300,59034
86,62,24,-,78500,59035
566,383,183,574,89300,59036
713,666,47,1280,170500,59037
313,213,100,617,87500,59038
20,13,7,-,-,59039
740,628,112,672,236400,59041
700,398,302,569,64900,59043
4741,3706,1035,796,211800,59044
181,132,49,825,85000,59046
5888,4081,1807,824,247000,59047
377,268,109,528,92200,59050
74,47,27,775,-,59052
92,42,50,-,330800,59053
121,95,26,563,123200,59054
30,13,17,-,181300,59055
327,316,11,-,343000,59057
17,17,0,-,187500,59058
85,71,14,-,167200,59059
122,97,25,683,461800,59061
5,5,0,-,-,59062
782,602,180,548,246300,59063
80,24,56,959,-,59064
82,77,5,-,-,59065
157,90,67,454,128600,59066
83,49,34,794,-,59067
1691,1210,481,910,282900,59068
225,188,37,829,192900,59069
370,303,67,-,266500,59070
63,42,21,-,376500,59071
1881,1319,562,744,190000,59072
149,117,32,638,128100,59074
66,44,22,583,112500,59075
33,17,16,1078,-,59076
29,21,8,-,-,59077
91,74,17,833,103100,59078
1221,1082,139,587,229600,59079
7,7,0,-,475000,59081
19,9,10,1094,229200,59082
47,38,9,-,136100,59085
421,315,106,658,222100,59086
158,108,50,475,137500,59087
639,446,193,858,205100,59088
129,80,49,581,115000,59089
16923,10000,6923,764,171100,59101
20853,13657,7196,918,211500,59102
12230,8977,3253,894,224600,59105
6811,5251,1560,1150,350200,59106
1511,952,559,451,122800,59201
57,52,5,-,-,59211
206,157,49,622,189600,59212
203,141,62,263,56100,59213
50,39,11,-,-,59214
447,371,76,631,124000,59215
47,43,4,-,193500,59217
336,258,78,725,204200,59218
105,83,22,946,103100,59219
685,517,168,832,180700,59221
65,56,9,-,230000,59222
175,128,47,676,220000,59223
190,89,101,373,75900,59225
144,112,32,888,122500,59226
1992,1613,379,479,153400,59230
230,162,68,970,21100,59231
12,10,2,-,187500,59240
271,228,43,605,125300,59241
27,16,11,-,121900,59242
102,63,39,500,201800,59243
11,8,3,-,-,59244
169,127,42,788,116800,59247
324,254,70,837,115900,59248
106,58,48,289,108300,59250
36,28,8,-,137500,59252
35,35,0,-,334100,59253
986,776,210,763,158600,59254
968,481,487,324,82300,59255
45,45,0,-,204200,59256
30,23,7,-,-,59257
55,37,18,-,103400,59258
142,112,30,438,79000,59259
75,46,29,-,188200,59260
230,178,52,342,78600,59261
271,192,79,767,171200,59262
739,583,156,594,122200,59263
3502,2135,1367,821,225200,59270
101,75,26,-,120200,59274
164,117,47,550,84200,59275
10,10,0,-,-,59276
4771,3262,1509,742,160000,59301
75,60,15,-,137500,59311
10,8,2,-,-,59312
1073,700,373,756,162500,59313
38,23,15,-,350000,59314
37,34,3,-,88000,59315
521,371,150,663,127400,59317
47,29,18,-,103400,59318
19,12,7,-,110000,59322
834,754,80,883,117400,59323
459,389,70,714,100800,59324
99,68,31,-,193800,59326
1195,870,325,500,157500,59327
3724,2511,1213,809,160500,59330
83,55,28,-,-,59332
7,7,0,-,-,59333
83,57,26,-,156300,59336
319,242,77,528,93800,59337
39,33,6,-,166100,59338
65,55,10,-,101600,59339
45,31,14,-,-,59343
187,143,44,796,181300,59344
119,95,24,721,112500,59347
455,395,60,-,89300,59349
90,82,8,-,96700,59351
497,391,106,697,102500,59353
16,16,0,-,230800,59354
6579,3286,3293,635,147000,59401
10702,8705,1997,776,191300,59404
13392,7201,6191,775,169100,59405
277,167,110,508,197900,59410
98,75,23,-,59800,59411
689,545,144,683,193500,59412
487,338,149,560,100900,59414
121,101,20,-,94400,59416
2245,1258,987,421,80100,59417
57,24,33,-,320000,59418
48,30,18,544,104200,59419
78,72,6,-,273100,59420
788,603,185,640,239900,59421
1091,700,391,770,165400,59422
32,29,3,-,-,59424
1335,999,336,761,129800,59425
1593,968,625,609,125500,59427
159,114,45,618,76500,59430
49,42,7,-,90000,59432
236,192,44,633,87000,59433
242,174,68,638,154200,59434
774,562,212,717,178000,59436
72,24,48,-,-,59440
29,26,3,-,340000,59441
811,569,242,543,155900,59442
156,151,5,-,218300,59443
85,36,49,-,125000,59444
242,186,56,814,100000,59446
117,91,26,-,170800,59447
152,86,66,414,53800,59448
217,168,49,680,167200,59450
103,88,15,-,-,59451
239,200,39,600,163600,59452
132,115,17,700,115600,59453
89,72,17,-,57800,59454
144,50,94,-,47800,59456
4004,2823,1181,754,136900,59457
87,71,16,-,65800,59460
7,7,0,-,-,59461
81,76,5,-,78600,59462
59,55,4,-,201800,59463
173,134,39,531,125000,59464
23,19,4,-,134400,59465
59,34,25,-,-,59466
52,42,10,-,231300,59467
253,196,57,825,182500,59468
63,57,6,-,152100,59469
123,100,23,525,172700,59471
268,172,96,796,153600,59472
1327,746,581,538,151400,59474
133,107,26,-,165500,59477
366,220,146,536,108600,59479
208,159,49,-,155100,59480
222,140,82,700,114400,59482
226,185,41,757,206600,59483
58,40,18,-,123600,59484
251,248,3,-,207100,59485
449,349,100,575,137900,59486
512,381,131,634,160000,59487
128,89,39,700,97300,59489
5139,3139,2000,672,153600,59501
422,317,105,529,106600,59520
993,416,577,313,80900,59521
683,402,281,568,120800,59522
941,671,270,510,131000,59523
238,149,89,531,67100,59524
116,79,37,581,107500,59525
802,390,412,452,77200,59526
286,136,150,421,38500,59527
116,82,34,-,70000,59528
76,48,28,-,209400,59529
30,26,4,-,-,59530
129,116,13,-,112000,59531
91,68,23,-,122200,59532
34,14,20,-,-,59535
18,12,6,-,137500,59537
1255,973,282,581,145700,59538
127,110,17,625,98900,59540
61,40,21,367,75000,59542
86,42,44,284,-,59544
31,20,11,-,83300,59545
50,47,3,-,153100,59546
24,21,3,-,-,59547
13864,7721,6143,804,230000,59601
10145,8480,1665,969,243700,59602
106,92,14,450,166700,59631
639,441,198,732,174100,59632
94,91,3,-,288500,59633
1913,1777,136,1051,334600,59634
2744,2082,662,784,202200,59635
0,0,0,-,-,59636
218,188,30,550,258000,59638
542,424,118,660,168700,59639
41,41,0,-,201500,59640
38,20,18,-,75900,59642
211,194,17,-,159600,59643
1787,1385,402,677,183800,59644
646,472,174,635,154400,59645
136,128,8,-,169200,59647
248,185,63,1058,236900,59648
14647,9648,4999,622,140700,59701
22,22,0,-,362500,59703
100,63,37,588,174000,59710
3950,2736,1214,543,121000,59711
85,49,36,-,153100,59713
7720,5490,2230,911,251000,59714
14029,7377,6652,899,440100,59715
927,508,419,1278,378700,59716
14799,9185,5614,1166,329100,59718
83,83,0,-,355800,59720
188,149,39,675,225000,59721
1909,1302,607,618,142100,59722
37,20,17,-,200000,59724
3355,2250,1105,620,192500,59725
99,84,15,975,207700,59727
161,137,24,671,169800,59728
1089,771,318,810,317400,59729
822,606,216,840,514300,59730
53,44,9,-,258300,59731
85,33,52,867,189600,59732
61,32,29,638,262500,59733
97,74,23,-,255600,59735
40,26,14,625,-,59736
115,84,31,753,113600,59739
141,127,14,-,403700,59740
1748,1277,471,1073,275900,59741
54,39,15,-,143100,59743
38,28,10,-,162500,59745
70,66,4,-,275000,59746
67,55,12,-,252100,59747
108,104,4,-,167000,59748
746,610,136,715,208200,59749
165,156,9,-,212500,59750
115,73,42,-,187500,59751
1407,1016,391,769,234000,59752
407,306,101,814,242400,59754
100,86,14,875,202800,59755
11,0,11,-,-,59756
781,431,350,614,271800,59758
1551,1261,290,727,224400,59759
136,92,44,660,206700,59760
150,90,60,-,227800,59761
120,100,20,-,295000,59762
14237,5701,8536,793,240500,59801
9283,4238,5045,775,268100,59802
6603,5000,1603,881,300300,59803
3184,2134,1050,1034,332200,59804
7938,5189,2749,928,251000,59808
729,614,115,927,221300,59820
955,729,226,677,210100,59821
746,601,145,979,278400,59823
635,411,224,709,247000,59824
927,778,149,860,228400,59825
217,195,22,667,409600,59826
107,91,16,-,161200,59827
2158,1745,413,777,283400,59828
1023,748,275,615,248800,59829
84,65,19,-,172100,59830
195,141,54,450,111600,59831
286,171,115,528,162900,59832
2289,2022,267,990,307500,59833
930,828,102,638,321900,59834
189,133,56,517,241700,59837
6098,4192,1906,756,227000,59840
166,126,40,555,187500,59841
13,13,0,-,-,59842
106,65,41,629,273400,59843
281,230,51,718,269700,59844
600,433,167,490,117800,59845
596,559,37,-,364800,59846
2183,1784,399,623,243100,59847
63,51,12,-,187500,59848
57,57,0,-,114200,59851
331,244,87,-,220000,59853
100,68,32,644,255000,59854
330,121,209,783,-,59855
126,93,33,447,133000,59856
545,441,104,659,222200,59858
1291,1013,278,640,242300,59859
4276,3067,1209,690,239500,59860
30,23,7,-,95500,59863
2618,1745,873,630,191500,59864
1287,970,317,664,229600,59865
356,232,124,650,147500,59866
31,8,23,-,-,59867
815,690,125,715,244800,59868
4085,3299,786,736,288100,59870
127,75,52,-,271900,59871
825,607,218,295,169200,59872
1465,1073,392,832,262800,59873
647,547,100,442,232400,59874
1536,1165,371,761,246400,59875
20514,14451,6063,797,241600,59901
252,239,13,-,239000,59910
3584,2928,656,1080,344300,59911
5800,4342,1458,772,223200,59912
243,212,31,-,199100,59913
105,91,14,-,-,59914
139,100,39,-,138300,59915
80,74,6,-,280000,59916
1840,1492,348,692,226900,59917
296,245,51,728,-,59918
251,147,104,1090,112800,59919
638,550,88,835,287800,59920
868,654,214,932,291900,59922
4097,3054,1043,637,167500,59923
454,402,52,873,288600,59925
185,108,77,599,-,59926
145,107,38,838,282900,59927
97,78,19,-,420000,59928
102,78,24,-,268800,59929
219,173,46,-,176300,59930
139,111,28,-,504600,59931
550,505,45,-,228800,59932
23,20,3,-,-,59933
230,207,23,-,257300,59934
1554,1273,281,656,221500,59935
132,102,30,638,400000,59936
5897,4132,1765,888,363600,59937
9073,7218,1855,1020,203600,60002
20061,15856,4205,1387,355900,60004
12555,8009,4546,1220,332000,60005
13411,9946,3465,1197,268900,60007
8313,5616,2697,1268,226500,60008
16546,14918,1628,1498,537700,60010
3849,3536,313,1484,310100,60012
9131,7931,1200,1204,231000,60013
17585,13648,3937,1271,223500,60014
9768,8220,1548,1818,517300,60015
22895,15030,7865,1107,227600,60016
10029,7140,2889,996,243400,60018
4351,3083,1268,964,144000,60020
2085,1772,313,979,239600,60021
3091,2915,176,1199,915000,60022
14991,12362,2629,1256,435100,60025
5344,3821,1523,1683,588600,60026
150,147,3,-,855400,60029
14209,11011,3198,1223,212000,60030
13706,9931,3775,1220,248400,60031
4618,2882,1736,958,153700,60033
768,507,261,1053,166600,60034
11563,9623,1940,1737,576000,60035
1999,768,1231,1205,368400,60040
3424,2798,626,1106,172800,60041
3271,2618,653,1360,168400,60042
794,712,82,3250,1133000,60043
3927,2757,1170,1382,481300,60044
7437,6386,1051,1768,840200,60045
12418,10330,2088,1234,219700,60046
13757,12481,1276,1552,438900,60047
10315,8676,1639,1373,451100,60048
12470,8840,3630,1212,175800,60050
8648,7095,1553,1248,198400,60051
8336,7610,726,1817,308700,60053
20724,14385,6339,1101,320400,60056
12666,9690,2976,1354,250700,60060
9980,6657,3323,1591,344700,60061
15951,13144,2807,1641,501600,60062
5134,2100,3034,940,99200,60064
15571,12068,3503,1313,352400,60067
14231,11728,2503,1412,427000,60068
3432,2784,648,2714,458300,60069
5790,4005,1785,1054,263200,60070
1399,913,486,921,225400,60071
364,335,29,1063,302700,60072
18806,14547,4259,1304,155400,60073
14510,8923,5587,1128,240700,60074
10692,8332,2360,1288,318800,60076
10254,6107,4147,1185,268700,60077
3443,2943,500,1307,275400,60081
3506,2999,507,1718,257700,60083
6183,4784,1399,1169,225200,60084
22747,9242,13505,915,106000,60085
9517,6000,3517,1047,136200,60087
1109,0,1109,1638,-,60088
15596,12340,3256,1601,324600,60089
14019,8489,5530,1217,191500,60090
9635,8364,1271,1639,680300,60091
6871,6039,832,1704,930800,60093
2628,1977,651,1034,195300,60096
4370,3618,752,1149,161200,60097
12313,8103,4210,1020,199000,60098
10309,6493,3816,1015,127700,60099
13261,8900,4361,1017,244800,60101
11616,10253,1363,1651,250800,60102
13714,11854,1860,1571,276000,60103
6224,4247,1977,1079,134900,60104
7036,3826,3210,1102,223800,60106
13217,10862,2355,1684,182500,60107
8765,6456,2309,1334,300200,60108
202,147,55,1220,168800,60109
11106,7729,3377,1119,166300,60110
79,71,8,-,282300,60111
1426,1127,299,1149,153700,60112
139,76,63,854,109200,60113
16012,6350,9662,874,157900,60115
6474,4911,1563,1202,270000,60118
3588,3042,546,1343,298400,60119
15506,10131,5375,1059,165900,60120
16665,10881,5784,1019,166700,60123
7774,7147,627,2119,296600,60124
16837,13525,3312,1516,411600,60126
121,103,18,1028,138800,60129
7115,3636,3479,1045,230700,60130
6213,4599,1614,856,189800,60131
11219,8391,2828,1271,183800,60133
10510,8784,1726,1482,346900,60134
2632,1742,890,1041,182400,60135
2406,2268,138,1694,255400,60136
14295,11351,2944,1041,389700,60137
11451,7220,4231,1219,179300,60139
6031,5171,860,1643,257700,60140
22,0,22,-,-,60141
11564,10657,907,1265,246200,60142
4208,3174,1034,1215,328100,60143
32,30,2,-,259100,60144
847,596,251,1099,189500,60145
1005,767,238,737,151900,60146
20300,14653,5647,1338,256000,60148
690,524,166,974,156600,60150
1489,1202,287,1389,220400,60151
4591,3441,1150,941,204700,60152
7690,4677,3013,966,146300,60153
6557,5916,641,1431,235000,60154
3204,2071,1133,983,149300,60155
9614,7969,1645,1428,220700,60156
855,838,17,-,361900,60157
7695,3989,3706,972,178600,60160
2969,1783,1186,1109,161000,60162
1713,1480,233,968,178800,60163
6551,4752,1799,945,170600,60164
1264,640,624,1099,121100,60165
11615,7796,3819,1292,222200,60169
3765,2270,1495,939,202500,60171
9018,6923,2095,1372,251700,60172
5695,1886,3809,1398,324200,60173
12491,8706,3785,1229,280900,60174
7990,7661,329,2093,400300,60175
4291,2555,1736,981,191900,60176
7482,6059,1423,1437,228400,60177
8353,5493,2860,982,195000,60178
630,429,201,2128,258900,60180
10776,7489,3287,1202,232600,60181
863,809,54,3200,541700,60184
10573,7785,2788,1096,260300,60185
9825,7225,2600,1277,351500,60187
14961,10207,4754,1231,248800,60188
11539,8783,2756,1419,366100,60189
4389,4004,385,2002,302300,60190
5192,4067,1125,1266,228100,60191
5301,4744,557,2332,344500,60192
15126,11417,3709,1389,262500,60193
7476,5304,2172,1448,218800,60194
2223,739,1484,1394,210500,60195
15088,9008,6080,1480,482200,60201
13436,7044,6392,1280,311100,60202
1489,1385,104,1426,443100,60203
1595,357,1238,1824,181200,60301
13707,7867,5840,1062,392800,60302
6382,4456,1926,1169,368400,60304
3965,3528,437,1182,581900,60305
3037,2640,397,1022,174100,60401
20764,12408,8356,950,190700,60402
6897,4576,2321,1084,168400,60403
6449,5702,747,1566,247100,60404
8747,4432,4315,868,115500,60406
618,449,169,927,133200,60407
2149,1571,578,972,162600,60408
13822,7432,6390,955,103800,60409
4160,3729,431,1274,213700,60410
19502,12170,7332,964,101100,60411
5159,2712,2447,989,159000,60415
3650,2585,1065,991,188600,60416
5780,5015,765,966,177500,60417
7637,5075,2562,1185,98000,60419
2111,1449,662,672,133800,60420
1453,1319,134,1030,187900,60421
3495,3060,435,2106,234700,60422
10271,9636,635,1352,316300,60423
1006,754,252,892,151300,60424
3040,2373,667,1303,128000,60425
10311,5382,4929,892,73600,60426
4015,2877,1138,1273,87100,60428
5816,3722,2094,1415,111500,60429
7848,6061,1787,1154,159400,60430
7405,6501,904,1523,185100,60431
6184,3311,2873,932,105600,60432
5431,3135,2296,1001,112800,60433
18318,11534,6784,968,153900,60435
6031,3604,2427,1057,115000,60436
77,63,14,-,110500,60437
11440,7466,3974,1008,130100,60438
8258,6883,1375,1074,363500,60439
16415,12150,4265,1361,184200,60440
11854,9643,2211,1216,213700,60441
3482,2974,508,1309,247400,60442
8201,6702,1499,1247,156400,60443
696,504,192,951,166800,60444
10568,7881,2687,954,146000,60445
11665,9666,1999,1515,181000,60446
4647,4121,526,1536,199700,60447
9122,8186,936,1049,306100,60448
3592,3308,284,881,206100,60449
8496,5233,3263,947,211200,60450
11561,10540,1021,1190,284000,60451
10295,7978,2317,1070,188300,60452
21415,16841,4574,1029,194300,60453
5559,3945,1614,946,171600,60455
1718,1421,297,-,113100,60456
4957,3576,1381,942,223700,60457
5330,2907,2423,1035,168400,60458
9173,7129,2044,1046,182100,60459
516,398,118,867,112400,60460
1922,1638,284,1676,228500,60461
15364,12920,2444,1217,267000,60462
5448,5102,346,1595,275800,60463
3847,3321,526,1609,389800,60464
6714,5098,1616,1055,199400,60465
8386,5000,3386,1186,70500,60466
9779,9315,464,1168,335600,60467
2233,1841,392,859,201300,60468
1822,1305,517,1033,108800,60469
210,177,33,820,117600,60470
5070,2760,2310,986,144000,60471
1617,805,812,847,72700,60472
7279,6121,1158,1442,150400,60473
402,298,104,813,127200,60474
4340,2810,1530,911,107300,60475
1043,754,289,858,110100,60476
15030,11561,3469,1161,207500,60477
5874,4420,1454,1257,130200,60478
372,276,96,1099,170900,60479
1977,1594,383,1135,316700,60480
4678,3591,1087,865,169600,60481
4107,2638,1469,941,158600,60482
2444,1470,974,986,117500,60484
8866,8240,626,1091,254600,60487
6068,5763,305,2394,280400,60490
7854,7381,473,1438,323200,60491
3472,1814,1658,880,159300,60501
8056,6258,1798,1563,290700,60502
5303,4635,668,1807,237800,60503
13163,7696,5467,1544,204300,60504
21665,12176,9489,1080,120800,60505
17759,11383,6376,1015,169300,60506
10789,8411,2378,1180,302000,60510
652,561,91,1121,232400,60511
391,356,35,-,206500,60512
6997,5512,1485,1050,239700,60513
3849,2993,856,963,499600,60514
11522,8721,2801,1164,355100,60515
11973,9341,2632,1344,338900,60516
12689,8449,4240,1229,259500,60517
1372,973,399,759,134100,60518
24,18,6,-,-,60519
1058,809,249,949,214800,60520
6048,5156,892,1934,864700,60521
4477,3729,748,635,680100,60523
11508,9190,2318,1063,344100,60525
5126,3596,1530,1166,345000,60526
11408,9034,2374,1406,424900,60527
201,154,47,857,122100,60530
699,561,138,849,180900,60531
12354,7497,4857,1274,306500,60532
3836,2360,1476,978,164600,60534
44,30,14,1125,191700,60536
243,216,27,875,182300,60537
9072,7327,1745,1313,190300,60538
0,0,0,-,-,60539
16048,12191,3857,1450,413700,60540
1258,1051,207,936,255500,60541
6640,5296,1344,1042,241900,60542
13167,11136,2031,1191,238500,60543
9347,7438,1909,1710,224100,60544
4398,3198,1200,859,167500,60545
5864,4427,1437,1027,294000,60546
4398,3451,947,1081,172200,60548
94,94,0,-,200000,60549
642,418,224,805,183900,60550
1540,1228,312,838,216500,60551
1744,1286,458,1091,182700,60552
300,240,60,854,150900,60553
4467,4052,415,1395,282200,60554
4939,3908,1031,1495,217700,60555
721,561,160,913,166200,60556
76,76,0,-,112500,60557
4401,4221,180,1941,590800,60558
10390,5756,4634,1123,287100,60559
8286,6801,1485,1220,244100,60560
9162,7726,1436,1225,322300,60561
15208,8424,6784,1423,335100,60563
13343,11893,1450,1944,453400,60564
13810,12405,1405,1401,385100,60565
7098,6405,693,1907,331600,60585
13377,12254,1123,1748,216400,60586
8864,3335,5529,2212,499900,60601
602,225,377,3055,-,60602
564,325,239,2259,676900,60603
479,170,309,2015,480000,60604
13865,7727,6138,2033,395700,60605
2084,912,1172,2177,421500,60606
12823,5504,7319,1825,376800,60607
25627,9348,16279,907,252200,60608
20603,7657,12946,806,172000,60609
23269,9261,14008,1582,430600,60610
20726,9619,11107,1967,552700,60611
13142,3637,9505,1016,269800,60612
26449,10405,16044,1360,332200,60613
33584,14969,18615,1611,593000,60614
21122,6317,14805,1107,238500,60615
24417,8786,15631,1033,316000,60616
28188,15960,12228,846,131500,60617
35091,16404,18687,1187,386400,60618
26234,10696,15538,877,156100,60619
25239,11727,13512,889,139900,60620
10900,2656,8244,830,104100,60621
23410,8767,14643,1472,483900,60622
25005,8434,16571,860,155900,60623
11831,2889,8942,938,164500,60624
29527,11726,17801,1155,336100,60625
22417,5540,16877,977,203300,60626
22996,13158,9838,942,119400,60628
31827,18179,13648,920,159400,60629
20952,13441,7511,1066,298200,60630
11921,9041,2880,1180,344600,60631
24918,13439,11479,868,171200,60632
4682,3175,1507,919,121900,60633
26116,18719,7397,1083,252000,60634
11062,5204,5858,882,93300,60636
19232,4843,14389,946,185100,60637
20199,15551,4648,980,208800,60638
25570,12006,13564,1000,223300,60639
34969,11066,23903,1006,292500,60640
24773,12793,11980,1016,284100,60641
9263,3618,5645,1642,426500,60642
17934,13410,4524,1008,195200,60643
16339,4538,11801,936,155300,60644
16255,8221,8034,1100,273200,60645
10904,8218,2686,1060,399500,60646
34714,13301,21413,1228,378000,60647
21043,4526,16517,888,158800,60649
19653,8607,11046,1002,164500,60651
13370,10898,2472,1120,168700,60652
14575,3488,11087,792,264400,60653
12068,5098,6970,2127,450000,60654
10231,8856,1375,1121,246700,60655
12088,7424,4664,1107,288400,60656
36624,14252,22372,1477,439200,60657
13193,5234,7959,1120,306200,60659
20676,7574,13102,1002,239200,60660
5911,1716,4195,1943,364000,60661
8869,6822,2047,995,275600,60706
15626,10312,5314,1012,248400,60707
4260,3612,648,1868,393500,60712
11004,8084,2920,1117,273300,60714
8433,5223,3210,946,168100,60803
22226,10850,11376,910,154600,60804
6998,5437,1561,1082,187000,60805
10851,4552,6299,783,89200,60827
12677,7616,5061,838,111400,60901
226,155,71,834,91500,60910
530,391,139,728,142900,60911
215,186,29,912,85500,60912
595,557,38,676,187000,60913
10372,7494,2878,950,171500,60914
3725,2267,1458,881,118400,60915
162,130,32,-,137200,60917
362,317,45,625,83500,60918
208,164,44,963,82800,60919
80,60,20,933,90000,60920
606,422,184,609,78300,60921
872,694,178,868,132300,60922
669,508,161,619,113500,60924
20,20,0,-,62500,60926
827,644,183,758,140100,60927
317,258,59,743,93500,60928
333,215,118,594,89100,60929
339,286,53,988,123400,60930
210,178,32,645,89600,60931
41,33,8,-,-,60932
135,99,36,656,85300,60933
126,102,24,575,166700,60934
377,348,29,1141,211200,60935
1861,1245,616,658,124800,60936
789,579,210,690,120400,60938
1283,1060,223,1088,209600,60940
822,672,150,553,168600,60941
2437,1709,728,545,72000,60942
86,77,9,925,65900,60945
180,137,43,621,81000,60946
656,575,81,668,165300,60948
222,158,64,750,76000,60949
4501,3160,1341,872,177900,60950
331,244,87,837,118800,60951
264,220,44,650,83500,60952
1026,824,202,559,79700,60953
2099,1531,568,836,140200,60954
617,524,93,760,103400,60955
2129,1520,609,606,104300,60957
715,397,318,735,76500,60958
481,352,129,720,84300,60959
399,326,73,639,70600,60960
272,247,25,975,109500,60961
290,182,108,731,62000,60962
683,455,228,612,76300,60963
1920,1427,493,725,132100,60964
651,531,120,715,65700,60966
129,99,30,542,97500,60968
17,11,6,-,95000,60969
3151,2141,1010,635,84800,60970
167,98,69,767,74000,60973
120,100,20,720,75000,60974
477,418,59,588,149200,61001
708,504,204,856,122900,61006
201,149,52,738,121000,61007
12258,9217,3041,773,137100,61008
2935,2320,615,760,177200,61010
835,803,32,1265,205000,61011
856,689,167,927,145400,61012
186,176,10,833,88700,61013
505,392,113,757,93600,61014
399,305,94,583,166900,61015
2116,1703,413,755,165100,61016
424,335,89,646,101200,61018
1321,1184,137,858,152500,61019
1014,879,135,958,148600,61020
8943,6485,2458,677,118400,61021
1036,827,209,685,143800,61024
1950,1475,475,637,142600,61025
40,0,40,-,-,61027
1020,752,268,718,129100,61028
940,702,238,685,104200,61030
624,475,149,644,118300,61031
13238,8305,4933,642,84800,61032
3022,2427,595,684,218800,61036
26,26,0,-,95700,61037
433,420,13,-,170100,61038
370,283,87,754,120600,61039
532,360,172,520,84100,61041
278,201,77,474,143800,61042
35,26,9,910,120800,61043
103,84,19,-,95000,61044
1071,842,229,636,140600,61046
831,680,151,704,158400,61047
1680,1320,360,512,106000,61048
216,190,26,794,165500,61049
166,137,29,-,78900,61050
717,499,218,673,112500,61051
360,335,25,900,183200,61052
1184,908,276,563,98300,61053
1645,974,671,709,96600,61054
48,48,0,-,-,61057
74,60,14,833,96700,61059
637,462,175,616,113900,61060
2953,2134,819,614,150400,61061
730,624,106,750,135600,61062
1741,1361,380,837,128800,61063
1531,1171,360,706,108600,61064
3383,2879,504,1342,149400,61065
350,292,58,827,140000,61067
5708,3629,2079,764,122300,61068
524,456,68,553,135500,61070
5689,4139,1550,742,85900,61071
4439,3800,639,746,163100,61072
6995,5924,1071,1053,167300,61073
1989,1453,536,635,79800,61074
440,382,58,703,148100,61075
18,18,0,-,-,61077
535,449,86,515,113200,61078
54,47,7,-,114600,61079
3888,2959,929,714,128800,61080
8813,6244,2569,657,103500,61081
1217,1105,112,1025,164200,61084
1486,1154,332,627,104300,61085
666,517,149,567,85800,61087
2356,2077,279,777,155700,61088
307,253,54,625,109600,61089
20,20,0,-,-,61091
7595,3915,3680,708,68200,61101
6113,3998,2115,717,72500,61102
10319,5601,4718,712,85100,61103
7865,2580,5285,658,56400,61104
13288,8890,4398,884,124200,61107
11234,7433,3801,824,96300,61108
10881,6564,4317,743,99700,61109
9813,6706,3107,840,110100,61111
59,0,59,-,-,61112
6529,4767,1762,932,151000,61114
8660,6581,2079,944,115600,61115
15433,10028,5405,728,102000,61201
500,427,73,718,123800,61230
2270,1565,705,619,108600,61231
524,476,48,675,143300,61232
601,410,191,666,113700,61234
592,508,84,875,111100,61235
41,25,16,900,91700,61236
1323,1129,194,818,112600,61238
503,188,315,814,91400,61239
2446,2146,300,1151,179700,61240
2731,2309,422,738,134200,61241
511,417,94,771,140200,61242
107,97,10,-,135400,61243
9319,6401,2918,650,109800,61244
1038,850,188,700,135600,61250
139,139,0,-,147300,61251
2357,1857,500,630,129200,61252
4429,3613,816,668,171900,61254
792,652,140,900,147400,61256
431,359,72,668,95300,61257
77,65,12,-,56800,61258
494,394,100,914,179300,61259
443,354,89,638,91200,61260
360,289,71,795,76400,61261
448,417,31,718,144800,61262
259,174,85,575,99300,61263
4739,3511,1228,700,120600,61264
18928,12423,6505,749,119300,61265
2878,2378,500,726,124800,61270
527,424,103,629,93800,61272
1365,1184,181,707,151000,61273
93,58,35,-,114300,61274
1836,1592,244,903,194700,61275
36,36,0,-,126300,61276
1320,1066,254,697,107600,61277
161,149,12,610,195300,61278
397,317,80,864,112000,61279
969,855,114,870,162900,61281
3354,1921,1433,771,114900,61282
547,428,119,597,81000,61283
870,804,66,1163,185600,61284
673,584,89,764,144600,61285
4218,2681,1537,843,92300,61301
1582,1160,422,690,104500,61310
88,75,13,-,110400,61311
207,163,44,1057,126800,61312
88,69,19,-,132300,61313
375,301,74,757,69600,61314
76,54,22,850,47500,61315
130,108,22,927,84200,61316
195,161,34,639,79800,61317
305,211,94,1111,128700,61318
567,492,75,769,125700,61319
314,253,61,744,124500,61320
104,87,17,-,78900,61321
510,373,137,656,53500,61322
30,28,2,-,60000,61323
44,44,0,-,82500,61324
389,317,72,725,116800,61325
920,741,179,649,115700,61326
523,392,131,782,160100,61327
9,9,0,-,-,61328
519,450,69,783,103800,61329
581,505,76,641,124800,61330
9,9,0,-,-,61331
35,35,0,-,83500,61332
120,116,4,-,95700,61333
281,215,66,850,92100,61334
172,125,47,713,122300,61335
219,178,41,725,125000,61336
168,130,38,855,87100,61337
120,90,30,621,77100,61338
115,95,20,644,126800,61340
3129,2317,812,892,143300,61341
3425,2465,960,525,125000,61342
164,119,45,725,62500,61344
338,303,35,809,109000,61345
33,33,0,-,57500,61346
1906,1541,365,592,105600,61348
358,284,74,815,96300,61349
10017,6740,3277,790,137500,61350
522,409,113,771,134400,61353
4643,3273,1370,720,122900,61354
4666,3403,1263,623,137100,61356
143,125,18,675,73400,61358
125,109,16,788,89600,61359
1341,1004,337,922,164200,61360
471,355,116,672,81700,61361
2333,1641,692,539,112100,61362
130,96,34,369,83300,61363
8068,5984,2084,645,86000,61364
352,253,99,779,134500,61367
576,474,102,723,104500,61368
737,625,112,630,85500,61369
563,420,143,696,136700,61370
60,43,17,700,114000,61372
893,746,147,815,175900,61373
58,48,10,-,84300,61374
512,499,13,575,120700,61375
872,661,211,638,101300,61376
598,442,156,674,113400,61377
166,145,21,940,116900,61378
565,479,86,720,85400,61379
13714,8005,5709,639,78700,61401
1535,1074,461,531,66900,61410
233,184,49,730,106500,61411
591,529,62,683,75600,61412
398,324,74,656,100700,61413
373,271,102,622,73100,61414
740,627,113,633,87700,61415
110,83,27,-,30600,61416
112,103,9,-,86200,61417
252,213,39,775,95900,61418
64,52,12,-,78200,61419
465,383,82,558,82000,61420
510,415,95,685,86000,61421
1255,959,296,450,71100,61422
205,180,25,-,99600,61423
42,30,12,-,86700,61424
179,172,7,-,108000,61425
42,42,0,-,122500,61426
883,744,139,702,87800,61427
408,405,3,-,193800,61428
323,234,89,648,97100,61430
139,109,30,608,98300,61431
253,230,23,913,83100,61432
31,26,5,-,-,61433
1336,1016,320,503,76300,61434
14,14,0,-,-,61435
326,268,58,639,104200,61436
402,309,93,538,105300,61437
338,274,64,621,112500,61438
115,92,23,728,82500,61439
285,264,21,930,82500,61440
432,362,70,574,83300,61441
310,240,70,383,61600,61442
5570,3672,1898,592,65700,61443
404,381,23,605,86100,61447
1427,1126,301,625,110500,61448
166,136,30,481,48200,61449
742,646,96,589,74000,61450
119,117,2,-,89300,61451
108,107,1,-,56900,61452
251,193,58,638,62900,61453
234,170,64,531,66500,61454
7166,4205,2961,660,111800,61455
321,265,56,675,75600,61458
163,148,15,-,104500,61459
134,112,22,675,89400,61460
4384,3123,1261,631,82100,61462
513,424,89,665,90700,61465
146,115,31,575,73600,61466
417,339,78,713,103400,61467
37,37,0,-,-,61468
1001,835,166,491,80700,61469
166,154,12,650,70000,61470
30,30,0,-,45000,61471
236,217,19,575,146000,61472
627,481,146,546,81200,61473
112,92,20,763,58200,61474
96,78,18,483,112000,61475
167,155,12,-,87500,61476
274,210,64,779,83500,61477
117,113,4,-,152200,61478
25,25,0,-,84100,61479
488,333,155,536,101000,61480
275,226,49,675,69300,61482
878,695,183,612,82200,61483
352,320,32,650,55300,61484
216,167,49,725,71300,61485
576,456,120,594,110200,61486
457,384,73,440,87000,61488
378,281,97,608,79500,61489
469,371,98,797,95000,61490
844,697,147,544,93900,61491
673,602,71,495,59200,61501
288,239,49,663,109100,61516
1220,1092,128,809,222100,61517
112,86,26,645,86000,61519
6379,4456,1923,610,94700,61520
4420,3571,849,720,139000,61523
144,97,47,788,75000,61524
3112,2595,517,1023,270300,61525
294,294,0,-,191400,61526
1114,958,156,1141,246300,61528
1061,857,204,565,137100,61529
2560,1824,736,647,145700,61530
1364,1129,235,723,98900,61531
252,233,19,731,85800,61532
949,783,166,669,129500,61533
705,614,91,639,140800,61534
561,541,20,-,198500,61535
1186,936,250,681,156800,61536
1155,914,241,617,102900,61537
86,70,16,678,63300,61539
1047,800,247,619,101500,61540
53,51,2,-,66300,61541
1477,1169,308,645,90500,61542
71,56,15,413,45400,61543
245,212,33,1250,65300,61544
273,248,25,725,106500,61545
1646,1387,259,703,116400,61546
1503,1418,85,1036,186300,61547
4362,3772,590,945,209400,61548
7495,5736,1759,916,194000,61550
60,50,10,-,113100,61552
66,53,13,667,58200,61553
17390,12704,4686,677,108800,61554
1170,962,208,809,161600,61559
282,268,14,-,156700,61560
966,794,172,679,125800,61561
27,27,0,-,-,61562
226,165,61,645,58900,61563
343,276,67,747,77800,61564
644,583,61,770,136800,61565
258,209,49,835,74200,61567
1474,1185,289,761,181000,61568
440,430,10,-,149600,61569
695,521,174,734,89400,61570
9881,7667,2214,863,166100,61571
521,400,121,694,106300,61572
551,104,447,544,235000,61602
6338,3135,3203,809,66700,61603
12647,8342,4305,708,91600,61604
5829,2184,3645,687,36700,61605
2225,902,1323,722,125300,61606
4230,3675,555,881,130200,61607
2146,1539,607,628,81300,61610
10777,8248,2529,728,143200,61611
12683,8193,4490,805,146100,61614
9802,5797,4005,867,183500,61615
2659,1477,1182,730,83200,61616
5,0,5,-,-,61625
15213,7922,7291,760,117900,61701
14773,10019,4754,937,200900,61704
4458,3729,729,919,258600,61705
73,60,13,907,85000,61720
242,189,53,813,120100,61721
173,135,38,943,98100,61722
996,857,139,733,106300,61723
195,160,35,817,94300,61724
549,537,12,850,185100,61725
973,680,293,758,113900,61726
4078,3158,920,524,97100,61727
484,375,109,698,111400,61728
430,396,34,775,185300,61729
146,127,19,735,137000,61730
83,83,0,-,124100,61731
749,657,92,698,145600,61732
331,275,56,895,155200,61733
1115,863,252,726,119600,61734
169,150,19,625,-,61735
623,577,46,933,208600,61736
197,166,31,671,123200,61737
1586,1255,331,812,135000,61738
1899,1377,522,672,111600,61739
617,497,120,756,116700,61740
600,463,137,635,114200,61741
476,426,50,572,214800,61742
84,78,6,-,88800,61743
716,590,126,667,125300,61744
1626,1309,317,838,168800,61745
587,450,137,875,139800,61747
1054,960,94,753,182600,61748
212,176,36,716,71500,61749
65,60,5,-,86300,61750
40,32,8,-,104200,61751
1659,1305,354,618,149600,61752
1151,948,203,688,168100,61753
442,356,86,785,116700,61754
1778,1578,200,721,174200,61755
857,712,145,582,99200,61756
597,473,124,809,124300,61759
1015,830,185,741,101800,61760
19689,10809,8880,854,170200,61761
5168,3423,1745,697,106900,61764
232,202,30,600,84200,61769
464,367,97,711,107300,61770
291,274,17,829,117500,61771
99,70,29,575,187500,61772
189,141,48,647,71700,61773
394,339,55,825,118400,61774
107,86,21,800,90000,61775
532,464,68,1053,184500,61776
313,257,56,690,106300,61777
253,230,23,650,81200,61778
11568,3766,7802,807,150400,61801
8579,4958,3621,824,122800,61802
134,104,30,656,94400,61810
227,175,52,978,81900,61811
166,135,31,553,98300,61812
668,537,131,728,91200,61813
422,347,75,728,105300,61814
107,77,30,873,105100,61815
174,158,16,825,94500,61816
1077,831,246,786,101400,61817
641,562,79,625,97100,61818
14299,3074,11225,860,141100,61820
13366,7704,5662,924,137500,61821
10226,7099,3127,1137,219200,61822
162,140,22,842,92700,61830
63,60,3,-,93300,61831
14435,8472,5963,696,65800,61832
937,710,227,720,67500,61833
2711,2305,406,667,121700,61834
255,206,49,478,91400,61839
296,250,46,998,242900,61840
515,470,45,604,116900,61841
1217,945,272,822,127200,61842
906,745,161,751,138100,61843
319,286,33,781,96600,61844
161,146,15,1075,157900,61845
2060,1489,571,689,77100,61846
463,414,49,725,147700,61847
83,67,16,638,65000,61848
788,675,113,728,123900,61849
168,155,13,646,67900,61850
150,126,24,619,99500,61851
79,72,7,-,60000,61852
4953,4132,821,1000,207900,61853
534,446,88,769,126500,61854
56,56,0,-,-,61855
3177,2507,670,990,168300,61856
96,81,15,638,56700,61857
1242,1036,206,709,100200,61858
477,439,38,1000,135600,61859
209,179,30,667,161000,61862
305,270,35,927,131500,61863
630,555,75,786,160400,61864
568,452,116,635,93500,61865
5514,2861,2653,765,90600,61866
537,406,131,694,74100,61870
134,116,18,-,145000,61871
303,273,30,725,109900,61872
2379,2022,357,489,183300,61873
3388,1635,1753,895,219600,61874
302,251,51,864,304600,61875
231,204,27,515,80000,61876
666,549,117,900,160000,61877
637,469,168,704,97400,61878
1400,1229,171,546,148800,61880
290,255,35,722,84800,61882
1670,1298,372,658,71100,61883
460,405,55,667,203200,61884
1449,928,521,708,113300,61910
1597,1151,446,666,123900,61911
585,494,91,607,87600,61912
656,546,110,598,86600,61913
783,672,111,675,90500,61914
310,233,77,827,71000,61917
369,320,49,780,139400,61919
9124,4994,4130,707,107100,61920
977,782,195,538,83100,61924
273,257,16,1094,105200,61925
365,262,103,677,84800,61928
288,202,86,600,83800,61929
271,202,69,693,64800,61930
439,342,97,727,91400,61931
204,154,50,688,65600,61932
437,330,107,475,65000,61933
113,113,0,-,104300,61936
842,625,217,557,84500,61937
9374,5919,3455,635,92800,61938
100,83,17,-,34400,61940
45,6,39,-,-,61941
481,371,110,627,76300,61942
744,602,142,604,81700,61943
5263,3926,1337,617,83400,61944
80,66,14,500,62500,61949
3297,2529,768,716,124100,61951
2599,1767,832,708,113300,61953
76,56,20,1023,57300,61955
1108,879,229,677,99500,61956
781,605,176,706,73500,61957
706,575,131,604,161700,62001
13397,8662,4735,771,92600,62002
180,175,5,-,114400,62006
745,553,192,719,66300,62009
4532,3305,1227,799,142600,62010
71,67,4,-,-,62011
2525,2214,311,726,153800,62012
256,207,49,608,121200,62013
1658,1309,349,675,129900,62014
243,194,49,918,104400,62015
1380,1042,338,649,96500,62016
444,358,86,544,83100,62017
1290,824,466,754,67300,62018
181,147,34,941,148800,62019
383,374,9,-,187000,62021
449,414,35,-,150500,62022
35,35,0,-,66100,62023
4271,2868,1403,825,106300,62024
12079,8755,3324,910,222300,62025
206,189,17,488,105900,62027
332,277,55,695,127100,62028
49,35,14,822,53800,62030
323,310,13,-,112000,62031
285,264,21,675,82500,62032
1960,1446,514,708,87500,62033
5589,4092,1497,1021,211400,62034
6788,5431,1357,880,137200,62035
351,310,41,650,155100,62036
872,720,152,665,176700,62037
17699,12226,5473,770,84800,62040
807,666,141,539,86500,62044
135,129,6,238,82600,62045
277,192,85,887,160400,62046
540,413,127,489,115400,62047
672,508,164,886,74400,62048
2755,2151,604,667,82700,62049
115,80,35,725,39400,62050
295,234,61,763,74700,62051
4926,3619,1307,594,141800,62052
187,136,51,496,66900,62053
271,224,47,569,83500,62054
3791,2669,1122,547,88400,62056
377,253,124,733,79200,62058
208,81,127,447,33600,62059
1973,966,1007,701,41200,62060
690,542,148,765,168900,62061
3465,2678,787,966,193700,62062
474,396,78,693,108200,62063
54,54,0,-,-,62065
1149,922,227,588,162100,62067
1289,1097,192,769,73400,62069
37,37,0,-,-,62070
479,436,43,691,145300,62074
1393,1138,255,641,79600,62075
51,39,12,-,80600,62076
108,94,14,696,55500,62077
26,23,3,-,45800,62078
93,93,0,-,-,62079
916,814,102,588,78800,62080
130,124,6,-,79500,62081
994,772,222,627,68300,62082
87,87,0,-,132800,62083
607,382,225,784,79800,62084
76,53,23,825,64400,62085
588,494,94,635,77900,62086
787,453,334,753,74600,62087
2874,1948,926,649,109400,62088
222,156,66,658,76300,62089
486,158,328,699,41600,62090
146,122,24,-,72500,62091
1194,947,247,497,58000,62092
193,153,40,766,52900,62093
442,380,62,572,50900,62094
4417,2740,1677,770,85000,62095
1091,968,123,823,173400,62097
16,16,0,-,24000,62098
2587,701,1886,410,61700,62201
2832,1962,870,908,53700,62203
3339,1369,1970,480,47300,62204
3370,1814,1556,811,51600,62205
5223,2452,2771,831,50500,62206
3495,1396,2099,526,46700,62207
7006,4603,2403,1038,125100,62208
507,441,66,627,149500,62214
685,484,201,746,167300,62215
987,783,204,829,177300,62216
336,247,89,829,75700,62217
618,556,62,868,198500,62218
397,318,79,769,98000,62219
7493,4694,2799,791,109600,62220
12151,8025,4126,867,166500,62221
6870,5212,1658,798,107000,62223
1344,19,1325,1571,-,62225
12258,7910,4348,817,117800,62226
2570,2163,407,1196,163600,62230
2969,2365,604,811,135500,62231
2581,2117,464,948,92200,62232
2484,1831,653,581,102200,62233
13375,9304,4071,879,137800,62234
5286,4560,726,846,223300,62236
1016,845,171,654,106700,62237
241,176,65,675,59700,62238
1956,1398,558,850,80600,62239
575,404,171,845,80500,62240
432,388,44,654,114400,62241
530,477,53,620,87700,62242
2355,1916,439,891,176200,62243
411,365,46,792,234100,62244
698,591,107,759,161700,62245
3324,2365,959,588,144200,62246
156,113,43,713,127400,62248
6142,4567,1575,742,170200,62249
195,172,23,705,90000,62250
256,230,26,620,78600,62253
2512,1674,838,845,145900,62254
378,316,62,775,141000,62255
1165,920,245,736,86500,62257
3364,2682,682,930,159700,62258
2910,2445,465,782,208900,62260
50,50,0,-,-,62261
697,645,52,617,77100,62262
2207,1705,502,655,120700,62263
1481,1143,338,805,133700,62264
1695,1298,397,1019,154400,62265
30,30,0,-,-,62266
274,210,64,677,163600,62268
11756,8472,3284,1006,194600,62269
921,709,212,719,113800,62271
630,511,119,610,112300,62272
126,89,37,-,85000,62273
2502,1825,677,434,87400,62274
1497,1267,230,820,150600,62275
570,505,65,625,86100,62277
2528,2011,517,706,163200,62278
7,7,0,-,-,62279
152,128,24,-,87800,62280
937,837,100,1086,208400,62281
163,148,15,908,125000,62282
228,188,40,694,97400,62284
1669,1488,181,950,176200,62285
2667,1877,790,605,100100,62286
1255,912,343,692,114400,62288
124,76,48,838,83300,62289
364,266,98,628,57300,62292
1739,1333,406,735,166500,62293
5203,4024,1179,818,189700,62294
564,471,93,921,160200,62295
126,115,11,-,179200,62297
6660,5497,1163,844,208400,62298
13872,8247,5625,658,97100,62301
7653,6481,1172,804,173900,62305
288,251,37,513,77500,62311
813,632,181,538,67200,62312
165,141,24,-,69800,62313
188,159,29,525,75000,62314
207,174,33,567,52600,62316
133,121,12,-,132200,62319
838,679,159,863,132700,62320
1689,1344,345,530,93900,62321
111,103,8,-,115200,62323
496,409,87,333,85800,62324
171,144,27,640,97500,62325
930,722,208,611,77900,62326
778,668,110,631,76300,62330
59,49,10,715,67700,62334
12,10,2,-,58000,62336
473,446,27,-,169600,62338
367,300,67,481,93800,62339
699,543,156,641,73300,62340
1389,1035,354,627,106400,62341
347,290,57,572,54000,62343
7,4,3,-,-,62344
179,152,27,513,81800,62345
96,87,9,-,74700,62346
749,644,105,497,171900,62347
65,65,0,-,92500,62348
251,215,36,522,128100,62349
747,607,140,815,116400,62351
109,89,20,660,69000,62352
1508,1077,431,564,92200,62353
612,463,149,767,114600,62354
319,297,22,375,59600,62355
198,140,58,525,65600,62356
189,125,64,516,83500,62357
295,285,10,-,113100,62358
85,85,0,-,91400,62359
700,595,105,721,102100,62360
171,147,24,616,113500,62361
156,125,31,347,52800,62362
2463,1837,626,588,99600,62363
243,217,26,606,85000,62365
641,519,122,510,64900,62366
455,356,99,566,64300,62367
105,99,6,-,84300,62370
121,121,0,-,72100,62373
195,184,11,565,76900,62374
136,129,7,-,150700,62375
470,307,163,666,95700,62376
435,370,65,659,83500,62378
712,587,125,642,83400,62379
114,100,14,313,-,62380
7689,5597,2092,585,144900,62401
416,379,37,606,89000,62410
1610,1241,369,684,117000,62411
149,125,24,-,96300,62413
749,629,120,458,105000,62414
1373,1082,291,543,70000,62417
767,624,143,668,80500,62418
110,106,4,750,38600,62419
2130,1646,484,706,79400,62420
203,171,32,821,81400,62421
442,361,81,692,82000,62422
219,204,15,-,150000,62423
889,775,114,744,150100,62424
221,214,7,-,75000,62425
351,315,36,662,61000,62426
673,545,128,708,109300,62427
1132,857,275,529,89000,62428
417,323,94,634,55800,62431
174,155,19,-,93200,62432
429,380,49,700,73800,62433
178,169,9,-,85800,62434
273,225,48,528,77200,62436
101,93,8,-,102200,62438
3235,2243,992,671,75900,62439
543,451,92,691,81700,62440
2839,1966,873,716,113200,62441
1213,886,327,586,85100,62442
619,551,68,827,133500,62443
127,120,7,-,137500,62444
476,372,104,561,110400,62445
156,133,23,-,86200,62446
1425,1153,272,587,100600,62447
2173,1714,459,580,100700,62448
1366,1074,292,637,85200,62449
5156,3500,1656,550,90500,62450
933,709,224,498,69700,62451
151,104,47,671,78000,62452
4167,3170,997,640,98500,62454
803,671,132,570,82500,62458
120,108,12,438,66700,62459
500,417,83,588,76600,62460
299,261,38,490,155100,62461
336,274,62,539,117900,62462
480,401,79,550,99400,62463
372,353,19,-,104200,62465
1017,642,375,600,77300,62466
1474,1288,186,663,179000,62467
1062,782,280,622,96700,62468
240,219,21,-,132800,62469
3307,2456,851,618,89700,62471
577,541,36,545,102300,62473
394,348,46,647,81900,62474
156,156,0,-,97500,62475
685,603,82,389,69900,62476
310,256,54,-,59700,62477
140,140,0,-,79400,62478
271,215,56,775,157100,62479
227,180,47,539,71700,62480
169,161,8,-,70700,62481
1099,960,139,750,126300,62501
672,512,160,494,81800,62510
177,166,11,-,-,62512
618,467,151,823,97900,62513
72,72,0,-,68200,62514
403,297,106,800,135900,62515
69,52,17,758,65000,62517
98,75,23,682,91700,62518
37,37,0,-,68400,62519
697,610,87,921,164000,62520
14878,10807,4071,754,100500,62521
6245,4128,2117,658,82000,62522
422,4,418,320,-,62523
14116,8741,5375,642,81700,62526
684,517,167,745,109100,62530
762,575,187,711,98200,62531
57,57,0,-,88000,62532
339,249,90,578,106400,62533
607,450,157,-,85400,62534
1172,1037,135,1540,209500,62535
311,261,50,-,217300,62536
37,37,0,-,93800,62537
138,113,25,625,83100,62538
523,440,83,731,96500,62539
665,460,205,638,81400,62540
23,23,0,-,53600,62541
241,130,111,513,97100,62543
652,570,82,658,102000,62544
482,436,46,725,133700,62545
659,544,115,640,88700,62546
378,342,36,768,90400,62547
1021,853,168,536,128600,62548
2342,1815,527,726,139700,62549
1118,925,193,740,96700,62550
280,242,38,497,85800,62551
194,174,20,625,86500,62553
507,419,88,765,135100,62554
167,148,19,575,84000,62555
144,137,7,-,75600,62556
3048,2319,729,590,85200,62557
1314,1038,276,799,147300,62558
456,360,96,765,87700,62560
2072,1502,570,797,130200,62561
2191,1952,239,1053,189500,62563
3176,2426,750,492,100900,62565
462,360,102,775,93200,62567
6587,4635,1952,682,96100,62568
203,171,32,493,68600,62570
638,524,114,592,62400,62571
234,216,18,584,104700,62572
702,565,137,575,103900,62573
158,136,22,-,130600,62601
61,53,8,-,48800,62610
463,399,64,585,104700,62611
786,612,174,684,104500,62612
1543,1227,316,786,156700,62613
2122,1684,438,789,131500,62615
304,244,60,738,70000,62617
2847,2008,839,585,70200,62618
455,322,133,575,73800,62621
22,10,12,-,-,62622
203,202,1,-,70000,62624
355,339,16,-,183800,62625
2908,2169,739,766,109700,62626
406,344,62,725,78300,62627
313,242,71,731,87400,62628
5190,4082,1108,1068,189800,62629
141,128,13,-,-,62630
132,90,42,687,86700,62631
241,209,32,735,74400,62633
320,250,70,496,100900,62634
301,234,67,775,108500,62635
515,435,80,733,102100,62638
126,112,14,-,155900,62639
1487,1204,283,766,115900,62640
597,461,136,693,95700,62642
237,175,62,725,89500,62643
2161,1617,544,608,75500,62644
193,137,56,753,98800,62649
10593,6712,3881,690,110900,62650
220,171,49,679,57700,62655
6904,4662,2242,687,99700,62656
630,482,148,737,115100,62661
102,93,9,-,70600,62663
1339,1002,337,598,80600,62664
565,465,100,560,69100,62665
247,214,33,675,86200,62666
204,139,65,613,108000,62667
556,463,93,567,107200,62668
1102,914,188,690,150300,62670
211,153,58,603,92500,62671
97,85,12,-,57700,62672
186,165,21,538,83500,62673
628,483,145,605,106100,62674
2592,1939,653,725,155900,62675
959,844,115,569,148400,62677
2128,1522,606,643,84700,62681
388,334,54,654,68900,62682
2129,1807,322,900,207300,62684
979,803,176,700,126400,62685
266,209,57,771,87500,62688
220,195,25,700,69300,62689
1636,1260,376,619,97500,62690
848,679,169,603,79700,62691
858,724,134,689,88400,62692
543,471,72,729,168500,62693
1201,960,241,510,96900,62694
103,87,16,759,99200,62695
578,9,569,622,-,62701
15642,9578,6064,768,80700,62702
12310,7078,5232,789,83600,62703
18951,11149,7802,790,135200,62704
3096,2706,390,786,141900,62707
6974,5984,990,933,241700,62711
4146,3239,907,844,219800,62712
8422,5839,2583,633,72300,62801
413,324,89,702,102600,62803
1467,1133,334,494,85300,62806
309,229,80,463,75000,62807
591,455,136,719,96900,62808
67,58,9,-,66000,62809
335,277,58,606,87400,62810
101,88,13,625,34200,62811
4499,3091,1408,668,79500,62812
722,623,99,739,77500,62814
119,108,11,408,61300,62815
515,402,113,544,73600,62816
230,179,51,671,89300,62817
122,118,4,-,71500,62818
186,157,29,685,54000,62819
61,48,13,-,39300,62820
3186,2465,721,587,75600,62821
1250,837,413,696,62700,62822
704,578,126,510,79500,62823
727,536,191,504,86700,62824
84,69,15,666,66400,62825
543,400,143,544,64100,62827
534,461,73,428,112900,62828
0,0,0,-,-,62829
576,428,148,307,95700,62830
184,153,31,470,100700,62831
3909,2860,1049,541,78700,62832
167,142,25,413,125000,62833
409,323,86,468,54800,62835
275,234,41,720,99400,62836
4011,2913,1098,637,81200,62837
706,602,104,540,68300,62838
2701,1959,742,576,83700,62839
38,37,1,-,79200,62841
301,233,68,643,65200,62842
54,50,4,-,38300,62843
885,691,194,471,69900,62844
241,168,73,700,75600,62846
281,199,82,691,78200,62848
827,736,91,665,78700,62849
139,135,4,-,112300,62850
75,62,13,-,90000,62851
35,33,2,-,70700,62852
365,327,38,834,72000,62853
682,567,115,582,76200,62854
183,147,36,732,48500,62856
1152,907,245,593,82000,62858
2420,1929,491,598,95900,62859
239,208,31,586,89000,62860
63,47,16,-,20300,62861
155,133,22,-,52500,62862
4242,3151,1091,636,80700,62863
10303,6989,3314,671,91300,62864
829,774,55,-,112900,62865
223,183,40,515,67900,62867
625,538,87,717,81600,62868
1115,931,184,322,76800,62869
843,666,177,681,64100,62870
253,215,38,288,95900,62871
400,349,51,692,92500,62872
202,176,26,642,35800,62874
477,422,55,450,85200,62875
82,77,5,-,62500,62876
248,202,46,783,88000,62877
176,163,13,-,52700,62878
47,32,15,620,25700,62879
267,205,62,563,76500,62880
4624,3253,1371,600,83200,62881
964,771,193,589,54300,62882
330,286,44,364,-,62883
1206,973,233,608,83600,62884
290,229,61,-,92500,62885
105,98,7,-,111400,62886
131,90,41,-,52500,62887
876,691,185,633,86400,62888
376,323,53,495,117900,62889
1123,894,229,685,87000,62890
229,211,18,521,66800,62891
141,122,19,518,118300,62892
414,353,61,596,105900,62893
397,329,68,665,143500,62894
840,659,181,661,78200,62895
5130,3609,1521,610,70800,62896
142,128,14,1025,98300,62897
814,726,88,659,123600,62898
750,567,183,-,81300,62899
10489,3530,6959,711,117300,62901
2000,1264,736,715,155200,62902
1137,580,557,725,157400,62903
240,225,15,-,110100,62905
2564,1781,783,558,96200,62906
795,684,111,634,103600,62907
200,176,24,571,66300,62908
1074,928,146,540,68300,62910
531,432,99,650,62700,62912
1048,644,404,375,30700,62914
142,103,39,975,72200,62915
358,306,52,588,106100,62916
945,696,249,621,66800,62917
4129,2786,1343,838,143600,62918
330,301,29,481,70500,62919
1392,1149,243,495,124200,62920
175,151,24,-,-,62921
1079,961,118,528,140700,62922
165,145,20,820,82800,62923
1140,750,390,796,85100,62924
850,694,156,575,102900,62926
154,97,57,725,47900,62927
97,61,36,417,49500,62928
2581,1855,726,707,56900,62930
567,437,130,391,88400,62931
585,448,137,655,75400,62932
654,335,319,736,114600,62933
427,337,90,422,73300,62934
735,540,195,582,78400,62935
1109,909,200,319,89200,62938
1289,1111,178,702,127300,62939
113,103,10,475,34600,62940
288,262,26,883,87500,62941
267,162,105,529,46100,62942
162,142,20,-,134100,62943
5226,3745,1481,580,82000,62946
200,184,16,-,103900,62947
5339,3838,1501,634,87000,62948
357,221,136,338,55500,62949
91,83,8,-,72300,62950
1901,1421,480,515,69000,62951
1199,1012,187,593,100900,62952
110,71,39,610,61300,62953
220,152,68,-,114800,62954
289,234,55,563,63300,62956
320,226,94,828,55400,62957
877,626,251,712,153300,62958
11055,7302,3753,735,135500,62959
4582,3309,1273,686,87400,62960
21,21,0,-,36100,62961
5,0,5,-,-,62962
258,135,123,450,38900,62963
554,413,141,461,46700,62964
32,20,12,500,46700,62965
6431,4280,2151,652,97300,62966
107,103,4,-,65600,62967
117,90,27,850,69400,62969
302,244,58,456,64800,62970
423,387,36,-,110500,62972
615,537,78,793,99700,62974
146,72,74,-,-,62975
141,117,24,-,83700,62976
277,226,51,835,132100,62977
537,379,158,519,76600,62979
368,271,97,340,58800,62982
593,468,125,634,58300,62983
684,502,182,424,65200,62984
318,290,28,-,103000,62985
501,433,68,767,72500,62987
516,425,91,478,67400,62988
286,240,46,238,101100,62990
286,184,102,559,71600,62992
225,178,47,680,102800,62994
1591,1223,368,570,96900,62995
178,150,28,-,63800,62996
214,156,58,819,63600,62997
139,109,30,-,85300,62998
602,421,181,596,50200,62999
6376,5486,890,1171,561300,63005
13931,10440,3491,909,156000,63010
14504,12115,2389,1254,270300,63011
3907,3441,466,880,153600,63012
667,615,52,-,165800,63013
401,365,36,762,170500,63014
1047,849,198,686,136700,63015
3047,2664,383,901,151100,63016
16624,12988,3636,1171,364700,63017
1788,1144,644,844,129300,63019
7875,5939,1936,728,132200,63020
21885,17938,3947,1079,235200,63021
2157,1735,422,908,163700,63023
4989,4195,794,1085,280000,63025
16579,13660,2919,863,193100,63026
9849,7896,1953,813,158100,63028
104,86,18,-,158300,63030
17544,12702,4842,1053,101200,63031
16948,10912,6036,962,108400,63033
6647,6222,425,1517,170100,63034
389,299,90,575,153900,63036
1196,968,228,757,140300,63037
2484,2232,252,936,419800,63038
249,205,44,1117,137500,63039
3040,2650,390,1186,311300,63040
176,169,7,-,168800,63041
8823,4642,4181,867,104500,63042
9259,6237,3022,1038,157300,63043
3987,2732,1255,881,161700,63044
0,0,0,-,-,63045
21,21,0,-,-,63047
1401,1167,234,1150,158200,63048
6534,5709,825,878,157800,63049
5895,5066,829,812,171600,63050
5186,4115,1071,923,143900,63051
9870,8050,1820,875,175100,63052
20,10,10,738,166700,63053
1043,718,325,853,260500,63055
762,657,105,569,192900,63056
0,0,0,-,-,63057
809,689,120,909,113100,63060
54,54,0,-,139500,63061
1879,1536,343,639,161000,63068
5624,4111,1513,755,194600,63069
3160,2069,1091,693,112700,63070
385,274,111,609,55700,63071
1185,980,205,854,178300,63072
317,317,0,-,592600,63073
6517,3187,3330,837,87900,63074
4492,3174,1318,742,127900,63077
24,24,0,-,-,63079
5721,3603,2118,763,123400,63080
7301,5263,2038,745,163800,63084
312,255,57,642,155700,63087
3851,2404,1447,1028,173800,63088
2029,1716,313,1122,163500,63089
8900,6445,2455,720,195500,63090
572,500,72,544,167000,63091
2163,349,1814,993,227000,63101
983,0,983,897,-,63102
4662,597,4065,870,171200,63103
9485,3566,5919,880,209100,63104
6563,3934,2629,1194,594400,63105
4700,734,3966,643,120600,63106
4037,1801,2236,737,52100,63107
10778,3124,7654,929,349900,63108
13602,7954,5648,794,169700,63109
8129,3544,4585,858,187500,63110
8782,3285,5497,765,82800,63111
8390,3237,5153,833,145800,63112
4580,1925,2655,745,66800,63113
14615,8209,6406,905,83300,63114
7519,3568,3951,776,55900,63115
19248,10438,8810,748,117000,63116
4369,2404,1965,983,237400,63117
11202,3992,7210,826,136100,63118
13867,10455,3412,995,235900,63119
3006,1440,1566,740,46800,63120
10556,5549,5007,864,74100,63121
15897,12744,3153,1061,324800,63122
22604,16341,6263,833,146000,63123
4760,3429,1331,968,807100,63124
14020,9832,4188,812,123700,63125
6187,5230,957,873,192800,63126
2075,1548,527,2020,402200,63127
12818,9968,2850,953,230300,63128
21990,17264,4726,825,211400,63129
12028,6831,5197,996,263400,63130
6453,5955,498,1853,579000,63131
5348,2973,2375,1052,269700,63132
3132,1097,2035,799,54200,63133
5290,2596,2694,990,66700,63134
8282,4972,3310,927,79000,63135
18208,8225,9983,871,67400,63136
7129,3704,3425,988,61300,63137
7122,3441,3681,777,99800,63138
11088,6549,4539,793,146400,63139
122,28,94,732,-,63140
8652,6500,2152,1178,428400,63141
4977,2266,2711,720,165900,63143
4336,2881,1455,1222,225300,63144
14102,8275,5827,1074,214500,63146
3804,2123,1681,765,63200,63147
0,0,0,-,-,63155
19599,13167,6432,868,168800,63301
19742,14444,5298,1063,209000,63303
15061,13519,1542,1226,232100,63304
69,51,18,588,187500,63330
516,452,64,728,287500,63332
332,223,109,850,103400,63333
2687,1934,753,630,110000,63334
553,352,201,639,139000,63336
350,279,71,678,138800,63339
1350,1200,150,1169,345100,63341
1604,1144,460,719,128400,63343
529,409,120,641,155800,63344
222,172,50,369,85000,63345
947,772,175,771,151900,63347
2454,2331,123,873,259200,63348
684,590,94,831,193400,63349
225,188,37,525,76000,63350
802,650,152,756,149000,63351
514,366,148,567,85900,63352
1913,1269,644,698,87100,63353
1840,1509,331,814,186500,63357
553,414,139,638,115600,63359
1881,1179,702,616,103900,63361
2356,1660,696,898,162000,63362
737,549,188,673,112500,63363
18429,14894,3535,945,199400,63366
8629,7302,1327,1060,263000,63367
15968,13349,2619,1288,236400,63368
710,535,175,800,129400,63369
9,9,0,-,-,63370
216,180,36,950,153900,63373
28466,23597,4869,1031,178800,63376
798,675,123,838,173900,63377
8427,6654,1773,797,160200,63379
197,159,38,947,159200,63381
1402,903,499,594,72700,63382
6015,4538,1477,726,146500,63383
681,491,190,675,79600,63384
14515,12189,2326,1027,230000,63385
191,136,55,883,96900,63386
31,20,11,-,65000,63387
330,294,36,-,64200,63388
2361,1868,493,814,146000,63389
3939,3062,877,814,181400,63390
8820,5529,3291,699,121300,63401
221,184,37,571,87500,63430
130,115,15,-,110100,63431
192,172,20,-,-,63432
11,11,0,-,-,63433
246,149,97,498,71900,63434
1607,1120,487,597,92100,63435
612,439,173,650,133900,63436
600,464,136,490,71000,63437
176,143,33,761,117200,63438
40,36,4,-,219200,63439
417,291,126,555,87100,63440
452,325,127,568,112500,63441
157,115,42,318,72800,63443
1540,1024,516,627,88400,63445
232,193,39,592,73200,63446
454,303,151,457,71700,63447
585,475,110,585,97800,63448
37,37,0,-,89200,63450
89,78,11,-,113900,63451
481,370,111,516,75800,63452
217,184,33,775,98600,63453
326,238,88,706,114100,63454
1848,1234,614,631,103500,63456
112,110,2,-,150000,63457
56,38,18,-,65000,63458
1513,1345,168,864,143800,63459
156,124,32,513,60000,63460
2240,1639,601,619,124900,63461
637,549,88,488,119600,63462
273,196,77,492,160800,63463
13,13,0,-,-,63464
162,142,20,679,152600,63465
7,7,0,-,-,63467
999,698,301,574,76500,63468
467,368,99,608,96900,63469
247,191,56,743,130700,63471
286,190,96,636,44800,63472
99,99,0,-,-,63473
209,148,61,450,110000,63474
8005,4385,3620,618,125600,63501
374,303,71,525,70200,63530
128,113,15,375,70700,63531
559,473,86,630,66300,63532
274,224,50,670,93000,63533
288,246,42,613,62500,63534
28,22,6,-,116700,63535
383,281,102,326,90600,63536
746,599,147,425,73300,63537
108,100,8,-,-,63538
72,58,14,700,76700,63539
44,43,1,-,34400,63540
148,115,33,496,57200,63541
100,85,15,-,57000,63543
244,224,20,600,80900,63544
354,250,104,575,78900,63545
639,543,96,471,108200,63546
172,143,29,523,64500,63547
435,327,108,494,72300,63548
950,695,255,514,115200,63549
75,69,6,-,-,63551
2987,1969,1018,503,111900,63552
1272,870,402,522,81100,63555
1319,899,420,624,76400,63556
91,85,6,-,116300,63557
272,225,47,1063,86500,63558
589,480,109,-,77600,63559
83,73,10,350,49200,63560
416,293,123,659,65300,63561
235,120,115,-,-,63563
1400,993,407,590,87500,63565
39,39,0,-,51700,63566
74,44,30,522,77100,63567
6217,4014,2203,624,86100,63601
531,358,173,563,73700,63620
458,272,186,373,96200,63621
363,351,12,-,75600,63622
321,261,60,593,86900,63623
1558,1192,366,634,88300,63624
181,167,14,-,121000,63625
546,506,40,-,98500,63626
1347,980,367,555,171800,63627
5360,3654,1706,641,135600,63628
545,453,92,363,108800,63629
1397,1158,239,661,82900,63630
447,340,107,790,145500,63631
211,161,50,661,81700,63633
266,172,94,294,56900,63636
617,476,141,634,105400,63637
1087,786,301,587,116100,63638
10798,7453,3345,693,146000,63640
4680,3466,1214,580,99900,63645
437,386,51,683,100000,63648
1726,1287,439,595,87900,63650
510,295,215,753,49700,63653
299,257,42,637,121400,63654
652,499,153,683,107800,63655
157,134,23,544,107100,63656
1084,939,145,546,82200,63660
590,538,52,-,87400,63662
278,104,174,618,82800,63663
3520,2638,882,517,91700,63664
143,107,36,-,87000,63665
34,34,0,-,22700,63666
4579,3536,1043,742,156200,63670
680,581,99,775,125300,63673
39,39,0,-,-,63674
91,91,0,-,63800,63675
14111,8696,5415,810,160100,63701
3560,1524,2036,759,76700,63703
1255,951,304,546,98100,63730
384,352,32,688,129200,63732
290,198,92,527,47200,63735
1447,1137,310,622,90200,63736
31,22,9,-,-,63738
157,113,44,797,136300,63739
1934,1343,591,608,96400,63740
24,21,3,-,53900,63742
28,28,0,-,177800,63743
38,24,14,-,71700,63744
10,6,4,-,-,63745
17,11,6,-,-,63746
158,137,21,-,103400,63747
399,340,59,705,133000,63748
5,5,0,-,-,63750
520,405,115,725,133900,63751
9357,7102,2255,819,163400,63755
71,58,13,-,162500,63758
241,203,38,367,185900,63760
65,65,0,-,101400,63763
2028,1493,535,633,101900,63764
418,353,65,611,164100,63766
292,202,90,753,87500,63767
502,446,56,850,121000,63769
42,35,7,1313,86100,63770
1165,876,289,506,97000,63771
37,19,18,-,-,63774
6724,4926,1798,665,139800,63775
2349,1717,632,776,123600,63780
522,456,66,927,138300,63781
153,138,15,-,72200,63782
44,44,0,-,184100,63783
79,67,12,-,66900,63784
348,268,80,770,115200,63785
298,236,62,565,83100,63787
9487,5978,3509,628,109000,63801
57,44,13,-,31700,63820
343,276,67,610,42000,63821
1024,713,311,579,78000,63822
524,374,150,525,82800,63823
52,9,43,803,102500,63824
1684,1200,484,585,103800,63825
26,19,7,-,60800,63826
332,249,83,547,63800,63827
66,56,10,-,36700,63828
493,277,216,581,48900,63829
2894,1460,1434,585,86900,63830
96,73,23,-,-,63833
2179,1192,987,634,78700,63834
615,360,255,447,38600,63837
176,55,121,588,61300,63839
5404,3500,1904,639,116700,63841
2265,1419,846,484,78100,63845
639,501,138,629,78300,63846
52,29,23,-,-,63847
577,383,194,754,49100,63848
52,30,22,-,-,63849
1552,738,814,662,67000,63851
436,310,126,610,64800,63852
92,63,29,674,38000,63853
435,343,92,399,63600,63855
5181,3129,2052,581,93600,63857
84,71,13,-,31200,63860
672,375,297,642,61500,63862
2565,1487,1078,610,70800,63863
133,81,52,768,23200,63866
413,303,110,547,76600,63867
340,169,171,567,54300,63868
1503,787,716,590,104300,63869
357,189,168,729,64100,63870
1863,1143,720,538,81100,63873
162,101,61,717,52500,63874
835,545,290,622,70700,63876
1339,786,553,571,92100,63877
38,31,7,-,29200,63878
255,173,82,544,56300,63879
58,40,18,-,45000,63880
166,106,60,681,35000,63882
13487,8249,5238,678,117000,63901
0,0,0,-,-,63902
502,377,125,390,49400,63932
1432,1029,403,556,67000,63933
112,76,36,-,-,63934
3683,2902,781,534,93100,63935
341,198,143,769,70000,63936
1037,788,249,593,85300,63937
574,453,121,558,73100,63939
564,420,144,565,92400,63940
109,84,25,-,-,63941
258,209,49,492,95900,63942
214,170,44,688,101600,63943
653,541,112,466,81800,63944
379,325,54,-,-,63945
116,60,56,-,63300,63951
149,124,25,450,136100,63952
643,508,135,654,65900,63953
240,158,82,496,43000,63954
88,71,17,-,65800,63955
446,327,119,431,91900,63956
2545,1851,694,578,69600,63957
1093,848,245,603,111200,63960
602,480,122,593,77400,63961
47,0,47,-,-,63962
214,138,76,566,-,63964
1192,935,257,604,132700,63965
1000,794,206,846,65400,63966
760,559,201,450,71700,63967
270,196,74,683,98000,64001
1277,1102,175,820,175600,64011
10558,7364,3194,1013,139400,64012
9013,6393,2620,973,155400,64014
11547,8529,3018,929,165200,64015
1871,1446,425,839,120700,64016
197,145,52,669,67100,64017
347,290,57,631,212500,64018
900,792,108,1009,140200,64019
1486,1065,421,616,121200,64020
206,184,22,675,70800,64021
63,59,4,-,98800,64022
6377,4510,1867,672,133500,64024
6395,4649,1746,996,177600,64029
9799,4847,4952,820,103900,64030
3138,2879,259,1413,193800,64034
407,309,98,760,84600,64035
106,74,32,833,37500,64036
2376,1501,875,699,112600,64037
2529,2018,511,628,133500,64040
1569,1438,131,870,204100,64048
9112,4501,4611,718,87700,64050
8961,5250,3711,830,83600,64052
2125,1104,1021,829,47200,64053
1554,891,663,777,76100,64054
14564,10131,4433,910,120000,64055
5883,3912,1971,863,105700,64056
5958,3583,2375,918,158200,64057
2467,1810,657,1033,130800,64058
4931,3907,1024,1077,213300,64060
1312,1112,200,902,171700,64061
2183,1823,360,940,157800,64062
8096,5415,2681,914,158700,64063
6612,5550,1062,1100,260100,64064
8,0,8,600,-,64065
13,7,6,-,-,64066
2325,1545,780,691,96300,64067
13981,10486,3495,895,175400,64068
1283,1111,172,1105,233400,64070
247,217,30,448,83900,64071
214,177,37,906,76300,64072
304,239,65,1319,203100,64074
4369,3178,1191,879,161800,64075
3561,2717,844,750,159000,64076
615,507,108,857,122200,64077
3736,3170,566,848,176700,64078
4999,3602,1397,1010,223800,64079
4769,3654,1115,931,194800,64080
9405,7314,2091,1139,225500,64081
5467,4912,555,1263,272800,64082
8837,7285,1552,1108,195900,64083
648,590,58,775,169400,64084
3362,2195,1167,602,108900,64085
8658,6661,1997,958,192400,64086
523,450,73,960,147800,64088
4707,3916,791,781,200300,64089
43,38,5,-,42500,64090
13,0,13,-,-,64092
10446,5356,5090,757,156400,64093
436,321,115,695,90200,64096
546,399,147,580,123000,64097
1282,959,323,860,203500,64098
10,10,0,-,-,64101
0,0,0,-,-,64102
3322,369,2953,1114,178400,64105
3881,642,3239,816,183200,64106
4174,1521,2653,1050,191400,64108
4628,1900,2728,747,120400,64109
6919,3024,3895,906,152100,64110
10127,2626,7501,881,165700,64111
4706,2088,2618,1143,341200,64112
4875,4650,225,2066,376500,64113
12220,7464,4756,1038,167700,64114
7369,3180,4189,869,159800,64116
5784,2936,2848,900,105500,64117
16860,9852,7008,894,141000,64118
10968,8163,2805,966,141100,64119
147,111,36,788,26600,64120
3368,1781,1587,774,59900,64123
4101,1876,2225,702,57800,64124
591,262,329,746,41200,64125
2294,913,1381,804,42600,64126
6232,2474,3758,737,41600,64127
4788,1876,2912,728,41000,64128
3887,1758,2129,786,76800,64129
8496,4319,4177,792,54300,64130
10317,5012,5305,854,150200,64131
5602,2399,3203,798,61900,64132
14708,9254,5454,875,106600,64133
8999,4357,4642,987,85200,64134
1016,429,587,968,153900,64136
4175,2251,1924,963,117300,64137
10313,6057,4256,871,104900,64138
650,521,129,1245,308700,64139
2018,1677,341,1069,235300,64145
668,601,67,-,167500,64146
172,0,172,540,-,64147
159,159,0,-,334800,64149
1396,482,914,703,220200,64150
11203,6615,4588,1022,199600,64151
10679,8432,2247,1028,241700,64152
2317,1139,1178,1195,200400,64153
4438,2388,2050,1114,228400,64154
8360,6353,2007,982,180900,64155
2844,2271,573,1157,242800,64156
6240,5758,482,1463,244000,64157
1887,1062,825,966,219000,64158
134,96,38,1036,101400,64161
341,175,166,579,120700,64163
102,58,44,-,388900,64164
58,58,0,-,271600,64165
117,101,16,-,262000,64166
138,138,0,-,440000,64167
0,0,0,-,-,64192
555,476,79,765,153800,64401
1072,769,303,515,81700,64402
29,24,5,-,-,64420
354,299,55,792,104200,64421
139,80,59,-,128000,64422
316,291,25,497,109300,64423
1860,1234,626,495,89000,64424
163,120,43,482,76700,64426
265,202,63,394,117500,64427
313,249,64,498,61800,64428
3741,2386,1355,740,136100,64429
339,271,68,671,161300,64430
151,109,42,458,85000,64431
28,27,1,-,87500,64432
33,31,2,-,53800,64433
196,171,25,386,149300,64434
311,288,23,1063,157100,64436
292,243,49,671,96500,64437
62,54,8,-,31000,64438
617,532,85,707,196700,64439
258,230,28,694,136500,64440
81,71,10,-,-,64441
347,264,83,626,73300,64442
542,428,114,1007,189000,64443
489,424,65,792,154400,64444
124,89,35,635,54200,64445
489,349,140,479,73300,64446
381,333,48,716,144000,64448
219,193,26,642,64300,64449
185,130,55,458,90000,64451
76,73,3,-,83200,64453
983,796,187,816,159900,64454
151,117,34,394,86800,64455
591,463,128,534,70100,64456
92,79,13,817,169600,64457
61,47,14,718,70500,64458
163,162,1,-,133900,64459
267,207,60,627,72500,64461
653,473,180,734,108500,64463
1909,1462,447,716,155800,64465
219,154,65,446,66700,64466
100,74,26,-,103300,64467
5586,2644,2942,648,142300,64468
891,643,248,583,91600,64469
701,467,234,422,113600,64470
169,139,30,500,57400,64471
644,475,169,606,88200,64473
366,280,86,633,113200,64474
156,100,56,617,96700,64475
133,93,40,738,108500,64476
1508,1164,344,783,138000,64477
361,286,75,625,101900,64479
102,65,37,642,85700,64480
384,308,76,622,71800,64481
1005,706,299,528,101700,64482
269,235,34,838,113600,64483
394,300,94,721,106800,64484
3134,2266,868,728,124400,64485
198,148,50,595,64200,64486
304,222,82,628,71300,64487
753,572,181,433,105900,64489
782,588,194,749,153800,64490
856,592,264,591,76400,64491
705,609,96,778,181400,64492
220,181,39,848,109400,64493
365,290,75,406,80500,64494
19,16,3,-,43300,64496
143,132,11,510,160000,64497
123,86,37,617,50000,64498
33,28,5,-,37900,64499
4603,1908,2695,663,78200,64501
4923,3259,1664,793,105200,64503
4175,2939,1236,784,82600,64504
5047,3496,1551,768,128700,64505
8812,5548,3264,781,168100,64506
5145,3388,1757,765,105700,64507
4579,2928,1651,652,106300,64601
178,156,22,692,85200,64620
184,132,52,525,90000,64622
170,143,27,500,77100,64623
655,496,159,668,78800,64624
210,159,51,434,75900,64625
2433,1629,804,558,86400,64628
224,206,18,283,81300,64630
340,276,64,-,71100,64631
177,145,32,372,65000,64632
1943,1297,646,544,90100,64633
232,195,37,650,77100,64635
107,86,21,850,45000,64636
240,197,43,482,122300,64637
307,268,39,439,86000,64638
101,84,17,-,66400,64639
1192,895,297,542,115900,64640
274,220,54,418,77700,64641
367,283,84,593,63100,64642
453,347,106,587,91300,64643
1211,871,340,676,106800,64644
56,49,7,313,118800,64645
77,57,20,383,45800,64646
149,120,29,616,81000,64647
681,530,151,463,116000,64648
301,266,35,-,119700,64649
269,165,104,670,107200,64650
290,215,75,575,81500,64651
177,151,26,542,81000,64652
288,238,50,559,70000,64653
18,18,0,-,-,64654
80,70,10,-,-,64655
118,94,24,284,84400,64656
114,87,27,343,60800,64657
1296,1007,289,512,88200,64658
383,288,95,640,102700,64659
186,169,17,719,68600,64660
354,265,89,338,90500,64661
185,161,24,681,124400,64664
103,87,16,830,-,64667
652,494,158,538,84000,64668
371,275,96,472,104800,64670
786,592,194,558,127200,64671
70,67,3,-,65200,64672
866,681,185,527,85400,64673
169,138,31,425,114700,64674
58,55,3,-,-,64676
244,191,53,500,61700,64679
67,55,12,-,58400,64681
148,131,17,-,72200,64682
3236,2057,1179,619,99000,64683
79,70,9,-,72100,64686
228,193,35,677,82700,64688
220,175,45,768,99400,64689
5429,3469,1960,854,157400,64701
1471,1125,346,696,130600,64720
181,153,28,617,110400,64722
336,272,64,850,130400,64723
835,601,234,467,78500,64724
968,719,249,800,149900,64725
137,117,20,1031,160500,64726
207,165,42,763,112500,64728
2784,1786,998,651,117200,64730
474,348,126,681,150500,64733
744,656,88,893,259700,64734
5669,4025,1644,678,112100,64735
434,351,83,666,77000,64738
357,300,57,850,221400,64739
843,688,155,654,78600,64740
96,84,12,613,158300,64741
899,708,191,972,160300,64742
87,49,38,708,79500,64743
3291,2293,998,590,89200,64744
102,72,30,822,108300,64745
579,470,109,872,151600,64746
1458,1109,349,796,142400,64747
618,416,202,532,70000,64748
175,154,21,788,102200,64750
287,240,47,658,93600,64752
988,708,280,642,99800,64755
277,231,46,669,95500,64756
3279,2290,989,578,106700,64759
516,407,109,714,110100,64761
637,452,185,541,71700,64762
657,496,161,713,69300,64763
17,16,1,-,-,64765
224,188,36,-,80800,64767
227,153,74,558,42500,64769
408,313,95,670,89000,64770
241,208,33,579,68400,64771
5507,3491,2016,656,107400,64772
1703,1307,396,600,107700,64776
244,189,55,715,115600,64778
968,784,184,577,69500,64779
251,188,63,650,194700,64780
29,27,2,-,-,64781
355,307,48,729,62500,64783
428,362,66,665,64900,64784
688,498,190,862,91300,64788
335,264,71,503,82500,64790
14847,8209,6638,780,114600,64801
13984,9862,4122,738,141300,64804
307,232,75,531,75400,64830
2170,1681,489,593,108200,64831
295,242,53,1059,105000,64832
27,18,9,-,100000,64833
3447,2724,723,933,144900,64834
725,546,179,767,71700,64835
8691,5776,2915,764,121900,64836
1220,1069,151,594,118200,64840
211,192,19,696,95400,64841
333,206,127,597,80600,64842
1256,992,264,674,72900,64843
1834,1212,622,757,88700,64844
175,56,119,492,36700,64847
292,244,48,548,148900,64848
59,50,9,836,85500,64849
8815,5642,3173,695,116500,64850
1451,706,745,528,100700,64854
909,751,158,1018,121100,64855
1514,1036,478,707,111700,64856
142,123,19,840,79500,64857
61,61,0,-,-,64858
507,366,141,567,106700,64859
496,358,138,579,118800,64861
1239,1003,236,657,91600,64862
489,316,173,632,86300,64863
2283,1651,632,713,98700,64865
435,336,99,-,87700,64866
467,368,99,714,131600,64867
5732,3737,1995,741,114000,64870
381,354,27,-,87900,64873
309,175,134,518,83900,64874
117,117,0,-,101800,65001
2359,1826,533,638,203800,65010
760,615,145,-,169600,65011
1275,879,396,566,120200,65013
914,669,245,493,116300,65014
541,490,51,725,159100,65016
440,407,33,-,-,65017
2843,2200,643,578,123700,65018
5386,4170,1216,786,172600,65020
679,623,56,467,175700,65023
457,401,56,512,95000,65024
269,177,92,650,162000,65025
4744,3327,1417,654,120400,65026
645,594,51,502,127400,65032
303,239,64,-,105900,65034
689,567,122,427,160500,65035
2118,1796,322,710,163600,65037
1001,934,67,345,266300,65039
544,495,49,-,159400,65040
2394,1938,456,600,146300,65041
4086,3225,861,800,141800,65043
516,467,49,400,120800,65046
428,224,204,501,146600,65047
62,62,0,-,111300,65048
2672,2089,583,728,222900,65049
196,171,25,-,237500,65050
1808,1343,465,544,137800,65051
1239,1056,183,932,178200,65052
607,571,36,667,225500,65053
263,250,13,-,146900,65054
373,319,54,363,148800,65058
278,193,85,761,175400,65059
297,262,35,693,65000,65061
7,7,0,-,-,65062
1209,1005,204,860,162700,65063
170,158,12,-,160300,65064
2530,1710,820,680,259300,65065
2474,2004,470,607,124000,65066
119,82,37,730,97200,65067
250,213,37,725,124600,65068
269,231,38,1263,131700,65069
579,529,50,525,181700,65072
1065,789,276,624,156800,65074
324,278,46,456,153100,65075
272,241,31,763,169600,65076
160,112,48,-,147500,65077
1499,1175,324,585,87500,65078
1642,1409,233,920,237700,65079
470,370,100,1092,181800,65080
1152,768,384,493,104200,65081
363,305,58,588,164500,65082
95,95,0,-,58000,65083
2419,1731,688,557,104300,65084
502,410,92,435,173800,65085
10653,7085,3568,624,159900,65101
16183,10511,5672,648,158500,65109
16434,5033,11401,837,181200,65201
19564,11601,7963,881,153300,65202
24341,14307,10034,849,229900,65203
0,0,0,-,-,65215
263,201,62,434,59600,65230
1269,997,272,647,128400,65231
122,95,27,629,57400,65232
4296,2837,1459,709,138000,65233
594,430,164,408,90000,65236
360,258,102,563,104400,65237
491,432,59,808,115700,65239
3323,2564,759,632,135500,65240
708,634,74,739,140700,65243
145,140,5,-,137500,65244
12,11,1,-,-,65246
278,278,0,-,97400,65247
1389,1031,358,804,112100,65248
245,218,27,755,119800,65250
7282,4751,2531,643,139800,65251
756,643,113,504,107100,65254
1519,1129,390,834,165700,65255
601,588,13,600,184700,65256
576,493,83,644,77900,65257
184,152,32,500,110700,65258
1030,908,122,550,99200,65259
174,164,10,575,110700,65260
363,285,78,390,75900,65261
333,300,33,800,171700,65262
754,588,166,665,89700,65263
266,217,49,379,157500,65264
5941,3665,2276,680,103500,65265
5702,3825,1877,632,100700,65270
684,476,208,438,104300,65274
1116,884,232,427,87400,65275
595,449,146,602,121500,65276
56,46,10,683,57900,65278
729,642,87,907,228100,65279
124,106,18,542,84300,65280
993,792,201,547,84700,65281
58,58,0,-,75200,65282
226,221,5,-,141300,65283
858,698,160,788,152600,65284
222,180,42,-,159600,65285
44,41,3,-,75600,65286
157,151,6,-,137500,65287
13005,8318,4687,713,111600,65301
890,34,856,1057,-,65305
27,24,3,-,99200,65320
201,142,59,766,114100,65321
216,186,30,663,95700,65322
364,308,56,470,91400,65323
660,565,95,433,159300,65324
1309,1137,172,628,118700,65325
855,735,120,513,115400,65326
87,74,13,731,95000,65327
156,127,29,-,137500,65329
178,141,37,605,79000,65330
520,425,95,550,131300,65332
250,212,38,530,117900,65333
333,272,61,565,128300,65334
64,57,7,-,67500,65335
2306,1362,944,809,136400,65336
712,464,248,621,119200,65337
1152,933,219,649,100700,65338
202,161,41,597,65700,65339
5655,3802,1853,641,114100,65340
85,70,15,711,121400,65344
115,57,58,-,222400,65345
244,178,66,688,118200,65347
517,405,112,575,103500,65348
1081,710,371,578,67700,65349
757,650,107,681,150400,65350
961,722,239,656,95900,65351
232,139,93,541,172900,65354
4548,3743,805,610,120400,65355
1779,1384,395,613,95700,65360
12762,7156,5606,730,139900,65401
26,26,0,-,142300,65436
983,711,272,609,115800,65438
87,59,28,-,29500,65439
138,132,6,-,120200,65440
2235,1586,649,738,111700,65441
31,31,0,-,177200,65443
387,337,50,1025,103100,65444
97,93,4,-,185600,65446
135,107,28,-,107400,65449
1076,868,208,745,130100,65452
3462,2263,1199,569,122400,65453
287,226,61,-,118200,65456
43,43,0,-,228800,65457
2496,1894,602,726,134900,65459
38,27,11,-,-,65461
646,581,65,644,96200,65462
412,389,23,-,106600,65463
425,380,45,-,89900,65464
708,491,217,449,129900,65466
71,71,0,-,-,65468
366,330,36,467,88500,65470
2101,19,2082,1287,-,65473
88,47,41,-,-,65479
1852,1126,726,604,131600,65483
25,25,0,-,-,65484
1324,1102,222,664,127700,65486
70,70,0,-,162500,65501
82,73,9,-,-,65529
365,313,52,-,159100,65534
547,387,160,497,87400,65535
11385,7513,3872,667,114600,65536
90,90,0,-,-,65541
1957,1449,508,594,109200,65542
113,98,15,-,162500,65543
2276,1527,749,552,105600,65548
1224,948,276,643,87600,65550
813,637,176,775,163300,65552
476,387,89,497,72800,65555
2152,1597,555,573,100800,65556
36,36,0,-,-,65557
3481,2430,1051,687,118300,65559
5849,3932,1917,552,109600,65560
37,37,0,-,66500,65564
1956,1464,492,632,120400,65565
326,259,67,643,73400,65566
500,414,86,684,96300,65567
217,201,16,900,45000,65570
813,594,219,496,112200,65571
301,238,63,702,140600,65580
909,680,229,563,121400,65582
4080,2185,1895,868,152800,65583
4339,1640,2699,985,165400,65584
40,40,0,-,-,65586
1068,743,325,495,73000,65588
33,22,11,-,66200,65589
516,443,73,-,139200,65590
526,395,131,722,168100,65591
249,206,43,591,109000,65601
80,59,21,922,-,65603
1404,1033,371,686,143400,65604
5115,3768,1347,690,94200,65605
1336,1040,296,499,69600,65606
3499,2687,812,584,106800,65608
352,265,87,661,76800,65609
1939,1547,392,717,159400,65610
877,683,194,775,182300,65611
483,423,60,-,184800,65612
6654,4182,2472,690,128700,65613
234,179,55,753,136700,65614
11504,5768,5736,824,148900,65616
456,339,117,913,149500,65617
109,72,37,-,95000,65618
2854,2318,536,810,146400,65619
88,88,0,-,256300,65620
3370,2262,1108,658,108700,65622
5,5,0,-,-,65623
668,624,44,858,134600,65624
2899,2004,895,745,110400,65625
709,495,214,573,109300,65626
214,189,25,-,105200,65627
289,233,56,710,91300,65629
124,123,1,-,332700,65630
1893,1530,363,884,124700,65631
1017,744,273,675,133300,65632
1452,1108,344,615,99900,65633
297,243,54,594,69500,65634
245,205,40,600,77000,65635
485,431,54,769,150800,65637
205,182,23,-,119600,65638
342,291,51,-,123700,65640
536,426,110,480,165100,65641
864,686,178,642,137900,65644
688,575,113,559,89200,65646
784,578,206,570,101500,65647
2234,1941,293,625,137200,65648
686,525,161,641,79600,65649
544,487,57,675,116200,65650
1285,966,319,612,121600,65652
2434,1791,643,706,113800,65653
92,61,31,425,73200,65654
1403,980,423,563,102100,65655
1782,1374,408,610,159300,65656
54,32,22,-,100000,65657
711,604,107,446,123400,65658
71,71,0,-,214000,65660
1153,924,229,517,76100,65661
509,400,109,-,73100,65662
882,698,184,675,140300,65663
56,32,24,693,73800,65664
1141,812,329,605,117500,65667
788,612,176,398,94800,65668
822,710,112,649,170100,65669
3603,2067,1536,698,151200,65672
1078,801,277,675,78200,65674
190,130,60,825,116300,65676
951,654,297,637,130000,65679
571,538,33,575,85800,65680
743,688,55,-,177700,65681
759,557,202,671,84800,65682
256,235,21,666,99200,65685
2083,1754,329,773,167100,65686
2076,1423,653,565,121300,65689
81,78,3,-,-,65690
574,461,113,448,112000,65692
129,107,22,-,91400,65702
1449,966,483,506,117600,65704
1486,949,537,783,98700,65705
5858,4014,1844,598,129100,65706
854,712,142,598,104300,65707
4476,3026,1450,665,113300,65708
469,363,106,486,165200,65710
3965,2806,1159,576,91600,65711
3414,2326,1088,648,111400,65712
908,749,159,565,87600,65713
12421,8970,3451,811,183200,65714
24,9,15,-,-,65715
1012,729,283,549,105200,65717
322,303,19,-,107800,65720
11234,7972,3262,818,161800,65721
598,501,97,670,100900,65722
1328,991,337,622,106100,65723
681,603,78,983,81300,65724
1161,963,198,689,150400,65725
55,55,0,-,-,65727
0,0,0,-,-,65728
141,90,51,-,198600,65729
21,21,0,-,-,65730
204,159,45,825,84300,65731
319,255,64,721,122800,65732
390,375,15,-,78600,65733
1127,813,314,590,94100,65734
21,17,4,-,-,65735
3411,2750,661,731,174600,65737
7315,4859,2456,818,135000,65738
468,451,17,-,151800,65739
1374,885,489,718,77000,65740
4909,3907,1002,713,171700,65742
37,34,3,-,95000,65744
1159,824,335,643,81800,65745
2590,2062,528,619,123500,65746
1696,1495,201,573,180300,65747
188,107,81,708,78500,65752
1807,1439,368,653,132300,65753
307,253,54,-,182400,65754
205,173,32,-,95600,65755
224,209,15,690,155500,65756
2767,2288,479,797,167900,65757
544,444,100,667,93400,65759
238,234,4,-,46700,65760
580,503,77,583,165800,65761
160,114,46,566,73100,65762
478,443,35,-,87900,65764
44,37,7,-,53800,65766
793,629,164,613,115200,65767
184,110,74,507,149100,65768
953,724,229,769,115200,65769
1230,999,231,700,133800,65770
491,445,46,-,221900,65771
704,593,111,710,108400,65772
255,238,17,-,66900,65773
419,300,119,607,78900,65774
10099,6628,3471,633,106000,65775
199,179,20,-,76600,65777
189,130,59,606,150000,65778
862,658,204,623,96400,65779
3200,2447,753,829,139600,65781
25,16,9,-,-,65783
10,3,7,-,-,65784
2183,1615,568,679,115900,65785
708,588,120,569,137700,65786
583,465,118,900,201800,65787
162,132,30,343,85000,65788
570,469,101,449,114100,65789
343,330,13,-,-,65790
1805,1256,549,510,99300,65791
2398,1819,579,490,100300,65793
18918,9879,9039,708,105600,65802
17454,9586,7868,711,107200,65803
18010,10291,7719,747,155400,65804
6042,842,5200,628,83200,65806
24993,11585,13408,798,124900,65807
4710,4105,605,997,280300,65809
9281,6679,2602,886,202800,65810
4715,3111,1604,674,98400,66002
2787,2101,686,888,202500,66006
2510,2004,506,952,224700,66007
126,112,14,-,92900,66008
325,279,46,523,107200,66010
4278,3257,1021,860,191700,66012
792,737,55,-,314400,66013
85,52,33,-,227300,66014
312,212,100,562,86000,66015
122,111,11,-,158500,66016
157,116,41,429,81100,66017
2336,1604,732,774,218600,66018
172,0,172,637,-,66019
487,405,82,928,189300,66020
959,845,114,938,162300,66021
485,340,145,744,96200,66023
334,211,123,576,62400,66024
2674,1807,867,985,171900,66025
181,151,30,856,128100,66026
1488,0,1488,1643,-,66027
8030,5462,2568,1060,185000,66030
0,0,0,-,-,66031
2026,1468,558,672,93200,66032
253,205,48,591,96500,66033
283,193,90,550,72100,66035
236,210,26,708,105800,66039
1455,949,506,671,83600,66040
303,265,38,621,95800,66041
294,271,23,763,107100,66042
3064,2167,897,1069,171800,66043
10617,4117,6500,815,161200,66044
0,0,0,-,-,66045
8151,3887,4264,825,163000,66046
8351,3866,4485,970,222500,66047
13222,8281,4941,851,140500,66048
12863,7463,5400,1007,228400,66049
818,742,76,986,202700,66050
1004,830,174,1103,179500,66052
2779,2238,541,1011,211900,66053
1055,793,262,842,150800,66054
806,668,138,641,107100,66056
124,94,30,570,68800,66058
485,333,152,683,96500,66060
21637,15241,6396,869,223900,66061
27970,20832,7138,1072,233100,66062
2266,1481,785,768,99400,66064
1059,832,227,834,164900,66066
6109,3960,2149,768,121800,66067
1046,966,80,829,138200,66070
5105,4033,1072,784,185700,66071
471,456,15,-,146200,66072
1058,837,221,933,155100,66073
1100,852,248,668,89600,66075
965,797,168,803,137500,66076
456,363,93,726,158900,66078
337,290,47,919,129300,66079
339,278,61,854,81600,66080
3224,2773,451,909,225200,66083
2781,2587,194,1394,393500,66085
3496,2901,595,927,193200,66086
796,625,171,545,95300,66087
927,768,159,591,130400,66088
1149,818,331,667,124700,66090
132,103,29,-,105100,66091
1348,1076,272,728,157700,66092
224,189,35,-,109800,66093
143,93,50,513,64600,66094
378,283,95,725,87400,66095
574,428,146,566,123300,66097
4667,1725,2942,662,55000,66101
10406,5031,5375,814,65900,66102
6102,2061,4041,874,90500,66103
9404,5669,3735,901,74600,66104
780,415,365,775,41200,66105
8331,5404,2927,859,101700,66106
8422,6798,1624,1307,166500,66109
3694,2675,1019,901,103400,66111
5265,2518,2747,873,112600,66112
0,0,0,-,-,66115
0,0,0,-,-,66118
7845,3794,4051,922,163700,66202
8228,5033,3195,895,161000,66203
8879,4293,4586,1004,154700,66204
5989,4908,1081,1173,198500,66205
4215,3801,414,2041,410200,66206
6111,4673,1438,1323,276600,66207
9110,7463,1647,1413,264500,66208
8319,6011,2308,1199,381000,66209
8455,4795,3660,1117,239900,66210
2158,1394,764,1248,463500,66211
14433,8710,5723,995,177000,66212
11632,7317,4315,1161,325300,66213
5148,2680,2468,871,197300,66214
11028,7030,3998,1041,208000,66215
9035,7462,1573,1052,219700,66216
2476,1363,1113,1018,326900,66217
2666,2347,319,1639,278400,66218
5323,2244,3079,1157,254200,66219
2595,2430,165,1302,400000,66220
5760,4495,1265,1184,451200,66221
9596,5721,3875,1361,295300,66223
4650,4126,524,1192,460100,66224
4453,3961,492,1060,264200,66226
2323,2108,215,1492,295600,66227
722,612,110,663,130800,66401
1155,970,185,807,155800,66402
306,266,40,800,166700,66403
178,97,81,473,265800,66404
187,148,39,425,96700,66406
211,106,105,844,142900,66407
141,94,47,675,89100,66408
1367,1239,128,866,229300,66409
459,380,79,581,81600,66411
73,69,4,-,114600,66412
789,612,177,568,93100,66413
1191,861,330,661,107400,66414
339,289,50,450,84600,66415
253,186,67,1294,141700,66416
131,108,23,535,91400,66417
176,167,9,625,130400,66418
172,154,18,870,110800,66419
135,128,7,-,97300,66422
367,292,75,520,81900,66423
209,178,31,556,86300,66424
190,161,29,525,88500,66425
469,393,76,574,86600,66427
159,153,6,-,108100,66428
176,157,19,-,125800,66429
219,206,13,396,94300,66431
128,94,34,712,113500,66432
1902,1393,509,718,94400,66434
2536,1689,847,588,137000,66436
62,62,0,-,-,66438
1096,703,393,533,80600,66439
720,640,80,748,155600,66440
10241,4372,5869,940,141100,66441
3812,30,3782,1215,-,66442
428,371,57,809,160800,66449
597,479,118,817,103500,66451
129,126,3,-,65000,66501
17719,7114,10605,869,183300,66502
6322,3823,2499,1064,255000,66503
17,0,17,-,-,66506
458,407,51,635,160000,66507
1924,1342,582,568,104200,66508
1003,770,233,743,146100,66509
295,224,71,608,96700,66510
1160,1007,153,727,145100,66512
459,380,79,693,186600,66514
161,150,11,625,96300,66515
135,117,18,500,90600,66516
730,301,429,938,99800,66517
59,57,2,-,91300,66518
228,197,31,912,143300,66520
651,471,180,588,89000,66521
32,4,28,845,85000,66522
1652,1031,621,608,113600,66523
959,773,186,900,149500,66524
286,217,69,847,215000,66526
92,57,35,592,69000,66527
328,250,78,648,127500,66528
691,579,112,1045,154100,66531
283,244,39,1000,125000,66532
591,447,144,895,146300,66533
1433,981,452,675,120900,66534
1049,915,134,845,198400,66535
1109,903,206,709,155700,66536
407,356,51,875,96800,66537
1411,1133,278,531,155100,66538
1042,793,249,652,172500,66539
193,170,23,714,80000,66540
84,75,9,-,43200,66541
1152,1098,54,-,158300,66542
495,425,70,860,126200,66543
163,116,47,571,85000,66544
474,433,41,588,184800,66546
3558,2524,1034,788,188000,66547
375,299,76,638,81800,66548
680,512,168,606,161600,66549
241,171,70,700,67900,66550
192,158,34,600,81400,66552
235,201,34,825,172900,66554
747,158,589,615,43800,66603
9858,5526,4332,808,95800,66604
7118,4812,2306,781,114000,66605
5293,2734,2559,794,82300,66606
2950,1360,1590,705,39700,66607
2151,1222,929,819,56200,66608
3071,2119,952,774,112100,66609
3846,3568,278,1577,241300,66610
4648,2545,2103,846,100700,66611
1242,242,1000,469,59000,66612
14066,8979,5087,831,143700,66614
1389,895,494,933,207500,66615
2380,1467,913,724,67000,66616
3363,2845,518,867,153200,66617
3557,3201,356,901,169300,66618
883,312,571,1058,72100,66619
7,7,0,-,-,66621
0,0,0,-,-,66622
4838,3291,1547,621,85000,66701
231,201,30,700,59600,66710
248,187,61,525,32300,66711
708,462,246,570,87900,66712
2146,1523,623,613,79300,66713
96,95,1,-,-,66714
124,92,32,658,42300,66716
219,202,17,550,44500,66717
4700,3167,1533,593,80700,66720
389,334,55,667,62100,66724
2190,1583,607,559,85700,66725
21,14,7,-,-,66728
116,108,8,-,-,66732
863,638,225,684,64300,66733
96,82,14,-,157500,66734
159,148,11,-,60600,66735
1649,1106,543,744,76700,66736
89,87,2,-,95000,66738
2092,1571,521,748,71800,66739
170,159,11,770,63200,66740
61,61,0,-,90800,66741
1568,1077,491,817,89400,66743
91,83,8,-,51000,66746
1118,857,261,553,78800,66748
3189,2089,1100,654,84000,66749
340,297,43,638,57100,66751
427,347,80,469,56400,66753
157,116,41,1109,155000,66754
390,296,94,518,63500,66755
384,287,97,303,63300,66756
1391,988,403,568,66900,66757
118,93,25,494,47000,66758
0,0,0,-,-,66760
110,97,13,-,87400,66761
9712,4836,4876,724,96100,66762
1374,993,381,779,132100,66763
226,184,42,517,113800,66767
151,112,39,-,48300,66769
438,331,107,613,89300,66770
353,301,52,565,133600,66771
76,71,5,-,78800,66772
325,280,45,925,53200,66773
79,66,13,-,162500,66775
542,386,156,652,75700,66776
264,214,50,413,55000,66777
0,0,0,-,-,66778
272,213,59,471,84000,66779
196,179,17,-,76600,66780
457,373,84,672,75300,66781
58,44,14,-,31300,66782
1003,756,247,599,59400,66783
11559,6385,5174,670,104600,66801
65,59,6,-,82500,66830
216,190,26,625,131300,66833
361,308,53,700,85900,66834
489,384,105,700,104500,66835
40,40,0,-,50000,66838
1566,1143,423,628,134100,66839
260,201,59,608,77500,66840
182,136,46,-,85300,66842
71,69,2,-,107600,66843
442,341,101,608,75500,66845
1320,971,349,570,113500,66846
176,162,14,543,84800,66849
95,68,27,777,-,66850
264,161,103,536,35500,66851
264,199,65,709,80700,66852
207,177,30,670,38200,66853
299,213,86,785,61100,66854
721,604,117,617,129200,66856
451,336,115,660,76500,66857
175,154,21,578,70000,66858
96,82,14,913,96700,66859
595,403,192,593,76600,66860
1249,1022,227,625,88800,66861
45,37,8,-,137500,66862
14,10,4,-,-,66863
181,166,15,663,73000,66864
522,404,118,643,133700,66865
675,493,182,497,85500,66866
315,259,56,669,130800,66868
296,231,65,595,98300,66869
53,48,5,-,-,66870
551,460,91,613,88400,66871
408,316,92,725,102300,66872
98,88,10,519,57800,66873
2596,1716,880,625,82400,66901
68,44,24,-,-,66930
40,33,7,-,83800,66932
193,154,39,605,106000,66933
1110,773,337,521,71600,66935
146,122,24,-,35000,66936
317,258,59,468,68500,66937
464,373,91,672,74000,66938
255,201,54,585,74700,66939
159,123,36,765,47500,66940
101,91,10,767,34400,66941
108,101,7,-,50500,66942
214,156,58,463,57500,66943
77,59,18,233,36900,66944
374,315,59,543,86300,66945
52,51,1,-,87000,66946
195,175,20,575,71300,66948
322,216,106,446,44700,66949
315,253,62,575,76200,66951
188,165,23,765,36900,66952
282,214,68,447,97300,66953
33,29,4,-,-,66955
546,455,91,508,62600,66956
126,97,29,819,28600,66958
94,90,4,-,31100,66959
81,60,21,-,13700,66960
148,127,21,513,115300,66962
54,41,13,-,29300,66963
84,69,15,338,30400,66964
350,273,77,525,62300,66966
935,711,224,492,68800,66967
673,502,171,442,79300,66968
54,54,0,-,86000,66970
433,357,76,969,192100,67001
5108,3967,1141,1368,190900,67002
1017,719,298,792,71800,67003
300,195,105,667,95400,67004
6132,3867,2265,662,80300,67005
295,233,62,738,100500,67008
371,240,131,617,62400,67009
5293,3615,1678,837,142300,67010
12,12,0,-,-,67012
1197,915,282,790,86200,67013
196,172,24,980,111900,67016
880,772,108,1081,196600,67017
52,37,15,-,201900,67018
466,394,72,688,86800,67019
603,470,133,686,108200,67020
18,13,5,-,80800,67021
663,497,166,580,61400,67022
120,110,10,544,90000,67023
347,235,112,544,62500,67024
1321,1097,224,860,159700,67025
1724,1480,244,732,164900,67026
150,108,42,769,55000,67028
444,347,97,563,72200,67029
846,778,68,900,177200,67030
904,725,179,689,105700,67031
370,278,92,756,98600,67035
24,21,3,-,72500,67036
10708,7993,2715,908,164300,67037
261,207,54,538,77200,67038
1231,958,273,664,135800,67039
106,102,4,-,106800,67041
6702,4517,2185,734,98700,67042
1439,1011,428,561,61500,67045
319,224,95,707,55200,67047
49,49,0,-,173400,67049
638,557,81,747,162100,67050
201,166,35,581,70000,67051
2623,2240,383,1068,178800,67052
246,197,49,521,88200,67053
529,347,182,675,160100,67054
52,38,14,-,-,67055
1078,830,248,610,122000,67056
92,70,22,432,55000,67057
749,565,184,640,75700,67058
309,252,57,621,89200,67059
5244,3905,1339,880,107600,67060
79,62,17,-,-,67061
1698,1210,488,578,144900,67062
1341,1047,294,605,94700,67063
74,67,7,1104,93000,67065
143,130,13,-,93300,67066
633,589,44,1021,166300,67067
1772,1345,427,710,88100,67068
430,338,92,472,77100,67070
93,81,12,-,-,67071
81,71,10,1042,43900,67072
136,121,15,525,101300,67073
619,485,134,707,85000,67074
1632,1007,625,857,164100,67101
82,75,7,-,154500,67103
1001,634,367,526,65300,67104
59,46,13,725,86700,67105
112,83,29,-,107700,67106
1383,1016,367,613,150700,67107
586,467,119,730,130600,67108
165,119,46,579,81400,67109
3333,2766,567,847,131700,67110
106,89,17,-,105500,67111
96,85,11,-,72500,67112
8620,6175,2445,742,112600,67114
677,448,229,581,150000,67117
275,226,49,740,83300,67118
580,395,185,455,88800,67119
465,426,39,-,164400,67120
62,54,8,-,123100,67122
251,187,64,650,84400,67123
3113,2049,1064,672,94000,67124
236,206,30,371,81900,67127
146,108,38,343,-,67131
162,146,16,-,92500,67132
2284,1867,417,953,159300,67133
158,115,43,540,74200,67134
1092,824,268,855,165700,67135
193,179,14,438,54500,67137
132,120,12,638,71500,67138
364,310,54,646,85900,67140
177,155,22,705,110600,67142
12,9,3,-,63800,67143
960,783,177,689,124300,67144
739,584,155,750,109900,67146
3705,3173,532,1052,165500,67147
317,313,4,-,224500,67149
18,6,12,-,-,67150
217,163,54,905,83200,67151
3644,2465,1179,712,78900,67152
510,386,124,772,152000,67154
86,69,17,-,187500,67155
5390,3519,1871,716,97200,67156
57,46,11,-,54400,67159
1036,115,921,855,-,67202
12610,6503,6107,722,98900,67203
7802,5830,1972,724,105500,67204
6312,5436,876,1186,228300,67205
7113,4712,2401,885,239800,67206
11283,5593,5690,780,143000,67207
7324,4029,3295,809,116100,67208
4980,3660,1320,909,145900,67209
3192,1268,1924,699,131100,67210
8006,3475,4531,694,71300,67211
18649,12221,6428,863,138800,67212
8723,3730,4993,764,68900,67213
6016,2034,3982,682,50500,67214
2105,1932,173,1229,146900,67215
8832,5284,3548,752,70400,67216
11581,7688,3893,819,84100,67217
9551,4437,5114,749,87200,67218
4553,3096,1457,918,103500,67219
5506,3255,2251,806,149000,67220
202,192,10,-,298500,67223
7972,4870,3102,965,201000,67226
91,91,0,-,292500,67227
743,738,5,-,326100,67228
3847,3639,208,1618,295500,67230
184,184,0,-,301100,67232
4292,4151,141,1623,224200,67235
0,0,0,-,-,67260
5220,3455,1765,694,91100,67301
548,410,138,560,89600,67330
39,30,9,490,70800,67332
1088,852,236,603,66300,67333
20,20,0,-,23300,67334
1322,1017,305,660,72400,67335
693,454,239,668,58700,67336
5137,3306,1831,617,65800,67337
176,154,22,775,46800,67340
108,108,0,-,109800,67341
383,314,69,594,88300,67342
357,314,43,663,74800,67344
54,42,12,-,-,67345
153,141,12,535,66400,67346
178,169,9,-,154800,67347
456,344,112,396,53200,67349
145,124,21,613,58900,67351
206,162,44,571,47900,67352
264,223,41,633,62800,67353
315,232,83,519,91300,67354
79,75,4,-,116300,67355
1085,774,311,548,67200,67356
4841,3325,1516,653,79200,67357
175,145,30,-,49100,67360
740,579,161,597,55400,67361
52,52,0,-,81300,67363
122,104,18,713,60000,67364
20787,13825,6962,749,127600,67401
4197,2938,1259,654,123900,67410
393,326,67,750,165200,67416
99,86,13,-,64200,67417
56,41,15,-,13800,67418
1930,1365,565,566,93100,67420
538,463,75,750,139800,67422
102,77,25,672,75000,67423
260,209,51,606,159000,67425
169,131,38,600,66100,67427
653,520,133,800,127100,67428
292,238,54,557,59300,67430
806,534,272,750,152300,67431
2359,1838,521,614,92600,67432
294,230,64,725,82400,67436
491,371,120,448,84300,67437
88,73,15,644,72500,67438
1225,881,344,622,124900,67439
461,350,111,900,74000,67441
70,63,7,-,173700,67442
660,538,122,802,153200,67443
236,210,26,423,70000,67444
268,213,55,633,53300,67445
232,202,30,413,78800,67446
132,74,58,-,73600,67447
497,390,107,833,120300,67448
1279,841,438,657,64100,67449
289,235,54,675,68800,67450
448,302,146,600,72600,67451
74,67,7,-,42700,67452
286,230,56,700,84200,67454
811,639,172,512,76800,67455
1707,1152,555,688,165500,67456
333,231,102,652,84700,67457
86,59,27,654,60900,67458
99,69,30,678,63600,67459
6559,4397,2162,766,147400,67460
503,407,96,667,97500,67464
362,276,86,498,56500,67466
1070,831,239,583,89300,67467
114,96,18,615,68000,67468
186,136,50,1105,141700,67470
798,580,218,538,72300,67473
108,89,19,-,61100,67474
70,68,2,-,63300,67475
28,25,3,-,-,67478
638,531,107,632,119100,67480
259,230,29,569,75300,67481
48,37,11,-,77200,67482
153,123,30,525,65800,67483
359,302,57,496,93800,67484
146,116,30,434,89200,67485
561,428,133,883,145300,67487
395,302,93,658,82600,67490
158,136,22,669,141000,67491
101,73,28,855,57000,67492
9817,5799,4018,674,66600,67501
9997,7450,2547,811,135000,67502
1179,702,477,488,96400,67505
123,119,4,-,74500,67510
126,118,8,-,70000,67511
74,57,17,-,39700,67512
37,34,3,-,38300,67513
366,258,108,625,55900,67514
18,10,8,-,-,67515
173,151,22,-,54300,67516
24,20,4,-,118800,67518
80,47,33,470,70600,67519
124,103,21,-,75000,67520
61,34,27,-,-,67521
776,585,191,628,137300,67522
198,152,46,631,50500,67523
267,211,56,511,31500,67524
453,369,84,539,81500,67525
1219,949,270,653,83400,67526
124,104,20,810,55000,67529
7728,5197,2531,657,98000,67530
778,577,201,734,100200,67543
1112,758,354,682,81300,67544
72,66,6,-,61400,67545
971,719,252,762,149800,67546
836,650,186,543,59600,67547
608,436,172,559,83800,67548
2116,1398,718,606,79000,67550
267,228,39,492,58200,67552
75,64,11,1313,36400,67553
1636,1227,409,553,75100,67554
153,123,30,-,49200,67556
209,180,29,755,52300,67557
17,15,2,-,-,67559
723,610,113,552,87500,67560
502,387,115,646,72600,67561
141,120,21,481,79100,67563
103,94,9,-,40000,67564
220,196,24,600,74400,67565
187,167,20,780,86300,67566
228,170,58,488,47500,67567
88,81,7,-,98300,67568
506,414,92,717,81500,67570
231,212,19,507,64300,67572
86,72,14,475,93800,67573
95,72,23,568,52200,67574
216,166,50,719,68600,67575
844,693,151,662,86500,67576
572,443,129,601,49400,67578
1195,868,327,562,97000,67579
119,109,10,375,46100,67581
356,277,79,520,49000,67583
139,120,19,446,60000,67584
9679,5601,4078,689,171300,67601
169,137,32,439,54300,67621
253,184,69,611,89500,67622
93,66,27,514,46700,67623
165,126,39,446,57800,67625
80,74,6,-,68500,67626
51,43,8,-,108600,67628
92,76,16,-,63700,67629
69,61,8,-,-,67631
91,68,23,446,84500,67632
108,63,45,472,55000,67634
66,40,26,-,-,67635
1121,906,215,726,115400,67637
128,94,34,317,58800,67638
82,74,8,-,166700,67639
247,187,60,750,86900,67640
847,663,184,600,78100,67642
151,104,47,632,58200,67643
124,100,24,681,38900,67644
360,330,30,583,49600,67645
345,286,59,526,72100,67646
97,65,32,478,56100,67647
267,206,61,519,53300,67648
88,86,2,-,65000,67649
95,81,14,-,61300,67650
215,168,47,517,53600,67651
166,137,29,563,52100,67653
1322,926,396,694,77500,67654
24,24,0,-,-,67656
125,87,38,533,80600,67657
74,48,26,-,166700,67658
45,40,5,-,58200,67659
33,23,10,-,78500,67660
1407,1055,352,644,87900,67661
1057,809,248,593,85500,67663
119,93,26,-,71300,67664
2120,1753,367,614,94800,67665
68,63,5,-,101500,67667
769,613,156,480,63800,67669
633,483,150,740,163000,67671
1194,908,286,592,87900,67672
52,39,13,-,56300,67673
35,35,0,-,71900,67674
76,74,2,-,45600,67675
2767,1979,788,529,127200,67701
766,551,215,610,105700,67730
313,223,90,580,75800,67731
205,151,54,579,95900,67732
109,85,24,-,87600,67733
127,73,54,572,107500,67734
2334,1483,851,797,99900,67735
89,60,29,755,82500,67736
206,181,25,531,85600,67737
264,206,58,608,79700,67738
83,68,15,505,35000,67739
720,521,199,543,113800,67740
182,126,56,591,76500,67741
45,36,9,-,89500,67743
107,95,12,-,103900,67744
154,134,20,775,71500,67745
85,81,4,-,71400,67747
963,677,286,732,103200,67748
1062,739,323,645,67800,67749
137,122,15,-,38600,67751
559,408,151,616,93300,67752
191,133,58,628,97500,67753
912,747,165,572,86000,67756
235,193,42,625,106600,67757
472,367,105,507,101000,67758
99,80,19,-,98900,67761
78,55,23,500,87800,67762
165,128,37,425,57900,67764
9799,6062,3737,765,110000,67801
413,296,117,492,58200,67831
404,304,100,635,83100,67834
1022,708,314,706,150000,67835
53,37,16,-,52500,67836
352,245,107,540,98400,67837
308,260,48,675,55900,67838
639,514,125,425,78600,67839
34,26,8,-,20700,67840
141,123,18,767,57300,67841
191,132,59,582,65000,67842
113,0,113,-,-,67843
355,227,128,618,92300,67844
11492,7004,4488,774,138600,67846
143,111,32,510,51500,67849
160,105,55,550,51700,67850
836,706,130,1024,150900,67851
258,200,58,750,113100,67853
554,418,136,647,85300,67854
687,548,139,627,96000,67855
45,28,17,-,175000,67857
267,203,64,761,79700,67859
908,674,234,669,122700,67860
768,581,187,690,89300,67861
128,115,13,705,66800,67862
144,92,52,492,78700,67863
780,540,240,614,90200,67864
474,325,149,794,108400,67865
656,504,152,699,133000,67867
109,82,27,-,-,67868
536,385,151,770,105600,67869
412,310,102,738,84300,67870
2053,1515,538,802,135300,67871
502,417,85,742,131800,67876
824,660,164,675,117300,67877
768,538,230,615,85500,67878
494,307,187,648,97900,67879
2619,2033,586,632,108900,67880
179,69,110,638,162100,67882
7001,4774,2227,741,99300,67901
818,595,223,679,94400,67950
1727,1162,565,684,111000,67951
184,146,38,-,102400,67952
51,23,28,-,101300,67953
274,179,95,710,88500,67954
39,35,4,-,81500,68001
1020,816,204,677,177200,68002
1770,1291,479,755,197800,68003
369,274,95,681,96500,68004
9331,5180,4151,852,136900,68005
3589,3157,432,1039,232400,68007
4871,3758,1113,699,169900,68008
11,2,9,-,-,68010
126,118,8,675,109800,68014
458,378,80,938,146700,68015
203,177,26,1153,231500,68016
691,593,98,720,147900,68017
172,163,9,900,163400,68018
192,163,29,709,98200,68019
285,243,42,280,80700,68020
8460,6389,2071,1065,322900,68022
973,761,212,1110,282000,68023
12645,7656,4989,743,131600,68025
4495,3743,752,996,252700,68028
392,258,134,658,134100,68029
327,239,88,876,115100,68030
736,518,218,690,141700,68031
141,124,17,825,167100,68033
299,268,31,-,146800,68034
77,51,26,691,83000,68036
900,725,175,833,195800,68037
624,459,165,537,90500,68038
301,83,218,584,55500,68039
206,162,44,983,142100,68040
427,309,118,796,145300,68041
35,30,5,875,105000,68042
231,203,28,944,139900,68044
729,517,212,743,92800,68045
9916,7268,2648,908,205500,68046
712,559,153,694,117300,68047
4954,3854,1100,781,165700,68048
275,230,45,722,98100,68050
115,84,31,660,63800,68055
654,484,170,584,83300,68057
117,103,14,675,-,68058
1225,1083,142,922,210100,68059
1031,773,258,575,98400,68061
116,91,25,715,134700,68062
108,86,22,-,85000,68063
1590,1105,485,805,200300,68064
571,475,96,766,170300,68065
2214,1565,649,697,156600,68066
325,211,114,562,33800,68067
36,35,1,-,155400,68068
1199,994,205,853,243800,68069
252,217,35,669,166100,68070
562,242,320,575,76700,68071
29,20,9,-,67500,68072
708,627,81,800,169900,68073
3981,521,3460,962,308400,68102
14193,7958,6235,858,102200,68104
9458,4049,5409,772,119200,68105
9484,5796,3688,890,134400,68106
9277,5641,3636,847,91900,68107
5142,2361,2781,854,90300,68108
3097,1448,1649,740,65200,68110
7954,3204,4750,895,62400,68111
4364,2910,1454,933,95600,68112
222,0,222,1184,-,68113
8152,4085,4067,976,170300,68114
10991,8690,2301,1097,220600,68116
3147,2219,928,999,108700,68117
3510,3061,449,1332,269800,68118
4200,3432,768,1136,148200,68122
11521,6554,4967,1123,185000,68123
6549,4314,2235,1091,192500,68124
10163,4565,5598,807,154900,68127
7582,4465,3117,999,166100,68128
7884,6125,1759,1236,265100,68130
5650,1629,4021,789,113000,68131
5828,3034,2794,735,242700,68132
3659,3285,374,1073,256100,68133
12354,6571,5783,826,137600,68134
9630,8703,927,1444,228400,68135
5979,5174,805,1190,232600,68136
10416,7024,3392,1031,151500,68137
4719,3595,1124,863,146000,68138
1571,1430,141,1102,207000,68142
10043,7062,2981,897,164700,68144
3919,2806,1113,930,133100,68147
2366,1869,497,778,189000,68152
10109,6074,4035,897,211800,68154
2502,1806,696,1025,149000,68157
11893,7670,4223,997,159300,68164
0,0,0,-,-,68178
549,451,98,905,230100,68301
130,118,12,513,52000,68303
137,123,14,1031,248300,68304
1781,1224,557,624,115600,68305
175,132,43,625,135000,68307
53,37,16,-,46900,68309
6049,3691,2358,637,112700,68310
255,220,35,839,110300,68313
211,147,64,1037,89900,68314
47,37,10,-,77700,68315
213,172,41,667,98300,68316
688,640,48,950,183300,68317
191,154,37,850,74400,68318
242,193,49,672,97500,68319
180,141,39,588,111200,68320
148,141,7,-,100500,68321
215,176,39,298,82000,68322
130,113,17,-,100900,68323
39,26,13,-,-,68324
89,82,7,-,65000,68325
88,71,17,625,63100,68326
138,129,9,-,41300,68327
197,157,40,677,130700,68328
253,210,43,580,75600,68329
350,300,50,1161,160500,68331
61,57,4,-,-,68332
2818,1821,997,763,99700,68333
216,181,35,633,57500,68335
194,192,2,-,190000,68336
163,143,20,525,80300,68337
145,122,23,-,75500,68338
487,431,56,500,283500,68339
385,284,101,633,64800,68340
431,337,94,814,122000,68341
244,176,68,607,97800,68342
397,307,90,788,102200,68343
175,159,16,760,117600,68344
119,115,4,-,58600,68345
204,151,53,570,143200,68346
976,949,27,846,219100,68347
140,101,39,427,146600,68348
434,381,53,738,162500,68349
90,83,7,-,59200,68350
386,285,101,621,79800,68351
2240,1474,766,599,71300,68352
414,341,73,625,64100,68354
2268,1720,548,604,73600,68355
148,125,23,950,108700,68357
615,573,42,550,273800,68358
606,504,102,758,129100,68359
209,170,39,1352,165600,68360
974,693,281,586,92400,68361
20,20,0,-,38800,68362
47,46,1,-,110900,68364
106,86,20,581,82000,68365
399,359,40,950,155200,68366
142,118,24,395,50000,68367
216,206,10,1125,258800,68368
961,699,262,539,85700,68370
655,493,162,720,123400,68371
1121,984,137,885,215200,68372
45,38,7,381,"10,000-",68375
668,489,179,515,64600,68376
187,160,27,-,78600,68377
301,278,23,706,117800,68378
26,26,0,-,76000,68379
49,39,10,-,32200,68380
83,62,21,475,-,68381
9,8,1,-,108300,68382
265,208,57,715,142400,68401
517,436,81,925,242900,68402
63,52,11,750,129200,68403
343,294,49,-,265200,68404
1277,815,462,689,168600,68405
225,178,47,667,70000,68406
305,239,66,769,199200,68407
356,290,66,794,146300,68409
3568,2392,1176,650,122700,68410
247,210,37,643,117400,68413
125,76,49,577,118800,68414
272,249,23,542,97400,68415
120,98,22,523,28500,68416
136,116,20,875,62900,68417
443,368,75,867,156100,68418
95,74,21,738,140000,68419
600,479,121,512,78900,68420
314,197,117,528,79300,68421
213,194,19,741,158300,68422
476,433,43,633,223000,68423
324,275,49,525,103400,68424
476,448,28,706,348000,68428
624,555,69,1324,318200,68430
177,160,17,-,58800,68431
107,57,50,520,34200,68433
3228,2258,970,702,166400,68434
259,203,56,650,88800,68436
126,111,15,584,62800,68437
52,44,8,725,117900,68438
230,182,48,625,109300,68439
47,47,0,-,51700,68440
77,68,9,-,-,68441
144,113,31,-,66800,68442
417,378,39,772,88900,68443
31,27,4,-,54200,68444
46,44,2,-,54300,68445
1196,852,344,633,144500,68446
237,197,40,606,58300,68447
157,142,15,714,104500,68448
930,610,320,667,84100,68450
35,31,4,-,27800,68452
179,122,57,805,51700,68453
262,203,59,650,170400,68454
210,184,26,-,256400,68455
490,352,138,834,139500,68456
146,131,15,469,43800,68457
68,58,10,650,85000,68458
312,246,66,822,116500,68460
209,160,49,-,326800,68461
1480,1147,333,695,171100,68462
581,444,137,655,135600,68463
244,220,24,613,55900,68464
876,625,251,653,124900,68465
718,565,153,565,55300,68466
3880,2603,1277,679,136800,68467
11277,6026,5251,649,143100,68502
6202,1920,4282,694,97200,68503
7778,3044,4734,823,119200,68504
7023,4227,2796,882,146300,68505
13025,7993,5032,930,166400,68506
6190,4320,1870,815,139200,68507
5134,517,4617,589,96600,68508
9304,5449,3855,714,142200,68510
5296,3420,1876,1001,221000,68512
38,38,0,-,324000,68514
17162,12429,4733,960,226400,68516
194,171,23,-,325600,68517
644,615,29,1356,349300,68520
13451,7987,5464,878,154200,68521
4407,3220,1187,915,152000,68522
536,489,47,-,342500,68523
2067,1252,815,808,131300,68524
2416,2003,413,1168,308000,68526
264,264,0,-,416200,68527
2512,1542,970,964,151100,68528
137,44,93,965,456400,68531
208,208,0,-,324200,68532
11256,7971,3285,745,146100,68601
1149,865,284,597,130600,68620
236,218,18,-,139100,68621
133,91,42,336,88800,68622
126,93,33,-,30300,68623
380,354,26,736,149000,68624
283,227,56,715,102400,68626
299,258,41,663,101900,68627
347,258,89,668,82800,68628
546,455,91,580,87800,68629
165,137,28,483,105600,68631
1667,1149,518,699,107400,68632
513,391,122,625,89500,68633
200,165,35,1045,102000,68634
168,155,13,775,144200,68635
593,478,115,589,86700,68636
153,107,46,550,66500,68637
756,583,173,521,81700,68638
667,506,161,645,87700,68640
501,419,82,515,101000,68641
724,575,149,818,165300,68642
443,337,106,613,122100,68643
220,170,50,788,117300,68644
265,211,54,625,89400,68647
173,140,33,723,137500,68648
811,593,218,714,117600,68649
558,460,98,587,103200,68651
284,241,43,632,77300,68652
293,257,36,968,103700,68653
219,154,65,825,67000,68654
75,63,12,783,-,68655
295,267,28,833,110600,68658
78,53,25,533,97500,68659
488,361,127,602,84800,68660
2289,1521,768,699,88000,68661
528,414,114,633,112000,68662
326,276,50,659,66500,68663
158,117,41,840,62500,68664
358,291,67,693,76400,68665
592,461,131,581,88500,68666
46,41,5,-,-,68667
190,148,42,558,84400,68669
12642,8314,4328,685,140200,68701
302,250,52,762,115400,68710
106,99,7,-,68700,68711
951,713,238,577,115200,68713
544,391,153,558,82200,68714
595,467,128,652,144100,68715
460,321,139,674,81300,68716
93,88,5,-,108300,68717
772,552,220,574,81900,68718
55,45,10,675,57500,68719
121,92,29,756,74600,68720
241,176,65,308,54700,68722
216,173,43,568,106300,68723
64,51,13,-,-,68724
237,206,31,581,71200,68725
246,192,54,550,78800,68726
328,260,68,513,102900,68727
101,77,24,-,65000,68728
842,687,155,600,95000,68729
740,591,149,438,153600,68730
974,715,259,665,119700,68731
114,103,11,570,63900,68732
549,388,161,594,97200,68733
36,27,9,-,103400,68734
333,277,56,593,72500,68735
231,178,53,-,142900,68736
1228,1054,174,717,136500,68739
428,368,60,768,166700,68740
271,191,80,975,135600,68741
79,61,18,775,-,68742
226,174,52,875,162500,68743
604,457,147,703,100900,68745
192,158,34,475,36700,68746
43,39,4,-,112500,68747
1002,666,336,724,99800,68748
32,24,8,-,57500,68749
33,29,4,-,63500,68751
331,276,55,572,103600,68752
45,36,9,-,144400,68753
140,116,24,-,69500,68755
785,566,219,559,84600,68756
330,290,40,648,95500,68757
561,379,182,611,83600,68758
109,82,27,518,46000,68759
543,308,235,397,73800,68760
159,140,19,600,19800,68761
2015,1367,648,735,125600,68763
347,262,85,424,77600,68764
585,441,144,638,98300,68765
193,167,26,288,65800,68766
1366,1047,319,588,139100,68767
257,186,71,779,88100,68768
762,601,161,631,83900,68769
645,518,127,632,98600,68770
600,444,156,676,114700,68771
72,59,13,-,156300,68773
92,87,5,-,120100,68774
5413,3401,2012,733,110100,68776
308,256,52,470,86500,68777
233,179,54,592,61000,68778
1046,859,187,532,111600,68779
481,350,131,545,117100,68780
625,457,168,556,91800,68781
417,295,122,513,73500,68783
704,569,135,714,90100,68784
90,70,20,600,115000,68785
441,334,107,463,77600,68786
2448,1327,1121,698,138200,68787
1935,1303,632,639,127700,68788
61,54,7,-,-,68789
363,278,85,588,83500,68790
751,520,231,660,112500,68791
172,141,31,633,100800,68792
10788,6294,4494,738,118300,68801
9752,6185,3567,745,164900,68803
385,321,64,833,86900,68810
220,179,41,665,101000,68812
216,170,46,721,66900,68813
402,292,110,645,66400,68814
257,171,86,595,119500,68815
105,85,20,-,111600,68816
142,114,28,630,82500,68817
2188,1710,478,730,142700,68818
170,143,27,936,106900,68820
31,15,16,600,-,68821
2081,1336,745,629,117900,68822
1005,793,212,432,109300,68823
522,388,134,712,140000,68824
498,374,124,680,121000,68825
1660,1069,591,627,100100,68826
252,191,61,784,87800,68827
118,94,24,647,68000,68828
302,248,54,675,131300,68831
799,634,165,788,202200,68832
164,98,66,675,109700,68833
73,55,18,583,85000,68834
271,191,80,572,98800,68835
666,534,132,828,118200,68836
65,41,24,-,-,68837
99,96,3,-,80000,68838
1155,862,293,838,146400,68840
199,185,14,725,143800,68841
268,179,89,556,93800,68842
321,288,33,913,119300,68843
126,118,8,-,138400,68844
8120,4640,3480,782,196600,68845
114,93,21,617,69100,68846
7031,4362,2669,778,153700,68847
0,0,0,-,-,68849
4324,2658,1666,760,95400,68850
233,175,58,655,65000,68852
701,517,184,522,86800,68853
383,305,78,1298,146100,68854
174,126,48,594,78200,68855
297,172,125,772,98100,68856
132,106,26,585,65000,68858
261,198,63,288,78600,68859
164,135,29,470,60400,68860
41,36,5,-,77800,68861
1298,997,301,591,109000,68862
477,358,119,629,87500,68863
426,340,86,590,123700,68864
367,319,48,-,156800,68865
376,306,70,594,176600,68866
871,645,226,605,110400,68869
233,205,28,750,222400,68870
111,88,23,-,155600,68871
336,298,38,809,125000,68872
1466,1086,380,563,140500,68873
410,294,116,650,66500,68874
292,254,38,469,101600,68875
648,448,200,632,100000,68876
163,108,55,700,118800,68878
178,143,35,513,75600,68879
10,0,10,-,-,68881
184,136,48,675,44200,68882
953,711,242,627,130000,68883
10625,6911,3714,675,113600,68901
766,599,167,634,110500,68920
583,419,164,648,84500,68922
45,43,2,-,85000,68923
461,397,64,650,139300,68924
215,171,44,919,202100,68925
300,207,93,481,52600,68926
566,408,158,800,119700,68927
125,114,11,-,76700,68928
88,88,0,-,40000,68929
602,467,135,535,120000,68930
192,175,17,580,50300,68932
404,303,101,525,84000,68933
56,31,25,-,-,68934
262,186,76,538,70800,68935
100,71,29,631,33600,68936
730,570,160,682,153900,68937
243,211,32,582,75300,68938
514,399,115,468,64600,68939
252,195,57,708,185800,68940
321,298,23,833,105100,68941
152,115,37,675,37500,68942
110,87,23,-,-,68943
495,328,167,592,85200,68944
116,109,7,-,143300,68945
10,8,2,-,38300,68946
278,222,56,521,86000,68947
130,95,35,620,40300,68948
2792,1949,843,585,127800,68949
153,111,42,660,84500,68950
50,30,20,443,-,68952
14,7,7,-,-,68954
791,693,98,590,179300,68955
531,445,86,650,114500,68956
253,233,20,533,78100,68957
266,223,43,558,120400,68958
1619,1179,440,699,144000,68959
64,54,10,-,33900,68960
364,302,62,540,70300,68961
34,29,5,-,28600,68964
335,271,64,421,63200,68966
389,272,117,575,72600,68967
20,19,1,-,-,68969
658,489,169,343,57900,68970
164,123,41,638,106500,68971
67,65,2,-,84200,68972
170,158,12,675,102900,68973
83,76,7,-,-,68974
66,66,0,-,-,68975
144,102,42,675,113800,68976
97,92,5,-,50900,68977
990,691,299,478,70100,68978
796,640,156,682,110900,68979
151,123,28,707,116400,68980
165,142,23,-,73800,68981
253,179,74,667,89600,68982
3781,2735,1046,613,103300,69001
170,143,27,658,75600,69020
611,426,185,457,79800,69021
822,622,200,649,96200,69022
131,111,20,-,169800,69023
469,347,122,760,80300,69024
453,288,165,608,95200,69025
79,62,17,-,-,69026
23,15,8,-,-,69027
351,281,70,660,117300,69028
164,148,16,371,69100,69029
128,80,48,666,50000,69030
219,158,61,433,68600,69032
1120,882,238,650,149500,69033
400,328,72,672,77400,69034
35,28,7,-,33600,69036
56,56,0,-,28200,69037
238,180,58,600,77200,69038
37,20,17,-,86700,69039
281,217,64,653,47400,69040
28,24,4,-,-,69041
8,8,0,-,-,69042
222,176,46,715,46200,69043
368,224,144,425,57500,69044
525,368,157,573,72900,69045
79,71,8,-,-,69046
12414,7742,4672,693,136000,69101
501,395,106,608,103700,69120
169,117,52,575,106300,69121
301,215,86,643,79800,69122
372,293,79,668,138400,69123
152,75,77,633,52500,69125
408,338,70,675,148300,69127
71,62,9,825,78300,69128
523,409,114,541,76500,69129
2129,1486,643,681,95300,69130
248,205,43,1029,85500,69131
61,43,18,-,-,69132
201,162,39,775,74000,69133
158,125,33,588,151400,69134
55,30,25,-,-,69135
1585,1191,394,697,111300,69138
776,574,202,707,117200,69140
166,125,41,767,83900,69141
43,33,10,-,75000,69142
562,477,85,834,147600,69143
77,64,13,-,-,69144
1345,912,433,719,80700,69145
158,110,48,-,147600,69146
240,192,48,722,103900,69147
71,46,25,392,68000,69148
322,277,45,438,72800,69149
149,128,21,921,-,69150
340,277,63,642,152200,69151
374,244,130,530,92200,69152
2669,1777,892,593,113600,69153
547,467,80,581,82200,69154
482,368,114,542,88400,69155
308,254,54,775,88600,69156
30,30,0,-,82700,69157
51,34,17,430,-,69161
3424,2214,1210,726,115300,69162
386,289,97,573,123200,69163
766,590,176,740,116400,69165
290,187,103,600,150800,69166
165,110,55,706,113600,69167
108,90,18,-,53300,69168
246,200,46,675,104200,69169
128,101,27,663,133900,69170
3,3,0,-,-,69171
1763,1018,745,720,137700,69201
1122,841,281,513,81700,69210
158,106,52,619,62200,69211
93,56,37,421,-,69212
121,61,60,758,107100,69214
60,49,11,-,70600,69216
194,165,29,600,47900,69217
107,81,26,-,35600,69218
66,20,46,438,205600,69219
11,6,5,-,-,69220
75,54,21,-,119400,69221
4272,2775,1497,613,124300,69301
25,18,7,-,262500,69331
120,95,25,-,58100,69333
816,656,160,706,88500,69334
22,12,10,-,-,69335
1059,722,337,709,101300,69336
2780,1656,1124,584,135900,69337
691,546,145,533,75800,69339
41,34,7,-,231300,69340
4098,3175,923,830,131700,69341
1031,671,360,582,64500,69343
173,130,43,430,140000,69345
281,207,74,582,91700,69346
585,505,80,680,81900,69347
630,480,150,615,98200,69348
203,151,52,383,60800,69350
107,50,57,-,112800,69351
282,204,78,1233,104400,69352
9,7,2,-,67500,69353
66,48,18,-,-,69354
63,58,5,825,90000,69355
726,516,210,709,87800,69356
1571,1169,402,735,115100,69357
763,526,237,686,131800,69358
559,363,196,637,75000,69360
7228,4546,2682,733,121200,69361
9,9,0,-,-,69365
85,58,27,-,105400,69366
109,96,13,569,127500,69367
17312,9038,8274,923,223400,70001
8733,4372,4361,943,282000,70002
15942,12092,3850,899,188000,70003
11352,7152,4200,961,283600,70005
5951,3827,2124,986,256900,70006
1315,1260,55,-,176300,70030
496,461,35,1571,139200,70031
1778,1229,549,856,144400,70032
429,393,36,-,136700,70036
5884,3565,2319,1266,260000,70037
102,85,17,-,85000,70038
964,662,302,974,122500,70039
483,422,61,564,88200,70040
1133,936,197,995,54400,70041
7587,4221,3366,937,144800,70043
4610,3915,695,1048,229100,70047
718,502,216,652,93300,70049
62,51,11,-,-,70050
666,593,73,-,118900,70051
1363,1046,317,929,151100,70052
6641,3069,3572,888,159500,70053
14122,8024,6098,1025,167300,70056
1594,1135,459,680,184900,70057
13666,8654,5012,994,142700,70058
6152,3037,3115,896,143300,70062
19359,11920,7439,991,188900,70065
946,845,101,1086,162000,70067
11812,9021,2791,975,161200,70068
4620,3913,707,1155,202900,70070
1440,1009,431,844,142300,70071
19750,14597,5153,961,146300,70072
1711,1384,327,875,168500,70075
95,59,36,-,154500,70076
1186,923,263,926,160200,70079
510,452,58,-,149500,70080
124,92,32,-,-,70082
943,724,219,833,74900,70083
2497,1940,557,470,118100,70084
1650,1477,173,741,99600,70085
835,589,246,768,86700,70086
2908,1897,1011,696,153600,70087
2668,2092,576,492,132500,70090
86,65,21,-,103200,70091
2303,1887,416,878,130800,70092
11078,6645,4433,944,105600,70094
1477,203,1274,1340,362800,70112
3590,713,2877,723,197500,70113
9655,4305,5350,860,157500,70114
14808,7502,7306,1175,442800,70115
5987,2291,3696,954,301500,70116
11777,5462,6315,933,172600,70117
12669,6074,6595,994,344100,70118
16090,5321,10769,988,255200,70119
5412,2928,2484,885,179800,70121
14371,8111,6260,976,190600,70122
11715,7048,4667,1086,243200,70123
8181,5743,2438,1411,411300,70124
6142,2616,3526,1006,325100,70125
9987,4705,5282,905,158600,70126
9654,4169,5485,844,156200,70127
7007,4543,2464,930,171100,70128
3068,1995,1073,846,152000,70129
7596,2475,5121,1139,379900,70130
11977,6809,5168,915,172700,70131
0,0,0,-,-,70139
0,0,0,-,-,70163
17059,11981,5078,803,168200,70301
2570,2027,543,740,114500,70339
19,19,0,-,-,70340
1517,1093,424,850,131200,70341
1705,1107,598,744,138300,70342
1932,1749,183,917,171500,70343
2002,1624,378,584,87200,70344
3533,2855,678,1000,133300,70345
3987,2543,1444,630,120300,70346
61,61,0,-,185200,70352
600,539,61,-,63500,70353
1806,1582,224,963,113400,70354
409,386,23,-,-,70355
812,610,202,645,87700,70356
1069,689,380,754,84700,70357
335,212,123,575,178100,70358
3005,2283,722,796,155500,70359
10844,7358,3486,995,221000,70360
8063,5287,2776,726,117700,70363
11044,7762,3282,895,158800,70364
1155,889,266,759,112500,70372
2497,1953,544,682,124400,70373
2586,1866,720,769,120500,70374
43,43,0,-,210300,70375
1495,1256,239,698,79200,70377
8590,5016,3574,776,115500,70380
2521,1893,628,717,98100,70390
71,71,0,-,-,70391
3178,2081,1097,795,120600,70392
376,314,62,-,125000,70393
5533,4430,1103,786,139900,70394
1841,1463,378,871,124400,70395
327,240,87,725,152300,70397
7282,3756,3526,821,175500,70401
0,0,0,-,-,70402
11070,6596,4474,823,156900,70403
3114,2524,590,956,210200,70420
5093,4030,1063,691,113800,70422
1797,1341,456,621,86500,70426
7468,4873,2595,617,85000,70427
1999,1818,181,748,230600,70431
14276,10321,3955,1117,244000,70433
6453,5983,470,1025,210600,70435
273,212,61,-,-,70436
3169,2737,432,1031,233600,70437
7168,5054,2114,616,100700,70438
1550,1168,382,703,101000,70441
93,93,0,-,212500,70442
3709,2762,947,770,99500,70443
4011,2993,1018,814,104100,70444
3953,3492,461,967,163000,70445
2651,2012,639,732,177400,70446
4772,4414,358,1197,276400,70447
9178,7391,1787,1203,257100,70448
1497,1340,157,841,138200,70449
1087,898,189,749,72400,70450
0,0,0,-,-,70451
4684,3742,942,763,148600,70452
283,261,22,-,107700,70453
11295,8964,2331,824,163400,70454
316,275,41,-,-,70455
890,635,255,678,89800,70456
14215,10293,3922,1078,171700,70458
8011,5956,2055,976,147700,70460
10098,7494,2604,887,198600,70461
2115,1854,261,872,152800,70462
54,42,12,700,152200,70463
196,129,67,-,112500,70464
191,118,73,816,41300,70465
3215,2237,978,794,93700,70466
7879,5942,1937,1050,293900,70471
11285,5264,6021,759,111700,70501
11546,8002,3544,1005,233100,70503
17283,8910,8373,836,168200,70506
6198,4291,1907,818,151500,70507
16357,11009,5348,977,245100,70508
9292,6874,2418,679,111300,70510
3474,2890,584,656,90800,70512
147,43,104,317,-,70513
869,536,333,772,74700,70514
1155,829,326,462,85100,70515
219,219,0,-,120800,70516
9787,7493,2294,758,130600,70517
5152,4014,1138,945,195000,70518
113,113,0,-,57400,70519
6925,5310,1615,693,155000,70520
330,264,66,838,110400,70523
79,57,22,463,79400,70524
5230,3829,1401,585,90400,70525
6763,4219,2544,680,108600,70526
891,661,230,706,92100,70528
4411,3096,1315,695,126200,70529
535,430,105,-,114500,70531
909,653,256,607,82800,70532
2640,2140,500,646,109700,70533
286,200,86,663,70000,70534
6517,4310,2207,622,111200,70535
200,162,38,-,-,70537
5144,3129,2015,758,85100,70538
144,104,40,705,106600,70541
1440,1268,172,665,100500,70542
1691,1269,422,544,154700,70543
3984,2536,1448,678,87600,70544
6213,4290,1923,603,114600,70546
3827,2906,921,702,97800,70548
1283,831,452,588,104600,70549
55,55,0,-,-,70550
638,446,192,882,103100,70552
2042,1213,829,494,103900,70554
2923,2395,528,864,171700,70555
135,75,60,246,73200,70556
0,0,0,-,-,70558
990,741,249,698,81600,70559
14483,8694,5789,747,83700,70560
7006,5611,1395,899,158900,70563
14124,9537,4587,626,105600,70570
45,45,0,-,-,70575
250,159,91,679,84100,70576
1619,1304,315,676,90200,70577
6000,4322,1678,639,121700,70578
103,59,44,-,-,70580
257,234,23,-,85600,70581
7087,5490,1597,606,115100,70582
4389,3140,1249,794,113600,70583
2909,2258,651,617,130100,70584
101,82,19,538,82000,70585
7571,4887,2684,607,89700,70586
1219,937,282,538,116100,70589
1974,1495,479,684,135500,70591
8277,7016,1261,1171,197500,70592
14033,6732,7301,716,118700,70601
14375,10287,4088,1022,210300,70605
11145,6209,4936,807,116500,70607
7492,6219,1273,830,191900,70611
4847,3090,1757,809,104100,70615
770,647,123,689,159400,70630
203,198,5,-,94300,70631
187,187,0,-,109300,70632
2589,2018,571,602,101500,70633
9304,6882,2422,732,133100,70634
218,145,73,-,52600,70637
294,229,65,1079,91700,70638
138,138,0,-,80800,70639
134,99,35,557,59800,70640
88,74,14,-,-,70643
70,70,0,-,111200,70644
556,491,65,802,119600,70645
271,187,84,-,90900,70646
3490,2600,890,777,158100,70647
2600,2001,599,703,117400,70648
88,88,0,-,106300,70650
68,50,18,-,-,70651
846,675,171,736,69100,70652
1302,1036,266,396,84000,70653
72,72,0,-,-,70654
1052,780,272,594,85800,70655
1404,1156,248,946,71100,70656
1762,1652,110,844,117600,70657
305,258,47,750,85400,70658
523,266,257,890,131000,70659
597,535,62,-,66700,70660
824,694,130,377,73800,70661
115,106,9,-,-,70662
10469,7713,2756,807,136200,70663
3942,3329,613,980,164700,70665
2509,1917,592,636,99900,70668
3728,2826,902,1019,126100,70669
7622,6506,1116,961,167300,70706
1684,1292,392,1049,190600,70710
1500,1226,274,720,154700,70711
164,27,137,850,"10,000-",70712
6883,5056,1827,972,140100,70714
526,425,101,458,79000,70715
1618,1201,417,848,212000,70719
276,82,194,908,56000,70721
2134,1662,472,582,155200,70722
438,367,71,687,138100,70723
598,576,22,-,179000,70725
20332,15518,4814,922,162300,70726
359,238,121,-,168800,70729
1428,1257,171,823,104200,70730
503,398,105,771,88300,70732
531,426,105,932,114800,70733
2562,2072,490,1029,241800,70734
196,175,21,-,110400,70736
15756,11726,4030,1009,176400,70737
4844,4374,470,851,217300,70739
651,454,197,771,130100,70740
77,71,6,-,220800,70743
2321,1898,423,858,121100,70744
68,40,28,-,42500,70747
1559,1251,308,658,86900,70748
590,439,151,1081,173100,70749
616,421,195,588,74500,70750
362,239,123,-,152000,70752
355,231,124,988,77700,70753
4355,3525,830,984,154000,70754
766,696,70,589,132500,70755
130,100,30,-,-,70756
1236,983,253,455,88600,70757
715,583,132,808,125600,70759
2488,1579,909,807,139400,70760
285,240,45,442,122200,70761
425,315,110,-,184200,70762
1447,1213,234,590,233100,70763
5843,4373,1470,809,137500,70764
5997,4214,1783,842,173800,70767
14849,13175,1674,1124,223200,70769
1252,1156,96,772,167100,70770
325,284,41,613,157300,70772
91,47,44,-,146800,70773
3659,3002,657,935,161200,70774
3618,2670,948,823,210400,70775
1206,994,212,677,217700,70776
1562,1254,308,848,132400,70777
1322,1133,189,884,194400,70778
473,436,37,-,154500,70780
86,73,13,-,-,70782
1146,1041,105,750,171200,70783
7598,6456,1142,822,161300,70785
40,24,16,-,-,70787
1434,940,494,560,153800,70788
258,209,49,-,94200,70789
8874,6538,2336,897,215300,70791
76,7,69,1411,-,70801
9645,3444,6201,748,72300,70802
0,0,0,-,-,70803
9393,4124,5269,739,77800,70805
12370,5498,6872,788,225200,70806
5552,2649,2903,682,82300,70807
13536,8009,5527,1002,307100,70808
11069,6113,4956,1157,268200,70809
15752,10785,4967,1144,283700,70810
4721,2982,1739,909,107700,70811
3633,2154,1479,908,111000,70812
4999,3503,1496,855,146500,70814
10575,6735,3840,868,165300,70815
17504,8574,8930,965,185100,70816
12501,10068,2433,1144,234600,70817
3641,2825,816,874,188900,70818
1550,1219,331,1096,137100,70819
7223,1678,5545,885,224800,70820
0,0,0,-,-,70836
1816,1108,708,465,79200,71001
481,396,85,770,82100,71003
259,207,52,1000,139900,71004
4696,4047,649,896,212200,71006
311,283,28,-,85900,71007
365,315,50,413,60700,71008
853,628,225,603,70000,71016
619,388,231,328,66300,71018
3010,2157,853,514,83200,71019
389,205,184,509,47000,71021
1380,1106,274,783,100200,71023
713,550,163,354,104300,71024
526,375,151,838,78000,71027
573,411,162,459,91100,71028
71,65,6,-,104200,71029
691,543,148,-,175700,71030
398,239,159,727,81000,71031
975,790,185,635,145800,71032
1413,1181,232,690,152900,71033
142,126,16,750,86500,71034
7307,5866,1441,794,162300,71037
1776,1063,713,622,72500,71038
555,507,48,780,77800,71039
3120,1937,1183,651,76200,71040
172,134,38,700,78600,71043
288,245,43,845,75800,71044
262,237,25,-,104600,71045
560,529,31,-,168600,71046
4243,3650,593,747,160300,71047
22,22,0,-,-,71048
1279,926,353,633,78100,71049
757,639,118,-,127800,71051
3591,2187,1404,515,82600,71052
7775,4892,2883,711,90800,71055
918,688,230,736,127300,71060
685,415,270,488,148000,71061
340,264,76,-,-,71063
1364,1112,252,601,60000,71064
504,347,157,283,81600,71065
1253,795,458,771,86500,71067
1583,1257,326,403,66200,71068
253,219,34,1025,47000,71069
750,661,89,828,65500,71070
990,792,198,830,87300,71071
577,508,69,690,74800,71072
1057,651,406,528,97100,71073
2693,1787,906,602,62100,71075
2568,2152,416,739,163100,71078
74,74,0,-,-,71079
1982,1228,754,592,81600,71082
2786,752,2034,634,68500,71101
2482,938,1544,715,62300,71103
6248,2653,3595,827,129500,71104
9790,5388,4402,997,182300,71105
13064,8761,4303,765,232300,71106
12066,7470,4596,768,120200,71107
6814,3492,3322,782,70600,71108
7781,3306,4475,688,72300,71109
977,20,957,1386,-,71110
17261,9742,7519,880,198500,71111
13812,8170,5642,962,153300,71112
6991,3975,3016,988,219100,71115
9681,5974,3707,882,145600,71118
4417,3385,1032,892,154800,71119
5056,2823,2233,819,149700,71129
8767,4747,4020,726,209100,71201
8703,4020,4683,650,64700,71202
13808,7801,6007,793,143000,71203
0,0,0,-,-,71209
540,480,60,-,89700,71219
8220,5313,2907,604,88800,71220
1195,870,325,385,76100,71222
134,107,27,-,41700,71223
2393,2032,361,786,180000,71225
757,470,287,485,126700,71226
1480,1224,256,831,109600,71227
472,326,146,671,123000,71229
2619,1733,886,567,75900,71232
93,44,49,646,-,71233
1307,1172,135,-,142700,71234
1866,1409,457,669,99300,71235
544,382,162,513,80200,71237
1126,1053,73,758,117200,71238
3282,2695,587,631,112500,71241
84,59,25,-,237500,71243
1674,533,1141,622,101200,71245
454,260,194,480,63600,71247
88,41,47,-,41000,71250
3136,2038,1098,527,84600,71251
90,59,31,442,65800,71253
1850,801,1049,466,67300,71254
341,250,91,415,71000,71256
620,518,102,663,68900,71259
1169,908,261,456,83400,71260
508,397,111,366,84000,71261
2956,2202,754,539,89400,71263
416,384,32,612,145700,71264
562,471,91,477,103100,71266
1023,942,81,520,107300,71268
4302,2603,1699,677,100100,71269
12167,5693,6474,710,167800,71270
0,0,0,-,-,71272
813,575,238,581,94500,71275
51,33,18,-,88300,71276
607,571,36,331,39900,71277
36,0,36,-,-,71279
1505,1039,466,940,169700,71280
3578,2033,1545,603,66600,71282
181,156,25,-,75800,71286
12917,7916,5001,809,153400,71291
7684,5138,2546,728,105700,71292
4998,3410,1588,573,87800,71295
8303,3959,4344,793,120100,71301
5292,3069,2223,717,97500,71302
8740,4567,4173,953,192900,71303
27,27,0,-,-,71316
2221,1464,757,835,89700,71322
338,276,62,729,88600,71323
416,235,181,333,62700,71325
411,294,117,500,54800,71326
1464,1028,436,649,122700,71327
2433,1927,506,862,160800,71328
401,340,61,-,85900,71331
236,150,86,-,104700,71333
3432,1964,1468,570,75900,71334
720,488,232,574,93200,71336
68,68,0,-,-,71339
312,228,84,510,104300,71340
1313,1017,296,733,113200,71341
2718,1966,752,600,96000,71342
2883,2321,562,570,78100,71343
41,0,41,-,-,71345
995,636,359,628,137300,71346
1726,968,758,602,128900,71350
4224,3112,1112,689,88800,71351
694,500,194,605,91400,71353
729,579,150,619,153100,71354
1219,895,324,633,94400,71355
274,228,46,-,93000,71356
685,429,256,493,78800,71357
371,275,96,429,68600,71358
12654,8015,4639,773,160200,71360
734,601,133,569,86200,71362
668,462,206,447,58600,71366
424,368,56,-,76800,71367
558,343,215,509,125100,71368
1026,585,441,446,73000,71369
732,554,178,-,79100,71371
2477,1769,708,548,90200,71373
472,316,156,466,67100,71375
62,35,27,-,-,71377
916,600,316,521,73600,71378
78,78,0,-,105100,71401
1593,1259,334,769,116400,71403
325,245,80,567,94400,71404
2079,1417,662,834,131000,71405
35,35,0,-,57900,71406
330,262,68,-,104300,71407
2090,1572,518,762,122800,71409
38,23,15,-,-,71410
1313,610,703,609,98000,71411
67,11,56,593,31900,71414
386,188,198,686,82700,71416
2020,1209,811,642,87700,71417
2443,1746,697,574,68900,71418
784,596,188,630,76000,71419
650,536,114,603,65000,71422
1536,1098,438,898,136400,71423
314,232,82,-,130700,71424
44,36,8,-,81800,71425
84,50,34,740,76200,71426
198,160,38,-,68900,71427
1252,980,272,647,129900,71429
995,680,315,648,79400,71430
447,312,135,550,73600,71432
1536,1175,361,598,87600,71433
1251,1077,174,729,78500,71435
717,603,114,-,111300,71438
723,508,215,611,109600,71439
260,150,110,628,105900,71441
8224,5072,3152,840,128200,71446
528,328,200,721,82200,71447
3564,2162,1402,547,113000,71449
451,307,144,726,101400,71450
53,34,19,-,48900,71452
782,399,383,669,79500,71454
40,40,0,-,30400,71455
553,284,269,728,171100,71456
10017,4049,5968,691,149300,71457
3504,51,3453,1107,86700,71459
900,415,485,741,104400,71461
664,497,167,577,41900,71462
3217,2165,1052,514,76300,71463
1081,873,208,617,70700,71465
206,163,43,933,133900,71466
1645,1218,427,715,109500,71467
354,137,217,679,82500,71468
960,603,357,768,76500,71469
164,164,0,-,-,71472
203,176,27,-,48800,71473
208,152,56,850,122700,71474
317,248,69,577,84600,71479
235,192,43,-,66900,71480
3689,2424,1265,612,86800,71483
835,670,165,794,225800,71485
2022,1374,648,601,77800,71486
5502,2796,2706,645,58600,71601
6234,4037,2197,764,105500,71602
12728,8257,4471,729,88800,71603
222,168,54,598,45000,71630
174,144,30,-,66300,71631
4756,3281,1475,613,77500,71635
1378,896,482,587,62000,71638
2385,1411,974,537,59200,71639
1295,736,559,589,51700,71640
264,213,51,763,39400,71642
506,350,156,470,65400,71643
363,262,101,391,59500,71644
2250,1829,421,605,68600,71646
895,579,316,498,76900,71647
88,88,0,-,213900,71651
469,271,198,608,73100,71652
1836,1291,545,610,74900,71653
1771,1041,730,417,78400,71654
5680,3711,1969,640,103900,71655
250,183,67,554,61400,71658
30,25,5,-,92200,71659
332,308,24,-,66200,71660
151,114,37,-,33000,71661
98,0,98,-,-,71662
225,179,46,-,80300,71663
2266,1713,553,644,88800,71665
22,8,14,-,-,71666
2796,2115,681,613,77300,71667
596,414,182,363,51500,71670
3484,2131,1353,638,79600,71671
293,224,69,829,57300,71674
778,651,127,830,85100,71675
221,144,77,518,54300,71676
68,44,24,661,63800,71677
7459,4859,2600,528,80300,71701
18,0,18,-,-,71711
1100,763,337,393,53700,71720
27,22,5,-,52000,71722
213,196,17,-,72300,71724
226,187,39,450,41700,71725
685,576,109,313,57100,71726
12140,8602,3538,670,93700,71730
581,505,76,-,66000,71740
2050,1197,853,664,69400,71742
1677,1211,466,665,75800,71743
1172,982,190,652,72500,71744
142,110,32,464,66700,71745
385,325,60,525,40600,71747
991,891,100,593,80400,71749
433,386,47,627,82100,71751
399,218,181,497,55800,71752
6163,4054,2109,674,93500,71753
200,200,0,-,88700,71758
238,189,49,648,57600,71759
941,752,189,793,57900,71762
700,644,56,406,70500,71763
763,621,142,475,57700,71764
866,777,89,-,41200,71765
280,211,69,608,59800,71766
1416,1093,323,630,79300,71770
1,1,0,-,-,71772
5948,3870,2078,676,83500,71801
18,18,0,-,-,71820
3757,2634,1123,574,76300,71822
19,14,5,-,55000,71823
256,230,26,598,70500,71825
426,332,94,318,46900,71826
310,276,34,588,50900,71827
3514,2699,815,573,84700,71832
883,713,170,394,73900,71833
537,399,138,760,-,71834
521,417,104,584,64700,71835
1224,933,291,522,60200,71836
2007,1673,334,602,102800,71837
400,300,100,-,48900,71838
131,103,28,407,"10,000-",71839
419,342,77,628,75000,71841
854,585,269,511,72200,71842
885,594,291,260,63100,71845
1073,767,306,509,75300,71846
237,193,44,-,75000,71847
836,577,259,613,86900,71851
3672,2495,1177,562,103400,71852
110,92,18,580,30500,71853
14073,8496,5577,717,110900,71854
247,164,83,610,71600,71855
1886,1117,769,655,67400,71857
882,732,150,663,62100,71858
237,188,49,-,97300,71859
953,709,244,565,55000,71860
777,647,130,579,85600,71861
190,123,67,643,-,71862
70,53,17,722,52500,71865
261,204,57,590,121100,71866
11402,6767,4635,662,128600,71901
7510,6578,932,1105,188700,71909
19836,12974,6862,791,134200,71913
1310,1065,245,584,73200,71921
37,26,11,581,52500,71922
5978,3473,2505,606,122900,71923
1595,1473,122,597,106000,71929
411,301,110,479,146200,71933
199,194,5,-,77700,71935
829,639,190,532,66000,71937
730,539,191,567,66800,71940
858,734,124,526,77900,71941
1749,1273,476,449,80800,71943
317,247,70,433,69100,71944
559,449,110,632,100800,71945
830,633,197,-,89200,71949
358,346,12,-,91500,71950
40,40,0,-,112500,71952
5781,4399,1382,613,103400,71953
663,499,164,569,62100,71956
1329,1065,264,533,119900,71957
1005,673,332,529,80800,71958
187,170,17,-,86000,71959
680,561,119,433,84300,71960
384,316,68,907,80700,71961
279,219,60,349,54700,71962
1325,1029,296,825,164800,71964
126,98,28,-,133300,71965
1496,1431,65,-,132400,71968
123,104,19,-,141700,71969
380,371,9,-,120400,71970
217,162,55,-,181300,71971
152,100,52,810,84600,71972
588,401,187,503,59000,71973
0,0,0,-,-,71998
0,0,0,-,-,71999
278,245,33,681,66800,72001
5992,5061,931,840,146500,72002
314,283,31,900,58900,72003
409,312,97,509,58000,72004
57,37,20,-,45000,72005
1185,669,516,448,65000,72006
2693,2030,663,914,137000,72007
2630,1653,977,620,84900,72010
1473,1335,138,924,130800,72011
4729,3187,1542,770,141300,72012
797,624,173,691,85400,72013
20,15,5,-,32100,72014
10496,7269,3227,781,124100,72015
1013,933,80,713,111300,72016
303,234,69,379,49200,72017
9466,7891,1575,857,175200,72019
1675,1392,283,608,61300,72020
1716,923,793,529,72400,72021
6880,4576,2304,883,155600,72022
14118,9554,4564,841,153600,72023
1374,992,382,774,91300,72024
295,270,25,600,85700,72025
133,81,52,-,-,72026
556,496,60,375,96700,72027
837,470,367,398,53100,72029
320,283,37,-,56400,72030
2816,2141,675,514,115100,72031
12285,7431,4854,794,137900,72032
18703,9941,8762,792,172100,72034
0,0,0,-,-,72035
383,265,118,550,35100,72036
17,9,8,-,-,72037
29,21,8,-,-,72038
804,597,207,713,144500,72039
1279,897,382,512,71500,72040
609,416,193,680,37500,72041
2097,1416,681,583,65300,72042
283,265,18,-,165800,72044
491,332,159,741,171200,72045
1648,1001,647,613,105500,72046
326,286,40,1643,162500,72047
39,39,0,-,67700,72048
269,201,68,778,79100,72051
377,253,124,616,78400,72055
341,275,66,838,122400,72057
6150,4570,1580,814,164400,72058
12,12,0,-,-,72059
297,173,124,622,69900,72060
46,33,13,-,146900,72061
795,615,180,527,117300,72063
1086,786,300,663,80400,72064
1831,1459,372,690,125100,72065
1257,886,371,688,127200,72067
142,83,59,778,100600,72068
536,398,138,513,72400,72069
718,566,152,582,93100,72070
186,167,19,-,69300,72072
466,325,141,325,75200,72073
65,59,6,-,73700,72074
14233,8241,5992,792,114900,72076
268,268,0,-,62800,72079
182,160,22,-,69700,72080
2805,2051,754,671,102300,72081
779,446,333,545,58500,72082
82,47,35,822,77500,72083
451,342,109,565,54500,72084
88,47,41,715,65000,72085
3842,2786,1056,750,121100,72086
712,603,109,-,211000,72087
1300,1109,191,935,112400,72088
0,0,0,-,-,72099
1141,857,284,608,77100,72101
1128,815,313,688,85000,72102
4656,3497,1159,845,107800,72103
8574,6030,2544,674,91500,72104
1993,1439,554,814,124300,72106
63,56,7,-,91400,72107
46,46,0,-,-,72108
4655,2696,1959,632,101800,72110
509,457,52,813,140600,72111
3455,2201,1254,581,70500,72112
10507,6094,4413,890,216900,72113
4943,1157,3786,670,68200,72114
9383,5865,3518,895,175600,72116
5035,2851,2184,811,85100,72117
8522,4826,3696,791,99700,72118
0,0,0,-,-,72119
12922,9238,3684,877,155400,72120
1413,1133,280,717,90400,72121
193,193,0,-,210600,72122
174,105,69,425,39500,72123
299,215,84,658,74500,72125
1279,916,363,652,99100,72126
954,732,222,745,100000,72127
299,249,50,938,104900,72128
459,402,57,631,85800,72129
292,234,58,474,134500,72130
1895,1591,304,757,120900,72131
1353,965,388,927,106900,72132
137,113,24,-,52500,72134
984,827,157,893,259900,72135
520,502,18,-,127800,72136
948,731,217,759,73400,72137
100,46,54,263,61400,72139
186,174,12,-,78100,72140
292,197,95,-,90800,72141
984,865,119,643,184200,72142
12844,7891,4953,710,151800,72143
0,0,0,-,-,72149
4715,3662,1053,732,138100,72150
196,148,48,-,-,72152
962,737,225,624,91400,72153
205,127,78,-,99800,72156
502,402,100,-,123500,72157
4278,2477,1801,665,97800,72160
44,28,16,-,-,72165
69,45,24,-,22500,72166
611,530,81,902,83900,72167
156,116,40,-,-,72168
55,32,23,-,42900,72169
111,76,35,533,62500,72170
3114,2655,459,808,144300,72173
138,97,41,486,60800,72175
3434,2166,1268,841,120500,72176
139,118,21,-,90400,72179
8,0,8,-,-,72181
706,301,405,961,321400,72201
4740,1451,3289,807,119900,72202
11499,6868,4631,815,91700,72204
10696,5298,5398,853,161700,72205
9077,5703,3374,708,93900,72206
5164,3381,1783,779,304400,72207
11199,5485,5714,760,81200,72209
6808,4218,2590,844,178600,72210
9651,5141,4510,904,185500,72211
4914,4287,627,970,276600,72212
9303,6071,3232,1052,346200,72223
4934,3467,1467,857,187200,72227
9588,4693,4895,714,84900,72301
50,41,9,-,53100,72311
8769,5072,3697,653,87500,72315
30,30,0,-,-,72320
63,42,21,-,77500,72321
68,50,18,-,42500,72322
914,688,226,537,73700,72324
19,12,7,-,-,72325
849,533,316,786,64200,72326
723,494,229,580,107500,72327
34,16,18,-,-,72328
60,12,48,-,-,72329
172,134,38,745,54700,72330
1210,752,458,665,71100,72331
20,8,12,-,-,72332
290,117,173,324,37100,72333
6056,3303,2753,630,66300,72335
6,6,0,-,-,72338
49,35,14,-,-,72339
62,52,10,-,57300,72340
93,75,18,720,65000,72341
1753,688,1065,568,105300,72342
277,210,67,994,61800,72346
265,167,98,458,41400,72347
1080,571,509,467,67800,72348
454,280,174,510,47300,72350
226,118,108,680,81300,72351
13,13,0,-,-,72353
929,551,378,551,61500,72354
958,680,278,725,81300,72355
500,269,231,565,31500,72358
213,106,107,474,22900,72359
2399,1294,1105,495,75500,72360
5641,3850,1791,799,152500,72364
1108,656,452,593,62800,72365
964,483,481,610,44600,72366
24,0,24,-,-,72367
536,359,177,475,63400,72368
3151,1450,1701,632,75000,72370
846,599,247,663,66400,72372
463,249,214,423,54700,72373
307,264,43,-,64600,72374
738,588,150,721,82700,72376
9,9,0,-,-,72377
0,0,0,-,-,72379
65,65,0,-,-,72383
357,151,206,571,59800,72384
780,551,229,567,59600,72386
88,64,24,-,43100,72389
3165,1283,1882,575,70700,72390
226,176,50,406,57600,72392
206,127,79,523,32100,72394
437,272,165,531,89200,72395
5000,3371,1629,724,90000,72396
22291,11341,10950,738,137400,72401
10274,6563,3711,826,175800,72404
171,117,54,575,51000,72410
949,611,338,690,84900,72411
256,178,78,-,152900,72412
202,145,57,613,45400,72413
143,87,56,429,75400,72414
509,386,123,548,76000,72415
2161,1632,529,674,116900,72416
2085,1317,768,728,115100,72417
668,433,235,538,51500,72419
220,106,114,619,-,72421
1930,1196,734,551,71300,72422
38,31,7,-,31100,72424
171,149,22,-,69100,72425
88,55,33,425,87700,72426
80,70,10,875,-,72427
25,19,6,750,-,72428
163,94,69,505,60500,72429
150,120,30,546,60000,72430
167,109,58,531,47700,72431
2513,1694,819,542,83000,72432
1278,840,438,482,67400,72433
857,680,177,473,81300,72434
171,136,35,500,51100,72435
358,320,38,774,72200,72436
1355,961,394,821,82000,72437
1043,648,395,490,57900,72438
109,65,44,519,87900,72440
39,29,10,-,-,72441
1758,1035,723,519,106000,72442
1216,882,334,709,69300,72443
728,589,139,557,84000,72444
37,31,6,-,58800,72445
864,566,298,480,80200,72447
109,71,38,533,31500,72449
14544,9599,4945,704,118800,72450
80,69,11,-,54100,72453
2170,1566,604,714,85200,72454
5257,3666,1591,633,87900,72455
226,161,65,684,48500,72456
78,57,21,475,71900,72457
280,266,14,-,100400,72458
573,444,129,483,88100,72459
316,241,75,485,62300,72460
1564,1140,424,493,76100,72461
182,102,80,366,51200,72462
16,16,0,-,-,72464
597,390,207,603,66500,72466
0,0,0,-,-,72467
418,348,70,533,83500,72469
101,74,27,-,55000,72470
509,383,126,542,57300,72471
3609,2276,1333,635,84500,72472
1027,753,274,590,71400,72473
2424,1384,1040,588,77300,72476
177,161,16,-,80500,72478
550,349,201,646,66300,72479
489,407,82,489,79500,72482
10001,7031,2970,630,115400,72501
1050,795,255,689,67500,72512
1079,832,247,441,98100,72513
0,0,0,-,-,72515
129,127,2,-,-,72517
1200,886,314,617,79600,72519
84,84,0,-,-,72520
2036,1423,613,555,76100,72521
216,174,42,423,93300,72522
526,366,160,536,69300,72523
124,68,56,-,-,72524
77,49,28,400,-,72526
168,168,0,-,138400,72527
7,7,0,-,-,72528
2291,1928,363,756,80900,72529
674,601,73,596,109100,72530
377,366,11,-,150000,72531
516,367,149,442,82800,72532
191,184,7,-,75600,72533
529,464,65,465,94000,72534
185,168,17,475,76900,72536
308,252,56,950,115700,72537
153,133,20,-,104600,72538
79,79,0,-,-,72539
78,55,23,731,-,72540
1706,1433,273,541,94700,72542
5023,3400,1623,673,151300,72543
287,214,73,-,89000,72544
76,60,16,-,-,72546
247,228,19,-,96700,72550
16,14,2,-,-,72553
1109,831,278,470,109200,72554
74,51,23,-,-,72555
1312,1019,293,525,84500,72556
3729,2602,1127,570,135400,72560
250,210,40,675,107600,72561
892,623,269,654,77700,72562
173,127,46,618,76400,72564
267,216,51,608,80700,72565
231,226,5,-,60500,72566
93,80,13,-,74600,72567
494,351,143,1091,57700,72568
137,108,29,-,85900,72569
137,137,0,-,138800,72571
64,41,23,-,-,72572
81,49,32,-,-,72573
1696,1155,541,496,84100,72576
268,221,47,386,85500,72577
24,24,0,-,-,72578
547,372,175,724,86700,72579
481,428,53,-,140400,72581
754,553,201,677,79000,72583
158,141,17,-,85200,72584
165,165,0,-,-,72585
34,17,17,-,-,72587
11956,8157,3799,640,125600,72601
595,407,188,549,142600,72611
4002,3112,890,574,117900,72616
30,24,6,467,155000,72617
881,662,219,485,129400,72619
390,373,17,-,-,72623
144,130,14,-,111600,72624
617,462,155,559,166500,72626
343,307,36,-,84100,72628
191,149,42,658,75400,72629
110,93,17,446,84200,72630
1894,1639,255,743,156800,72631
2017,1508,509,628,155400,72632
614,584,30,520,99500,72633
1729,1275,454,558,121600,72634
1456,1061,395,688,96500,72635
6,6,0,-,225000,72636
2720,1839,881,536,93300,72638
270,199,71,-,82100,72639
115,115,0,-,184400,72640
1071,906,165,471,112600,72641
1070,927,143,717,128400,72642
1111,956,155,521,123100,72644
851,651,200,519,91500,72645
174,141,33,586,-,72648
1673,1297,376,535,116400,72650
464,317,147,598,83300,72651
12702,9389,3313,681,134700,72653
148,135,13,-,101200,72655
629,512,117,754,131900,72658
225,188,37,788,81100,72660
278,226,52,-,88000,72661
1141,984,157,820,111600,72662
98,82,16,-,110700,72663
97,97,0,-,-,72666
110,110,0,-,225000,72668
23,21,2,-,-,72669
44,44,0,-,-,72670
111,58,53,597,52500,72672
560,448,112,496,93700,72675
155,103,52,522,75800,72677
16,9,7,-,-,72679
311,229,82,815,118100,72680
161,157,4,-,77400,72682
109,102,7,-,-,72683
425,370,55,669,81500,72685
71,71,0,-,-,72686
2564,1998,566,707,112600,72687
16401,6595,9806,748,205000,72701
14651,5969,8682,715,222900,72703
10503,5908,4595,940,182200,72704
19260,11302,7958,916,230200,72712
5193,4438,755,943,156400,72714
7179,6251,928,967,166500,72715
337,277,60,-,147000,72717
1024,942,82,1201,281800,72718
4066,2274,1792,1044,160100,72719
176,164,12,-,-,72721
1216,834,382,752,113300,72722
2108,1631,477,865,136600,72727
99,99,0,-,137500,72729
3315,2307,1008,908,164700,72730
1844,1587,257,663,199300,72732
2987,1987,1000,748,137100,72734
2466,1788,678,868,171000,72736
858,742,116,1016,124500,72738
232,148,84,704,172900,72739
3578,2662,916,609,112000,72740
263,221,42,-,-,72742
2074,1345,729,669,119500,72744
4800,3112,1688,827,154900,72745
126,116,10,-,43400,72747
21,12,9,-,-,72749
2531,2026,505,1066,130200,72751
197,134,63,-,53600,72752
3310,2528,782,769,155000,72753
15916,9696,6220,732,151900,72756
14717,9261,5456,950,215600,72758
132,110,22,-,132100,72760
7459,4590,2869,713,144300,72761
14283,9362,4921,855,168000,72762
18281,8877,9404,721,145700,72764
411,310,101,738,135800,72768
388,239,149,647,85300,72769
426,395,31,614,112800,72773
2282,1909,373,684,155200,72774
310,268,42,-,105200,72776
6588,2588,4000,641,105500,72801
7629,6231,1398,737,160300,72802
759,572,187,576,80600,72821
2384,1831,553,678,86600,72823
629,435,194,714,88300,72824
15,12,3,-,-,72826
73,73,0,-,-,72827
27,27,0,-,-,72828
5599,3540,2059,636,106600,72830
448,319,129,433,74700,72832
1393,919,474,525,119100,72833
3594,2581,1013,639,127200,72834
271,233,38,-,85300,72835
2761,2216,545,663,112700,72837
49,49,0,-,62800,72838
143,124,19,-,65600,72839
898,800,98,679,75900,72840
67,56,11,-,23400,72841
479,379,100,675,72600,72842
940,766,174,660,97900,72843
432,411,21,675,109500,72845
1571,1254,317,597,106500,72846
1008,779,229,835,94700,72847
264,231,33,773,82800,72851
60,60,0,-,-,72852
777,471,306,504,69900,72853
338,288,50,661,78600,72854
2453,1623,830,540,87800,72855
121,102,19,-,111800,72856
542,427,115,435,87300,72857
1499,1209,290,593,122400,72858
202,144,58,-,188700,72860
692,578,114,748,109700,72863
514,482,32,675,100900,72865
8870,3670,5200,579,92000,72901
11308,5467,5841,658,164300,72903
7819,4376,3443,679,75900,72904
5542,3545,1997,855,138400,72908
3392,2568,824,785,195500,72916
5273,4242,1031,617,146700,72921
1932,1116,816,843,100400,72923
259,190,69,630,92300,72926
3148,2084,1064,571,89000,72927
283,224,59,619,125600,72928
123,89,34,-,50200,72930
661,563,98,682,76300,72932
2105,1671,434,693,91400,72933
334,325,9,569,88700,72934
183,127,56,579,78100,72935
5516,4302,1214,715,124600,72936
1368,1090,278,776,111700,72937
480,403,77,758,87500,72938
1017,920,97,641,107400,72940
2049,1634,415,693,119400,72941
948,664,284,590,84500,72943
1216,984,232,667,86000,72944
90,63,27,528,52500,72945
1479,1355,124,523,94500,72946
1580,1351,229,615,83900,72947
121,121,0,-,82200,72948
3742,2564,1178,588,104800,72949
127,108,19,-,-,72950
389,318,71,580,78300,72951
1020,864,156,699,112400,72952
122,108,14,-,102000,72955
13329,9520,3809,734,115300,72956
2699,1932,767,499,71300,72958
1118,945,173,625,145700,72959
356,290,66,542,81000,73002
8845,5177,3668,1069,165100,73003
348,285,63,750,121900,73004
3255,2094,1161,571,71700,73005
1224,993,231,677,83600,73006
943,853,90,761,381300,73007
7739,4388,3351,833,119300,73008
501,361,140,498,88100,73009
6731,5825,906,758,170800,73010
147,109,38,625,49600,73011
12688,10417,2271,1608,229800,73012
18964,15054,3910,1159,213100,73013
654,509,145,907,112200,73014
1067,761,306,485,64900,73015
601,534,67,950,160400,73016
600,476,124,477,87900,73017
7836,5064,2772,677,89800,73018
0,0,0,-,-,73019
8549,7286,1263,985,178300,73020
105,96,9,783,97800,73021
257,197,60,829,99700,73024
4051,3888,163,799,327700,73025
3988,3583,405,916,164100,73026
425,294,131,583,118900,73027
1377,1113,264,826,96900,73028
640,511,129,430,101800,73029
1592,1058,534,686,114700,73030
101,87,14,517,83800,73032
138,92,46,754,70000,73033
16449,11694,4755,928,278700,73034
6660,4262,2398,758,114400,73036
747,596,151,493,79500,73038
782,485,297,687,75200,73040
158,131,27,392,57500,73041
410,304,106,653,80900,73042
82,76,6,-,56400,73043
8220,6017,2203,739,139500,73044
4409,3493,916,831,153300,73045
1433,1088,345,738,108200,73047
912,690,222,697,109400,73048
2090,1721,369,687,146400,73049
42,5,37,584,-,73050
2894,2233,661,731,109100,73051
2571,1920,651,715,101500,73052
265,204,61,484,106900,73053
1518,1270,248,826,154400,73054
3795,2983,812,675,118400,73055
139,122,17,572,88600,73056
901,616,285,616,87700,73057
75,63,12,388,152100,73058
1092,893,199,650,99900,73059
651,490,161,819,119800,73061
607,476,131,416,54400,73062
224,180,44,682,100000,73063
8069,6202,1867,1009,159100,73064
3251,2699,552,699,179900,73065
126,98,28,-,101600,73066
866,695,171,725,97200,73067
4595,3279,1316,943,114600,73068
10097,4840,5257,772,154100,73069
17167,7813,9354,880,146000,73071
17051,9962,7089,864,221100,73072
191,150,41,1078,130000,73073
412,262,150,691,89300,73074
3555,2253,1302,651,102300,73075
2834,2048,786,753,90800,73077
3263,3081,182,931,214400,73078
181,140,41,675,104000,73079
3572,2415,1157,798,156500,73080
1057,834,223,573,72400,73082
2738,1935,803,645,76700,73084
3363,2378,985,682,125800,73086
4256,3772,484,775,183900,73089
340,271,69,635,151900,73090
334,247,87,636,62200,73092
1004,846,158,825,180400,73093
761,580,181,632,112300,73095
5062,2559,2503,683,164800,73096
76,60,16,-,-,73097
1644,1169,475,633,95200,73098
22822,17215,5607,1051,162500,73099
1134,85,1049,1122,167000,73102
2645,854,1791,847,214600,73103
1230,306,924,1231,247700,73104
2744,1178,1566,885,105100,73105
4468,1790,2678,741,107300,73106
10496,5493,5003,816,98000,73107
4652,1804,2848,638,50400,73108
6998,3158,3840,684,69300,73109
13928,6468,7460,838,91800,73110
4679,2225,2454,742,72500,73111
14743,7441,7302,795,121100,73112
7716,2861,4855,872,90900,73114
8439,4758,3681,853,82100,73115
4424,3134,1290,978,226600,73116
2493,1064,1429,570,85900,73117
6365,3452,2913,874,158300,73118
9631,4822,4809,795,63200,73119
17459,9182,8277,827,166300,73120
1344,1058,286,935,159000,73121
4950,2983,1967,761,114700,73122
9031,4076,4955,729,113200,73127
1551,1052,499,1069,144900,73128
6248,3200,3048,742,49300,73129
8009,6054,1955,951,137500,73130
1456,949,507,1037,260200,73131
10816,6128,4688,820,154900,73132
2879,653,2226,1017,229000,73134
8335,4731,3604,960,139800,73135
7325,3017,4308,774,121300,73139
1074,694,380,772,77600,73141
6283,3445,2838,965,227700,73142
504,0,504,1279,-,73145
1913,943,970,808,63600,73149
1687,1561,126,900,228000,73150
600,580,20,-,407100,73151
12246,7487,4759,908,108900,73159
22705,14874,7831,985,136300,73160
11811,8333,3478,937,176500,73162
2254,2187,67,1100,210800,73165
736,573,163,974,135500,73169
14065,11300,2765,1271,193600,73170
1038,999,39,1663,310900,73173
1689,1500,189,1420,196800,73179
13676,8982,4694,776,126800,73401
25,25,0,-,32500,73425
456,422,34,670,123000,73430
433,327,106,688,102200,73432
1069,871,198,651,101500,73433
222,176,46,829,57400,73434
39,33,6,-,52700,73437
1373,997,376,612,71400,73438
3105,2413,692,719,95000,73439
131,94,37,525,106300,73440
59,49,10,706,42500,73441
160,142,18,-,76800,73442
1454,1083,371,684,109200,73443
76,49,27,-,-,73444
3004,1986,1018,651,84200,73446
462,371,91,678,79200,73447
1979,1477,502,681,96100,73448
1091,792,299,713,85200,73449
508,425,83,725,85800,73450
206,170,36,917,186400,73453
234,182,52,741,57600,73455
786,593,193,549,79300,73456
325,239,86,694,78800,73458
330,250,80,789,102500,73459
1945,1226,719,529,79600,73460
274,223,51,613,79700,73461
1166,1004,162,645,91500,73463
375,306,69,528,67200,73481
66,52,14,575,38800,73487
271,198,73,613,83000,73491
7119,2908,4211,718,108100,73501
1584,6,1578,1261,-,73503
18357,10179,8178,789,127900,73505
8774,4861,3913,875,125200,73507
72,48,24,625,68300,73520
8077,4281,3796,735,107400,73521
901,682,219,672,108300,73526
1684,1371,313,729,160900,73527
205,163,42,692,102600,73528
2084,1607,477,700,77600,73529
160,139,21,488,38400,73530
177,140,37,891,83000,73531
205,135,70,592,104600,73532
10709,7360,3349,689,111700,73533
239,172,67,540,47100,73537
2015,1443,572,1417,197800,73538
86,86,0,-,65000,73539
146,110,36,675,90000,73540
968,820,148,695,115800,73541
1712,1335,377,620,49500,73542
590,438,152,675,98900,73543
117,100,17,344,49500,73544
469,318,151,535,58400,73546
600,411,189,375,81200,73547
165,154,11,-,65600,73548
84,62,22,825,76700,73549
1010,732,278,620,62200,73550
24,24,0,-,-,73551
505,427,78,625,112800,73552
26,26,0,-,187500,73553
1327,925,402,581,64400,73554
57,51,6,-,40600,73555
55,33,22,508,80700,73556
166,144,22,-,170800,73557
197,150,47,485,41900,73559
258,178,80,575,72100,73560
220,192,28,681,76300,73562
227,171,56,410,75600,73564
388,273,115,473,60400,73565
747,507,240,538,69500,73566
276,181,95,470,78700,73567
408,302,106,525,35000,73568
224,158,66,471,41900,73569
453,345,108,620,61000,73570
36,17,19,-,191300,73571
1348,1038,310,584,82500,73572
894,572,322,515,63300,73573
3530,2209,1321,827,108800,73601
474,413,61,630,133200,73620
110,86,24,638,72700,73622
719,372,347,707,84800,73624
302,248,54,800,90900,73625
389,315,74,855,96300,73626
165,124,41,575,74700,73627
560,426,134,576,103300,73628
1448,1002,446,669,79900,73632
92,51,41,-,263800,73638
237,180,57,564,87500,73639
216,184,32,544,51700,73641
83,62,21,-,105600,73642
5043,3263,1780,792,137100,73644
566,377,189,691,84500,73645
224,205,19,-,82400,73646
225,193,32,-,154400,73647
332,255,77,553,112500,73650
1610,1021,589,629,59900,73651
294,216,78,811,125000,73654
358,290,68,512,64400,73655
72,70,2,-,61900,73658
80,68,12,483,-,73659
157,115,42,325,83900,73660
153,130,23,700,85300,73661
1927,1250,677,498,102600,73662
402,303,99,-,109500,73663
455,314,141,550,64700,73664
75,49,26,-,73000,73666
238,166,72,671,84400,73667
684,520,164,575,100500,73669
97,68,29,-,72000,73673
8389,5144,3245,791,70500,73701
12315,7695,4620,904,143300,73703
0,0,0,-,-,73705
222,201,21,450,142700,73716
2526,1673,853,707,102200,73717
250,215,35,800,96900,73718
26,23,3,-,104700,73719
82,70,12,-,90000,73720
179,133,46,753,153600,73722
453,351,102,443,61400,73724
219,181,38,817,51600,73726
91,80,11,-,168000,73727
774,585,189,644,76100,73728
211,177,34,719,80300,73729
289,226,63,567,68200,73730
63,59,4,-,62800,73731
121,113,8,-,115300,73733
320,246,74,838,79200,73734
269,235,34,804,124300,73735
168,134,34,-,81900,73736
1392,1091,301,763,85700,73737
469,343,126,707,74200,73738
143,140,3,-,87500,73739
269,201,68,775,82600,73741
1538,1183,355,675,113100,73742
47,33,14,-,75000,73743
61,46,15,-,74300,73744
7,7,0,-,-,73746
169,80,89,777,105800,73747
203,150,53,765,74400,73749
2687,2145,542,762,152500,73750
163,147,16,488,95000,73753
459,404,55,825,90000,73754
381,297,84,519,70900,73755
126,98,28,692,150000,73756
99,70,29,580,-,73757
41,33,8,-,-,73758
644,496,148,643,78200,73759
155,149,6,650,118800,73760
150,142,8,-,78800,73761
783,617,166,945,169200,73762
804,669,135,498,78100,73763
66,36,30,580,130600,73764
503,327,176,716,91700,73766
592,487,105,671,116800,73768
191,135,56,465,46800,73771
1263,961,302,566,90800,73772
777,576,201,739,86400,73773
5653,3786,1867,784,121200,73801
427,376,51,715,102200,73832
607,476,131,728,77600,73834
97,82,15,-,103100,73835
162,135,27,583,108700,73838
267,204,63,833,87600,73840
163,125,38,880,83000,73841
205,181,24,391,145300,73842
338,243,95,688,70800,73843
103,68,35,-,110500,73844
739,626,113,594,81400,73848
49,46,3,-,209100,73851
818,712,106,900,111500,73852
217,180,37,-,153600,73853
36,35,1,-,117500,73855
260,227,33,1536,142700,73857
603,379,224,648,75000,73858
531,394,137,641,116500,73859
573,415,158,685,77300,73860
59,36,23,-,86300,73901
192,150,42,613,123200,73931
843,611,232,671,94800,73932
688,533,155,525,56200,73933
99,64,35,-,59200,73937
292,256,36,705,72700,73938
499,222,277,593,100000,73939
4152,2646,1506,774,125200,73942
166,111,55,646,83500,73944
1016,754,262,627,92900,73945
23,23,0,-,55000,73946
157,94,63,663,47900,73947
579,400,179,590,84200,73949
474,388,86,725,111500,73950
375,313,62,716,72800,73951
135,107,28,506,49500,74001
791,623,168,651,77100,74002
5685,3333,2352,679,76600,74003
10852,8082,2770,792,143500,74006
10119,7887,2232,939,210800,74008
3975,2846,1129,615,109000,74010
10298,8380,1918,1125,165700,74011
22458,15347,7111,999,163900,74012
14207,12274,1933,1152,171200,74014
3497,2489,1008,885,143000,74015
2260,1764,496,641,93200,74016
11238,7624,3614,874,133200,74017
6900,5604,1296,815,169200,74019
2903,2106,797,736,92800,74020
7115,5875,1240,937,159000,74021
735,653,82,598,98100,74022
4167,2739,1428,708,95600,74023
311,234,77,680,65800,74026
387,308,79,588,70700,74027
634,516,118,620,85200,74028
2042,1507,535,617,88900,74029
1535,1071,464,509,77300,74030
827,690,137,680,113900,74032
4090,3140,950,989,133500,74033
51,36,15,792,42000,74034
1332,950,382,546,67600,74035
2687,2189,498,786,135200,74036
6344,4863,1481,1161,196600,74037
802,685,117,665,97900,74038
1337,1082,255,748,98700,74039
976,798,178,846,148800,74041
152,112,40,634,57300,74042
2812,2260,552,748,119700,74044
129,110,19,542,59400,74045
44,28,16,-,86700,74046
2537,2116,421,830,123900,74047
2463,1735,728,589,83600,74048
133,78,55,583,-,74050
735,672,63,829,118800,74051
418,283,135,660,55500,74052
1631,1392,239,757,146700,74053
279,245,34,478,48700,74054
16680,12508,4172,971,190100,74055
2193,1475,718,630,73100,74056
1443,1026,417,639,102100,74058
2130,1591,539,652,112200,74059
199,156,43,659,60000,74060
763,590,173,730,101500,74061
424,353,71,775,101800,74062
12386,9626,2760,809,126400,74063
12231,8980,3251,863,122500,74066
4,4,0,-,-,74068
5403,4011,1392,845,146100,74070
66,59,7,-,59700,74071
717,573,144,687,91000,74072
2070,1688,382,830,127400,74073
12036,5784,6252,918,193500,74074
10454,4110,6344,739,154800,74075
0,0,0,-,-,74078
1573,1103,470,675,97900,74079
1042,837,205,763,155300,74080
681,632,49,758,90300,74081
30,24,6,1000,65000,74082
389,313,76,563,105400,74083
214,173,41,567,55900,74084
902,669,233,659,74700,74085
293,4,289,1596,-,74103
5330,2354,2976,853,158000,74104
12160,6555,5605,771,214600,74105
7187,3204,3983,619,63100,74106
8056,4236,3820,755,90200,74107
2733,1661,1072,875,87900,74108
4990,2467,2523,747,52200,74110
9199,4982,4217,853,106100,74112
7276,5448,1828,1038,169600,74114
8094,4173,3921,846,59700,74115
1477,654,823,713,99600,74116
12,12,0,-,-,74117
2297,569,1728,812,142900,74119
2363,871,1492,707,262800,74120
3660,2115,1545,781,51300,74126
6675,3778,2897,791,82600,74127
4495,2799,1696,867,83900,74128
7115,3453,3662,773,107700,74129
732,490,242,803,52100,74130
1088,852,236,792,156900,74131
3559,2300,1259,951,170900,74132
19403,10030,9373,903,183500,74133
6112,3428,2684,787,121500,74134
9648,4730,4918,765,168800,74135
13884,4894,8990,754,221900,74136
10834,7324,3510,965,292400,74137
7605,3903,3702,848,124800,74145
5586,1912,3674,678,93300,74146
4365,3052,1313,707,110500,74301
1107,813,294,842,123200,74330
3040,2374,666,737,129100,74331
681,512,169,744,119000,74332
397,316,81,634,92000,74333
1905,1506,399,801,100800,74337
1899,1444,455,666,90900,74338
868,586,282,584,55200,74339
122,100,22,725,85700,74340
1144,894,250,584,70300,74342
1167,873,294,630,86100,74343
6677,4899,1778,694,151800,74344
2662,1918,744,564,103000,74346
974,757,217,646,76600,74347
137,91,46,588,79500,74349
321,238,83,681,89500,74350
2501,1961,540,635,94000,74352
6878,4430,2448,707,91200,74354
87,62,25,625,51300,74358
172,132,40,581,70800,74359
18,15,3,-,-,74360
6459,4253,2206,738,127300,74361
1030,804,226,711,81200,74363
712,566,146,454,105100,74364
1715,1237,478,698,89000,74365
613,533,80,565,75500,74366
191,145,46,705,89800,74367
33,28,5,-,65000,74368
753,600,153,717,106100,74369
1375,1117,258,642,99900,74370
6416,3718,2698,669,88500,74401
12144,7743,4401,687,106200,74403
1728,1357,371,754,112700,74421
300,253,47,905,94500,74422
348,268,80,511,99100,74423
487,412,75,668,102400,74425
4058,3206,852,618,89900,74426
508,478,30,-,139100,74427
470,384,86,559,140600,74428
5291,4068,1223,834,152100,74429
202,153,49,619,92100,74430
321,254,67,706,63600,74431
4217,3387,830,544,93200,74432
3320,2634,686,662,144400,74434
1245,1028,217,567,86200,74435
1837,1399,438,746,150600,74436
3866,2832,1034,662,76300,74437
42,35,7,-,31900,74438
1912,1558,354,546,99800,74441
401,340,61,713,76400,74442
1124,804,320,690,113600,74445
187,137,50,686,84600,74446
6245,3879,2366,624,73600,74447
667,581,86,735,92900,74450
1496,1183,313,635,127400,74451
125,89,36,653,143000,74452
1269,1044,225,797,95000,74454
1252,1014,238,575,79400,74455
80,63,17,532,85000,74456
207,174,33,826,92500,74457
32,25,7,-,-,74458
50,43,7,-,101000,74459
82,59,23,531,49400,74460
2987,2180,807,596,90400,74462
71,40,31,525,64000,74463
10700,6275,4425,638,115400,74464
6092,4038,2054,742,109300,74467
120,111,9,-,77500,74468
862,592,270,611,89200,74469
589,476,113,529,79700,74470
538,446,92,491,126000,74471
246,208,38,796,88800,74472
0,0,0,-,-,74477
10859,7553,3306,722,116700,74501
74,58,16,581,68300,74521
117,94,23,775,106900,74522
2369,1710,659,507,75500,74523
3748,2651,1097,548,101700,74525
71,56,15,438,88000,74528
72,63,9,-,71000,74530
350,282,68,713,77100,74531
330,246,84,740,85000,74533
61,52,9,538,170800,74534
42,37,5,-,114800,74535
652,456,196,540,86900,74536
1641,1115,526,611,82400,74538
103,90,13,517,110700,74540
153,128,25,-,152500,74543
296,219,77,608,59400,74546
1376,976,400,660,85700,74547
29,22,7,-,56700,74549
469,364,105,485,95800,74552
493,373,120,614,83800,74553
774,420,354,749,99400,74554
308,240,68,535,87200,74555
144,128,16,475,74000,74556
201,170,31,639,85000,74557
180,151,29,463,76900,74558
246,181,65,725,75600,74560
816,646,170,458,89800,74561
372,305,67,415,70200,74562
780,651,129,563,85600,74563
274,212,62,770,82000,74565
56,53,3,-,96100,74567
280,234,46,650,86000,74569
426,324,102,1000,75500,74570
1357,938,419,500,77400,74571
248,198,50,631,80000,74572
471,398,73,717,99000,74574
45,35,10,-,122900,74576
87,57,30,515,71700,74577
2353,1546,807,621,84400,74578
7348,4226,3122,673,73600,74601
5015,4103,912,653,142400,74604
253,145,108,571,47700,74630
3000,2241,759,720,62600,74631
266,227,39,555,57500,74632
132,121,11,550,65000,74633
120,99,21,1042,102200,74636
693,551,142,486,42200,74637
126,101,25,738,83900,74640
296,269,27,438,97300,74641
183,160,23,583,47800,74643
199,142,57,643,57100,74644
86,83,3,-,65300,74646
1396,1057,339,632,91800,74647
265,220,45,653,66400,74650
294,189,105,410,51300,74651
315,259,56,488,42600,74652
1473,965,508,585,71700,74653
9364,5065,4299,748,126400,74701
201,160,41,600,59000,74720
81,63,18,-,88100,74722
552,391,161,541,111000,74723
121,93,28,-,55400,74724
926,676,250,656,83500,74726
770,533,237,568,87000,74727
4301,2957,1344,575,91600,74728
1122,848,274,714,97400,74729
1742,1175,567,782,104500,74730
599,414,185,666,73000,74731
1221,869,352,668,91900,74733
454,358,96,533,88100,74734
605,485,120,625,89100,74735
404,306,98,559,111000,74736
255,202,53,619,57100,74738
916,760,156,588,76500,74740
397,309,88,675,104200,74741
3354,2073,1281,534,94900,74743
3872,2478,1394,570,79800,74745
112,65,47,592,72800,74747
243,221,22,822,66100,74748
127,109,18,625,70900,74750
15,15,0,-,-,74753
141,105,36,365,56100,74754
47,47,0,-,-,74755
292,249,43,718,143300,74756
549,463,86,667,90800,74759
145,103,42,531,115200,74760
36,26,10,488,73300,74761
1442,1098,344,609,77300,74764
598,480,118,447,58900,74766
8435,4890,3545,667,95000,74801
7727,5219,2508,716,145700,74804
11862,7265,4597,697,133900,74820
466,393,73,719,96700,74824
781,605,176,639,92100,74825
417,340,77,668,82900,74826
130,105,25,769,118400,74827
167,127,40,450,68300,74829
77,61,16,613,34500,74830
279,211,68,492,98300,74831
328,271,57,713,95000,74832
304,252,52,542,79200,74833
2781,2139,642,596,130400,74834
94,42,52,717,-,74836
92,73,19,688,53500,74837
210,159,51,505,67200,74839
696,524,172,684,120100,74840
53,46,7,-,-,74842
159,136,23,706,80000,74843
147,115,32,700,90700,74844
174,133,41,525,75000,74845
2243,1645,598,533,67600,74848
1167,825,342,539,79300,74849
116,100,16,-,70000,74850
3272,2705,567,742,123500,74851
543,424,119,867,82100,74852
679,546,133,480,61900,74854
1863,1529,334,705,116000,74855
291,198,93,732,79200,74856
3346,2942,404,665,133700,74857
2231,1491,740,570,79100,74859
597,499,98,589,92900,74860
1881,1339,542,664,135600,74864
631,527,104,678,116600,74865
312,241,71,388,65800,74867
4821,3324,1497,647,79300,74868
288,247,41,933,91400,74869
869,751,118,550,100200,74871
1221,856,365,559,99800,74872
4244,3272,972,743,95200,74873
431,376,55,711,91700,74875
552,469,83,657,95600,74878
703,549,154,564,62200,74880
1839,1565,274,730,90300,74881
804,545,259,548,65000,74883
2201,1490,711,610,65100,74884
768,494,274,588,74700,74901
1524,1074,450,701,98400,74902
798,659,139,647,80200,74930
450,396,54,713,82400,74931
909,652,257,665,84300,74932
71,50,21,650,-,74935
405,299,106,720,85300,74936
1930,1353,577,587,59400,74937
248,187,61,530,83100,74939
932,719,213,675,98300,74940
975,723,252,614,80100,74941
56,39,17,500,101100,74942
56,38,18,-,76700,74943
460,343,117,539,80500,74944
152,115,37,578,67500,74945
52,15,37,517,31900,74946
4298,3390,908,704,96300,74948
135,106,29,616,69500,74949
526,333,193,689,61100,74951
4480,2948,1532,651,120400,74953
1766,1084,682,754,91500,74954
5778,3764,2014,633,103000,74955
657,487,170,667,90900,74956
444,375,69,382,81800,74957
2645,1864,781,673,89700,74959
4538,3073,1465,553,82600,74960
1787,1320,467,650,82900,74962
190,174,16,-,77500,74963
1000,728,272,732,83200,74964
1834,1192,642,564,86500,74965
1435,1246,189,576,99600,74966
8361,1461,6900,1300,310000,75001
22236,17508,4728,1506,254300,75002
18022,9054,8968,1118,184000,75006
19356,14148,5208,1189,219400,75007
3633,2860,773,1527,285800,75009
11482,5108,6374,1245,291800,75010
13663,10046,3617,1416,395700,75013
15953,11270,4683,1373,369400,75019
8829,5624,3205,812,107000,75020
3369,2584,785,795,113500,75021
7933,7395,538,1733,405100,75022
18121,11586,6535,1399,234700,75023
17726,7557,10169,1335,382100,75024
18780,13027,5753,1417,328400,75025
15826,13158,2668,1669,296400,75028
10973,8978,1995,1236,303300,75032
35506,24828,10678,1314,387500,75034
22460,18061,4399,1769,327900,75035
12279,2084,10195,1049,248300,75038
9697,1593,8104,1431,449300,75039
18460,13189,5271,1139,135600,75040
9379,5709,3670,977,117800,75041
11483,5846,5637,928,125600,75042
21054,12260,8794,1089,153500,75043
15054,10161,4893,1224,183500,75044
7626,6780,846,1342,209500,75048
14690,6352,8338,1026,115000,75050
12798,6006,6792,894,95800,75051
29698,22032,7666,1270,161600,75052
3082,2658,424,2055,306700,75054
21956,13697,8259,1350,248300,75056
5022,1805,3217,1172,126600,75057
846,671,175,1076,245000,75058
14003,8666,5337,947,123500,75060
17381,6609,10772,919,139400,75061
16126,6813,9313,993,142100,75062
15903,6332,9571,1212,341700,75063
4492,3385,1107,1206,176400,75065
24965,9528,15437,1145,194700,75067
19329,15587,3742,1652,236900,75068
13853,7136,6717,1050,253500,75069
34661,25028,9633,1462,294500,75070
16901,12258,4643,1562,282300,75071
17124,9694,7430,1231,204200,75074
14219,9039,5180,1218,246900,75075
3159,2506,653,893,135300,75076
12912,10421,2491,1451,280400,75077
6897,6079,818,1506,435300,75078
19098,10551,8547,1306,258400,75080
14975,8521,6454,1309,208600,75081
8543,6210,2333,1479,313300,75082
11746,9278,2468,1374,255900,75087
9104,7807,1297,1556,201400,75088
10997,9684,1313,1688,209100,75089
8286,5135,3151,867,86500,75090
9920,5444,4476,886,154800,75092
19131,12108,7023,1372,431900,75093
6140,5291,849,2137,332500,75094
17370,13759,3611,1435,207900,75098
190,144,46,860,65700,75101
440,372,68,938,96000,75102
5241,4156,1085,976,123400,75103
15820,11001,4819,1295,155800,75104
66,61,5,-,106300,75105
1718,1424,294,1087,141800,75109
10283,6464,3819,787,93400,75110
1960,1567,393,1163,121900,75114
18722,12004,6718,1128,163600,75115
6514,3576,2938,993,125400,75116
1518,1146,372,750,145000,75117
9164,6083,3081,908,120400,75119
1614,1240,374,673,115700,75124
2091,1551,540,1056,81600,75125
13398,11518,1880,1322,198800,75126
584,432,152,691,99700,75127
504,426,78,-,191500,75132
7145,4088,3057,1018,119300,75134
2373,1883,490,984,159700,75135
6776,4817,1959,1230,147400,75137
2337,1714,623,714,108900,75140
1176,787,389,923,80300,75141
5781,4249,1532,918,106400,75142
5466,4350,1116,804,97500,75143
1259,876,383,696,85000,75144
6783,4374,2409,1050,129200,75146
2510,1718,792,847,111400,75147
2249,1571,678,775,84900,75148
17603,10655,6948,1023,111400,75149
21248,9484,11764,1060,122800,75150
1562,1177,385,1056,101300,75152
124,109,15,673,69300,75153
12580,9728,2852,1145,170900,75154
825,689,136,782,83500,75155
6546,5161,1385,748,101200,75156
89,73,16,844,67500,75157
1373,1232,141,1051,157500,75158
5286,3758,1528,991,103700,75159
8328,5178,3150,956,122300,75160
2153,1703,450,941,122800,75161
1237,914,323,1021,77900,75163
263,197,66,1094,113200,75164
15240,9286,5954,1057,166100,75165
1318,1121,197,1644,236300,75166
3523,3269,254,1366,228500,75167
5096,3907,1189,771,98000,75169
1205,702,503,859,64200,75172
1456,1292,164,1064,185300,75173
6202,3733,2469,985,89600,75180
8084,7007,1077,1641,164700,75181
1834,1815,19,-,366300,75182
8731,7370,1361,1402,189700,75189
9532,1123,8409,1684,514200,75201
1344,291,1053,1488,261600,75202
6551,1753,4798,803,84800,75203
17390,3558,13832,1436,351100,75204
9238,5954,3284,1498,1177500,75205
20324,5430,14894,1232,375000,75206
1494,9,1485,1582,-,75207
10380,5564,4816,972,244100,75208
6636,4039,2597,1322,603300,75209
2823,661,2162,715,66400,75210
21846,10900,10946,889,97600,75211
7608,3867,3741,649,90700,75212
15887,8555,7332,1137,461700,75214
6450,2144,4306,811,69400,75215
18415,9002,9413,817,65200,75216
23629,14419,9210,898,80800,75217
10417,6891,3526,1114,303500,75218
14592,5042,9550,1338,295300,75219
14476,4522,9954,838,256400,75220
4589,2407,2182,885,114500,75223
10994,5318,5676,843,101600,75224
8804,6711,2093,2018,1041300,75225
1785,114,1671,1153,-,75226
17672,10219,7453,911,98800,75227
25797,12019,13778,841,130800,75228
10935,7882,3053,989,371900,75229
13237,8195,5042,1028,597600,75230
16956,2996,13960,862,327700,75231
10943,6178,4765,946,96800,75232
5025,2509,2516,929,138600,75233
12016,7319,4697,1257,167200,75234
7853,1885,5968,1167,134600,75235
6686,2317,4369,929,123000,75236
8441,1235,7206,837,120200,75237
12776,6345,6431,919,341200,75238
10194,2454,7740,991,238500,75240
10811,6344,4467,883,78800,75241
27936,6744,21192,888,217400,75243
6115,2992,3123,1388,402400,75244
1306,149,1157,709,169900,75246
210,0,210,868,-,75247
16389,8682,7707,1139,373400,75248
5143,3795,1348,1443,145600,75249
1583,0,1583,1289,-,75251
12402,5162,7240,963,348400,75252
6453,3991,2462,988,46800,75253
11720,2186,9534,1087,387300,75254
0,0,0,-,-,75270
27735,5691,22044,1004,289300,75287
0,0,0,-,-,75390
6626,3396,3230,788,65700,75401
6517,4630,1887,902,140400,75402
5516,3798,1718,1109,172200,75407
4566,3478,1088,1604,178800,75409
2113,1717,396,619,155000,75410
507,375,132,871,75200,75411
288,272,16,-,72200,75412
90,55,35,996,63500,75413
1006,825,181,734,127700,75414
79,69,10,-,-,75415
1133,856,277,805,89200,75416
1016,886,130,568,72900,75417
4868,3291,1577,756,106100,75418
351,280,71,702,126800,75420
199,188,11,769,115800,75421
1095,908,187,844,108600,75422
1047,888,159,819,123400,75423
1121,913,208,1116,149900,75424
1959,1244,715,640,53900,75426
3747,1761,1986,820,79400,75428
842,596,246,634,58800,75431
1292,834,458,582,76500,75432
1017,829,188,818,95400,75433
497,347,150,489,57300,75435
807,612,195,493,86200,75436
481,443,38,-,114700,75437
350,298,52,707,104500,75438
401,236,165,823,109100,75439
2567,2136,431,667,130300,75440
66,66,0,-,-,75441
3292,2408,884,1099,150900,75442
1190,900,290,752,87500,75446
407,336,71,863,163000,75447
247,227,20,-,68800,75448
585,419,166,740,75300,75449
56,43,13,-,109700,75450
549,462,87,603,112500,75451
1453,958,495,815,110700,75452
1122,923,199,879,120500,75453
2892,2479,413,1660,270400,75454
9300,5945,3355,727,99700,75455
2303,1718,585,833,133100,75457
1898,1417,481,785,124400,75459
9366,4688,4678,686,72100,75460
4449,3454,995,767,145500,75462
324,312,12,-,66300,75468
117,101,16,550,85000,75469
162,162,0,-,50000,75470
413,336,77,-,87600,75471
1357,967,390,744,102600,75472
1371,1132,239,747,105500,75473
5334,4143,1191,878,90800,75474
55,50,5,-,127300,75475
477,417,60,937,143300,75476
402,260,142,551,68100,75477
369,289,80,800,109600,75478
680,547,133,618,87700,75479
631,581,50,630,233900,75480
139,121,18,-,79500,75481
9413,6153,3260,777,100300,75482
808,709,99,797,98900,75486
700,504,196,581,91000,75487
236,190,46,-,125000,75488
425,272,153,887,102500,75489
906,791,115,1077,129400,75490
1793,1360,433,621,136800,75491
184,163,21,669,128100,75492
126,84,42,625,55300,75493
3473,2670,803,779,114700,75494
2871,2363,508,1060,180100,75495
1270,1045,225,549,114400,75496
1479,1207,272,731,169400,75497
12874,7614,5260,695,95200,75501
9600,6021,3579,859,168600,75503
343,278,65,616,65800,75550
4100,3218,882,725,97600,75551
819,710,109,502,81600,75554
659,584,75,742,76900,75555
410,288,122,779,69800,75556
465,410,55,-,56700,75558
2033,1557,476,591,81100,75559
374,297,77,690,67200,75560
1953,1317,636,725,74300,75561
117,117,0,-,70200,75562
1891,1401,490,545,92700,75563
91,60,31,825,-,75565
374,353,21,879,128100,75566
1752,1358,394,895,89500,75567
1038,685,353,591,80300,75568
1339,725,614,904,111100,75569
3205,2121,1084,598,106800,75570
1072,941,131,540,105200,75571
1662,1279,383,574,65600,75572
40,40,0,-,83900,75573
734,590,144,578,80000,75574
6043,3588,2455,731,126900,75601
7140,4235,2905,758,82800,75602
2248,1856,392,732,97000,75603
11361,6205,5156,862,143000,75604
12213,7398,4815,905,181800,75605
1148,1018,130,-,98200,75630
1117,819,298,777,104900,75631
5182,3723,1459,731,108300,75633
2356,1780,576,773,76200,75638
1150,889,261,809,80300,75639
1767,1412,355,1051,118000,75640
52,40,12,-,85600,75641
26,26,0,-,-,75642
860,714,146,658,85400,75643
4528,3308,1220,739,117000,75644
3398,3031,367,932,149300,75645
4517,3311,1206,945,113000,75647
3373,2293,1080,858,168100,75650
756,702,54,791,116000,75651
4559,3116,1443,722,145100,75652
4616,3685,931,724,115800,75654
1554,1163,391,580,89200,75656
3249,2385,864,766,93100,75657
1049,803,246,605,93900,75661
8894,6417,2477,795,116800,75662
450,320,130,778,99000,75667
926,620,306,570,105600,75668
193,172,21,-,109600,75669
5931,3722,2209,686,68200,75670
5893,4541,1352,866,131100,75672
908,745,163,607,110700,75681
172,170,2,-,109400,75682
1480,1174,306,698,84800,75683
2413,1757,656,810,95500,75684
4829,3534,1295,743,90500,75686
1398,968,430,726,113900,75691
1530,1284,246,905,93200,75692
2366,1631,735,1030,151600,75693
12129,6868,5261,882,136900,75701
7660,3966,3694,714,73800,75702
16692,9095,7597,928,211700,75703
3088,2329,759,819,102700,75704
987,845,142,908,106200,75705
2841,1946,895,739,88600,75706
5388,3927,1461,1184,168600,75707
2393,1639,754,789,82100,75708
1885,1019,866,993,143600,75709
1366,1143,223,642,136600,75750
5692,3614,2078,804,90300,75751
2763,2339,424,827,123800,75752
2372,1766,606,880,155800,75754
1942,1314,628,748,121700,75755
1546,1374,172,848,94100,75756
4315,3851,464,760,193600,75757
3422,2624,798,746,119600,75758
25,21,4,-,55800,75759
1006,786,220,648,79500,75760
4648,3694,954,1125,171600,75762
2340,1961,379,728,114700,75763
70,57,13,538,57200,75764
2928,2442,486,782,130500,75765
9730,6613,3117,700,92100,75766
1198,990,208,673,110300,75770
7143,5561,1582,976,159500,75771
4862,3741,1121,775,134800,75773
1231,973,258,662,116500,75778
34,34,0,-,66300,75779
59,42,17,469,-,75780
3040,2411,629,743,103800,75783
301,278,23,790,88900,75784
3314,2474,840,815,87800,75785
71,49,22,-,-,75788
2802,2283,519,881,154200,75789
1512,1166,346,698,121600,75790
4365,3370,995,995,162900,75791
1111,748,363,821,83800,75792
5844,3515,2329,746,102600,75801
6052,4547,1505,747,89400,75803
1931,1442,489,700,86600,75831
9,0,9,-,-,75832
1263,933,330,794,121200,75833
4526,2755,1771,681,85900,75835
249,214,35,-,-,75838
2066,1723,343,802,76900,75839
2403,1739,664,716,117600,75840
2438,1957,481,676,80100,75844
1177,929,248,728,77700,75845
1061,806,255,691,78100,75846
762,561,201,510,70400,75847
55,41,14,-,57100,75848
33,22,11,631,37500,75849
288,281,7,-,162500,75850
861,726,135,738,117100,75851
425,333,92,1020,116100,75852
288,241,47,491,82000,75853
1093,903,190,717,78500,75855
22,22,0,-,-,75856
0,0,0,-,-,75858
823,703,120,1003,77300,75859
1981,1494,487,650,84700,75860
707,368,339,802,84600,75861
4199,3313,886,764,77900,75862
10642,6978,3664,820,101200,75901
12366,7435,4931,827,113900,75904
1491,971,520,694,89900,75925
442,357,85,918,78500,75926
339,296,43,-,61500,75928
705,572,133,-,111700,75929
750,674,76,772,71700,75930
900,816,84,766,95100,75931
573,528,45,828,98800,75932
444,444,0,-,48800,75933
68,40,28,-,68000,75934
4827,3412,1415,565,74400,75935
326,276,50,1594,78900,75936
339,292,47,425,95700,75937
1046,895,151,723,99000,75938
1870,1256,614,492,65500,75939
2629,1964,665,587,83200,75941
67,67,0,-,-,75942
515,381,134,632,61100,75943
532,475,57,717,77700,75944
1338,898,440,833,109000,75946
2533,2270,263,547,146700,75948
2873,2177,696,696,83400,75949
5448,3751,1697,759,98000,75951
1083,852,231,714,63000,75954
3109,2404,705,647,110100,75956
274,263,11,-,78300,75959
305,284,21,-,44000,75960
6163,3132,3031,793,104600,75961
0,0,0,-,-,75962
6825,4224,2601,673,86100,75964
7504,3548,3956,780,179900,75965
1680,1392,288,588,68900,75966
682,528,154,641,57100,75968
1374,1195,179,718,108100,75969
2407,1880,527,525,87200,75972
1069,919,150,470,66600,75973
1236,920,316,613,72000,75974
1402,1068,334,546,88400,75975
249,118,131,327,106800,75976
254,208,46,663,67600,75977
51,45,6,-,135400,75978
3525,2875,650,719,81000,75979
1043,816,227,781,81200,75980
10116,8344,1772,1354,177900,76001
9646,8086,1560,1812,171900,76002
11700,2997,8703,949,238400,76006
5796,5175,621,1483,309600,76008
6902,5465,1437,892,106000,76009
17389,5693,11696,873,92100,76010
9626,1939,7687,889,113200,76011
10342,6310,4032,981,186300,76012
13193,6820,6373,909,174300,76013
10883,5580,5303,1148,107700,76014
6267,3053,3214,1131,135100,76015
11245,8949,2296,1422,185600,76016
16972,11321,5651,1102,166700,76017
9477,6809,2668,1408,134900,76018
10119,7588,2531,849,147800,76020
15378,8583,6795,1049,217600,76021
5722,2942,2780,1106,152100,76022
2325,1749,576,1014,143700,76023
24119,18758,5361,1210,180000,76028
5848,4468,1380,865,95500,76031
9831,6134,3697,906,125300,76033
8886,8554,332,1865,488500,76034
605,582,23,1264,284300,76035
8483,6338,2145,1212,168500,76036
14872,6211,8661,1192,183500,76039
11478,5158,6320,908,170200,76040
161,138,23,-,103600,76041
2776,1875,901,1018,204600,76043
1484,1156,328,874,189900,76044
9437,6392,3045,870,148200,76048
11174,9218,1956,967,205800,76049
2218,1801,417,916,163100,76050
20081,10812,9269,1278,294400,76051
7209,6533,676,1484,264300,76052
10770,5978,4792,1054,145800,76053
4371,3784,587,1378,231600,76054
1008,750,258,798,78600,76055
6115,4894,1221,909,124000,76058
1569,594,975,842,106600,76059
2749,2050,699,957,200400,76060
20,20,0,-,-,76061
23178,17669,5509,1366,234900,76063
547,446,101,942,175900,76064
11755,9692,2063,1127,222600,76065
1053,850,203,543,169400,76066
6865,4627,2238,766,88500,76067
268,268,0,-,220000,76070
1321,988,333,877,153500,76071
1944,1651,293,1055,147100,76073
154,154,0,-,-,76077
3143,2694,449,1161,150100,76078
6392,5113,1279,987,147300,76082
2337,1849,488,951,109300,76084
3572,3007,565,795,207700,76085
8157,4246,3911,1038,124500,76086
9640,8536,1104,1268,231400,76087
4048,3184,864,986,208000,76088
9165,8434,731,1445,657300,76092
666,424,242,758,92500,76093
3542,1085,2457,1343,232400,76102
5056,3060,1996,802,93300,76103
6306,2625,3681,869,64300,76104
6566,3346,3220,805,61500,76105
10292,5179,5113,890,79300,76106
14065,6881,7184,1092,274200,76107
15336,10338,4998,998,140200,76108
9737,5455,4282,1159,430700,76109
10378,6109,4269,871,115900,76110
6641,4034,2607,923,88800,76111
16491,8063,8428,854,109400,76112
8893,5127,3766,943,90400,76114
5847,2894,2953,846,75500,76115
21506,7923,13583,911,180100,76116
10270,5630,4640,898,99100,76117
5521,4198,1323,924,162400,76118
14423,7367,7056,869,70700,76119
7191,2930,4261,963,149900,76120
10647,8257,2390,1552,161500,76123
8496,6955,1541,1139,195700,76126
62,7,55,1707,-,76127
0,0,0,-,-,76129
12313,8887,3426,1456,173000,76131
12711,4018,8693,989,291500,76132
18264,11429,6835,1049,125000,76133
8320,4945,3375,995,108200,76134
8152,5553,2599,927,145400,76135
19982,12301,7681,1273,159300,76137
9606,6639,2967,1138,102600,76140
7775,6241,1534,1382,121500,76148
2888,0,2888,1114,-,76155
4379,2498,1881,862,66900,76164
3618,2162,1456,1285,222200,76177
19425,14576,4849,1469,176200,76179
14390,6840,7550,1112,159100,76180
11071,9102,1969,1163,217800,76182
9927,1969,7958,869,154900,76201
7548,2746,4802,1064,209500,76205
5431,3445,1986,1136,216500,76207
8036,5212,2824,1173,248600,76208
9122,4285,4837,1023,159500,76209
14656,11295,3361,1375,214300,76210
1056,831,225,754,155200,76225
8292,7575,717,1620,382000,76226
10543,8279,2264,1641,210900,76227
355,302,53,675,102300,76228
4111,2947,1164,897,131100,76230
1201,908,293,1032,146400,76233
5895,4478,1417,1042,165700,76234
151,112,39,659,89600,76238
514,404,110,832,161700,76239
10822,6693,4129,852,142200,76240
24115,19027,5088,1655,237400,76244
812,661,151,668,89900,76245
4246,3449,797,1217,175600,76247
12983,10497,2486,1325,342900,76248
2852,2218,634,1177,169100,76249
404,353,51,1100,184400,76250
267,201,66,870,144800,76251
1052,807,245,863,184300,76252
96,69,27,550,-,76253
2294,1572,722,629,101000,76255
2643,1813,830,1044,182500,76258
1861,1385,476,1257,168200,76259
100,76,24,-,73600,76261
12350,9625,2725,1238,355400,76262
53,27,26,-,-,76263
650,468,182,814,120600,76264
641,496,145,694,99000,76265
5365,4118,1247,1158,170100,76266
98,71,27,1167,42700,76268
649,457,192,439,130100,76270
591,481,110,1033,159700,76271
1550,1269,281,687,121900,76272
3579,2706,873,901,143000,76273
6485,3050,3435,663,52100,76301
4980,2922,2058,786,110100,76302
1849,1605,244,618,118400,76305
5744,3443,2301,803,75500,76306
8048,4700,3348,822,139300,76308
5186,3285,1901,774,92100,76309
7214,4989,2225,818,135200,76310
635,6,629,1238,-,76311
839,609,230,611,81800,76351
4883,3305,1578,843,106000,76354
224,178,46,692,63800,76357
1609,1120,489,667,40800,76360
157,135,22,414,29200,76363
60,40,20,675,75000,76364
1784,1407,377,719,86600,76365
722,568,154,685,96800,76366
3672,3037,635,947,90300,76367
119,107,12,-,28200,76370
544,451,93,516,48300,76371
446,321,125,446,86900,76372
83,83,0,-,-,76373
1648,1207,441,620,56500,76374
317,292,25,398,58000,76377
176,135,41,633,97500,76379
1492,1069,423,444,69500,76380
5029,3149,1880,638,73800,76384
103,81,22,675,29800,76388
497,415,82,632,123100,76389
10265,5949,4316,848,148500,76401
0,0,0,-,-,76402
3016,2440,576,603,68700,76424
4205,2784,1421,918,146500,76426
294,189,105,703,66000,76427
79,38,41,-,-,76429
888,749,139,567,83000,76430
1174,943,231,984,96400,76431
503,454,49,912,114100,76432
567,508,59,1008,269200,76433
194,180,14,-,40000,76435
88,75,13,-,285400,76436
2077,1618,459,606,74500,76437
2940,2361,579,546,108000,76442
932,725,207,625,83900,76443
1513,1155,358,524,90100,76444
108,101,7,-,70700,76445
2696,2173,523,680,113800,76446
1894,1420,474,595,82600,76448
978,811,167,600,124800,76449
5071,4115,956,704,97700,76450
26,12,14,-,-,76452
569,516,53,745,179800,76453
551,397,154,450,61300,76454
349,299,50,586,78300,76455
1318,972,346,717,124800,76457
2012,1673,339,759,83700,76458
106,100,6,-,56400,76459
134,110,24,-,181900,76460
1140,1030,110,969,201400,76462
183,161,22,967,67300,76463
233,174,59,532,44400,76464
146,92,54,-,-,76466
37,37,0,-,56300,76469
1195,851,344,315,55100,76470
685,585,100,618,54100,76471
717,548,169,951,112300,76472
97,88,9,-,118900,76474
334,257,77,695,88600,76475
989,866,123,892,177900,76476
54,36,18,-,-,76481
485,318,167,453,66700,76483
375,298,77,721,145000,76484
468,400,68,656,84800,76486
1034,886,148,1102,157400,76487
45,40,5,-,-,76490
141,125,16,725,49200,76491
6236,3836,2400,709,117400,76501
14826,9975,4851,1086,159300,76502
8929,3566,5363,839,93100,76504
0,0,0,-,-,76508
736,559,177,599,93100,76511
13268,8901,4367,844,167400,76513
543,465,78,800,85900,76518
115,106,9,-,201200,76519
2944,1963,981,669,91400,76520
13561,7817,5744,892,115100,76522
0,0,0,-,-,76523
1038,918,120,903,130800,76524
437,335,102,700,100300,76525
1233,848,385,770,168600,76527
6123,4432,1691,738,107200,76528
740,543,197,739,146100,76530
1928,1647,281,769,130100,76531
961,684,277,680,129800,76534
1805,1360,445,1176,166900,76537
303,220,83,1229,122400,76538
3132,2743,389,842,164900,76539
7762,2164,5598,695,69300,76541
17384,9806,7578,1040,147300,76542
11899,4303,7596,834,89400,76543
3793,42,3751,1232,84400,76544
10363,6319,4044,877,190200,76548
17267,8670,8597,1072,133300,76549
4950,3544,1406,772,131800,76550
714,523,191,922,119000,76554
542,452,90,605,100600,76556
1854,1543,311,716,133900,76557
2062,1125,937,903,134300,76559
400,298,102,763,82700,76561
41,41,0,-,-,76565
124,87,37,-,184400,76566
3723,2256,1467,723,99000,76567
792,604,188,942,85600,76569
848,668,180,643,61300,76570
2693,2251,442,715,279900,76571
9,4,5,-,-,76573
6531,4284,2247,861,152600,76574
1194,898,296,829,147100,76577
456,379,77,1033,162900,76578
1524,1172,352,1045,116600,76579
0,0,0,-,-,76596
0,0,0,-,-,76597
0,0,0,-,-,76598
0,0,0,-,-,76599
334,292,42,750,148100,76621
400,307,93,790,99200,76622
56,51,5,-,71900,76623
734,535,199,764,110300,76624
423,312,111,845,94300,76626
521,476,45,850,85200,76627
19,17,2,-,-,76628
714,459,255,632,82300,76629
390,344,46,942,132900,76630
181,154,27,1018,75000,76631
531,429,102,1078,73400,76632
1867,1637,230,956,197800,76633
2847,2211,636,806,128000,76634
403,315,88,613,60200,76635
556,460,96,711,123200,76636
239,189,50,510,101400,76637
1125,957,168,888,220400,76638
584,387,197,525,86000,76639
1220,865,355,891,79400,76640
646,507,139,724,84100,76641
2408,1780,628,690,96100,76642
5164,3813,1351,1126,159600,76643
3606,2188,1418,766,87500,76645
1003,741,262,731,97600,76648
261,232,29,733,93800,76649
54,46,8,-,65000,76650
1237,838,399,840,98200,76651
499,434,65,820,88100,76652
440,352,88,669,121500,76653
55,50,5,-,80000,76654
3024,2550,474,1007,174600,76655
722,575,147,535,121400,76656
3443,2425,1018,1049,186400,76657
175,136,39,725,84000,76660
2293,1420,873,448,54200,76661
1262,953,309,775,88100,76664
981,666,315,651,106700,76665
118,101,17,745,110200,76666
3704,2699,1005,713,87100,76667
499,391,108,1000,101900,76670
734,592,142,765,98100,76671
478,354,124,683,100600,76673
106,97,9,-,91300,76676
74,33,41,819,-,76678
526,455,71,493,106800,76679
99,99,0,-,63500,76680
258,196,62,947,88300,76681
1020,762,258,865,93100,76682
20,6,14,-,-,76685
88,65,23,725,78300,76686
749,591,158,756,136900,76687
1277,1053,224,843,117800,76689
371,253,118,803,84300,76690
2366,1819,547,829,115200,76691
4116,3202,914,656,101400,76692
540,329,211,746,98400,76693
724,143,581,992,233800,76701
3173,1068,2105,670,83900,76704
10477,6051,4426,746,95300,76705
13206,5207,7999,855,111400,76706
5015,2367,2648,816,71700,76707
9550,5712,3838,868,132500,76708
10653,5212,5441,764,130500,76710
3265,1729,1536,982,64300,76711
9922,6939,2983,967,195600,76712
0,0,0,-,-,76798
9155,6216,2939,774,96800,76801
1900,1429,471,761,119800,76802
75,64,11,-,339100,76820
1737,1257,480,598,79300,76821
1105,937,168,471,79100,76823
11,0,11,-,-,76824
2658,1915,743,720,83100,76825
159,138,21,-,113600,76827
81,74,7,-,109600,76828
19,19,0,-,-,76831
219,142,77,1091,153600,76832
2243,1551,692,690,64800,76834
12,12,0,-,-,76836
595,379,216,715,82000,76837
17,17,0,-,-,76841
70,59,11,-,323400,76842
1293,1022,271,400,104600,76844
102,82,20,-,225000,76845
37,37,0,-,-,76848
1650,1208,442,691,137500,76849
103,83,20,667,123200,76852
530,411,119,756,89600,76853
157,122,35,-,-,76854
1478,1032,446,817,152600,76856
746,591,155,509,72800,76857
101,84,17,-,50000,76858
911,562,349,613,55600,76859
608,443,165,678,107700,76861
73,50,23,-,233300,76862
295,258,37,664,158900,76864
62,55,7,-,128800,76865
179,161,18,529,150700,76866
36,24,12,-,-,76869
82,66,16,675,91100,76870
312,240,72,519,76000,76871
387,327,60,685,118100,76872
22,18,4,-,-,76873
0,0,0,-,-,76874
242,181,61,885,106500,76875
1469,945,524,696,99700,76877
681,450,231,629,102800,76878
106,94,12,-,117300,76882
48,36,12,-,32500,76884
101,91,10,-,330000,76885
70,70,0,-,225000,76887
66,53,13,-,151000,76888
348,285,63,-,134200,76890
11403,7688,3715,926,112700,76901
11842,7112,4730,745,81700,76903
14077,8066,6011,871,194000,76904
4404,2845,1559,1005,131000,76905
0,0,0,-,-,76908
42,31,11,-,81800,76930
1148,793,355,844,94700,76932
565,406,159,688,82600,76933
368,308,60,758,86000,76934
633,607,26,-,171500,76935
1105,871,234,474,69800,76936
14,14,0,-,-,76937
5,5,0,-,-,76939
53,53,0,-,-,76940
548,448,100,1016,141700,76941
1358,968,390,550,82200,76943
835,641,194,566,72100,76945
0,0,0,-,-,76949
1494,999,495,641,95700,76950
462,398,64,918,64700,76951
68,29,39,-,-,76953
63,51,12,-,-,76955
0,0,0,-,-,76957
67,52,15,-,189600,76958
3739,731,3008,1432,240600,77002
4544,1969,2575,1135,295700,77003
13036,4368,8668,969,271100,77004
10118,7421,2697,1753,1002100,77005
12862,4572,8290,1385,457800,77006
19602,10312,9290,1675,409000,77007
16262,9594,6668,1264,419500,77008
13848,7728,6120,893,269400,77009
576,82,494,3161,-,77010
5831,2610,3221,651,85900,77011
5997,2387,3610,736,76700,77012
5937,2280,3657,910,87800,77013
11583,4940,6643,969,139200,77014
17306,9056,8250,890,102000,77015
9741,6017,3724,846,65700,77016
9953,5254,4699,848,96000,77017
11067,7683,3384,867,379000,77018
10935,5643,5292,1659,560000,77019
8454,3827,4627,698,77900,77020
10904,4227,6677,896,94400,77021
9398,4282,5116,740,93800,77022
9744,4465,5279,786,121200,77023
15173,9987,5186,1557,938100,77024
12819,5310,7509,1231,440200,77025
7995,3288,4707,676,63000,77026
9245,3108,6137,1532,713200,77027
5654,3168,2486,836,58700,77028
5697,3398,2299,789,73900,77029
4876,2028,2848,1510,521100,77030
6000,2700,3300,886,143300,77031
4210,1535,2675,902,82100,77032
8996,5609,3387,897,64100,77033
12371,5410,6961,934,116600,77034
14126,5962,8164,864,210100,77035
26917,4951,21966,785,142800,77036
5428,3855,1573,925,103500,77037
8731,4787,3944,941,111700,77038
7570,4674,2896,882,95000,77039
17924,10000,7924,986,162200,77040
11484,8618,2866,1381,176000,77041
19198,4805,14393,1041,244000,77042
9200,5381,3819,1068,228700,77043
13456,10217,3239,1231,180100,77044
10475,6930,3545,932,80400,77045
678,201,477,1815,343000,77046
9816,7138,2678,1218,134300,77047
5753,3656,2097,749,75700,77048
10639,7076,3563,1063,141800,77049
1428,1105,323,744,81100,77050
6427,2604,3823,805,76500,77051
8613,5572,3041,1164,87200,77053
12614,1950,10664,1152,137000,77054
15178,6626,8552,946,428200,77055
11003,4695,6308,1573,630500,77056
19836,6544,13292,1106,339100,77057
8210,2354,5856,1054,178500,77058
5832,5301,531,1648,300400,77059
13837,3276,10561,794,99100,77060
8664,3048,5616,774,120500,77061
9601,7536,2065,1158,191600,77062
18455,4564,13891,1039,221400,77063
16364,9418,6946,1243,155300,77064
15104,7033,8071,1126,160700,77065
10650,7283,3367,1169,135500,77066
10187,4118,6069,879,110100,77067
3940,2706,1234,1072,201200,77068
8020,4441,3579,1215,242900,77069
20053,10010,10043,1247,183700,77070
10040,5322,4718,917,134800,77071
18096,8495,9601,973,102400,77072
13140,7415,5725,1026,131000,77073
13181,4405,8776,863,123600,77074
13042,7146,5896,934,135800,77075
9816,4699,5117,913,98500,77076
26605,9428,17177,1205,284400,77077
4672,2760,1912,909,76200,77078
12159,7630,4529,1321,485800,77079
15243,6541,8702,938,191400,77080
18656,980,17676,803,270800,77081
22334,7774,14560,1136,155000,77082
22434,14821,7613,1017,138800,77083
34864,21540,13324,1228,151800,77084
5228,3626,1602,1104,113800,77085
8025,4735,3290,959,107600,77086
11089,5535,5554,772,89800,77087
17396,10777,6619,883,108200,77088
16997,11121,5876,1103,147500,77089
15892,3463,12429,964,143300,77090
9785,3945,5840,790,116400,77091
14105,4804,9301,875,166100,77092
12591,7285,5306,826,79100,77093
3277,2725,552,1936,402400,77094
24175,18325,5850,1245,205000,77095
13595,6639,6956,972,345300,77096
8130,2243,5887,1588,499500,77098
17046,6045,11001,922,112500,77099
0,0,0,-,-,77201
10510,5325,5185,873,122700,77301
6338,5237,1101,1067,163100,77302
6707,4969,1738,1072,124900,77303
12431,7052,5379,1065,219300,77304
3974,3023,951,946,98700,77306
7993,6973,1020,1105,296400,77316
5806,4434,1372,1163,209600,77318
9105,5615,3490,892,131800,77320
46,46,0,-,-,77326
7795,5323,2472,739,95000,77327
4781,3727,1054,789,113400,77328
2784,2418,366,781,150100,77331
121,75,46,-,-,77334
1176,1019,157,1002,100900,77335
4400,3496,904,1079,163800,77336
14282,7733,6549,1004,139900,77338
15474,10077,5397,1298,182800,77339
10986,4319,6667,879,171700,77340
0,0,0,-,-,77342
9508,8421,1087,1476,281700,77345
20953,17458,3495,1398,193800,77346
70,68,2,-,43300,77350
12016,9107,2909,727,109700,77351
12171,9903,2268,1186,243700,77354
9386,7905,1481,1096,246800,77355
11315,9241,2074,1360,248500,77356
7659,5613,2046,846,123200,77357
1824,1358,466,916,154500,77358
171,171,0,-,-,77359
2210,1739,471,863,87800,77360
1733,1519,214,1643,171700,77362
1310,1110,200,1000,156500,77363
818,711,107,835,114700,77364
11176,8444,2732,1116,188600,77365
67,38,29,-,-,77367
68,68,0,-,-,77368
238,215,23,-,66900,77369
2510,1888,622,573,67200,77371
4222,3199,1023,943,99600,77372
19975,14203,5772,1369,147200,77373
173,128,45,-,44800,77374
17002,12041,4961,1171,183600,77375
249,249,0,-,15400,77376
11950,9926,2024,1441,255000,77377
5157,3844,1313,964,122000,77378
27041,21184,5857,1271,244800,77379
11686,4732,6954,1318,258100,77380
14137,10611,3526,1374,350300,77381
13204,9553,3651,1811,408200,77382
7163,4588,2575,1289,313300,77384
8600,6833,1767,1250,215800,77385
17158,13022,4136,1467,220800,77386
16553,12627,3926,1566,187400,77388
11245,9019,2226,1583,314200,77389
17960,10401,7559,1177,150000,77396
7008,5809,1199,1612,837300,77401
15096,13113,1983,1308,286100,77406
15337,12906,2431,1421,227100,77407
12,12,0,-,-,77412
8646,5191,3455,824,113900,77414
17,17,0,-,-,77415
1018,651,367,945,108900,77417
4115,3030,1085,819,235800,77418
433,398,35,-,130900,77419
906,711,195,824,113000,77420
4834,3896,938,903,107300,77422
3592,2724,868,922,206000,77423
781,556,225,1171,189600,77426
0,0,0,-,-,77428
28386,24171,4215,1368,234700,77429
784,696,88,-,127600,77430
37,15,22,-,-,77432
24884,21226,3658,1517,257800,77433
1624,1233,391,715,54700,77434
1545,1265,280,918,161500,77435
13,13,0,-,-,77436
6137,3979,2158,744,153600,77437
23,0,23,-,-,77440
3670,3548,122,664,429100,77441
361,313,48,-,106000,77442
53,53,0,-,-,77443
245,178,67,731,-,77444
4579,2463,2116,861,124700,77445
719,130,589,1034,168300,77446
4842,4009,833,1176,153600,77447
71,17,54,-,-,77448
34991,24254,10737,1492,153100,77449
24841,17443,7398,1374,257900,77450
25,23,2,-,63100,77451
98,41,57,670,-,77453
15,15,0,-,-,77454
794,702,92,679,123500,77455
596,511,85,-,86100,77456
199,190,9,-,130400,77457
61,36,25,-,-,77458
21874,18419,3455,1735,264200,77459
20,10,10,-,-,77460
3840,2984,856,857,145000,77461
76,44,32,764,136100,77464
2691,2180,511,751,111100,77465
167,94,73,974,111700,77466
13,0,13,-,-,77467
20,20,0,-,-,77468
15544,11270,4274,1112,215600,77469
179,144,35,-,54800,77470
13055,7258,5797,1006,142900,77471
31,10,21,-,-,77473
4507,3431,1076,824,167300,77474
335,335,0,-,84900,77475
71,61,10,-,309600,77476
13101,6057,7044,1225,159600,77477
9295,7093,2202,1468,285500,77478
28469,23961,4508,1818,358900,77479
2933,2401,532,889,113500,77480
8,2,6,-,-,77481
912,777,135,867,90700,77482
79,24,55,-,-,77483
3679,2779,900,827,193700,77484
1494,1027,467,790,137200,77485
2673,2071,602,1097,132900,77486
5379,3301,2078,721,106600,77488
11963,9010,2953,1333,124000,77489
9817,7868,1949,1336,198700,77493
35342,27491,7851,1620,343000,77494
15216,11111,4105,1474,198400,77498
10803,6580,4223,915,98000,77502
7910,4074,3836,915,100900,77503
8697,3534,5163,908,143500,77504
8300,5603,2697,1175,180700,77505
10954,4395,6559,826,77000,77506
0,0,0,-,-,77507
5374,4210,1164,899,168600,77510
16252,11372,4880,945,142400,77511
1778,1435,343,809,104600,77514
10939,7369,3570,873,118700,77515
1767,1682,85,1119,190800,77517
3631,2239,1392,842,101000,77518
405,392,13,-,65100,77519
12442,7001,5441,891,84500,77520
19650,12189,7461,952,142200,77521
6874,5951,923,897,225000,77523
9249,6184,3065,889,95300,77530
5969,3223,2746,893,118500,77531
10387,8240,2147,936,147200,77532
301,192,109,615,68600,77533
847,710,137,864,153900,77534
9885,7885,2000,878,108200,77535
10874,8247,2627,1252,159800,77536
336,309,27,788,111700,77538
15579,11217,4362,1006,162900,77539
6479,3787,2692,821,90300,77541
7192,5974,1218,1431,164900,77545
17894,13999,3895,1338,231300,77546
2624,1634,990,886,72000,77547
9837,4200,5637,863,154300,77550
8425,3390,5035,974,166100,77551
3733,2424,1309,1058,281100,77554
235,223,12,-,189000,77560
39,39,0,-,114800,77561
3676,2859,817,949,102600,77562
4015,2849,1166,889,148000,77563
637,562,75,-,97500,77564
3589,1878,1711,1231,245300,77565
11272,7763,3509,1158,172100,77566
5660,3746,1914,893,99700,77568
13296,9940,3356,1017,140400,77571
29602,22140,7462,1346,237500,77573
5765,4181,1584,858,108300,77575
572,528,44,687,130400,77577
6011,5345,666,1510,244800,77578
220,220,0,-,331800,77580
16904,13127,3777,1171,217000,77581
9146,7046,2100,747,185800,77583
29612,21626,7986,1440,236700,77584
330,296,34,-,18700,77585
8824,5683,3141,1111,231900,77586
4615,2640,1975,829,93100,77587
11086,6610,4476,908,101500,77590
5380,2824,2556,975,130100,77591
264,225,39,-,-,77597
11012,2331,8681,1061,143100,77598
3188,2404,784,850,139300,77611
3252,2857,395,782,123200,77612
449,338,111,728,109900,77613
179,141,38,-,-,77614
309,267,42,580,84400,77615
305,288,17,-,80000,77616
25,25,0,-,-,77617
5992,4235,1757,933,110100,77619
441,372,69,1056,114900,77622
144,129,15,-,102800,77623
288,233,55,-,93000,77624
3393,2856,537,762,81800,77625
8789,6225,2564,862,138700,77627
265,228,37,499,103400,77629
11536,7612,3924,815,100100,77630
8649,7276,1373,853,120700,77632
6341,3878,2463,839,67300,77640
13815,7454,6361,757,64200,77642
866,643,223,804,191100,77650
5006,3642,1364,935,161100,77651
156,137,19,-,105800,77655
6076,4832,1244,666,98800,77656
7666,5883,1783,845,161300,77657
1709,1381,328,858,164300,77659
359,317,42,-,83200,77660
243,171,72,-,-,77661
9748,7934,1814,748,91000,77662
574,505,69,-,175300,77663
934,869,65,-,90700,77664
2364,1756,608,904,118200,77665
5024,2763,2261,727,53300,77701
1130,565,565,840,83500,77702
4984,2502,2482,689,62600,77703
10775,6697,4078,718,83300,77705
13034,7247,5787,908,166900,77706
6714,4672,2042,950,107200,77707
4867,2447,2420,850,109000,77708
5751,3775,1976,1103,150500,77713
6126,963,5163,826,106900,77801
10958,5602,5356,950,170400,77802
9546,5582,3964,837,84500,77803
3425,2053,1372,944,163800,77807
4546,4034,512,987,214000,77808
1086,948,138,564,250400,77830
1218,1063,155,830,120000,77831
10071,7498,2573,835,177000,77833
1170,881,289,-,120300,77835
4493,3607,886,751,120900,77836
671,460,211,679,106000,77837
21152,2707,18445,908,177900,77840
23285,15568,7717,1158,240100,77845
459,388,71,725,96900,77853
43,10,33,-,-,77855
2064,1623,441,805,154800,77856
301,231,70,590,215000,77857
2427,1853,574,642,91800,77859
902,778,124,771,142700,77861
2829,1981,848,696,111800,77864
726,672,54,625,117200,77865
58,51,7,-,83200,77867
4589,3253,1336,719,121700,77868
1153,876,277,786,142600,77871
697,635,62,831,109300,77872
517,397,120,553,141300,77873
22,7,15,-,-,77876
125,83,42,-,-,77878
2096,1690,406,717,88400,77879
512,431,81,-,149600,77880
14697,7804,6893,842,94800,77901
10416,7337,3079,987,183900,77904
5359,4674,685,984,144600,77905
77,59,18,529,83000,77950
686,442,244,664,43100,77951
3802,2624,1178,846,112700,77954
3068,1993,1075,797,102400,77957
56,56,0,-,-,77960
145,107,38,-,113900,77961
1209,890,319,907,112200,77962
1939,1628,311,584,119100,77963
3283,2367,916,681,176500,77964
1117,1016,101,597,190100,77968
38,38,0,-,-,77969
131,82,49,844,74600,77970
408,257,151,759,82200,77971
0,0,0,-,-,77973
147,119,28,1031,176000,77974
680,497,183,765,125300,77975
43,37,6,-,195800,77976
243,163,80,612,63900,77977
288,168,120,957,86500,77978
6182,4375,1807,723,109600,77979
289,181,108,758,207400,77982
764,581,183,701,152700,77983
1587,1303,284,765,184000,77984
108,95,13,-,78400,77987
156,142,14,-,121000,77988
311,215,96,777,81300,77990
75,55,20,1063,82300,77991
57,33,24,-,1020800,77993
186,151,35,-,-,77994
3767,2903,864,666,112700,77995
0,0,0,-,-,78001
1857,1311,546,795,88300,78002
3708,2979,729,911,155100,78003
399,372,27,-,355700,78004
219,219,0,-,84300,78005
11466,8214,3252,1148,326200,78006
56,34,22,725,119400,78007
176,136,40,-,-,78008
2779,2285,494,1036,134600,78009
1282,1037,245,851,132500,78010
600,498,102,587,48900,78011
130,123,7,-,69700,78012
1892,1547,345,889,180600,78013
1780,1208,572,626,85200,78014
5019,4416,603,1516,425300,78015
3501,2726,775,659,112600,78016
1044,557,487,781,61800,78017
391,288,103,675,53700,78019
73,69,4,-,-,78021
1338,996,342,815,100000,78022
8931,8168,763,1521,296100,78023
482,368,114,-,347600,78024
1804,1415,389,858,129800,78025
1895,1396,499,951,90300,78026
111,111,0,-,333600,78027
16657,11741,4916,844,173200,78028
0,0,0,-,-,78029
626,536,90,573,100300,78039
11731,5171,6560,650,75700,78040
14111,7586,6525,831,155100,78041
12402,6961,5441,801,98000,78043
116,76,40,-,-,78044
18703,14247,4456,1162,168500,78045
16145,11661,4484,832,90400,78046
155,91,64,-,142000,78050
2090,1632,458,759,98900,78052
573,454,119,635,177500,78055
680,589,91,-,378100,78056
282,261,21,-,153000,78057
450,387,63,475,306400,78058
1924,1765,159,791,151500,78059
31,31,0,-,-,78060
3181,2162,1019,644,76700,78061
3646,3206,440,876,164800,78063
5398,3885,1513,931,150000,78064
3274,2426,848,700,84800,78065
202,119,83,-,258000,78066
207,184,23,-,103500,78067
1715,1438,277,691,89600,78069
5687,5164,523,1250,291500,78070
1062,799,263,710,104000,78071
160,126,34,831,100900,78072
2221,1619,602,771,78900,78073
59,41,18,-,111900,78075
4049,2841,1208,487,69300,78076
2214,2028,186,938,214400,78101
7209,4377,2832,909,92400,78102
38,29,9,-,-,78104
166,79,87,-,-,78107
11655,9517,2138,1711,213100,78108
11721,8394,3327,1216,148300,78109
2170,1850,320,1003,84100,78112
1106,839,267,925,163100,78113
7451,5825,1626,851,156200,78114
88,88,0,-,217600,78116
207,175,32,740,208900,78117
1079,767,312,808,88000,78118
1854,1349,505,623,88800,78119
4327,3908,419,1048,253500,78121
185,151,34,-,135600,78122
1101,761,340,866,147100,78123
2248,1881,367,972,169800,78124
34,26,8,-,-,78125
26343,16802,9541,1124,188400,78130
9812,8435,1377,1097,355200,78132
7385,5998,1387,986,216100,78133
1229,795,434,832,75700,78140
202,171,31,725,90500,78141
45,31,14,-,75000,78142
39,39,0,-,68100,78143
43,19,24,-,-,78144
53,34,19,-,116700,78145
163,105,58,815,65000,78146
658,456,202,764,148800,78147
7860,4469,3391,965,166000,78148
0,0,0,-,-,78150
495,356,139,668,104900,78151
657,607,50,1098,201200,78152
13825,9745,4080,1265,192700,78154
17460,12558,4902,849,144000,78155
368,289,79,471,63900,78159
1671,1334,337,884,142900,78160
301,272,29,-,96100,78161
113,90,23,2589,76000,78162
3738,3525,213,1083,348500,78163
1362,1168,194,695,115800,78164
16314,7757,8557,786,99000,78201
3848,1886,1962,804,73000,78202
1976,948,1028,775,64500,78203
4279,2440,1839,858,85700,78204
949,149,800,591,360100,78205
15351,7274,8077,663,57700,78207
1552,539,1013,755,80100,78208
17823,10239,7584,1096,346800,78209
12469,6700,5769,788,87900,78210
9157,5890,3267,834,67800,78211
10805,5150,5655,817,157900,78212
16098,7803,8295,893,121900,78213
7609,4380,3229,759,74000,78214
1783,96,1687,1387,346900,78215
17177,6266,10911,942,179900,78216
13786,5721,8065,925,135400,78217
12458,5962,6496,901,105100,78218
5785,2760,3025,946,84600,78219
5381,3011,2370,870,71900,78220
11535,6915,4620,813,82400,78221
7472,5303,2169,893,111900,78222
17808,10422,7386,831,91100,78223
5692,3433,2259,926,89500,78224
4174,2860,1314,797,68500,78225
2457,984,1473,698,68900,78226
14396,7629,6767,869,87200,78227
18437,10868,7569,824,91500,78228
13932,2356,11576,930,150300,78229
18638,9102,9536,994,218600,78230
3304,2367,937,1180,276500,78231
15536,8960,6576,1140,234000,78232
16920,9677,7243,1081,130300,78233
953,57,896,1732,-,78234
531,0,531,1201,-,78235
402,0,402,1750,-,78236
11073,7099,3974,806,61300,78237
8974,4147,4827,994,130500,78238
9020,6539,2481,1156,133900,78239
23610,8391,15219,1006,163400,78240
8855,4981,3874,880,76000,78242
0,0,0,-,-,78243
9422,6561,2861,1219,121300,78244
21675,14880,6795,1163,148900,78245
17408,13298,4110,1228,169800,78247
5539,4308,1231,1306,320300,78248
20073,11050,9023,1196,188900,78249
18794,14269,4525,1172,143700,78250
20144,11026,9118,1099,161800,78251
2743,2028,715,1227,118700,78252
12812,10359,2453,1381,234900,78253
17020,13622,3398,1262,187300,78254
4360,3822,538,1447,312100,78255
4114,1672,2442,1297,412100,78256
2754,1537,1217,1188,588400,78257
16079,10707,5372,1379,320700,78258
9101,6540,2561,1294,257500,78259
8692,7865,827,1769,312500,78260
5735,4713,1022,1468,288800,78261
1620,1444,176,869,175200,78263
3089,2551,538,877,84900,78264
2304,2201,103,1921,378200,78266
318,262,56,985,80000,78330
9349,6089,3260,720,75700,78332
0,0,0,-,-,78335
4213,2477,1736,942,127300,78336
16,5,11,-,-,78338
163,127,36,-,64100,78339
188,164,24,675,85900,78340
808,560,248,477,41400,78341
132,79,53,839,29700,78342
1486,1100,386,749,83400,78343
123,88,35,-,95300,78344
177,170,7,-,62400,78349
125,89,36,838,33800,78351
111,111,0,-,32100,78352
140,116,24,-,63200,78353
1992,1231,761,626,65300,78355
869,533,336,722,57100,78357
274,171,103,921,61700,78358
645,423,222,822,61000,78359
1735,1262,473,496,67900,78361
3641,2578,1063,1138,136900,78362
10459,5290,5169,821,88400,78363
3242,2379,863,727,62600,78368
131,95,36,-,41400,78369
1575,1150,425,804,102000,78370
117,82,35,648,75000,78371
1597,1206,391,906,92500,78372
2023,1236,787,1077,308100,78373
6197,4231,1966,1256,163500,78374
907,720,187,679,56700,78375
224,138,86,575,47200,78376
1245,837,408,639,86900,78377
482,398,84,1077,70000,78379
7783,5410,2373,780,74000,78380
8144,6591,1553,871,165400,78382
1588,1458,130,636,122200,78383
1670,897,773,706,40500,78384
183,66,117,525,27500,78385
3230,2199,1031,661,66500,78387
538,449,89,894,65800,78389
1895,1239,656,753,78300,78390
73,64,9,-,53800,78391
817,615,202,852,76500,78393
1740,373,1367,746,62600,78401
137,64,73,1375,163900,78402
6990,3510,3480,880,102000,78404
5293,2757,2536,703,54400,78405
383,276,107,1139,47100,78406
1043,552,491,917,62800,78407
4271,1920,2351,693,73700,78408
967,512,455,590,78100,78409
9479,6419,3060,1067,150900,78410
10075,6030,4045,1004,116900,78411
14775,6748,8027,1022,122500,78412
15026,8343,6683,1137,172000,78413
14416,9235,5181,1202,198300,78414
13442,7997,5445,945,96700,78415
5091,3044,2047,858,71600,78416
1328,927,401,708,90900,78417
12273,7499,4774,1062,193700,78418
161,0,161,1680,-,78419
20913,10936,9977,683,101900,78501
6390,4010,2380,852,95800,78503
17936,12369,5567,868,148800,78504
9539,7184,2355,538,55700,78516
17963,10852,7111,637,85300,78520
25264,14873,10391,708,71400,78521
12619,9236,3383,853,109200,78526
217,136,81,820,60000,78535
93,80,13,-,58900,78536
12137,9321,2816,550,55000,78537
3091,2306,785,494,53700,78538
11164,6432,4732,767,137300,78539
12817,6879,5938,744,88600,78541
16670,12762,3908,619,78600,78542
2491,1770,721,540,51300,78543
162,136,26,-,37100,78545
180,172,8,-,51000,78548
254,221,33,-,48400,78549
16638,8652,7986,716,78100,78550
12117,9515,2602,828,94500,78552
3523,2590,933,638,91800,78557
206,158,48,-,77000,78558
3945,2893,1052,617,62800,78559
1354,890,464,686,81100,78560
175,132,43,610,38100,78561
793,600,193,438,48900,78562
78,61,17,-,93000,78563
45,0,45,-,-,78564
51,28,23,-,-,78565
4881,3548,1333,741,99200,78566
156,142,14,-,47200,78567
1233,1045,188,611,65600,78569
9060,6541,2519,570,59500,78570
24134,16812,7322,757,88900,78572
9920,6680,3240,709,87100,78573
15443,11867,3576,713,77500,78574
3445,2669,776,841,123700,78575
2717,2036,681,653,61600,78576
21609,13211,8398,750,77600,78577
4233,2860,1373,705,127900,78578
1293,1077,216,648,57500,78579
3726,2560,1166,588,58000,78580
10702,7968,2734,533,68700,78582
2635,2218,417,486,70100,78583
4955,3518,1437,557,69700,78584
94,94,0,-,-,78585
15758,12230,3528,651,59700,78586
57,41,16,-,-,78588
10768,8362,2406,685,83000,78589
82,82,0,-,33600,78590
99,78,21,-,-,78591
259,196,63,583,36100,78592
1528,1060,468,614,56700,78593
552,474,78,-,46500,78594
1707,1334,373,545,58200,78595
18821,13530,5291,681,78300,78596
1527,1030,497,1075,304900,78597
45,45,0,-,117700,78598
8931,6787,2144,936,173000,78602
1991,1674,317,763,152500,78605
2029,1618,411,825,228600,78606
32,24,8,-,-,78607
192,118,74,-,206400,78608
877,679,198,765,129500,78609
12084,9203,2881,1238,241500,78610
4743,3473,1270,746,167100,78611
3919,3299,620,1214,157300,78612
26122,18193,7929,1355,275900,78613
237,184,53,918,173100,78614
398,314,84,947,170000,78615
2468,1775,693,1010,119400,78616
6501,4986,1515,1229,137400,78617
127,112,15,940,313500,78618
1556,1440,116,1537,465500,78619
5805,5014,791,1188,382900,78620
6957,5235,1722,891,156100,78621
79,72,7,-,50000,78622
353,303,50,-,239900,78623
8978,6322,2656,924,286600,78624
10458,7055,3403,1091,209500,78626
11546,8199,3347,1154,287500,78628
4284,2733,1551,764,128800,78629
1084,901,183,981,221100,78631
402,362,40,992,175000,78632
11702,10896,806,1675,299200,78633
9300,7549,1751,1348,189600,78634
128,94,34,-,369100,78635
1571,1151,420,825,238200,78636
892,734,158,1030,127700,78638
3306,2492,814,839,126800,78639
17378,12415,4963,1370,174800,78640
20060,16377,3683,1500,236400,78641
3639,3164,475,916,283100,78642
2253,1777,476,813,171200,78643
6000,3910,2090,963,140200,78644
4634,3749,885,1057,237100,78645
2964,1961,1003,749,111900,78648
506,376,130,900,157100,78650
2169,1369,800,1346,280100,78652
6846,5772,1074,1352,168300,78653
6978,4959,2019,838,197000,78654
1053,824,229,882,124600,78655
712,362,350,907,115900,78656
2565,2194,371,1082,320800,78657
970,893,77,729,147300,78659
29945,22182,7763,1355,214600,78660
136,101,35,975,79700,78661
863,741,122,992,171100,78662
340,287,53,-,-,78663
20075,11105,8970,1228,193900,78664
14639,10610,4029,1413,252000,78665
28183,10278,17905,997,159500,78666
4459,3912,547,994,455600,78669
51,40,11,-,120000,78670
354,325,29,-,158300,78671
571,519,52,-,129900,78672
137,126,11,-,-,78675
5476,4588,888,1273,257700,78676
8,8,0,-,-,78677
17105,13118,3987,1379,281200,78681
5571,1956,3615,1950,435400,78701
9287,4188,5099,1159,361500,78702
9479,5134,4345,1452,822800,78703
24115,8530,15585,1344,500600,78704
8559,902,7657,1238,444700,78705
0,0,0,-,-,78712
10347,6128,4219,1338,347900,78717
447,338,109,840,131800,78719
4278,2273,2005,1100,245500,78721
3107,1385,1722,1359,382700,78722
13000,5890,7110,1049,300600,78723
6458,3978,2480,1216,133400,78724
2620,2155,465,1504,160200,78725
5520,2456,3064,1189,447400,78726
13242,6546,6696,1274,271200,78727
9997,2665,7332,1132,228200,78728
12483,5292,7191,1250,261800,78729
3810,2283,1527,1329,700300,78730
12458,7251,5207,1266,606000,78731
5831,4403,1428,1496,519100,78732
2923,2594,329,1842,579500,78733
7424,5971,1453,1759,406800,78734
7352,3760,3592,1453,482400,78735
3278,2624,654,1490,330000,78736
5341,4889,452,1565,428000,78737
5977,4333,1644,1529,553000,78738
6476,6127,349,2309,447500,78739
21474,3309,18165,1082,194000,78741
256,148,108,1067,58300,78742
14857,6783,8074,1157,138500,78744
26330,11701,14629,1293,255200,78745
10867,7516,3351,1519,851900,78746
6558,4978,1580,1390,222700,78747
19385,11720,7665,1392,256200,78748
15428,9615,5813,1396,322400,78749
11724,7381,4343,1353,388900,78750
7605,2297,5308,1299,450000,78751
8188,2237,5951,1061,253800,78752
20121,7309,12812,1058,177300,78753
8192,4255,3937,1204,211000,78754
4336,2026,2310,1236,493200,78756
10720,5789,4931,1178,389000,78757
19976,5761,14215,1142,202200,78758
20454,9308,11146,1260,414600,78759
7193,5196,1997,657,82000,78801
79,79,0,-,-,78802
412,304,108,429,56700,78827
30,30,0,-,-,78828
306,244,62,722,29200,78829
259,215,44,770,46300,78830
1170,868,302,542,72800,78832
528,409,119,642,62500,78833
2555,1792,763,824,81800,78834
70,70,0,-,38000,78836
101,92,9,-,63500,78837
83,83,0,-,267700,78838
2672,1861,811,595,52300,78839
15257,9585,5672,719,96300,78840
35,0,35,-,-,78843
397,374,23,-,154500,78850
22,19,3,-,-,78851
15970,10503,5467,663,95200,78852
23,23,0,-,-,78860
3842,2813,1029,878,139100,78861
289,187,102,572,76600,78870
24,24,0,-,-,78871
544,386,158,557,44400,78872
738,621,117,925,119000,78873
255,181,74,-,99300,78877
61,55,6,-,111600,78879
586,468,118,460,68900,78880
696,570,126,718,64000,78881
140,131,9,-,-,78883
430,376,54,-,160100,78884
31,29,2,-,483300,78885
149,120,29,-,194600,78886
110,110,0,-,329800,78931
181,132,49,723,125000,78932
540,420,120,-,156800,78933
2196,1640,556,642,129100,78934
394,384,10,-,298200,78935
126,96,30,615,94600,78938
867,790,77,781,167100,78940
1010,851,159,659,157000,78941
2979,2068,911,899,115400,78942
111,111,0,-,-,78943
247,235,12,1313,240300,78944
3941,3013,928,747,177000,78945
484,353,131,935,166100,78946
1715,1482,233,782,166400,78947
303,272,31,-,221400,78948
206,184,22,-,157900,78949
762,721,41,-,186300,78950
0,0,0,-,-,78951
400,327,73,1368,151900,78953
518,480,38,788,325000,78954
1828,1398,430,841,146300,78956
3537,2714,823,931,164300,78957
690,559,131,432,78100,78959
2076,1741,335,757,144500,78962
356,348,8,-,133300,78963
76,62,14,-,103600,79001
70,45,25,-,102700,79003
588,445,143,670,90800,79005
4704,3609,1095,803,79400,79007
599,361,238,683,75000,79009
172,110,62,-,-,79010
92,67,25,-,105700,79011
526,476,50,-,236100,79012
1046,626,420,602,58900,79013
1310,832,478,825,135200,79014
7723,5033,2690,809,191700,79015
0,0,0,-,-,79016
158,80,78,653,49200,79018
652,518,134,824,139200,79019
52,19,33,-,75000,79021
3369,2193,1176,779,107600,79022
176,131,45,1010,81100,79024
24,13,11,-,-,79025
1601,838,763,639,83400,79027
4892,3165,1727,821,132300,79029
507,370,137,625,76800,79031
22,16,6,-,-,79032
37,15,22,-,-,79033
211,158,53,704,88500,79034
1707,1209,498,714,87000,79035
1764,1642,122,740,73500,79036
366,307,59,686,116500,79039
575,355,220,749,113100,79040
1105,788,317,674,71900,79041
425,315,110,709,79200,79042
466,290,176,642,51500,79043
305,118,187,1018,83100,79044
6156,3905,2251,782,91100,79045
249,173,76,880,77700,79046
0,0,0,-,-,79051
427,338,89,632,73300,79052
41,25,16,568,127500,79053
249,190,59,767,33500,79054
28,23,5,-,105400,79056
524,358,166,546,48600,79057
0,0,0,-,-,79058
264,208,56,775,117600,79059
150,99,51,530,58300,79061
55,43,12,-,-,79062
242,207,35,507,170100,79063
873,581,292,629,64200,79064
7325,5456,1869,752,80500,79065
1264,1014,250,738,121500,79068
3317,2402,915,788,99600,79070
8584,4985,3599,663,83100,79072
97,89,8,625,-,79078
1156,655,501,653,81300,79079
206,171,35,775,41300,79080
1339,1034,305,759,100800,79081
85,78,7,-,106300,79082
718,568,150,818,72000,79083
784,610,174,675,102100,79084
12,12,0,-,-,79085
713,525,188,783,84000,79086
255,192,63,696,97000,79087
1843,1261,582,715,74700,79088
43,43,0,-,70400,79091
345,302,43,883,106800,79092
52,52,0,-,-,79093
17,17,0,-,57100,79094
948,729,219,644,52900,79095
816,582,234,735,99500,79096
319,297,22,792,106500,79097
143,126,17,675,115800,79098
1164,108,1056,758,71400,79101
4183,1943,2240,744,98200,79102
3980,2830,1150,895,85900,79103
2400,1491,909,806,61900,79104
0,0,0,-,-,79105
11422,5633,5789,781,117400,79106
11349,6692,4657,763,66200,79107
4256,3247,1009,860,115000,79108
18257,10893,7364,789,160900,79109
6911,4798,2113,980,108900,79110
576,14,562,1017,-,79111
7768,6220,1548,984,156700,79118
6349,4683,1666,978,254500,79119
2579,1723,856,872,200500,79121
3402,2847,555,1044,238100,79124
2250,1326,924,742,80300,79201
91,38,53,556,58600,79220
362,275,87,663,39900,79225
1096,823,273,663,73900,79226
569,478,91,455,45100,79227
143,123,20,425,50300,79229
42,39,3,-,-,79230
26,0,26,-,-,79231
58,33,25,738,23600,79233
14,14,0,-,72500,79234
1389,1050,339,719,55200,79235
87,34,53,588,38300,79236
188,137,51,588,52500,79237
100,59,41,-,80900,79239
12,5,7,-,-,79240
878,586,292,711,71700,79241
32,18,14,-,85000,79243
301,195,106,625,54600,79244
982,599,383,530,49900,79245
25,24,1,-,27900,79247
665,422,243,363,39800,79248
499,361,138,707,65600,79250
10,10,0,-,66000,79251
1176,848,328,560,37900,79252
234,153,81,661,109500,79255
131,87,44,606,53900,79256
393,324,69,621,56500,79257
20,20,0,-,59100,79258
26,26,0,-,-,79259
166,108,58,523,54200,79261
1264,868,396,689,81200,79311
362,264,98,482,63100,79312
552,371,181,610,62700,79313
29,23,6,-,30500,79314
3589,2410,1179,727,75400,79316
742,548,194,624,58600,79322
2197,1799,398,793,104000,79323
11,11,0,-,-,79324
842,606,236,694,116500,79325
46,46,0,-,-,79326
1122,874,248,729,120400,79329
31,22,9,-,-,79330
4156,2951,1205,619,67600,79331
5980,4088,1892,701,95300,79336
2304,1526,778,806,62000,79339
141,69,72,423,76400,79342
536,339,197,500,69500,79343
15,8,7,-,-,79344
342,277,65,619,92300,79345
790,618,172,545,33000,79346
2219,1742,477,668,71400,79347
139,99,40,733,76300,79350
493,330,163,696,70500,79351
10,2,8,-,-,79353
646,459,187,813,91300,79355
1585,1018,567,827,76500,79356
759,549,210,540,54900,79357
408,323,85,696,101200,79358
845,589,256,671,46000,79359
4575,3633,942,737,150200,79360
1913,1394,519,822,147200,79363
3017,2109,908,680,76600,79364
444,402,42,950,227200,79366
237,171,66,956,69100,79367
54,54,0,-,-,79369
599,458,141,478,54100,79370
537,431,106,596,63800,79371
431,327,104,667,78900,79372
1137,754,383,638,74500,79373
18,18,0,-,63300,79376
85,64,21,-,78000,79377
100,83,17,1500,-,79378
177,138,39,429,71000,79379
53,39,14,681,51000,79380
507,384,123,802,120200,79381
2532,1830,702,977,182100,79382
3321,330,2991,969,77600,79401
5766,3463,2303,788,54600,79403
3299,1903,1396,768,51900,79404
0,0,0,-,-,79406
9145,4177,4968,829,100600,79407
3939,1468,2471,1132,138800,79410
3230,1156,2074,877,72800,79411
5582,2823,2759,813,80100,79412
8539,5002,3537,1063,137000,79413
7834,3232,4602,860,98700,79414
6257,2380,3877,827,60500,79415
13048,6423,6625,1048,128900,79416
14434,9979,4455,1020,150700,79423
18627,12940,5687,957,191600,79424
1093,788,305,676,76600,79501
536,400,136,499,57300,79502
48,37,11,-,83100,79503
1127,921,206,587,78100,79504
106,81,25,716,44400,79505
388,324,64,533,69600,79506
528,429,99,933,168800,79508
2782,2313,469,877,96200,79510
471,410,61,733,102200,79511
2115,1615,500,671,73700,79512
88,69,19,-,168800,79517
17,17,0,-,-,79518
27,27,0,-,77700,79519
916,684,232,756,62300,79520
1301,987,314,534,60700,79521
998,758,240,770,105700,79525
408,335,73,880,81100,79526
80,69,11,-,82500,79527
302,208,94,483,35000,79528
493,425,68,546,39900,79529
213,185,28,-,52000,79530
257,215,42,764,50900,79532
160,113,47,384,31300,79533
40,34,6,-,118800,79534
79,78,1,-,56200,79535
1879,1462,417,835,75600,79536
19,19,0,-,-,79537
105,98,7,-,112500,79538
81,66,15,755,37500,79539
32,32,0,-,80000,79540
336,260,76,-,219000,79541
449,358,91,675,62200,79543
219,163,56,694,27500,79544
674,563,111,930,78200,79545
778,506,272,517,54700,79546
311,230,81,613,32100,79547
64,52,12,-,132100,79548
5379,4088,1291,762,88300,79549
1573,1094,479,575,60200,79553
4651,3001,1650,685,73200,79556
88,61,27,910,90600,79560
273,202,71,619,58300,79561
1295,1208,87,1016,202000,79562
399,290,109,841,65400,79563
82,75,7,-,-,79565
162,129,33,-,231600,79566
1202,757,445,608,53700,79567
7611,3522,4089,789,99100,79601
8197,6013,2184,906,157900,79602
8364,5178,3186,845,74500,79603
11114,5952,5162,910,105400,79605
10108,5470,4638,969,177000,79606
628,0,628,1213,-,79607
0,0,0,-,-,79699
9656,6534,3122,969,120900,79701
7646,5272,2374,1342,152700,79703
14442,9858,4584,1273,235600,79705
7795,6027,1768,1190,163100,79706
14550,8718,5832,1290,289900,79707
165,120,45,513,112500,79713
5508,4024,1484,1000,135600,79714
311,213,98,756,51600,79718
162,123,39,740,38900,79719
10540,6925,3615,875,93300,79720
89,82,7,-,27300,79730
1411,1207,204,740,93600,79731
69,42,27,433,72000,79733
990,830,160,687,114300,79734
3825,2676,1149,894,77300,79735
106,75,31,-,-,79738
363,256,107,825,251200,79739
115,97,18,-,69600,79741
178,148,30,733,33900,79742
107,60,47,406,60000,79743
459,354,105,721,101400,79744
2289,1872,417,874,65200,79745
70,62,8,-,53300,79748
113,81,32,447,182500,79749
839,629,210,779,59900,79752
33,21,12,-,-,79754
58,23,35,707,197500,79755
3303,2311,992,911,89100,79756
768,621,147,899,250300,79758
8,8,0,-,-,79759
11322,7079,4243,952,127200,79761
15683,8757,6926,1090,162100,79762
11703,7885,3818,920,105800,79763
7205,5393,1812,1034,94000,79764
5272,3785,1487,1425,223900,79765
1788,1445,343,961,98700,79766
19,19,0,-,-,79770
3282,2321,961,845,64900,79772
81,41,40,-,63900,79777
400,300,100,510,84600,79778
102,73,29,-,-,79780
109,86,23,680,31800,79781
1297,995,302,827,128800,79782
84,72,12,-,175000,79783
27,27,0,-,-,79785
200,154,46,680,43500,79788
259,203,56,740,50300,79789
1905,1419,486,722,96800,79821
3284,1858,1426,695,153100,79830
4,4,0,-,-,79831
85,5,80,582,-,79834
3063,1988,1075,773,80600,79835
1686,1294,392,678,85100,79836
140,85,55,-,28400,79837
1917,1189,728,530,58900,79838
432,347,85,624,48800,79839
206,151,55,758,97000,79842
837,525,312,825,144000,79843
1761,878,883,427,52000,79845
17,0,17,-,-,79846
81,36,45,2167,22500,79847
365,312,53,697,70000,79848
3352,2417,935,706,72700,79849
176,100,76,450,54100,79851
363,267,96,362,75500,79852
676,541,135,490,61400,79853
57,17,40,-,-,79854
659,456,203,435,56600,79855
3835,437,3398,414,56000,79901
8050,3197,4853,613,162900,79902
6067,3412,2655,630,92700,79903
11006,4495,6511,821,99800,79904
7683,3941,3742,466,80500,79905
1189,0,1189,1357,-,79906
16483,9790,6693,697,88900,79907
854,0,854,1564,-,79908
1947,1553,394,1635,235900,79911
28539,15233,13306,898,187800,79912
12274,7196,5078,604,87300,79915
6,0,6,-,-,79916
0,0,0,-,-,79920
2611,2231,380,811,267100,79922
19824,12469,7355,839,98800,79924
14669,7608,7061,813,142400,79925
11119,8458,2661,736,88100,79927
15201,12730,2471,937,116600,79928
10279,5015,5264,777,93900,79930
8986,6547,2439,859,165200,79932
8917,5977,2940,1127,138900,79934
6155,3471,2684,796,146700,79935
35120,23975,11145,992,127100,79936
22438,16749,5689,1030,145100,79938
10,10,0,-,-,79942
8239,4527,3712,1104,311000,80002
14420,10025,4395,1256,281600,80003
14964,10214,4750,1232,350500,80004
11176,9740,1436,1454,384000,80005
4282,4074,208,2269,582800,80007
13626,4772,8854,979,214500,80010
16257,8436,7821,1178,191200,80011
18764,8524,10240,1158,232900,80012
24994,18770,6224,1448,270400,80013
17923,10168,7755,1298,237000,80014
22408,18271,4137,1586,337300,80015
18354,14345,4009,1565,474600,80016
12839,7210,5629,1268,222400,80017
3954,3377,577,1746,345000,80018
981,737,244,1287,297800,80019
19398,14008,5390,1475,340300,80020
14477,7771,6706,1587,328900,80021
14395,9865,4530,1172,268200,80022
8047,6665,1382,1711,546000,80023
109,70,39,-,115900,80024
99,80,19,-,-,80025
12041,8716,3325,1343,394700,80026
12775,8496,4279,1699,546700,80027
6238,3303,2935,998,240000,80030
13445,9727,3718,1454,315000,80031
11747,5989,5758,1053,331800,80033
561,0,561,1545,-,80045
170,141,29,1042,318600,80101
2000,1684,316,1042,331500,80102
940,800,140,1185,290500,80103
10894,8293,2601,1463,363900,80104
465,399,66,750,243900,80105
1870,1756,114,748,392200,80106
4453,4049,404,1150,428500,80107
9477,7928,1549,1494,602800,80108
7470,6328,1142,1440,418300,80109
9281,5106,4175,1188,258200,80110
12652,7989,4663,1622,622600,80111
13369,7951,5418,1528,415600,80112
10395,5769,4626,1073,402500,80113
1474,1313,161,-,592300,80116
1157,1020,137,1167,334700,80117
2512,2335,177,2106,572600,80118
13702,7846,5856,1110,367700,80120
7346,6194,1152,1376,419500,80121
12595,10701,1894,1608,392200,80122
19433,13884,5549,1437,358900,80123
8568,5128,3440,1638,495200,80124
3770,3655,115,1878,416800,80125
15497,13091,2406,1723,454600,80126
16509,14467,2042,1520,410800,80127
14054,11597,2457,1443,346400,80128
11164,8383,2781,1832,431300,80129
9942,7536,2406,2037,434500,80130
124,95,29,-,238400,80131
7106,6438,668,1658,446500,80132
1012,744,268,979,262300,80133
23450,18996,4454,1629,414000,80134
1449,1276,173,1219,573800,80135
1674,1533,141,1190,292000,80136
427,305,122,1258,453500,80137
11499,9649,1850,1495,442900,80138
8947,2576,6371,1713,498500,80202
14409,2886,11523,1114,328100,80203
13220,4482,8738,989,300500,80204
14516,6316,8200,1229,395400,80205
13093,6084,7009,1187,600900,80206
10220,6859,3361,1280,403000,80207
13496,6753,6743,1481,610300,80209
15206,9255,5951,1327,572300,80210
16390,8553,7837,1275,460900,80211
9059,5736,3323,1061,431900,80212
11905,4122,7783,1052,316600,80214
8357,4956,3401,1202,415900,80215
3951,1444,2507,1287,208100,80216
11445,3722,7723,1120,386600,80218
21560,11455,10105,1040,222700,80219
15989,9359,6630,1154,465500,80220
13925,8683,5242,1228,247200,80221
10811,5137,5674,1174,347800,80222
7781,3965,3816,1099,259900,80223
8252,4540,3712,1231,378100,80224
13492,7715,5777,1315,309700,80226
15087,9368,5719,1298,317200,80227
14252,9346,4906,1315,371400,80228
17975,11066,6909,1274,212500,80229
4157,2349,1808,1455,581300,80230
16988,5781,11207,1185,316200,80231
9232,6691,2541,1256,295200,80232
17057,10090,6967,1423,261800,80233
10667,6376,4291,1320,312100,80234
3627,1899,1728,1194,314200,80235
6417,3729,2688,1148,293200,80236
10470,5048,5422,1462,390000,80237
7138,5404,1734,1817,551800,80238
12013,7102,4911,1369,228500,80239
11484,8728,2756,1536,315500,80241
7495,1434,6061,1176,347000,80246
14334,5506,8828,1257,181100,80247
9492,7504,1988,1708,269400,80249
11833,6964,4869,1136,123400,80260
0,0,0,-,-,80264
0,0,0,-,-,80290
0,0,0,-,-,80293
0,0,0,-,-,80294
11504,7179,4325,1576,489000,80301
11888,4581,7307,1402,719800,80302
11183,5004,6179,1374,647300,80303
11286,7686,3600,1512,762000,80304
7065,4296,2769,1815,653200,80305
68,0,68,906,-,80310
16494,11107,5387,1357,473900,80401
8036,6733,1303,1484,490300,80403
0,0,0,-,-,80419
359,236,123,1213,322600,80420
3753,3182,571,1172,287800,80421
1965,1774,191,1117,337300,80422
48,43,5,-,-,80423
3136,2050,1086,1460,566600,80424
87,87,0,-,472800,80425
52,49,3,-,505000,80426
458,158,300,1071,234800,80427
284,256,28,-,504800,80428
100,87,13,-,-,80432
3537,3066,471,1544,434100,80433
23,23,0,-,-,80434
2122,1570,552,1377,525300,80435
273,231,42,-,264500,80436
284,218,66,826,112900,80438
10056,8626,1430,1493,510700,80439
1017,729,288,1158,288200,80440
715,326,389,1008,337800,80442
1748,1058,690,1478,579700,80443
650,382,268,1026,277300,80444
1697,1175,522,1067,290500,80446
883,793,90,798,400200,80447
55,17,38,-,-,80448
379,374,5,-,191200,80449
307,188,119,1107,222700,80451
1569,1073,496,928,269600,80452
75,42,33,-,350000,80453
529,504,25,-,388500,80454
257,168,89,1313,262500,80455
311,268,43,-,284100,80456
139,43,96,1367,395000,80457
948,635,313,900,199600,80459
3258,1999,1259,958,208700,80461
86,76,10,-,266700,80463
6085,5515,570,1427,377200,80465
1611,1036,575,1503,437000,80466
978,692,286,1076,292200,80467
188,141,47,-,260200,80468
196,112,84,1115,164300,80469
1314,1234,80,910,340200,80470
0,0,0,-,-,80471
2,2,0,-,-,80473
30,0,30,-,-,80475
92,58,34,827,261500,80476
70,61,9,-,787500,80477
541,439,102,1063,267100,80478
5,5,0,-,-,80479
550,385,165,675,196900,80480
256,231,25,1732,441800,80481
515,283,232,938,396500,80482
255,190,65,1006,254700,80483
6752,4787,1965,1343,607000,80487
51,0,51,-,-,80488
128,116,12,-,395100,80497
2573,1622,951,1305,584100,80498
16475,8654,7821,1117,275400,80501
13345,9165,4180,1314,452700,80503
18789,15433,3356,1431,349900,80504
158,120,38,-,403100,80510
0,0,0,-,-,80511
822,792,30,-,350900,80512
4780,4054,726,1329,380100,80513
1874,1289,585,1040,240000,80514
442,391,51,-,274000,80515
8991,7850,1141,1798,442400,80516
4813,3150,1663,930,392100,80517
499,354,145,1367,195200,80520
13145,4908,8237,1218,344900,80521
14622,9749,4873,1132,322400,80524
21710,13115,8595,1293,352800,80525
18495,10499,7996,1237,326200,80526
7367,5783,1584,1575,416300,80528
1606,1367,239,1356,261200,80530
107,107,0,-,440900,80532
5847,5107,740,1692,321000,80534
1170,803,367,840,338000,80535
1035,941,94,1350,341300,80536
18153,11605,6548,1131,302700,80537
19281,13581,5700,1231,294100,80538
1800,1496,304,1336,505700,80540
1539,1493,46,1775,360700,80542
2531,2234,297,1226,236300,80543
57,57,0,-,-,80544
444,423,21,-,263500,80545
122,122,0,-,223100,80546
662,618,44,1078,479300,80547
3880,3428,452,1630,312800,80549
10092,8384,1708,1224,364600,80550
12547,7973,4574,1210,282100,80601
10917,10180,737,1885,403700,80602
4526,3906,620,1363,311600,80603
1165,798,367,887,244800,80610
339,245,94,1066,288100,80611
157,131,26,-,332500,80612
2868,2232,636,937,289900,80615
6490,3951,2539,1092,189000,80620
4333,3264,1069,894,237600,80621
54,35,19,-,271700,80622
326,254,72,838,172400,80623
411,248,163,1530,387800,80624
17458,8365,9093,837,168800,80631
22059,15766,6293,1153,247100,80634
3526,2841,685,1402,292800,80640
1387,1083,304,1120,337700,80642
1322,1130,192,1080,343000,80643
1072,729,343,922,233900,80644
1526,1089,437,873,230800,80645
454,403,51,1172,285200,80648
146,85,61,740,251800,80649
628,519,109,985,241600,80650
1535,1201,334,866,265800,80651
197,145,52,-,153900,80652
335,257,78,617,195100,80653
989,731,258,789,257900,80654
5892,3696,2196,782,190800,80701
437,253,184,794,80500,80705
1107,756,351,711,130900,80720
120,84,36,-,-,80721
110,60,50,606,185000,80722
2802,1769,1033,734,165400,80723
201,149,52,944,184400,80726
216,86,130,831,67300,80727
410,321,89,667,149000,80728
250,169,81,832,166500,80729
536,430,106,611,150400,80731
216,160,56,1021,132100,80733
1125,747,378,733,164000,80734
121,67,54,850,221200,80735
218,178,40,755,116700,80736
703,468,235,569,91900,80737
51,33,18,800,275000,80740
383,269,114,905,143800,80741
106,80,26,-,72000,80742
475,313,162,678,141500,80743
188,161,27,643,74300,80744
105,81,24,-,190400,80745
27,25,2,-,91700,80746
148,122,26,675,130600,80747
126,99,27,488,107800,80749
99,56,43,675,-,80750
6603,3859,2744,742,155300,80751
71,50,21,-,207100,80754
35,16,19,-,277800,80755
100,53,47,194,171900,80757
1415,831,584,730,145100,80758
1985,1348,637,836,207800,80759
56,46,10,-,143800,80801
89,60,29,675,109400,80802
120,83,37,475,71700,80804
167,154,13,750,131800,80805
1827,1223,604,823,144300,80807
2177,1591,586,948,229900,80808
563,467,96,1250,283500,80809
474,348,126,545,120900,80810
108,95,13,-,108600,80812
779,429,350,893,169500,80813
1467,1256,211,1155,265800,80814
348,269,79,614,132500,80815
2639,2299,340,1077,237000,80816
10252,6966,3286,1333,216300,80817
153,137,16,1063,120400,80818
409,267,142,867,257200,80819
353,353,0,-,276500,80820
400,309,91,671,124500,80821
95,75,20,-,209800,80822
56,40,16,625,137500,80823
100,75,25,-,173800,80824
152,115,37,658,72000,80825
315,315,0,-,273900,80827
737,441,296,850,171000,80828
2681,1555,1126,943,359500,80829
95,70,25,-,166700,80830
8158,7056,1102,1681,297200,80831
290,248,42,778,222700,80832
283,233,50,692,205100,80833
140,103,37,586,102100,80834
344,216,128,714,142900,80835
450,248,202,598,152800,80836
558,0,558,1599,-,80840
326,230,96,691,105900,80860
90,84,6,475,164300,80861
21,21,0,-,71700,80862
5118,4129,989,1154,315700,80863
527,400,127,1132,216900,80864
2995,12,2983,1597,-,80902
7027,2645,4382,789,224700,80903
10247,5662,4585,936,255200,80904
7407,3637,3770,905,220000,80905
15011,9428,5583,1175,348800,80906
12645,7040,5605,944,206400,80907
6050,5624,426,1990,465400,80908
16284,7882,8402,825,200200,80909
11656,4799,6857,903,151700,80910
11573,9527,2046,1269,189400,80911
12,0,12,-,-,80913
22,0,22,2208,-,80914
8052,5269,2783,995,181100,80915
14121,7026,7095,1084,157200,80916
12880,7385,5495,983,218900,80917
18774,11228,7546,1180,245000,80918
11208,8388,2820,1271,353800,80919
13793,9994,3799,1457,309800,80920
8151,6281,1870,1474,422800,80921
9733,7266,2467,1536,240700,80922
10310,7550,2760,1639,267700,80923
2653,1953,700,1787,439200,80924
3298,2744,554,1728,264300,80925
666,522,144,533,-,80926
1071,931,140,1943,346200,80927
438,340,98,1152,162800,80928
87,60,27,-,318900,80929
701,266,435,1645,228600,80930
28,28,0,-,-,80938
0,0,0,-,-,80939
1459,1071,388,1679,241300,80951
12042,6056,5986,762,119500,81001
5691,2500,3191,678,98700,81003
10807,5435,5372,778,98700,81004
12595,9045,3550,815,156600,81005
4424,3679,745,901,180500,81006
11365,9344,2021,980,202500,81007
4317,2833,1484,993,170700,81008
525,364,161,922,195500,81019
402,272,130,582,143200,81020
9,5,4,-,-,81021
558,470,88,763,162000,81022
517,475,42,-,198000,81023
116,101,15,-,-,81024
310,237,73,-,96000,81025
85,56,29,1250,-,81027
110,63,47,346,55000,81029
60,47,13,573,106300,81030
84,56,28,663,45000,81033
423,340,83,627,77700,81036
0,0,0,-,-,81038
740,481,259,680,101800,81039
208,199,9,-,-,81040
292,195,97,564,78500,81041
25,16,9,-,45000,81043
121,89,32,417,74400,81044
30,29,1,-,62500,81045
593,409,184,608,87100,81047
125,88,37,-,120800,81049
3950,2227,1723,687,97600,81050
3791,2345,1446,699,96900,81052
1312,812,500,647,71000,81054
739,553,186,966,209300,81055
213,132,81,763,134100,81057
430,312,118,575,79800,81058
49,37,12,-,-,81059
310,230,80,1438,90000,81062
578,431,147,721,73600,81063
114,85,29,475,62500,81064
2313,1559,754,678,80500,81067
835,775,60,700,248900,81069
131,69,62,559,120500,81071
854,629,225,442,86900,81073
201,129,72,931,85000,81076
271,200,71,554,121800,81077
47,42,5,-,332100,81081
5410,3677,1733,699,145400,81082
48,21,27,-,-,81084
56,36,20,650,82000,81087
2187,1452,735,616,114500,81089
463,348,115,542,72900,81090
245,198,47,1033,221400,81091
364,288,76,627,113300,81092
5824,3206,2618,648,158100,81101
945,689,256,387,96200,81120
155,130,25,1094,219200,81121
3578,2866,712,1179,318800,81122
344,241,103,836,87700,81123
80,68,12,-,206300,81124
1207,718,489,559,87100,81125
134,119,15,-,89900,81126
47,40,7,-,629300,81128
51,40,11,-,61700,81129
367,324,43,719,290500,81130
665,551,114,802,198300,81131
1274,991,283,618,130300,81132
514,374,140,625,159500,81133
94,64,30,583,104200,81136
2126,1509,617,988,241100,81137
42,18,24,-,-,81138
838,654,184,658,138800,81140
478,408,70,563,112700,81141
329,278,51,747,86900,81143
2661,1620,1041,592,158200,81144
237,155,82,744,134400,81146
5375,3975,1400,933,295300,81147
117,105,12,725,75000,81148
371,276,95,588,148900,81149
599,513,86,500,130400,81151
602,394,208,292,109900,81152
519,425,94,-,234600,81154
124,106,18,-,366700,81155
4115,3227,888,744,344900,81201
152,125,27,-,537500,81210
2912,2159,753,833,313500,81211
11355,8171,3184,777,169600,81212
78,78,0,-,409300,81220
130,113,17,1125,79300,81221
201,155,46,1029,172400,81222
732,649,83,695,138600,81223
1331,805,526,1226,589400,81224
584,390,194,1168,438300,81225
2493,1856,637,893,129600,81226
6,6,0,-,-,81227
4105,2331,1774,860,282900,81230
0,0,0,-,-,81231
17,17,0,-,-,81232
417,348,69,-,264800,81233
345,241,104,732,347900,81235
691,550,141,-,393000,81236
23,23,0,-,350000,81237
45,45,0,-,331000,81239
1524,1294,230,929,181100,81240
45,44,1,-,243500,81241
238,165,73,819,261200,81242
46,46,0,-,400000,81243
200,179,21,670,132600,81244
58,58,0,-,-,81248
95,86,9,-,284800,81251
1885,1591,294,635,248500,81252
186,186,0,-,450000,81253
12247,8132,4115,1156,437000,81301
3207,2331,876,1097,366800,81303
95,95,0,-,112900,81320
6026,4064,1962,769,183600,81321
1846,1465,381,916,266100,81323
517,439,78,577,108900,81324
111,95,16,-,214500,81325
804,694,110,1055,282900,81326
216,197,19,-,171100,81327
1837,1415,422,911,258600,81328
44,0,44,-,-,81330
153,145,8,-,221900,81331
86,49,37,866,302800,81332
536,299,237,360,155100,81334
13,0,13,-,-,81335
9728,6189,3539,852,191700,81401
4199,3503,696,1090,294400,81403
639,463,176,614,226600,81410
30,26,4,-,147200,81411
2074,1639,435,848,238300,81413
578,505,73,1225,339400,81415
5202,3347,1855,829,203800,81416
674,478,196,1018,208500,81418
1664,1214,450,926,236400,81419
314,192,122,719,133800,81422
644,445,199,1044,277500,81423
470,365,105,617,165200,81424
2051,1489,562,773,196000,81425
56,44,12,975,598200,81426
514,356,158,1075,356300,81427
1393,1089,304,801,221300,81428
20,20,0,-,235700,81429
366,328,38,-,590200,81430
189,166,23,-,200000,81431
1397,946,451,1206,461300,81432
252,168,84,990,286400,81433
99,59,40,1089,-,81434
2317,1214,1103,1160,596600,81435
9797,4057,5740,807,174100,81501
6378,4530,1848,943,187700,81503
11420,8167,3253,1033,173900,81504
4459,3135,1324,1118,265400,81505
5241,3279,1962,978,282900,81506
6220,5369,851,1215,311900,81507
5301,3375,1926,810,132700,81520
6260,4460,1800,1112,223700,81521
65,65,0,-,-,81522
465,465,0,-,417800,81523
743,600,143,-,283900,81524
491,319,172,1301,173300,81525
2265,1649,616,835,307700,81526
811,698,113,1111,284400,81527
5916,3765,2151,1224,406700,81601
132,93,39,804,117200,81610
4268,2632,1636,1442,656400,81611
0,0,0,-,-,81612
1255,710,545,741,886100,81615
3399,1966,1433,1395,574100,81620
2461,1690,771,1933,592900,81621
5569,3884,1685,1606,586400,81623
458,360,98,865,271600,81624
4945,3366,1579,782,172000,81625
353,268,85,836,199200,81630
2459,1934,525,1474,531300,81631
3235,2444,791,1487,698300,81632
0,0,0,-,-,81633
2529,1561,968,805,185400,81635
2500,1910,590,1649,342000,81637
50,36,14,-,307700,81638
923,601,322,965,232500,81639
75,41,34,-,-,81640
1473,1009,464,707,223400,81641
0,0,0,-,-,81642
272,205,67,1000,297600,81643
388,221,167,1313,658100,81645
63,47,16,-,402500,81646
2489,1878,611,1404,312100,81647
900,650,250,795,170100,81648
120,82,38,1731,338300,81649
4670,3254,1416,985,236000,81650
1791,1240,551,1273,300400,81652
16,8,8,-,-,81653
434,372,62,3367,287300,81654
15,0,15,-,-,81655
98,98,0,-,-,81656
2330,1567,763,1526,772000,81657
15348,9254,6094,931,184400,82001
0,0,0,-,-,82005
8202,5389,2813,980,151000,82007
13653,11146,2507,875,280900,82009
90,69,21,685,222600,82050
22,5,17,-,-,82051
6,6,0,-,-,82052
442,322,120,944,217200,82053
356,251,105,-,220100,82054
151,132,19,-,270000,82055
22,22,0,-,"2,000,000+",82058
109,109,0,-,219900,82059
191,191,0,-,260600,82060
0,0,0,-,-,82061
122,50,72,-,227300,82063
8540,4683,3857,785,226400,82070
7057,2955,4102,738,227800,82072
0,0,0,-,-,82073
42,42,0,-,308700,82081
760,573,187,533,228100,82082
116,77,39,-,75800,82083
7,7,0,-,-,82084
193,0,193,435,-,82190
2922,2169,753,699,196800,82201
221,136,85,660,83300,82210
239,205,34,717,149400,82212
248,219,29,536,137500,82213
563,403,160,932,137500,82214
63,43,20,925,123900,82215
19,9,10,-,-,82217
5,5,0,-,-,82219
156,92,64,531,118500,82221
18,18,0,-,-,82222
464,376,88,778,202100,82223
6,6,0,-,-,82224
756,551,205,671,151400,82225
115,106,9,415,150000,82227
1,1,0,-,-,82229
4055,2950,1105,726,160500,82240
18,18,0,-,-,82242
45,30,15,-,-,82243
206,162,44,539,227300,82244
3542,2364,1178,835,164200,82301
245,165,80,880,153800,82321
57,51,6,-,52500,82322
66,44,22,1396,-,82323
118,74,44,-,182500,82324
454,362,92,944,223600,82325
348,230,118,792,76800,82327
205,142,63,550,85600,82329
1016,723,293,771,214700,82331
69,34,35,-,137000,82332
206,152,54,670,124200,82334
29,29,0,-,-,82335
81,40,41,-,-,82336
3155,2406,749,632,160100,82401
814,607,207,609,148300,82410
155,105,50,775,202300,82411
194,177,17,575,143800,82412
6520,4780,1740,915,270100,82414
315,247,68,688,149600,82420
128,111,17,-,131300,82421
6,6,0,-,-,82422
68,48,20,450,-,82423
1088,806,282,711,158400,82426
77,52,25,-,230800,82428
33,29,4,-,103400,82430
1336,924,412,655,158300,82431
108,84,24,-,-,82432
393,251,142,689,173000,82433
41,30,11,-,162500,82434
4906,3422,1484,776,234300,82435
68,68,0,-,-,82440
122,62,60,-,-,82441
327,247,80,534,254200,82442
2158,1634,524,719,152000,82443
67,67,0,-,376100,82450
7152,4861,2291,748,183200,82501
117,107,10,-,-,82510
78,59,19,658,-,82512
841,620,221,717,214800,82513
474,285,189,503,121000,82514
180,139,41,814,157600,82515
191,135,56,746,184400,82516
5145,3679,1466,873,220900,82520
343,255,88,875,222800,82523
11968,7653,4315,777,195700,82601
10453,7754,2699,1101,198800,82604
7382,4481,2901,894,248200,82609
82,35,47,-,-,82620
0,0,0,-,-,82630
3888,2979,909,703,209500,82633
90,48,42,790,63300,82635
1948,1500,448,796,188800,82636
1557,937,620,704,202100,82637
0,0,0,-,-,82638
340,233,107,963,-,82639
24,24,0,-,-,82640
37,32,5,-,-,82642
156,134,22,658,45000,82643
756,376,380,863,120800,82644
0,0,0,-,-,82646
10,10,0,-,-,82648
445,316,129,603,132900,82649
2280,1828,452,857,165300,82701
129,117,12,-,303900,82710
40,22,18,-,-,82711
136,136,0,-,235500,82712
30,9,21,-,-,82714
0,0,0,-,-,82715
6906,4795,2111,833,190900,82716
9138,6664,2474,1032,236300,82718
391,297,94,641,153400,82720
1080,918,162,793,224400,82721
138,126,12,-,-,82723
216,203,13,-,241300,82725
392,392,0,-,263500,82727
1066,897,169,819,216900,82729
742,510,232,750,177600,82730
63,13,50,-,-,82731
773,559,214,1034,202400,82732
11215,7517,3698,819,251600,82801
99,64,35,1010,377100,82831
334,304,30,-,392600,82832
43,43,0,-,-,82833
3397,2408,989,876,257300,82834
136,72,64,665,125000,82835
448,304,144,670,238000,82836
25,14,11,-,-,82837
124,86,38,-,371400,82838
487,400,87,1103,266900,82839
326,193,133,764,306300,82842
9,9,0,-,-,82844
14,14,0,-,-,82845
10372,7731,2641,894,207400,82901
156,156,0,-,554800,82922
148,132,16,-,-,82923
181,181,0,-,439700,82925
101,0,101,589,-,82929
5409,3903,1506,654,171300,82930
158,96,62,-,280000,82932
189,189,0,-,117300,82933
29,27,2,-,-,82934
4651,3631,1020,889,212200,82935
0,0,0,-,-,82936
1540,1294,246,686,206600,82937
62,62,0,-,-,82938
580,406,174,811,193500,82939
1608,1305,303,950,243100,82941
69,69,0,-,10100,82942
163,146,17,-,116800,82943
34,34,0,-,387500,82944
128,109,19,937,80300,82945
6811,3677,3134,1367,785400,83001
27,27,0,-,-,83011
109,20,89,-,-,83012
213,88,125,-,-,83013
1421,1166,255,1220,1053400,83014
198,113,85,-,1223800,83025
1323,1024,299,817,187600,83101
1516,1179,337,784,214300,83110
235,142,93,-,234200,83111
138,108,30,-,-,83112
748,527,221,879,216900,83113
283,240,43,1031,207100,83114
434,353,81,-,320500,83115
328,260,68,758,152000,83116
390,288,102,-,466700,83118
91,76,15,-,328300,83119
322,287,35,-,257900,83120
0,0,0,-,-,83121
219,176,43,-,122400,83122
188,127,61,755,121100,83123
58,52,6,-,-,83124
131,131,0,-,456100,83126
1486,1189,297,769,290700,83127
449,341,108,1028,301500,83128
13767,9016,4751,663,147300,83201
7844,5874,1970,760,159800,83202
127,92,35,415,-,83203
7188,4502,2686,621,145600,83204
150,0,150,657,-,83209
1147,830,317,569,122000,83210
2052,1323,729,638,139800,83211
57,50,7,450,158300,83212
508,401,107,549,84700,83213
216,165,51,-,155700,83214
29,26,3,-,66400,83215
314,264,50,453,132900,83217
105,80,25,779,140600,83218
69,42,27,-,135700,83220
8963,6713,2250,610,153200,83221
37,35,2,-,221900,83223
892,724,168,646,150800,83226
97,28,69,-,-,83227
185,125,60,757,182000,83228
167,130,37,850,171400,83232
0,0,0,-,-,83233
567,445,122,634,107900,83234
25,25,0,-,-,83235
770,651,119,514,166600,83236
342,290,52,685,206600,83237
25,17,8,-,-,83238
222,197,25,608,135200,83239
863,677,186,575,127600,83241
12,12,0,-,-,83243
116,105,11,-,171300,83244
812,708,104,642,195000,83245
363,326,37,615,205800,83246
576,467,109,673,167100,83250
508,370,138,620,180700,83251
1573,1267,306,735,157300,83252
33,26,7,-,-,83253
1440,1014,426,580,130900,83254
571,479,92,671,145600,83255
264,244,20,950,149200,83261
386,339,47,872,159300,83262
3141,2528,613,666,201500,83263
161,130,31,807,131800,83271
108,91,17,-,167600,83272
2787,2152,635,902,163700,83274
1405,1133,272,618,139100,83276
90,90,0,-,127100,83277
90,65,25,433,-,83278
37,18,19,-,-,83281
50,46,4,-,450000,83283
43,35,8,-,305600,83285
409,351,58,828,185300,83286
118,106,12,-,412900,83287
21104,13783,7321,787,160900,83301
86,41,45,628,58500,83302
269,186,83,-,169400,83311
76,40,36,-,134400,83312
1426,1030,396,854,343000,83313
362,275,87,779,151300,83314
3964,2902,1062,657,132300,83316
5985,4155,1830,638,148700,83318
284,214,70,725,180200,83320
176,131,45,830,111500,83321
16,16,0,-,433300,83322
522,399,123,617,133200,83323
211,158,53,817,138300,83324
285,185,100,813,118800,83325
277,188,89,663,158800,83327
1964,1468,496,873,173300,83328
2457,1690,767,589,138700,83330
1084,749,335,729,187200,83332
3592,2340,1252,852,400000,83333
768,536,232,922,109800,83334
653,456,197,548,157400,83335
1761,1287,474,745,155400,83336
22,22,0,-,-,83337
6897,4383,2514,778,153600,83338
2098,1459,639,1116,548700,83340
2363,2050,313,726,202200,83341
413,354,59,421,159300,83342
382,215,167,755,182400,83344
547,369,178,691,167500,83346
1118,840,278,653,143000,83347
105,75,30,-,-,83348
385,275,110,583,144500,83349
4561,3129,1432,617,131900,83350
1161,811,350,828,129500,83352
568,502,66,1632,795500,83353
11,11,0,-,-,83354
1437,919,518,680,123600,83355
14036,9527,4509,783,157700,83401
9208,5817,3391,684,152200,83402
8715,6473,2242,930,179000,83404
5904,4445,1459,897,194200,83406
202,196,6,-,561600,83414
812,640,172,753,198900,83420
88,72,16,-,163400,83421
1110,810,300,969,318300,83422
274,167,107,575,61000,83423
125,58,67,-,262500,83424
156,118,38,623,112500,83425
561,540,21,1125,196300,83427
184,158,26,1083,200000,83428
323,310,13,-,325500,83429
277,226,51,650,161300,83431
2,2,0,-,-,83433
510,388,122,740,152200,83434
187,131,56,547,168000,83435
166,138,28,914,150000,83436
10138,4601,5537,701,209800,83440
6598,5373,1225,807,199300,83442
394,319,75,920,145400,83443
435,250,185,509,123300,83444
2414,1920,494,733,147800,83445
14,14,0,-,175000,83446
580,406,174,1094,187200,83448
87,68,19,697,257900,83449
282,238,44,713,120700,83450
341,280,61,838,113200,83451
680,594,86,643,398000,83452
159,147,12,-,147800,83454
1821,1301,520,765,300600,83455
0,0,0,-,-,83460
288,231,57,-,335400,83462
67,47,20,-,-,83463
135,88,47,475,117500,83464
55,40,15,-,267600,83465
149,114,35,-,218500,83466
2752,2059,693,649,160700,83467
65,64,1,-,225000,83468
15,15,0,-,-,83469
14441,10153,4288,724,183300,83501
108,62,46,603,221100,83520
678,509,169,727,164300,83522
333,280,53,591,108000,83523
364,248,116,725,160400,83524
192,167,25,-,163700,83525
104,91,13,821,215500,83526
2223,1602,621,673,157600,83530
95,84,11,-,231600,83533
477,353,124,816,144400,83535
1797,1315,482,626,156200,83536
449,378,71,756,184700,83537
863,684,179,540,160500,83539
740,441,299,722,113300,83540
435,388,47,770,216100,83541
60,44,16,560,206300,83542
283,223,60,620,117000,83543
2459,1846,613,745,152100,83544
184,149,35,744,126100,83545
230,196,34,558,86900,83546
142,112,30,600,213100,83547
51,48,3,-,105000,83548
332,249,83,828,178900,83549
428,372,56,655,155300,83552
592,457,135,616,109200,83553
222,188,34,454,164300,83554
241,200,41,564,161500,83555
11,11,0,-,-,83601
7,7,0,-,-,83602
222,116,106,665,142900,83604
14409,9162,5247,752,136000,83605
7989,5809,2180,896,196100,83607
386,333,53,554,159100,83610
659,574,85,705,276100,83611
780,561,219,576,133200,83612
343,266,77,941,232600,83615
10637,8961,1676,1101,387200,83616
6086,4413,1673,740,155400,83617
2913,2260,653,825,175100,83619
886,749,137,886,252900,83622
598,367,231,655,102600,83623
467,242,225,548,159500,83624
481,376,105,735,132800,83626
239,188,51,461,219600,83627
1546,1040,506,732,89300,83628
729,609,120,742,157200,83629
422,348,74,671,131300,83631
161,146,15,-,220700,83632
221,156,65,593,120300,83633
7268,5498,1770,1136,185200,83634
26,26,0,-,-,83636
72,56,16,-,220300,83637
2495,1921,574,764,296700,83638
1279,982,297,549,143700,83639
1272,1018,254,695,194700,83641
16727,11801,4926,957,245300,83642
73,73,0,-,156300,83643
3782,3273,509,744,200200,83644
328,257,71,706,179600,83645
20913,17400,3513,1149,252000,83646
8155,5290,2865,766,146300,83647
1010,0,1010,944,-,83648
200,119,81,800,162000,83650
11457,7059,4398,877,132200,83651
644,553,91,638,219300,83654
1672,1279,393,605,163200,83655
206,176,30,950,94800,83656
100,86,14,-,173500,83657
2157,1605,552,617,161900,83660
3832,2554,1278,748,121800,83661
13,11,2,-,131300,83666
3690,3023,667,1099,274300,83669
162,146,16,-,210000,83670
5,5,0,-,-,83671
3286,2216,1070,673,144400,83672
1607,1158,449,679,204000,83676
0,0,0,-,-,83677
16951,11807,5144,850,177800,83686
11463,7560,3903,927,168900,83687
10889,5663,5226,792,390000,83702
7077,4504,2573,924,236500,83703
15885,8962,6923,910,177200,83704
11866,6067,5799,853,174000,83705
13700,6896,6804,885,245900,83706
20623,16278,4345,1110,231200,83709
4064,2704,1360,955,399400,83712
10393,7058,3335,1075,229100,83713
9789,6667,3122,892,218100,83714
6318,4834,1484,1190,284600,83716
2616,2303,313,1079,262500,83801
28,6,22,692,-,83802
440,234,206,912,246800,83803
673,548,125,676,196800,83804
3202,2544,658,633,180400,83805
100,81,19,669,80600,83806
62,52,10,508,86300,83808
102,102,0,-,351600,83809
440,382,58,1632,195400,83810
619,424,195,768,133600,83811
38,36,2,-,80000,83812
454,405,49,-,367300,83813
11202,6091,5111,873,272500,83814
13837,8720,5117,1062,224600,83815
101,86,15,-,-,83821
781,638,143,643,161000,83822
549,451,98,833,185600,83823
85,59,26,383,-,83824
118,93,25,1719,215900,83825
0,0,0,-,-,83826
91,71,20,-,100600,83827
168,96,72,-,160200,83830
562,447,115,845,194300,83832
676,588,88,916,447900,83833
104,80,24,-,-,83834
8455,7063,1392,1043,279400,83835
382,319,63,759,283100,83836
1305,718,587,673,110000,83837
615,494,121,757,175200,83839
101,75,26,686,146900,83840
158,79,79,500,152300,83841
84,54,30,-,122700,83842
11314,4967,6347,698,229000,83843
0,0,0,-,-,83844
739,517,222,900,161600,83845
334,257,77,632,84600,83846
664,395,269,548,226800,83847
89,73,16,-,203400,83848
872,657,215,595,128500,83849
926,773,153,762,143800,83850
624,448,176,730,129800,83851
377,93,284,755,-,83852
15527,11426,4101,941,201900,83854
913,640,273,662,139400,83855
2536,2031,505,691,180400,83856
358,290,68,1103,283300,83857
5554,4469,1085,986,233700,83858
2512,2072,440,991,286600,83860
2528,1919,609,582,163300,83861
7479,5033,2446,951,256400,83864
33,33,0,-,-,83866
238,214,24,-,165000,83867
349,198,151,711,66100,83868
1916,1636,280,779,208100,83869
105,74,31,525,130600,83870
815,656,159,700,212300,83871
238,186,52,1042,280300,83872
739,445,294,666,127400,83873
0,0,0,-,-,83874
689,526,163,674,244800,83876
231,207,24,920,185700,84001
101,82,19,1104,230600,84002
13041,10525,2516,1095,332100,84003
2735,2377,358,1959,544200,84004
6937,6011,926,1325,257300,84005
431,341,90,-,173800,84006
211,201,10,-,190900,84007
15185,10690,4495,1022,289300,84010
288,270,18,913,231700,84013
5541,4795,746,1247,297600,84014
19399,14562,4837,1018,203000,84015
1405,1214,191,959,295800,84017
41,41,0,-,373100,84018
13542,10837,2705,1386,435200,84020
1337,971,366,868,162500,84021
230,4,226,708,-,84022
58,42,16,413,281300,84023
17,17,0,-,-,84024
6515,5332,1183,1147,366100,84025
370,312,58,830,134800,84026
224,204,20,-,192700,84027
197,154,43,842,269000,84028
3106,2551,555,854,234600,84029
87,63,24,-,258800,84031
6605,4629,1976,1283,368100,84032
334,267,67,853,256000,84033
62,37,25,256,-,84034
142,142,0,-,169600,84035
2501,1767,734,1095,365900,84036
10691,9519,1172,944,330500,84037
100,85,15,-,269100,84038
256,233,23,-,168900,84039
7326,6164,1162,1297,285800,84040
16207,10693,5514,958,212000,84041
2803,2371,432,1188,382500,84042
16202,13118,3084,1464,316800,84043
8076,6044,2032,1084,177600,84044
6316,5129,1187,1425,323400,84045
87,87,0,-,169600,84046
13013,5641,7372,1061,239500,84047
2088,1631,457,2281,422600,84049
3265,2740,525,1185,358900,84050
152,130,22,963,181900,84051
455,326,129,838,158600,84052
319,282,37,784,199100,84053
6467,4770,1697,1099,283500,84054
434,330,104,884,336700,84055
936,4,932,1211,-,84056
11987,7008,4979,997,224400,84057
11213,5683,5530,1022,263400,84058
3265,1972,1293,1322,1015000,84060
198,140,58,-,336400,84061
13294,9514,3780,1108,293200,84062
77,68,9,-,153800,84063
203,149,54,625,137500,84064
11363,9990,1373,1398,351800,84065
3917,2854,1063,869,183000,84066
12465,10263,2202,983,174600,84067
176,147,29,-,222100,84069
9965,6132,3833,1139,238400,84070
375,326,49,907,223100,84071
152,133,19,769,188300,84072
72,65,7,-,159700,84073
15497,12643,2854,948,206700,84074
7750,7225,525,1533,283500,84075
94,94,0,-,147800,84076
8950,6692,2258,866,203800,84078
97,91,6,-,161700,84080
12892,10562,2330,1283,280600,84081
233,217,16,-,306400,84082
447,107,340,554,41500,84083
11929,8708,3221,1190,238700,84084
122,98,24,956,120800,84085
120,89,31,-,166100,84086
4724,4159,565,1210,260900,84087
11287,7977,3310,1131,261300,84088
9059,8447,612,1549,428500,84092
7462,6626,836,1788,379700,84093
9225,7122,2103,1418,275900,84094
20167,16221,3946,1413,379200,84095
12186,10296,1890,1331,340400,84096
6336,4762,1574,984,298300,84097
7015,5715,1300,1462,708100,84098
2967,620,2347,939,253300,84101
9079,2322,6757,920,285400,84102
10438,5167,5271,869,437300,84103
7626,3899,3727,1014,167100,84104
9420,6056,3364,1013,360700,84105
14469,8484,5985,1119,294400,84106
13774,6763,7011,1015,240000,84107
7787,5776,2011,1053,483800,84108
8927,6920,2007,1281,393700,84109
6571,1425,5146,770,235200,84111
173,3,170,807,-,84112
50,0,50,-,-,84113
10997,4347,6650,834,209200,84115
10974,6035,4939,992,167600,84116
10256,6442,3814,1072,359700,84117
19955,16104,3851,1214,210100,84118
16914,9591,7323,1027,170200,84119
13643,9738,3905,1048,197700,84120
15859,12034,3825,1216,354500,84121
14379,8256,6123,1029,224300,84123
7922,5905,2017,1046,397500,84124
6994,6063,931,1402,215100,84128
202,80,122,1943,1000000,84144
0,0,0,-,-,84180
255,243,12,-,193000,84301
8543,6108,2435,740,184800,84302
0,0,0,-,-,84304
236,221,15,825,166100,84305
148,98,50,-,333300,84306
430,373,57,1016,189200,84307
77,57,20,-,192700,84308
146,131,15,650,228400,84309
1514,1424,90,-,404100,84310
217,154,63,629,208000,84311
1443,1226,217,743,178500,84312
42,21,21,-,-,84313
336,302,34,719,225000,84314
2590,2443,147,1300,304600,84315
106,89,17,825,126800,84316
820,711,109,818,414400,84317
1274,1098,176,930,264100,84318
2256,1748,508,756,174100,84319
784,618,166,780,189800,84320
14884,7331,7553,686,190400,84321
236,222,14,713,258600,84324
677,625,52,706,295500,84325
578,459,119,645,227900,84326
250,228,22,625,203200,84327
524,484,40,755,315600,84328
16,16,0,-,-,84329
121,116,5,675,169400,84330
94,78,16,681,158300,84331
2395,2033,362,949,265800,84332
895,700,195,788,201400,84333
86,31,55,-,-,84334
3607,3118,489,896,228200,84335
57,36,21,750,137500,84336
3784,2903,881,734,180900,84337
141,117,24,633,180100,84338
1441,1276,165,737,241300,84339
1212,1047,165,822,265500,84340
7626,3458,4168,890,236100,84341
13881,7488,6393,756,198300,84401
13025,8796,4229,806,214100,84403
20155,14546,5609,862,170200,84404
11139,8222,2917,902,203500,84405
8952,7775,1177,1086,252200,84414
4884,3473,1411,662,149600,84501
1261,993,268,613,165800,84511
236,198,38,-,83300,84512
523,424,99,593,133800,84513
0,0,0,-,-,84515
67,67,0,-,160400,84516
293,236,57,1057,225900,84518
448,315,133,563,62600,84520
270,226,44,533,153800,84521
101,94,7,-,102600,84522
643,503,140,545,149700,84523
322,228,94,523,115200,84525
1652,1302,350,676,133000,84526
883,692,191,723,132500,84528
143,121,22,-,-,84529
108,27,81,-,-,84530
169,158,11,-,29100,84531
4149,2690,1459,862,240100,84532
88,24,64,-,-,84533
616,508,108,595,56000,84534
909,726,183,829,184900,84535
417,360,57,430,41600,84536
487,358,129,738,141200,84537
87,81,6,-,48700,84539
24,24,0,-,-,84540
630,427,203,627,119800,84542
10727,4660,6067,837,209900,84601
11850,6050,5800,886,318000,84604
10391,2341,8050,819,215800,84606
328,313,15,-,166600,84620
55,55,0,-,-,84621
568,469,99,-,184500,84622
85,34,51,-,-,84623
1956,1451,505,664,145500,84624
37,37,0,-,287500,84626
1973,1027,946,707,204200,84627
226,202,24,-,101700,84628
874,791,83,1199,198200,84629
103,81,22,600,167500,84630
1048,862,186,675,137700,84631
386,320,66,735,161200,84632
415,362,53,722,197700,84633
401,362,39,807,161000,84634
255,225,30,869,105700,84635
189,142,47,654,160100,84636
250,201,49,835,157400,84637
91,78,13,717,159400,84638
318,228,90,748,164100,84639
38,38,0,-,102500,84640
1163,796,367,758,168600,84642
166,132,34,968,172900,84643
704,628,76,625,266700,84645
547,472,75,726,156500,84646
1485,1185,300,858,165500,84647
2060,1609,451,797,193100,84648
305,261,44,622,156400,84649
7154,5743,1411,911,239300,84651
297,270,27,810,152500,84652
2356,2070,286,1144,336300,84653
1026,809,217,721,110200,84654
3184,2744,440,941,232400,84655
129,111,18,763,174300,84656
242,173,69,646,140900,84657
10880,8330,2550,1106,251900,84660
493,423,70,891,176500,84662
9291,6474,2817,986,242000,84663
2451,2310,141,1384,389000,84664
149,138,11,-,280000,84665
109,81,28,-,174000,84667
2915,1972,943,727,165300,84701
36,28,8,1100,200000,84710
228,200,28,859,184100,84711
53,47,6,-,143800,84712
1237,841,396,617,183000,84713
183,113,70,840,106600,84714
147,136,11,500,170700,84715
129,69,60,820,263900,84716
78,53,25,939,232500,84718
36,23,13,-,119200,84719
7259,4311,2948,724,224000,84720
6949,4580,2369,788,197800,84721
368,321,47,834,177700,84722
245,214,31,639,161600,84723
440,360,80,632,120300,84724
517,439,78,1020,191100,84725
349,291,58,754,158200,84726
20,0,20,-,-,84728
81,71,10,-,163300,84729
87,85,2,-,204600,84730
56,56,0,-,150000,84731
21,21,0,-,-,84732
70,42,28,-,325000,84733
112,54,58,517,187500,84734
93,84,9,-,221400,84735
89,81,8,-,121300,84736
6081,4355,1726,1018,217900,84737
3243,2644,599,1113,265700,84738
196,145,51,725,152400,84739
34,33,1,-,151800,84740
2163,1756,407,1007,195500,84741
100,86,14,636,583300,84742
1,1,0,-,-,84743
95,87,8,-,141100,84744
1283,1036,247,1019,170600,84745
366,327,39,713,305100,84746
420,289,131,589,161300,84747
101,82,19,-,234400,84749
184,160,24,941,136400,84750
668,529,139,731,127800,84751
341,260,81,885,177800,84752
6,6,0,-,-,84753
1327,1157,170,696,196100,84754
21,21,0,-,-,84755
148,85,63,-,176000,84756
457,321,136,1317,334900,84757
171,137,34,883,141000,84758
651,533,118,775,185500,84759
185,158,27,691,178100,84760
1212,972,240,944,168300,84761
98,70,28,-,232900,84762
138,111,27,830,419600,84763
75,25,50,617,-,84764
2081,1699,382,1426,295400,84765
88,57,31,-,184900,84766
193,138,55,542,537500,84767
14682,8447,6235,914,245000,84770
111,81,30,-,260900,84772
100,77,23,-,251200,84773
511,475,36,1331,288700,84774
141,128,13,-,200000,84775
206,163,43,789,203600,84776
231,189,42,833,302900,84779
8203,5637,2566,1110,277800,84780
84,68,16,-,267600,84781
301,279,22,-,284400,84782
328,315,13,-,388300,84783
336,32,304,927,115000,84784
15244,11255,3989,1084,279200,84790
3912,1412,2500,847,343100,85003
2753,566,2187,965,271100,85004
9251,3489,5762,828,185400,85006
5157,1831,3326,780,261400,85007
21902,5465,16437,884,159700,85008
12338,5534,6804,793,87900,85009
3560,1907,1653,1042,398200,85012
9903,4403,5500,954,264600,85013
12867,4526,8341,949,249300,85014
14885,5439,9446,775,162100,85015
16566,7596,8970,944,295300,85016
11584,4619,6965,769,105500,85017
17207,9157,8050,927,495200,85018
7512,3661,3851,897,135100,85019
15522,8262,7260,905,245900,85020
15941,6233,9708,836,261800,85021
21806,11843,9963,1042,233900,85022
12687,7337,5350,964,212400,85023
9953,6939,3014,1337,248000,85024
15536,8617,6919,1083,170600,85027
7962,6331,1631,1339,361600,85028
17042,8637,8405,889,168800,85029
7906,4039,3867,961,130500,85031
27909,15168,12741,986,227600,85032
15952,7548,8404,981,131400,85033
1833,395,1438,715,124400,85034
14758,5487,9271,993,136500,85035
14533,8200,6333,1165,153200,85037
10007,4253,5754,890,117900,85040
17015,10668,6347,1111,156500,85041
14525,8430,6095,1046,172800,85042
9813,5508,4305,1168,161400,85043
17072,10090,6982,1188,284700,85044
2473,2216,257,2032,397300,85045
13339,9297,4042,1352,361700,85048
11797,8573,3224,1606,325600,85050
14978,7866,7112,858,153000,85051
11221,6408,4813,955,189200,85053
3649,1286,2363,1507,374900,85054
6332,5660,672,1859,353800,85083
8482,5177,3305,1250,367700,85085
14642,11658,2984,1634,332300,85086
3087,2721,366,1576,292700,85087
6436,5934,502,1160,273700,85118
10177,7834,2343,830,149800,85119
13812,10565,3247,774,78500,85120
508,109,399,586,103800,85121
18859,11940,6919,930,130000,85122
4530,2916,1614,892,103000,85123
4739,2883,1856,763,98900,85128
3392,2202,1190,670,85400,85131
7703,5889,1814,967,147300,85132
181,117,64,600,32600,85135
944,641,303,965,89900,85137
11451,8799,2652,1353,190200,85138
5564,3794,1770,1244,165500,85139
13971,11180,2791,1205,205600,85140
141,114,27,858,56300,85141
19760,16627,3133,1382,294400,85142
12086,8699,3387,1287,192800,85143
1014,814,200,1176,143000,85145
1163,375,788,670,89000,85147
509,258,251,871,-,85172
1198,860,338,720,78600,85173
694,630,64,542,83100,85192
1393,989,404,739,81600,85193
2946,2514,432,1097,196500,85194
19560,6536,13024,893,160900,85201
15762,6844,8918,924,214400,85202
12567,6870,5697,927,228600,85203
22177,12163,10014,977,168700,85204
17300,12026,5274,947,182500,85205
15388,9902,5486,1157,188900,85206
17981,13931,4050,1120,262500,85207
14861,11001,3860,1166,134300,85208
15916,11854,4062,1229,211000,85209
14558,5767,8791,894,171300,85210
9944,8043,1901,1367,287200,85212
12594,9340,3254,1058,261400,85213
7425,6081,1344,1291,245900,85215
16856,9126,7730,1232,236800,85224
25231,14350,10881,1090,223000,85225
14291,8760,5531,1277,285500,85226
12613,8392,4221,1289,289800,85233
15747,11187,4560,1236,295400,85234
15597,12250,3347,1327,311000,85248
13504,11768,1736,1726,363500,85249
8614,6108,2506,1234,330200,85250
20456,9729,10727,1133,311700,85251
7583,6414,1169,1552,1235800,85253
18225,12865,5360,1442,433800,85254
17354,13582,3772,1836,657800,85255
1707,1266,441,552,44100,85256
14305,8076,6229,1166,249100,85257
12684,8918,3766,1440,471100,85258
9500,7322,2178,1156,613900,85259
17518,10622,6896,1345,433600,85260
5203,4662,541,2298,779400,85262
1350,1279,71,-,473300,85263
418,350,68,536,254200,85264
5361,5144,217,2388,739300,85266
11693,9250,2443,1236,406700,85268
23822,4752,19070,1070,194900,85281
22334,9651,12683,1079,220200,85282
19477,9121,10356,1139,243700,85283
7090,5853,1237,1699,417500,85284
13834,8930,4904,1484,344700,85286
14095,8995,5100,1443,314000,85295
13703,10678,3025,1603,280800,85296
9706,7151,2555,1597,323400,85297
9840,8826,1014,2044,371900,85298
21934,7789,14145,793,102000,85301
14383,7679,6704,903,174400,85302
9529,5642,3887,1027,170700,85303
9312,6548,2764,1151,194900,85304
4356,2410,1946,1191,237300,85305
8860,5155,3705,1086,200800,85306
3369,1503,1866,1103,174600,85307
24544,17197,7347,1205,259900,85308
0,0,0,-,-,85309
6696,5612,1084,1484,299500,85310
325,244,81,612,204700,85320
1655,1084,571,784,77900,85321
266,191,75,491,154300,85322
12686,6452,6234,1080,168600,85323
1406,1224,182,775,102800,85324
631,598,33,-,99800,85325
15693,10682,5011,1143,179600,85326
111,53,58,1063,-,85328
11644,10213,1431,1713,445300,85331
737,666,71,1061,146500,85332
268,185,83,675,82300,85333
461,308,153,559,55600,85334
10478,6519,3959,1184,151500,85335
155,106,49,823,93300,85336
802,356,446,578,77300,85337
15228,11018,4210,1307,233800,85338
12695,8969,3726,1440,220200,85339
10558,8099,2459,1385,297900,85340
0,0,0,-,-,85341
707,579,128,613,161000,85342
71,36,35,-,132000,85343
3701,2513,1188,726,107300,85344
19806,12750,7056,1078,158900,85345
2597,1949,648,601,74400,85346
209,95,114,538,66400,85347
1137,1013,124,454,41700,85348
8133,5473,2660,697,115600,85349
5945,4223,1722,712,122600,85350
17612,14831,2781,1056,138600,85351
208,183,25,-,75400,85352
10546,6951,3595,1187,181100,85353
2263,1670,593,793,150600,85354
3491,3014,477,1449,310500,85355
1864,1532,332,809,82000,85356
181,134,47,399,65900,85357
82,31,51,271,-,85360
2054,1784,270,1104,206800,85361
382,279,103,828,129500,85362
2456,1282,1174,952,141800,85363
26211,14443,11768,793,125200,85364
18790,13632,5158,1074,129200,85365
10717,8748,1969,1123,127000,85367
93,52,41,473,-,85371
8906,7594,1312,1330,197000,85373
21551,15559,5992,1165,199300,85374
16778,14827,1951,1277,211100,85375
1719,1295,424,1264,690200,85377
14073,10079,3994,1411,231400,85379
9028,6022,3006,1225,243600,85381
15463,10717,4746,1309,249600,85382
15795,14187,1608,1746,369000,85383
4799,4057,742,1119,285000,85387
8697,6762,1935,1365,234100,85388
4191,3283,908,669,229900,85390
12719,7105,5614,1175,221200,85392
9999,7841,2158,1403,334000,85395
6292,5371,921,1449,264500,85396
5259,3586,1673,795,107000,85501
410,290,120,362,29000,85530
142,89,53,792,204600,85531
1163,716,447,623,80300,85533
1021,847,174,683,83200,85534
0,0,0,-,-,85535
171,155,16,-,-,85536
1766,1330,436,626,76200,85539
1020,0,1020,433,-,85540
9784,7422,2362,920,212700,85541
679,375,304,410,28300,85542
1215,979,236,942,135300,85543
1316,1211,105,795,275600,85544
298,270,28,-,102500,85545
5919,4101,1818,736,128700,85546
1160,612,548,382,32400,85550
118,108,10,-,83100,85551
2168,1400,768,825,157000,85552
854,690,164,437,141800,85553
303,226,77,680,198900,85554
382,300,82,717,-,85601
4129,2966,1163,787,105200,85602
3221,2300,921,655,125100,85603
239,146,93,-,62300,85605
510,435,75,545,110900,85606
5040,3518,1522,591,89800,85607
0,0,0,-,-,85608
118,118,0,-,-,85609
436,346,90,567,111200,85610
415,394,21,-,286200,85611
905,5,900,1229,-,85613
13030,10459,2571,1014,167700,85614
3978,3465,513,1038,182100,85615
2343,1614,729,648,122700,85616
626,452,174,547,142900,85617
639,479,160,628,59400,85618
42,9,33,-,-,85619
228,152,76,596,71400,85620
7078,3556,3522,576,117500,85621
3655,3274,381,1097,231700,85622
2159,1844,315,842,235800,85623
569,402,167,742,211100,85624
1029,931,98,775,104300,85625
343,280,63,-,88200,85626
453,343,110,1042,124000,85627
8384,6956,1428,1414,183100,85629
985,851,134,654,158300,85630
1361,972,389,822,72300,85631
397,324,73,636,167200,85632
12,2,10,417,-,85633
1626,979,647,532,64800,85634
14276,7820,6456,893,157800,85635
503,455,48,-,380500,85637
948,698,250,616,126400,85638
78,62,16,-,-,85640
8904,8101,803,1421,230200,85641
3198,2177,1021,549,96700,85643
728,640,88,772,108800,85645
767,669,98,1870,332600,85646
6174,4832,1342,908,138900,85648
6424,5599,825,1170,204900,85650
5845,4840,1005,1033,153500,85653
0,0,0,-,-,85654
4766,4096,670,1232,330100,85658
2747,683,2064,844,256100,85701
14821,8493,6328,963,255800,85704
23656,10455,13201,695,77900,85705
17097,10058,7039,782,91800,85706
0,0,0,-,-,85707
1230,19,1211,1279,-,85708
25061,13126,11935,837,157100,85710
16673,8040,8633,760,150200,85711
15901,5876,10025,811,153800,85712
16772,10647,6125,792,90200,85713
5242,2817,2425,644,89100,85714
7731,5200,2531,1065,225200,85715
14825,5972,8853,757,184100,85716
12569,8616,3953,934,472700,85718
17495,4762,12733,847,195400,85719
0,0,0,-,-,85723
0,0,0,-,-,85724
0,0,0,-,-,85726
15369,10318,5051,928,137300,85730
4315,3673,642,902,122900,85735
1863,1596,267,1004,89400,85736
9541,6873,2668,1270,294900,85737
8601,7756,845,1094,293700,85739
14150,8021,6129,1063,166800,85741
10296,7935,2361,1250,197700,85742
11468,9397,2071,1240,211100,85743
16110,9446,6664,916,212300,85745
14561,9630,4931,904,121300,85746
8616,6662,1954,1404,207300,85747
7515,5397,2118,1176,223800,85748
7676,6357,1319,1170,367200,85749
11325,7873,3452,999,383900,85750
7012,6189,823,1543,307900,85755
10889,8108,2781,1019,115100,85756
6184,4557,1627,976,156000,85757
7068,4896,2172,895,163600,85901
430,255,175,513,55200,85911
166,166,0,-,78700,85912
231,198,33,743,209400,85920
23,23,0,-,307100,85922
163,117,46,-,173000,85923
1134,1081,53,-,95300,85924
1714,1414,300,692,169400,85925
100,57,43,375,81400,85926
74,53,21,-,408300,85927
429,275,154,542,245100,85928
3055,2077,978,783,168100,85929
265,129,136,567,96800,85930
95,87,8,-,275000,85931
163,117,46,-,445700,85932
1233,890,343,766,194400,85933
142,142,0,-,198900,85934
1968,1588,380,696,250000,85935
1087,839,248,523,98600,85936
2406,1995,411,703,131700,85937
769,572,197,592,119200,85938
1571,1099,472,809,155300,85939
457,440,17,-,171300,85940
2523,1576,947,462,59000,85941
44,44,0,-,-,85942
17469,8661,8808,1233,346200,86001
3,3,0,-,-,86003
13247,8345,4902,1185,299800,86004
68,0,68,642,-,86011
169,62,107,-,-,86015
20,20,0,-,-,86016
499,441,58,-,235500,86017
404,326,78,1370,276600,86018
585,500,85,513,53900,86020
809,154,655,814,134400,86021
719,482,237,617,127100,86022
742,120,622,472,33000,86023
326,305,21,-,290500,86024
1728,1026,702,655,87200,86025
0,0,0,-,-,86028
64,64,0,-,"10,000-",86029
387,349,38,-,94500,86030
513,383,130,645,84600,86031
519,378,141,680,123800,86032
2138,1189,949,566,47700,86033
598,390,208,448,85500,86034
558,428,130,561,69600,86035
177,129,48,-,104000,86036
9,9,0,-,-,86038
403,339,64,-,97000,86039
3226,2180,1046,920,97700,86040
548,330,218,850,57200,86042
568,485,83,638,83100,86043
976,834,142,564,53600,86044
3062,2024,1038,638,54400,86045
2427,1787,640,1013,181500,86046
4100,2396,1704,574,87300,86047
0,0,0,-,-,86052
550,462,88,513,53700,86053
540,384,156,536,57200,86054
9843,6424,3419,1041,266400,86301
8269,5745,2524,839,322900,86303
8064,6373,1691,897,383500,86305
0,0,0,-,-,86313
15323,9295,6028,925,194700,86314
3247,2993,254,1816,278300,86315
843,756,87,810,84600,86320
772,130,642,484,33300,86321
4283,3138,1145,713,183700,86322
6864,5411,1453,892,196300,86323
2292,1595,697,971,238200,86324
2492,2129,363,1333,267800,86325
10352,6491,3861,929,183100,86326
4205,3671,534,1102,201600,86327
440,406,34,-,193500,86329
227,138,89,834,307100,86331
832,665,167,809,144300,86332
2630,2192,438,771,107500,86333
1760,1231,529,956,163400,86334
2238,1552,686,884,151100,86335
6181,4810,1371,1203,446700,86336
567,453,114,590,89500,86337
221,161,60,680,361300,86338
46,42,4,-,162900,86343
3252,2364,888,1178,451100,86351
9984,6959,3025,846,141400,86401
7525,4395,3130,833,195400,86403
7643,5649,1994,909,229300,86404
10601,7916,2685,896,254500,86406
11232,7924,3308,774,92100,86409
138,130,8,-,116700,86411
5231,4599,632,744,79000,86413
6126,4568,1558,913,157200,86426
3549,2001,1548,788,226900,86429
250,201,49,-,70700,86431
1603,1153,450,683,87600,86432
0,0,0,-,-,86433
451,245,206,443,68800,86434
3,3,0,-,-,86435
622,480,142,508,76300,86436
36,24,12,1104,56900,86437
402,318,84,617,69200,86438
3105,2115,990,634,146800,86440
1199,930,269,515,81200,86441
13981,8127,5854,749,102500,86442
0,0,0,-,-,86443
539,474,65,743,68800,86444
148,148,0,-,143800,86445
363,343,20,-,51500,86502
3142,2193,949,466,30600,86503
1780,1174,606,557,38500,86504
2047,1692,355,466,46600,86505
358,310,48,613,46300,86506
560,532,28,766,48500,86507
204,196,8,-,53800,86508
1330,1112,218,492,94500,86510
1016,944,72,431,45700,86511
694,513,181,522,72700,86512
827,654,173,571,56500,86514
1301,712,589,432,50200,86515
460,398,62,575,53000,86520
320,313,7,-,49500,86535
636,449,187,414,38500,86538
257,224,33,461,66500,86540
295,257,38,525,50200,86544
372,335,37,570,50200,86545
279,262,17,-,51100,86547
446,251,195,292,46100,86556
907,659,248,538,179600,87001
8596,6317,2279,774,132100,87002
4110,2955,1155,778,153500,87004
202,156,46,-,152000,87005
226,201,25,-,137500,87006
285,261,24,-,77100,87007
1105,989,116,1670,268500,87008
506,427,79,1024,260300,87010
29,29,0,-,128100,87011
89,59,30,-,-,87012
1542,1077,465,554,63300,87013
279,228,51,-,111100,87014
4980,4567,413,1033,193400,87015
1099,907,192,607,134100,87016
112,89,23,1045,170800,87017
163,100,63,-,24200,87018
3966,2395,1571,662,104600,87020
1222,776,446,741,79200,87021
323,310,13,-,63500,87022
210,210,0,-,137500,87023
545,456,89,556,121100,87024
577,537,40,-,262300,87025
1122,931,191,398,76000,87026
142,86,56,-,110600,87027
92,92,0,-,-,87028
153,148,5,-,-,87029
15242,12601,2641,850,131300,87031
65,19,46,-,-,87032
516,475,41,556,73800,87034
2742,2296,446,843,116200,87035
667,528,139,794,75100,87036
229,191,38,-,55500,87037
179,106,73,258,58000,87038
163,163,0,-,-,87040
271,191,80,724,125500,87041
1323,1105,218,786,194900,87042
2244,1991,253,1090,351100,87043
102,102,0,-,245000,87044
502,455,47,-,29700,87045
52,46,6,-,203100,87046
1832,1659,173,1401,287100,87047
3938,3558,380,1052,420800,87048
364,333,31,675,70900,87049
333,301,32,-,79900,87051
554,421,133,458,117300,87052
367,255,112,778,88000,87053
446,393,53,691,268600,87056
4271,3924,347,1236,248300,87059
246,246,0,-,-,87061
394,346,48,734,52700,87062
85,47,38,-,53200,87063
56,56,0,-,228600,87064
1852,1708,144,856,187000,87068
26,0,26,-,-,87070
168,144,24,563,107100,87072
264,235,29,1132,149800,87083
9318,3247,6071,706,141000,87102
5724,3324,2400,789,230300,87104
19931,14469,5462,752,140600,87105
11082,4413,6669,731,252600,87106
13101,8388,4713,729,221300,87107
16760,5451,11309,666,161000,87108
17859,9108,8751,842,217700,87109
17104,10830,6274,841,190600,87110
24223,15508,8715,1043,267000,87111
18063,11055,7008,810,178200,87112
5793,4488,1305,1217,249300,87113
25056,17150,7906,1077,212200,87114
1226,22,1204,1331,-,87116
0,0,0,-,-,87117
23559,17385,6174,1093,195100,87120
23992,17180,6812,1037,130300,87121
7054,6224,830,1381,472600,87122
17081,10743,6338,783,179800,87123
20661,15747,4914,1027,174600,87124
14223,11224,2999,1223,192200,87144
7735,4649,3086,724,121600,87301
1001,881,120,-,37000,87305
274,247,27,-,66300,87310
1054,845,209,521,31900,87311
186,152,34,-,21900,87312
1620,938,682,586,64100,87313
82,54,28,-,86600,87315
304,195,109,575,38800,87316
546,420,126,-,23000,87317
474,438,36,-,37700,87319
157,142,15,375,52400,87320
769,627,142,377,92600,87321
32,32,0,-,-,87322
1277,965,312,694,51400,87323
851,729,122,552,53800,87325
494,451,43,-,45300,87326
1850,1481,369,544,73600,87327
683,336,347,437,47500,87328
96,66,30,-,161300,87347
227,128,99,483,36700,87357
294,263,31,383,46600,87364
744,683,61,390,46300,87375
16112,10258,5854,842,167400,87401
3744,2956,788,1125,231700,87402
6452,5005,1447,803,156500,87410
328,298,30,-,115700,87412
5677,4203,1474,786,149000,87413
639,594,45,-,165900,87415
1481,1186,295,892,72800,87416
1898,1294,604,792,153000,87417
378,300,78,590,186400,87418
178,126,52,-,-,87419
3240,2205,1035,470,72300,87420
512,380,132,796,98600,87421
561,441,120,573,43200,87455
422,393,29,586,49800,87461
169,135,34,-,76500,87499
8130,5151,2979,1179,423600,87501
14003,8389,5614,1019,328800,87505
5682,4603,1079,928,407300,87506
17947,12045,5902,987,216200,87507
7808,6666,1142,1308,364100,87508
326,190,136,-,127800,87510
787,560,227,540,134800,87511
26,26,0,-,-,87512
216,138,78,1101,335000,87513
274,274,0,-,247600,87514
118,118,0,-,-,87515
21,21,0,-,-,87516
232,184,48,-,172100,87517
9,9,0,-,-,87518
236,131,105,784,106300,87519
518,452,66,720,240000,87520
370,313,57,713,-,87521
923,750,173,-,156300,87522
214,178,36,-,240300,87523
39,39,0,-,-,87524
32,23,9,-,613100,87525
261,251,10,-,123200,87527
727,500,227,501,92700,87528
1480,1141,339,749,295100,87529
203,203,0,-,144300,87530
189,165,24,-,166400,87531
6429,4302,2127,687,174500,87532
58,39,19,738,17900,87533
548,442,106,1688,180800,87535
856,668,188,623,144200,87537
319,239,80,-,173100,87538
22,22,0,-,-,87539
424,368,56,2125,438300,87540
56,56,0,-,-,87543
7567,5611,1956,1037,292200,87544
522,423,99,-,162500,87548
266,218,48,-,160100,87549
162,162,0,-,288600,87551
1532,1285,247,665,156000,87552
479,362,117,595,139800,87553
0,0,0,-,-,87554
967,844,123,531,144400,87556
2189,1795,394,927,302900,87557
180,103,77,836,273600,87558
487,273,214,723,65100,87560
135,110,25,-,-,87562
133,133,0,-,347300,87564
228,151,77,-,88200,87565
806,713,93,650,236900,87566
557,304,253,550,156600,87567
218,190,28,-,160400,87569
4614,3102,1512,628,248300,87571
38,38,0,-,-,87573
93,79,14,-,65900,87574
270,197,73,-,303900,87575
163,163,0,-,122800,87577
119,119,0,-,161500,87578
296,240,56,778,171300,87579
181,127,54,-,-,87580
17,17,0,-,-,87581
264,231,33,-,117900,87582
69,53,16,-,136700,87583
7379,4920,2459,634,121200,87701
735,534,201,645,310500,87710
316,250,66,-,58100,87711
78,54,24,-,211400,87712
88,78,10,-,-,87713
498,318,180,640,93800,87714
198,95,103,-,-,87715
182,137,45,-,172800,87718
211,211,0,-,106600,87722
104,73,31,-,-,87723
21,0,21,-,-,87724
165,110,55,471,64500,87728
16,13,3,-,165600,87729
10,5,5,-,-,87730
115,98,17,-,241900,87731
514,391,123,820,75100,87732
43,30,13,-,106800,87733
63,49,14,-,-,87734
75,55,20,-,-,87735
31,31,0,-,-,87736
3451,2323,1128,571,91900,87740
268,246,22,-,172400,87742
129,79,50,547,67300,87743
285,250,35,-,205600,87745
48,28,20,-,55000,87746
564,436,128,425,105900,87747
48,24,24,-,-,87749
0,0,0,-,-,87750
133,96,37,475,58000,87752
33,15,18,-,-,87753
2665,1641,1024,612,121400,87801
39,39,0,-,-,87820
265,264,1,-,203500,87821
297,237,60,-,168400,87823
42,42,0,-,179000,87824
674,628,46,-,57000,87825
45,32,13,-,-,87827
139,131,8,-,60700,87828
260,260,0,-,155100,87829
514,451,63,1125,124700,87830
61,56,5,-,-,87831
101,101,0,-,33200,87832
3109,2097,1012,495,81300,87901
275,213,62,576,77800,87930
390,319,71,734,135900,87931
34,34,0,-,-,87933
840,776,64,845,140400,87935
178,163,15,-,129500,87936
958,629,329,334,77900,87937
57,57,0,-,-,87939
231,177,54,-,-,87940
291,190,101,-,72800,87941
420,349,71,883,144200,87942
74,74,0,-,-,87943
14113,5847,8266,677,106600,88001
273,25,248,1201,-,88002
0,0,0,-,-,88003
0,0,0,-,-,88004
10609,6607,4002,697,151400,88005
8610,6388,2222,712,163000,88007
2663,1701,962,782,186300,88008
3,0,3,-,-,88009
13011,6741,6270,964,260000,88011
9992,7628,2364,1008,144800,88012
261,206,55,-,80000,88020
5832,3942,1890,589,101000,88021
411,350,61,758,113600,88022
999,617,382,642,81800,88023
51,35,16,-,-,88024
131,105,26,-,-,88025
581,437,144,538,75400,88026
133,113,20,-,185200,88027
130,112,18,-,198400,88028
529,367,162,347,69600,88029
8478,5075,3403,536,86500,88030
130,83,47,-,59000,88032
0,0,0,-,-,88033
16,16,0,-,-,88034
142,109,33,-,212900,88038
187,176,11,-,141200,88039
49,39,10,-,64200,88040
568,454,114,536,107200,88041
120,120,0,-,331500,88042
612,493,119,694,83400,88043
1263,956,307,643,98200,88044
1377,936,441,473,82200,88045
372,210,162,706,202300,88046
824,635,189,849,106500,88047
948,836,112,-,88800,88048
213,152,61,-,213000,88049
51,51,0,-,150800,88051
101,55,46,-,-,88052
132,20,112,542,341200,88053
24,24,0,-,-,88055
104,83,21,-,114100,88056
7700,5320,2380,699,161900,88061
4042,2692,1350,585,94900,88063
252,145,107,952,128800,88065
474,327,147,659,114100,88072
4281,3324,957,647,71200,88081
17462,9850,7612,850,130000,88101
0,0,0,-,-,88103
57,41,16,-,162500,88112
29,12,17,-,90000,88113
11,11,0,-,-,88114
40,36,4,-,50000,88115
195,159,36,-,120700,88116
123,74,49,-,160000,88118
668,455,213,657,95300,88119
85,69,16,-,96300,88120
41,34,7,471,112500,88121
454,365,89,768,94800,88124
27,7,20,-,-,88125
17,17,0,-,-,88126
6463,3899,2564,761,113100,88130
74,50,24,-,150000,88132
17,0,17,-,-,88134
497,334,163,737,107900,88135
20,13,7,-,-,88136
9981,7166,2815,798,150500,88201
10652,7003,3649,750,91400,88203
6799,4733,2066,842,168100,88210
13528,9686,3842,928,139600,88220
1580,1112,468,771,89500,88230
1075,803,272,973,98000,88231
643,529,114,625,86800,88232
12655,7958,4697,873,127200,88240
2403,1913,490,1019,191100,88242
111,26,85,-,-,88250
758,523,235,698,67400,88252
261,177,84,883,89700,88253
29,29,0,-,-,88254
11,11,0,-,-,88255
689,479,210,909,113700,88256
4679,3370,1309,801,115400,88260
5,5,0,-,-,88262
74,53,21,-,-,88263
11,0,11,-,-,88264
54,45,9,-,126000,88265
463,345,118,650,82100,88267
63,34,29,-,-,88268
467,399,68,687,88100,88301
14685,9106,5579,797,116100,88310
475,419,56,525,63200,88311
1228,1124,104,912,303000,88312
16,16,0,-,-,88314
862,665,197,802,168900,88316
723,653,70,1094,169700,88317
106,91,15,-,235000,88318
59,48,11,-,35000,88321
0,0,0,-,-,88323
79,72,7,-,182100,88324
354,274,80,757,217500,88325
973,9,964,1135,-,88330
128,82,46,-,155800,88336
935,821,114,580,111500,88337
49,49,0,-,167500,88338
207,180,27,-,153800,88339
982,565,417,305,62300,88340
255,253,2,-,262100,88341
40,35,5,-,-,88342
5,5,0,-,-,88343
12,12,0,-,-,88344
3461,2648,813,699,214500,88345
950,469,481,512,153600,88346
46,14,32,-,-,88347
135,97,38,-,-,88348
14,14,0,-,-,88349
221,221,0,-,107600,88350
92,65,27,-,-,88351
1827,1569,258,597,110500,88352
84,46,38,325,45200,88353
0,0,0,-,-,88354
0,0,0,-,-,88355
2372,1376,996,528,66100,88401
21,12,9,-,-,88410
26,15,11,-,195800,88411
8,6,2,-,-,88414
1128,771,357,541,78200,88415
35,35,0,-,-,88416
0,0,0,-,-,88417
78,56,22,1313,-,88418
61,56,5,-,190000,88419
39,39,0,-,-,88421
31,31,0,-,173600,88422
40,36,4,-,"2,000,000+",88424
383,329,54,650,88300,88426
56,41,15,-,-,88427
54,45,9,-,-,88430
12,12,0,-,-,88431
126,100,26,-,73300,88434
1071,695,376,374,88700,88435
37,20,17,-,-,88436
480,409,71,639,117900,89001
11985,8873,3112,1343,266600,89002
417,178,239,615,60300,89003
124,112,12,-,397200,89004
6481,4488,1993,991,269200,89005
329,223,106,-,201000,89007
572,381,191,767,132500,89008
183,106,77,511,119300,89010
9898,6218,3680,1147,247500,89011
14219,8989,5230,1339,308000,89012
169,117,52,556,67500,89013
16083,7238,8845,1106,243500,89014
14974,8824,6150,998,213400,89015
51,51,0,-,-,89017
338,284,54,807,76700,89018
946,633,313,579,146200,89019
422,201,221,630,85000,89020
971,788,183,1032,243300,89021
0,0,0,-,-,89022
338,251,87,665,117200,89025
0,0,0,-,-,89026
7889,5602,2287,849,216000,89027
3946,1698,2248,716,152100,89029
13742,5026,8716,851,113200,89030
20812,14099,6713,1356,206400,89031
13966,7976,5990,1168,186700,89032
101,89,12,633,85000,89039
1401,1020,381,882,133300,89040
470,291,179,488,136200,89042
468,370,98,575,175700,89043
8819,7409,1410,1677,348200,89044
890,714,176,894,67800,89045
197,131,66,832,68600,89046
74,41,33,560,37500,89047
8869,6195,2674,844,157600,89048
1279,520,759,625,67400,89049
21558,13983,7575,1419,382100,89052
29,29,0,-,-,89054
3925,2985,940,762,115900,89060
2587,2225,362,1068,196200,89061
19940,11939,8001,1272,283500,89074
10845,6308,4537,1325,223500,89081
9330,5946,3384,1298,280000,89084
1113,968,145,2004,298500,89085
1835,674,1161,1195,264500,89086
14622,2664,11958,721,115300,89101
14711,3406,11305,837,190000,89102
21695,7075,14620,940,140500,89103
14209,6284,7925,811,146000,89104
8639,2634,6005,869,141900,89106
12575,6184,6391,917,152800,89107
26276,11792,14484,992,163600,89108
4187,1298,2889,933,370200,89109
20835,11411,9424,976,164400,89110
11321,6187,5134,1215,282000,89113
18309,5905,12404,894,125500,89115
23095,10818,12277,1155,303400,89117
8137,3260,4877,1099,252900,89118
21650,3726,17924,855,174900,89119
9301,4980,4321,1007,209200,89120
24091,11311,12780,909,157200,89121
17869,9988,7881,1022,155700,89122
23638,12327,11311,1247,259400,89123
437,373,64,1028,362600,89124
14679,7537,7142,1134,228900,89128
19954,13077,6877,1254,258200,89129
12549,8917,3632,1293,246100,89130
16188,12231,3957,1426,317000,89131
11398,9160,2238,1617,288200,89134
11540,7843,3697,1742,401500,89135
5790,3940,1850,1784,466100,89138
12589,7555,5034,1445,274300,89139
10740,7113,3627,1581,312600,89141
11054,6139,4915,1100,167000,89142
4206,3091,1115,1465,261800,89143
7328,4669,2659,1431,330300,89144
9613,5821,3792,1176,204200,89145
6836,3011,3825,987,268100,89146
19644,9848,9796,1215,229500,89147
17641,8341,9300,1398,286000,89148
14585,9445,5140,1276,290600,89149
9455,5340,4115,920,158400,89156
86,86,0,-,365900,89161
6627,4467,2160,1302,275800,89166
9194,1693,7501,809,147400,89169
12424,8930,3494,1434,277000,89178
2081,1738,343,1482,288400,89179
13992,6659,7333,1282,241000,89183
0,0,0,-,-,89191
2734,1994,740,612,168000,89301
201,165,36,367,255000,89310
52,32,20,-,-,89311
136,65,71,375,34800,89314
492,340,152,391,89700,89316
117,117,0,-,176600,89317
532,375,157,767,91000,89318
78,78,0,-,-,89319
8,8,0,-,-,89402
6057,4281,1776,1003,225900,89403
28,15,13,-,-,89404
55,0,55,1526,-,89405
9796,6433,3363,799,174400,89406
7264,4884,2380,1108,186200,89408
118,118,0,-,36300,89409
4822,3072,1750,954,328400,89410
280,246,34,731,763200,89411
105,105,0,-,-,89412
282,232,50,"3,500+",1375000,89413
94,80,14,-,106900,89414
1412,982,430,592,99600,89415
129,98,31,-,45500,89418
1494,1058,436,660,102700,89419
0,0,0,-,-,89420
217,185,32,575,77400,89421
62,62,0,-,37200,89422
4542,3792,750,1339,387300,89423
109,76,33,361,83600,89424
148,102,46,-,-,89425
50,17,33,-,-,89426
445,271,174,311,48100,89427
75,51,24,-,-,89428
2836,2347,489,926,122700,89429
166,148,18,-,348500,89430
14605,6225,8380,865,199500,89431
6781,4541,2240,988,147600,89433
10705,6683,4022,1165,246900,89434
15834,11845,3989,1549,326400,89436
49,49,0,-,"10,000-",89438
656,503,153,1180,302400,89439
324,233,91,762,304000,89440
4437,3768,669,1709,358900,89441
441,316,125,606,113900,89442
1255,1101,154,993,215200,89444
6016,4542,1474,813,175400,89445
0,0,0,-,-,89446
3224,2052,1172,710,123900,89447
747,583,164,1375,678900,89448
1468,751,717,1138,428700,89449
27,20,7,-,-,89450
3770,2763,1007,1454,833300,89451
5557,3560,1997,1041,318500,89460
2427,558,1869,669,296700,89501
18527,6461,12066,834,201100,89502
11671,5282,6389,872,265000,89503
13823,9293,4530,1129,223800,89506
4461,3957,504,1364,253100,89508
16670,8758,7912,943,387000,89509
651,602,49,541,349300,89510
10877,8107,2770,1282,565400,89511
10218,3143,7075,798,165400,89512
3719,2986,733,1429,491700,89519
11875,8456,3419,1590,365300,89521
14428,8073,6355,1211,360500,89523
10070,5612,4458,860,235700,89701
0,0,0,-,-,89702
4525,3096,1429,861,370200,89703
1834,1608,226,896,343700,89704
2140,1544,596,1196,252200,89705
8525,4254,4271,971,168800,89706
8922,6054,2868,1025,214600,89801
4783,4282,501,1350,225300,89815
1933,1548,385,618,179800,89820
240,191,49,1000,57000,89821
700,549,151,1053,119900,89822
40,40,0,-,450000,89823
537,195,342,540,-,89825
0,0,0,-,-,89826
165,165,0,-,228400,89828
87,40,47,-,-,89830
0,0,0,-,-,89831
484,291,193,423,70800,89832
51,6,45,261,-,89833
41,16,25,-,-,89834
648,398,250,737,166700,89835
1307,817,490,734,135500,89883
13815,4966,8849,1087,336100,90001
12706,4540,8166,1147,306000,90002
17127,4856,12271,1178,327700,90003
21971,3670,18301,1229,1014000,90004
16442,1303,15139,1138,734200,90005
19419,1708,17711,1071,585300,90006
11884,1344,10540,1154,580700,90007
14834,5004,9830,1157,636500,90008
1961,420,1541,1841,876800,90010
24160,6213,17947,1123,350500,90011
12736,1307,11429,1518,495400,90012
6966,607,6359,768,567700,90013
5496,170,5326,1559,545900,90014
9423,1236,8187,1204,653300,90015
17087,6515,10572,1204,524700,90016
10869,435,10434,1009,626400,90017
16426,4996,11430,1122,507200,90018
24756,6951,17805,1319,857000,90019
16396,1483,14913,1303,600400,90020
1758,160,1598,548,890600,90021
17444,5724,11720,1078,373600,90022
11519,3159,8360,1087,393000,90023
16737,5140,11597,2157,1173700,90024
22105,5881,16224,1918,813200,90025
25785,6161,19624,1284,777700,90026
21716,4051,17665,1397,1071700,90027
16652,784,15868,1364,727600,90028
14018,1303,12715,1151,671800,90029
11621,3739,7882,1114,481900,90031
13470,6741,6729,1152,468200,90032
13236,2403,10833,1032,393500,90033
25878,4985,20893,1649,900000,90034
12329,4027,8302,1864,1028600,90035
18426,3269,15157,2169,1239500,90036
17334,4120,13214,1060,369900,90037
11601,1023,10578,1229,761200,90038
11413,5152,6261,1642,809000,90039
3512,1619,1893,1124,381700,90040
9724,5135,4589,1381,698800,90041
20622,9098,11524,1281,576700,90042
17066,9171,7895,1122,489600,90043
28160,8049,20111,1092,360300,90044
15514,8041,7473,1924,913800,90045
29183,6346,22837,1614,1148300,90046
17420,9719,7701,1198,394800,90047
12054,3674,8380,2103,1242500,90048
16647,8498,8149,2149,"2,000,000+",90049
3374,2251,1123,1740,935500,90056
17031,608,16423,1018,423300,90057
757,80,677,632,314000,90058
10628,4898,5730,988,321200,90059
7318,3009,4309,1158,332400,90061
9905,4295,5610,1185,392500,90062
13675,5482,8193,1118,377400,90063
10958,6159,4799,1936,1114900,90064
15337,7386,7951,1250,651300,90065
25225,9387,15838,1698,1001700,90066
1375,1132,243,3042,1041200,90067
11360,5549,5811,1710,1171900,90068
12640,4717,7923,1773,843500,90069
0,0,0,-,-,90071
0,0,0,-,-,90073
3276,2767,509,2304,"2,000,000+",90077
0,0,0,-,-,90079
7,0,7,-,-,90089
0,0,0,-,-,90090
4345,1643,2702,2967,981000,90094
0,0,0,-,-,90095
24065,5457,18608,1185,388900,90201
8036,5747,2289,2422,"2,000,000+",90210
3805,1180,2625,1900,1564200,90211
5934,1764,4170,2131,"2,000,000+",90212
13509,7916,5593,1193,295000,90220
12228,6265,5963,1153,331700,90221
7985,3932,4053,1196,321600,90222
13204,7284,5920,1664,696000,90230
6410,2398,4012,1702,1023200,90232
7442,4939,2503,1470,577500,90240
13542,5787,7755,1318,541500,90241
12203,6074,6129,1416,476900,90242
6639,2938,3701,1785,969700,90245
15886,6172,9714,1228,428100,90247
3822,2717,1105,1239,452500,90248
8784,5182,3602,1206,453100,90249
31978,9753,22225,1195,513500,90250
8979,4371,4608,2143,1357300,90254
18500,6074,12426,1035,377200,90255
10509,4026,6483,1426,505500,90260
15551,6653,8898,1161,371600,90262
0,0,0,-,-,90263
7555,5578,1977,2556,"2,000,000+",90265
13520,9450,4070,2499,1947900,90266
6679,1731,4948,1028,375600,90270
9008,7278,1730,2490,"2,000,000+",90272
9089,7969,1120,2475,1542300,90274
15634,12204,3430,2678,1114700,90275
15724,7096,8628,1990,1021900,90277
15354,8890,6464,1932,828600,90278
23926,10096,13830,1125,375900,90280
2236,1745,491,2236,997500,90290
13612,4455,9157,1972,1521800,90291
12381,3809,8572,2851,944800,90292
6679,3149,3530,2074,739700,90293
12136,3125,9011,1221,396500,90301
10893,3048,7845,1275,410400,90302
7144,2789,4355,1270,425400,90303
6430,1845,4585,1135,409500,90304
5946,3894,2052,1453,468800,90305
4649,340,4309,1707,1101900,90401
4874,3357,1517,1893,"2,000,000+",90402
12918,2976,9942,1900,1104100,90403
9904,2297,7607,1579,808800,90404
14029,4698,9331,1685,1304200,90405
14244,6157,8087,1367,622300,90501
6011,3849,2162,1464,429700,90502
16738,8456,8282,1757,751200,90503
11559,6991,4568,1474,610100,90504
14089,8047,6042,1700,834600,90505
0,0,0,-,-,90506
11097,6548,4549,1323,500700,90601
7769,3078,4691,1247,506200,90602
6659,5203,1456,1822,583000,90603
12295,8211,4084,1455,488900,90604
10388,7134,3254,1437,449400,90605
8893,5968,2925,1413,428600,90606
13091,9190,3901,1744,535800,90620
10172,4061,6111,1497,560500,90621
4952,3403,1549,1705,636200,90623
15927,10583,5344,1834,605000,90630
21332,13035,8297,1495,559000,90631
14462,11315,3147,1636,517500,90638
19290,8372,10918,1263,467300,90640
27180,17344,9836,1488,410400,90650
16666,11219,5447,1304,415100,90660
4868,3287,1581,1414,432300,90670
8659,4296,4363,1487,373300,90680
4602,2181,2421,1591,506300,90701
15553,12031,3522,2256,659200,90703
1562,451,1111,1427,714400,90704
23517,9222,14295,1303,436200,90706
9162,4805,4357,1166,468900,90710
10453,7743,2710,1843,519300,90712
9267,7562,1705,1924,565100,90713
5994,3479,2515,1599,446500,90715
3809,1562,2247,1327,342400,90716
8515,3961,4554,1312,583600,90717
7922,5042,2880,1858,878900,90720
14452,5569,8883,1335,323600,90723
22624,7108,15516,1267,552600,90731
8522,6036,2486,1961,596600,90732
12515,9453,3062,1870,356100,90740
388,126,262,2061,1128400,90742
119,80,39,"3,500+","2,000,000+",90743
14638,5444,9194,1111,374400,90744
15139,10313,4826,1416,418600,90745
8159,7023,1136,1781,462100,90746
0,0,0,-,-,90747
4607,2128,2479,1398,487000,90755
20749,4280,16469,1228,385700,90802
16947,7336,9611,1635,857100,90803
15066,3222,11844,1278,476600,90804
27034,11245,15789,1189,374900,90805
12821,4414,8407,1139,437100,90806
12644,6667,5977,1366,582300,90807
13967,10943,3024,1772,634300,90808
9334,5142,4192,1181,385000,90810
17148,2027,15121,1071,364800,90813
8954,3463,5491,1377,658700,90814
14459,9775,4684,1859,622200,90815
0,0,0,-,-,90822
0,0,0,-,-,90831
12745,9558,3187,1639,693900,91001
10459,7034,3425,1742,960500,91006
11617,6370,5247,1480,1015900,91007
428,271,157,2777,1606100,91008
8073,5152,2921,1522,445600,91010
6597,5906,691,2851,1403000,91011
14354,7061,7293,1461,614800,91016
3450,1195,2255,1603,595600,91020
4603,2854,1749,1470,924400,91024
9992,4670,5322,1660,985000,91030
7263,5248,2015,1400,543600,91040
9854,5185,4669,1361,529400,91042
100,0,100,1097,-,91046
10521,1751,8770,1633,523400,91101
8500,3957,4543,1383,671700,91103
12960,6450,6510,1408,698600,91104
5299,3135,2164,2338,1093200,91105
10554,3920,6634,1642,713300,91106
12462,7567,4895,1667,802400,91107
4686,4047,639,"3,500+",1862500,91108
8311,2401,5910,1535,709600,91201
8764,3138,5626,1695,730200,91202
5698,1024,4674,1550,494800,91203
6327,627,5700,1395,480700,91204
14294,2156,12138,1378,545000,91205
13294,4598,8696,1558,750000,91206
4166,2288,1878,1668,1032600,91207
5806,3735,2071,1823,867600,91208
308,67,241,2950,506600,91210
10240,7854,2386,1840,732300,91214
9191,7165,2026,2318,784500,91301
9513,6672,2841,2356,1201400,91302
9823,2366,7457,1446,432300,91303
17225,8743,8482,1419,581000,91304
14510,8197,6313,1354,474700,91306
8738,7380,1358,2727,644400,91307
14122,9244,4878,1825,585400,91311
12252,6073,6179,1663,668900,91316
15032,11423,3609,2256,670000,91320
11045,6078,4967,1539,450000,91321
9925,5119,4806,1636,588300,91324
11748,5620,6128,1490,638700,91325
12888,9384,3504,1895,719800,91326
0,0,0,-,-,91330
23367,14396,8971,1387,391600,91331
24085,11435,12650,1395,459200,91335
8870,4849,4021,1343,399200,91340
25033,16388,8645,1525,429100,91342
17850,9052,8798,1311,485500,91343
16820,12628,4192,1754,593900,91344
5314,3921,1393,1646,441800,91345
11458,9598,1860,1862,504600,91350
9871,6961,2910,1668,412300,91351
12474,6742,5732,1347,454500,91352
10277,8029,2248,2279,574100,91354
12030,7068,4962,1933,529300,91355
11827,6702,5125,1546,878100,91356
15002,10064,4938,1817,642000,91360
8583,6502,2081,2248,914300,91361
13506,9625,3881,1988,792200,91362
10607,7132,3475,2186,808600,91364
18236,9357,8879,2066,666000,91367
0,0,0,-,-,91371
5306,3767,1539,2286,734800,91377
6675,4612,2063,1899,670900,91381
6980,5849,1131,1587,491800,91384
13240,8084,5156,1872,487800,91387
5996,5429,567,2177,576500,91390
15132,5162,9970,1318,645400,91401
19476,6406,13070,1241,385300,91402
11491,5080,6411,1749,921900,91403
18009,4788,13221,1224,457300,91405
18126,7166,10960,1357,497400,91406
9689,2606,7083,1361,621400,91411
15305,6030,9275,1791,890300,91423
5594,4411,1183,2312,1228000,91436
7870,2542,5328,1653,704500,91501
5125,448,4677,1417,501600,91502
9414,4973,4441,1580,720600,91504
12835,6010,6825,1808,667400,91505
7460,4036,3424,1587,680400,91506
16809,3283,13526,1440,607600,91601
9557,3238,6319,1702,728400,91602
14808,6797,8011,1840,1088000,91604
15774,5799,9975,1305,458300,91605
15439,4725,10714,1243,532400,91606
13673,4097,9576,1485,762400,91607
0,0,0,-,-,91608
13050,10268,2782,1682,488500,91701
15383,8718,6665,1407,389800,91702
18172,10267,7905,1430,380800,91706
590,303,287,2040,501000,91708
24374,18392,5982,2053,597400,91709
21639,13745,7894,1533,435700,91710
11938,7716,4222,1612,645400,91711
9880,7045,2835,1460,419500,91722
6250,2547,3703,1320,453900,91723
7941,5668,2273,1680,509100,91724
23576,10529,13047,1688,382200,91730
8085,3109,4976,1146,429700,91731
15904,6979,8925,1242,431900,91732
11150,4728,6422,1229,418000,91733
7977,5670,2307,1836,589200,91737
11598,8185,3413,1836,585300,91739
8357,5640,2717,1462,472800,91740
8941,6517,2424,1730,656900,91741
18895,12614,6281,1393,390300,91744
16233,12557,3676,1794,570600,91745
6676,4967,1709,1348,421400,91746
13492,8513,4979,1529,609600,91748
11856,8857,2999,1465,568300,91750
8456,5190,3266,1496,426400,91752
11109,6118,4991,1296,593900,91754
8783,4270,4513,1393,592600,91755
195,128,67,1488,429200,91759
17028,10935,6093,1528,366000,91761
17326,8638,8688,1248,348300,91762
10281,5349,4932,1274,334800,91763
16129,7223,8906,1476,331200,91764
14937,11255,3682,1952,643200,91765
17906,9463,8443,1335,372400,91766
14099,7284,6815,1280,364800,91767
8073,4197,3876,1204,357400,91768
16977,8616,8361,1322,523200,91770
11494,8277,3217,1723,545600,91773
8070,5321,2749,1529,761900,91775
11455,4353,7102,1399,601000,91776
11173,6615,4558,1548,687600,91780
8945,7574,1371,2262,617000,91784
19085,8107,10978,1348,417300,91786
13264,11015,2249,2166,707600,91789
12217,8426,3791,1526,473200,91790
10170,6795,3375,1520,566600,91791
8655,4776,3879,1694,461900,91792
19721,7044,12677,1357,577000,91801
9671,4427,5244,1324,589700,91803
6411,4611,1800,1465,563500,91901
6249,4671,1578,1905,639100,91902
565,346,219,704,285500,91905
1218,832,386,1088,266500,91906
24999,11893,13106,1364,453300,91910
24928,12713,12215,1422,400600,91911
14756,10387,4369,2193,484400,91913
4350,3511,839,2637,635100,91914
8255,6050,2205,2377,530500,91915
664,624,40,867,367800,91916
205,189,16,-,450000,91917
145,125,20,-,-,91931
9175,2811,6364,1344,488800,91932
150,150,0,-,138300,91934
2869,2479,390,1851,615700,91935
11656,7255,4401,1452,602900,91941
16318,6318,10000,1465,464500,91942
8548,4543,4005,1304,402000,91945
15,15,0,-,-,91948
16787,6021,10766,1122,366000,91950
801,601,200,1182,423500,91962
266,220,46,-,270500,91963
18984,11082,7902,1363,415700,91977
3331,2164,1167,1744,434000,91978
84,64,20,-,-,91980
1773,1222,551,1806,670500,92003
1193,981,212,748,151300,92004
4469,2590,1879,1924,1042300,92007
11410,5249,6161,1844,764200,92008
16469,12075,4394,2061,820400,92009
5963,4257,1706,2134,635100,92010
9451,6302,3149,2157,793600,92011
5924,3840,2084,2248,1448800,92014
14566,9671,4895,1628,497900,92019
19156,7643,11513,1276,495800,92020
22463,11329,11134,1331,401400,92021
19544,12589,6955,1874,893100,92024
15760,6634,9126,1300,484900,92025
16853,9948,6905,1477,452200,92026
16363,9775,6588,1354,410700,92027
16575,11071,5504,1209,537900,92028
6996,5227,1769,1811,612500,92029
1105,826,279,1175,357100,92036
17064,9939,7125,1976,1447200,92037
15274,9854,5420,1347,432500,92040
15358,6062,9296,1442,556400,92054
195,0,195,2761,-,92055
19412,12089,7323,1813,472900,92056
19342,12667,6675,1857,436100,92057
14202,3905,10297,1910,387900,92058
481,381,100,983,291700,92059
63,51,12,-,277500,92060
699,457,242,1253,368800,92061
15796,11666,4130,1532,658700,92064
11969,9089,2880,1487,479800,92065
194,122,72,1145,363500,92066
2873,2427,446,2079,"2,000,000+",92067
14927,8451,6476,1457,484600,92069
315,250,65,625,403700,92070
19611,13863,5748,1687,422600,92071
5330,3077,2253,2094,1137900,92075
16986,11440,5546,1802,524100,92078
10424,5585,4839,1782,509500,92081
6021,4853,1168,1172,551300,92082
11290,5130,6160,1470,396300,92083
14879,8501,6378,1404,503900,92084
702,593,109,895,156700,92086
652,575,77,2704,926200,92091
23297,5631,17666,1591,603100,92101
14592,4103,10489,1216,395300,92102
18118,6241,11877,1473,740400,92103
21017,6071,14946,1343,592800,92104
21777,6535,15242,1123,369900,92105
7461,4298,3163,1904,975400,92106
13758,5490,8268,1531,832200,92107
11097,3002,8095,2105,352100,92108
22554,6428,16126,1665,862000,92109
11476,4694,6782,1620,571100,92110
16892,8457,8435,1529,516900,92111
13088,3616,9472,1113,328100,92113
17994,11812,6182,1380,380900,92114
21425,7019,14406,1333,471600,92115
16553,5583,10970,1333,597400,92116
20865,12304,8561,1627,588600,92117
8396,4279,4117,2401,1537000,92118
9335,6629,2706,1753,548500,92119
11387,7842,3545,1756,588100,92120
1798,990,808,1956,768100,92121
19946,6339,13607,2031,696400,92122
11788,5822,5966,2061,507900,92123
10947,5175,5772,2326,605900,92124
25221,13990,11231,1966,497500,92126
15584,10334,5250,2014,773000,92127
20638,13232,7406,2044,601900,92128
17879,11919,5960,1935,684100,92129
19525,12993,6532,2422,991000,92130
11654,9064,2590,2322,752000,92131
0,0,0,-,-,92132
0,0,0,-,-,92134
0,0,0,-,-,92135
10410,6199,4211,1521,377500,92139
0,0,0,-,-,92140
692,488,204,1353,1309000,92145
0,0,0,-,-,92147
21999,12987,9012,1538,383900,92154
0,0,0,-,-,92155
7998,2395,5603,1103,355100,92173
22942,14625,8317,1035,229700,92201
11751,8726,3025,1454,338600,92203
2613,2208,405,861,692900,92210
12788,9543,3245,1379,357000,92211
11667,7547,4120,1014,227500,92220
0,0,0,-,-,92222
16599,12820,3779,1183,293100,92223
5891,3161,2730,738,143400,92225
7043,3978,3065,806,170700,92227
984,556,428,1035,149600,92230
8825,4837,3988,906,196500,92231
1043,580,463,650,135200,92233
17951,10987,6964,1167,259700,92234
14772,10139,4633,886,208000,92236
98,89,9,100-,113300,92239
11952,5775,6177,958,175600,92240
3584,2828,756,845,77200,92241
628,504,124,627,75800,92242
12945,6793,6152,793,179200,92243
1836,1158,678,765,195400,92249
2402,1498,904,643,174000,92250
5135,3808,1327,1164,228000,92251
3901,2229,1672,885,122900,92252
15243,11125,4118,1525,386200,92253
2947,1808,1139,635,147500,92254
1552,1208,344,809,135900,92256
551,408,143,429,47700,92257
283,200,83,819,73800,92258
56,50,6,-,-,92259
15607,9206,6401,1231,323600,92260
13233,7688,5545,1021,377300,92262
10917,6904,4013,1094,352100,92264
96,68,28,-,-,92266
5,0,5,-,-,92267
318,268,50,873,264400,92268
9406,7587,1819,1196,499900,92270
461,221,240,825,144300,92273
4980,3551,1429,681,88700,92274
822,631,191,1044,134700,92275
2707,1878,829,1197,165400,92276
9136,3251,5885,912,129600,92277
298,0,298,1191,-,92278
19,0,19,-,-,92280
693,317,376,757,114300,92281
420,289,131,1286,153900,92282
548,289,259,529,79800,92283
10930,7259,3671,940,164600,92284
1022,813,209,883,100500,92285
8077,4182,3895,1112,180600,92301
12,0,12,-,-,92304
253,160,93,1500,279300,92305
12868,8546,4322,1014,244200,92307
14291,9344,4947,1051,229500,92308
188,53,135,668,-,92309
2500,2,2498,1337,-,92310
11416,5442,5974,762,113200,92311
4407,2780,1627,1363,302100,92313
4495,2891,1604,1094,258200,92314
2216,1264,952,923,391100,92315
7575,5342,2233,1208,254400,92316
3298,2782,516,1096,201300,92320
425,303,122,1160,299500,92321
302,287,15,-,216800,92322
18075,9470,8605,1139,238400,92324
3388,2208,1180,952,220400,92325
282,133,149,722,111300,92327
195,54,141,241,11800,92328
42,3,39,-,-,92332
172,156,16,-,415200,92333
24837,12480,12357,1137,283800,92335
24524,18603,5921,1827,396700,92336
9766,6912,2854,1611,332800,92337
0,0,0,-,-,92338
450,331,119,1265,264300,92339
118,99,19,-,191800,92341
2502,1945,557,1409,219900,92342
6082,4627,1455,1464,286100,92344
23480,14614,8866,1104,215200,92345
17265,11412,5853,1074,315800,92346
253,223,30,-,82900,92347
2276,1766,510,1338,438200,92352
7762,3238,4524,1277,351200,92354
2229,1594,635,779,147500,92356
420,304,116,1339,277300,92358
3092,1990,1102,952,295300,92359
2234,1164,1070,616,87200,92363
0,0,0,-,-,92364
1038,769,269,988,125900,92365
293,127,166,938,153100,92368
5187,3812,1375,1131,203400,92371
2178,1579,599,1090,235100,92372
12841,6769,6072,1339,437200,92373
13696,8187,5509,1258,332200,92374
21468,12586,8882,1178,261400,92376
5340,4678,662,1789,345500,92377
86,86,0,-,275000,92378
1835,1205,630,1165,254200,92382
10,0,10,-,-,92384
89,77,12,-,346000,92385
998,619,379,1068,186700,92386
87,63,24,-,64100,92389
927,508,419,786,267200,92391
15994,9178,6816,1352,217300,92392
8025,5142,2883,1257,211600,92394
13429,6854,6575,1133,202800,92395
1726,1197,529,1168,299200,92397
647,276,371,686,109500,92398
18769,13485,5284,1111,316500,92399
672,80,592,780,121400,92401
17722,7647,10075,1012,237900,92404
8862,4047,4815,1047,210600,92405
17028,10169,6859,1242,299800,92407
3713,1346,2367,957,239100,92408
12482,5107,7375,913,128400,92410
6430,3320,3110,1062,171700,92411
6706,2872,3834,1118,290700,92501
25016,15759,9257,1275,348400,92503
16538,9771,6767,1260,336100,92504
13517,6928,6589,1452,330900,92505
14871,11159,3712,1423,414500,92506
16763,5388,11375,1242,308000,92507
10244,8052,2192,1997,445600,92508
18963,13091,5872,1236,322100,92509
500,46,454,1743,289500,92518
14959,8582,6377,1286,297000,92530
6908,5304,1604,1822,353500,92532
1059,741,318,1022,277200,92536
1627,1083,544,822,172800,92539
12833,6379,6454,964,119300,92543
15314,10266,5048,1134,214500,92544
14948,9885,5063,1284,217200,92545
2356,1452,904,1030,127400,92548
1145,746,399,1075,276300,92549
7868,5145,2723,1436,265100,92551
18331,8876,9455,1307,251100,92553
10774,7969,2805,1755,338300,92555
13743,8979,4764,1426,305200,92557
595,514,81,916,333100,92561
19745,13447,6298,1658,413300,92562
17952,12404,5548,1768,392900,92563
2577,1833,744,1157,298100,92567
13944,8816,5128,1142,265900,92570
12406,8239,4167,1479,259000,92571
3942,2934,1008,1565,245500,92582
9296,5653,3643,1058,195600,92583
14463,11819,2644,1824,353000,92584
6043,4839,1204,1557,333800,92585
9137,6040,3097,1170,213600,92586
5593,4443,1150,1714,378400,92587
1552,636,916,976,1045700,92590
12968,7725,5243,1736,425100,92591
24505,17984,6521,1921,447600,92592
9504,6724,2780,1544,335000,92595
7927,5954,1973,1950,400700,92596
8735,4314,4421,2285,819900,92602
7292,4857,2435,2389,1172200,92603
9698,6038,3660,2221,715100,92604
8660,3819,4841,2284,768800,92606
4857,3644,1213,2057,694200,92610
12736,3955,8781,2262,697700,92612
9804,4365,5439,2292,715000,92614
3991,953,3038,1374,470300,92617
17258,5901,11357,2348,782900,92618
17819,11096,6723,2227,865500,92620
2810,1858,952,1958,781800,92624
5804,3936,1868,2555,"2,000,000+",92625
19058,7888,11170,1907,707300,92626
22180,8235,13945,1685,712200,92627
11439,7065,4374,1995,880500,92629
21234,14303,6931,1927,601700,92630
11156,8305,2851,1695,278300,92637
21352,16121,5231,1994,719400,92646
21363,9750,11613,1827,663600,92647
19471,9678,9793,1792,879200,92648
14247,8730,5517,1794,735300,92649
11126,7120,4006,2264,1778000,92651
9970,7177,2793,2056,703500,92653
2499,896,1603,1348,498800,92655
19252,11684,7568,2168,604600,92656
3884,3263,621,2532,"2,000,000+",92657
15268,8128,7140,2345,1659100,92660
1519,671,848,2054,"2,000,000+",92661
1350,818,532,2046,"2,000,000+",92662
10029,4563,5466,1892,1249700,92663
14230,7712,6518,1770,867100,92672
10294,8553,1741,2394,892100,92673
12895,9576,3319,2006,683400,92675
847,669,178,2080,680400,92676
25667,17760,7907,2179,795300,92677
218,147,71,2058,715900,92678
10711,9261,1450,2381,862000,92679
27536,14479,13057,1488,581900,92683
16081,10940,5141,1948,618400,92688
16759,12586,4173,2145,650900,92691
17552,13482,4070,2154,695700,92692
8620,6578,2042,2430,803300,92694
13053,3573,9480,1231,430200,92701
13589,6580,7009,1527,415500,92703
20269,10647,9622,1648,446700,92704
14711,10027,4684,1649,839200,92705
9189,5042,4147,1352,591400,92706
13931,7175,6756,1645,432900,92707
18892,12819,6073,1909,687700,92708
19343,8899,10444,1649,553500,92780
8059,4963,3096,2283,799000,92782
17826,6024,11802,1517,443900,92801
11503,4195,7308,1426,481400,92802
24572,10006,14566,1508,499700,92804
19113,7781,11332,1458,468000,92805
12380,4622,7758,1759,547100,92806
12337,9842,2495,2082,659500,92807
7417,5567,1850,2238,701400,92808
13516,7994,5522,1776,618900,92821
1448,1295,153,3235,783100,92823
12407,4855,7552,1549,624600,92831
8209,3040,5169,1480,516700,92832
16375,9482,6893,1639,602500,92833
8502,6142,2360,1659,752000,92835
15131,8286,6845,1515,487600,92840
9559,4901,4658,1429,531700,92841
11761,5438,6323,1414,474500,92843
6715,2742,3973,1498,468300,92844
5655,4560,1095,1803,599100,92845
7149,5870,1279,1958,496700,92860
1979,1870,109,3493,1159800,92861
6340,3796,2544,1807,590100,92865
5468,1987,3481,1596,644200,92866
12906,8546,4360,1721,684100,92867
8016,2641,5375,1760,462300,92868
11597,8535,3062,1812,663500,92869
17128,11098,6030,1734,609600,92870
14384,8061,6323,1550,388500,92879
17575,12763,4812,2199,516800,92880
9851,7727,2124,1430,501200,92881
21510,14109,7401,1477,436200,92882
10403,8541,1862,2327,452700,92883
16559,13469,3090,2019,794400,92886
6792,5795,997,1927,864200,92887
12806,5187,7619,1402,549900,93001
19191,11136,8055,1667,534400,93003
10856,7000,3856,1703,520500,93004
15798,9755,6043,1796,607900,93010
13138,9836,3302,2086,607000,93012
6232,3457,2775,1899,753200,93013
5064,3062,2002,1357,395900,93015
11783,8895,2888,1908,624900,93021
2508,1926,582,1505,497400,93022
7989,5134,2855,1497,650600,93023
14954,7281,7673,1366,447200,93030
17109,9586,7523,1484,367900,93033
9982,5830,4152,1946,541700,93035
12879,6660,6219,1584,448100,93036
572,362,210,1188,319400,93040
7194,3199,3995,1709,385100,93041
0,0,0,-,-,93042
16,2,14,-,-,93043
10001,5355,4646,1232,375300,93060
19096,13549,5547,1827,531700,93063
0,0,0,-,-,93064
23865,17537,6328,2003,575000,93065
1070,717,353,1506,905500,93066
295,160,135,3206,777800,93067
12842,3043,9799,1553,863700,93101
7608,3642,3966,1955,1022400,93103
11356,6247,5109,1896,1012700,93105
4116,3088,1028,2244,"2,000,000+",93108
4615,2832,1783,2122,1159000,93109
6358,4109,2249,1866,830900,93110
6166,4054,2112,2101,869100,93111
15977,6024,9953,1665,793400,93117
378,161,217,801,95000,93201
1112,627,485,1030,133400,93202
5345,2419,2926,873,154300,93203
2299,1080,1219,802,138900,93204
727,507,220,761,98300,93205
562,258,304,903,144200,93206
114,107,7,-,158000,93207
47,0,47,-,-,93208
4566,2406,2160,847,166500,93210
4220,1985,2235,819,144600,93212
11937,7036,4901,873,173300,93215
253,177,76,788,107900,93218
2520,1082,1438,715,131800,93219
58,0,58,-,-,93220
4800,3328,1472,911,221400,93221
683,589,94,1413,206300,93222
2760,1754,1006,753,143000,93223
159,103,56,1030,92500,93224
1812,1090,722,925,173600,93225
107,89,18,886,198400,93226
21799,12449,9350,967,213900,93230
1852,512,1340,677,153800,93234
1245,698,547,768,130400,93235
538,332,206,930,225500,93238
349,158,191,730,159500,93239
2707,1631,1076,836,134900,93240
4150,1601,2549,810,119300,93241
1056,506,550,931,206300,93242
776,486,290,797,-,93243
160,134,26,850,259500,93244
12194,5505,6689,1108,219800,93245
5246,2867,2379,774,151300,93247
541,178,363,670,118600,93249
3733,2070,1663,882,162500,93250
78,49,29,395,45800,93251
542,311,231,778,85000,93252
280,157,123,965,120800,93254
326,277,49,-,67700,93255
1560,575,985,792,121600,93256
21804,11601,10203,879,166500,93257
558,259,299,825,102400,93258
87,57,30,1979,143100,93260
743,296,447,683,109100,93261
0,0,0,-,-,93262
5516,2834,2682,825,171700,93263
1717,1399,318,1072,247300,93265
339,105,234,1043,167800,93266
1774,974,800,819,139100,93267
5710,3003,2707,851,139900,93268
1569,974,595,794,199600,93270
1075,882,193,1122,314700,93271
1094,404,690,860,125000,93272
21580,11902,9678,987,191200,93274
61,28,33,645,-,93276
18022,10094,7928,976,210400,93277
6251,3557,2694,746,160300,93280
1028,784,244,594,103100,93283
1208,1021,187,801,113600,93285
2859,1709,1150,689,166000,93286
45,45,0,-,194800,93287
16769,10589,6180,942,259800,93291
13275,8113,5162,1063,206700,93292
4651,1367,3284,820,202200,93301
15060,6672,8388,926,151300,93304
10844,3831,7013,815,141200,93305
22240,14212,8028,1022,194500,93306
22006,11357,10649,946,153500,93307
19454,8888,10566,954,207500,93308
21718,9807,11911,986,194700,93309
14551,10339,4212,1411,294600,93311
19560,15267,4293,1576,290600,93312
13981,10140,3841,1518,234800,93313
8934,7557,1377,1369,359400,93314
12088,5590,6498,1368,658100,93401
6503,4503,2000,1480,498600,93402
8574,2945,5629,1612,673400,93405
0,0,0,-,-,93410
11634,7989,3645,1391,626100,93420
12791,8282,4509,1349,492700,93422
512,277,235,1503,815200,93424
497,396,101,1020,459300,93426
2123,1430,693,1513,513400,93427
2881,2101,780,1417,638200,93428
36,36,0,-,172500,93429
1478,905,573,1234,707200,93430
451,402,49,1368,611300,93432
5216,2366,2850,1328,464000,93433
2014,1028,986,1182,238200,93434
17978,9196,8782,1192,322200,93436
917,0,917,1816,-,93437
485,258,227,1590,470700,93440
403,292,111,2100,915900,93441
4968,2939,2029,1456,589500,93442
7148,5333,1815,1551,557800,93444
2468,1458,1010,1275,355900,93445
17438,11546,5892,1195,445600,93446
4245,2627,1618,1678,689900,93449
229,49,180,1019,267300,93450
1331,848,483,1441,354500,93451
277,66,211,976,415400,93452
1309,925,384,1048,448300,93453
11695,6066,5629,1322,329500,93454
15245,11283,3962,1722,394000,93455
13230,5845,7385,1297,303400,93458
1939,1493,446,1574,944600,93460
539,266,273,1577,281900,93461
3247,2044,1203,1491,760600,93463
3285,2469,816,1589,588200,93465
1845,744,1101,700,105800,93501
4008,2040,1968,967,112800,93505
2703,2478,225,1202,536700,93510
134,112,22,-,187500,93512
750,532,218,848,233800,93513
6159,4067,2092,939,306500,93514
986,539,447,703,63400,93516
232,226,6,-,230000,93517
425,318,107,1167,176700,93518
22,22,0,-,-,93519
43,43,0,-,31500,93522
1141,220,921,1459,57900,93523
0,0,0,-,-,93524
288,196,92,784,168100,93526
675,492,183,951,170700,93527
80,30,50,-,-,93528
200,161,39,-,356900,93529
15,15,0,-,26900,93530
129,103,26,-,445100,93531
1039,776,263,1178,264700,93532
13943,4664,9279,1066,204200,93534
20976,11795,9181,1126,181900,93535
21529,14617,6912,1327,305100,93536
146,91,55,-,209800,93541
3711,2428,1283,1322,237300,93543
521,472,49,-,227200,93544
829,469,360,764,256300,93545
3080,1599,1481,1190,382400,93546
112,89,23,-,195600,93549
21577,11367,10210,1081,210100,93550
15932,12232,3700,1688,346600,93551
9972,7535,2437,1625,241300,93552
724,541,183,1167,232700,93553
56,47,9,-,-,93554
12980,8464,4516,870,174800,93555
31,15,16,-,-,93558
6969,4361,2608,961,186900,93560
11574,8704,2870,989,252500,93561
756,391,365,573,57700,93562
127,90,37,-,304000,93563
1886,1328,558,1113,174200,93591
49,26,23,-,67800,93592
652,491,161,783,325100,93601
1499,1289,210,1090,277900,93602
73,46,27,-,-,93603
310,295,15,-,694300,93604
53,17,36,922,322700,93605
221,123,98,885,154200,93606
270,126,144,849,115500,93608
1538,803,735,826,177200,93609
4891,2481,2410,882,219100,93610
15615,11345,4270,1619,311500,93611
13606,4883,8723,991,191000,93612
4562,3996,566,1290,261600,93614
1521,676,845,918,109000,93615
686,369,317,711,264600,93616
8074,4221,3853,893,193700,93618
12342,10641,1701,1960,402900,93619
2826,1723,1103,891,206700,93620
64,33,31,-,-,93621
2820,1149,1671,711,158000,93622
58,58,0,-,334100,93623
218,6,212,548,-,93624
2350,1191,1159,1057,252900,93625
722,605,117,1608,354000,93626
39,0,39,-,-,93627
87,38,49,-,-,93628
5341,2696,2645,945,218300,93630
5350,3459,1891,896,277300,93631
0,0,0,-,-,93633
2,2,0,-,-,93634
11353,6248,5105,1164,268100,93635
4044,3611,433,1365,312300,93636
12305,7111,5194,1019,219100,93637
12275,6330,5945,970,187600,93638
2847,1012,1835,781,153900,93640
113,91,22,-,254500,93641
1257,1003,254,809,252500,93643
3543,2545,998,1022,288600,93644
88,88,0,-,389500,93645
2786,1149,1637,738,144200,93646
2889,1415,1474,896,141100,93647
4299,1827,2472,786,155400,93648
1308,599,709,856,75900,93650
713,621,92,1349,387500,93651
103,37,66,819,99500,93652
530,474,56,1161,280000,93653
8753,5682,3071,963,213000,93654
1670,883,787,988,167400,93656
10529,6560,3969,927,251200,93657
1120,412,708,591,156600,93660
8496,4916,3580,960,183900,93662
210,167,43,950,509900,93664
250,214,36,-,86900,93665
231,39,192,792,104600,93666
875,680,195,950,258500,93667
359,203,156,1087,260300,93668
80,47,33,-,-,93669
184,99,85,766,126400,93673
1286,1158,128,1049,193000,93675
3376,495,2881,670,112000,93701
11894,4080,7814,788,116400,93702
9889,3721,6168,913,140000,93703
11302,6034,5268,991,238700,93704
12109,4990,7119,899,159800,93705
11087,4430,6657,821,149700,93706
11238,4487,6751,972,228400,93710
15945,9401,6544,1162,343500,93711
17979,10295,7684,1459,312300,93720
2000,227,1773,777,150400,93721
24718,14039,10679,1156,226300,93722
3836,3104,732,1338,311200,93723
6666,3547,3119,945,176600,93725
14130,5454,8676,914,167900,93726
24224,13907,10317,914,237200,93727
5781,2350,3431,855,146700,93728
4223,3159,1064,1744,439200,93730
9690,4059,5631,1249,454500,93901
12899,4952,7947,1163,337700,93905
16920,8860,8060,1463,369200,93906
7235,5207,2028,1450,463300,93907
4514,3681,833,2461,747900,93908
485,95,390,702,1536500,93920
1674,1007,667,2083,1370100,93921
5489,4243,1246,2002,1124500,93923
2550,1891,659,1683,938900,93924
420,166,254,922,338900,93925
2315,1100,1215,1135,345300,93926
4133,1883,2250,1246,277300,93927
17,0,17,-,-,93928
4255,2163,2092,1118,273600,93930
260,135,125,995,271600,93932
8838,3560,5278,1333,474400,93933
13044,5559,7485,1741,769300,93940
0,0,0,-,-,93943
6845,3254,3591,1689,823900,93950
1750,1455,295,2976,1215000,93953
100,42,58,1107,224100,93954
10606,4280,6326,1635,445400,93955
4081,2412,1669,1260,332400,93960
142,75,67,-,564000,93962
10380,6308,4072,2147,1374300,94002
1836,1354,482,1967,872700,94005
16037,9460,6577,2093,"2,000,000+",94010
14028,8169,5859,1789,661000,94014
20052,11199,8853,2182,758900,94015
7328,5124,2204,2010,950500,94019
607,436,171,1573,827700,94020
61,14,47,1109,-,94021
7165,5776,1389,3140,"2,000,000+",94022
7845,6979,866,3146,"2,000,000+",94024
14964,9172,5792,2268,1950600,94025
2313,2132,181,"3,500+","2,000,000+",94027
2543,2056,487,2877,"2,000,000+",94028
8047,5161,2886,2320,1230600,94030
1064,905,159,1708,914400,94037
1110,857,253,1617,939600,94038
14444,6016,8428,2317,1618800,94040
6368,2008,4360,2272,1355400,94041
13024,5965,7059,2368,1011500,94043
13954,9591,4363,2248,818100,94044
318,239,79,2272,1076000,94060
13894,7113,6781,2093,1126300,94061
10248,7537,2711,1970,1634400,94062
10092,3596,6496,1933,776600,94063
5192,3593,1599,3217,1234400,94065
14807,8546,6261,2194,839000,94066
11638,8459,3179,2182,1512600,94070
94,74,20,-,1112900,94074
21204,12974,8230,1892,785200,94080
8361,3124,5237,2280,865400,94085
19461,6377,13084,2265,1101600,94086
20180,11559,8621,2333,1530200,94087
8101,4913,3188,2700,273500,94089
17841,1478,16363,1043,812200,94102
14841,2310,12531,1219,889900,94103
272,36,236,514,1722200,94104
4908,2096,2812,2902,967400,94105
13961,5632,8329,2365,1041200,94107
7833,805,7028,1238,1090200,94108
33108,5301,27807,1772,980600,94109
27736,10001,17735,1716,1051700,94110
2160,459,1701,2264,1099700,94111
23266,14961,8305,1718,790200,94112
16860,7642,9218,2172,1359100,94114
17208,4641,12567,1984,1244700,94115
16247,11174,5073,1987,1010000,94116
18204,5505,12699,2213,1299900,94117
17657,6229,11428,1937,1485400,94118
17641,7760,9881,1848,1138900,94121
23141,11310,11831,2000,1030700,94122
13918,3629,10289,2326,"2,000,000+",94123
11041,5694,5347,1034,678600,94124
7532,5995,1537,2652,1253000,94127
0,0,0,-,-,94128
1288,11,1277,3338,-,94129
595,0,595,2135,-,94130
13284,7392,5892,2165,1168900,94131
10280,4408,5872,1959,922200,94132
12995,2491,10504,1300,1201600,94133
12044,7289,4755,1535,764500,94134
3812,1026,2786,2745,1072700,94158
7177,3668,3509,2349,"2,000,000+",94301
14004,7474,6530,1900,1356700,94303
1845,241,1604,2923,"2,000,000+",94304
3459,964,2495,1600,"2,000,000+",94305
10676,5964,4712,2287,"2,000,000+",94306
12459,6076,6383,2098,770000,94401
9623,6561,3062,2213,1456100,94402
16382,9092,7290,2489,1102900,94403
14260,8249,6011,3008,1102800,94404
25347,10454,14893,1700,793000,94501
5018,3991,1027,2151,809300,94502
5442,4211,1231,1769,468400,94503
5473,4423,1050,2442,573400,94505
8279,7372,907,2608,1197000,94506
5335,4990,345,2961,1607400,94507
1073,592,481,1647,726200,94508
21586,11793,9793,1498,340000,94509
11179,7952,3227,1720,558700,94510
885,742,143,1049,122300,94511
16,16,0,-,-,94512
20386,15403,4983,2035,545300,94513
447,331,116,1184,522900,94514
2970,1838,1132,1318,657700,94515
66,46,20,850,541700,94516
4731,4376,355,2227,698300,94517
10539,7178,3361,1747,576200,94518
6949,4820,2129,1663,465800,94519
13531,4501,9030,1461,375500,94520
16088,11374,4714,1727,569900,94521
13863,8796,5067,1927,681900,94523
1404,708,696,1303,470200,94525
12233,10183,2050,2448,1027900,94526
163,163,0,-,"2,000,000+",94528
10202,6025,4177,1785,739900,94530
12507,8763,3744,2121,403800,94531
23867,12658,11209,1301,321000,94533
12979,9883,3096,2112,473600,94534
1057,15,1042,2129,-,94535
24517,14080,10437,2065,801600,94536
22095,10320,11775,2178,704100,94538
16317,13527,2790,2426,1226200,94539
21713,9405,12308,1585,529200,94541
4330,2860,1470,1984,728600,94542
22991,10839,12152,1704,480100,94544
9340,6495,2845,1806,520900,94545
16325,10780,5545,1695,653600,94546
8098,6525,1573,2021,510000,94547
197,146,51,1528,931400,94548
10869,8101,2768,2034,1234900,94549
18036,13187,4849,1869,777200,94550
15530,11163,4367,1976,656000,94551
5112,4584,528,2838,875800,94552
18949,12711,6238,1634,525900,94553
11545,7947,3598,2420,836600,94555
5949,4821,1128,1960,1098400,94556
24302,16349,7953,1687,616900,94558
10211,5015,5196,1556,595200,94559
13677,9466,4211,2128,668700,94560
12216,9346,2870,1524,392700,94561
7071,6341,730,2404,1340400,94563
6666,4629,2037,1745,461300,94564
27947,15735,12212,1584,341200,94565
16434,11839,4595,2115,996000,94566
251,169,82,1451,342200,94567
18310,11676,6634,2527,792600,94568
108,24,84,1863,-,94569
4555,3648,907,1385,323300,94571
3329,2033,1296,1245,431800,94572
10,0,10,-,-,94573
3614,2276,1338,1570,1018300,94574
0,0,0,-,-,94575
38,30,8,-,-,94576
17193,9304,7889,1537,560200,94577
14538,5676,8862,1429,508000,94578
7052,5140,1912,1538,546000,94579
8917,6157,2760,1739,529600,94580
13620,9566,4054,2309,1014400,94582
12003,8723,3280,2243,856300,94583
9395,5639,3756,1677,333900,94585
317,243,74,1559,1086800,94586
21484,13839,7645,2063,688800,94587
12551,8517,4034,2370,878400,94588
9643,5823,3820,1547,283800,94589
14557,5465,9092,1156,289000,94590
18658,12130,6528,1636,390700,94591
308,231,77,2410,472800,94592
9628,8100,1528,1699,548100,94595
9736,4024,5712,1875,942700,94596
10388,5015,5373,2081,719700,94597
10247,7816,2431,2330,901300,94598
1418,986,432,1944,551100,94599
15430,4880,10550,1187,417400,94601
11854,6790,5064,1372,735600,94602
9901,4540,5361,1391,343100,94603
15951,8973,6978,1343,553200,94605
15201,2901,12300,1207,499900,94606
11300,3492,7808,1147,522200,94607
14114,5144,8970,1856,555000,94608
9740,2804,6936,1529,775000,94609
15327,5626,9701,1554,914600,94610
17494,10482,7012,1475,1019900,94611
8788,733,8055,1132,576000,94612
4,0,4,-,-,94613
7285,4702,2583,1855,1141800,94618
9063,5967,3096,1518,665500,94619
9602,3123,6479,1229,307800,94621
7466,3381,4085,1427,783200,94702
8729,3683,5046,1710,821100,94703
7998,853,7145,1548,784900,94704
5805,3254,2551,1656,1138300,94705
7905,3732,4173,1784,811500,94706
4861,4071,790,1885,1108900,94707
4812,4106,706,2799,1044600,94708
5004,1428,3576,1678,992900,94709
2936,1004,1932,1572,784000,94710
22,22,0,-,"2,000,000+",94720
9263,4068,5195,1310,335400,94801
9400,6780,2620,1551,497300,94803
14419,6519,7900,1298,398700,94804
5299,3285,2014,1571,458900,94805
19773,9172,10601,1470,365800,94806
0,0,0,-,-,94850
15679,7082,8597,1748,965200,94901
12139,8450,3689,2298,808600,94903
5355,3433,1922,1983,1544300,94904
5355,3773,1582,2431,"2,000,000+",94920
230,145,85,-,881400,94922
500,303,197,1278,732100,94923
562,351,211,1608,1061300,94924
3893,2697,1196,2598,1175000,94925
15998,8438,7560,1642,414300,94928
76,43,33,2734,983700,94929
3810,2631,1179,1889,848400,94930
3229,1924,1305,1501,518300,94931
289,156,133,2008,603300,94933
417,216,201,1286,873300,94937
330,278,52,2600,873800,94938
3307,1699,1608,2164,1462700,94939
93,77,16,-,793800,94940
13429,9167,4262,2175,1319700,94941
7306,4822,2484,1923,788300,94945
288,220,68,1875,1338200,94946
10358,7831,2527,1907,746000,94947
7202,4528,2674,2224,766300,94949
63,35,28,-,1125000,94950
1811,1316,495,1328,811500,94951
13726,8218,5508,1629,726100,94952
13754,9334,4420,1891,565600,94954
657,332,325,1245,1012200,94956
474,404,70,2111,"2,000,000+",94957
6380,4874,1506,1828,1127600,94960
172,150,22,-,801500,94963
97,11,86,874,-,94964
5905,2827,3078,2087,1114900,94965
360,223,137,1556,"2,000,000+",94970
144,88,56,1194,557000,94971
12,12,0,-,-,94972
751,593,158,1332,846000,94973
560,393,167,2059,546600,95002
10153,7550,2603,1931,825700,95003
1252,942,310,1565,647800,95004
2787,2036,751,1774,667500,95005
3991,3003,988,1667,575300,95006
286,238,48,-,625000,95007
18256,9415,8841,2022,992300,95008
4095,2007,2088,1772,645600,95010
2482,1069,1413,1098,344800,95012
28,12,16,-,-,95013
21378,12625,8753,2948,1584400,95014
260,160,100,1200,822400,95017
2856,2212,644,1552,590100,95018
2277,772,1505,1029,426100,95019
18743,11632,7111,1745,670000,95020
15429,9948,5481,1485,485800,95023
5070,3663,1407,2198,"2,000,000+",95030
9836,6819,3017,2249,1457800,95032
3608,3030,578,1914,1034100,95033
22688,14705,7983,2239,783100,95035
17265,12611,4654,1798,835200,95037
349,237,112,981,206000,95039
82,28,54,845,666700,95041
277,168,109,1402,638300,95043
1378,710,668,1456,658800,95045
1755,1228,527,1482,928000,95046
14270,4752,9518,1886,881100,95050
21161,10274,10887,2360,962200,95051
8,8,0,-,-,95053
8360,3669,4691,2652,901100,95054
18617,9464,9153,1771,842900,95060
15106,7852,7254,1654,703300,95062
473,177,296,1651,343100,95064
3199,2234,965,2125,834000,95065
5644,3968,1676,1990,804600,95066
11091,9418,1673,2720,"2,000,000+",95070
3926,2892,1034,1686,785000,95073
153,93,60,1700,785000,95075
23480,12538,10942,1448,521900,95076
6377,2431,3946,1969,592700,95110
15783,9313,6470,1496,529700,95111
20316,5879,14437,1599,643500,95112
1115,180,935,2680,816400,95113
14407,5395,9012,1490,523600,95116
10722,4000,6722,1846,911900,95117
11265,7551,3714,1900,872800,95118
3263,2433,830,2199,791700,95119
12516,11124,1392,3162,1233300,95120
9709,7060,2649,2049,662900,95121
12741,6381,6360,1778,559500,95122
22645,14371,8274,2320,736500,95123
17057,12655,4402,2204,997300,95124
20966,13599,7367,1836,983600,95125
14939,5008,9931,1864,778900,95126
16567,10929,5638,1874,650200,95127
13785,5562,8223,1816,826800,95128
13875,8399,5476,2151,1265100,95129
5137,3067,2070,1767,1106900,95130
9528,6215,3313,2473,749300,95131
12127,8877,3250,2403,809300,95132
8648,4996,3652,1636,664400,95133
11419,1885,9534,2793,170300,95134
7450,6372,1078,2529,970700,95135
15767,9110,6657,2192,717900,95136
6172,5338,834,2571,934000,95138
2249,1766,483,2619,715300,95139
79,44,35,929,1050000,95140
12092,9888,2204,2597,800300,95148
2850,134,2716,588,218800,95202
5498,1955,3543,875,190100,95203
11186,5730,5456,984,217100,95204
10855,4519,6336,967,143500,95205
17277,8788,8489,1149,204500,95206
18222,6972,11250,997,246500,95207
13121,8755,4366,1434,284300,95209
11805,5278,6527,1095,190000,95210
0,0,0,-,-,95211
7038,5097,1941,1691,334400,95212
6795,3988,2807,1001,205800,95215
10895,5999,4896,1307,363900,95219
2547,1790,757,1239,493700,95220
2380,1560,820,1048,335200,95222
1363,1060,303,1146,291900,95223
125,113,12,-,-,95224
161,61,100,818,361100,95225
16,0,16,-,-,95226
261,182,79,946,773300,95227
1731,1526,205,1566,305700,95228
183,91,92,1556,620100,95230
801,317,484,969,243700,95231
80,80,0,-,390900,95232
198,133,65,-,307400,95233
26,0,26,-,-,95234
1532,1046,486,734,385900,95236
1250,888,362,1199,307900,95237
16319,8002,8317,1023,273100,95240
10046,6379,3667,1402,355300,95242
774,621,153,1246,280100,95245
609,469,140,-,362000,95246
1769,1445,324,1403,320000,95247
94,80,14,-,205800,95248
1571,984,587,1270,198000,95249
0,0,0,-,-,95250
258,227,31,-,313300,95251
5011,4125,886,1568,307500,95252
431,431,0,-,336400,95254
670,487,183,746,203500,95255
190,131,59,1553,-,95257
1501,1151,350,1120,383000,95258
11611,6654,4957,967,240000,95301
316,121,195,1027,450000,95303
3734,2659,1075,1480,526000,95304
17,0,17,-,-,95305
492,377,115,-,355600,95306
12408,7409,4999,1083,247800,95307
992,652,340,796,268500,95310
841,694,147,763,230200,95311
91,62,29,-,218800,95312
447,224,223,728,286400,95313
0,0,0,-,-,95314
3636,2356,1280,1148,204100,95315
2114,1547,567,1125,332100,95316
270,101,169,675,365400,95317
127,20,107,1010,245500,95318
569,225,344,699,158200,95319
4530,3033,1497,1280,338600,95320
1669,1219,450,820,295200,95321
3288,1932,1356,912,239200,95322
392,232,160,679,322200,95323
2757,1686,1071,1038,278300,95324
47,34,13,-,-,95325
3371,2109,1262,1416,334500,95326
2447,1957,490,891,222100,95327
1219,715,504,1048,222800,95328
1062,787,275,1061,244600,95329
5453,3871,1582,1652,334600,95330
823,562,261,902,168000,95333
4532,2374,2158,995,234000,95334
109,23,86,829,-,95335
15429,8962,6467,1314,329200,95336
11538,7255,4283,1408,384600,95337
4843,3353,1490,843,277400,95338
11964,6306,5658,975,253300,95340
8365,3499,4866,842,173600,95341
394,232,162,646,272100,95345
726,484,242,1093,269800,95346
10895,4144,6751,1031,220700,95348
19826,9855,9971,1058,243600,95350
13330,5895,7435,1048,172900,95351
8818,4201,4617,1028,234500,95354
21291,12817,8474,1177,291500,95355
11628,7345,4283,1201,323100,95356
3602,2598,1004,1302,291800,95357
8973,5172,3801,1161,233000,95358
3830,2420,1410,1034,216500,95360
12020,7593,4427,1038,340300,95361
7273,4577,2696,1372,297600,95363
0,0,0,-,-,95364
1324,721,603,742,131400,95365
5944,4177,1767,1294,442100,95366
7360,5128,2232,1151,278800,95367
4061,2808,1253,1386,278400,95368
374,180,194,575,240000,95369
11877,7940,3937,979,281400,95370
826,678,148,1225,276300,95372
527,278,249,991,325000,95374
0,0,0,-,-,95375
15783,8803,6980,1535,370200,95376
9025,6514,2511,2093,465500,95377
1492,930,562,768,279600,95379
14121,6460,7661,948,253500,95380
13344,7942,5402,1241,325300,95382
1811,1409,402,1109,312100,95383
176,73,103,-,"10,000-",95385
2976,2034,942,1028,236700,95386
167,20,147,722,-,95387
3968,2068,1900,829,166200,95388
266,45,221,-,736100,95389
4399,3173,1226,2558,558400,95391
13505,7145,6360,1460,436200,95401
16532,8772,7760,1559,478200,95403
16294,9155,7139,1387,646800,95404
8369,4932,3437,1707,577300,95405
12702,6522,6180,1461,385400,95407
12176,7832,4344,1793,587000,95409
477,308,169,1272,468500,95410
152,117,35,-,480800,95412
414,200,214,958,371200,95415
157,107,50,-,-,95417
227,160,67,-,448600,95420
732,531,201,976,496200,95421
6129,3051,3078,870,99300,95422
1679,1205,474,924,181700,95423
3935,2631,1304,1279,466300,95425
591,456,135,1123,263500,95426
126,67,59,1308,-,95427
947,657,290,760,257300,95428
64,64,0,-,322200,95429
7,0,7,-,-,95430
0,0,0,-,-,95431
240,137,103,1700,442000,95432
14,14,0,-,-,95435
2852,2058,794,1152,451600,95436
5872,3382,2490,1039,377500,95437
232,112,120,-,800000,95439
670,333,337,1273,894500,95441
1381,853,528,1579,864700,95442
139,36,103,696,-,95443
244,158,86,-,588200,95444
1034,853,181,1817,508300,95445
2418,1548,870,1194,447400,95446
6893,4382,2511,1622,763400,95448
508,242,266,1128,402900,95449
160,69,91,966,495800,95450
4724,3582,1142,1291,211400,95451
481,464,17,-,788700,95452
4618,2986,1632,939,237000,95453
1147,791,356,427,360700,95454
437,286,151,1198,351000,95456
1347,1092,255,882,157400,95457
1206,770,436,844,121000,95458
232,176,56,1107,361100,95459
1129,744,385,1139,425000,95460
1037,625,412,642,244400,95461
622,454,168,1036,414100,95462
89,73,16,-,446300,95463
963,679,284,893,152900,95464
1027,803,224,1798,711900,95465
333,140,193,861,791700,95466
2284,1684,600,1586,286600,95467
599,322,277,928,400000,95468
779,425,354,1368,446900,95469
2016,1461,555,1203,391700,95470
261,130,131,1409,429400,95471
12565,8514,4051,1493,755500,95472
15296,9906,5390,1522,649000,95476
11396,6154,5242,1107,336700,95482
1058,874,184,711,257600,95485
56,17,39,-,-,95486
107,62,45,-,558300,95488
5340,3066,2274,1111,275200,95490
10056,7537,2519,1818,572400,95492
123,93,30,-,370800,95493
47,20,27,-,-,95494
601,483,118,1333,785900,95497
9870,4082,5788,892,270800,95501
9863,6618,3245,1027,279200,95503
116,89,27,-,346400,95511
56,56,0,-,650000,95514
7333,4754,2579,974,303000,95519
8567,3872,4695,952,335600,95521
757,594,163,1125,460000,95524
661,396,265,1107,302100,95525
124,96,28,733,284400,95526
309,252,57,794,253900,95527
493,391,102,1202,333400,95528
8337,5119,3218,874,203000,95531
1079,568,511,1026,398800,95536
189,114,75,-,-,95537
5395,3108,2287,933,273400,95540
1024,594,430,869,518500,95542
267,216,51,633,200000,95543
36,36,0,-,428600,95545
1219,864,355,534,205000,95546
436,316,120,1000,410600,95547
425,254,171,788,150000,95548
364,293,71,865,447700,95549
32,5,27,1050,843800,95550
572,333,239,756,248300,95551
315,244,71,650,261200,95552
469,244,225,1286,428600,95553
120,95,25,-,625000,95554
148,69,79,755,223200,95555
248,177,71,478,235200,95556
198,150,48,700,436400,95558
50,19,31,-,-,95559
570,303,267,1053,344700,95560
1405,785,620,853,201900,95562
312,187,125,953,359300,95563
165,40,125,1113,250000,95564
301,59,242,1077,295800,95565
770,526,244,804,267600,95567
78,60,18,765,265600,95568
134,101,33,-,389300,95569
1021,803,218,1145,408500,95570
121,94,27,-,313000,95571
665,383,282,920,282500,95573
224,139,85,963,336800,95585
39,39,0,-,-,95587
503,385,118,2090,391100,95589
70,61,9,-,531300,95595
64,30,34,833,380000,95601
7069,5306,1763,1222,449300,95602
11851,7757,4094,1166,396200,95603
53,41,12,-,-,95604
4925,1816,3109,908,256100,95605
99,51,48,979,-,95606
147,147,0,-,565900,95607
25109,13690,11419,1074,377000,95608
17670,8601,9069,1160,305800,95610
406,253,153,1451,445300,95612
1534,1361,173,1305,378100,95614
289,80,209,797,-,95615
17381,6109,11272,1403,631700,95616
9571,5528,4043,1602,646500,95618
2030,1497,533,1742,261400,95619
6660,4472,2188,1374,366100,95620
16303,10540,5763,1225,247900,95621
1479,1264,215,1114,361400,95623
19612,15009,4603,1493,375900,95624
59,9,50,1149,-,95625
1999,1558,441,1440,313900,95626
1209,795,414,1328,262100,95627
16087,11087,5000,1323,407000,95628
281,195,86,976,373000,95629
27251,19075,8176,1601,488700,95630
2582,2050,532,1160,342200,95631
9716,6987,2729,1259,323800,95632
1306,1265,41,-,332000,95633
1386,1022,364,1342,278000,95634
392,361,31,-,274500,95635
451,451,0,-,227400,95636
83,36,47,-,-,95637
750,703,47,1140,505400,95638
109,44,65,1692,422200,95639
2938,2244,694,1112,278200,95640
732,477,255,900,242600,95641
2991,2091,900,1063,287300,95642
616,320,296,837,185400,95645
27,6,21,675,-,95646
19420,15449,3971,1688,424400,95648
5161,4214,947,1522,532300,95650
280,236,44,-,656300,95651
173,0,173,1117,-,95652
137,109,28,-,208000,95653
1367,1075,292,1508,335400,95655
2727,2235,492,1516,552400,95658
360,209,151,1055,378100,95659
10671,5484,5187,1110,188100,95660
12084,7312,4772,1455,444100,95661
12055,8692,3363,1421,356700,95662
883,790,93,1695,593000,95663
537,387,150,1873,514300,95664
1764,1438,326,1077,294100,95665
2312,1988,324,1057,255200,95666
14222,11032,3190,1105,368100,95667
279,193,86,2015,484000,95668
853,677,176,1190,352500,95669
20519,11258,9261,1137,298100,95670
1842,1608,234,1713,466900,95672
4839,3464,1375,1250,242200,95673
290,211,79,1066,391700,95674
215,160,55,-,157500,95675
9153,6181,2972,1445,396800,95677
16437,8964,7473,1452,349400,95678
26,26,0,-,-,95679
10,10,0,-,-,95680
354,271,83,1462,286800,95681
11010,8239,2771,1206,453500,95682
2543,2323,220,1941,454100,95683
1344,1064,280,1378,333700,95684
1968,1347,621,1008,397700,95685
371,186,185,861,250000,95686
22429,13473,8956,1608,374200,95687
13234,8681,4553,1383,457800,95688
703,646,57,-,348200,95689
757,413,344,788,469100,95690
13266,8085,5181,1123,347500,95691
1787,1163,624,1313,259000,95692
2431,1977,454,1370,558200,95693
3594,2342,1252,1154,393600,95694
14625,7768,6857,1101,354700,95695
144,118,26,-,-,95697
69,34,35,-,368000,95698
20,20,0,-,-,95699
335,269,66,1260,379000,95701
424,361,63,1685,347000,95703
1929,1694,235,1323,374700,95709
3946,2964,982,1284,341700,95713
207,153,54,960,284100,95714
40,34,6,-,191700,95715
70,40,30,-,306300,95717
37,35,2,-,239100,95720
15,15,0,-,-,95721
1951,1787,164,1264,497600,95722
0,0,0,-,-,95724
3343,2641,702,1184,287500,95726
103,75,28,-,689500,95728
6,6,0,-,625000,95735
45,0,45,-,-,95736
3507,3003,504,2076,400500,95742
8249,7171,1078,1991,709700,95746
22670,17575,5095,1659,448400,95747
13852,10083,3769,1854,431000,95757
21018,14427,6591,1608,342400,95758
14147,12359,1788,1916,619000,95762
12447,8384,4063,1663,478900,95765
7432,4617,2815,1194,353500,95776
3299,636,2663,895,498100,95811
6425,486,5939,904,411500,95814
9236,3075,6161,948,200500,95815
9874,2882,6992,1067,547300,95816
6004,2446,3558,980,318500,95817
9774,5109,4665,983,519300,95818
7972,5489,2483,1476,523500,95819
12708,6703,6005,1146,229300,95820
14788,6275,8513,915,317200,95821
15993,8905,7088,1147,289100,95822
23359,10673,12686,1071,221900,95823
8925,3425,5500,978,169000,95824
15976,3842,12134,1017,278900,95825
15032,7839,7193,1196,283300,95826
7232,4177,3055,1211,241400,95827
17762,10726,7036,1245,231300,95828
8279,6341,1938,1604,364500,95829
290,271,19,-,565900,95830
18587,10482,8105,1317,394500,95831
3156,1391,1765,1309,233800,95832
14722,6264,8458,1294,261200,95833
10141,4296,5845,1303,327200,95834
13526,8370,5156,1694,375000,95835
115,84,31,-,721200,95837
11083,5539,5544,1133,201900,95838
8212,2859,5353,1060,233300,95841
11230,5227,6003,1151,222300,95842
14206,9550,4656,1538,299900,95843
9343,7073,2270,1367,562600,95864
11785,6049,5736,915,212000,95901
343,0,343,1757,-,95903
37,37,0,-,-,95910
1506,982,524,894,265300,95912
368,283,85,960,178300,95914
0,0,0,-,-,95915
512,415,97,857,162500,95916
1147,766,381,977,211800,95917
1109,929,180,1119,363200,95918
539,429,110,1074,212800,95919
115,89,26,577,186400,95920
225,178,47,873,258600,95922
14,14,0,-,-,95923
161,101,60,-,-,95925
14986,6466,8520,1011,304500,95926
14463,6702,7761,1055,330600,95928
63,43,20,-,-,95930
2802,1585,1217,837,256800,95932
144,109,35,706,214500,95934
219,98,121,-,313200,95935
86,39,47,-,156300,95936
517,382,135,950,137500,95937
1534,968,566,1244,485600,95938
212,88,124,538,134100,95939
283,240,43,-,214800,95941
321,321,0,-,297600,95942
339,189,150,920,350000,95943
20,9,11,-,-,95944
11136,6347,4789,1061,353700,95945
3950,3234,716,1612,397100,95946
812,655,157,809,163700,95947
3645,2112,1533,883,213600,95948
8347,7373,974,1628,368700,95949
126,37,89,796,-,95950
856,515,341,687,181800,95951
3275,2036,1239,856,213900,95953
5346,4201,1145,1048,164600,95954
523,325,198,880,227200,95955
135,135,0,-,247400,95956
316,190,126,835,264300,95957
7510,5896,1614,1176,430800,95959
352,231,121,1075,279200,95960
8821,5604,3217,936,230800,95961
617,457,160,849,271100,95962
5352,3326,2026,869,237800,95963
6892,3924,2968,829,169200,95965
11181,7871,3310,968,200200,95966
486,334,152,702,159400,95968
11762,8367,3395,1052,220600,95969
237,161,76,950,291700,95970
2413,1466,947,956,228200,95971
14041,8542,5499,1100,326400,95973
17,0,17,-,-,95974
658,551,107,-,311900,95975
703,530,173,1331,370500,95977
58,19,39,-,-,95978
206,132,74,642,243800,95979
12,12,0,-,-,95981
1150,868,282,1133,232000,95982
177,163,14,-,-,95983
33,33,0,-,-,95984
30,24,6,-,137500,95986
1803,1197,606,947,227400,95987
3220,1847,1373,761,218800,95988
14321,6724,7597,928,226400,95991
12116,7994,4122,1169,294400,95993
13939,8033,5906,976,275000,96001
12658,7332,5326,987,243600,96002
18058,10519,7539,1102,252000,96003
166,148,18,-,141200,96006
9051,6099,2952,909,213000,96007
490,449,41,839,242000,96008
177,151,26,1125,262100,96009
57,49,8,567,235400,96010
68,43,25,617,127500,96011
1745,1052,693,788,143300,96013
88,47,41,-,-,96014
69,21,48,-,-,96015
173,156,17,-,169000,96016
78,56,22,880,296200,96017
3744,2350,1394,1120,175000,96019
1019,690,329,732,194800,96020
5693,3717,1976,815,175800,96021
6218,4859,1359,903,234700,96022
464,303,161,645,109500,96023
443,356,87,1082,242100,96024
950,562,388,899,162800,96025
1001,776,225,953,241700,96027
505,427,78,654,265200,96028
73,56,17,781,290000,96029
60,54,6,-,150000,96031
1067,718,349,824,246700,96032
218,167,51,1200,107100,96033
125,63,62,975,206300,96034
1290,938,352,760,168000,96035
144,102,42,-,154300,96037
294,155,139,816,165200,96038
449,267,182,757,153600,96039
102,102,0,-,210900,96040
1239,768,471,750,285800,96041
456,323,133,779,169700,96044
79,54,25,-,-,96046
365,291,74,743,254400,96047
320,268,52,803,313600,96048
26,20,6,-,-,96049
223,157,66,458,192700,96050
581,437,144,986,229300,96051
584,383,201,827,268500,96052
158,117,41,-,252300,96054
1556,1105,451,692,208500,96055
701,581,120,638,211200,96056
620,482,138,836,177700,96057
261,184,77,683,156800,96058
245,154,91,718,402900,96059
11,11,0,-,-,96061
424,328,96,1016,344900,96062
118,71,47,882,168200,96063
1889,1379,510,838,174600,96064
170,103,67,731,276300,96065
3330,2131,1199,1040,271200,96067
53,24,29,-,-,96068
355,299,56,867,240800,96069
24,24,0,-,-,96071
1489,1376,113,1971,392300,96073
58,39,19,843,-,96074
139,125,14,761,187500,96075
84,72,12,-,229400,96076
11136,6543,4593,866,209500,96080
161,127,34,792,203900,96084
28,28,0,-,-,96085
148,115,33,840,167200,96086
266,217,49,-,226100,96087
1996,1736,260,1222,228400,96088
191,133,58,938,153100,96090
330,248,82,766,364000,96091
122,83,39,1343,-,96092
1703,963,740,796,283300,96093
2882,1801,1081,923,198300,96094
291,241,50,807,318100,96096
4323,2733,1590,784,160700,96097
2304,1751,553,737,114100,96101
727,585,142,972,298200,96103
259,209,50,342,183800,96104
77,77,0,-,-,96105
92,69,23,906,452800,96106
493,333,160,818,224100,96107
42,42,0,-,44800,96108
407,304,103,781,130800,96109
69,45,24,-,-,96110
61,61,0,-,273900,96111
78,52,26,234,175000,96112
390,188,202,878,-,96113
1375,1135,240,1096,256400,96114
74,71,3,-,180700,96115
101,101,0,-,"2,000,000+",96116
136,118,18,-,202400,96117
650,490,160,935,148800,96118
21,5,16,-,-,96119
267,228,39,619,329200,96120
137,117,20,-,187800,96121
1399,981,418,679,217700,96122
11,6,5,-,95000,96123
187,177,10,-,128500,96124
108,108,0,-,433300,96125
55,41,14,-,-,96126
280,280,0,-,209000,96128
156,156,0,-,-,96129
5233,3134,2099,1001,185100,96130
36,22,14,-,200000,96132
51,9,42,-,-,96133
722,440,282,622,87400,96134
90,90,0,-,-,96135
36,36,0,-,243800,96136
1591,1242,349,804,184900,96137
479,327,152,1469,650900,96140
146,140,6,-,699200,96141
330,242,88,1375,461000,96142
1450,827,623,1166,464600,96143
1051,719,332,1108,600400,96145
454,305,149,1234,875000,96146
210,127,83,1558,850800,96148
11536,6195,5341,994,426200,96150
0,0,0,-,-,96155
6929,5086,1843,1585,553200,96161
13209,8416,4793,1765,655300,96701
590,453,137,950,431300,96703
2610,1707,903,1332,457900,96704
786,534,252,1337,426300,96705
19191,13239,5952,2234,564000,96706
13211,8811,4400,1997,558500,96707
3630,2219,1411,1741,751900,96708
122,98,24,-,821400,96710
2500,1449,1051,1496,1112800,96712
395,243,152,-,393600,96713
350,150,200,1372,909700,96714
889,651,238,1721,407900,96716
1309,642,667,1616,619100,96717
511,316,195,1157,403200,96719
17162,10578,6584,1017,319800,96720
863,661,202,1669,776200,96722
1059,693,366,1429,613900,96725
105,62,43,-,500000,96726
1527,1129,398,987,362500,96727
178,142,36,1375,239300,96728
333,283,50,1016,163500,96729
497,318,179,1439,673100,96730
808,538,270,1546,581400,96731
7648,4830,2818,1294,562300,96732
15688,9444,6244,2762,944000,96734
1656,1267,389,1053,141100,96737
2587,1829,758,1438,434500,96738
13711,8516,5195,1368,512800,96740
2047,1386,661,1509,664900,96741
47,2,45,863,-,96742
4364,2629,1735,1646,483900,96743
16229,12114,4115,1911,749300,96744
6639,4176,2463,1429,543100,96746
228,0,228,766,-,96747
1513,1053,460,789,295300,96748
5783,4540,1243,1206,276600,96749
1197,676,521,844,453800,96750
44,44,0,-,583300,96751
1125,771,354,914,396000,96752
10571,5759,4812,1585,622600,96753
986,728,258,1685,769400,96754
1058,707,351,1054,408800,96755
2126,1151,975,1219,645200,96756
235,147,88,1223,232800,96757
118,0,118,1109,-,96759
1061,887,174,692,234600,96760
7590,3813,3777,1443,687300,96761
929,338,591,1734,697000,96762
1143,693,450,1032,413600,96763
246,202,44,1025,433300,96764
162,91,71,1375,525000,96765
4932,3114,1818,1204,514200,96766
6408,4209,2199,1360,629600,96768
93,0,93,444,-,96769
239,78,161,778,390000,96770
2867,2124,743,988,184700,96771
874,682,192,969,246600,96772
26,26,0,-,604200,96773
97,97,0,-,233500,96774
463,310,153,1065,324000,96776
530,396,134,732,199000,96777
5849,4094,1755,1120,192100,96778
830,578,252,2185,733300,96779
208,137,71,-,258100,96780
455,330,125,962,186400,96781
11407,7536,3871,1790,628000,96782
639,413,226,336,259000,96783
1467,1180,287,1018,206000,96785
12684,3443,9241,2387,557000,96786
17637,12973,4664,1956,618200,96789
3604,2443,1161,1410,847600,96790
2304,1343,961,1748,645900,96791
12058,7088,4970,1345,386100,96792
10125,6337,3788,1220,536100,96793
2352,1660,692,1144,567600,96795
664,301,363,1162,442200,96796
18708,12076,6632,1654,581800,96797
10463,4739,5724,1408,605700,96813
10179,3972,6207,1417,549500,96814
13376,5789,7587,1639,522800,96815
17268,10620,6648,1695,904700,96816
19225,7611,11614,1166,681400,96817
18286,6284,12002,2818,499600,96818
12066,5675,6391,1525,694500,96819
6365,5376,989,2354,1076600,96821
18253,9498,8755,1410,658300,96822
10406,8516,1890,2678,847800,96825
14799,4189,10610,1277,409200,96826
0,0,0,-,-,96850
0,0,0,-,-,96853
0,0,0,-,-,96857
0,0,0,-,-,96859
0,0,0,-,-,96860
0,0,0,-,-,96863
78,21,57,629,319200,97001
2185,1873,312,1009,353800,97002
1685,1483,202,1177,425300,97004
11156,3992,7164,1120,298100,97005
26610,13777,12833,1348,314500,97006
25312,18167,7145,1341,344700,97007
11914,6852,5062,1203,341100,97008
2942,2568,374,1278,391000,97009
276,276,0,-,370500,97011
8652,6090,2562,970,316200,97013
510,304,206,675,211900,97014
8675,5458,3217,1219,338200,97015
2420,1904,516,826,186200,97016
1074,983,91,1122,326800,97017
821,633,188,986,264000,97018
1264,1149,115,1048,376500,97019
361,327,34,1403,170100,97020
425,279,146,1011,226300,97021
1373,1158,215,1144,366800,97022
3739,2972,767,1056,335000,97023
4081,2465,1616,1183,262400,97024
1151,858,293,1139,230100,97026
4764,3007,1757,1225,278900,97027
93,67,26,-,351400,97028
129,74,55,929,93800,97029
14453,6458,7995,1111,248700,97030
7264,4727,2537,1233,364000,97031
1674,1214,460,962,230900,97032
32,8,24,-,-,97033
7916,6133,1783,1641,698700,97034
11149,7472,3677,1468,505000,97035
411,251,160,690,169500,97037
5553,4198,1355,1027,279600,97038
207,136,71,729,163200,97039
547,359,188,964,384300,97040
804,617,187,815,338500,97041
1047,872,175,1293,399000,97042
20290,15280,5010,1155,354500,97045
2656,2116,540,773,224200,97048
685,585,100,967,259800,97049
103,71,32,675,121300,97050
6063,4067,1996,879,223800,97051
1270,1076,194,1028,336600,97053
686,621,65,1052,249400,97054
6735,5123,1612,1149,290700,97055
4510,3187,1323,1042,279500,97056
9,8,1,-,-,97057
8121,4952,3169,794,198000,97058
7458,4903,2555,1105,281500,97060
11359,6538,4821,1218,408300,97062
474,394,80,950,180400,97063
1264,1065,199,963,211300,97064
265,187,78,725,151700,97065
916,647,269,1107,284400,97067
11162,8861,2301,1426,486600,97068
9858,4597,5261,1272,414200,97070
9152,5777,3375,967,191500,97071
15558,11080,4478,1189,310900,97080
11163,7310,3853,1279,446400,97086
4632,4140,492,1515,404100,97089
1382,1046,336,1130,284700,97101
149,149,0,-,602400,97102
7479,4827,2652,903,253900,97103
1605,1381,224,1319,427000,97106
711,546,165,1013,233000,97107
204,182,22,-,290000,97108
184,176,8,-,437900,97109
489,183,306,753,423300,97110
1273,1004,269,1207,330400,97111
814,620,194,958,215000,97112
4478,3504,974,1072,241500,97113
1487,1080,407,1040,236200,97114
1437,1253,184,1581,318600,97115
9363,5836,3527,951,299100,97116
255,224,31,-,354300,97117
359,238,121,983,244000,97118
1614,1332,282,1276,376300,97119
570,283,287,869,270600,97121
190,178,12,-,192300,97122
16146,11022,5124,1181,309200,97123
20834,10262,10572,1440,347400,97124
59,59,0,-,413900,97125
1295,1122,173,945,222600,97127
14067,8985,5082,935,250000,97128
232,187,45,979,422100,97130
1201,972,229,910,256800,97131
10403,7051,3352,1154,319700,97132
1611,1360,251,1082,395000,97133
106,106,0,-,-,97134
366,265,101,-,196100,97135
756,522,234,960,213400,97136
429,275,154,916,371300,97137
4334,2207,2127,907,286100,97138
8772,6964,1808,1420,424100,97140
5293,3193,2100,842,235600,97141
34,34,0,-,314300,97144
179,128,51,878,767200,97145
2429,1768,661,1033,265400,97146
157,81,76,675,274200,97147
1278,1092,186,1171,344200,97148
407,362,45,-,364700,97149
9116,2714,6402,1373,621200,97201
18402,9137,9265,1168,494000,97202
12198,6860,5338,1092,319300,97203
417,38,379,635,470400,97204
4992,881,4111,954,523600,97205
20247,12768,7479,1272,319400,97206
0,0,0,-,-,97208
12047,2760,9287,1163,472600,97209
6523,2671,3852,1198,740100,97210
13302,8728,4574,1334,417200,97211
10888,7076,3812,1310,635000,97212
13966,8665,5301,1144,418500,97213
12614,4275,8339,1244,511200,97214
7772,4856,2916,1293,478800,97215
6609,3101,3508,1207,259700,97216
14480,8767,5713,1292,376000,97217
5481,3216,2265,994,330900,97218
16724,11994,4730,1294,451800,97219
11544,6249,5295,1094,279200,97220
5193,3880,1313,1118,583800,97221
15480,8432,7048,1132,281900,97222
19486,11867,7619,1161,387300,97223
14563,9977,4586,1186,380000,97224
11537,6157,5380,1318,498300,97225
2350,705,1645,1281,508100,97227
24393,17253,7140,1430,502400,97229
15260,8769,6491,1048,274000,97230
1686,1458,228,1403,581900,97231
6689,2007,4682,1229,590700,97232
13546,6050,7496,1018,217600,97233
13181,7633,5548,1101,254200,97236
8704,4222,4482,1355,559400,97239
12363,6743,5620,1132,243900,97266
13019,9290,3729,1170,315700,97267
18286,7644,10642,860,160400,97301
15851,9433,6418,904,259300,97302
14608,8772,5836,975,237200,97303
11753,7763,3990,1011,269900,97304
14348,7642,6706,906,189800,97305
12274,7592,4682,1088,258800,97306
7675,4907,2768,1041,237900,97317
10450,7635,2815,922,258800,97321
13969,7550,6419,940,191100,97322
491,380,111,817,212500,97324
2327,1811,516,956,232900,97325
391,332,59,753,286300,97326
1305,973,332,944,217400,97327
82,48,34,-,230800,97329
17746,8879,8867,988,325500,97330
0,0,0,-,-,97331
9295,4318,4977,1083,301400,97333
8121,5897,2224,799,231200,97338
1278,843,435,899,245600,97341
74,33,41,675,154700,97342
94,66,28,-,220000,97343
481,393,88,1054,156700,97344
181,124,57,1344,208700,97345
373,279,94,706,185300,97346
805,578,227,399,204700,97347
551,358,193,725,214800,97348
91,59,32,719,-,97350
3625,1966,1659,984,182000,97351
2062,1434,628,1031,249000,97352
11592,7401,4191,925,195100,97355
100,90,10,-,348100,97357
1093,989,104,1054,218400,97358
936,554,382,912,174100,97360
4203,2254,1949,869,229200,97361
1535,978,557,789,246400,97362
248,150,98,1303,330600,97364
4894,2784,2110,846,238900,97365
803,565,238,963,220500,97366
4375,2306,2069,894,233900,97367
1506,1114,392,870,171900,97368
94,81,13,-,235000,97369
3262,2540,722,842,280000,97370
240,183,57,-,457300,97371
0,0,0,-,-,97373
1782,1350,432,899,278600,97374
447,408,39,1239,298100,97375
488,403,85,1246,260500,97376
369,261,108,1171,305300,97377
2356,1602,754,845,203700,97378
1082,750,332,799,155900,97380
5808,4183,1625,919,293500,97381
3444,2024,1420,851,236200,97383
0,0,0,-,-,97384
1358,933,425,1139,301900,97385
5268,3718,1550,872,169400,97386
413,326,87,928,385900,97388
601,416,185,1092,229700,97389
389,245,144,1120,300500,97390
2160,1545,615,875,225800,97391
2376,1859,517,1116,263200,97392
2313,1725,588,779,251000,97394
1180,814,366,910,190000,97396
20474,6010,14464,961,297300,97401
20918,10121,10797,936,200900,97402
3982,1964,2018,942,358900,97403
13391,9308,4083,1140,236300,97404
19468,13043,6425,1030,316200,97405
13,13,0,-,-,97406
5579,3573,2006,1199,315200,97408
373,231,142,845,341700,97410
3374,2147,1227,744,248200,97411
195,155,40,1047,195300,97412
468,316,152,772,291100,97413
152,27,125,-,-,97414
6561,4482,2079,899,268700,97415
391,280,111,623,208900,97416
1050,647,403,681,123200,97417
523,451,72,1125,280300,97419
11465,7145,4320,801,181500,97420
2790,1916,874,818,177800,97423
7259,5167,2092,887,207800,97424
3758,2706,1052,890,234200,97426
318,230,88,768,257100,97429
162,114,48,1111,212500,97430
866,710,156,804,308400,97431
322,260,62,707,245400,97434
901,710,191,686,164300,97435
402,319,83,776,241000,97436
1071,915,156,942,269400,97437
428,336,92,880,272500,97438
6912,4784,2128,895,224500,97439
158,67,91,-,241100,97441
842,442,400,829,142500,97442
784,514,270,803,261400,97443
2465,1764,701,808,232700,97444
1783,1379,404,1063,202300,97446
225,154,71,-,87900,97447
5133,3649,1484,890,256100,97448
1096,944,152,728,175600,97449
176,140,36,-,253300,97450
126,115,11,-,363000,97451
640,539,101,796,215200,97452
455,299,156,620,237500,97453
531,481,50,1023,268000,97454
939,770,169,1579,332400,97455
1078,830,248,741,268900,97456
3991,2940,1051,815,163800,97457
1955,1321,634,684,159700,97458
5377,3489,1888,813,197200,97459
257,213,44,-,305700,97461
1638,1156,482,734,249400,97462
1684,1174,510,794,117800,97463
1044,713,331,803,183200,97465
443,284,159,435,100000,97466
2168,1433,735,596,152300,97467
1052,728,324,778,156300,97469
8783,5606,3177,814,173400,97470
12424,8657,3767,849,226300,97471
128,116,12,-,177900,97473
181,181,0,-,277900,97476
15811,7710,8101,862,194600,97477
14526,9726,4800,976,227400,97478
3923,2783,1140,866,163600,97479
161,95,66,623,175500,97480
300,233,67,948,214500,97481
103,76,27,735,170400,97484
265,249,16,-,288700,97486
3394,2619,775,915,226200,97487
491,414,77,900,322900,97488
385,322,63,-,357300,97489
86,63,23,-,269400,97490
289,233,56,959,157300,97492
159,126,33,638,290500,97493
15,15,0,-,-,97494
728,558,170,915,304300,97495
3087,1905,1182,736,164700,97496
658,511,147,568,235100,97497
752,475,277,1047,293100,97498
776,577,199,765,179100,97499
17798,9553,8245,910,195600,97501
10830,7634,3196,970,248200,97502
3895,3037,858,957,172200,97503
19201,10947,8254,962,280400,97504
11592,6827,4765,1000,435200,97520
273,209,64,871,187500,97522
2571,1779,792,805,203500,97523
5977,4287,1690,1157,278500,97524
1818,1573,245,925,240900,97525
14831,9301,5530,830,257200,97526
14976,10273,4703,944,256400,97527
3051,2118,933,1087,357500,97530
404,257,147,965,-,97531
1036,781,255,728,300200,97532
363,234,129,556,181300,97534
2463,1646,817,745,184700,97535
448,328,120,811,174000,97536
3212,2125,1087,877,257900,97537
763,620,143,668,229800,97538
1585,1242,343,1273,174400,97539
3756,2361,1395,971,238000,97540
646,517,129,1286,267400,97541
274,198,76,968,287200,97543
974,779,195,597,303700,97544
9681,4882,4799,752,171300,97601
11639,7841,3798,773,162400,97603
8,0,8,-,-,97604
85,39,46,325,132500,97620
75,50,25,-,275600,97621
218,171,47,529,106000,97622
1072,934,138,687,148900,97623
1494,1217,277,784,150300,97624
93,71,22,672,-,97625
32,0,32,-,-,97626
268,254,14,-,165200,97627
2139,1388,751,717,123700,97630
545,390,155,596,116200,97632
548,426,122,613,143800,97633
68,63,5,-,156500,97634
90,90,0,-,133300,97635
194,123,71,458,89800,97636
51,39,12,400,122100,97637
172,127,45,656,148600,97638
330,281,49,-,138400,97639
77,45,32,475,236100,97640
681,372,309,643,114600,97641
27943,16573,11370,1160,391400,97701
18930,13386,5544,1259,359300,97702
2588,1900,688,1187,301600,97707
62,36,26,-,265000,97710
24,21,3,-,-,97711
22,0,22,-,-,97712
1951,1459,492,623,90100,97720
100,73,27,-,252500,97721
43,13,30,756,-,97722
107,91,16,750,451600,97730
168,25,143,-,282100,97731
42,25,17,590,168300,97732
233,110,123,635,116300,97733
1045,785,260,827,192500,97734
44,44,0,-,147500,97735
42,15,27,581,171900,97736
303,204,99,948,-,97737
745,588,157,640,128400,97738
4838,3679,1159,955,201900,97739
4137,2521,1616,835,180500,97741
140,110,30,594,166700,97750
41,33,8,-,338200,97751
0,0,0,-,-,97752
962,793,169,1613,457400,97753
8299,5752,2547,834,191100,97754
14562,9159,5403,1028,270100,97756
41,22,19,236,372700,97758
3094,2416,678,1099,392600,97759
2935,2575,360,1063,249400,97760
1045,691,354,447,123400,97761
7537,4340,3197,716,166500,97801
400,316,84,950,276200,97810
337,210,127,924,126500,97812
529,365,164,790,142400,97813
5201,3595,1606,679,153800,97814
3,3,0,-,-,97817
1436,932,504,724,132300,97818
15,10,5,-,-,97819
408,317,91,605,169000,97820
501,320,181,841,107300,97823
688,534,154,892,269400,97824
138,95,43,654,148400,97825
397,247,150,731,136200,97826
1056,798,258,713,147900,97827
1426,909,517,698,194600,97828
346,239,107,582,119200,97830
388,283,105,712,205200,97833
457,312,145,645,208000,97834
109,77,32,795,164400,97835
808,471,337,827,132400,97836
28,17,11,-,91500,97837
9175,5963,3212,749,170900,97838
118,103,15,1094,-,97839
39,19,20,-,-,97840
218,162,56,1110,238100,97841
66,32,34,-,527800,97842
236,163,73,805,169900,97843
1344,1057,287,800,133600,97844
1309,844,465,742,125900,97845
874,628,246,641,305700,97846
88,60,28,446,253800,97848
6907,3963,2944,779,178500,97850
178,103,75,438,227500,97856
212,147,65,775,267000,97857
48,48,0,-,-,97859
4157,2870,1287,640,141100,97862
112,72,40,617,273100,97864
547,424,123,502,191900,97865
280,185,95,775,149200,97867
748,495,253,782,124700,97868
359,263,96,783,133900,97869
314,260,54,550,186100,97870
125,107,18,613,67800,97873
177,140,37,600,175000,97874
1031,698,333,954,116200,97875
343,312,31,1010,307000,97876
180,166,14,-,136100,97877
128,86,42,819,116700,97880
2193,1303,890,627,120800,97882
955,719,236,836,146400,97883
77,61,16,825,154200,97884
587,362,225,682,178300,97885
453,349,104,880,116900,97886
296,180,116,687,185000,97901
42,35,7,-,207500,97903
95,61,34,538,331800,97904
70,39,31,-,208300,97905
123,66,57,508,175000,97906
224,168,56,667,82900,97907
18,9,9,-,-,97908
37,25,12,-,-,97909
248,168,80,600,181300,97910
48,23,25,-,-,97911
1750,1076,674,649,115900,97913
5959,3435,2524,663,135200,97914
1530,912,618,679,154500,97918
71,57,14,-,189000,97920
11002,8545,2457,1454,311300,98001
13132,6388,6744,1098,213500,98002
18567,8911,9656,1162,269000,98003
16523,7438,9085,2033,1101800,98004
7807,4217,3590,1787,745400,98005
13417,10550,2867,2105,812200,98006
11569,4156,7413,1696,571900,98007
9214,6864,2350,1795,651900,98008
2043,1727,316,1088,426300,98010
13286,8654,4632,1585,479800,98011
23593,16267,7326,1692,458600,98012
2736,2317,419,1481,494700,98014
4096,3645,451,1573,469300,98019
8758,6347,2411,1549,556700,98020
10724,8587,2137,1758,494400,98021
8466,5775,2691,1126,342300,98022
17699,11492,6207,1382,326500,98023
2305,1936,369,1492,661100,98024
14474,10707,3767,1421,433500,98026
11666,8170,3496,1690,608800,98027
8699,6310,2389,1358,526200,98028
11251,7518,3733,2096,578200,98029
11989,5850,6139,1287,320400,98030
12093,8100,3993,1318,319100,98031
13674,5465,8209,1235,276900,98032
16204,10263,5941,1879,764300,98033
17558,10700,6858,1713,500100,98034
14517,9206,5311,1302,394600,98036
10865,6369,4496,1353,385300,98037
12053,10280,1773,1721,392600,98038
1191,1057,134,2750,"2,000,000+",98039
10123,7140,2983,1977,1135200,98040
16457,13686,2771,1657,357400,98042
8316,4588,3728,1402,352700,98043
5386,4244,1142,1503,457100,98045
2304,1260,1044,1171,257000,98047
181,181,0,-,662500,98050
1587,1362,225,1411,435500,98051
26876,14138,12738,1854,651400,98052
8251,6992,1259,1943,704200,98053
9511,4608,4903,1518,338700,98055
13887,7826,6061,1493,443700,98056
6235,1521,4714,1207,363700,98057
15739,11485,4254,1583,372500,98058
13546,10549,2997,1692,483100,98059
5085,4333,752,1670,576300,98065
174,166,8,-,529300,98068
4501,3589,912,1204,494600,98070
9273,6766,2507,1803,628800,98072
9370,8220,1150,2312,728500,98074
7750,6626,1124,2291,838200,98075
4685,4442,243,1839,761000,98077
14102,7170,6932,1593,362400,98087
16090,11397,4693,1354,354500,98092
8640,1610,7030,1615,597700,98101
15370,4608,10762,1566,633000,98102
24438,11532,12906,1591,658500,98103
8125,964,7161,1135,486400,98104
16564,5617,10947,1374,827800,98105
10860,5390,5470,1190,385500,98106
13310,5156,8154,1659,650900,98107
8645,4637,4008,1134,413700,98108
16400,4082,12318,1748,660700,98109
9857,7657,2200,1399,653500,98110
11471,6277,5194,1564,953700,98112
22182,13774,8408,1705,686100,98115
12751,7515,5236,1489,650600,98116
14778,10721,4057,1690,652500,98117
16888,9919,6969,1269,447200,98118
12558,5039,7519,1569,765500,98119
12215,2772,9443,1844,575800,98121
18923,6004,12919,1515,600600,98122
19008,8912,10096,1396,496800,98125
10366,5720,4646,1315,507800,98126
21305,10069,11236,1281,432000,98133
210,74,136,1636,344100,98134
7561,5305,2256,1440,629000,98136
13439,6256,7183,1256,587600,98144
10111,5950,4161,1243,384500,98146
4547,1699,2848,1231,331300,98148
0,0,0,-,-,98154
13665,9451,4214,1411,463000,98155
0,0,0,-,-,98158
115,82,33,-,648600,98164
8516,5507,3009,1157,468000,98166
11459,6106,5353,1168,295800,98168
0,0,0,-,-,98174
8658,6688,1970,1392,679600,98177
9572,6070,3502,1381,362400,98178
8925,4044,4881,1155,284600,98188
0,0,0,-,-,98195
13838,7405,6433,1325,320600,98198
9717,6173,3544,1564,762400,98199
12763,5026,7737,998,273100,98201
13621,8053,5568,1274,328500,98203
16848,5611,11237,1234,231200,98204
5025,4169,856,1576,336100,98205
0,0,0,-,-,98207
20435,14063,6372,1442,359900,98208
256,163,93,-,329600,98220
9523,6599,2924,1164,396200,98221
40,40,0,-,750000,98222
15807,12161,3646,1264,335400,98223
146,118,28,1250,180000,98224
20498,8096,12402,981,357000,98225
17434,10805,6629,1085,331800,98226
12961,8839,4122,1085,353200,98229
7275,5570,1705,1076,274400,98230
1774,1373,401,1755,358000,98232
6116,3911,2205,1062,258300,98233
58,46,12,-,187500,98235
2682,1970,712,1002,409500,98236
1743,1257,486,964,177400,98237
0,0,0,-,-,98238
3396,2789,607,909,355400,98239
1176,934,242,996,329000,98240
833,540,293,922,160500,98241
284,216,68,1034,595200,98243
1172,858,314,753,287200,98244
1847,1313,534,930,464800,98245
3082,2199,883,952,269000,98247
9035,6770,2265,948,318100,98248
1962,1447,515,1132,381100,98249
3750,2695,1055,1036,457200,98250
1722,1412,310,917,204800,98251
3716,2764,952,1185,254400,98252
882,815,67,-,438300,98253
111,94,17,963,226700,98255
150,88,62,794,220000,98256
1823,1357,466,1029,298500,98257
11302,8651,2651,1553,351300,98258
2643,1997,646,1099,429600,98260
1337,1034,303,1026,458700,98261
436,363,73,775,436200,98262
30,21,9,-,182800,98263
7540,5214,2326,1121,325000,98264
1475,880,595,919,127100,98266
166,125,41,-,122700,98267
17984,12088,5896,1332,301000,98270
10761,7834,2927,1355,291500,98271
9643,7243,2400,1330,356800,98272
10940,6535,4405,936,263400,98273
6691,5121,1570,1197,295000,98274
8287,5746,2541,1720,544200,98275
187,161,26,1125,268500,98276
15809,8607,7202,1160,276500,98277
0,0,0,-,-,98278
340,259,81,900,596700,98279
238,215,23,917,461700,98280
671,522,149,971,247600,98281
6990,6186,804,1233,362400,98282
204,164,40,863,215000,98283
9578,6378,3200,1068,247600,98284
90,69,21,820,741100,98286
92,58,34,915,256300,98288
12824,10068,2756,1127,420400,98290
8493,6813,1680,1216,354000,98292
2734,1930,804,1220,255000,98294
950,688,262,835,236400,98295
9981,8756,1225,1929,512200,98296
17,15,2,-,184400,98297
624,548,76,1148,244800,98303
338,243,95,725,133400,98304
158,144,14,-,179200,98305
9007,4437,4570,990,227900,98310
10146,7236,2910,1248,253400,98311
13045,7812,5233,1061,238500,98312
17,0,17,-,-,98314
1250,0,1250,1525,-,98315
563,465,98,838,215600,98320
5562,4565,997,1245,292800,98321
280,238,42,1236,231900,98323
671,546,125,634,216000,98325
303,197,106,-,113400,98326
3631,1793,1838,1784,317200,98327
3797,3191,606,958,278200,98328
3895,3267,628,1313,274800,98329
68,68,0,-,-,98330
2416,1616,800,608,153700,98331
6779,5707,1072,1499,432800,98332
1408,1300,108,1238,568500,98333
10028,7391,2637,1394,441500,98335
356,297,59,636,121700,98336
3326,1284,2042,880,194800,98337
9520,8274,1246,1415,259900,98338
1434,959,475,812,231800,98339
1360,1154,206,871,296900,98340
590,449,141,1280,405100,98342
205,63,142,900,259400,98345
3865,2863,1002,1195,358700,98346
1742,1333,409,871,204700,98349
129,58,71,479,60000,98350
486,419,67,864,366500,98351
30,0,30,-,-,98353
2842,1641,1201,1301,281300,98354
406,370,36,-,114600,98355
886,659,227,787,165200,98356
493,337,156,467,69000,98357
444,361,83,1161,453000,98358
1832,1594,238,1208,334000,98359
4745,3986,759,1571,273200,98360
470,333,137,919,118400,98361
10378,6906,3472,865,228300,98362
5658,3914,1744,1000,221600,98363
47,0,47,-,-,98364
2421,1966,455,1428,365700,98365
12597,7754,4843,1141,255700,98366
10536,8698,1838,1284,288000,98367
7420,5149,2271,934,320200,98368
12316,9574,2742,1322,355200,98370
8335,5828,2507,1097,290100,98371
9668,5609,4059,1198,306500,98372
9072,5150,3922,1244,289100,98373
14128,9794,4334,1435,283800,98374
9860,7277,2583,1666,260300,98375
839,649,190,842,272500,98376
765,510,255,700,132700,98377
1817,1446,371,1078,329300,98380
165,118,47,795,227300,98381
13479,10174,3305,1032,276600,98382
8518,4732,3786,1325,332500,98383
125,111,14,1313,235500,98385
16255,12127,4128,1283,224300,98387
2562,1596,966,1127,338100,98388
4513,2438,2075,1126,291900,98390
17316,14592,2724,1446,322000,98391
1301,941,360,1077,240500,98392
486,400,86,1100,293800,98394
280,206,74,1352,223300,98396
3590,562,3028,1110,380300,98402
4201,1607,2594,968,423900,98403
11384,6667,4717,968,185400,98404
9595,4152,5443,979,225300,98405
9722,6148,3574,1093,321400,98406
9321,5542,3779,1312,352300,98407
7448,4445,3003,1194,199100,98408
9956,3515,6441,1155,191200,98409
0,0,0,-,-,98416
3818,2129,1689,1121,189400,98418
0,0,0,-,-,98421
7658,5906,1752,1564,369300,98422
4097,1681,2416,1229,282100,98424
0,0,0,-,-,98430
4199,49,4150,1680,-,98433
4,0,4,-,-,98438
2030,229,1801,1060,18900,98439
2215,1792,423,1159,291200,98443
12595,4796,7799,992,192600,98444
11332,7419,3913,1291,228300,98445
3632,2690,942,1051,278500,98446
0,0,0,-,-,98447
3150,1540,1610,1088,324200,98465
11573,5933,5640,1161,328900,98466
6175,3247,2928,1059,346900,98467
11262,6725,4537,1111,254100,98498
12947,4632,8315,924,238700,98499
17092,9911,7181,1113,302500,98501
14354,7707,6647,1141,346300,98502
15450,8117,7333,1180,235300,98503
7925,4913,3012,992,283800,98506
11960,8127,3833,1147,271400,98512
12876,8987,3889,1490,250600,98513
9607,6935,2672,1363,322200,98516
8310,4863,3447,740,152600,98520
1484,1200,284,888,286200,98524
86,60,26,638,97500,98526
161,154,7,-,114300,98527
3648,2696,952,1076,248300,98528
250,145,105,888,115800,98530
10163,5928,4235,851,162400,98531
9159,6678,2481,880,237200,98532
191,183,8,-,197900,98533
276,201,75,-,140000,98535
33,33,0,-,-,98536
834,631,203,904,173300,98537
131,98,33,1225,275000,98538
3889,2791,1098,750,173500,98541
195,170,25,-,266100,98542
12,12,0,-,-,98544
1342,1049,293,1111,286100,98546
579,434,145,752,171200,98547
1210,1114,96,1219,195500,98548
4738,2814,1924,729,128200,98550
184,162,22,-,107500,98552
198,198,0,-,194000,98555
1345,999,346,1050,176200,98557
80,29,51,-,-,98558
0,0,0,-,-,98559
85,85,0,-,229500,98560
0,0,0,-,-,98562
3023,2329,694,823,208100,98563
1001,843,158,644,190000,98564
228,152,76,800,183800,98565
1121,854,267,795,193000,98568
3074,2271,803,899,216000,98569
1577,1226,351,863,218300,98570
139,95,44,-,-,98571
247,191,56,935,126900,98572
76,58,18,775,133300,98575
1869,1462,407,968,235100,98576
2637,2070,567,751,150600,98577
4779,3875,904,1211,230300,98579
4233,3257,976,1201,251400,98580
267,246,21,-,123500,98581
130,122,8,-,206700,98582
57,39,18,-,114400,98583
13456,9845,3611,946,193100,98584
319,215,104,995,230400,98585
649,421,228,535,121600,98586
237,162,75,513,92700,98587
733,587,146,1387,257000,98588
2850,2169,681,1172,240400,98589
188,148,40,331,145000,98590
1390,1106,284,707,237800,98591
681,654,27,-,307600,98592
436,330,106,904,142900,98593
1249,734,515,749,168800,98595
2625,2015,610,1043,192700,98596
8467,5991,2476,1329,228300,98597
1076,746,330,1292,284800,98601
62,54,8,-,-,98602
472,439,33,-,267200,98603
12219,9717,2502,1150,326500,98604
429,272,157,936,234400,98605
3033,2792,241,907,428900,98606
11126,8692,2434,1294,401000,98607
1191,734,457,856,209200,98610
3626,2950,676,794,209700,98611
1212,1039,173,708,217200,98612
147,109,38,1025,193800,98613
80,80,0,-,-,98614
40,40,0,-,-,98616
492,342,150,1016,176300,98617
211,149,62,775,233600,98619
3048,1849,1199,753,153300,98620
185,167,18,-,187500,98621
683,518,165,732,220300,98624
2600,2072,528,809,247800,98625
9238,6245,2993,814,184900,98626
156,78,78,757,86000,98628
2968,2576,392,1556,349400,98629
1693,1176,517,725,182700,98631
20759,12169,8590,814,187000,98632
733,512,221,917,261000,98635
552,447,105,933,205300,98638
463,259,204,767,243400,98639
2091,1805,286,943,184400,98640
10,10,0,-,-,98641
6909,5776,1133,1414,389600,98642
186,180,6,-,174500,98643
157,99,58,853,221500,98644
495,428,67,1101,172100,98645
151,128,23,-,161500,98647
1286,854,432,684,284000,98648
356,295,61,-,254100,98649
341,265,76,892,442200,98650
375,278,97,1021,398500,98651
5427,2498,2929,874,248600,98660
18513,8181,10332,1015,252600,98661
12272,7959,4313,1277,246100,98662
6098,3611,2487,1028,254600,98663
9105,5213,3892,1164,261800,98664
9939,6100,3839,1139,270500,98665
22,20,2,-,216700,98670
8512,6756,1756,1112,332700,98671
2679,1910,769,944,331900,98672
203,118,85,881,128300,98673
4554,3223,1331,841,267400,98674
2035,1752,283,895,299700,98675
19829,14087,5742,1303,259000,98682
13687,7840,5847,1302,311300,98683
10715,5965,4750,1298,272000,98684
10607,8473,2134,1382,345500,98685
7597,5619,1978,1341,344200,98686
15794,9835,5959,890,252700,98801
11328,8086,3242,914,270800,98802
51,33,18,-,70700,98811
1725,895,830,639,167100,98812
828,485,343,700,105900,98813
337,243,94,844,290200,98814
2652,1822,830,779,264300,98815
2466,1531,935,836,347200,98816
57,57,0,-,-,98817
139,85,54,575,180400,98819
155,155,0,-,355800,98821
749,581,168,1055,251500,98822
3775,2485,1290,724,166100,98823
100,37,63,629,115400,98824
3058,2237,821,975,368100,98826
137,65,72,-,-,98827
848,730,118,807,256200,98828
220,138,82,450,340000,98829
284,201,83,658,122700,98830
1220,765,455,658,278500,98831
68,49,19,-,154200,98832
68,41,27,-,-,98833
90,77,13,-,237500,98834
315,137,178,624,240200,98836
15050,9035,6015,843,184400,98837
1813,1145,668,664,150300,98840
3988,2606,1382,710,154900,98841
635,280,355,769,293100,98843
2087,1409,678,639,170700,98844
111,91,20,544,268200,98845
441,249,192,655,235000,98846
699,600,99,591,321700,98847
3534,2290,1244,697,170800,98848
461,293,168,754,236300,98849
611,427,184,1008,162200,98850
1746,1329,417,705,144600,98851
6,3,3,-,-,98852
8,8,0,-,-,98853
2595,1946,649,712,159500,98855
1173,830,343,790,312600,98856
1213,810,403,691,123000,98857
797,587,210,719,171000,98858
119,70,49,-,123400,98859
133,106,27,768,84100,98860
1078,833,245,765,344200,98862
10370,5657,4713,713,156200,98901
16602,8793,7809,773,145100,98902
5256,3799,1457,899,154200,98903
14556,10398,4158,1049,223800,98908
153,0,153,944,-,98921
2869,2125,744,974,298600,98922
375,194,181,964,102200,98923
297,229,68,-,279200,98925
13058,6835,6223,939,277700,98926
0,0,0,-,-,98929
4677,2943,1734,762,149500,98930
1342,785,557,879,119500,98932
362,257,105,763,128600,98933
502,278,224,894,150000,98934
984,743,241,763,107700,98935
1921,1515,406,1186,181000,98936
1593,1179,414,880,190200,98937
865,624,241,1165,175000,98938
51,42,9,-,76300,98939
130,130,0,-,255000,98940
302,186,116,873,250000,98941
6303,4423,1880,974,227400,98942
408,272,136,1160,180200,98943
6218,3897,2321,705,150500,98944
242,155,87,891,336200,98946
879,605,274,847,204000,98947
3668,2247,1421,669,124300,98948
46,21,25,-,-,98950
3564,2056,1508,693,124600,98951
577,333,244,554,106900,98952
2227,1753,474,949,194100,98953
1481,798,683,921,161500,99001
1891,1675,216,834,298200,99003
7753,4370,3383,872,206100,99004
2984,2655,329,1593,304100,99005
4729,4202,527,718,234100,99006
237,180,57,713,175000,99008
1444,1105,339,629,215800,99009
759,0,759,1301,-,99011
343,258,85,743,159200,99012
643,417,226,381,168800,99013
5517,4356,1161,1118,233800,99016
60,43,17,850,106300,99017
79,61,18,950,156300,99018
4533,3185,1348,1041,303900,99019
0,0,0,-,-,99020
3546,3153,393,1023,243100,99021
3156,2503,653,696,209100,99022
226,189,37,-,272800,99023
1870,1613,257,690,255100,99025
3469,3047,422,1049,251600,99026
2327,2102,225,1272,230900,99027
475,373,102,800,192500,99029
450,395,55,850,152800,99030
561,393,168,655,254800,99031
324,253,71,844,111100,99032
320,226,94,615,114100,99033
0,0,0,-,-,99034
668,568,100,933,306600,99036
5967,3890,2077,928,237700,99037
31,23,8,470,88300,99039
297,217,80,500,95600,99040
540,490,50,739,177200,99101
216,157,59,730,133000,99102
218,184,34,841,173100,99103
22,12,10,-,81400,99105
2124,1419,705,647,187500,99109
595,331,264,701,208500,99110
1744,1061,683,704,169900,99111
320,271,49,746,223800,99113
5060,3770,1290,704,181000,99114
475,364,111,681,144800,99115
697,509,188,778,143400,99116
204,153,51,594,120800,99117
305,214,91,645,234400,99118
483,451,32,840,178800,99119
67,53,14,-,176800,99121
1603,1304,299,732,178700,99122
422,323,99,760,184800,99123
157,110,47,888,97100,99124
260,192,68,706,125000,99125
341,255,86,732,-,99126
119,103,16,875,177500,99128
320,233,87,518,109200,99129
373,274,99,875,169500,99130
72,67,5,575,262500,99131
710,442,268,656,109200,99133
259,183,76,770,107100,99134
112,86,26,835,175000,99135
9,9,0,-,-,99136
174,127,47,581,159200,99137
415,273,142,479,143800,99138
544,460,84,650,213400,99139
163,109,54,388,145800,99140
2128,1612,516,635,168800,99141
339,259,80,588,106600,99143
10,6,4,-,-,99144
25,25,0,-,232700,99146
78,78,0,-,311800,99147
872,747,125,761,209800,99148
109,99,10,-,58800,99149
146,135,11,-,223300,99150
62,50,12,-,128600,99151
68,48,20,658,164300,99152
244,134,110,544,161500,99153
11,11,0,-,-,99154
431,232,199,479,88600,99155
3610,2814,796,842,218500,99156
301,208,93,684,122100,99157
224,161,63,794,135300,99158
651,509,142,764,103700,99159
102,85,17,704,-,99160
641,514,127,574,171100,99161
12037,3553,8484,792,254500,99163
0,0,0,-,-,99164
1374,930,444,665,156700,99166
243,229,14,810,165300,99167
1075,736,339,691,118700,99169
404,302,102,488,121700,99170
510,344,166,629,148100,99171
698,567,131,581,161200,99173
22,17,5,-,109700,99174
71,48,23,829,-,99176
192,154,38,692,243800,99179
533,418,115,622,216400,99180
681,586,95,643,155700,99181
534,435,99,810,157400,99185
6753,1962,4791,655,153800,99201
7298,3035,4263,803,151200,99202
9015,6829,2186,1068,266200,99203
3591,1215,2376,682,183900,99204
17969,11374,6595,964,150200,99205
15152,9338,5814,843,207000,99206
12030,6064,5966,885,116300,99207
21409,13809,7600,817,234900,99208
8624,6060,2564,874,165800,99212
11160,5229,5931,959,189800,99216
6661,4313,2348,888,172700,99217
6054,3194,2860,856,240600,99218
13232,8107,5125,939,263900,99223
8610,5898,2712,908,258900,99224
23461,16421,7040,913,191600,99301
3677,2886,791,842,174000,99320
119,41,78,-,-,99321
80,61,19,600,190600,99322
1346,1123,223,863,195500,99323
3742,2257,1485,896,196200,99324
1395,846,549,670,122100,99326
1612,1113,499,761,170600,99328
63,51,12,950,119800,99329
314,225,89,652,111100,99330
15,10,5,-,-,99333
102,68,34,579,94300,99335
18418,9014,9404,879,167800,99336
10899,9477,1422,962,199400,99337
5336,4945,391,968,297700,99338
315,199,116,761,130500,99341
829,403,426,668,162300,99343
4910,3005,1905,761,165500,99344
51,31,20,675,307100,99345
195,184,11,-,182700,99346
994,696,298,595,137200,99347
450,160,290,704,152800,99348
2085,1044,1041,690,191300,99349
5149,3286,1863,793,194700,99350
12775,8537,4238,1078,273100,99352
5265,4439,826,1158,253300,99353
9078,5539,3539,958,215000,99354
88,53,35,647,112500,99356
959,450,509,687,143900,99357
87,58,29,491,131300,99359
541,415,126,1025,260500,99360
765,598,167,697,181000,99361
15385,9806,5579,911,219200,99362
67,30,37,-,-,99363
171,126,45,694,72600,99371
104,104,0,-,-,99401
693,494,199,755,213700,99402
8396,5865,2531,759,181100,99403
7646,2438,5208,1086,346100,99501
8959,5582,3377,1299,327600,99502
5928,1775,4153,1032,239400,99503
14700,9795,4905,1356,252900,99504
1107,0,1107,2288,-,99505
2204,15,2189,1966,-,99506
13951,9579,4372,1434,294500,99507
12330,6655,5675,1145,251500,99508
0,0,0,-,-,99510
0,0,0,-,-,99513
7889,6064,1825,1456,324000,99515
7028,6505,523,1614,465000,99516
6945,3850,3095,1298,302700,99517
4139,2691,1448,1469,262800,99518
0,0,0,-,-,99519
155,105,50,-,258800,99540
40,22,18,1300,23800,99546
13,10,3,-,95000,99547
23,20,3,-,115000,99548
27,18,9,725,73300,99549
82,76,6,-,143200,99550
133,98,35,425,75000,99551
81,59,22,-,101800,99552
58,45,13,-,97100,99553
168,145,23,769,95800,99554
62,46,16,1125,200000,99555
1061,933,128,917,176600,99556
205,139,66,963,180800,99557
37,25,12,1125,52500,99558
2252,1069,1183,1475,236900,99559
86,74,12,525,68000,99561
215,176,39,758,66200,99563
25,17,8,663,-,99564
26,21,5,-,275000,99565
42,33,9,850,"10,000-",99566
3148,2503,645,1173,328800,99567
159,151,8,-,186000,99568
17,11,6,-,87500,99569
55,25,30,1038,112500,99571
203,175,28,-,364800,99572
186,135,51,709,135400,99573
1022,711,311,1055,314900,99574
31,22,9,-,162500,99575
848,479,369,1184,253500,99576
9503,6889,2614,1848,341200,99577
117,80,37,429,55500,99578
18,16,2,-,95000,99579
25,20,5,-,104200,99580
179,137,42,813,89700,99581
36,9,27,-,177500,99583
68,41,27,456,95000,99585
101,74,27,-,325000,99586
829,374,455,1247,435900,99587
225,175,50,861,210500,99588
48,37,11,-,59000,99589
57,34,23,375,43800,99590
27,17,10,-,75000,99591
65,48,17,688,45800,99602
4034,2800,1234,999,276700,99603
209,144,65,550,64000,99604
41,41,0,-,336100,99605
101,65,36,600,115300,99606
68,56,12,925,141700,99607
105,79,26,688,58800,99609
780,639,141,957,209800,99610
5910,4201,1709,973,236000,99611
284,174,110,867,116700,99612
156,74,82,1125,196900,99613
156,119,37,463,69300,99614
4105,2190,1915,1379,282800,99615
158,119,39,538,59600,99620
153,121,32,513,76900,99621
73,60,13,-,85000,99622
25,20,5,563,87100,99624
31,23,8,-,-,99625
71,58,13,525,175000,99626
125,75,50,975,58600,99627
152,106,46,694,70000,99628
80,64,16,663,82500,99630
126,84,42,-,256700,99631
167,113,54,608,71700,99632
180,110,70,870,190000,99633
115,76,39,488,52700,99634
110,72,38,538,114100,99636
117,81,36,763,72100,99637
12,6,6,950,20000,99638
426,348,78,750,196200,99639
53,34,19,775,154200,99640
124,92,32,625,72200,99641
83,68,15,1083,78700,99643
78,51,27,900,-,99644
8670,6761,1909,1072,254500,99645
9,9,0,-,-,99647
24,21,3,-,91700,99648
30,26,4,-,85000,99649
122,78,44,488,65000,99650
6,4,2,-,-,99651
1230,959,271,959,183000,99652
37,7,30,940,-,99653
18101,13726,4375,1142,247800,99654
165,140,25,613,51300,99655
8,8,0,-,112500,99656
50,35,15,-,97500,99657
197,154,43,850,103600,99658
108,63,45,875,67000,99659
126,67,59,1016,88300,99660
427,279,148,1051,142200,99661
119,83,36,613,60600,99662
186,138,48,590,196900,99663
1522,938,584,942,217900,99664
26,12,14,375,66700,99665
40,32,8,-,-,99666
44,44,0,-,217900,99667
30,21,9,-,162500,99668
5877,4360,1517,1099,239400,99669
18,9,9,-,106300,99670
112,81,31,467,-,99671
1318,1060,258,1017,264800,99672
559,434,125,905,168100,99674
555,428,127,1163,183500,99676
20,15,5,-,-,99677
206,122,84,688,70000,99678
85,48,37,542,43300,99679
139,91,48,529,59000,99680
71,51,20,525,49500,99681
98,64,34,1054,30000,99682
207,186,21,1375,118800,99683
179,124,55,1000,141700,99684
897,209,688,1414,342600,99685
1322,1048,274,1125,189700,99686
939,760,179,1021,187500,99688
232,145,87,1027,169300,99689
39,37,2,-,74200,99690
38,25,13,625,28800,99691
61,0,61,850,-,99692
131,49,82,833,51300,99693
552,424,128,968,182500,99694
0,0,0,-,-,99695
6924,3018,3906,1172,187000,99701
999,5,994,2100,-,99702
2017,12,2005,2074,-,99703
0,0,0,-,-,99704
8370,5736,2634,1259,227100,99705
1,1,0,-,-,99706
12020,7777,4243,1143,253100,99709
5555,4433,1122,1060,262800,99712
468,385,83,1330,229700,99714
61,37,24,375,54400,99720
70,46,24,825,105000,99721
55,44,11,-,85000,99722
1345,581,764,1140,181600,99723
22,19,3,-,101400,99724
11,7,4,-,65000,99726
114,78,36,675,108300,99727
97,82,15,-,150000,99729
34,33,1,-,68300,99730
7,0,7,-,-,99732
25,15,10,-,-,99733
0,0,0,-,-,99734
44,33,11,1188,67000,99736
1485,1118,367,1151,210500,99737
58,41,17,588,97500,99738
85,60,25,775,50000,99739
209,147,62,742,107500,99740
193,148,45,1167,119000,99741
150,132,18,-,84000,99742
386,304,82,596,221400,99743
50,42,8,900,115600,99744
33,15,18,-,57500,99745
113,93,20,650,57100,99746
53,40,13,950,103600,99747
58,40,18,667,65000,99748
80,59,21,750,117000,99749
117,80,37,793,72000,99750
30,15,15,700,120800,99751
942,400,542,1417,214900,99752
76,44,32,613,103600,99753
34,29,5,258,41300,99754
100,65,35,-,336800,99755
38,27,11,756,88300,99756
7,7,0,-,85000,99757
79,41,38,-,-,99758
56,24,32,775,104200,99759
215,163,52,775,122700,99760
94,76,18,775,100000,99761
1431,700,731,1536,228700,99762
118,61,57,650,129700,99763
86,51,35,1685,71300,99764
87,71,16,750,57900,99765
152,115,37,863,91300,99766
20,18,2,-,68000,99767
69,55,14,338,79200,99768
211,182,29,983,75000,99769
175,133,42,838,75000,99770
71,54,17,575,80000,99771
158,114,44,825,74100,99772
62,48,14,850,94300,99773
7,3,4,-,-,99774
163,0,163,974,-,99775
44,34,10,-,90000,99776
96,64,32,600,56400,99777
59,38,21,450,105000,99778
544,385,159,832,150300,99780
50,36,14,558,-,99781
131,80,51,792,98600,99782
56,32,24,617,55000,99783
83,48,35,831,83300,99784
96,62,34,725,95000,99785
78,51,27,1094,106300,99786
37,30,7,-,65000,99788
106,63,43,900,81700,99789
8,8,0,-,-,99790
49,37,12,1125,112500,99791
11554,7502,4052,1232,344000,99801
133,78,55,575,150000,99820
967,512,455,1163,344800,99824
39,39,0,-,325000,99825
190,153,37,950,298600,99826
1052,710,342,921,256200,99827
287,186,101,1096,178600,99829
181,127,54,930,145300,99830
56,52,4,-,187500,99832
1170,799,371,950,213100,99833
3561,2062,1499,1123,349300,99835
33,30,3,-,104200,99836
400,206,194,1056,314500,99840
68,64,4,-,245200,99841
5327,3240,2087,1165,272300,99901
0,0,0,-,-,99903
78,60,18,-,185400,99918
328,267,61,906,168800,99919
776,531,245,945,230900,99921
111,79,32,525,111200,99922
15,15,0,-,-,99923
325,223,102,725,174500,99925
480,355,125,671,143100,99926
29,29,0,-,272500,99927
1074,734,340,809,212600,99929
