housing_units_occ,homeowner_units_occ,renters_units_occ,med_rent,med_household_price,zip
5818,3170,2648,373,82500,601
12719,9494,3225,380,87300,602
19009,11242,7767,400,122300,603
1959,1459,500,284,92700,606
9120,7080,2040,415,90300,610
23037,14926,8111,395,97300,612
3606,2709,897,509,92900,616
8079,5972,2107,478,101900,617
2330,1471,859,538,135500,622
14165,8170,5995,422,111800,623
7690,5763,1927,431,77600,624
11571,8029,3542,419,108300,627
615,271,344,223,86300,631
7568,5677,1891,464,95800,637
6033,4035,1998,372,96500,638
9104,5785,3319,387,94200,641
12075,9308,2767,694,142900,646
1866,1474,392,525,84400,647
5051,3824,1227,524,93900,650
1335,1152,183,373,98200,652
3662,2609,1053,400,89800,653
6566,4568,1998,342,82200,656
14443,10722,3721,436,97500,659
6271,4646,1625,393,104700,660
14482,9282,5200,483,103800,662
4850,3051,1799,384,90400,664
8153,4660,3493,417,92000,667
9727,5554,4173,407,86400,669
3006,2088,918,314,73100,670
15726,11554,4172,471,105900,674
13035,8689,4346,424,97400,676
5092,3719,1373,444,121900,677
9179,5612,3567,445,108800,678
18602,11142,7460,410,92500,680
11718,6688,5030,409,112800,682
11368,8193,3175,391,95100,683
14338,9022,5316,395,99800,685
10129,7130,2999,489,98000,687
4244,3097,1147,418,95800,688
2313,1719,594,560,112900,690
11756,8136,3620,502,120400,692
18246,15226,3020,511,114200,693
46,46,0,-,-,694
10713,8159,2554,379,91500,698
8642,5786,2856,445,111200,703
2803,2277,526,345,82200,704
8529,6826,1703,443,109300,705
3958,3020,938,390,90800,707
6091,4819,1272,467,87500,714
1300,856,444,314,82100,715
11256,6801,4455,391,112300,716
6686,2934,3752,276,103900,717
8284,6556,1728,430,92100,718
8887,7002,1885,478,94700,719
6676,4608,2068,375,89700,720
6519,4606,1913,332,94900,723
30699,19998,10701,487,125600,725
20122,14760,5362,688,143700,727
13450,9934,3516,428,97100,728
16482,12822,3660,530,114800,729
12051,7658,4393,354,94000,730
4482,3155,1327,434,83600,731
4594,3441,1153,473,93500,735
17409,11427,5982,464,119100,736
11823,7889,3934,475,103600,738
11876,8408,3468,519,117900,739
613,224,389,568,72000,740
1573,1258,315,505,85800,741
16178,12403,3775,553,115200,745
8296,6636,1660,393,87600,751
13633,10376,3257,483,111000,754
7759,5679,2080,435,92800,757
2473,1932,541,646,104500,765
7907,5653,2254,385,93500,766
11997,8603,3394,428,87700,767
13706,10430,3276,457,88500,769
12385,9178,3207,517,115100,771
6768,4556,2212,372,94500,772
6636,4677,1959,484,109200,773
512,345,167,604,89900,775
12850,9150,3700,407,113100,777
15181,12498,2683,676,147900,778
4081,3296,785,-,112000,780
5635,3488,2147,388,89100,782
10847,8644,2203,513,88500,783
14568,10627,3941,380,90700,784
96,96,0,-,88400,786
16797,12158,4639,433,99400,791
9122,7042,2080,416,90600,794
15299,11350,3949,445,92500,795
2696,1048,1648,506,242200,901
68,48,20,-,342900,906
8780,5143,3637,735,233800,907
2452,1063,1389,443,136200,909
3805,2080,1725,682,292500,911
2528,1439,1089,571,130400,912
3470,484,2986,184,401400,913
11214,4984,6230,404,94200,915
8273,3915,4358,442,113100,917
8208,3695,4513,298,179800,918
6874,3987,2887,621,152800,920
13599,6386,7213,512,140900,921
10045,4182,5863,359,112800,923
19373,10833,8540,382,133100,924
3178,721,2457,448,122600,925
37216,26023,11193,597,176400,926
5831,3220,2611,512,197000,927
25,0,25,-,-,934
0,0,0,-,-,936
25855,19622,6233,573,135100,949
0,0,0,-,-,950
0,0,0,-,-,951
2988,1823,1165,532,105800,952
21798,18110,3688,627,143400,953
25459,18404,7055,572,131000,956
14764,10366,4398,521,133800,957
18297,11853,6444,575,144500,959
0,0,0,-,-,960
11349,7683,3666,495,151900,961
7005,3898,3107,338,112700,962
2748,1595,1153,435,101500,965
6208,4756,1452,807,235800,966
1825,1313,512,883,219700,968
15099,11783,3316,814,234100,969
9503,6611,2892,544,139900,971
21413,14440,6973,531,152400,976
7713,5014,2699,799,172000,979
6014,4039,1975,603,139700,982
14156,9220,4936,571,142300,983
12677,8893,3784,493,138500,985
21665,16221,5444,667,150600,987
7460,5356,2104,1034,209400,1001
9976,4687,5289,1278,344600,1002
31,5,26,-,-,1003
1785,1439,346,945,222000,1005
5558,4470,1088,970,263900,1007
548,508,40,825,231500,1008
157,157,0,-,221200,1009
1465,1290,175,743,270100,1010
572,472,100,900,202600,1011
233,206,27,1203,250000,1012
9273,4263,5010,860,175700,1013
12491,7981,4510,889,180400,1020
1223,918,305,1226,124100,1022
459,366,93,829,253000,1026
7871,4706,3165,937,249800,1027
5978,4938,1040,928,256500,1028
316,239,77,632,266200,1029
4290,3498,792,819,240500,1030
531,298,233,821,184200,1031
251,215,36,1344,257800,1032
2457,2108,349,992,263300,1033
878,779,99,1125,271700,1034
2316,1761,555,1050,310100,1035
1976,1798,178,964,275200,1036
238,222,16,-,312000,1037
1337,1011,326,1079,291400,1038
526,373,153,1105,263200,1039
15403,6259,9144,795,182700,1040
925,776,149,987,211500,1050
562,469,93,1561,277800,1053
818,723,95,1163,348500,1054
8086,5952,2134,922,224700,1056
3495,2932,563,819,232200,1057
6563,2750,3813,1124,322800,1060
4281,3010,1271,915,321800,1062
0,0,0,-,-,1063
9,0,9,-,-,1066
679,641,38,1201,278200,1068
3630,2785,845,727,197100,1069
272,239,33,1000,239000,1070
499,464,35,829,216500,1071
636,570,66,1519,276600,1072
2422,2225,197,989,319800,1073
134,0,134,1083,-,1074
6745,4902,1843,948,232700,1075
3750,3031,719,933,290200,1077
256,153,103,1322,180500,1079
911,566,345,845,160000,1080
734,583,151,843,194000,1081
4455,3322,1133,812,186400,1082
1115,767,348,876,212100,1083
74,73,1,-,245800,1084
15542,10734,4808,947,222100,1085
0,0,0,-,-,1086
211,137,74,985,240800,1088
11971,7105,4866,849,213800,1089
445,302,143,468,215300,1092
141,131,10,-,338100,1093
190,88,102,522,188900,1094
5266,4613,653,775,299900,1095
1034,876,158,973,274700,1096
17,7,10,-,-,1097
556,481,75,788,270900,1098
1418,138,1280,841,118000,1103
8989,4137,4852,838,134800,1104
4831,519,4312,707,139100,1105
5822,5134,688,1375,327600,1106
3825,911,2914,715,169500,1107
9899,3719,6180,940,153700,1108
9591,4393,5198,945,130000,1109
5701,4378,1323,873,160500,1118
4822,3471,1351,901,148800,1119
1097,1036,61,1682,167500,1128
2787,2211,576,1071,167400,1129
3243,1355,1888,916,136200,1151
0,0,0,-,-,1199
19953,12484,7469,819,174600,1201
3768,2455,1313,704,152000,1220
348,320,28,1222,246100,1222
1028,968,60,1375,256300,1223
124,64,60,726,184000,1224
1404,1132,272,923,192600,1225
2970,2212,758,861,185800,1226
48,40,8,-,333300,1229
3398,2404,994,928,334300,1230
1196,1046,150,735,191100,1235
427,359,68,1097,313200,1236
970,810,160,1132,246500,1237
2351,1626,725,771,266400,1238
2201,1441,760,820,361700,1240
173,105,68,-,260900,1242
164,159,5,-,230500,1243
62,52,10,-,388900,1244
405,327,78,1194,428700,1245
6848,4150,2698,711,153300,1247
365,351,14,625,248800,1253
471,441,30,1354,456300,1254
326,303,23,595,296500,1255
321,285,36,825,185700,1256
1014,803,211,1023,312200,1257
195,176,19,-,389600,1258
262,249,13,950,383900,1259
131,66,65,-,446700,1260
557,316,241,758,406300,1262
76,52,24,1125,450000,1264
583,527,56,1682,378700,1266
2405,1819,586,995,297900,1267
342,340,2,-,295900,1270
7995,4523,3472,864,189600,1301
632,525,107,917,273000,1330
5403,3897,1506,846,154000,1331
1101,878,223,983,239200,1337
73,67,6,-,260400,1338
601,493,108,791,227600,1339
722,596,126,968,205400,1340
692,608,84,1150,322300,1341
563,360,203,2103,306500,1342
25,25,0,-,287500,1343
602,503,99,734,208400,1344
189,176,13,-,227300,1346
78,78,0,-,115600,1347
462,378,84,978,194000,1349
47,37,10,825,108000,1350
999,734,265,864,269200,1351
583,482,101,1006,247900,1354
392,350,42,1074,254900,1355
1214,952,262,830,249000,1360
3185,2190,995,784,160900,1364
493,408,85,775,271800,1366
231,202,29,1323,195000,1367
528,442,86,1118,230700,1368
1853,1302,551,840,239100,1370
1850,1536,314,943,279500,1373
1597,674,923,1293,282000,1375
2375,1177,1198,784,186000,1376
338,323,15,1097,211100,1378
384,307,77,956,208300,1379
14828,7813,7015,954,183400,1420
2024,1810,214,1292,230600,1430
1106,971,135,1174,245600,1431
3387,2081,1306,927,296000,1432
191,103,88,-,282500,1434
1229,930,299,903,167900,1436
229,221,8,-,237500,1438
8254,4233,4021,786,175200,1440
4101,3593,508,1289,440700,1450
1645,1522,123,1375,568300,1451
1682,1531,151,987,249400,1452
16563,9178,7385,913,231700,1453
3440,2896,544,975,401500,1460
4171,3329,842,1617,285300,1462
4346,3396,950,1118,326100,1463
2426,1673,753,972,328700,1464
163,163,0,-,386300,1467
1891,1698,193,1105,207500,1468
2683,2206,477,862,263600,1469
2832,2517,315,1136,274600,1473
715,600,115,1065,275700,1474
3889,2955,934,729,188100,1475
6642,5498,1144,961,246100,1501
1151,1001,150,1037,379600,1503
3438,2431,1007,852,267800,1504
1713,1484,229,921,363100,1505
1421,1170,251,908,224300,1506
4889,3957,932,969,280400,1507
5586,3014,2572,1118,248100,1510
828,732,96,1094,246500,1515
3151,2511,640,1006,291600,1516
1397,1006,391,699,325700,1518
2468,1965,503,1142,363800,1519
5420,4869,551,1223,297100,1520
951,860,91,1298,214300,1521
1239,1062,177,1077,284900,1522
2245,1874,371,1131,340400,1523
2597,1902,695,876,223900,1524
94,44,50,-,237500,1525
5330,3957,1373,1029,263200,1527
1158,886,272,1154,298000,1529
425,380,45,945,270700,1531
5278,4350,928,1344,389600,1532
2236,1698,538,748,338300,1534
1818,1263,555,797,238200,1535
2759,2216,543,1122,334900,1536
880,684,196,866,189400,1537
4323,3204,1119,808,240000,1540
1279,1167,112,1129,381700,1541
828,669,159,1088,258400,1542
2904,2433,471,948,281800,1543
12853,9496,3357,1249,394100,1545
6926,2995,3931,868,188200,1550
1712,971,741,1118,365700,1560
85,34,51,-,-,1561
4969,3232,1737,858,252100,1562
2692,2336,356,1270,340500,1564
2220,1965,255,1258,266000,1566
2725,2293,432,903,407900,1568
4817,3868,949,1134,277700,1569
6734,3720,3014,885,211800,1570
3873,2834,1039,960,252700,1571
6682,4105,2577,1539,432000,1581
2055,1759,296,892,268200,1583
1887,1350,537,1303,222700,1585
3739,2085,1654,962,261000,1588
3341,3071,270,787,349100,1590
9666,5756,3910,1150,225400,1602
7203,3320,3883,996,183400,1603
14447,6741,7706,1084,209700,1604
10657,3082,7575,929,198300,1605
8129,5409,2720,1029,215400,1606
3694,1548,2146,993,173100,1607
1639,130,1509,787,157600,1608
7401,2754,4647,994,305700,1609
8114,1187,6927,1015,162500,1610
877,551,326,963,227800,1611
1558,1442,116,973,297600,1612
12587,9851,2736,1371,389000,1701
15244,5298,9946,1260,326900,1702
240,154,86,-,275600,1718
2288,1685,603,1010,506700,1719
8476,6364,2112,1346,564000,1720
6689,5368,1321,1312,379000,1721
5240,3880,1360,1770,605900,1730
540,6,534,2619,-,1731
1686,1565,121,-,485200,1740
1773,1680,93,1328,793300,1741
6741,5166,1575,2006,775100,1742
157,140,17,-,400000,1745
5171,4539,632,1001,417100,1746
2232,1798,434,1054,322500,1747
5614,4817,797,1675,551400,1748
7708,5794,1914,1148,319700,1749
15529,8805,6724,1350,325700,1752
4274,3104,1170,1111,334000,1754
2064,1813,251,1486,422400,1756
11086,7609,3477,1119,292800,1757
14157,10186,3971,1392,497000,1760
1480,1369,111,1153,723500,1770
3246,2873,373,1092,599200,1772
2008,1582,426,1831,846300,1773
2627,2361,266,1507,474800,1775
6226,5741,485,923,668500,1776
5044,4501,543,1086,662000,1778
15650,9475,6175,1478,394900,1801
9572,6717,2855,1851,465900,1803
12369,9846,2523,1423,603700,1810
11211,8922,2289,1368,371500,1821
9805,8382,1423,1378,386800,1824
11185,8542,2643,1281,305100,1826
1138,1095,43,1682,460600,1827
10148,5598,4550,1093,281500,1830
8825,5034,3791,1118,264700,1832
3265,2621,644,1463,431700,1833
2339,1967,372,1272,381100,1834
5182,3654,1528,1125,270200,1835
2215,165,2050,905,97700,1840
14854,4165,10689,1058,243800,1841
8732,2994,5738,1123,238700,1843
17671,12555,5116,1160,304900,1844
11136,8225,2911,1399,457800,1845
5421,2358,3063,1155,209100,1850
10203,4175,6028,1134,252100,1851
13830,6388,7442,1057,254000,1852
9542,3536,6006,1007,227900,1854
2683,2382,301,795,335300,1860
3417,2940,477,1225,365400,1862
3888,3028,860,1144,313200,1863
5422,4637,785,1434,469200,1864
9063,7469,1594,1220,491200,1867
11413,9878,1535,1647,359400,1876
4378,3766,612,1266,349100,1879
10335,7865,2470,1298,448000,1880
8244,7351,893,1841,485600,1886
7947,6710,1237,1772,422800,1887
7928,6827,1101,1568,842300,1890
916,78,838,819,286200,1901
17154,5833,11321,1079,253800,1902
6345,4780,1565,1346,316900,1904
8539,3972,4567,1093,266900,1905
10210,8242,1968,1045,361600,1906
5494,4252,1242,1583,450600,1907
1597,1126,471,1312,548900,1908
7025,4921,2104,1113,316500,1913
16408,9967,6441,1141,392900,1915
2707,2637,70,800,627900,1921
1050,909,141,-,456500,1922
10624,7440,3184,1259,380600,1923
1439,1149,290,1108,585700,1929
12906,8246,4660,1051,381000,1930
0,0,0,-,-,1937
5677,4176,1501,1033,452400,1938
4949,4150,799,1489,593300,1940
2106,1481,625,1301,763600,1944
8250,6621,1629,1408,611100,1945
2998,2583,415,1686,461500,1949
7881,5957,1924,1174,479100,1950
1765,1441,324,1393,474800,1951
3597,2728,869,1280,333900,1952
21251,13690,7561,1265,356800,1960
3201,2286,915,1078,471800,1966
2186,1826,360,1154,428200,1969
18277,9277,9000,1147,331300,1970
2677,2197,480,1096,519200,1982
2237,2120,117,323,566700,1983
1381,1236,145,1262,535800,1984
1596,1486,110,2000,490200,1985
6347,5154,1193,1364,288900,2019
9026,6978,2048,1570,460200,2021
3046,2358,688,1496,852300,2025
9865,6816,3049,1546,416300,2026
2011,1925,86,2415,1006800,2030
1644,1396,248,1474,461400,2032
6626,4329,2297,1397,392800,2035
11288,9181,2107,1190,403000,2038
8712,6989,1723,2190,710700,2043
4892,3325,1567,1291,377000,2045
50,18,32,-,-,2047
8471,6108,2363,1186,386800,2048
9495,7428,2067,1363,433800,2050
4189,3641,548,1215,633500,2052
4642,4086,556,1078,383800,2053
3100,2611,489,1557,387100,2054
3183,3020,163,1280,469100,2056
3632,3422,210,711,583300,2061
11757,6876,4881,1414,402600,2062
6650,5804,846,1072,533700,2066
6220,5332,888,1762,516900,2067
300,286,14,-,429100,2071
10724,7635,3089,1313,323500,2072
7027,5936,1091,1392,459200,2081
5528,4761,767,1575,662800,2090
4076,3418,658,1098,421100,2093
1888,895,993,2480,1009200,2108
1943,639,1304,2680,815600,2109
1347,796,551,2211,891600,2110
3202,849,2353,1425,694200,2111
4370,992,3378,1848,548900,2113
7196,1738,5458,2128,697400,2114
9258,1266,7992,1563,660900,2115
11987,4732,7255,1800,992100,2116
12514,4581,7933,1196,710700,2118
11261,2534,8727,917,379300,2119
4991,426,4565,1074,413600,2120
10471,2090,8381,812,417500,2121
8384,3274,5110,1370,398800,2122
19130,7351,11779,1314,362500,2124
12586,4371,8215,1273,375800,2125
10027,4127,5900,1354,316300,2126
17056,6741,10315,1485,533200,2127
16286,4651,11635,1249,355800,2128
8931,4068,4863,1153,622200,2129
16336,7587,8749,1518,486400,2130
12480,6929,5551,1365,414900,2131
11333,8287,3046,1539,459400,2132
7855,997,6858,1660,452900,2134
19063,4567,14496,1652,465200,2135
11762,6263,5499,1178,361100,2136
13542,5538,8004,1984,748200,2138
14094,5046,9048,1904,644300,2139
8891,3117,5774,1481,671200,2140
6437,2161,4276,1761,583300,2141
1326,189,1137,3129,838000,2142
11238,3306,7932,1730,550200,2143
10792,3790,7002,1824,635500,2144
10409,4091,6318,1514,472100,2145
23081,9447,13634,1395,359400,2148
15521,6150,9371,1342,357300,2149
12714,3276,9438,1286,308300,2150
19986,9746,10240,1301,332100,2151
7747,4293,3454,1312,387200,2152
22474,12930,9544,1613,443100,2155
528,0,528,2380,-,2163
24770,10573,14197,1374,365100,2169
7766,4160,3606,1272,408000,2170
7631,4383,3248,1554,416900,2171
11481,7697,3784,1243,463300,2176
9062,6014,3048,1390,438700,2180
14017,10191,3826,1373,402000,2184
8970,7401,1569,1520,558700,2186
6296,3709,2587,1346,347600,2188
6179,3846,2333,1203,318700,2189
7038,4957,2081,1464,363900,2190
3501,2792,709,1374,342200,2191
743,31,712,2860,"2,000,000+",2199
27,0,27,-,-,2203
1543,571,972,3072,752900,2210
7463,912,6551,1778,465900,2215
21042,9752,11290,1058,250300,2301
11158,7650,3508,1033,221600,2302
1574,1200,374,1116,294900,2322
7897,5829,2068,1385,338000,2324
4460,4125,335,1319,274600,2330
5427,4899,528,2176,594000,2332
4854,4065,789,1148,321600,2333
2850,2519,331,1599,281500,2338
4980,4311,669,1161,469200,2339
3720,3422,298,932,344300,2341
4257,3447,810,1046,290000,2343
9078,7378,1700,1138,292800,2346
3956,3408,548,1347,356200,2347
6236,4225,2011,1169,319200,2351
4395,3613,782,1269,417700,2356
24,13,11,-,-,2357
6464,5676,788,1633,370300,2359
22468,17733,4735,1343,346300,2360
4758,3785,973,1241,348500,2364
0,0,0,-,-,2366
1005,870,135,1216,357600,2367
12226,8361,3865,1308,283500,2368
6853,4895,1958,1181,288100,2370
3656,2980,676,1468,330200,2375
2469,2138,331,1289,327200,2379
5380,3908,1472,1057,289800,2382
5058,4520,538,2126,813900,2420
6697,4981,1716,1942,818100,2421
8473,4761,3712,2133,797700,2445
13301,5731,7570,2109,805800,2446
7346,4308,3038,1614,439600,2451
5112,3266,1846,1668,494300,2452
11244,4654,6590,1432,469400,2453
0,0,0,-,-,2457
4942,2998,1944,1740,733400,2458
6680,5388,1292,1744,973000,2459
3722,2429,1293,1708,769700,2460
2683,1978,705,1761,835400,2461
612,377,235,1790,836600,2462
1247,834,413,1667,620000,2464
4296,3322,974,1789,765900,2465
2820,1607,1213,1691,747900,2466
6181,4213,1968,2171,769900,2467
1924,1793,131,2313,1109300,2468
15233,7921,7312,1720,480500,2472
11400,6596,4804,1615,565300,2474
7232,4753,2479,1542,595600,2476
9708,6151,3557,1802,758900,2478
4736,4028,708,2000,1150900,2481
3922,3133,789,1483,956000,2482
7063,6294,769,854,790900,2492
3764,3256,508,1542,1198400,2493
3589,2505,1084,1754,695000,2494
5685,4472,1213,1255,321700,2532
277,217,60,-,437500,2534
468,385,83,1458,986900,2535
8094,6500,1594,1420,334600,2536
2430,2229,201,1440,440000,2537
1440,1031,409,1185,237700,2538
1597,1285,312,1702,728000,2539
3974,2599,1375,924,537100,2540
278,11,267,1240,-,2542
432,288,144,1328,860400,2543
35,35,0,-,-,2553
3651,2328,1323,1689,986100,2554
1383,1181,202,1391,527300,2556
1684,1323,361,1386,577900,2557
464,233,231,1102,227600,2558
1818,1370,448,1265,336600,2559
170,141,29,-,299300,2561
1244,986,258,1350,382300,2562
3854,3306,548,1164,362500,2563
100,100,0,-,"2,000,000+",2564
1442,957,485,1282,595800,2568
4578,3000,1578,985,277000,2571
930,806,124,-,745500,2575
1899,1823,76,1408,250400,2576
10,10,0,-,-,2584
6319,3176,3143,1147,248900,2601
839,708,131,1723,589200,2630
4267,3633,634,936,431300,2631
4336,3724,612,1326,351800,2632
1921,1515,406,917,600700,2633
1556,1415,141,1928,390200,2635
56,43,13,-,479600,2637
1514,1320,194,1166,480300,2638
1553,907,646,1169,331100,2639
101,101,0,-,575000,2641
2446,2048,398,1000,453400,2642
0,0,0,-,-,2643
1512,1242,270,1208,327200,2644
4260,3615,645,1221,370800,2645
887,792,95,1267,436600,2646
74,65,9,-,1822900,2647
2696,2532,164,1917,344600,2648
6279,5514,765,1339,337600,2649
375,257,118,1532,876300,2650
0,0,0,-,-,2651
439,379,60,894,511300,2652
2895,2272,623,1040,612500,2653
1468,1202,266,1523,478900,2655
1772,1199,573,1120,511600,2657
481,412,69,1378,522900,2659
3202,2453,749,1064,344600,2660
47,38,9,-,1086200,2663
4176,2982,1194,1231,327000,2664
357,282,75,1066,454400,2666
1456,1208,248,1007,496900,2667
1209,940,269,1417,443800,2668
48,34,14,-,-,2669
661,486,175,1094,392400,2670
456,357,99,1077,410200,2671
135,116,19,-,861900,2672
3723,2883,840,1342,270300,2673
3031,2771,260,1388,363500,2675
1516,1358,158,1428,337800,2702
17094,11333,5761,1030,273900,2703
12,12,0,-,666700,2713
1303,1209,94,1115,336300,2715
1689,1474,215,1052,330500,2717
2287,1989,298,702,263900,2718
6506,4887,1619,886,270800,2719
13223,5322,7901,814,234300,2720
10897,4032,6865,731,227100,2721
6672,1880,4792,721,219600,2723
7621,2567,5054,705,238900,2724
933,693,240,1091,264500,2725
6062,5062,1000,993,276100,2726
1897,1540,357,1078,471000,2738
2429,1884,545,1142,419800,2739
18406,7376,11030,812,205000,2740
4033,3406,627,793,277600,2743
4654,1737,2917,753,215000,2744
10119,5883,4236,831,218500,2745
6218,1110,5108,794,204300,2746
6970,5420,1550,965,319800,2747
4733,3709,1024,902,349100,2748
10049,6968,3081,1005,330500,2760
3474,2588,886,1290,333300,2762
693,584,109,1208,367600,2763
1438,1208,230,624,315300,2764
6532,5482,1050,1138,326700,2766
4838,3915,923,1382,330200,2767
4048,3633,415,1250,358300,2769
1798,1644,154,995,386900,2770
5886,5091,795,1124,318000,2771
6223,5366,857,894,271200,2777
2388,2289,99,-,343700,2779
19934,12134,7800,977,243500,2780
6239,5217,1022,1052,356300,2790
153,96,57,1296,537200,2791
324,109,215,758,245600,2802
911,837,74,591,224000,2804
6075,5420,655,1407,402300,2806
443,308,135,841,1104200,2807
860,675,185,1140,235800,2808
8489,5485,3004,1032,318800,2809
418,401,17,-,312700,2812
3271,2743,528,1141,305900,2813
2750,2462,288,796,256600,2814
87,87,0,-,338700,2815
13152,10119,3033,927,216800,2816
2178,1783,395,1656,319800,2817
7567,5636,1931,987,385600,2818
2442,1970,472,873,327300,2822
2081,1740,341,1092,287700,2825
357,332,25,-,217900,2826
808,728,80,1458,288800,2827
3002,2466,536,840,259200,2828
2203,1624,579,892,251600,2830
1170,1034,136,1086,278500,2831
1923,1548,375,1240,261600,2832
385,287,98,669,265300,2833
2303,1888,415,1761,582100,2835
60,60,0,-,-,2836
1653,1277,376,1250,511200,2837
1414,650,764,924,240000,2838
714,499,215,1136,113600,2839
10531,4248,6283,1165,405700,2840
0,0,0,-,-,2841
6824,3574,3250,1250,350500,2842
8928,6513,2415,1002,313300,2852
3454,3063,391,924,293600,2857
217,112,105,1101,238400,2858
2473,1819,654,953,230600,2859
17926,6258,11668,839,170500,2860
9831,5896,3935,976,174200,2861
6310,1439,4871,833,149100,2863
13495,9961,3534,947,266500,2864
6199,4384,1815,1187,296800,2865
7121,5403,1718,1279,368300,2871
148,131,17,-,230600,2872
137,113,24,-,361900,2873
2223,2094,129,1857,407300,2874
207,142,65,-,288500,2875
90,0,90,1292,-,2876
6841,5452,1389,936,267500,2878
8337,6134,2203,1062,343400,2879
1062,657,405,1172,344400,2881
6025,3856,2169,1271,406100,2882
4957,2561,2396,943,265100,2885
12509,8339,4170,1081,209800,2886
8327,6461,1866,1034,193300,2888
11312,8572,2740,1100,189500,2889
9253,5758,3495,1063,289500,2891
1853,1574,279,1612,288500,2892
13135,6985,6150,936,183200,2893
271,238,33,-,276700,2894
17054,6277,10777,848,158500,2895
4446,3469,977,985,280300,2896
599,449,150,1059,230200,2898
4802,805,3997,1005,314300,2903
12755,6134,6621,844,192100,2904
8796,4093,4703,901,181300,2905
10941,5099,5842,1204,390900,2906
8865,2568,6297,921,146800,2907
12204,5158,7046,961,174900,2908
14790,4261,10529,907,154500,2909
8128,5665,2463,1008,182300,2910
6655,3767,2888,997,195500,2911
0,0,0,-,-,2912
8807,4438,4369,915,195200,2914
7329,4586,2743,975,207300,2915
3749,2676,1073,874,232200,2916
4527,3562,965,880,287700,2917
11992,8134,3858,940,211800,2919
14064,8436,5628,1007,214400,2920
4489,3809,680,1068,345300,2921
4081,3691,390,1569,335000,3031
1984,1823,161,869,296300,3032
1750,1620,130,1172,317200,3033
1534,1442,92,1619,273100,3034
1694,1615,79,2097,315800,3036
1611,1448,163,1163,269000,3037
13154,8194,4960,1152,226400,3038
2668,2313,355,1118,239700,3042
639,586,53,1263,282000,3043
1700,1500,200,1523,255800,3044
5197,4125,1072,1106,252400,3045
977,892,85,1125,290200,3046
642,506,136,1014,217900,3047
1411,1220,191,831,202900,3048
3010,2743,267,1573,442100,3049
8955,7187,1768,1380,270500,3051
3101,2591,510,1193,293600,3052
8883,7769,1114,1345,295900,3053
9745,8457,1288,1426,263200,3054
5989,3923,2066,1110,236000,3055
880,826,54,927,305000,3057
11889,3972,7917,1097,222500,3060
11100,7880,3220,1372,258100,3062
6650,3965,2685,1352,250500,3063
5735,3304,2431,1088,256700,3064
1851,1726,125,1301,297500,3070
1792,1562,230,1107,229900,3071
4575,4079,496,1168,334500,3076
4033,3038,995,1283,214700,3077
11177,8687,2490,1081,301600,3079
657,593,64,1163,269900,3082
519,476,43,1358,264500,3084
1557,1200,357,979,255700,3086
5093,4707,386,2175,389300,3087
1663,169,1494,817,216800,3101
13248,5231,8017,1108,204500,3102
13984,6479,7505,1048,190500,3103
13628,6461,7167,1061,247800,3104
5174,4050,1124,1216,237400,3106
4302,3285,1017,1123,212600,3109
7752,6765,987,1647,381800,3110
86,86,0,-,358600,3215
967,770,197,894,200000,3216
924,471,453,843,160500,3217
280,262,18,-,219700,3218
2821,2400,421,825,185700,3220
886,774,112,1086,229000,3221
2272,1729,543,851,196900,3222
1701,1291,410,722,178500,3223
940,890,50,825,262500,3224
1368,1217,151,992,174300,3225
419,363,56,1154,340100,3226
464,381,83,1354,289800,3227
2137,1832,305,1080,256000,3229
587,503,84,942,173800,3230
109,95,14,-,307800,3231
48,42,6,-,333300,3233
1792,1400,392,1058,208500,3234
3599,2164,1435,832,160300,3235
787,752,35,1060,215100,3237
53,45,8,-,91700,3238
492,431,61,923,162700,3240
349,296,53,874,281600,3241
1666,1151,515,879,230200,3242
392,359,33,1275,186500,3243
3122,2625,497,1001,186300,3244
746,614,132,1004,266700,3245
6904,3786,3118,921,180600,3246
3082,2712,370,1057,244800,3249
560,317,243,801,213900,3251
2599,1944,655,927,284700,3253
1785,1525,260,1281,347900,3254
853,808,45,1313,279200,3255
857,737,120,995,207800,3256
1675,1300,375,1109,359600,3257
984,892,92,1026,245800,3258
142,121,21,-,286200,3259
303,263,40,1208,300600,3260
1598,1409,189,1053,234100,3261
434,314,120,688,195000,3262
1636,939,697,784,189400,3263
2210,1256,954,822,176900,3264
934,804,130,943,174800,3266
468,433,35,966,207800,3268
1118,1025,93,1625,260200,3269
150,132,18,-,217500,3273
4383,3203,1180,981,203400,3275
3321,2268,1053,901,178100,3276
1068,823,245,1080,236400,3278
272,214,58,754,152000,3279
556,507,49,733,207100,3280
3211,2851,360,1395,243800,3281
325,285,40,1000,186700,3282
320,270,50,1000,200000,3284
861,768,93,1014,229600,3285
628,499,129,1266,281500,3287
1732,1676,56,1019,275900,3290
16,16,0,-,-,3291
78,66,12,-,189900,3293
12982,6572,6410,1031,226000,3301
6185,4291,1894,1011,191600,3303
2759,2449,310,1061,306000,3304
2071,1771,300,1077,225300,3307
10366,5726,4640,979,179700,3431
997,727,270,938,186000,3440
80,57,23,-,121600,3441
584,427,157,993,170900,3442
229,198,31,-,303700,3443
580,458,122,868,262000,3444
296,235,61,1116,189400,3445
2289,1866,423,940,173400,3446
1005,873,132,971,170200,3447
289,263,26,1054,189100,3448
790,680,110,1093,284100,3449
437,374,63,975,259800,3450
1763,1330,433,752,134900,3451
2175,1404,771,795,190400,3452
916,618,298,844,199300,3455
282,255,27,913,166100,3456
275,223,52,971,274200,3457
3137,2210,927,956,247100,3458
1883,1483,400,1166,233100,3461
622,506,116,856,266000,3462
435,403,32,1179,216400,3464
888,663,225,937,155400,3465
605,527,78,726,281900,3466
643,589,54,1092,259300,3467
2060,1545,515,1116,149900,3470
2663,1460,1203,645,161000,3561
3941,2388,1553,722,90400,3570
1094,747,347,830,154000,3574
14,14,0,-,805600,3575
1397,1079,318,655,150900,3576
192,154,38,665,214700,3579
609,514,95,989,309600,3580
1478,1106,372,586,142100,3581
1053,755,298,683,80800,3582
464,399,65,810,191500,3583
1564,1096,468,741,134200,3584
1026,826,200,904,160100,3585
287,259,28,814,299200,3586
704,604,100,648,148800,3588
405,313,92,513,94300,3590
568,463,105,444,149500,3592
203,178,25,856,248700,3593
287,250,37,742,199100,3595
143,95,48,772,75900,3597
1497,1012,485,774,143200,3598
193,182,11,892,166000,3601
1077,820,257,806,205400,3602
2217,1781,436,781,138600,3603
141,98,43,-,223700,3604
412,390,22,967,172100,3605
188,171,17,1188,162800,3607
1176,991,185,843,229100,3608
314,212,102,763,129200,3609
277,235,42,747,188800,3740
1522,1156,366,1092,193600,3741
5743,3339,2404,861,134900,3743
614,546,68,1042,265000,3745
108,95,13,-,276400,3746
2090,1487,603,978,267700,3748
250,235,15,-,531600,3750
231,154,77,912,257100,3751
271,206,65,1016,176200,3752
1159,1056,103,1675,241500,3753
76,0,76,-,-,3754
2725,1729,996,1427,526600,3755
231,231,0,-,155400,3765
4226,2183,2043,992,236200,3766
661,596,65,1167,409100,3768
147,133,14,-,247500,3770
316,294,22,731,193600,3771
3030,2259,771,871,162200,3773
732,591,141,1088,153700,3774
547,446,101,1156,268800,3777
352,298,54,613,187000,3779
218,187,31,-,200800,3780
773,688,85,1578,279400,3781
1382,950,432,1093,285700,3782
1951,884,1067,899,247800,3784
841,516,325,903,124500,3785
10497,5401,5096,1208,377900,3801
1392,1128,264,796,244000,3809
785,706,79,2080,436600,3810
2679,2454,225,882,344400,3811
321,201,120,731,253300,3812
1213,1037,176,945,166000,3813
1077,791,286,-,156000,3814
546,452,94,988,230800,3816
377,236,141,889,161900,3817
1777,1236,541,783,164900,3818
1608,1377,231,935,261300,3819
13214,7041,6173,1084,240600,3820
601,518,83,1054,338000,3823
3325,1833,1492,999,361300,3824
3433,3163,270,1025,279000,3825
1052,750,302,781,297200,3826
1203,1101,102,1726,340000,3827
841,737,104,-,213000,3830
178,148,30,888,323500,3832
8894,6696,2198,1140,295000,3833
2719,1850,869,935,174500,3835
587,502,85,1313,268500,3836
656,620,36,1175,266300,3837
533,417,116,1108,275000,3838
1430,896,534,979,179000,3839
1505,1326,179,1868,424400,3840
2569,2114,455,1124,304300,3841
7057,5111,1946,1163,345100,3842
896,795,101,1635,464100,3844
580,372,208,827,195600,3845
455,365,90,894,371600,3846
201,153,48,-,375600,3847
2324,1954,370,1165,266300,3848
528,455,73,1125,172600,3849
169,169,0,-,418000,3850
1541,1336,205,1058,201000,3851
191,184,7,-,217700,3852
257,226,31,-,291300,3853
467,393,74,2034,988800,3854
995,921,74,1045,229900,3855
540,477,63,1386,411500,3856
4090,2167,1923,1103,267600,3857
1803,1411,392,1127,293600,3858
1739,1311,428,1092,222000,3860
1752,1450,302,1075,323900,3861
1747,1543,204,1736,404500,3862
727,642,85,-,172500,3864
3000,2434,566,1311,264500,3865
9211,5881,3330,947,167600,3867
2196,1531,665,1096,154700,3868
1020,749,271,1072,233500,3869
2164,1796,368,1681,590800,3870
45,45,0,-,-,3871
1415,1258,157,710,179300,3872
2210,2036,174,1452,272500,3873
3975,2580,1395,969,267500,3874
529,431,98,-,252400,3875
4933,2751,2182,1000,172100,3878
602,495,107,914,171200,3882
53,53,0,-,209800,3883
1387,1242,145,928,268800,3884
2747,2421,326,1451,382900,3885
911,604,307,789,181100,3886
731,635,96,1160,171800,3887
149,138,11,-,192300,3890
2929,2296,633,837,284700,3894
2945,2542,403,884,219200,3901
970,875,95,-,363000,3902
2569,2160,409,1013,324700,3903
3312,2091,1221,1371,283800,3904
921,854,67,-,376400,3905
1836,1490,346,900,240500,3906
668,555,113,1163,507200,3907
2784,2233,551,879,269700,3908
4310,3480,830,1040,400400,3909
163,55,108,-,298100,3910
45,29,16,-,-,3911
1025,903,122,1011,192000,4001
2826,2525,301,953,214800,4002
174,148,26,-,553600,4003
9172,4831,4341,914,215400,4005
106,20,86,1036,750000,4006
1185,1059,126,1314,212400,4008
2079,1535,544,845,158400,4009
553,497,56,1080,182000,4010
8297,5732,2565,831,219100,4011
1468,1069,399,1029,205200,4015
237,210,27,950,391400,4017
14,14,0,-,-,4019
573,386,187,697,192200,4020
2240,1846,394,1092,327500,4021
375,354,21,-,211700,4022
229,209,20,700,180100,4024
2211,2081,130,-,186900,4027
701,585,116,1032,187700,4029
1057,1023,34,-,206200,4030
3354,2499,855,1171,307700,4032
1264,996,268,875,170400,4037
6101,5163,938,1024,251300,4038
3180,2449,731,1047,217500,4039
1391,1175,216,877,186200,4040
614,502,112,821,153700,4041
1977,1694,283,870,196800,4042
4972,3811,1161,1017,289000,4043
3406,2842,564,1030,314600,4046
763,616,147,825,170700,4047
1175,983,192,961,174800,4048
1274,1126,148,795,176000,4049
118,93,25,950,382000,4050
403,372,31,681,184300,4051
1648,1451,197,988,186700,4055
133,104,29,-,186400,4056
19,19,0,-,-,4057
1101,935,166,688,174700,4061
6438,5528,910,1000,232400,4062
316,175,141,271,265600,4063
4370,2959,1411,891,198300,4064
318,196,122,1137,523600,4066
546,445,101,929,140100,4068
634,572,62,956,255300,4069
2112,1832,280,897,266600,4071
7712,5105,2607,1010,228700,4072
6832,3869,2963,802,164000,4073
7582,6047,1535,1308,337900,4074
1093,1029,64,992,190500,4076
1693,1332,361,872,353900,4079
1865,1306,559,848,173800,4083
2829,2564,265,868,237900,4084
804,804,0,-,196900,4085
3734,2795,939,910,219600,4086
607,534,73,-,199200,4087
585,482,103,756,161400,4088
4551,3782,769,777,272000,4090
330,297,33,1188,163800,4091
8054,5030,3024,899,216400,4092
3141,2627,514,890,220100,4093
543,473,70,833,182100,4095
3533,2614,919,1095,351600,4096
1362,1235,127,1073,300900,4097
8797,1602,7195,963,310600,4101
7783,3625,4158,982,254800,4102
13130,7645,5485,1136,250000,4103
4613,3852,761,1657,411900,4105
10791,6697,4094,1119,235000,4106
3733,3295,438,1060,392900,4107
396,350,46,575,342400,4108
47,33,14,-,482100,4109
557,510,47,-,625600,4110
9916,5599,4317,746,152400,4210
176,164,12,575,126800,4216
1194,918,276,584,173000,4217
595,536,59,1143,153600,4219
1096,963,133,688,142600,4220
317,253,64,1007,124500,4221
1573,1425,148,746,225700,4222
949,748,201,648,100200,4224
73,73,0,-,133700,4226
30,13,17,-,-,4227
30,0,30,-,-,4228
109,96,13,-,154500,4231
50,50,0,-,48100,4234
1625,1347,278,1065,181800,4236
83,76,7,-,200000,4237
489,427,62,1038,199800,4238
1727,1464,263,571,132500,4239
16063,8060,8003,696,140600,4240
1811,1367,444,734,140500,4250
1777,1327,450,714,145300,4252
847,702,145,595,149500,4253
1384,683,701,597,96100,4254
240,208,32,975,170300,4255
1145,912,233,672,123400,4256
968,805,163,560,77500,4257
923,830,93,786,185300,4258
1205,1042,163,995,172700,4259
2156,1793,363,984,223700,4260
155,135,20,900,248100,4261
851,722,129,781,145800,4263
479,380,99,1125,167100,4265
16,16,0,-,187500,4267
1664,1278,386,718,118800,4268
2346,2001,345,675,134400,4270
0,0,0,-,-,4271
2345,1859,486,785,174100,4274
131,118,13,683,96700,4275
2415,1631,784,599,85400,4276
2701,2238,463,1062,159700,4280
1888,1234,654,632,138500,4281
2272,1882,390,643,179600,4282
440,409,31,789,225000,4284
181,163,18,842,147300,4285
46,35,11,-,-,4286
1365,1244,121,776,195000,4287
637,494,143,716,136500,4289
501,455,46,721,121300,4290
346,304,42,525,151200,4292
1552,1249,303,604,132500,4294
11159,6682,4477,707,149400,4330
731,642,89,821,171500,4342
42,42,0,-,-,4343
1430,1023,407,754,143900,4344
4559,3416,1143,674,156200,4345
862,597,265,700,118500,4346
1127,602,525,850,197900,4347
1154,967,187,938,171900,4348
426,403,23,1125,157200,4349
1402,1243,159,697,181500,4350
1058,819,239,693,215900,4351
687,591,96,930,173700,4352
938,773,165,980,150300,4353
649,582,67,864,159800,4354
1060,898,162,1013,193600,4355
1608,1215,393,882,152600,4357
1685,1407,278,750,159700,4358
181,128,53,-,112700,4359
206,190,16,950,161500,4360
1023,810,213,793,141900,4363
2469,1677,792,785,208000,4364
18900,10499,8401,797,156800,4401
305,275,30,691,133100,4406
75,63,12,-,156300,4408
432,391,41,592,101400,4410
639,545,94,728,149300,4411
3754,2238,1516,863,159900,4412
105,92,13,-,115000,4413
563,473,90,570,79500,4414
109,81,28,630,59800,4415
2415,1773,642,753,150300,4416
124,119,5,-,49600,4417
675,560,115,720,81300,4418
1055,899,156,938,151900,4419
308,201,107,935,332100,4421
461,443,18,289,121900,4422
306,256,50,492,72900,4424
1968,1433,535,527,136100,4426
990,850,140,648,125200,4427
1180,969,211,836,151400,4428
1847,1526,321,848,184900,4429
827,603,224,465,55300,4430
19,19,0,-,205000,4431
432,370,62,1125,139900,4434
432,399,33,385,123500,4435
439,381,58,755,106300,4438
870,681,189,720,167000,4441
7,7,0,-,-,4442
1020,725,295,546,112000,4443
3440,2883,557,866,197400,4444
538,412,126,652,97400,4448
617,529,88,650,151500,4449
453,392,61,835,137500,4450
119,107,12,-,58700,4451
292,220,72,806,85000,4453
10,10,0,-,-,4454
336,300,36,645,113300,4455
1091,881,210,906,152100,4456
2368,1692,676,656,94100,4457
417,318,99,440,75000,4459
503,451,52,617,66100,4460
1193,918,275,825,115100,4461
2263,1636,627,535,66600,4462
1286,876,410,734,74300,4463
259,220,39,350,103300,4464
4010,2791,1219,687,120900,4468
0,0,0,-,-,4469
296,266,30,646,85000,4471
932,777,155,838,182000,4472
3121,1594,1527,918,188800,4473
1589,1388,201,837,169600,4474
223,206,17,542,85000,4475
567,490,77,910,185700,4476
165,133,32,-,200600,4478
616,518,98,796,111900,4479
201,174,27,-,123100,4481
87,77,10,721,155500,4485
382,356,26,629,63700,4487
523,485,38,-,134400,4488
127,108,19,-,137000,4489
128,121,7,-,84500,4490
65,62,3,-,46500,4491
66,56,10,-,60000,4492
791,700,91,793,106300,4493
231,221,10,-,66000,4495
1652,1401,251,762,169400,4496
162,138,24,442,73000,4497
5146,3303,1843,767,182400,4530
310,281,29,1088,196000,4535
921,864,57,923,247400,4537
1003,704,299,717,249400,4538
498,451,47,1069,201800,4539
27,27,0,-,-,4541
925,571,354,757,235500,4543
301,274,27,-,598800,4544
415,385,30,1087,168300,4547
435,372,63,900,376200,4548
346,332,14,-,224600,4551
786,573,213,936,267200,4553
415,343,72,917,372600,4554
760,633,127,912,220100,4555
527,435,92,934,242700,4556
93,93,0,-,284800,4558
1035,911,124,856,232900,4562
585,396,189,901,200000,4563
258,258,0,-,336500,4564
253,209,44,1063,381600,4568
0,0,0,-,-,4570
234,191,43,-,161300,4571
2235,1633,602,477,172800,4572
246,201,45,1106,262500,4573
587,543,44,950,142200,4574
34,34,0,-,-,4575
327,265,62,815,422400,4576
1893,1162,731,712,184500,4578
1285,1064,221,986,211300,4579
5833,4120,1713,782,181900,4605
516,443,73,643,168800,4606
469,375,94,768,170000,4607
2329,1459,870,879,317300,4609
182,151,31,-,159600,4611
234,198,36,861,247500,4612
55,44,11,-,86000,4613
1214,832,382,734,234300,4614
363,315,48,1083,240200,4616
346,305,41,692,254300,4617
1378,845,533,657,91600,4619
587,441,146,542,100300,4622
389,323,66,780,119400,4623
85,74,11,-,353300,4624
44,39,5,-,247500,4625
238,188,50,652,175000,4626
735,527,208,580,202200,4627
277,217,60,375,118800,4628
37,37,0,-,-,4629
576,447,129,851,115400,4630
711,489,222,660,110800,4631
793,615,178,969,139800,4634
9,7,2,-,225000,4635
80,75,5,-,208300,4637
980,706,274,793,185800,4640
42,38,4,-,366700,4642
421,345,76,918,109700,4643
0,0,0,-,-,4644
17,13,4,-,-,4645
36,27,9,-,330000,4646
284,219,65,825,99800,4648
594,427,167,648,98700,4649
108,108,0,-,-,4650
839,688,151,464,121900,4652
269,144,125,716,314300,4653
1360,885,475,593,125400,4654
391,297,94,713,156000,4655
145,120,25,590,121200,4657
630,501,129,695,108000,4658
531,431,100,952,414800,4660
256,148,108,928,440000,4662
446,365,81,943,148400,4664
536,486,50,533,113700,4666
595,424,171,563,90000,4667
670,427,243,292,69000,4668
79,79,0,-,-,4669
250,239,11,-,178100,4671
71,68,3,-,250000,4673
182,156,26,800,267600,4674
116,89,27,-,320300,4675
435,374,61,1007,199300,4676
145,121,24,1200,166900,4677
791,517,274,762,312700,4679
567,460,107,563,139500,4680
513,345,168,719,269800,4681
47,20,27,729,-,4683
701,560,141,871,207300,4684
197,155,42,633,205000,4685
49,45,4,-,84600,4686
144,123,21,825,156900,4691
216,169,47,625,178100,4693
999,771,228,629,87200,4694
4114,2691,1423,508,98800,4730
763,618,145,453,84000,4732
116,104,12,-,93800,4733
319,251,68,693,105700,4734
249,222,27,234,80700,4735
4143,2877,1266,645,89900,4736
357,308,49,513,122000,4739
498,374,124,-,91000,4740
3,3,0,-,-,4741
1612,1032,580,580,85400,4742
1981,1481,500,556,124400,4743
393,350,43,525,97900,4745
238,192,46,379,59300,4746
573,505,68,425,90300,4747
739,452,287,675,67500,4750
1568,1167,401,537,91500,4756
1224,1072,152,542,126000,4757
554,391,163,425,103500,4758
302,224,78,491,89300,4760
224,200,24,805,131800,4761
248,224,24,714,109800,4762
278,215,63,518,80100,4763
26,26,0,-,125000,4764
578,469,109,525,89000,4765
160,128,32,733,90000,4766
175,164,11,-,117500,4768
4102,2273,1829,655,108700,4769
395,309,86,456,123600,4772
287,222,65,607,138600,4773
297,226,71,281,83200,4774
406,358,48,625,90800,4776
189,178,11,838,71400,4777
162,141,21,478,124300,4779
302,260,42,566,85500,4780
213,179,34,-,103300,4781
202,176,26,578,90800,4783
972,619,353,538,64600,4785
836,623,213,557,96600,4786
213,197,16,704,83900,4787
3567,1999,1568,733,164200,4841
2390,1733,657,772,294300,4843
605,533,72,760,235100,4847
351,303,48,850,324400,4848
1704,1455,249,906,229100,4849
36,36,0,-,218200,4851
26,25,1,-,350000,4852
233,197,36,910,251300,4853
686,590,96,988,232400,4854
110,102,8,-,333300,4855
1329,1146,183,947,262400,4856
553,495,58,675,203700,4858
353,323,30,1150,216300,4859
690,652,38,873,225800,4860
1304,868,436,763,170600,4861
1480,1279,201,982,180100,4862
518,414,104,575,240400,4863
1564,1279,285,787,165600,4864
11477,6840,4637,682,133700,4901
784,640,144,833,139000,4910
879,714,165,630,85700,4911
350,274,76,588,107500,4912
3836,2572,1264,822,176900,4915
979,933,46,-,183100,4917
185,141,44,-,188100,4918
757,666,91,408,79900,4920
689,539,150,732,123600,4921
535,437,98,625,95800,4922
227,200,27,725,86200,4923
903,712,191,771,118800,4924
43,36,7,-,156800,4925
32,32,0,-,-,4926
1377,1120,257,985,100900,4927
845,658,187,813,114500,4928
341,228,113,749,108600,4929
1857,1300,557,809,99300,4930
549,490,59,783,144000,4932
24,19,5,-,-,4933
80,66,14,-,201900,4936
2565,1764,801,802,119000,4937
3532,2548,984,628,134900,4938
482,463,19,-,99700,4939
0,0,0,-,-,4940
628,540,88,545,152300,4941
591,527,64,875,89900,4942
709,538,171,662,78500,4943
57,0,57,-,-,4944
458,349,109,653,129100,4945
650,587,63,797,172300,4947
390,331,59,635,143800,4949
2143,1496,647,712,103000,4950
438,404,34,1125,122200,4951
833,709,124,896,155400,4952
1382,966,416,739,157800,4953
566,508,58,800,134300,4955
304,260,44,918,153100,4956
1629,1349,280,791,113100,4957
823,718,105,689,108900,4958
412,393,19,505,128900,4961
70,35,35,-,107500,4962
2988,2453,535,771,161800,4963
71,51,20,-,412500,4964
826,732,94,929,92200,4965
742,615,127,556,102800,4966
1515,1087,428,840,108800,4967
521,427,94,720,130700,4969
674,543,131,483,241900,4970
779,676,103,843,99000,4971
586,496,90,758,158200,4973
1294,933,361,331,128300,4974
0,0,0,-,-,4975
4467,3051,1416,708,109400,4976
281,237,44,1034,157000,4978
381,320,61,661,117800,4979
1078,893,185,802,150900,4981
215,127,88,456,145600,4982
640,525,115,661,110300,4983
270,225,45,-,122700,4984
25,22,3,-,90000,4985
675,569,106,847,132400,4986
416,336,80,777,154000,4987
781,566,215,825,174300,4988
1660,1271,389,834,168000,4989
109,72,37,-,-,4992
4228,2777,1451,984,220000,5001
39,34,5,-,625000,5031
986,739,247,770,193900,5032
1187,899,288,867,173100,5033
143,93,50,794,455000,5034
287,206,81,1074,238600,5035
467,393,74,928,231800,5036
211,197,14,-,287900,5037
552,423,129,690,161500,5038
472,412,60,875,162800,5039
217,192,25,667,158800,5040
136,120,16,-,169000,5041
192,173,19,1525,161100,5042
424,348,76,769,266700,5043
861,688,173,958,230000,5045
441,355,86,525,141500,5046
1205,1000,205,974,211600,5048
49,25,24,-,163500,5050
717,590,127,938,177600,5051
79,25,54,-,210900,5052
184,171,13,1594,402500,5053
1255,979,276,1078,463100,5055
203,172,31,548,292900,5056
149,139,10,-,217000,5058
173,101,72,1519,390400,5059
1925,1396,529,769,187600,5060
481,444,37,753,197000,5061
281,245,36,881,280600,5062
433,316,117,1145,227400,5065
108,108,0,-,371400,5067
1417,756,661,937,199200,5068
207,182,25,-,143500,5069
232,211,21,1125,325400,5070
58,58,0,-,-,5071
223,198,25,1625,229300,5072
455,403,52,788,251300,5075
173,140,33,874,156500,5076
533,427,106,883,211700,5077
290,256,34,943,168000,5079
253,145,108,614,114400,5081
88,70,18,-,136500,5083
124,124,0,-,226000,5084
273,250,23,825,158200,5086
2072,1317,755,779,183200,5089
1532,1175,357,1094,379100,5091
1907,1004,903,781,148300,5101
89,45,44,825,160900,5141
280,231,49,817,209600,5142
1845,1408,437,856,202400,5143
308,261,47,1042,251900,5146
432,318,114,1019,218400,5148
984,680,304,828,233600,5149
548,388,160,917,127900,5150
608,578,30,1018,175000,5151
173,156,17,925,332600,5152
286,211,75,889,166100,5153
195,118,77,875,205800,5154
392,260,132,910,283800,5155
3634,2499,1135,820,147300,5156
443,334,109,792,152800,5158
239,188,51,758,373300,5161
5933,3702,2231,828,166000,5201
1550,1178,372,987,252300,5250
635,540,95,1179,372900,5251
122,103,19,-,193800,5252
254,239,15,-,249600,5253
83,72,11,-,411100,5254
1947,1379,568,886,271500,5255
998,703,295,863,194400,5257
200,166,34,-,172200,5260
1037,844,193,895,163800,5261
950,840,110,918,241600,5262
7439,4312,3127,858,223400,5301
304,267,37,935,308000,5340
206,162,44,846,193500,5341
301,278,23,990,223800,5342
348,278,70,786,240700,5343
1056,898,158,1004,225300,5345
2070,1608,462,949,208700,5346
357,287,70,659,155100,5350
363,337,26,867,206500,5352
376,287,89,903,221300,5353
840,663,177,721,230000,5354
325,278,47,916,169700,5355
415,270,145,638,287500,5356
73,66,7,-,175000,5358
223,194,29,1063,211500,5359
92,79,13,1042,364300,5360
435,364,71,788,194400,5361
23,23,0,-,234400,5362
911,669,242,1039,232700,5363
12246,3532,8714,1148,319400,5401
8605,5284,3321,1398,281100,5403
3205,1296,1909,1087,217100,5404
0,0,0,-,-,5405
3973,2824,1149,1010,233100,5408
28,0,28,-,-,5439
688,531,157,831,187900,5440
357,334,23,1163,206500,5441
164,148,16,700,147000,5442
2834,2140,694,964,230700,5443
690,576,114,1034,254200,5444
1466,1327,139,1692,496300,5445
6548,4518,2030,1192,264200,5446
31,24,7,-,150000,5447
377,360,17,875,219600,5448
1965,1460,505,762,192300,5450
8730,6061,2669,1125,283800,5452
1763,1337,426,1156,240300,5454
418,336,82,950,249000,5455
495,379,116,934,244000,5456
622,547,75,809,194900,5457
906,709,197,1083,301900,5458
736,550,186,1083,173400,5459
1836,1398,438,1071,301400,5461
765,667,98,1072,253300,5462
204,179,25,990,202400,5463
1354,918,436,989,237900,5464
2118,1918,200,1186,297600,5465
5198,4278,920,1096,245100,5468
323,234,89,1028,145200,5471
681,527,154,1087,251300,5472
563,475,88,992,287500,5473
423,372,51,1069,297200,5474
1222,855,367,915,132900,5476
1755,1362,393,1003,311700,5477
5789,3845,1944,963,205100,5478
0,0,0,-,-,5481
3215,2283,932,2048,398500,5482
593,491,102,734,215300,5483
32,32,0,-,108300,5485
731,571,160,1391,356700,5486
555,468,87,1295,220500,5487
2993,2172,821,835,212900,5488
1268,1148,120,1357,319200,5489
2479,1802,677,1006,229600,5491
301,246,55,867,164400,5492
661,611,50,1000,283800,5494
4087,3179,908,1172,316700,5495
5371,3407,1964,964,242600,5602
56,53,3,-,270800,5640
6911,4570,2341,738,169000,5641
432,385,47,779,199500,5647
174,152,22,-,284500,5648
233,203,30,-,158000,5649
474,388,86,1135,265100,5650
670,554,116,1008,233200,5651
331,291,40,1053,139500,5652
144,105,39,1140,179300,5653
414,240,174,913,117700,5654
1238,1081,157,835,187800,5655
1278,686,592,823,176900,5656
34,34,0,-,300000,5657
635,544,91,787,170400,5658
768,678,90,885,278400,5660
2427,1724,703,753,223000,5661
2318,1683,635,765,193600,5663
79,79,0,-,-,5664
842,634,208,946,207900,5667
270,237,33,1175,167900,5669
2066,1305,761,1088,392100,5672
1144,892,252,1056,347300,5673
764,627,137,728,324000,5674
489,443,46,869,174800,5675
2078,1493,585,965,255200,5676
895,735,160,806,249500,5677
56,39,17,-,-,5678
1415,1051,364,881,169300,5679
853,758,95,988,204200,5680
189,182,7,-,215600,5681
495,429,66,1125,224100,5682
8893,5306,3587,790,170500,5701
126,122,4,-,181300,5730
395,235,160,994,192800,5732
2518,1932,586,830,186200,5733
574,409,165,1006,222000,5734
1426,1059,367,915,172400,5735
297,197,100,854,173300,5736
333,273,60,983,199700,5737
470,428,42,1080,225000,5738
576,443,133,971,172900,5739
25,25,0,-,-,5740
247,210,37,910,221700,5742
1612,1184,428,864,161800,5743
256,209,47,1125,180900,5744
132,87,45,795,179200,5747
133,103,30,725,144600,5748
346,311,35,933,293000,5751
3728,2148,1580,915,273600,5753
365,303,62,950,235400,5757
341,310,31,954,206100,5758
738,603,135,792,191200,5759
492,418,74,968,212000,5760
427,362,65,721,207900,5761
184,141,43,950,202500,5762
1200,1032,168,839,180800,5763
1255,943,312,793,169400,5764
705,533,172,914,155900,5765
283,214,69,1071,228800,5766
500,394,106,702,186300,5767
460,349,111,749,248300,5769
455,381,74,1119,214900,5770
325,289,36,1054,204200,5772
920,740,180,866,192000,5773
425,391,34,731,168900,5774
216,161,55,744,148400,5775
292,248,44,736,281600,5776
1381,1168,213,908,160900,5777
273,218,55,1150,250000,5778
3785,2523,1262,752,171300,5819
276,239,37,575,166600,5820
453,416,37,1007,209200,5821
685,531,154,650,134200,5822
485,398,87,720,159300,5824
60,43,17,580,159400,5825
376,330,46,957,171700,5826
130,98,32,656,187500,5827
841,713,128,1054,211000,5828
786,603,183,797,168800,5829
719,537,182,687,140100,5830
299,253,46,874,210600,5832
111,89,22,850,152600,5833
474,380,94,836,149100,5836
156,145,11,738,105800,5837
314,278,36,-,158000,5839
199,167,32,-,288600,5841
182,147,35,863,120300,5842
991,702,289,744,140700,5843
517,449,68,657,150400,5845
493,316,177,667,139300,5846
341,229,112,957,153500,5847
77,44,33,-,-,5850
2549,1621,928,677,151800,5851
240,214,26,1075,172200,5853
2904,1989,915,740,160700,5855
863,750,113,796,177300,5857
180,171,9,-,106900,5858
725,555,170,797,159400,5859
1128,899,229,758,132000,5860
113,103,10,-,295800,5862
253,217,36,847,131800,5866
324,280,44,955,192600,5867
169,169,0,-,180800,5868
586,473,113,775,152300,5871
404,323,81,736,176900,5872
269,231,38,847,171400,5873
218,185,33,790,210200,5874
219,180,39,643,217600,5875
10,10,0,-,-,5901
96,69,27,663,111700,5902
394,301,93,635,128000,5903
96,58,38,-,65500,5904
340,293,47,933,165900,5905
538,440,98,778,121500,5906
63,58,5,-,178600,5907
7125,6026,1099,1423,373100,6001
8605,6139,2466,1250,211300,6002
24789,16130,8659,950,190500,6010
3363,3205,158,980,316200,6013
2698,1859,839,1307,238300,6016
1154,760,394,1100,190400,6018
4048,3256,792,1099,299800,6019
0,0,0,-,-,6020
130,115,15,-,277200,6021
17,17,0,-,-,6022
505,392,113,1276,257100,6023
226,181,45,1284,229500,6024
2117,1682,435,914,288000,6026
552,505,47,783,261900,6027
6808,4451,2357,1163,250500,6029
645,586,59,1012,351300,6031
7243,5139,2104,1411,336100,6032
11410,8976,2434,1209,330600,6033
3098,2814,284,892,279200,6035
7702,6610,1092,1104,282400,6037
869,579,290,1069,359700,6039
13964,7762,6202,1095,191400,6040
9764,5716,4048,1393,173400,6042
1928,1720,208,1018,288200,6043
11876,3204,8672,910,142700,6051
3195,1863,1332,1080,198100,6052
13470,6595,6875,995,156700,6053
2410,2219,191,980,304700,6057
673,546,127,748,322100,6058
0,0,0,-,-,6059
781,744,37,-,414900,6060
31,31,0,-,-,6061
7584,5238,2346,995,205400,6062
1168,1064,104,1158,255400,6063
294,285,9,-,252400,6065
13219,6925,6294,1058,207200,6066
8547,5669,2878,1337,264100,6067
659,462,197,1670,479600,6068
1116,886,230,862,387000,6069
5750,4848,902,1461,330000,6070
3401,2879,522,1160,308500,6071
2168,1918,250,1353,461200,6073
9691,8332,1359,1128,281100,6074
5036,3734,1302,953,195400,6076
3794,3216,578,1238,286100,6078
572,392,180,960,206700,6081
16612,12360,4252,1109,185000,6082
5092,4726,366,1571,286600,6084
2938,2254,684,709,321200,6085
2041,1528,513,1079,162600,6088
1299,979,320,1112,302800,6089
410,356,54,-,340500,6090
46,30,16,-,291700,6091
1451,1307,144,-,371700,6092
1133,1030,103,1384,325600,6093
10876,9222,1654,1199,216400,6095
5078,3854,1224,1139,190400,6096
5372,3393,1979,988,171900,6098
1199,149,1050,1546,135900,6103
9830,1647,8183,862,244300,6105
13730,3052,10678,946,158300,6106
7292,6333,959,1474,379100,6107
9116,4067,5049,958,158000,6108
10778,8517,2261,1069,250700,6109
4855,3327,1528,1099,222800,6110
12519,9865,2654,1172,229900,6111
7464,2637,4827,967,151700,6112
9436,2801,6635,985,167600,6114
5497,4450,1047,1270,369300,6117
10465,7047,3418,1035,160900,6118
6646,3382,3264,1267,307600,6119
4384,772,3612,815,154500,6120
0,0,0,-,-,6160
6517,2254,4263,801,139500,6226
1281,1171,110,-,322200,6231
1217,1102,115,840,277100,6232
3102,2294,808,956,223300,6234
852,774,78,1110,196400,6235
2114,1934,180,1085,243300,6237
4710,4246,464,1040,243500,6238
4601,2894,1707,892,171600,6239
2608,1997,611,1099,204700,6241
484,405,79,843,254400,6242
12,12,0,-,-,6243
1050,892,158,1094,226500,6247
2153,2046,107,1048,290800,6248
2703,2429,274,913,254900,6249
1865,1356,509,1172,227700,6250
723,627,96,792,238000,6254
1711,1136,575,988,194400,6255
881,781,100,856,177100,6256
1759,1412,347,894,266300,6259
3868,2426,1442,853,182800,6260
367,312,55,-,179900,6262
121,40,81,825,136100,6263
28,28,0,-,222200,6264
189,152,37,-,141100,6266
3561,1815,1746,1150,239300,6268
5,5,0,-,-,6269
1578,1458,120,1007,223100,6277
1812,1410,402,903,240000,6278
2366,1578,788,1104,219600,6279
1335,997,338,1123,199100,6280
2675,2349,326,1129,262300,6281
437,387,50,-,203500,6282
10996,4039,6957,950,177100,6320
1255,872,383,1145,223400,6330
1847,1657,190,1026,220000,6331
201,165,36,-,160500,6332
2578,2165,413,1363,341800,6333
1004,883,121,971,226400,6334
2473,2075,398,1140,251700,6335
22,17,5,-,-,6336
3072,2374,698,1127,227000,6339
12409,4557,7852,1181,200300,6340
45,33,12,-,178100,6350
6108,4585,1523,988,206900,6351
35,35,0,-,-,6353
2360,1600,760,922,177900,6354
5466,4344,1122,1210,308300,6355
4868,3590,1278,1215,283700,6357
2076,1758,318,1112,273100,6359
14694,7853,6841,1017,168200,6360
1855,1591,264,1157,242800,6365
2695,2375,320,1147,214500,6370
4202,3519,683,1325,410500,6371
82,82,0,-,-,6373
2868,2187,681,759,171200,6374
1525,1319,206,1026,235100,6375
106,81,25,-,539100,6376
1031,870,161,961,219000,6377
2423,1814,609,1414,417500,6378
3732,2604,1128,852,265300,6379
1083,367,716,852,172300,6380
4249,3471,778,1094,182200,6382
1060,917,143,1083,218800,6384
6407,5362,1045,1165,260100,6385
106,24,82,1070,-,6387
10,0,10,-,-,6389
77,51,26,1388,1179700,6390
6974,4162,2812,1026,208500,6401
2419,2064,355,1225,235100,6403
12188,8345,3843,1296,298600,6405
224,156,68,-,281800,6409
10199,8858,1341,1186,328900,6410
1777,1328,449,1003,358400,6412
5325,4202,1123,1201,287800,6413
33,33,0,-,228800,6414
6137,4660,1477,1212,254900,6415
5769,4518,1251,1199,245000,6416
1922,1488,434,1131,274800,6417
4926,2829,2097,1131,195000,6418
2411,2288,123,1199,369200,6419
1653,1534,119,1319,270600,6420
2664,2419,245,1131,337800,6422
2217,1922,295,1015,286200,6423
4953,4323,630,1172,260100,6424
1625,1214,411,1507,427700,6426
8582,7435,1147,1386,389900,6437
997,806,191,836,337200,6438
2035,1784,251,1346,300900,6441
1179,930,249,1122,336800,6442
6749,5879,870,1317,432900,6443
57,47,10,-,-,6444
2312,2085,227,1162,314600,6447
15321,9421,5900,1006,171400,6450
10841,6218,4623,948,176800,6451
1224,1124,100,1634,296100,6455
123,99,24,-,299400,6456
19187,10091,9096,1094,228500,6457
16013,11521,4492,1542,297600,6460
5621,5004,617,1497,316900,6461
108,108,0,-,218400,6467
6865,6192,673,1462,363400,6468
1078,844,234,1060,243300,6469
5896,4933,963,1388,417600,6470
3078,2655,423,1074,259600,6471
2436,2207,229,1404,298200,6472
8673,7254,1419,1263,298700,6473
4255,3363,892,1529,373200,6475
4959,4349,610,1580,385100,6477
4463,4037,426,1169,354500,6478
3951,3337,614,1036,263300,6479
3930,3347,583,1088,244800,6480
487,352,135,847,303400,6481
3853,3452,401,1562,386300,6482
6146,4311,1835,1072,243400,6483
15961,12867,3094,1301,341500,6484
7756,6714,1042,1494,325000,6488
12718,10386,2332,1046,276500,6489
18458,13709,4749,1081,266300,6492
2882,2223,659,1217,379900,6498
1558,93,1465,1404,281300,6510
21140,4678,16462,1172,209800,6511
11634,7367,4267,1199,200200,6512
14915,5587,9328,1042,173300,6513
10007,6266,3741,1252,195100,6514
6732,2559,4173,1128,218400,6515
19387,10906,8481,1121,193300,6516
6170,4185,1985,1115,249600,6517
6667,4406,2261,1590,251600,6518
5213,1313,3900,1101,161900,6519
2007,1849,158,1141,359100,6524
2876,2571,305,1216,478600,6525
10064,2843,7221,1098,184800,6604
8673,2600,6073,1188,230600,6605
15947,9745,6202,1236,172800,6606
2760,899,1861,1145,136300,6607
4392,972,3420,1109,162000,6608
8505,4079,4426,1045,146800,6610
12383,10860,1523,1782,394600,6611
2762,2610,152,1845,629200,6612
12906,11230,1676,1375,263200,6614
7273,4850,2423,1143,217700,6615
1575,31,1544,474,127900,6702
9034,3709,5325,910,124100,6704
9860,3766,6094,967,120800,6705
5080,2400,2680,894,121200,6706
10718,6215,4503,995,138000,6708
3534,1103,2431,886,138400,6710
3311,2924,387,1119,307400,6712
5758,4941,817,1119,251900,6716
541,318,223,820,239400,6750
1282,1091,191,1016,351100,6751
736,657,79,1321,495000,6752
696,581,115,1775,398900,6754
331,284,47,-,289600,6755
1033,972,61,-,355100,6756
865,564,301,950,345000,6757
148,134,14,-,332400,6758
2430,1971,459,1079,355000,6759
2693,2412,281,1324,355700,6762
752,633,119,771,340100,6763
11804,7837,3967,1004,179800,6770
9912,7673,2239,1161,289800,6776
638,564,74,1441,388100,6777
645,614,31,-,251100,6778
3334,2465,869,996,190900,6779
823,755,68,1112,219900,6782
920,745,175,1346,595900,6783
1437,1329,108,2576,446500,6784
249,217,32,-,429300,6785
4019,3149,870,1022,189700,6786
3139,2493,646,936,202000,6787
14899,9967,4932,896,160200,6790
1990,1945,45,719,287900,6791
529,389,140,1208,763000,6793
414,320,94,1303,450000,6794
5082,4351,731,893,278100,6795
504,444,60,962,433700,6796
4045,3045,1000,1172,350800,6798
7122,5607,1515,1310,333900,6801
6133,5048,1085,1521,369400,6804
2560,1779,781,1849,1032700,6807
18457,8618,9839,1404,263000,6810
11215,9055,2160,1404,316300,6811
4869,4580,289,2180,356600,6812
6703,5719,984,2790,1398600,6820
11507,9675,1832,2145,669200,6824
7186,5753,1433,1525,463900,6825
9699,5060,4639,1784,1465100,6830
5021,3827,1194,2252,1157700,6831
7042,5447,1595,2001,1439600,6840
7287,4509,2778,1642,399300,6850
10521,7280,3241,1630,431000,6851
1445,1151,294,2516,957500,6853
10780,5200,5580,1459,377400,6854
3242,1665,1577,1607,426800,6855
0,0,0,-,-,6856
2506,2115,391,2328,1385400,6870
9104,7656,1448,1594,671700,6877
2562,2157,405,1898,1369500,6878
9962,8310,1652,1847,1141200,6880
3448,3294,154,2560,878600,6883
1633,1400,233,2205,833300,6890
3460,2847,613,1621,597400,6896
5985,5142,843,2415,816000,6897
3892,641,3251,1458,299200,6901
25598,10916,14682,1704,404200,6902
4935,4651,284,2898,783800,6903
7551,5723,1828,1941,555800,6905
3388,2089,1299,1668,441800,6906
3219,2322,897,1655,463800,6907
5020,2422,2598,1323,269700,7001
25213,9605,15608,1187,314800,7002
17657,9387,8270,1300,316800,7003
2517,2311,206,1907,472000,7004
5550,4311,1239,1338,442900,7005
9579,7255,2324,1430,528000,7006
7958,4616,3342,1443,267500,7008
4480,3539,941,1402,451500,7009
10577,5070,5507,1332,432200,7010
12635,6075,6560,1362,295900,7011
4542,2623,1919,1374,339500,7012
9912,7181,2731,1284,350600,7013
1843,1376,467,1412,335700,7014
8501,6658,1843,1566,463800,7016
13543,3945,9598,999,208700,7017
10682,2439,8243,1094,198300,7018
5411,1839,3572,2268,560000,7020
728,688,40,3018,832900,7021
5515,1779,3736,1263,351400,7022
2531,2224,307,2708,433100,7023
16658,9739,6919,1665,332600,7024
11265,4067,7198,1281,329100,7026
1789,1105,684,1433,365600,7027
2490,2294,196,1485,622500,7028
6391,1749,4642,1332,307500,7029
24812,8092,16720,2100,652200,7030
6088,3147,2941,1288,347800,7031
13461,6369,7092,1213,318700,7032
2800,2186,614,1421,347500,7033
3436,2247,1189,1209,327000,7034
3696,2864,832,1597,337700,7035
15022,8542,6480,1194,263900,7036
9931,8876,1055,2626,599100,7039
8149,6315,1834,1485,487000,7040
2561,1649,912,1656,721600,7041
10125,4924,5201,1491,501500,7042
4133,3323,810,1738,715900,7043
5222,4215,1007,1432,428600,7044
3816,3567,249,2277,568200,7045
1404,1282,122,1469,810300,7046
21932,8458,13474,1300,308000,7047
11733,2654,9079,1064,222300,7050
16184,10837,5347,1450,370200,7052
11082,5802,5280,1260,445800,7054
19544,4593,14951,1145,309100,7055
4545,2002,2543,1189,351900,7057
1864,887,977,1590,596700,7058
5097,4702,395,1538,749300,7059
14235,5742,8493,1184,269300,7060
3921,2388,1533,1252,229800,7062
3701,2477,1224,1342,239000,7063
1334,1070,264,1377,283700,7064
10844,6349,4495,1402,263000,7065
5718,4584,1134,1377,418100,7066
5989,5255,734,1380,351300,7067
2415,2001,414,2243,492700,7068
1968,1577,391,1728,722800,7069
7095,4348,2747,1383,446500,7070
8542,4890,3652,1275,368100,7071
2328,1564,764,1249,380700,7072
3850,1523,2327,1421,380600,7073
936,753,183,1293,336600,7074
3048,2180,868,1686,384700,7075
8576,6864,1712,1481,481500,7076
926,675,251,1247,281800,7077
4067,3720,347,1852,1315700,7078
5151,3504,1647,1578,553100,7079
7865,6294,1571,1691,325800,7080
7012,4550,2462,1574,426800,7081
1673,1609,64,2260,547100,7082
19235,14164,5071,1449,319700,7083
6267,1992,4275,1386,557200,7086
23559,4719,18840,1178,296800,7087
1232,788,444,1429,216000,7088
10591,8727,1864,1594,725100,7090
2428,2214,214,1853,619500,7092
23607,5479,18128,1235,304800,7093
7105,4105,3000,1593,426000,7094
7221,3999,3222,1570,273800,7095
4762,424,4338,783,225000,7102
10871,2572,8299,945,173400,7103
18365,4125,14240,1016,239900,7104
16692,3623,13069,1118,294000,7105
11192,3598,7594,1007,193200,7106
12576,2771,9805,996,231000,7107
7993,1418,6575,885,183600,7108
12824,6547,6277,1236,277700,7109
10672,7018,3654,1323,372100,7110
20108,5763,14345,974,181900,7111
9359,2711,6648,1044,229200,7112
3664,470,3194,864,200000,7114
8332,2125,6207,1101,251600,7201
13131,3033,10098,1126,269300,7202
7806,4218,3588,1083,206700,7203
4947,2929,2018,1183,277900,7204
7257,4748,2509,1263,239700,7205
7728,1823,5905,1156,249500,7206
11014,2956,8058,1067,290800,7208
20267,5903,14364,2077,605700,7302
15454,4108,11346,1078,283800,7304
22265,8706,13559,1148,291500,7305
20212,4377,15835,1134,322900,7306
15789,4590,11199,1240,335800,7307
5796,864,4932,2734,696300,7310
222,0,222,2978,-,7311
2279,1924,355,1905,682100,7401
2834,1921,913,1458,299000,7403
6211,4938,1273,1362,440100,7405
6685,3715,2970,1570,348200,7407
11611,9424,2187,1602,406400,7410
2151,1533,618,1137,198000,7416
3853,3367,486,2385,975000,7417
747,683,64,1820,278300,7418
3712,2868,844,1400,222700,7419
1579,1375,204,1376,256400,7420
2651,2260,391,1739,252800,7421
2463,2280,183,1872,214800,7422
1449,1335,114,2338,727900,7423
9611,6224,3387,1374,369400,7424
9345,7407,1938,1833,489900,7430
2690,1838,852,1635,488500,7432
994,859,135,1048,393300,7435
4319,3917,402,1702,446800,7436
4295,3993,302,1228,336100,7438
858,715,143,1313,223000,7439
1511,1280,231,736,386100,7440
4005,3059,946,1450,303300,7442
4788,3792,996,2037,393100,7444
5539,4890,649,1382,554400,7446
8359,6420,1939,1969,738900,7450
3901,3630,271,1840,621800,7452
3867,3710,157,2024,342000,7456
1887,1365,522,1942,331200,7457
3714,3274,440,2243,1043400,7458
1212,1155,57,2121,252000,7460
6806,5723,1083,1124,281800,7461
2573,1830,743,1289,223800,7462
3596,3125,471,1905,434000,7463
2653,2244,409,1536,335800,7465
18278,14538,3740,1551,454500,7470
5913,5273,640,1463,288400,7480
5827,5343,484,1663,724100,7481
0,0,0,-,-,7495
10250,1696,8554,1073,242400,7501
4413,2112,2301,1307,225200,7502
5193,1643,3550,1170,246300,7503
3144,1259,1885,1228,270300,7504
1052,56,996,999,-,7505
6933,4156,2777,1448,377700,7506
7407,4810,2597,1372,344200,7508
3371,2761,610,1540,370200,7512
3440,967,2473,1262,256800,7513
6470,1789,4681,1150,217300,7514
5813,1316,4497,1138,214500,7522
4011,919,3092,1123,223400,7524
18817,6505,12312,1335,292600,7601
2891,1977,914,1302,316100,7603
4406,2773,1633,1415,406800,7604
3281,1936,1345,1388,481200,7605
848,400,448,1440,365100,7606
3578,2189,1389,1463,373200,7607
47,2,45,1453,-,7608
563,451,112,1211,"2,000,000+",7620
8688,5840,2848,1316,344500,7621
2673,2236,437,1983,625700,7624
2987,2507,480,2151,595200,7626
1661,1506,155,3147,673200,7627
6282,4625,1657,1201,364500,7628
2462,2069,393,1854,465600,7630
10606,5389,5217,1431,372700,7631
1871,1655,216,3179,987400,7632
1629,1449,180,1738,595900,7640
1127,1084,43,3450,645500,7641
3570,3120,450,1503,522700,7642
4414,1874,2540,1273,323300,7643
9005,3669,5336,1227,369800,7644
2823,2417,406,1791,609700,7645
5929,3589,2340,1360,397000,7646
1835,1524,311,1473,463400,7647
2111,1709,402,1719,639100,7648
2696,2364,332,1384,580200,7649
7559,2636,4923,1420,522400,7650
8349,7294,1055,1865,574600,7652
3336,2603,733,1418,546000,7656
3724,1780,1944,1593,447300,7657
4703,2521,2182,1308,326700,7660
4004,2976,1028,1478,486900,7661
1906,1298,608,1618,371300,7662
5281,3608,1673,1442,366500,7663
13316,9774,3542,1403,389000,7666
4683,3668,1015,1717,785200,7670
9849,7667,2182,1688,566600,7675
3231,2990,241,2283,491600,7676
2053,1882,171,1878,769500,7677
9648,6354,3294,1400,386200,7701
1450,1331,119,2378,530100,7702
0,0,0,-,-,7703
1889,1689,200,2132,686100,7704
593,488,105,1243,740100,7711
16078,7188,8890,1145,385500,7712
3575,2660,915,1168,425400,7716
911,571,340,1505,864800,7717
2397,2003,394,1708,340100,7718
8385,6008,2377,1386,431700,7719
2169,954,1215,1306,479100,7720
1119,767,352,1206,271100,7721
3306,2976,330,1855,758400,7722
306,210,96,1337,1041700,7723
8722,5657,3065,1204,353000,7724
15363,13277,2086,1636,449800,7726
2713,1926,787,1053,424700,7727
19641,14710,4931,1628,354700,7728
5844,5151,693,922,320400,7730
12574,11233,1341,1415,321000,7731
2712,1713,999,1142,276200,7732
5772,4999,773,2083,637400,7733
5178,3142,2036,1075,211800,7734
6936,4932,2004,1194,253200,7735
1413,1222,191,1285,335600,7737
2106,1812,294,392,492800,7738
2103,1955,148,2254,605100,7739
12045,5274,6771,1239,339000,7740
5935,5755,180,2493,536300,7746
11479,8790,2689,1485,349000,7747
9418,7798,1620,1330,426000,7748
1411,1207,204,2372,710300,7750
6075,5580,495,2213,500400,7751
15710,9966,5744,1410,279400,7753
2180,1924,256,1233,374200,7755
1786,896,890,1100,482400,7756
2132,1776,356,1375,441600,7757
1447,1270,177,1940,306400,7758
3166,2694,472,1977,872400,7760
3868,2501,1367,1433,608600,7762
2454,1826,628,1493,412300,7764
7887,4033,3854,1362,281700,7801
1213,1039,174,1045,284400,7803
38,38,0,-,-,7820
3529,3198,331,1310,296300,7821
263,239,24,-,317000,7822
3212,2285,927,905,237900,7823
3336,2970,366,1336,318000,7825
2228,1792,436,1493,293200,7826
1665,1243,422,963,201300,7827
5838,2897,2941,1105,312700,7828
2412,2263,149,997,429300,7830
1486,1235,251,1269,285900,7832
41,11,30,-,-,7833
6918,5960,958,1771,390100,7834
4230,2843,1387,1413,391900,7836
1247,973,274,1384,323800,7838
11522,7529,3993,1125,288900,7840
45,45,0,-,-,7842
4628,3866,762,1394,227400,7843
13,13,0,-,240600,7846
571,491,80,1257,281500,7847
1635,1345,290,1199,324400,7848
3476,3025,451,1431,311300,7849
2174,1799,375,1157,269200,7850
17,17,0,-,322700,7851
1511,1191,320,1552,336000,7852
4245,4043,202,1929,474300,7853
2082,1521,561,1722,300100,7856
1410,695,715,1165,264200,7857
9646,7281,2365,1141,264900,7860
1665,1385,280,845,262100,7863
690,636,54,-,288500,7865
8335,6926,1409,1327,343800,7866
8923,6781,2142,1373,507900,7869
15,6,9,-,-,7870
7041,6349,692,1191,374500,7871
3038,2807,231,1486,257500,7874
3478,3307,171,1414,379300,7876
272,215,57,-,347500,7878
77,77,0,-,-,7880
6,6,0,-,-,7881
5655,4171,1484,1117,245700,7882
3821,2430,1391,1359,289400,7885
8301,5772,2529,1678,828000,7901
9640,7934,1706,2047,658200,7920
3951,3043,908,1974,375400,7921
4072,3844,228,2031,600000,7922
2724,2308,416,1721,699800,7924
7,0,7,-,-,7926
1531,1116,415,2127,477700,7927
6410,5355,1055,1788,800700,7928
2965,2794,171,1278,645400,7930
1084,886,198,2142,1015000,7931
4093,2795,1298,2300,620700,7932
1244,1103,141,1567,494400,7933
574,477,97,1926,688300,7934
126,94,32,2119,350000,7935
3811,3516,295,1986,557500,7936
0,0,0,-,-,7939
5369,3845,1524,1643,697800,7940
3090,2824,266,1882,742900,7945
1143,1054,89,3113,587000,7946
6952,5678,1274,2007,467600,7950
17641,11185,6456,1659,568000,7960
0,0,0,-,-,7961
51,51,0,-,360700,7970
4151,3499,652,1666,581600,7974
228,228,0,-,1750000,7976
193,118,75,1208,495100,7977
224,215,9,-,552600,7979
863,652,211,1335,529100,7980
3443,2991,452,1838,478200,7981
330,282,48,-,172900,8001
8559,5618,2941,1305,232300,8002
10907,9498,1409,1658,311200,8003
4018,3503,515,1406,191100,8004
9033,7774,1259,1513,252500,8005
201,172,29,1298,684400,8006
2041,1335,706,830,191300,8007
3455,3092,363,1161,776500,8008
4782,4007,775,1170,218900,8009
4427,2632,1795,1170,168300,8010
12,12,0,-,-,8011
14792,9891,4901,1122,201500,8012
206,156,50,-,174200,8014
6912,5343,1569,1141,166400,8015
12090,8756,3334,1010,234700,8016
351,313,38,2333,260300,8019
892,810,82,1071,268000,8020
17658,9392,8266,996,144400,8021
3699,3614,85,1792,304400,8022
171,58,113,1325,101100,8023
771,719,52,1841,199000,8026
1906,1550,356,1154,180900,8027
6751,4497,2254,1070,190800,8028
1850,1312,538,738,172000,8029
4789,3297,1492,1098,122000,8030
4357,2633,1724,830,165400,8031
6192,4658,1534,1092,436600,8033
6922,5570,1352,1346,240900,8034
2994,2383,611,879,278400,8035
2242,2114,128,-,280700,8036
8590,6532,2058,1190,233300,8037
29,27,2,-,167500,8038
28,28,0,-,226500,8039
300,262,38,-,373200,8041
61,47,14,-,236800,8042
10932,7443,3489,1227,308800,8043
1129,792,337,812,162300,8045
10245,8419,1826,1599,161300,8046
4629,3262,1367,1199,303800,8048
2125,1488,637,944,163400,8049
9535,8103,1432,1562,268500,8050
4249,3381,868,1291,178000,8051
8220,3926,4294,1153,179300,8052
17357,13229,4128,1421,282900,8053
17257,13700,3557,1482,257000,8054
9994,8707,1287,1370,343000,8055
1517,1465,52,950,368800,8056
7295,6183,1112,1179,489700,8057
2123,1674,449,980,164000,8059
8693,6511,2182,1167,229700,8060
891,785,106,2299,279200,8061
5392,4798,594,1219,342900,8062
1093,904,189,1025,151900,8063
0,0,0,-,-,8064
2987,2092,895,1288,173300,8065
3595,2087,1508,898,118700,8066
603,522,81,1213,219900,8067
2732,1700,1032,975,192200,8068
4649,2535,2114,1006,151800,8069
5005,3721,1284,898,154000,8070
3528,2706,822,1145,186200,8071
126,126,0,-,209700,8072
73,73,0,-,269600,8073
0,0,0,-,-,8074
10536,7765,2771,1196,224400,8075
6661,5863,798,1468,269000,8077
3173,2148,1025,895,168000,8078
4049,2356,1693,918,178700,8079
12930,11499,1431,1375,257700,8080
16813,13602,3211,1182,200100,8081
3675,2731,944,959,184500,8083
2568,1977,591,945,181600,8084
6711,5697,1014,1560,282200,8085
3189,2396,793,1289,226400,8086
10268,8514,1754,1305,223500,8087
9327,8694,633,1244,254500,8088
1601,1264,337,1077,192500,8089
2867,2556,311,1162,186600,8090
2058,1367,691,898,177900,8091
1324,1116,208,1641,302400,8092
3703,2207,1496,941,159100,8093
14815,12462,2353,1049,191200,8094
41,41,0,-,-,8095
13696,9688,4008,1162,189800,8096
1141,992,149,1131,202800,8097
3301,2443,858,1014,252700,8098
2497,506,1991,708,86000,8102
4772,2037,2735,938,80300,8103
8933,3078,5855,858,70600,8104
8526,3944,4582,949,91200,8105
3987,2612,1375,894,206400,8106
5300,2875,2425,1007,184400,8107
7411,4921,2490,1258,265900,8108
8344,6112,2232,1013,174900,8109
5689,4453,1236,1032,136400,8110
3971,2676,1295,1318,195400,8201
800,730,70,1219,1002200,8202
4355,3191,1164,1264,348900,8203
7642,6072,1570,1033,293500,8204
10199,7869,2330,1180,203400,8205
6191,5176,1015,1343,264800,8210
113,105,8,1438,709200,8212
5020,3609,1411,1118,201200,8215
0,0,0,-,-,8217
2569,2165,404,1544,285300,8221
1682,1517,165,1362,275100,8223
192,155,37,917,246100,8224
2903,2594,309,1645,224300,8225
5234,3582,1652,1135,567700,8226
2040,1767,273,1111,307800,8230
6299,3664,2635,1114,149600,8232
13985,12250,1735,980,219000,8234
0,0,0,-,-,8240
379,360,19,1417,288600,8241
1281,984,297,1053,246800,8242
1009,895,114,1211,661700,8243
4470,2444,2026,1016,218200,8244
51,51,0,-,-,8246
485,439,46,1329,1184100,8247
103,103,0,-,-,8248
4273,3278,995,1267,177300,8251
6250,4152,2098,905,332400,8260
2952,2250,702,1067,257100,8270
13756,8103,5653,1056,161300,8302
573,475,98,-,165600,8310
648,473,175,1295,163400,8311
2901,2168,733,1118,189600,8312
108,95,13,-,146300,8314
79,66,13,-,142900,8316
456,407,49,-,219900,8317
4534,4031,503,998,218900,8318
415,408,7,-,222700,8319
0,0,0,-,-,8320
130,80,50,955,163100,8321
3633,3320,313,1160,208200,8322
316,268,48,1385,194600,8323
76,57,19,-,228800,8324
541,432,109,1214,176100,8326
84,84,0,-,159800,8327
443,412,31,1317,168300,8328
55,31,24,-,193500,8329
10407,7761,2646,1404,195300,8330
13529,8697,4832,986,152700,8332
341,294,47,-,274400,8340
988,394,594,789,173200,8341
1659,1522,137,1442,270200,8343
1894,1576,318,1176,173300,8344
315,255,60,909,145100,8345
193,167,26,-,121900,8346
67,46,21,-,145800,8348
851,704,147,1044,153500,8349
378,319,59,-,228300,8350
224,188,36,-,124000,8352
175,127,48,817,158500,8353
14856,8544,6312,983,156300,8360
6508,5421,1087,939,198100,8361
15404,4057,11347,858,168800,8401
3277,2626,651,1166,482100,8402
528,454,74,1861,770800,8403
4403,2714,1689,1129,290100,8406
2292,2108,184,1145,391100,8501
3635,2830,805,2065,647800,8502
6900,5133,1767,1190,266700,8505
1775,1720,55,-,554300,8510
319,259,60,874,233000,8511
3934,2315,1619,1220,470400,8512
1883,1598,285,1173,366300,8514
1796,1646,150,1519,431800,8515
2274,1650,624,1018,204200,8518
9534,6611,2923,1323,291600,8520
1884,1534,350,1590,440000,8525
20114,17052,3062,1350,340400,8527
66,56,10,-,266100,8528
3140,2192,948,1244,396600,8530
2186,1853,333,1253,331700,8533
4885,4414,471,1390,469400,8534
1560,1507,53,1307,602600,8535
7955,3450,4505,1458,462500,8536
17643,11901,5742,1649,623800,8540
1697,469,1228,1567,575000,8542
6557,5598,959,1978,624000,8550
1800,1680,120,1509,459600,8551
230,186,44,1938,484400,8553
1426,1204,222,1286,170300,8554
278,244,34,-,281700,8555
2579,2225,354,1587,686100,8558
2053,1770,283,1350,453800,8559
1407,1286,121,1787,377400,8560
65,65,0,-,-,8561
1714,1029,685,910,252000,8562
493,11,482,814,-,8608
4260,960,3300,1048,84600,8609
11149,7445,3704,1099,190600,8610
7971,2625,5346,1043,90200,8611
12907,5864,7043,941,169600,8618
8492,5918,2574,1219,249900,8619
4174,3361,813,1012,266200,8620
3929,2558,1371,1265,261800,8628
3969,2743,1226,1209,118000,8629
7998,4774,3224,1088,184400,8638
891,5,886,2034,-,8640
1238,3,1235,1936,-,8641
11801,7939,3862,1542,287500,8648
6856,5990,866,1382,287800,8690
5867,4996,871,1698,390800,8691
23776,11514,12262,1397,313300,8701
248,233,15,-,495500,8720
7601,6301,1300,1433,273400,8721
3715,3113,602,1581,233300,8722
12885,10126,2759,1282,275400,8723
16539,14279,2260,1380,279200,8724
1786,1601,185,2150,633700,8730
7722,6880,842,1468,263700,8731
622,489,133,1571,401500,8732
876,591,285,1776,186800,8733
3117,2807,310,-,319700,8734
1812,1644,168,1091,620100,8735
4731,3909,822,1364,585600,8736
536,510,26,1406,1066200,8738
764,544,220,1661,250800,8740
957,880,77,989,306200,8741
9882,7771,2111,1484,401400,8742
1407,1277,130,1194,869800,8750
1770,864,906,1246,447000,8751
1191,957,234,1252,602300,8752
23297,18342,4955,1422,283100,8753
10176,8564,1612,1251,277100,8755
16678,14719,1959,1360,156400,8757
3444,2986,458,1593,313800,8758
19028,16520,2508,1059,114800,8759
2528,2105,423,1686,393100,8801
1503,1374,129,1213,374000,8802
983,920,63,994,293100,8804
4179,2357,1822,1273,283200,8805
13241,10903,2338,1659,468900,8807
43,22,21,-,-,8808
2007,1515,492,1481,336500,8809
2865,2356,509,1806,397500,8810
4611,3716,895,1334,343700,8812
16176,12948,3228,1426,383100,8816
15726,8616,7110,1513,306600,8817
13041,9574,3467,1465,476900,8820
105,94,11,-,350000,8821
11561,9123,2438,1433,408500,8822
3574,2412,1162,1850,283600,8823
4198,3785,413,1211,415100,8824
1655,1277,378,1182,372300,8825
2132,1722,410,1254,335300,8826
1675,1433,242,1038,367300,8827
869,678,191,1722,262000,8828
1476,1211,265,1436,251200,8829
6476,4711,1765,1641,294300,8830
20704,18268,2436,1290,337900,8831
1025,211,814,1288,279800,8832
3135,2791,344,1920,493800,8833
3721,2424,1297,1336,251900,8835
1327,1278,49,1384,594800,8836
6367,3386,2981,1247,318400,8837
5991,4794,1197,1510,382300,8840
13532,11601,1931,1574,411600,8844
4565,3295,1270,1385,293700,8846
3056,2749,307,1178,337300,8848
3033,2574,459,1602,344600,8850
6393,4153,2240,1591,381200,8852
1806,1424,382,1203,557800,8853
16126,10762,5364,1474,310300,8854
14910,10131,4779,1181,346300,8857
63,63,0,-,-,8858
8133,5308,2825,1205,296600,8859
16566,5251,11315,1243,247400,8861
4482,3225,1257,1310,291500,8863
11479,7157,4322,948,188500,8865
1789,1629,160,1467,494800,8867
2899,1743,1156,1645,331200,8869
7369,4398,2971,1213,286900,8872
19422,13666,5756,1525,328300,8873
8026,5701,2325,1353,361500,8876
9083,5214,3869,1216,277500,8879
1421,919,502,1366,246500,8880
5726,3671,2055,1245,288700,8882
3437,2743,694,934,294300,8884
2453,1960,493,1472,323600,8886
542,430,112,1482,187600,8887
3743,3432,311,1458,449700,8889
0,0,0,-,-,8890
14823,2777,12046,1395,257100,8901
14337,8359,5978,1542,319600,8902
5634,2388,3246,1376,360000,8904
12347,3479,8868,1912,355600,10001
33461,4510,28951,936,641400,10002
26699,8720,17979,2201,986100,10003
1587,474,1113,3049,1597500,10004
4239,778,3461,3141,1494400,10005
1815,238,1577,3011,1000000,10006
2761,1087,1674,3254,"2,000,000+",10007
29725,2111,27614,1549,609700,10009
15972,4602,11370,2513,753000,10010
28753,10506,18247,2125,978700,10011
12349,2201,10148,2203,1355800,10012
12207,3340,8867,1615,"2,000,000+",10013
18481,5941,12540,2381,1072700,10014
28681,8023,20658,2506,747600,10016
10076,4419,5657,2242,625000,10017
4993,407,4586,3008,976400,10018
24512,4673,19839,2251,967800,10019
0,0,0,-,-,10020
24912,11003,13909,2108,1222500,10021
17873,9114,8759,2463,911600,10022
33133,13964,19169,2305,1034000,10023
28418,11099,17319,2027,1438900,10024
42546,11870,30676,1442,1026300,10025
15401,2845,12556,1089,765400,10026
23607,3353,20254,1100,692100,10027
26435,8957,17478,2284,1175100,10028
31496,1964,29532,895,809300,10029
12258,1374,10884,944,593500,10030
22274,2662,19612,1240,379400,10031
20724,1574,19150,1159,444000,10032
19586,2040,17546,1341,504200,10033
16135,1423,14712,1270,334100,10034
14172,1226,12946,816,495000,10035
15624,1566,14058,2136,880200,10036
9735,652,9083,1098,459000,10037
10133,2689,7444,2055,735800,10038
11153,1434,9719,902,382100,10039
16222,1610,14612,1291,379400,10040
4820,942,3878,2310,652600,10044
15878,5674,10204,2385,1326700,10065
2574,695,1879,3050,1885100,10069
11373,4854,6519,2085,920600,10075
0,0,0,-,-,10103
0,0,0,-,-,10110
0,0,0,-,-,10111
0,0,0,-,-,10112
0,0,0,-,-,10115
0,0,0,-,-,10119
31644,10417,21227,2143,990200,10128
0,0,0,-,-,10152
0,0,0,-,-,10153
0,0,0,-,-,10154
655,0,655,3067,-,10162
0,0,0,-,-,10165
0,0,0,-,-,10167
0,0,0,-,-,10168
0,0,0,-,-,10169
0,0,0,-,-,10170
0,0,0,-,-,10171
0,0,0,-,-,10172
0,0,0,-,-,10173
0,0,0,-,-,10174
0,0,0,-,-,10177
0,0,0,-,-,10199
0,0,0,-,-,10271
0,0,0,-,-,10278
0,0,0,-,-,10279
4747,1378,3369,3190,840500,10280
2412,221,2191,2962,"2,000,000+",10282
14520,6509,8011,1232,435200,10301
6266,3512,2754,1251,364500,10302
8269,4916,3353,1027,321700,10303
14521,7864,6657,1077,451000,10304
14694,9729,4965,1258,421600,10305
19861,13967,5894,1306,466700,10306
5156,3897,1259,1173,646200,10307
10653,8827,1826,1410,469100,10308
11455,9807,1648,1341,571400,10309
8218,5070,3148,1130,426000,10310
0,0,0,-,-,10311
21230,18223,3007,1244,491100,10312
31307,23107,8200,1343,461300,10314
18783,2505,16278,992,156900,10451
25949,783,25166,1108,221800,10452
27338,1081,26257,1089,440400,10453
13085,727,12358,731,398100,10454
14202,1026,13176,910,290700,10455
30096,1842,28254,1002,363100,10456
24245,1492,22753,1107,406300,10457
27228,1115,26113,1175,369900,10458
16066,1645,14421,1004,381300,10459
20359,2162,18197,1020,414100,10460
19013,6303,12710,1326,443000,10461
29679,6808,22871,1279,259000,10462
28537,9140,19397,1279,273900,10463
1936,1193,743,1249,495000,10464
15685,8881,6804,1306,448700,10465
23312,9208,14104,1211,409000,10466
36335,4851,31484,1201,336200,10467
25557,2058,23499,1210,194600,10468
22038,11190,10848,1314,428200,10469
5925,2254,3671,1347,416200,10470
8726,4371,4355,1551,337300,10471
21813,3196,18617,1142,429600,10472
20890,6068,14822,931,376900,10473
3514,238,3276,1123,406500,10474
18792,7865,10927,1001,27200,10475
403,395,8,-,668200,10501
1948,1633,315,1370,628400,10502
95,95,0,-,525900,10503
2653,2463,190,"3,500+",1011400,10504
297,174,123,1273,721300,10505
1997,1878,119,2783,1030900,10506
2097,960,1137,1448,590300,10507
6937,5247,1690,1312,351400,10509
3578,2943,635,1473,692600,10510
759,584,175,1472,390800,10511
9071,7323,1748,1319,312100,10512
4046,3850,196,2290,957600,10514
2160,1593,567,1449,487800,10516
139,116,23,-,411100,10517
425,406,19,-,784200,10518
97,97,0,-,-,10519
5260,3232,2028,1362,503000,10520
3679,2231,1448,1875,617700,10522
2909,1516,1393,2117,429300,10523
1447,1315,132,1735,459300,10524
650,532,118,1491,496300,10526
251,251,0,-,636900,10527
4728,2739,1989,2139,715600,10528
5781,4608,1173,1803,379400,10530
1672,1414,258,1587,505800,10532
2549,2101,448,1521,699400,10533
216,92,124,1199,268800,10535
3519,3152,367,2177,714700,10536
629,559,70,1125,258000,10537
5898,4665,1233,1798,984100,10538
8901,7534,1367,1320,377400,10541
7563,4318,3245,1818,611800,10543
0,0,0,-,-,10545
480,428,52,3242,675600,10546
2513,1901,612,1773,339500,10547
1289,888,401,1344,367400,10548
5829,3916,1913,1516,529500,10549
13243,3221,10022,1226,346200,10550
8390,4743,3647,1419,368200,10552
3362,1899,1463,1394,361100,10553
1713,1416,297,1689,588600,10560
10475,6119,4356,1482,407300,10562
9381,4537,4844,1352,285100,10566
6896,6120,776,1816,385800,10567
4089,3415,674,1536,650100,10570
12360,6416,5944,1497,524200,10573
1974,1723,251,3042,906400,10576
790,696,94,"3,500+",1116200,10577
276,213,63,1786,479200,10578
3114,2880,234,1811,403300,10579
5954,4633,1321,2155,1165300,10580
13677,11857,1820,1964,888200,10583
1078,833,245,1623,350200,10588
3814,3450,364,2349,459400,10589
2594,2415,179,1867,574900,10590
8906,4521,4385,1498,585500,10591
1572,1305,267,1878,614500,10594
2289,1646,643,1585,606200,10595
486,281,205,1458,296300,10596
353,353,0,-,931200,10597
10533,9206,1327,1370,431500,10598
5363,1756,3607,1718,346000,10601
6881,4315,2566,1614,405300,10603
3808,2093,1715,1820,650800,10604
6826,5205,1621,1624,618500,10605
5529,2341,3188,1719,544900,10606
2242,1826,416,1434,507500,10607
22181,6913,15268,1261,339600,10701
7263,3886,3377,1232,343800,10703
12451,6987,5464,1441,396800,10704
13941,4279,9662,1198,382400,10705
3301,2538,763,1855,627500,10706
4005,2474,1531,1742,556800,10707
9075,7023,2052,1621,410300,10708
3666,2864,802,1661,637300,10709
10300,6922,3378,1370,433600,10710
14420,5622,8798,1397,464800,10801
4020,3098,922,1812,751600,10803
4975,4785,190,2517,715500,10804
7773,2840,4933,1475,349700,10805
8672,6439,2233,1278,397500,10901
25,0,25,-,-,10910
0,0,0,-,-,10911
1605,1578,27,1363,498600,10913
131,131,0,-,366300,10914
30,30,0,-,-,10915
1257,1172,85,1631,334900,10916
583,457,126,1586,298700,10917
3930,3243,687,1439,298000,10918
455,438,17,-,244600,10919
2967,2429,538,1483,430600,10920
1356,1059,297,1343,272000,10921
592,429,163,1554,264500,10922
2645,1649,996,1442,332300,10923
4412,3065,1347,1225,308200,10924
1676,1249,427,1171,271600,10925
1267,655,612,1463,214200,10926
3683,1481,2202,1331,248100,10927
1848,889,959,1173,214300,10928
2759,2541,218,1151,301900,10930
325,227,98,1648,305000,10931
35,35,0,-,-,10932
215,204,11,-,226600,10933
18037,10857,7180,1161,211000,10940
4820,3171,1649,1289,259100,10941
12814,8287,4527,1211,310400,10950
9119,4358,4761,1422,575600,10952
65,65,0,-,467100,10953
8403,6250,2153,1826,384400,10954
10251,9155,1096,1333,485100,10956
958,820,138,1107,290400,10958
6286,3101,3185,1614,491700,10960
1856,1557,299,995,472800,10962
905,722,183,1365,224000,10963
511,394,117,1854,602000,10964
5392,4282,1110,1378,440300,10965
1112,770,342,1610,603900,10968
500,418,82,1151,283600,10969
3628,2793,835,1699,297100,10970
813,602,211,1419,270500,10973
1141,903,238,1444,305200,10974
144,106,38,-,181900,10975
783,508,275,544,447000,10976
15647,7528,8119,1297,385400,10977
91,91,0,-,224200,10979
4690,3932,758,1522,363200,10980
1900,1761,139,2227,460100,10983
983,890,93,1911,378400,10984
50,50,0,-,268800,10985
592,528,64,1205,469500,10986
1315,1053,262,1539,458700,10987
266,217,49,1125,217900,10988
3484,2940,544,1963,400300,10989
7348,5711,1637,994,327900,10990
3087,2549,538,930,263700,10992
1576,870,706,1313,237300,10993
2684,2499,185,1363,503400,10994
790,14,776,3113,422200,10996
1006,816,190,1306,306800,10998
9109,7233,1876,1545,524600,11001
12106,9621,2485,1702,376900,11003
5026,3668,1358,1431,508900,11004
1306,1232,74,-,585100,11005
7708,6415,1293,1418,456400,11010
1901,1594,307,1484,906100,11020
8003,5472,2531,1756,617100,11021
2947,2423,524,2372,885500,11023
2075,1864,211,1641,1507000,11024
6206,5527,679,1490,1240200,11030
12862,11400,1462,1751,579700,11040
0,0,0,-,-,11042
10981,7051,3930,2003,798200,11050
2649,1130,1519,1345,369500,11096
12474,2115,10359,1442,846100,11101
13627,1802,11825,1618,560200,11102
16113,2557,13556,1625,762700,11103
11412,2201,9211,1506,414200,11104
15227,4043,11184,1644,762300,11105
17127,3067,14060,1557,502800,11106
2891,198,2693,3059,553600,11109
26923,10290,16633,2260,862300,11201
27464,11385,16079,1262,429800,11203
24243,9136,15107,1313,786300,11204
15843,3654,12189,1299,662600,11205
30516,3088,27428,992,595000,11206
32625,8073,24552,1124,433600,11207
31393,8011,23382,1222,446600,11208
29220,10849,18371,1461,728900,11209
22310,10040,12270,1280,556900,11210
38660,6426,32234,1645,912900,11211
31484,4548,26936,942,409700,11212
24731,3950,20781,1166,709600,11213
31945,10916,21029,1305,677300,11214
28880,11487,17393,2123,1084600,11215
23800,5113,18687,1292,917600,11216
16856,5174,11682,1917,1057900,11217
24967,8907,16060,1473,680600,11218
25240,6702,18538,1342,823600,11219
28766,7290,21476,1304,779000,11220
29818,6560,23258,1290,663200,11221
17508,3306,14202,1843,756900,11222
27527,9752,17775,1267,699900,11223
18551,5245,13306,762,369300,11224
23462,3604,19858,1311,704600,11225
36677,4682,31995,1312,521200,11226
15033,8482,6551,1359,809200,11228
31058,14874,16184,1253,562200,11229
30831,8872,21959,1308,708300,11230
15562,4641,10921,1745,1135100,11231
8808,2270,6538,1430,649400,11232
28424,6268,22156,1137,673200,11233
31926,21678,10248,1384,526300,11234
32828,13432,19396,1267,515800,11235
32903,16010,16893,1331,491000,11236
16789,1693,15096,1428,595400,11237
24510,7190,17320,1629,827800,11238
6569,154,6415,694,460000,11239
0,0,0,-,-,11351
20299,8026,12273,1412,473300,11354
27523,8529,18994,1345,533000,11355
7541,3626,3915,1603,598600,11356
14735,11227,3508,1742,641500,11357
12820,7173,5647,1583,700100,11358
0,0,0,-,-,11359
8382,5925,2457,2007,526000,11360
10378,6008,4370,1722,638900,11361
7163,5740,1423,1682,521800,11362
2620,1954,666,1951,817100,11363
13385,9872,3513,1685,530100,11364
15657,7615,8042,1459,638700,11365
4456,3122,1334,1624,690500,11366
14670,6895,7775,1345,394300,11367
28275,6246,22029,1526,517600,11368
10720,5539,5181,1456,533500,11369
8365,4048,4317,1581,627100,11370
0,0,0,-,-,11371
24051,7353,16698,1390,298700,11372
30216,9212,21004,1426,530900,11373
19276,7098,12178,1453,336700,11374
32492,16272,16220,1676,382700,11375
31464,9396,22068,1457,482600,11377
12623,6628,5995,1501,574900,11378
13528,8318,5210,1449,615200,11379
34993,11223,23770,1399,543800,11385
6052,5171,881,1556,417400,11411
10957,8108,2849,1395,412200,11412
12133,8714,3419,1564,430700,11413
10511,7317,3194,1509,496600,11414
8489,3015,5474,1461,335700,11415
7216,3071,4145,1411,502100,11416
9035,5441,3594,1457,460300,11417
10940,4662,6278,1422,477500,11418
12724,7490,5234,1471,460300,11419
13226,8911,4315,1457,453000,11420
11972,6845,5127,1542,450000,11421
9686,6229,3457,1629,418400,11422
9817,5597,4220,1338,458100,11423
0,0,0,-,-,11424
0,0,0,-,-,11425
6388,4902,1486,1711,506600,11426
7487,4632,2855,1330,475900,11427
5611,3800,1811,1435,451600,11428
7387,5210,2177,1411,412300,11429
0,0,0,-,-,11430
18390,6556,11834,1399,563400,11432
10423,4515,5908,1165,388200,11433
20993,10339,10654,1130,386000,11434
18795,6708,12087,1421,363900,11435
5628,4028,1600,1492,382600,11436
0,0,0,-,-,11451
7543,5011,2532,1500,460000,11501
2325,2267,58,1942,622500,11507
882,769,113,2638,752600,11509
10712,9127,1585,1749,374500,11510
1672,1204,468,1725,482200,11514
2192,1473,719,1843,511400,11516
3891,2961,930,2036,419000,11518
13759,9266,4493,1389,317800,11520
9321,8477,844,2472,744100,11530
9742,5046,4696,1742,475400,11542
4369,3863,506,1830,846000,11545
254,216,38,-,507700,11547
522,344,178,1967,665000,11548
0,0,0,-,-,11549
16355,7391,8964,1353,315700,11550
7285,6411,874,1848,416600,11552
6285,4572,1713,1388,317300,11553
12196,10715,1481,1921,414200,11554
0,0,0,-,-,11556
2643,2308,335,1235,496100,11557
2919,2137,782,1568,411700,11558
2677,2254,423,1706,801300,11559
2260,1712,548,1824,758200,11560
16131,9786,6345,1841,482800,11561
8006,5811,2195,1756,429200,11563
3233,3122,111,1418,441400,11565
11225,10597,628,2160,501400,11566
1044,972,72,1393,1765600,11568
475,342,133,1977,819200,11569
10100,7014,3086,1556,598100,11570
10222,8947,1275,1359,443200,11572
4293,3177,1116,1731,280200,11575
4662,4152,510,2220,938100,11576
4298,3694,604,2083,769900,11577
1961,1401,560,1954,655100,11579
13242,11193,2049,1547,378200,11580
6838,5719,1119,1714,439800,11581
14156,10929,3227,1796,433200,11590
3604,3044,560,1748,570200,11596
3896,3444,452,1865,663500,11598
20155,4973,15182,1118,440700,11691
6417,2341,4076,951,362300,11692
4767,2343,2424,1011,310600,11693
8319,4229,4090,1297,632500,11694
1398,1353,45,-,556400,11697
8463,5827,2636,1387,326300,11701
4963,3890,1073,1819,443500,11702
5429,4466,963,1832,338500,11703
12647,9285,3362,1676,341000,11704
2696,2226,470,1753,430300,11705
18712,13656,5056,1551,319000,11706
2472,1978,494,1506,538100,11709
11474,10194,1280,1633,452400,11710
3211,2055,1156,2091,322800,11713
7673,6861,812,1914,412100,11714
1581,1367,214,1659,393400,11715
3632,2727,905,1704,383300,11716
13587,9883,3704,1351,285500,11717
1116,1056,60,1097,503400,11718
1124,911,213,1353,415600,11719
8816,7379,1437,1928,338300,11720
2264,2095,169,1796,589300,11721
9468,6314,3154,1557,257400,11722
1049,895,154,2380,1096300,11724
9903,9016,887,1665,461800,11725
5835,4330,1505,1537,289800,11726
10910,6975,3935,1845,296100,11727
8939,7390,1549,1601,353300,11729
4361,3906,455,1817,402100,11730
10136,8864,1272,1844,465500,11731
1422,1043,379,2209,635900,11732
5613,5247,366,2488,481500,11733
11414,9202,2212,1645,388600,11735
5183,4373,810,1821,346000,11738
321,301,20,-,604700,11739
3175,2524,651,489,534900,11740
9024,7287,1737,1885,359700,11741
4554,3636,918,1700,341800,11742
15132,13070,2062,1829,582300,11743
20740,17443,3297,1750,471300,11746
7070,6152,918,2132,616600,11747
982,876,106,1854,305300,11749
5067,4302,765,1388,371700,11751
2954,2500,454,1737,352300,11752
4253,3776,477,1794,762300,11753
6613,5344,1269,1445,432100,11754
4167,3471,696,1771,389900,11755
13479,12431,1048,1852,362100,11756
14550,11360,3190,1548,343900,11757
18449,16865,1584,1653,451800,11758
7358,7146,212,2382,447000,11762
9316,7437,1879,1658,298200,11763
4187,3960,227,1465,424900,11764
247,213,34,2528,1744000,11765
4207,3909,298,1349,442600,11766
4996,4452,544,1752,445500,11767
7959,6923,1036,1673,625800,11768
3367,2939,428,1476,410800,11769
23,23,0,-,604200,11770
3649,2959,690,1641,779800,11771
17022,10852,6170,1415,302300,11772
7899,6381,1518,1720,347200,11776
3421,2453,968,1630,532300,11777
4165,3438,727,1402,286400,11778
12660,9740,2920,1492,336300,11779
5410,4896,514,1770,495200,11780
5290,4227,1063,1770,437400,11782
6960,6384,576,2003,440500,11783
7981,6632,1349,1563,295000,11784
1938,1783,155,2508,417400,11786
12006,10681,1325,1603,473200,11787
5548,4466,1082,1971,455400,11788
2863,2671,192,1438,292200,11789
4529,4155,374,2806,450600,11790
8275,7682,593,2823,668700,11791
2944,2792,152,-,423500,11792
10385,9775,610,1601,446800,11793
0,0,0,-,-,11794
7941,7504,437,1533,413200,11795
1216,952,264,1657,375500,11796
3022,2634,388,2367,836600,11797
3709,2632,1077,1669,294700,11798
12516,10763,1753,1824,414800,11801
9632,8790,842,1657,537100,11803
1703,1550,153,-,572300,11804
10047,7080,2967,1409,300300,11901
445,376,69,1836,1500000,11930
19,19,0,-,-,11931
440,372,68,1257,1175900,11932
2970,2532,438,2021,343700,11933
2512,2197,315,1197,377700,11934
1257,1146,111,1658,532000,11935
6488,5505,983,1664,746600,11937
431,352,79,1654,618600,11939
1848,1495,353,1755,411100,11940
762,568,194,1414,514800,11941
1804,1527,277,1828,529100,11942
1726,1130,596,1418,478100,11944
5533,3877,1656,1694,437900,11946
138,138,0,-,-,11947
386,386,0,-,501400,11948
4873,4132,741,1568,410000,11949
4674,3652,1022,1678,237200,11950
4803,3419,1384,1794,192500,11951
1987,1686,301,1367,547600,11952
5201,3806,1395,1730,274100,11953
1528,1331,197,2048,871300,11954
1750,805,945,1726,366600,11955
127,99,28,2000,702200,11956
331,290,41,1577,736700,11957
256,236,20,-,601900,11958
398,327,71,1588,1165300,11959
301,290,11,-,734600,11960
5392,4578,814,1361,273100,11961
123,116,7,-,"2,000,000+",11962
2662,2105,557,2040,859700,11963
859,773,86,-,770700,11964
336,294,42,-,823400,11965
7916,6590,1326,2024,251500,11967
4469,3617,852,1951,860700,11968
89,71,18,-,-,11970
2673,2306,367,1434,527000,11971
457,354,103,1458,544600,11972
0,0,0,-,-,11973
111,103,8,-,1595600,11975
889,823,66,2810,1717900,11976
817,723,94,2722,750600,11977
1228,866,362,1857,602300,11978
1780,1376,404,2243,303000,11980
0,0,0,-,-,12007
161,149,12,-,234700,12008
2953,2339,614,1014,261300,12009
11641,7714,3927,757,113000,12010
1040,772,268,833,173600,12015
167,133,34,997,255800,12017
2825,2391,434,858,217400,12018
5864,4687,1177,1018,278400,12019
13235,9869,3366,1071,220000,12020
418,300,118,917,131400,12022
777,725,52,579,189700,12023
0,0,0,-,-,12024
2248,1897,351,805,161100,12025
1466,1212,254,1248,259000,12027
317,271,46,-,154300,12028
400,331,69,1215,309600,12029
84,62,22,578,95000,12031
382,353,29,825,132300,12032
3126,2383,743,982,209500,12033
286,225,61,852,85600,12035
111,102,9,-,147200,12036
1852,1363,489,930,222400,12037
63,63,0,-,-,12040
243,235,8,-,160500,12041
118,85,33,-,145600,12042
3026,1745,1281,801,152700,12043
196,122,74,672,152300,12045
390,353,37,-,148100,12046
8978,4345,4633,876,172400,12047
1405,972,433,729,165200,12051
716,588,128,850,169000,12052
1509,1281,228,1178,223400,12053
6883,5087,1796,1138,271600,12054
689,618,71,963,202300,12056
867,755,112,710,179000,12057
591,494,97,865,196000,12058
646,590,56,803,221100,12059
636,556,80,-,252300,12060
3629,2589,1040,1192,244000,12061
646,582,64,1256,174500,12062
138,104,34,-,198100,12063
204,164,40,708,93300,12064
17591,12150,5441,1146,265900,12065
771,676,95,834,143900,12066
598,558,40,1045,238000,12067
1224,1018,206,710,121300,12068
73,51,22,-,86300,12069
629,557,72,960,127600,12070
125,90,35,-,153100,12071
933,778,155,811,104700,12072
1223,1082,141,860,235300,12074
1125,905,220,1053,225200,12075
626,540,86,900,119800,12076
2489,1896,593,1023,290400,12077
10011,6326,3685,702,89500,12078
1438,1271,167,832,173100,12083
2052,505,1547,1177,268100,12084
140,15,125,1098,-,12085
714,643,71,750,153500,12086
335,304,31,-,113400,12087
66,58,8,-,-,12089
2482,1588,894,872,140200,12090
342,225,117,738,111800,12092
674,564,110,603,156700,12093
915,774,141,1052,182400,12094
4872,3334,1538,798,99900,12095
1095,882,213,1104,235200,12106
108,78,30,820,231800,12108
7618,5323,2295,1202,239200,12110
72,44,28,-,-,12115
822,649,173,966,117800,12116
1412,1107,305,976,142400,12117
6465,4274,2191,871,237500,12118
239,200,39,863,170800,12120
610,581,29,-,199800,12121
2061,1681,380,785,116200,12122
2195,1778,417,873,196800,12123
249,237,12,-,183400,12124
612,420,192,945,185500,12125
308,250,58,-,217400,12130
39,31,8,-,144300,12131
127,75,52,-,-,12132
1476,1164,312,784,156800,12134
346,323,23,-,361300,12136
687,564,123,767,184300,12137
1357,1127,230,736,159200,12138
59,54,5,-,183300,12139
631,578,53,692,215400,12140
2008,1260,748,865,169900,12143
8918,5286,3632,962,173800,12144
231,203,28,1269,239500,12147
1870,1627,243,2693,317000,12148
967,685,282,757,152400,12149
286,253,33,-,155400,12150
325,274,51,1070,215200,12151
357,357,0,-,286600,12153
1059,854,205,702,176700,12154
731,547,184,750,118000,12155
385,309,76,725,307300,12156
1628,1352,276,753,160200,12157
2601,2090,511,1062,220400,12158
3291,2435,856,1093,342200,12159
346,304,42,1050,145000,12160
82,69,13,-,-,12161
57,54,3,-,145800,12164
79,55,24,683,-,12165
545,474,71,-,118200,12166
1167,805,362,589,142300,12167
929,724,205,754,148800,12168
107,107,0,-,179800,12169
1878,1548,330,1263,210100,12170
108,52,56,1079,158300,12172
760,577,183,980,170400,12173
110,69,41,1006,218800,12174
210,193,17,964,148200,12175
135,128,7,-,184500,12176
242,187,55,639,95400,12177
21529,9941,11588,914,172300,12180
6206,3416,2790,815,147200,12182
1206,391,815,825,120800,12183
2566,2028,538,828,226900,12184
789,674,115,834,211300,12185
2471,2146,325,971,248100,12186
199,184,15,836,189300,12187
4726,3038,1688,928,217200,12188
7952,3226,4726,850,168900,12189
190,171,19,857,158700,12190
709,629,80,1048,170000,12192
725,645,80,1027,184100,12193
64,64,0,-,82000,12194
92,75,17,-,233500,12195
1211,1105,106,791,229200,12196
886,720,166,770,120000,12197
2976,2493,483,879,203200,12198
4172,1026,3146,790,99900,12202
13576,6649,6927,1044,199400,12203
3666,906,2760,992,169800,12204
11158,7588,3570,1095,198100,12205
6147,1708,4439,922,109600,12206
915,74,841,294,145000,12207
9760,4752,5008,990,195700,12208
4130,2413,1717,974,155500,12209
5192,899,4293,900,188400,12210
4284,3832,452,1195,285600,12211
0,0,0,-,-,12222
10057,7631,2426,996,182600,12302
10369,7742,2627,901,171500,12303
8311,5284,3027,925,123500,12304
2232,454,1778,740,128300,12305
9015,6761,2254,889,163500,12306
1922,569,1353,783,77300,12307
4997,2491,2506,864,130300,12308
10356,8526,1830,1062,239200,12309
14466,8113,6353,1036,179500,12401
1509,1180,329,1015,233400,12404
168,119,49,-,226700,12405
457,264,193,764,174500,12406
95,93,2,-,245000,12407
313,272,41,1422,355400,12409
256,245,11,-,203300,12410
130,130,0,-,262500,12411
259,173,86,981,210300,12412
1038,660,378,912,153600,12413
3919,2464,1455,864,170200,12414
56,36,20,-,-,12416
172,122,50,1316,131300,12417
108,108,0,-,182900,12418
277,139,138,974,242400,12419
142,124,18,-,214700,12420
159,159,0,-,159300,12421
130,127,3,-,183500,12422
421,319,102,930,197200,12423
106,96,10,-,207600,12424
136,121,15,-,-,12427
2572,1455,1117,939,131900,12428
102,74,28,-,255600,12429
535,470,65,638,225300,12430
415,273,142,1096,194000,12431
201,137,64,1125,219900,12432
236,192,44,-,360000,12433
306,191,115,494,131600,12434
111,67,44,994,259000,12435
78,59,19,-,-,12436
18,18,0,-,-,12438
125,108,17,939,185400,12439
953,659,294,1335,274000,12440
12,12,0,-,-,12441
411,263,148,840,257500,12442
1597,1525,72,1352,236300,12443
250,224,26,929,215700,12444
1989,1460,529,884,206900,12446
235,209,26,-,298800,12448
1184,784,400,1078,182200,12449
71,71,0,-,-,12450
477,361,116,986,153500,12451
116,112,4,-,155800,12452
115,53,62,-,-,12453
107,95,12,-,257600,12454
914,682,232,835,193300,12455
213,180,33,1297,135100,12456
394,238,156,1172,264800,12457
927,652,275,722,111800,12458
113,113,0,-,212500,12459
113,74,39,694,137500,12460
771,593,178,824,258900,12461
571,483,88,855,186800,12463
485,365,120,995,224200,12464
113,108,5,-,257900,12465
997,829,168,981,199900,12466
455,388,67,675,164100,12468
270,250,20,-,153400,12469
147,84,63,-,158300,12470
86,0,86,1392,-,12471
682,398,284,1045,182800,12472
418,418,0,-,185100,12473
524,423,101,775,141500,12474
127,92,35,1514,188200,12475
7410,5120,2290,1016,211200,12477
303,297,6,-,163500,12480
576,461,115,1170,257200,12481
207,158,49,-,33900,12482
175,89,86,-,98800,12483
1194,932,262,991,252900,12484
580,416,164,927,174300,12485
595,548,47,-,233400,12486
1347,887,460,1223,182400,12487
134,113,21,-,-,12489
13,13,0,-,-,12490
643,587,56,2017,214300,12491
132,127,5,-,254000,12492
144,64,80,-,180200,12493
322,288,34,-,248500,12494
134,134,0,-,535000,12495
604,510,94,713,221300,12496
2414,1950,464,1151,290000,12498
1047,680,367,1234,283800,12501
476,374,102,1367,326600,12502
265,190,75,1339,285700,12503
46,16,30,1450,-,12504
75,59,16,-,448200,12507
7013,4075,2938,1250,252000,12508
60,60,0,-,-,12512
187,166,21,-,217100,12513
1190,1081,109,1341,340600,12514
566,390,176,928,203100,12515
661,504,157,1172,257900,12516
216,149,67,548,238800,12517
2439,1537,902,1328,305100,12518
1073,754,319,1324,312200,12520
614,581,33,875,236000,12521
1958,1331,627,861,229200,12522
698,536,162,831,252600,12523
5945,4218,1727,1397,281000,12524
1132,832,300,1231,249500,12525
1531,1187,344,1128,280500,12526
0,0,0,-,-,12527
4937,3335,1602,1145,243100,12528
1101,806,295,1028,253400,12529
89,40,49,-,-,12530
1076,861,215,1246,277900,12531
8786,7933,853,1167,338500,12533
7726,4748,2978,828,186400,12534
4946,3548,1398,1063,223200,12538
2706,2461,245,1395,332200,12540
2324,1595,729,928,244100,12542
1339,906,433,1057,179400,12543
1979,1110,869,1175,382500,12545
1217,759,458,1034,242600,12546
1004,718,286,1204,234600,12547
584,486,98,693,232100,12548
3867,2964,903,1198,277400,12549
18777,10568,8209,1155,230100,12550
9294,6597,2697,1236,246400,12553
6170,4051,2119,1174,296100,12561
2238,1867,371,1214,285100,12563
2763,2021,742,1054,317400,12564
572,247,325,773,168500,12565
3790,2933,857,964,247200,12566
1248,938,310,1139,260200,12567
4124,2857,1267,1320,254000,12569
2571,2323,248,1582,341900,12570
3991,3013,978,1084,287000,12571
3651,2554,1097,1202,361000,12572
93,68,25,1632,-,12574
764,724,40,-,341600,12575
553,501,52,2019,297300,12577
846,630,216,1283,306500,12578
1504,1088,416,953,268300,12580
929,719,210,1021,289100,12581
1432,1217,215,1326,358900,12582
830,549,281,1234,269400,12583
301,218,83,958,346800,12585
4143,2962,1181,1307,217500,12586
4825,4138,687,1009,254400,12589
12583,9198,3385,1371,281400,12590
402,291,111,634,261400,12592
1507,1066,441,913,243800,12594
15874,6319,9555,1105,207000,12601
15642,11840,3802,1193,246500,12603
6,6,0,-,-,12604
4153,1892,2261,872,115300,12701
506,401,105,991,205000,12719
120,41,79,-,-,12720
1981,1520,461,1149,233500,12721
78,78,0,-,-,12722
636,481,155,802,191800,12723
155,127,28,-,-,12724
76,65,11,-,237500,12725
513,421,92,924,176100,12726
842,573,269,1083,141600,12729
348,268,80,1131,174300,12732
322,152,170,709,152300,12733
358,257,101,810,180700,12734
29,29,0,-,-,12736
648,554,94,855,202700,12737
159,90,69,899,190900,12738
632,481,151,1203,228800,12740
120,99,21,675,219400,12741
35,18,17,608,-,12742
168,111,57,1206,206900,12743
84,60,24,-,178800,12745
384,330,54,1132,199300,12746
621,449,172,898,162800,12747
778,606,172,816,183900,12748
195,65,130,643,-,12749
79,59,20,1250,169200,12750
299,123,176,894,158800,12751
120,75,45,815,170600,12752
2475,1276,1199,765,129100,12754
1643,1167,476,1088,162200,12758
619,447,172,809,107400,12759
213,185,28,910,94200,12760
224,131,93,850,-,12762
219,168,51,841,162900,12763
737,557,180,656,180700,12764
368,261,107,842,212500,12765
142,134,8,-,164500,12766
39,39,0,-,98800,12767
338,229,109,672,130500,12768
116,91,25,-,131500,12769
109,97,12,-,183900,12770
5389,3604,1785,955,185600,12771
742,604,138,1083,221600,12775
907,756,151,698,171200,12776
402,343,59,1404,193900,12777
262,208,54,-,202700,12778
635,273,362,431,211900,12779
850,797,53,1129,145000,12780
53,53,0,-,-,12781
493,415,78,954,157100,12783
12,7,5,-,-,12784
358,252,106,1096,170300,12785
220,115,105,1040,165400,12786
104,87,17,-,137500,12787
748,627,121,836,168200,12788
991,485,506,813,120800,12789
1740,1345,395,1038,169600,12790
236,142,94,696,165400,12791
62,45,17,-,144800,12792
6389,3280,3109,826,148700,12801
3581,2364,1217,907,174300,12803
10729,8149,2580,1048,220600,12804
199,199,0,-,310600,12808
1418,1148,270,779,154100,12809
283,255,28,680,114100,12810
18,15,3,-,-,12811
37,34,3,-,137500,12812
582,414,168,861,315600,12814
440,400,40,850,195800,12815
1994,1485,509,808,164100,12816
1028,860,168,689,251400,12817
136,118,18,933,133300,12819
141,89,52,-,99300,12821
2366,1840,526,898,149200,12822
151,140,11,-,-,12823
496,438,58,1156,298200,12824
1435,1152,283,880,152800,12827
3579,2679,900,874,133700,12828
6488,4957,1531,1057,235600,12831
2698,1809,889,691,115600,12832
1715,1468,247,895,238200,12833
2547,2071,476,775,185400,12834
1040,898,142,784,178300,12835
319,275,44,838,245000,12836
317,259,58,854,112800,12837
225,197,28,1075,155100,12838
5135,2805,2330,860,134900,12839
67,52,15,-,1062500,12841
230,185,45,567,117300,12842
162,127,35,-,140200,12843
99,76,23,-,-,12844
1996,1598,398,892,265400,12845
1290,1059,231,887,161900,12846
101,91,10,1042,248100,12847
146,146,0,-,204900,12849
1248,1018,230,1153,241200,12850
135,124,11,625,130200,12851
224,212,12,610,158800,12852
661,530,131,788,150000,12853
116,92,24,645,131700,12855
50,50,0,-,164200,12856
199,160,39,967,137500,12857
41,41,0,-,316700,12858
861,723,138,1321,175200,12859
259,218,41,-,122100,12860
296,266,30,900,153900,12861
6,6,0,-,-,12862
275,233,42,888,285000,12863
26,23,3,-,-,12864
1608,1379,229,821,135500,12865
17005,10229,6776,1173,321500,12866
491,389,102,670,209900,12870
1651,1267,384,885,170600,12871
17,14,3,-,-,12872
345,324,21,1031,166800,12873
87,85,2,-,575000,12874
280,253,27,734,142900,12878
2055,1613,442,736,120700,12883
166,128,38,1024,127800,12884
1829,1293,536,773,139200,12885
86,66,20,-,108300,12886
1946,1362,584,787,109300,12887
13086,7087,5999,767,144400,12901
597,354,243,1249,138400,12903
606,501,105,758,86400,12910
4,4,0,-,-,12911
866,586,280,726,124300,12912
540,445,95,648,161600,12913
353,262,91,686,78800,12914
804,634,170,635,100500,12916
587,462,125,657,105900,12917
890,796,94,797,137500,12918
1274,988,286,687,100200,12919
1016,752,264,708,85300,12920
961,814,147,884,135500,12921
20,18,2,-,-,12922
256,207,49,394,79800,12923
54,44,10,-,-,12924
906,719,187,583,86200,12926
103,89,14,-,107800,12927
741,597,144,867,120800,12928
292,211,81,786,100300,12929
285,236,49,775,89200,12930
559,421,138,765,164800,12932
15,15,0,-,-,12933
395,295,100,712,102300,12934
649,464,185,682,113200,12935
208,170,38,394,231600,12936
711,571,140,815,81400,12937
106,73,33,1117,138800,12939
531,480,51,1272,160400,12941
387,346,41,-,240100,12942
166,88,78,1058,207700,12943
1676,1238,438,817,102300,12944
209,201,8,-,187100,12945
2003,1173,830,850,247800,12946
316,262,54,736,102600,12950
222,135,87,783,70300,12952
4820,3356,1464,665,96200,12953
156,141,15,697,100500,12955
373,295,78,-,77400,12956
723,512,211,743,81700,12957
997,753,244,-,99600,12958
637,581,56,-,89900,12959
431,325,106,-,142300,12960
148,88,60,-,112500,12961
2402,1979,423,774,151900,12962
37,19,18,1591,-,12964
180,159,21,-,80300,12965
1070,850,220,737,72300,12966
423,353,70,-,68300,12967
233,225,8,-,86100,12969
142,99,43,-,179900,12970
2178,1774,404,735,146000,12972
48,48,0,-,88000,12973
660,507,153,625,101000,12974
145,100,45,767,131300,12975
102,93,9,-,213500,12976
36,36,0,-,-,12977
144,79,65,-,131000,12978
978,563,415,594,147100,12979
530,455,75,633,63700,12980
982,850,132,761,113900,12981
3384,2022,1362,743,176100,12983
569,464,105,1120,92200,12985
2524,1753,771,652,121800,12986
130,110,20,-,135000,12987
434,376,58,825,175600,12989
2097,1645,452,774,110900,12992
670,559,111,744,148800,12993
926,765,161,820,123800,12996
538,423,115,879,210300,12997
185,169,16,-,-,12998
74,74,0,-,112900,13020
16895,10280,6615,708,124500,13021
0,0,0,-,-,13024
589,437,152,697,168500,13026
13683,10159,3524,848,156100,13027
554,402,152,928,175800,13028
2842,2190,652,941,158700,13029
1456,1147,309,760,154000,13030
6350,5058,1292,936,153400,13031
4786,3498,1288,827,118800,13032
1388,1227,161,702,121700,13033
768,644,124,710,123500,13034
3194,2603,591,865,222100,13035
3533,2771,762,763,120500,13036
3376,2803,573,708,136500,13037
6641,5752,889,855,171200,13039
1027,802,225,804,93100,13040
4214,3772,442,1125,146600,13041
979,757,222,985,98800,13042
969,815,154,649,113800,13044
10738,6328,4410,743,114500,13045
102,41,61,737,-,13051
597,492,105,654,96800,13052
1798,1364,434,781,171000,13053
500,385,115,1277,97000,13054
6113,4534,1579,818,118100,13057
1131,1022,109,854,133300,13060
434,343,91,890,184600,13061
22,22,0,-,-,13062
640,542,98,886,149600,13063
34,28,6,-,347400,13064
5165,3930,1235,1037,227600,13066
2204,1529,675,848,148000,13068
9262,6172,3090,758,85100,13069
353,276,77,649,114400,13071
250,223,27,625,79000,13072
2656,1952,704,811,137600,13073
1573,1251,322,773,83600,13074
930,908,22,-,104900,13076
2615,1770,845,742,122900,13077
3768,2940,828,1034,198300,13078
1363,1104,259,592,109100,13080
446,387,59,764,163400,13081
1763,1478,285,745,137600,13082
705,532,173,656,110000,13083
1645,1263,382,842,147300,13084
78,78,0,-,316300,13087
10282,6238,4044,874,128700,13088
12021,8733,3288,933,148600,13090
973,846,127,729,116800,13092
909,677,232,660,111800,13101
10,10,0,-,-,13102
128,94,34,684,131600,13103
5994,4818,1176,868,241600,13104
2436,2025,411,810,174600,13108
949,853,96,720,171200,13110
617,575,42,663,98400,13111
698,668,30,-,137100,13112
89,66,23,690,101200,13113
2463,1939,524,695,106800,13114
96,81,15,-,106300,13115
1368,1046,322,786,136400,13116
97,74,23,942,88200,13117
2130,1689,441,655,117900,13118
803,720,83,489,90000,13120
452,337,115,542,237500,13122
101,101,0,-,66500,13123
39,34,5,-,82500,13124
13550,8975,4575,750,102000,13126
1403,1186,217,789,107900,13131
1490,1293,197,905,102800,13132
56,41,15,642,83800,13134
2598,1717,881,679,113400,13135
186,148,38,392,66500,13136
0,0,0,-,-,13138
1793,1485,308,778,83900,13140
250,180,70,887,103600,13141
2450,1722,728,743,103900,13142
1058,860,198,643,85800,13143
641,525,116,713,74600,13144
765,621,144,775,101300,13145
822,715,107,769,84800,13146
490,354,136,911,109100,13147
4495,3136,1359,768,102300,13148
3566,2931,635,890,285200,13152
155,100,55,775,155000,13153
291,223,68,618,74800,13155
866,729,137,710,93900,13156
282,207,75,986,118300,13157
619,446,173,683,102000,13158
1957,1580,377,860,176400,13159
776,573,203,823,131300,13160
140,120,20,-,125000,13162
147,122,25,775,138900,13163
808,730,78,742,167500,13164
4426,3056,1370,726,88400,13165
2169,1713,456,803,127200,13166
1310,1051,259,850,128800,13167
2432,106,2326,673,-,13202
7136,2078,5058,745,107700,13203
7920,2274,5646,761,72100,13204
7265,2893,4372,772,76400,13205
7753,3986,3767,766,92200,13206
5190,3205,1985,854,85500,13207
8502,3735,4767,736,85000,13208
5676,3946,1730,768,113200,13209
8069,2322,5747,845,134100,13210
2610,1714,896,873,85300,13211
8599,6269,2330,850,115700,13212
2961,2139,822,799,157500,13214
5449,4479,970,962,196100,13215
6371,5171,1200,884,130100,13219
3535,2236,1299,789,154600,13224
0,0,0,-,-,13290
42,42,0,-,275000,13301
633,536,97,695,75900,13302
482,418,64,905,166500,13303
646,530,116,743,157800,13304
128,98,30,-,143800,13305
1204,1049,155,800,99700,13308
2279,1782,497,583,103300,13309
197,187,10,-,105300,13310
187,161,26,1014,240400,13312
192,128,64,711,70000,13313
170,170,0,-,71900,13314
524,477,47,1125,119100,13315
2585,1794,791,662,107300,13316
1518,1014,504,726,98800,13317
462,426,36,850,133100,13318
292,135,157,860,77300,13319
858,697,161,807,162500,13320
516,262,254,720,56800,13321
432,303,129,727,154600,13322
4152,2994,1158,1013,163200,13323
903,789,114,643,93200,13324
416,373,43,1069,100200,13325
2434,1760,674,827,259700,13326
744,575,169,606,119200,13327
555,468,87,544,127700,13328
1647,1224,423,639,82000,13329
87,87,0,-,321400,13331
1015,818,197,819,98000,13332
17,17,0,-,141300,13333
406,393,13,-,151600,13334
574,468,106,677,143400,13335
328,243,85,743,362500,13337
556,499,57,538,116400,13338
2442,1894,548,649,84900,13339
3203,2444,759,692,107900,13340
53,53,0,-,127300,13341
108,105,3,-,165200,13342
720,618,102,626,104000,13343
69,55,14,-,115300,13345
1742,1236,506,861,191900,13346
541,434,107,735,166400,13348
4189,2188,2001,741,89800,13350
38,38,0,-,-,13352
9,5,4,-,258300,13353
1349,1218,131,658,129600,13354
300,201,99,797,114500,13355
4298,2912,1386,644,79000,13357
41,38,3,-,307700,13360
297,277,20,-,98400,13361
75,59,16,-,-,13362
886,763,123,1250,115500,13363
63,52,11,-,61100,13364
3243,2315,928,603,90700,13365
3086,2350,736,738,141400,13367
481,372,109,757,104700,13368
789,668,121,475,110400,13402
1713,1390,323,871,177300,13403
77,77,0,-,88300,13404
282,257,25,817,101400,13406
2129,1506,623,595,91700,13407
952,820,132,693,123800,13408
938,778,160,790,92200,13409
101,80,21,654,80900,13410
1337,1094,243,600,87100,13411
6564,4861,1703,890,159200,13413
32,19,13,-,-,13415
915,730,185,529,109900,13416
1650,685,965,801,127100,13417
100,80,20,-,77500,13418
528,430,98,556,252400,13420
5516,3361,2155,711,110600,13421
940,658,282,895,130800,13424
880,689,191,677,97800,13425
639,388,251,442,104200,13428
676,594,82,733,138700,13431
675,500,175,717,87400,13433
110,104,6,-,96800,13435
30,23,7,-,255000,13436
172,150,22,500,113000,13437
1421,1221,200,706,124800,13438
1563,1186,377,728,120200,13439
16678,10372,6306,752,107300,13440
18,0,18,-,-,13441
31,23,8,-,137500,13450
1784,1335,449,649,85400,13452
286,233,53,747,89200,13454
1594,1367,227,904,150200,13456
903,649,254,873,153800,13459
1850,1263,587,636,104500,13460
1277,999,278,669,147500,13461
570,449,121,515,84900,13464
156,110,46,584,171700,13468
364,327,37,-,138300,13469
332,322,10,514,84000,13470
1264,1035,229,807,100800,13471
32,32,0,-,-,13472
243,224,19,1047,100700,13473
13,3,10,-,-,13475
1365,994,371,685,140100,13476
585,462,123,598,142800,13477
1195,935,260,658,110800,13478
1427,1012,415,652,109800,13480
103,72,31,875,158300,13483
58,58,0,-,-,13484
441,384,57,740,89000,13485
365,284,81,782,101600,13486
55,43,12,-,-,13488
246,209,37,761,103900,13489
656,486,170,818,172600,13490
1336,1050,286,658,107800,13491
5079,4021,1058,707,145500,13492
663,552,111,682,84300,13493
104,99,5,-,158500,13494
850,577,273,698,100600,13495
14293,6711,7582,681,98900,13501
12814,7833,4981,711,96100,13502
15212,7443,7769,851,149400,13601
114,0,114,1587,-,13602
3278,36,3242,1418,157700,13603
1774,1328,446,777,138900,13605
1111,768,343,869,140600,13606
707,446,261,713,131700,13607
554,431,123,760,108700,13608
887,559,328,938,170100,13612
1079,794,285,700,92300,13613
91,64,27,-,60000,13614
451,311,140,763,161400,13615
789,336,453,1197,144200,13616
3524,2484,1040,920,115500,13617
780,649,131,633,140900,13618
4175,2391,1784,858,135000,13619
739,546,193,692,113700,13620
215,179,36,1135,79400,13621
890,706,184,1035,148900,13622
10,6,4,-,-,13623
2021,1503,518,875,164500,13624
791,697,94,621,139100,13625
939,654,285,906,140800,13626
79,52,27,970,88300,13628
513,444,69,639,95500,13630
122,98,24,633,78400,13633
1540,1293,247,475,158900,13634
413,290,123,730,72600,13635
121,77,44,878,124200,13636
1828,437,1391,1159,172700,13637
145,120,25,1240,78300,13638
106,83,23,904,59700,13639
196,189,7,-,299000,13640
34,34,0,-,183300,13641
3572,2448,1124,752,92600,13642
0,0,0,-,-,13643
947,763,184,719,84900,13646
22,22,0,-,-,13647
934,762,172,700,88000,13648
671,559,112,826,178300,13650
81,61,20,-,361100,13651
713,575,138,625,75100,13652
955,836,119,617,93700,13654
1247,920,327,443,114200,13655
962,867,95,699,127900,13656
824,688,136,542,90500,13658
197,172,25,789,97700,13659
651,488,163,667,92900,13660
518,450,68,821,134000,13661
7257,5197,2060,733,80600,13662
139,112,27,1009,82500,13664
323,252,71,743,132500,13665
99,81,18,-,-,13666
1181,782,399,762,92300,13667
1546,1192,354,693,81700,13668
6143,4237,1906,616,78300,13669
198,169,29,700,76100,13670
337,225,112,738,79100,13672
933,568,365,725,142100,13673
40,16,24,-,-,13674
54,54,0,-,-,13675
5312,3223,2089,790,113800,13676
25,15,10,-,-,13677
96,51,45,640,-,13678
752,635,117,880,131300,13679
514,448,66,775,88300,13680
300,277,23,631,95300,13681
304,265,39,1250,168400,13682
426,386,40,609,81700,13684
1009,498,511,1054,263100,13685
189,165,24,600,105300,13687
328,229,99,500,75800,13690
1086,776,310,955,127900,13691
31,31,0,-,332600,13692
196,172,24,-,158300,13693
624,451,173,814,128500,13694
52,52,0,-,241200,13695
27,15,12,-,-,13696
814,702,112,808,74800,13697
1167,957,210,562,122200,13730
441,384,57,1020,209200,13731
2946,2520,426,633,133800,13732
2170,1716,454,754,96400,13733
886,663,223,624,98800,13734
800,650,150,916,93600,13736
326,261,65,663,155400,13739
230,188,42,758,224200,13740
1337,1219,118,682,97100,13743
476,445,31,-,116000,13744
844,782,62,693,118100,13746
1379,1123,256,672,115900,13748
409,268,141,831,132100,13750
50,21,29,686,-,13751
343,293,50,831,165900,13752
1780,1203,577,771,167500,13753
1434,1066,368,681,120900,13754
537,433,104,508,111500,13755
182,121,61,699,102500,13756
524,437,87,846,141700,13757
19116,12553,6563,718,123600,13760
60,43,17,-,78300,13774
735,608,127,675,145400,13775
216,170,46,555,125000,13776
144,134,10,-,136000,13777
2258,1736,522,574,125800,13778
401,354,47,-,111600,13780
294,250,44,961,165900,13782
1069,799,270,588,113100,13783
41,26,15,-,-,13784
186,156,30,1071,154500,13786
1377,920,457,682,84800,13787
420,284,136,710,145800,13788
7699,4499,3200,764,90400,13790
24,24,0,-,-,13794
1470,929,541,772,95800,13795
602,501,101,741,143800,13796
764,674,90,743,93700,13797
633,541,92,690,83500,13801
235,230,5,-,77900,13802
1511,1213,298,733,103700,13803
175,128,47,660,117000,13804
121,86,35,567,150000,13806
514,402,112,759,164600,13807
570,450,120,709,132100,13808
703,557,146,783,68800,13809
497,412,85,678,123800,13810
1712,1412,300,676,99800,13811
962,817,145,664,100100,13812
183,183,0,-,120500,13813
5420,3502,1918,649,85900,13815
7508,4629,2879,862,148200,13820
1406,1160,246,742,129800,13825
13,13,0,-,-,13826
5021,3544,1477,701,107500,13827
2174,1741,433,684,95800,13830
231,212,19,625,90000,13832
1717,1511,206,740,87200,13833
64,16,48,1556,-,13834
520,418,102,650,97700,13835
1861,1033,828,674,86500,13838
479,446,33,708,109500,13839
224,167,57,758,112900,13841
161,152,9,-,186100,13842
861,762,99,714,106400,13843
300,245,55,678,86700,13844
0,0,0,-,-,13845
145,138,7,-,151000,13846
22,16,6,-,-,13847
1764,1494,270,730,96100,13849
8716,6752,1964,932,145700,13850
2577,1818,759,705,115400,13856
114,95,19,-,115600,13859
26,16,10,-,-,13860
116,102,14,-,178100,13861
1694,1366,328,671,102400,13862
220,172,48,914,74800,13863
485,280,205,745,128100,13864
2275,2065,210,619,114700,13865
8252,4832,3420,637,118100,13901
8,8,0,-,-,13902
7726,5101,2625,699,109000,13903
3763,2578,1185,754,93100,13904
11398,5687,5711,742,107200,13905
4070,3116,954,751,134400,14001
4114,3516,598,755,165400,14004
710,590,120,707,120000,14005
4279,3554,725,774,107900,14006
522,410,112,833,119300,14008
2325,1814,511,641,113200,14009
2575,1982,593,671,123100,14011
905,712,193,697,113200,14012
731,641,90,782,93100,14013
9607,5968,3639,753,104000,14020
657,594,63,769,94400,14024
1358,1058,300,792,183000,14025
350,235,115,643,172300,14026
646,579,67,853,116400,14028
652,548,104,830,134600,14030
3954,3182,772,666,225200,14031
2969,2674,295,1006,307000,14032
872,717,155,704,243800,14033
764,704,60,550,103500,14034
33,17,16,-,-,14035
2078,1732,346,830,134100,14036
418,348,70,523,157000,14037
43,31,12,550,83000,14039
839,703,136,826,155000,14040
60,41,19,828,83600,14041
1586,1144,442,636,90100,14042
11034,7618,3416,785,122700,14043
2577,2197,380,767,128700,14047
6158,3915,2243,641,68300,14048
7563,6465,1098,1507,266600,14051
6664,5544,1120,763,211400,14052
562,435,127,671,115900,14054
568,471,97,497,173000,14055
3245,2756,489,703,173700,14057
746,619,127,755,113500,14058
4104,3521,583,905,231900,14059
154,146,8,-,75400,14060
137,105,32,770,100300,14061
1290,1087,203,630,86700,14062
5092,3534,1558,709,127600,14063
708,626,82,718,109300,14065
490,409,81,675,82600,14066
2073,1578,495,760,119600,14067
2774,2086,688,1011,224600,14068
362,309,53,397,172600,14069
2177,1508,669,615,85600,14070
8044,6537,1507,942,193700,14072
17906,13685,4221,826,160500,14075
1685,1410,275,550,163900,14080
1336,935,401,653,112200,14081
216,190,26,-,151600,14082
2561,2490,71,777,183600,14085
12914,10848,2066,746,191300,14086
411,349,62,550,110800,14091
4862,3988,874,786,170100,14092
20233,14667,5566,652,118500,14094
1164,943,221,739,94800,14098
661,562,99,766,110700,14101
467,409,58,-,205400,14102
4524,3218,1306,676,84000,14103
1754,1379,375,647,104000,14105
2295,2019,276,667,105500,14108
0,0,0,-,-,14109
1316,1087,229,635,122800,14111
0,0,0,-,-,14112
289,227,62,669,134400,14113
18727,13687,5040,671,132400,14120
1384,1104,280,701,94100,14125
255,196,59,819,97900,14126
11999,9239,2760,950,224400,14127
597,459,138,622,107900,14129
64,54,10,-,80800,14130
2057,1843,214,1066,147700,14131
2446,2000,446,648,147200,14132
45,38,7,-,92000,14134
49,27,22,-,95300,14135
2098,1679,419,706,92800,14136
773,636,137,611,76500,14138
997,863,134,724,188700,14139
3148,2301,847,618,130800,14141
500,406,94,708,108700,14143
661,532,129,789,145400,14145
18762,13371,5391,804,117500,14150
702,587,115,635,141000,14167
13,5,8,-,-,14168
67,44,23,-,"10,000-",14169
1032,857,175,706,171500,14170
878,729,149,861,110600,14171
1237,1019,218,717,136500,14172
164,86,78,688,105800,14173
2270,1870,400,755,157900,14174
5614,1383,4231,666,160100,14201
1655,456,1199,543,370500,14202
1021,5,1016,815,-,14203
4125,1438,2687,504,77900,14204
8763,5513,3250,667,69600,14206
9507,3071,6436,664,60200,14207
4362,1827,2535,777,54800,14208
3836,1132,2704,764,169000,14209
6181,2940,3241,730,68700,14210
9068,3409,5659,718,43400,14211
4569,2069,2500,642,61000,14212
9087,3151,5936,743,89700,14213
7824,3466,4358,808,169300,14214
16585,7714,8871,758,57300,14215
10488,5191,5297,813,150300,14216
10752,7003,3749,727,120300,14217
7888,4152,3736,632,93800,14218
5300,3353,1947,755,118700,14219
9878,6427,3451,724,90600,14220
22869,17074,5795,1185,209000,14221
6734,2248,4486,848,262700,14222
10091,8342,1749,797,124900,14223
17638,13687,3951,783,144600,14224
15299,10652,4647,768,97800,14225
12466,9075,3391,880,147300,14226
10597,7019,3578,861,122200,14227
9249,4857,4392,975,167100,14228
8,0,8,-,-,14261
5468,2298,3170,570,55300,14301
17,0,17,-,-,14302
2526,1065,1461,675,54000,14303
12824,9528,3296,701,88700,14304
6826,4017,2809,693,73800,14305
4981,3431,1550,690,91800,14411
2963,2118,845,810,143500,14414
76,62,14,-,113600,14415
1427,1103,324,737,118100,14416
523,471,52,1155,149000,14418
7127,4485,2642,792,139300,14420
964,793,171,869,114900,14422
1886,1463,423,734,128400,14423
11911,8169,3742,868,182600,14424
4727,3314,1413,1076,157600,14425
824,666,158,682,85400,14427
3114,2624,490,1067,164300,14428
2307,1822,485,638,109900,14432
1473,1183,290,803,83500,14433
1230,1114,116,841,139500,14435
4129,3028,1101,674,89500,14437
148,109,39,860,91900,14441
3425,1908,1517,885,101500,14445
16982,13200,3782,963,193100,14450
3321,1701,1620,833,170900,14454
7768,4646,3122,759,111000,14456
204,173,31,725,124500,14462
2763,2449,314,721,106800,14464
700,636,64,523,134400,14466
4026,2608,1418,947,140000,14467
6659,5564,1095,961,144000,14468
2520,2152,368,745,150300,14469
3216,2556,660,664,97600,14470
990,804,186,908,160500,14471
3178,2515,663,864,223500,14472
108,103,5,-,275000,14475
878,687,191,830,113400,14476
642,560,82,725,135700,14477
244,230,14,-,197500,14478
94,85,9,-,-,14479
360,250,110,843,162500,14480
817,614,203,760,106400,14481
3509,2520,989,755,106300,14482
1646,1259,387,713,144500,14485
158,148,10,-,109100,14486
2356,1939,417,855,161700,14487
2731,1930,801,738,81500,14489
4204,3464,740,759,161700,14502
781,571,210,851,94100,14504
2004,1740,264,803,111400,14505
529,529,0,-,250500,14506
498,413,85,731,133500,14507
1859,1229,630,710,85900,14510
221,150,71,-,120800,14511
1949,1661,288,657,144000,14512
5827,3695,2132,716,98600,14513
2623,1802,821,990,154800,14514
938,824,114,813,103600,14516
1247,925,322,572,90400,14517
5002,4064,938,834,156600,14519
954,727,227,694,97900,14521
3892,2819,1073,738,125200,14522
994,853,141,640,111800,14525
8268,6990,1278,861,185900,14526
4976,3611,1365,749,138700,14527
47,47,0,-,125500,14529
2162,1518,644,707,88400,14530
1677,1203,474,763,131100,14532
733,571,162,768,118400,14533
11997,10869,1128,1379,256100,14534
251,201,50,650,76800,14536
55,40,15,-,86700,14537
59,59,0,-,87700,14539
941,704,237,909,125500,14541
20,15,5,-,72500,14542
1254,1093,161,959,176100,14543
750,586,164,629,135500,14544
63,63,0,-,96500,14545
1872,1289,583,1056,134800,14546
1573,1342,231,839,118900,14548
23,10,13,514,-,14549
705,557,148,610,76900,14550
2012,1595,417,741,84500,14551
544,463,81,783,138600,14555
6740,5255,1485,1051,163500,14559
864,782,82,938,119400,14560
1126,944,182,824,135000,14561
5779,4738,1041,1260,254800,14564
2115,1994,121,737,142200,14568
2619,1606,1013,556,113500,14569
456,434,22,-,99400,14571
2151,1648,503,711,96100,14572
20939,15887,5052,992,186300,14580
60,60,0,-,31700,14585
4143,2947,1196,1108,179000,14586
64,55,9,-,98800,14588
2978,2232,746,692,131000,14589
2130,1627,503,533,90400,14590
637,554,83,638,114300,14591
111,72,39,-,150000,14592
1442,0,1442,583,-,14604
4581,1017,3564,693,55800,14605
11342,6219,5123,837,108500,14606
9515,1568,7947,811,169400,14607
5142,999,4143,757,88500,14608
17532,10748,6784,857,93500,14609
6908,3963,2945,882,157300,14610
6686,2233,4453,825,56300,14611
15008,10770,4238,850,140100,14612
4853,1711,3142,804,69700,14613
53,0,53,788,-,14614
7054,3748,3306,844,91600,14615
12149,8599,3550,853,99700,14616
9483,8145,1338,893,128000,14617
8440,6457,1983,1093,193900,14618
5309,2676,2633,940,75300,14619
11232,3702,7530,866,139500,14620
12690,4115,8575,767,56700,14621
5536,4323,1213,897,110700,14622
8598,4717,3881,968,121100,14623
13979,11330,2649,1012,129200,14624
4354,3823,531,946,175600,14625
12853,8865,3988,999,138800,14626
0,0,0,-,-,14627
16728,9913,6815,598,72800,14701
2646,2083,563,658,98600,14706
101,91,10,-,59400,14707
52,50,2,-,58000,14708
596,494,102,615,83400,14709
1340,1185,155,896,97600,14710
746,539,207,654,77500,14711
1414,1178,236,623,140900,14712
208,176,32,980,86900,14714
1133,804,329,641,61600,14715
852,560,292,578,73500,14716
235,175,60,668,76900,14717
887,709,178,695,97800,14718
1352,1071,281,572,82600,14719
379,179,200,623,42900,14720
73,48,25,475,47500,14721
118,103,15,-,672600,14722
422,359,63,764,81500,14723
858,722,136,751,112300,14724
585,425,160,613,70700,14726
2174,1864,310,630,77300,14727
423,386,37,-,93300,14728
419,348,71,669,98800,14729
589,484,105,658,202400,14731
46,46,0,-,71900,14732
1575,1051,524,602,77800,14733
1180,888,292,575,74300,14735
106,75,31,913,155700,14736
1752,1418,334,612,74400,14737
1499,1237,262,754,86000,14738
1195,943,252,623,53800,14739
496,412,84,867,89200,14740
829,707,122,549,122200,14741
85,67,18,-,95800,14742
759,652,107,695,71300,14743
455,305,150,655,103500,14744
921,775,146,506,84200,14747
277,182,95,565,65900,14748
2058,1500,558,658,132500,14750
144,116,28,-,83300,14752
491,388,103,631,63100,14753
277,217,60,571,75800,14754
1237,967,270,544,92500,14755
48,48,0,-,-,14756
1306,1061,245,540,102200,14757
8068,4623,3445,626,82200,14760
674,546,128,610,88000,14767
408,357,51,658,89100,14769
1093,871,222,477,86900,14770
1481,1027,454,577,80000,14772
31,23,8,-,81500,14774
1019,850,169,596,78100,14775
254,209,45,543,72200,14777
0,0,0,-,-,14778
2726,1563,1163,625,72200,14779
785,661,124,725,94100,14781
918,675,243,675,80400,14782
143,117,26,-,81900,14783
280,212,68,753,90000,14784
2057,1556,501,650,91000,14787
91,38,53,-,-,14788
2105,1608,497,612,86700,14801
345,105,240,756,113100,14802
444,291,153,705,104900,14803
536,437,99,660,83900,14804
417,334,83,859,120900,14805
858,643,215,639,69800,14806
1234,952,282,714,93500,14807
200,166,34,729,71300,14808
968,709,259,693,86000,14809
5048,3219,1829,620,84300,14810
1174,1017,157,711,86500,14812
1056,777,279,596,66500,14813
644,525,119,1021,160700,14814
386,331,55,733,115900,14815
144,134,10,-,77300,14816
842,580,262,871,150400,14817
971,789,182,847,132200,14818
257,211,46,780,82400,14819
313,254,59,658,84800,14820
1284,1155,129,708,88600,14821
481,374,107,774,72100,14822
1476,1160,316,588,83200,14823
241,205,36,871,81700,14824
331,241,90,779,106500,14825
805,693,112,632,89900,14826
97,97,0,-,85600,14827
8619,5472,3147,763,113300,14830
331,323,8,725,95500,14836
2170,1650,520,652,105700,14837
821,777,44,825,95100,14838
274,233,41,539,78100,14839
1378,1120,258,705,160700,14840
276,276,0,-,187500,14841
330,319,11,-,146100,14842
5324,3463,1861,621,80400,14843
8777,6502,2275,909,143900,14845
355,310,45,702,81900,14846
1012,783,229,667,110700,14847
24673,11015,13658,1113,231200,14850
0,0,0,-,-,14853
21,21,0,-,-,14854
305,270,35,533,99700,14855
90,29,61,-,-,14856
567,475,92,783,102100,14858
321,294,27,618,91300,14859
537,437,100,723,121300,14860
590,526,64,645,103400,14861
529,475,54,686,97100,14864
1123,701,422,663,106900,14865
2366,1809,557,812,135500,14867
490,349,141,591,113800,14869
4251,2909,1342,925,121000,14870
1906,1614,292,772,144300,14871
291,246,45,694,106000,14872
998,893,105,591,95300,14873
139,131,8,-,119600,14874
170,137,33,677,103000,14877
242,206,36,733,137000,14878
896,719,177,701,91900,14879
609,494,115,696,66700,14880
113,47,66,-,280400,14881
1693,1226,467,1173,179100,14882
1800,1266,534,747,129400,14883
116,108,8,-,84400,14884
266,236,30,808,112500,14885
3061,2465,596,876,181600,14886
644,540,104,775,103300,14889
1783,1236,547,674,121200,14891
3264,2248,1016,689,102400,14892
3,3,0,-,-,14893
514,456,58,756,86500,14894
4239,2765,1474,619,71700,14895
329,290,39,679,66300,14897
640,528,112,664,86200,14898
5363,2484,2879,681,74900,14901
3133,2018,1115,771,112900,14903
6439,3855,2584,740,73800,14904
3871,2633,1238,796,116400,14905
13313,9867,3446,663,127400,15001
5127,3265,1862,645,87500,15003
117,78,39,-,108800,15004
4052,3399,653,660,154200,15005
193,152,41,-,66600,15006
171,162,9,-,188300,15007
6411,4781,1630,596,172500,15009
11141,7662,3479,700,131200,15010
6516,5010,1506,729,124400,15012
1367,878,489,721,72700,15014
471,441,30,247,299100,15015
7525,5267,2258,862,163800,15017
341,291,50,727,84000,15018
691,519,172,677,111300,15019
114,48,66,-,75800,15020
3090,2490,600,754,128700,15021
4381,3204,1177,647,87800,15022
3675,3024,651,802,133500,15024
6772,4722,2050,825,133200,15025
1345,1198,147,775,182000,15026
982,804,178,493,127400,15027
63,54,9,580,65000,15028
507,299,208,785,57600,15030
212,130,82,1307,85500,15031
2005,1229,776,591,59600,15033
912,553,359,516,62700,15034
975,537,438,709,73100,15035
4532,3833,699,767,113800,15037
108,94,14,-,83100,15038
3773,3079,694,980,158500,15042
726,668,58,709,161200,15043
10582,9761,821,1204,250900,15044
2029,1272,757,630,60500,15045
1008,857,151,799,135200,15046
35,35,0,-,86000,15047
472,351,121,685,98200,15049
972,919,53,828,160700,15050
204,132,72,1030,67300,15051
1442,1283,159,650,120700,15052
61,41,20,843,95500,15053
180,99,81,736,65000,15054
584,442,142,643,176000,15055
533,333,200,802,79700,15056
5826,5004,822,789,204000,15057
1646,877,769,548,80700,15059
286,211,75,671,113600,15060
5193,3819,1374,672,123800,15061
3660,2544,1116,595,74500,15062
4714,3733,981,650,126000,15063
123,88,35,924,180000,15064
4889,3575,1314,666,100400,15065
5420,3423,1997,652,96900,15066
996,651,345,680,80100,15067
16687,11391,5296,678,123200,15068
4560,3214,1346,1042,165100,15071
37,22,15,-,-,15072
3722,2416,1306,706,90000,15074
70,45,25,-,176600,15075
416,304,112,-,82700,15076
48,35,13,575,121900,15077
171,99,72,697,131900,15078
198,149,49,578,92300,15081
51,51,0,-,119900,15082
355,295,60,807,88500,15083
4511,2835,1676,688,81100,15084
3363,2682,681,725,155300,15085
116,74,42,-,205000,15086
70,70,0,-,-,15087
184,125,59,700,60600,15088
2880,2261,619,536,122500,15089
9073,7271,1802,1307,316900,15090
9903,7892,2011,981,212300,15101
12399,9856,2543,907,172200,15102
3839,1681,2158,548,36400,15104
9377,5811,3566,794,118800,15106
17175,12128,5047,913,180900,15108
2280,926,1354,598,37800,15110
1427,633,794,606,63500,15112
6245,5460,785,877,173300,15116
8308,5127,3181,680,85500,15120
8724,6544,2180,621,92800,15122
3162,2388,774,787,164000,15126
4449,3424,1025,942,156000,15129
3747,2728,1019,810,105800,15131
9925,5165,4760,622,47900,15132
3019,2435,584,723,71500,15133
2181,1573,608,742,117800,15135
9568,6012,3556,692,129100,15136
4668,3125,1543,695,80100,15137
3093,1934,1159,840,178800,15139
1498,676,822,599,57900,15140
514,406,108,-,653800,15142
8183,6495,1688,1063,305600,15143
1890,1321,569,665,96500,15144
3255,1490,1765,527,67700,15145
12592,8344,4248,950,138400,15146
8085,5516,2569,745,90200,15147
1269,469,800,642,48800,15148
6196,3441,2755,966,133900,15201
9869,5070,4799,729,123500,15202
5257,2313,2944,1098,199200,15203
3495,2363,1132,903,70200,15204
10452,6064,4388,830,114800,15205
14131,5739,8392,894,157600,15206
5068,3271,1797,703,92900,15207
4510,2208,2302,718,142600,15208
5589,3988,1601,803,137400,15209
10873,6302,4571,752,59800,15210
5525,2707,2818,940,99400,15211
12913,6815,6098,796,97400,15212
9777,2559,7218,945,142400,15213
6187,3749,2438,763,102700,15214
5367,3744,1623,816,210300,15215
10634,6417,4217,833,116100,15216
11862,6111,5751,1027,279700,15217
6732,3731,3001,777,124800,15218
5327,1493,3834,669,92200,15219
7931,4804,3127,952,158200,15220
16067,7806,8261,785,97900,15221
2364,403,1961,1646,360300,15222
3068,2028,1040,700,102300,15223
5453,1941,3512,844,115100,15224
612,313,299,710,86900,15225
6029,4365,1664,848,100200,15226
11802,8340,3462,694,114200,15227
7224,5364,1860,861,251600,15228
6162,4495,1667,884,139900,15229
6110,1630,4480,1101,334400,15232
1352,685,667,761,127800,15233
6306,4373,1933,806,126100,15234
14962,11351,3611,878,96100,15235
12446,9673,2773,847,145400,15236
18102,13940,4162,1003,201900,15237
5321,4076,1245,944,316400,15238
8549,7031,1518,923,142300,15239
7653,6748,905,1291,278300,15241
5733,5015,718,1201,193800,15243
0,0,0,-,-,15260
0,0,0,-,-,15290
20055,13449,6606,717,154500,15301
122,91,31,458,173200,15310
646,496,150,724,216700,15311
1421,1199,222,694,157300,15312
158,139,19,915,97900,15313
1608,1133,475,473,118300,15314
293,250,43,793,52800,15315
34,28,6,-,44500,15316
14967,12199,2768,889,251600,15317
2325,1596,729,406,114200,15320
625,547,78,697,222700,15321
835,726,109,634,73700,15322
1741,1338,403,719,154100,15323
293,192,101,762,62500,15324
171,104,67,-,34000,15325
604,511,93,760,68500,15327
525,362,163,764,171800,15329
2077,1902,175,751,223000,15330
288,169,119,829,66300,15331
3782,3196,586,648,130700,15332
905,674,231,693,86900,15333
58,49,9,-,101000,15334
207,151,56,563,111600,15337
677,549,128,578,96100,15338
500,386,114,805,190900,15340
341,271,70,495,157000,15341
2077,1579,498,809,150800,15342
598,495,103,708,106500,15344
587,426,161,656,78800,15345
228,210,18,-,62200,15346
271,254,17,-,161300,15347
132,93,39,1018,108500,15348
752,554,198,784,132900,15349
155,105,50,746,54500,15350
371,192,179,693,22300,15351
366,298,68,586,122700,15352
36,30,6,-,187500,15353
652,536,116,449,120300,15357
331,234,97,675,88500,15358
85,57,28,725,101000,15359
678,582,96,738,168800,15360
54,22,32,-,-,15361
301,242,59,672,118000,15362
275,127,148,821,123900,15363
264,226,38,795,129700,15364
102,76,26,-,69000,15366
2928,2682,246,1201,363000,15367
143,94,49,592,44800,15368
5039,3483,1556,665,134700,15370
629,499,130,709,161100,15376
258,203,55,758,143100,15377
54,21,33,-,-,15378
56,45,11,-,121900,15379
243,151,92,621,96300,15380
13585,8913,4672,635,104700,15401
425,394,31,-,58100,15410
316,248,68,750,141400,15411
204,165,39,715,86300,15412
230,169,61,-,60800,15413
3552,2507,1045,601,92800,15417
1669,779,890,465,98400,15419
72,53,19,-,-,15420
30,30,0,-,-,15421
48,29,19,-,63100,15422
854,742,112,723,117300,15423
912,662,250,603,97100,15424
8076,5686,2390,522,96600,15425
497,411,86,780,105300,15427
750,650,100,775,91800,15428
109,80,29,583,101100,15429
109,91,18,-,68100,15430
1727,1388,339,613,78600,15431
201,141,60,595,75400,15432
320,280,40,-,161700,15433
111,90,21,592,65000,15434
230,174,56,842,86200,15435
1058,748,310,598,97000,15436
947,612,335,642,158000,15437
728,635,93,675,102700,15438
91,84,7,-,117500,15440
820,660,160,692,81400,15442
53,53,0,-,33600,15443
153,136,17,-,71500,15444
1163,909,254,730,104700,15445
224,205,19,-,122800,15446
0,0,0,-,-,15447
96,60,36,-,122700,15448
143,143,0,-,34600,15449
52,40,12,-,-,15450
424,359,65,492,76800,15451
44,30,14,-,-,15454
175,143,32,-,54000,15455
1094,850,244,636,91700,15456
929,812,117,-,78300,15458
608,437,171,493,102100,15459
34,26,8,-,42500,15460
1755,1178,577,651,74800,15461
132,132,0,-,-,15462
0,0,0,-,-,15463
572,472,100,572,102100,15464
183,152,31,729,67500,15466
61,44,17,-,50800,15467
965,727,238,692,88000,15468
907,680,227,749,94000,15469
267,205,62,928,149000,15470
64,9,55,-,-,15472
1673,1316,357,603,128500,15473
727,543,184,754,74900,15474
419,317,102,666,72600,15475
56,56,0,-,11800,15476
381,298,83,649,80000,15477
2517,1931,586,577,102700,15478
832,706,126,609,129700,15479
746,608,138,573,94600,15480
182,166,16,670,54200,15482
189,149,40,725,85400,15483
47,43,4,-,-,15484
896,776,120,496,132800,15486
136,98,38,-,72100,15489
279,216,63,-,99700,15490
74,74,0,-,74000,15492
6501,4571,1930,589,119900,15501
56,47,9,-,198200,15502
0,0,0,-,-,15510
103,92,11,-,62200,15520
679,574,105,683,117400,15521
4868,3714,1154,669,156600,15522
2105,1669,436,581,110000,15530
1643,1233,410,516,84900,15531
64,58,6,-,55000,15532
573,432,141,661,112500,15533
412,327,85,664,139000,15534
822,704,118,694,159000,15535
172,157,15,975,151300,15536
3309,2523,786,638,111800,15537
307,273,34,600,121800,15538
242,202,40,-,122200,15539
126,105,21,-,139600,15540
1422,1285,137,584,111200,15541
435,370,65,655,80700,15542
61,61,0,-,55300,15544
1078,893,185,655,97400,15545
87,87,0,-,-,15546
181,143,38,788,97900,15547
698,564,134,623,114000,15550
324,269,55,614,99800,15551
2240,1698,542,539,93300,15552
960,787,173,823,109600,15554
50,43,7,-,73000,15555
1422,1129,293,610,114100,15557
879,646,233,567,107700,15558
769,651,118,635,144400,15559
74,62,12,775,90000,15560
78,60,18,617,128400,15561
64,54,10,683,142200,15562
1232,1057,175,669,95700,15563
28,18,10,436,88000,15564
24641,17934,6707,680,161600,15601
1516,1378,138,504,155600,15610
373,296,77,1161,-,15611
166,166,0,-,-,15612
5927,4855,1072,687,137300,15613
74,67,7,-,155100,15615
0,0,0,-,-,15616
154,122,32,725,86200,15617
1004,797,207,613,78600,15618
340,224,116,691,66700,15620
30,0,30,-,-,15621
541,422,119,325,159400,15622
267,228,39,815,141700,15623
98,69,29,-,96200,15624
57,57,0,-,-,15625
2634,2091,543,700,148700,15626
2809,2238,571,647,105600,15627
258,206,52,575,84800,15628
339,198,141,610,54300,15629
437,287,150,681,86300,15631
3847,2932,915,729,214900,15632
173,111,62,-,110700,15633
158,133,25,531,60300,15634
96,80,16,-,152400,15635
1422,1318,104,781,235400,15636
680,514,166,951,105700,15637
135,60,75,1037,-,15638
892,692,200,545,167600,15639
194,187,7,-,101000,15640
212,189,23,530,85000,15641
18066,15237,2829,731,168900,15642
8261,6319,1942,678,115500,15644
74,56,18,-,68000,15646
129,109,20,-,102200,15647
11245,8400,2845,647,143500,15650
148,115,33,719,116300,15655
4315,3461,854,606,126900,15656
4015,3320,695,713,169500,15658
164,164,0,-,114700,15660
263,126,137,904,58300,15661
90,90,0,-,-,15662
238,186,52,496,84700,15663
595,454,141,984,139600,15665
6947,5460,1487,654,118900,15666
5338,4994,344,1090,231900,15668
1616,1374,242,635,155800,15670
306,306,0,-,161300,15671
1455,998,457,724,180500,15672
570,467,103,580,95000,15673
369,285,84,850,81400,15675
250,183,67,527,153000,15676
165,160,5,-,127300,15677
247,140,107,548,96300,15678
1097,880,217,540,130600,15679
72,64,8,-,74000,15680
1818,1478,340,645,115000,15681
3463,2613,850,547,104500,15683
266,243,23,432,-,15684
372,341,31,708,122000,15686
488,418,70,606,150800,15687
440,396,44,765,77100,15688
112,77,35,-,82700,15689
3790,2592,1198,620,76200,15690
40,40,0,-,-,15691
535,438,97,580,130900,15692
66,66,0,-,-,15693
199,174,25,-,86700,15695
157,134,23,696,80800,15696
1406,965,441,540,104300,15697
269,255,14,-,91700,15698
13537,7556,5981,754,141600,15701
85,70,15,-,95000,15710
209,173,36,725,78100,15711
69,60,9,-,65000,15712
138,138,0,-,47200,15713
1999,1561,438,643,70700,15714
196,151,45,585,71800,15715
255,132,123,637,-,15716
4090,3026,1064,658,116000,15717
94,70,24,631,56000,15721
951,829,122,558,85200,15722
19,19,0,-,-,15723
884,753,131,676,80400,15724
617,526,91,646,117300,15725
79,42,37,836,75000,15727
1413,1032,381,532,77300,15728
580,505,75,-,77500,15729
27,24,3,-,73300,15730
257,176,81,-,93000,15731
651,580,71,681,113500,15732
65,61,4,-,67500,15733
154,134,20,-,64600,15734
348,195,153,747,114800,15736
43,43,0,-,29800,15737
112,89,23,800,67300,15738
161,115,46,793,68200,15739
23,23,0,-,72100,15741
337,302,35,595,76800,15742
66,59,7,-,58500,15744
55,47,8,-,45000,15745
56,26,30,569,68800,15746
807,614,193,636,150500,15747
2704,2104,600,643,101000,15748
136,66,70,744,-,15750
18,0,18,-,-,15752
186,169,17,675,84200,15753
174,159,15,-,67600,15754
118,88,30,593,63100,15756
627,520,107,567,76500,15757
1098,910,188,649,115000,15759
61,52,9,-,56900,15760
45,28,17,850,126700,15761
376,344,32,675,131900,15762
90,81,9,-,156900,15764
709,588,121,663,139300,15765
5920,4262,1658,608,97100,15767
80,78,2,-,154800,15770
377,324,53,386,111200,15771
570,473,97,637,78100,15772
186,177,9,-,68200,15773
1204,1027,177,616,142800,15774
305,267,38,-,75000,15775
26,24,2,-,85000,15776
71,71,0,-,72500,15777
58,47,11,863,51500,15778
182,153,29,-,87700,15779
79,76,3,-,70000,15780
41,41,0,-,90800,15781
54,32,22,606,66700,15783
23,23,0,-,88300,15784
7764,5624,2140,647,109300,15801
61,59,2,-,101800,15821
599,496,103,541,95500,15823
2188,1581,607,588,103200,15824
3643,2696,947,611,110200,15825
97,79,18,-,38900,15827
122,114,8,663,130000,15828
576,458,118,613,112100,15829
137,125,12,-,59200,15832
1966,1371,595,589,74000,15834
879,680,199,755,89700,15840
119,90,29,-,-,15841
1386,1049,337,498,61800,15845
1388,1234,154,507,119500,15846
131,110,21,654,80000,15847
380,308,72,646,98600,15848
482,418,64,816,80300,15849
2707,2057,650,557,89100,15851
2875,2132,743,499,87400,15853
372,343,29,775,121700,15856
5610,4329,1281,580,114100,15857
496,425,71,528,105700,15860
71,65,6,680,87500,15861
129,114,15,819,48700,15863
666,556,110,650,93100,15864
599,391,208,678,69900,15865
98,86,12,-,80000,15866
615,535,80,569,87400,15868
516,448,68,498,82500,15870
2029,543,1486,432,27000,15901
5202,3237,1965,575,50100,15902
6404,4531,1873,753,127600,15904
9243,7056,2187,659,96000,15905
5061,3340,1721,489,47900,15906
2240,1880,360,566,85500,15909
312,296,16,745,110600,15920
46,41,5,-,81100,15921
69,54,15,-,93800,15922
599,508,91,575,78700,15923
438,399,39,680,59800,15924
66,49,17,1069,65000,15925
1078,939,139,656,82500,15926
449,418,31,-,76900,15927
890,633,257,873,147600,15928
38,13,25,-,85000,15929
62,62,0,-,34300,15930
3609,2600,1009,688,150500,15931
56,56,0,-,-,15934
1277,1087,190,657,105900,15935
610,529,81,644,85100,15936
302,244,58,589,85100,15937
932,818,114,600,87700,15938
674,531,143,652,163800,15940
898,873,25,542,130400,15942
1560,1267,293,498,67000,15943
1281,1071,210,557,108500,15944
53,53,0,-,65600,15945
2841,2292,549,475,92000,15946
240,161,79,596,77600,15948
212,204,8,-,69000,15949
247,223,24,-,56100,15951
656,463,193,603,132400,15952
48,35,13,-,-,15953
974,776,198,574,93000,15954
900,828,72,-,80500,15955
1099,885,214,605,66200,15956
253,221,32,-,120700,15957
858,727,131,635,123000,15958
234,190,44,692,53400,15960
343,285,58,600,78600,15961
55,47,8,1042,77000,15962
4670,3486,1184,621,98500,15963
17694,11706,5988,691,150000,16001
6003,5159,844,864,185800,16002
441,355,86,757,120600,16020
155,119,36,581,86400,16022
2008,1306,702,846,170200,16023
101,72,29,990,134100,16024
2132,1833,299,673,155300,16025
99,86,13,696,157100,16027
827,578,249,556,97300,16028
301,241,60,777,113600,16029
122,78,44,578,92500,16030
2568,1912,656,775,191800,16033
720,605,115,588,161600,16034
49,40,9,-,102800,16035
88,75,13,588,87900,16036
1798,1500,298,838,241500,16037
1395,1163,232,693,139700,16038
375,301,74,542,113100,16040
781,628,153,624,94100,16041
493,269,224,832,79500,16045
6065,4851,1214,1325,321400,16046
61,57,4,-,95000,16048
1230,1006,224,640,102300,16049
622,524,98,675,100000,16050
1195,1013,182,704,134200,16051
1003,871,132,980,165700,16052
1847,1660,187,681,214300,16053
161,146,15,663,100000,16054
3368,2966,402,917,192000,16055
1997,1509,488,628,182200,16056
4725,2816,1909,669,160500,16057
3180,2690,490,1768,270800,16059
1013,912,101,704,150900,16061
3053,2066,987,791,188200,16063
11458,9331,2127,1237,279000,16066
14107,9677,4430,573,82200,16101
2483,1933,550,679,85700,16102
6598,5093,1505,802,133100,16105
162,153,9,-,106900,16110
507,410,97,621,110100,16111
625,529,96,688,94200,16112
201,180,21,544,158300,16113
255,226,29,688,114400,16114
1211,1037,174,634,133200,16115
1082,992,90,550,92400,16116
7296,5426,1870,725,102800,16117
811,667,144,613,116300,16120
2021,1171,850,718,60100,16121
768,667,101,544,192800,16123
765,637,128,573,126300,16124
7021,5139,1882,608,105200,16125
5434,4054,1380,669,139700,16127
872,735,137,584,115400,16130
324,276,48,685,119200,16131
144,107,37,-,110500,16132
592,522,70,740,130700,16133
1698,1459,239,648,99300,16134
340,221,119,615,76200,16136
4414,3522,892,639,134500,16137
17,7,10,-,-,16140
739,665,74,525,83300,16141
2129,1595,534,624,171700,16142
1244,1111,133,708,122200,16143
1086,883,203,629,134400,16145
6099,3289,2810,596,64500,16146
7218,5267,1951,802,140500,16148
2936,2195,741,739,103700,16150
39,31,8,494,90600,16151
1073,851,222,623,117400,16153
1128,1016,112,682,119600,16154
51,12,39,778,-,16155
1143,977,166,688,150100,16156
1295,1051,244,546,99300,16157
1944,1505,439,639,125900,16159
379,283,96,752,77900,16160
411,284,127,621,52400,16161
7608,5419,2189,595,117800,16201
350,299,51,713,88600,16210
65,53,12,-,62500,16211
144,125,19,758,65400,16212
52,35,17,-,66900,16213
4048,1738,2310,623,127300,16214
35,28,7,-,120000,16217
401,340,61,936,115900,16218
899,780,119,622,87500,16222
77,63,14,-,80800,16223
490,410,80,661,87500,16224
3504,2556,948,643,87800,16226
211,182,29,706,81600,16228
2141,1645,496,708,148000,16229
153,103,50,638,77900,16230
1681,1346,335,514,105000,16232
508,438,70,809,155100,16233
532,455,77,675,119300,16235
87,87,0,-,79200,16236
187,127,60,638,85000,16238
453,371,82,675,85900,16239
595,454,141,510,112500,16240
1946,1339,607,580,87900,16242
118,96,22,-,74400,16244
115,82,33,669,63300,16245
90,71,19,833,66900,16246
1288,914,374,609,84700,16248
735,610,125,546,111300,16249
186,162,24,1104,77900,16250
39,36,3,-,62500,16253
1299,1090,209,671,114100,16254
662,542,120,694,95800,16255
576,501,75,525,91200,16256
847,513,334,718,114400,16258
777,651,126,539,89600,16259
123,110,13,-,186500,16260
1063,870,193,707,112700,16262
142,131,11,-,55400,16263
6588,4712,1876,579,68000,16301
184,161,23,625,114300,16311
3,3,0,-,-,16312
692,575,117,631,70800,16313
2182,1796,386,651,118300,16314
2464,1854,610,694,139200,16316
508,444,64,635,84700,16317
533,496,37,708,128300,16319
34,25,9,-,63600,16321
50,48,2,-,64600,16322
6759,4666,2093,606,85200,16323
164,154,10,475,117700,16326
1194,1042,152,811,114200,16327
37,26,11,950,70000,16328
219,186,33,-,82600,16329
23,23,0,-,119600,16331
16,7,9,-,-,16332
139,127,12,410,43600,16333
140,130,10,-,116400,16334
11554,7041,4513,666,108500,16335
744,675,69,565,95200,16340
786,688,98,561,80400,16341
785,660,125,654,82900,16342
236,154,82,-,-,16343
179,135,44,605,51000,16344
1471,1316,155,537,142600,16345
1428,978,450,618,95300,16346
987,802,185,504,71800,16347
959,770,189,573,100800,16350
662,517,145,482,88400,16351
110,98,12,750,68300,16352
1091,959,132,561,95500,16353
4504,2963,1541,599,85700,16354
558,457,101,600,114200,16360
15,15,0,-,-,16361
475,411,64,583,114100,16362
447,378,69,805,128000,16364
8076,5573,2503,596,96600,16365
69,57,12,569,58300,16370
1326,946,380,578,82600,16371
218,155,63,498,62800,16372
1293,1056,237,677,110800,16373
806,711,95,673,112300,16374
1747,1291,456,551,106500,16401
342,327,15,759,87900,16402
2402,1849,553,667,108700,16403
1263,1044,219,675,99800,16404
293,238,55,838,87300,16405
1234,1000,234,634,114900,16406
4314,2999,1315,699,93000,16407
620,568,52,906,108800,16410
656,530,126,863,108500,16411
4217,2803,1414,787,169200,16412
3349,2912,437,791,192000,16415
70,59,11,-,32000,16416
3176,2468,708,610,125300,16417
227,204,23,600,75600,16420
950,751,199,440,141700,16421
141,120,21,-,75800,16422
1737,1333,404,706,110100,16423
2040,1713,327,698,99500,16424
1545,1382,163,862,154600,16426
60,46,14,930,83800,16427
4967,3608,1359,735,152400,16428
2073,1771,302,669,120700,16433
935,770,165,671,98000,16434
727,587,140,686,111700,16435
200,162,38,-,117300,16436
3144,2522,622,622,98500,16438
386,343,43,640,138200,16440
4002,3377,625,652,171000,16441
1060,910,150,581,139500,16442
488,406,82,725,99800,16443
0,0,0,-,-,16444
1418,12,1406,385,-,16501
6789,2695,4094,675,72000,16502
5968,1961,4007,666,46800,16503
6404,4349,2055,825,87700,16504
7561,5466,2095,782,146900,16505
10024,6801,3223,902,167200,16506
3795,1190,2605,712,59300,16507
6944,4719,2225,714,95000,16508
11991,8357,3634,801,153600,16509
10003,7537,2466,755,117400,16510
4865,3148,1717,718,122900,16511
0,0,0,-,-,16546
0,0,0,-,-,16563
13616,9424,4192,600,101100,16601
12445,8037,4408,675,93800,16602
1066,907,159,653,130300,16611
550,491,59,683,120700,16613
49,27,22,-,93800,16616
1183,914,269,632,108900,16617
159,137,22,529,59500,16619
113,104,9,592,84100,16620
275,213,62,550,124600,16621
83,83,0,-,104200,16622
210,166,44,441,156000,16623
80,58,22,608,116100,16624
1571,1012,559,706,108800,16625
833,660,173,600,68700,16627
1840,1317,523,596,105600,16630
33,33,0,-,158900,16631
95,78,17,-,76900,16633
155,127,28,395,89300,16634
5167,3969,1198,801,156700,16635
311,303,8,700,118800,16636
909,690,219,783,125000,16637
12,10,2,-,112500,16638
573,509,64,703,93700,16639
331,315,16,533,109200,16640
1025,837,188,645,83900,16641
66,61,5,663,86400,16645
952,799,153,646,81200,16646
326,273,53,578,172700,16647
6174,4524,1650,773,183300,16648
705,555,150,643,113600,16650
1363,1038,325,523,82400,16651
5769,3891,1878,557,130200,16652
672,566,106,680,128900,16655
479,425,54,713,63400,16656
521,443,78,599,157900,16657
124,77,47,683,94400,16659
349,290,59,638,58000,16661
2353,1668,685,743,154300,16662
712,628,84,742,138500,16664
120,83,37,710,148600,16665
1265,1085,180,608,86000,16666
531,428,103,575,113800,16667
1507,1194,313,442,85500,16668
852,650,202,595,145000,16669
23,18,5,-,106300,16670
209,175,34,675,92000,16671
102,71,31,650,60500,16672
2172,1623,549,770,126600,16673
266,230,36,821,70000,16674
111,111,0,-,89300,16677
1071,824,247,651,92600,16678
348,282,66,543,74400,16679
173,146,27,850,120000,16680
28,17,11,-,-,16682
152,124,28,383,168800,16683
70,59,11,-,166100,16685
5199,3692,1507,646,121300,16686
184,177,7,-,157100,16689
132,116,16,835,152800,16691
282,226,56,633,72700,16692
1548,1185,363,615,114200,16693
77,70,7,-,69200,16694
431,353,78,638,136700,16695
0,0,0,-,-,16699
7357,4936,2421,616,77900,16701
453,390,63,638,76000,16720
56,47,9,725,52500,16724
92,73,19,-,-,16725
249,222,27,542,75700,16726
68,54,14,-,74400,16727
27,27,0,-,49200,16728
368,291,77,616,69800,16729
50,44,6,-,75600,16730
1084,864,220,574,69500,16731
187,164,23,458,74700,16732
102,87,15,-,70900,16733
104,94,10,-,63300,16734
2500,1870,630,605,69500,16735
568,471,97,671,85300,16738
450,339,111,645,60200,16740
1610,1216,394,713,84500,16743
123,123,0,-,75000,16744
231,216,15,675,87500,16745
522,417,105,709,86900,16746
1060,840,220,533,87400,16748
1618,1281,337,669,87100,16749
196,148,48,572,64100,16750
17703,7119,10584,989,269100,16801
14,0,14,-,-,16802
10050,4456,5594,1076,277300,16803
365,325,40,784,164200,16820
100,100,0,-,200000,16821
785,613,172,580,112700,16822
11093,8272,2821,788,175700,16823
110,70,40,-,75000,16825
240,206,34,679,164900,16826
1867,1530,337,977,263200,16827
1945,1680,265,1015,223400,16828
265,241,24,606,109700,16829
5791,3935,1856,581,92200,16830
179,148,31,721,184800,16832
2211,1658,553,639,90700,16833
73,73,0,-,-,16834
73,59,14,750,121300,16835
429,387,42,795,98800,16836
51,51,0,-,55700,16837
730,645,85,755,89400,16838
240,222,18,-,65400,16839
203,169,34,-,79500,16840
2175,1782,393,742,148100,16841
286,237,49,-,60100,16843
1063,943,120,821,163000,16844
286,248,38,556,88500,16845
127,104,23,-,85200,16847
127,90,37,647,122700,16848
173,160,13,-,151200,16849
312,284,28,-,214300,16851
119,102,17,1018,143300,16852
100,33,67,725,159900,16853
286,230,56,786,143000,16854
178,178,0,-,51400,16855
1432,1240,192,1050,103600,16858
225,179,46,731,113800,16859
157,101,56,-,120600,16860
116,109,7,-,74700,16861
251,188,63,802,92500,16863
722,698,24,947,188000,16865
3676,2476,1200,520,107300,16866
187,172,15,-,191800,16868
2599,2268,331,779,275500,16870
19,17,2,-,57500,16871
479,352,127,725,144200,16872
537,490,47,671,121200,16874
1559,1245,314,848,237600,16875
119,93,26,792,79300,16876
734,650,84,1523,176700,16877
741,658,83,620,91400,16878
160,126,34,882,73100,16879
906,796,110,-,84600,16881
154,119,35,669,147700,16882
3945,3090,855,693,159100,16901
138,126,12,-,134400,16911
731,501,230,641,116400,16912
818,682,136,718,152700,16914
2247,1674,573,752,119800,16915
454,381,73,679,157200,16917
811,527,284,666,79500,16920
188,147,41,717,119100,16921
805,595,210,662,94200,16922
601,490,111,638,119400,16923
1292,1098,194,811,135000,16925
363,308,55,875,173600,16926
245,200,45,661,94400,16927
514,375,139,666,92600,16928
962,741,221,718,140800,16929
483,382,101,803,128800,16930
273,217,56,979,190300,16932
2825,1731,1094,718,163000,16933
556,460,96,833,193100,16935
688,539,149,788,128800,16936
88,72,16,-,95700,16937
260,220,40,875,161800,16938
143,113,30,1156,86000,16939
100,63,37,442,96300,16940
39,37,2,-,70700,16941
299,237,62,1000,108900,16942
193,153,40,619,124300,16943
1032,750,282,787,114300,16946
1817,1343,474,650,144800,16947
585,431,154,516,114300,16948
1341,1011,330,585,96500,16950
264,192,72,378,156100,17002
4252,3198,1054,826,176400,17003
1634,1151,483,570,152600,17004
157,116,41,704,110500,17005
333,262,71,714,141300,17006
2160,1897,263,894,246500,17007
850,563,287,689,85300,17009
53,0,53,-,-,17010
13533,9601,3932,979,192000,17011
14080,8335,5745,871,177700,17013
8132,7179,953,901,219400,17015
366,145,221,2216,113900,17016
683,559,124,677,151900,17017
1708,1416,292,816,187800,17018
7036,5660,1376,849,213400,17019
3592,2775,817,775,166700,17020
378,270,108,565,127300,17021
10888,7214,3674,971,187700,17022
1361,963,398,627,131700,17023
784,665,119,742,175200,17024
7001,5201,1800,908,178400,17025
1318,1135,183,536,186600,17026
237,145,92,1200,186900,17027
1408,1250,158,733,163500,17028
91,63,28,-,47000,17029
346,277,69,671,119200,17030
3285,2713,572,628,164000,17032
6414,3663,2751,954,246000,17033
1089,505,584,842,91400,17034
391,279,112,475,114800,17035
9430,6828,2602,1003,219800,17036
348,282,66,866,153700,17037
3271,2426,845,830,176500,17038
53,53,0,-,-,17039
865,742,123,784,168000,17040
52,52,0,-,222900,17041
14523,9783,4740,849,165900,17042
2890,1501,1389,895,144400,17043
9023,5788,3235,642,92500,17044
1235,979,256,651,161600,17045
11592,7004,4588,723,134600,17046
873,651,222,686,162500,17047
1498,1124,374,756,105800,17048
1079,930,149,608,126400,17049
14919,11668,3251,1136,255800,17050
1958,1530,428,606,121300,17051
604,517,87,646,89100,17052
2183,1728,455,845,164100,17053
15526,10753,4773,978,197600,17055
19,19,0,-,47900,17056
9395,6369,3026,839,139200,17057
660,426,234,582,113900,17058
3204,2374,830,652,151000,17059
469,374,95,596,93800,17060
3028,2141,887,670,127500,17061
1537,1338,199,665,168700,17062
1360,1007,353,750,97900,17063
366,298,68,951,269000,17064
1740,1283,457,790,170000,17065
2343,1542,801,564,78900,17066
5531,4436,1095,776,168800,17067
1531,1166,365,840,170200,17068
56,23,33,689,128100,17069
6914,5105,1809,786,173600,17070
77,67,10,820,71900,17071
70,17,53,-,-,17072
1992,1660,332,739,172600,17073
2874,2126,748,685,157300,17074
39,35,4,-,59000,17075
16,16,0,-,-,17076
35,19,16,-,-,17077
8900,6190,2710,880,187900,17078
103,92,11,769,104200,17080
232,145,87,234,110200,17081
1247,937,310,642,145000,17082
18,11,7,-,-,17083
1731,1345,386,755,162200,17084
867,623,244,685,156400,17086
940,804,136,853,172700,17087
359,243,116,921,156100,17088
2379,2164,215,668,163400,17090
511,251,260,1305,144400,17093
1024,779,245,629,136600,17094
344,301,43,907,72200,17097
988,741,247,706,83700,17098
574,442,132,696,84000,17099
1422,53,1369,770,168400,17101
4028,1197,2831,805,141900,17102
4476,1864,2612,804,77900,17103
7325,3028,4297,789,75100,17104
10499,5474,5025,937,152200,17109
10612,6436,4176,979,160900,17110
12647,8498,4149,1004,168900,17111
14487,12015,2472,1059,204500,17112
3896,2401,1495,844,103100,17113
0,0,0,-,-,17120
10806,5355,5451,821,164400,17201
11024,8743,2281,986,198700,17202
65,37,28,-,139100,17210
165,141,24,766,141100,17211
264,238,26,-,174100,17212
205,157,48,589,122300,17213
445,276,169,690,188000,17214
78,62,16,-,167900,17215
54,31,23,1010,162500,17217
118,103,15,-,138800,17219
169,95,74,-,177700,17220
244,173,71,809,122500,17221
4870,3986,884,744,185200,17222
152,95,57,591,141400,17223
698,606,92,546,156200,17224
7162,5350,1812,943,203000,17225
420,356,64,694,155800,17228
500,417,83,663,129900,17229
2242,1606,636,630,144000,17233
185,90,95,1103,154400,17235
3461,2663,798,770,175300,17236
636,469,167,942,145200,17237
639,535,104,594,168800,17238
99,95,4,-,127900,17239
1255,1017,238,913,191900,17240
4558,3601,957,825,165000,17241
567,422,145,442,111300,17243
929,808,121,886,169000,17244
67,44,23,-,-,17246
160,15,145,1248,-,17247
169,153,16,842,85400,17249
58,31,27,-,-,17250
56,45,11,-,168800,17251
1691,1308,383,669,149300,17252
123,97,26,722,92800,17253
0,0,0,-,-,17254
469,390,79,734,123200,17255
65,65,0,-,149200,17256
10938,6870,4068,904,166900,17257
427,366,61,811,116700,17260
0,0,0,-,-,17261
556,428,128,753,166200,17262
157,132,25,-,179300,17263
929,759,170,583,125200,17264
240,204,36,953,131000,17265
188,138,50,733,171600,17266
1114,880,234,817,181600,17267
11911,8082,3829,805,162700,17268
27,27,0,-,-,17270
102,82,20,-,165000,17271
238,201,37,-,14400,17272
1596,1404,192,983,178600,17301
985,783,202,1065,181400,17302
1053,842,211,841,183300,17304
119,88,31,1188,158700,17306
2131,1534,597,849,198400,17307
713,596,117,765,216900,17309
94,68,26,775,134100,17311
4268,2971,1297,855,155000,17313
2030,1597,433,958,174900,17314
10159,8484,1675,882,154800,17315
3001,2640,361,900,202500,17316
245,183,62,950,139300,17317
176,100,76,1088,130400,17318
4539,3728,811,1036,168800,17319
2968,2675,293,885,218300,17320
841,723,118,1023,226200,17321
2252,1906,346,1213,175700,17322
1544,1342,202,753,182000,17324
10459,7443,3016,832,219200,17325
2952,2384,568,927,224600,17327
910,783,127,918,248400,17329
20403,14871,5532,902,174200,17331
2726,2082,644,915,239400,17339
4250,3406,844,862,205600,17340
26,26,0,-,-,17343
1581,943,638,810,153900,17344
3329,2430,899,879,146600,17345
2266,1945,321,1059,170400,17347
2701,2419,282,1018,271700,17349
4944,3831,1113,1075,168600,17350
493,409,84,869,221400,17352
1447,1228,219,857,187400,17353
109,69,40,883,189800,17355
8256,6245,2011,882,173300,17356
2481,2166,315,1111,205900,17360
2467,1966,501,869,226700,17361
5056,4306,750,818,190200,17362
3471,3118,353,884,221500,17363
1510,1381,129,647,174100,17364
914,829,85,611,201700,17365
2064,1665,399,787,143300,17366
3024,2385,639,879,152600,17368
1976,1729,247,852,154500,17370
125,107,18,-,135400,17371
1589,1247,342,831,205300,17372
6603,1756,4847,793,63000,17401
13707,9361,4346,994,172200,17402
14808,9473,5335,866,152600,17403
13808,9721,4087,874,132000,17404
9249,7120,2129,1050,162500,17406
752,691,61,1054,169000,17407
9280,7198,2082,1015,168200,17408
1761,1062,699,867,171700,17501
1011,846,165,1194,177700,17502
533,333,200,734,355600,17505
35,16,19,-,-,17507
225,209,16,-,241200,17508
1305,938,367,908,230500,17509
7163,4784,2379,776,141400,17512
1809,1559,250,840,210400,17516
5908,4614,1294,895,193000,17517
464,359,105,1151,212100,17518
2171,1486,685,899,229200,17519
1916,1650,266,1087,173500,17520
12929,8912,4017,870,178200,17522
1871,1431,440,944,227800,17527
1470,1050,420,811,269200,17529
1118,955,163,879,185400,17532
784,422,362,1053,279700,17535
925,798,127,708,275800,17536
2397,2012,385,731,227700,17538
3602,2311,1291,988,221300,17540
16610,12036,4574,1068,220700,17543
8200,6574,1626,991,192900,17545
2720,1992,728,923,163200,17547
300,131,169,1073,173900,17550
3968,2380,1588,1147,168400,17551
8147,5744,2403,1020,180400,17552
3295,1970,1325,941,188600,17554
2127,1729,398,812,252200,17555
5092,3171,1921,971,229500,17557
2084,1823,261,1086,145100,17560
1310,915,395,964,234700,17562
1204,919,285,1040,210200,17563
1035,888,147,1129,218200,17565
4049,3074,975,1044,217100,17566
1908,1668,240,1038,196500,17569
115,51,64,-,-,17570
1356,888,468,780,251100,17572
59,59,0,-,-,17576
2595,2071,524,840,189000,17578
2030,1622,408,1046,218100,17579
302,229,73,696,180400,17581
814,752,62,706,226200,17582
3817,2666,1151,1187,201000,17584
20473,14719,5754,1088,225800,17601
19006,9938,9068,913,164200,17602
25120,14311,10809,915,149700,17603
257,0,257,1576,-,17606
17913,10203,7710,767,124000,17701
4415,3280,1135,813,141000,17702
688,516,172,698,103400,17721
14,13,1,-,112500,17723
1932,1270,662,643,130600,17724
36,36,0,-,216700,17727
2071,1777,294,820,163700,17728
26,26,0,-,80000,17729
62,0,62,-,-,17730
117,110,7,-,400000,17731
2555,1967,588,721,159700,17737
24,22,2,-,120500,17739
4965,3683,1282,728,136800,17740
8,4,4,-,-,17742
1238,995,243,702,146800,17744
7019,4243,2776,714,131300,17745
1000,842,158,728,152000,17747
133,123,10,929,53700,17748
151,110,41,775,100000,17749
55,50,5,-,140900,17750
2712,2274,438,759,137700,17751
1744,1251,493,797,139900,17752
5023,4048,975,771,189400,17754
4234,3374,860,736,153300,17756
347,312,35,977,176700,17758
302,264,38,766,96800,17760
210,172,38,788,134100,17762
95,88,7,-,108300,17763
903,622,281,470,50000,17764
419,331,88,675,153600,17765
67,48,19,715,98500,17767
139,123,16,-,136800,17768
1280,1131,149,850,157300,17771
912,752,160,610,161200,17772
544,448,96,692,162500,17774
130,107,23,709,152100,17776
3128,2222,906,649,159700,17777
43,36,7,625,85000,17778
119,31,88,-,-,17779
6929,4500,2429,639,118600,17801
760,635,125,745,155000,17810
512,372,140,691,115700,17812
774,603,171,853,125600,17813
1904,1567,337,750,153100,17814
11494,7157,4337,757,158200,17815
2299,1831,468,778,146800,17820
7513,5416,2097,708,175700,17821
0,0,0,-,-,17822
482,367,115,725,171400,17823
1782,1524,258,809,199800,17824
312,245,67,643,137900,17827
75,66,9,731,113900,17829
786,658,128,691,135300,17830
319,301,18,-,69600,17832
1584,994,590,670,86700,17834
117,79,38,824,96300,17835
92,75,17,840,129200,17836
6515,4125,2390,709,196300,17837
199,199,0,-,52500,17840
1719,1381,338,645,116300,17841
3134,2417,717,636,152900,17842
3908,3034,874,720,166100,17844
726,584,142,725,153200,17845
1595,1286,309,706,171200,17846
4918,3478,1440,619,134800,17847
322,227,95,595,28600,17850
3640,2349,1291,607,44900,17851
1143,893,250,638,163900,17853
426,334,92,944,141400,17855
1237,922,315,775,147700,17856
3120,2331,789,759,139500,17857
1141,960,181,829,154300,17859
963,849,114,770,171000,17860
54,50,4,-,119400,17861
187,93,94,707,131900,17862
695,533,162,683,168300,17864
31,25,6,-,78100,17865
3486,2593,893,586,69200,17866
57,45,12,1375,211400,17867
479,390,89,901,166900,17868
5615,3900,1715,765,162300,17870
4344,2770,1574,574,50200,17872
834,465,369,702,156000,17876
534,447,87,758,175900,17878
54,28,26,675,-,17880
619,523,96,561,74900,17881
103,58,45,675,65000,17884
65,52,13,-,164600,17885
465,196,269,931,126400,17886
166,166,0,-,65900,17887
115,100,15,633,86000,17888
896,796,100,765,200600,17889
9822,7108,2714,620,87800,17901
166,154,12,-,75000,17920
2796,2125,671,477,90800,17921
1962,1782,180,919,166300,17922
195,146,49,625,74700,17923
158,111,47,690,87800,17925
681,469,212,744,103300,17929
200,140,60,760,80400,17930
2202,1650,552,814,78800,17931
56,40,16,-,-,17933
188,172,16,642,29100,17934
661,521,140,644,27300,17935
289,239,50,617,107800,17936
929,783,146,606,135600,17938
319,261,58,585,166100,17941
67,55,12,-,120100,17943
76,68,8,-,65000,17944
72,70,2,-,54700,17945
43,43,0,-,29800,17946
1926,1318,608,675,31600,17948
126,116,10,-,35300,17949
99,92,7,-,90000,17951
98,93,5,-,73800,17952
220,169,51,636,65400,17953
1978,1297,681,609,56800,17954
173,168,5,-,84300,17957
619,491,128,575,52700,17959
1584,1424,160,744,172900,17960
2839,2191,648,676,163200,17961
3475,2771,704,696,151500,17963
312,256,56,475,139200,17964
888,675,213,714,76100,17965
1081,932,149,629,125300,17967
94,74,20,775,88800,17968
1392,933,459,622,63500,17970
4621,3499,1122,725,130000,17972
152,95,57,627,133800,17974
2775,1820,955,630,34700,17976
117,61,56,658,115600,17978
100,100,0,-,120000,17979
1238,1031,207,666,84800,17980
1054,821,233,592,73200,17981
210,171,39,913,75800,17982
630,408,222,640,120300,17983
509,451,58,1063,158900,17985
2148,1795,353,1407,196700,18011
6710,4974,1736,951,195300,18013
4336,3640,696,992,196000,18014
10950,5954,4996,941,156400,18015
0,0,0,-,-,18016
15243,10493,4750,1109,226200,18017
13581,7164,6417,988,163400,18018
7604,6624,980,1215,243400,18020
296,204,92,581,135500,18030
3807,2577,1230,1558,285300,18031
3821,2535,1286,826,161400,18032
2786,2296,490,1312,296800,18034
59,59,0,-,-,18035
5075,4394,681,826,281400,18036
3106,2478,628,967,185500,18037
1157,1000,157,913,199800,18038
6187,5497,690,912,253800,18040
2031,1573,458,926,216900,18041
15292,8306,6986,962,146000,18042
10481,8653,1828,1198,228800,18045
16,16,0,-,-,18046
7327,5160,2167,1010,195200,18049
1361,1202,159,1468,278600,18051
11034,6792,4242,1038,180300,18052
828,692,136,1063,208300,18053
1582,1313,269,923,275500,18054
4711,3464,1247,1003,207400,18055
313,302,11,-,31700,18056
3772,3391,381,926,169400,18058
443,443,0,-,256900,18059
10179,8571,1608,1287,243100,18062
315,276,39,-,205100,18063
9421,7097,2324,960,251800,18064
2369,2060,309,1094,259200,18066
7517,5900,1617,988,199500,18067
0,0,0,-,-,18068
2995,2657,338,1125,277700,18069
348,247,101,1143,149500,18070
4059,3163,896,794,154400,18071
2464,1729,735,878,164500,18072
3649,3243,406,954,261300,18073
2324,2123,201,1169,263800,18074
1178,800,378,851,188800,18076
897,755,142,1065,307900,18077
2850,2298,552,1058,290700,18078
171,154,17,-,153000,18079
4734,3672,1062,862,177900,18080
151,115,36,-,-,18081
167,115,52,1040,193500,18083
384,325,59,890,193900,18085
190,165,25,-,177400,18086
231,98,133,1079,165600,18087
3253,2851,402,885,190800,18088
2352,1654,698,852,197500,18091
1214,1118,96,1130,303900,18092
1544,172,1372,698,65200,18101
16064,5235,10829,892,91700,18102
17705,11500,6205,997,163000,18103
16351,11523,4828,1232,218800,18104
0,0,0,-,-,18105
3146,2255,891,1280,243800,18106
6603,3124,3479,960,122900,18109
0,0,0,-,-,18195
9735,5403,4332,737,90900,18201
4658,2752,1906,792,120600,18202
2980,2503,477,1370,153000,18210
504,438,66,825,221800,18211
76,69,7,-,114100,18212
818,754,64,639,136600,18214
473,347,126,802,78300,18216
1030,654,376,622,48800,18218
623,471,152,780,146600,18219
161,154,7,-,48800,18220
196,146,50,-,65000,18221
3556,3336,220,-,180300,18222
83,83,0,-,-,18223
2500,1891,609,741,82800,18224
102,102,0,-,26700,18225
3410,2693,717,857,164700,18229
49,39,10,783,90700,18230
208,116,92,780,84800,18231
1764,1162,602,626,49200,18232
135,126,9,-,99500,18234
7835,6207,1628,765,160400,18235
1436,993,443,658,87900,18237
158,93,65,867,-,18239
1613,1177,436,741,94100,18240
325,182,143,678,90000,18241
85,81,4,-,-,18242
139,122,17,729,103400,18244
182,147,35,-,71900,18245
76,32,44,869,-,18246
253,167,86,817,110300,18248
1535,1362,173,950,198800,18249
1119,722,397,910,118300,18250
16,0,16,-,-,18251
4610,2863,1747,709,79400,18252
462,320,142,823,94800,18254
1855,1525,330,840,124000,18255
175,133,42,806,91000,18256
9549,6768,2781,1120,167900,18301
5909,4965,944,1146,155300,18302
624,504,120,946,155600,18321
856,624,232,917,177000,18322
84,84,0,-,368400,18323
3298,2775,523,1328,125500,18324
832,680,152,863,175500,18325
1732,1247,485,776,182500,18326
257,113,144,1083,183600,18327
2649,2394,255,1248,154700,18328
2706,2438,268,1256,167700,18330
214,197,17,-,138000,18331
1123,903,220,780,185100,18332
191,136,55,-,147100,18333
1548,1361,187,1320,154700,18334
312,237,75,1741,171500,18335
1576,1130,446,949,200200,18336
5332,4516,816,1066,230400,18337
77,77,0,-,318100,18340
218,119,99,-,120800,18342
1652,1227,425,1045,230500,18343
1358,810,548,881,155000,18344
883,746,137,988,152000,18346
1293,1141,152,943,166200,18347
96,96,0,-,240400,18349
702,612,90,832,168400,18350
176,136,40,1077,162500,18351
368,283,85,-,206600,18352
4154,3765,389,862,183300,18353
391,342,49,-,206600,18354
372,266,106,1399,225400,18355
40,40,0,-,204500,18356
81,30,51,-,-,18357
9648,6572,3076,989,199600,18360
359,276,83,1457,162900,18370
277,226,51,-,183000,18371
863,700,163,918,179500,18372
2965,2388,577,693,152600,18403
960,797,163,947,196800,18405
5785,3777,2008,634,105100,18407
8617,6982,1635,1012,222300,18411
102,28,74,-,219600,18413
2106,1847,259,804,205900,18414
500,395,105,856,268200,18415
450,393,57,700,210800,18417
1803,1503,300,771,167800,18419
16,16,0,-,-,18420
2114,1588,526,704,123000,18421
2105,1882,223,1087,152000,18424
470,421,49,1158,165300,18425
1865,1515,350,951,160600,18426
45,22,23,-,-,18427
4745,3842,903,1042,192200,18428
2,2,0,-,-,18430
5019,3562,1457,805,170400,18431
2632,2132,500,718,146100,18433
1700,1150,550,683,142600,18434
304,274,30,-,257300,18435
4861,4112,749,990,185100,18436
90,76,14,675,172700,18437
513,490,23,-,221600,18438
207,163,44,713,175900,18439
121,78,43,648,119100,18441
215,176,39,894,170300,18443
5263,4427,836,831,211500,18444
968,795,173,892,178600,18445
1376,1154,222,641,158600,18446
4512,3001,1511,748,161300,18447
294,271,23,-,261400,18451
2374,1723,651,625,158400,18452
448,405,43,783,172400,18453
20,17,3,-,-,18454
33,30,3,-,140600,18455
161,111,50,875,183800,18456
72,62,10,-,208100,18457
1138,911,227,988,214100,18458
3,3,0,-,-,18459
99,91,8,-,-,18460
158,148,10,763,134600,18461
147,129,18,600,147900,18462
88,83,5,-,164400,18463
595,521,74,1266,211300,18464
559,473,86,763,146900,18465
5418,4076,1342,1234,121300,18466
95,63,32,-,191500,18469
806,702,104,698,221700,18470
217,190,27,-,351700,18471
1579,1201,378,650,174300,18472
265,187,78,738,109200,18473
535,84,451,405,94400,18503
8568,4697,3871,741,108900,18504
8215,4427,3788,724,103800,18505
2122,1686,436,760,159000,18507
5111,2677,2434,788,95100,18508
4680,2530,2150,800,123000,18509
4660,1822,2838,776,117400,18510
5371,3716,1655,747,137600,18512
2188,1297,891,738,117700,18517
3759,2401,1358,771,153700,18518
1993,1068,925,695,126700,18519
111,97,14,1600,351900,18602
8173,5617,2556,726,116400,18603
1477,1347,130,1148,145700,18610
6292,4883,1409,869,186700,18612
1057,793,264,582,161400,18614
724,571,153,788,176400,18615
251,190,61,575,133600,18616
727,417,310,598,75200,18617
1549,1257,292,974,171800,18618
129,109,20,1150,128100,18619
1973,1764,209,777,151900,18621
98,83,15,-,102500,18622
1091,834,257,721,153800,18623
153,153,0,-,285900,18624
194,142,52,615,195800,18625
203,195,8,725,198400,18626
117,101,16,713,88700,18628
636,528,108,870,165700,18629
1197,856,341,815,168000,18630
550,412,138,890,134800,18631
236,178,58,781,78200,18632
5848,3602,2246,649,85000,18634
1552,1159,393,719,132500,18635
508,417,91,783,120500,18636
7446,4916,2530,788,119800,18640
2554,2049,505,712,111700,18641
1939,1479,460,777,138200,18642
5312,3654,1658,758,135200,18643
3168,2332,836,726,153500,18644
3769,2365,1404,688,83600,18651
39,39,0,-,154200,18653
2403,2017,386,689,160700,18655
926,785,141,715,185200,18656
4805,3707,1098,767,166700,18657
1462,1261,201,691,155200,18660
2233,1918,315,851,150500,18661
1004,85,919,581,165600,18701
15542,8535,7007,766,84700,18702
13521,8205,5316,768,123200,18704
6294,3979,2315,697,91900,18705
6905,4741,2164,638,85100,18706
6072,5495,577,610,193600,18707
3378,2907,471,790,176700,18708
1472,875,597,575,91900,18709
3437,2579,858,776,166400,18801
2392,1785,607,496,139800,18810
696,627,69,1024,205800,18812
70,56,14,775,133300,18814
62,58,4,-,119300,18816
75,59,16,917,142200,18817
527,439,88,609,188600,18818
570,322,248,699,152600,18821
1459,1042,417,740,113200,18822
101,68,33,340,115400,18823
615,473,142,944,164900,18824
46,46,0,-,118200,18825
663,559,104,677,200300,18826
133,75,58,857,168100,18828
314,268,46,755,155800,18829
281,216,65,819,145300,18830
510,408,102,756,132900,18831
701,547,154,760,139100,18832
863,720,143,738,153400,18833
1366,1103,263,783,161700,18834
1171,954,217,911,148600,18837
4790,3240,1550,748,136700,18840
114,108,6,-,123900,18842
153,127,26,-,102100,18843
761,612,149,844,175000,18844
129,112,17,1063,155400,18845
370,327,43,955,194100,18846
2316,1758,558,700,122100,18847
3716,2609,1107,733,155800,18848
912,710,202,788,126400,18850
319,260,59,1054,123000,18851
1578,1316,262,739,170300,18853
558,440,118,957,154500,18854
10220,7143,3077,1379,412300,18901
7512,6680,832,1570,467300,18902
72,72,0,-,353700,18912
49,26,23,-,-,18913
7632,6630,1002,1293,363900,18914
277,238,39,-,251900,18915
899,449,450,1044,311900,18917
179,169,10,-,291700,18920
294,289,5,-,412000,18923
2383,2184,199,1227,459100,18925
3154,3002,152,1762,431900,18929
1183,1015,168,1181,379500,18930
174,156,18,-,386000,18932
15,15,0,-,-,18935
0,0,0,-,-,18936
6060,5042,1018,1454,574400,18938
10883,9175,1708,1457,455300,18940
1223,987,236,1047,380300,18942
9404,7312,2092,1174,298400,18944
2305,2143,162,1099,418000,18947
62,62,0,-,544100,18950
13459,10787,2672,999,243300,18951
3115,3050,65,1946,429600,18954
653,446,207,910,231400,18955
4986,3855,1131,1128,284900,18960
169,132,37,1072,277300,18962
5220,4062,1158,933,271500,18964
14145,12008,2137,1482,349100,18966
5900,4230,1670,990,263700,18969
340,246,94,900,226200,18970
1601,1282,319,1178,386500,18972
16361,12019,4342,1342,303200,18974
7223,5852,1371,1312,389000,18976
1512,1396,116,1538,596000,18977
217,196,21,-,490700,18980
6317,5190,1127,1121,251400,19001
12124,9189,2935,1230,419600,19002
5633,3484,2149,1296,309000,19003
3795,3056,739,1361,479000,19004
7978,6298,1680,1134,382700,19006
7913,4219,3694,913,190900,19007
7233,6277,956,1215,344600,19008
234,140,94,1167,463000,19009
7240,4762,2478,1476,617800,19010
2260,1983,277,1085,229900,19012
12177,4484,7693,822,67900,19013
7841,6664,1177,1031,231900,19014
6348,4787,1561,1009,164200,19015
63,63,0,-,465000,19017
9602,6068,3534,1012,154600,19018
21967,12490,9477,1137,257100,19020
3632,2572,1060,974,200700,19021
1334,562,772,956,103100,19022
7459,4058,3401,971,91700,19023
2058,1730,328,1962,427000,19025
11899,7738,4161,1070,185200,19026
8469,5120,3349,1023,276500,19027
1435,878,557,919,139100,19029
4579,3409,1170,1048,244300,19030
1727,1312,415,1314,346800,19031
2313,1649,664,1294,108800,19032
3176,2441,735,1112,207500,19033
1990,1612,378,1171,487100,19034
1512,1309,203,1479,819000,19035
5163,3724,1439,1028,131600,19036
11140,9442,1698,1151,279000,19038
7841,5640,2201,1142,273700,19040
2417,1459,958,1525,621800,19041
1049,755,294,1093,174000,19043
6664,4370,2294,1238,261700,19044
6935,4911,2024,1154,335500,19046
12977,9551,3426,1236,346800,19047
10752,6509,4243,901,146300,19050
9561,7714,1847,1130,285300,19053
5975,4409,1566,1123,229600,19054
4691,3983,708,1084,206400,19055
5556,3954,1602,1137,247100,19056
6215,4581,1634,1097,207100,19057
3797,3689,108,1732,425300,19060
7566,4885,2681,1002,172800,19061
14510,10444,4066,1214,366200,19063
8506,7869,637,1204,295500,19064
1773,1608,165,2219,646100,19066
19735,15732,4003,1258,359700,19067
2765,2066,699,934,222300,19070
3996,3089,907,1450,507000,19072
7817,6208,1609,1579,418200,19073
2000,1598,402,927,164100,19074
2749,2384,365,1032,314600,19075
2591,1635,956,925,196100,19076
4353,3068,1285,919,178800,19078
3562,2464,1098,964,108100,19079
3376,2752,624,1136,281000,19081
13884,6516,7368,911,111600,19082
13159,11543,1616,1091,306800,19083
1901,1752,149,2207,816300,19085
4153,3673,480,1213,322100,19086
11942,9264,2678,1479,514700,19087
7227,5143,2084,1232,251500,19090
1565,993,572,889,167200,19094
2870,1500,1370,1488,308500,19095
5322,4044,1278,1491,494000,19096
2996,833,2163,1996,447000,19102
14496,4677,9819,1615,500600,19103
16002,3242,12760,932,117600,19104
6220,2863,3357,1745,473400,19106
7181,1404,5777,1214,342200,19107
0,0,0,-,-,19109
23930,13874,10056,958,171900,19111
0,0,0,-,-,19112
56,37,19,-,162000,19113
12783,7944,4839,1071,188000,19114
13648,7779,5869,944,236500,19115
12662,7473,5189,937,236600,19116
4388,2016,2372,1450,489200,19118
11859,7526,4333,956,246600,19119
23294,12660,10634,965,97600,19120
12501,3761,8740,781,82500,19121
6494,2703,3791,796,162500,19122
7089,2217,4872,1259,327200,19123
22910,11650,11260,883,96000,19124
9543,5922,3621,1038,218300,19125
5842,3485,2357,868,144800,19126
2395,1041,1354,1445,224100,19127
15501,9017,6484,1290,239300,19128
4468,2155,2313,1299,205500,19129
12655,5248,7407,1376,360000,19130
17863,8436,9427,965,111700,19131
14134,6581,7553,819,50600,19132
9507,3872,5635,729,49700,19133
20048,10373,9675,871,83600,19134
11784,7528,4256,896,114800,19135
12059,7294,4765,867,146200,19136
2873,2195,678,1000,129100,19137
11597,8300,3297,952,114700,19138
16636,7249,9387,844,76300,19139
18927,7926,11001,816,62000,19140
12651,6046,6605,808,102000,19141
9672,5188,4484,929,80900,19142
25675,12865,12810,863,85800,19143
17380,6476,10904,865,130500,19144
18093,11055,7038,947,165000,19145
16446,8744,7702,1096,287800,19146
16673,8878,7795,1216,339300,19147
19150,12833,6317,1033,174000,19148
18920,11122,7798,1085,128800,19149
9754,7050,2704,986,160100,19150
12234,8133,4101,1012,128900,19151
12804,8082,4722,982,187400,19152
5512,3309,2203,1074,137800,19153
12092,9731,2361,1136,196000,19154
2633,1997,636,1351,386000,19301
1033,730,303,971,244000,19310
2880,2226,654,1333,347800,19311
4364,3794,570,1461,607900,19312
85,55,30,-,212000,19316
3704,3062,642,1648,477200,19317
85,85,0,-,-,19319
19593,14113,5480,1137,228200,19320
2010,1690,320,1153,298000,19330
2802,1761,1041,1472,540100,19333
17833,14296,3537,1207,327800,19335
6805,4130,2675,1416,354000,19341
7410,5293,2117,1819,432400,19342
2752,2438,314,1626,391500,19343
4200,3147,1053,1220,253700,19344
0,0,0,-,-,19345
8413,6024,2389,1124,389300,19348
4148,3608,540,1448,377800,19350
2822,2611,211,1131,341200,19352
9502,7232,2270,1541,450200,19355
207,66,141,1164,172700,19358
2034,1693,341,852,211600,19362
5762,4196,1566,955,261300,19363
2635,1953,682,991,208400,19365
8,8,0,-,-,19367
687,399,288,1621,241500,19372
1003,908,95,1258,562600,19373
281,142,139,1103,324700,19374
32,0,32,-,-,19375
20356,14604,5752,1387,380100,19380
20077,14298,5779,1303,407100,19382
0,0,0,-,-,19383
4865,3720,1145,1047,301000,19390
16270,7259,9011,1076,172900,19401
17923,13019,4904,1319,266600,19403
2256,1214,1042,1023,203300,19405
10178,6382,3796,1341,298500,19406
7153,5477,1676,1720,426700,19422
5096,4791,305,1624,471000,19425
12338,10819,1519,1342,346100,19426
7799,4376,3423,1467,304300,19428
43,43,0,-,189900,19435
380,74,306,1696,366700,19436
360,360,0,-,892200,19437
9361,7092,2269,1383,331300,19438
7256,5082,2174,973,284100,19440
0,0,0,-,-,19442
4294,3183,1111,1513,389900,19444
22147,14277,7870,1260,317500,19446
661,546,115,-,211700,19453
11194,8566,2628,1297,319500,19454
283,235,48,-,352200,19456
22,22,0,-,-,19457
16505,11998,4507,1189,296700,19460
5869,4442,1427,1421,337200,19462
18252,11765,6487,935,166800,19464
6649,5208,1441,1078,275800,19465
10202,7384,2818,1273,253700,19468
25,0,25,-,-,19472
5773,5068,705,946,313700,19473
332,294,38,-,230400,19474
4204,3030,1174,853,269700,19475
0,0,0,-,-,19477
264,7,257,2309,-,19492
440,230,210,821,186500,19501
466,367,99,881,174700,19503
2005,1770,235,870,264300,19504
1287,1008,279,956,221100,19505
2750,2445,305,793,216200,19506
1036,950,86,969,188600,19507
5960,5158,802,939,174700,19508
3115,2716,399,1116,190800,19510
25,25,0,-,181600,19511
7124,5362,1762,841,192600,19512
5574,4724,850,1128,232600,19518
0,0,0,-,-,19519
2375,1889,486,856,287000,19520
5424,4718,706,883,174500,19522
157,157,0,-,144600,19523
5628,5145,483,1070,303800,19525
4696,3570,1126,802,151800,19526
1378,1111,267,1029,247000,19529
4680,3008,1672,920,191300,19530
2384,1925,459,868,190300,19533
782,550,232,809,206800,19534
7,7,0,-,-,19535
243,140,103,867,138000,19536
15,15,0,-,-,19538
1795,1472,323,1091,202200,19539
4459,3682,777,843,233900,19540
1626,1398,228,955,216500,19541
0,0,0,-,-,19542
2258,1878,380,941,255300,19543
55,49,6,-,152900,19544
191,166,25,-,165000,19545
1695,1358,337,1157,237300,19547
114,72,42,1000,86000,19549
121,72,49,-,161100,19550
1838,1523,315,799,183400,19551
154,130,24,-,152900,19554
1354,1046,308,825,160400,19555
129,87,42,900,144300,19559
3256,2608,648,1193,141000,19560
1173,684,489,744,145800,19562
76,36,40,-,171900,19564
3523,2834,689,889,174500,19565
1972,1501,471,824,165300,19567
11519,4183,7336,759,69900,19601
6218,2225,3993,681,50800,19602
8033,3994,4039,885,71600,19604
7593,6528,1065,994,150300,19605
13318,10589,2729,1022,167500,19606
9696,6250,3446,965,148800,19607
8193,6716,1477,1174,224300,19608
3872,3184,688,965,154700,19609
6362,4592,1770,1210,230900,19610
3858,1920,1938,697,109600,19611
14348,11160,3188,1382,267700,19701
19350,12131,7219,1260,238800,19702
5913,3211,2702,1009,209400,19703
743,513,230,1027,190400,19706
5901,5214,687,1771,415100,19707
12810,11163,1647,1142,322400,19709
8,8,0,-,-,19710
19087,12168,6919,1158,293400,19711
11965,7424,4541,1035,201800,19713
0,0,0,-,-,19716
0,0,0,-,-,19717
21362,14752,6610,1072,186800,19720
330,284,46,1458,316300,19730
75,67,8,-,163500,19731
7,7,0,-,-,19732
101,73,28,-,-,19733
3795,3507,288,1379,311000,19734
17,0,17,-,-,19735
24,0,24,-,-,19736
5992,1565,4427,809,140400,19801
10251,5396,4855,950,148800,19802
8452,7242,1210,1311,350900,19803
6901,4848,2053,1048,190200,19804
15087,8218,6869,1032,174800,19805
5135,2752,2383,1062,287000,19806
3017,2213,804,1276,756300,19807
15398,12183,3215,1118,253300,19808
5967,3769,2198,1140,231500,19809
9792,8004,1788,1101,323400,19810
13688,7360,6328,1112,178500,19901
0,0,0,-,-,19902
12649,8611,4038,1040,205300,19904
1266,1234,32,1313,580400,19930
117,100,17,-,189800,19931
3577,2833,744,696,205000,19933
5053,4098,955,1408,226400,19934
94,60,34,881,186700,19936
3147,2620,527,1105,228100,19938
2496,2320,176,1191,262400,19939
2068,1549,519,822,185800,19940
917,687,230,848,177200,19941
4736,3881,855,1048,197800,19943
359,306,53,1109,690300,19944
2362,1680,682,1114,221300,19945
1811,1335,476,1074,174800,19946
6319,4387,1932,879,214400,19947
2601,2121,480,1005,205600,19950
737,665,72,1591,323200,19951
3794,2666,1128,849,201500,19952
1650,1402,248,876,207100,19953
583,492,91,1202,202400,19954
11,10,1,-,-,19955
5588,4227,1361,862,171600,19956
10894,9198,1696,1286,341000,19958
2443,1934,509,920,196600,19960
3980,3201,779,989,225600,19962
8046,5663,2383,920,203600,19963
344,263,81,806,265600,19964
11665,9415,2250,966,190200,19966
497,412,85,1239,290600,19967
4600,3811,789,1058,277700,19968
3635,2928,707,1160,334400,19970
6569,5490,1079,1222,388800,19971
9282,6667,2615,895,183400,19973
4056,2979,1077,1027,326900,19975
8649,6421,2228,1009,223200,19977
246,200,46,953,181600,19979
18764,6569,12195,1823,619300,20001
26217,10703,15514,1473,583300,20002
12394,5941,6453,1900,732700,20003
1163,480,683,2530,514600,20004
8172,1866,6306,1858,504900,20005
616,28,588,1786,235000,20006
11885,6454,5431,1857,945900,20007
15611,6377,9234,1903,740300,20008
27184,9761,17423,1744,614100,20009
12593,4549,8044,1435,582800,20010
24288,12567,11721,1162,486800,20011
5945,3833,2112,1231,572500,20012
6437,4487,1950,1626,953400,20015
13757,9403,4354,1915,873300,20016
7637,4367,3270,1446,439500,20017
7890,4427,3463,925,456100,20018
23499,8058,15441,957,249600,20019
21135,6326,14809,1039,276700,20020
7309,2868,4441,1454,377100,20024
14627,2833,11794,1021,244700,20032
4171,1535,2636,1881,369200,20036
6381,2348,4033,2062,616900,20037
0,0,0,-,-,20045
0,0,0,-,-,20052
0,0,0,-,-,20053
0,0,0,-,-,20057
0,0,0,-,-,20064
5675,5075,600,2303,492300,20105
2147,1890,257,1075,364500,20106
13089,5756,7333,1559,254300,20109
14098,9364,4734,1432,315600,20110
10060,7223,2837,1538,306700,20111
8059,7613,446,2003,447800,20112
2207,1593,614,1294,390500,20115
1148,728,420,961,507700,20117
2,0,2,-,-,20118
1587,1296,291,1318,378600,20119
13684,10210,3474,1810,458000,20120
9766,5950,3816,1780,364700,20121
5011,4607,404,2573,666100,20124
236,236,0,-,806800,20129
122,113,9,-,518800,20130
5411,4470,941,1310,484700,20132
1215,973,242,1077,381700,20135
8673,7723,950,2234,417800,20136
475,432,43,-,543100,20137
117,45,72,-,456700,20139
2009,1813,196,1702,438400,20141
381,339,42,-,649100,20143
424,367,57,1154,598700,20144
21557,15243,6314,1804,488000,20147
14185,11567,2618,2090,571100,20148
6792,5620,1172,1744,495800,20151
9937,8684,1253,2238,518100,20152
11168,9499,1669,2156,454500,20155
1367,1256,111,1614,522800,20158
12601,9277,3324,1724,352800,20164
11317,9121,2196,1824,485000,20165
3601,2219,1382,1759,378400,20166
7494,6805,689,2548,516000,20169
13308,9002,4306,1841,461200,20170
16795,10235,6560,1874,600100,20171
11257,8692,2565,1537,466500,20175
16989,12632,4357,1620,478100,20176
2423,2130,293,1755,458000,20180
2602,2368,234,1497,453600,20181
435,265,170,-,619100,20184
5581,3851,1730,1245,359400,20186
5594,4915,679,1680,428600,20187
8746,4135,4611,1789,448500,20190
11527,7767,3760,1603,470100,20191
5558,3958,1600,1897,626400,20194
654,616,38,1333,668800,20197
1045,782,263,820,398700,20198
0,0,0,-,-,20202
0,0,0,-,-,20204
0,0,0,-,-,20228
0,0,0,-,-,20230
0,0,0,-,-,20240
0,0,0,-,-,20245
0,0,0,-,-,20260
0,0,0,-,-,20307
310,15,295,1840,-,20317
0,0,0,-,-,20319
0,0,0,-,-,20373
0,0,0,-,-,20390
0,0,0,-,-,20405
0,0,0,-,-,20418
0,0,0,-,-,20427
0,0,0,-,-,20506
0,0,0,-,-,20510
0,0,0,-,-,20520
0,0,0,-,-,20535
0,0,0,-,-,20540
0,0,0,-,-,20551
0,0,0,-,-,20553
0,0,0,-,-,20560
0,0,0,-,-,20565
0,0,0,-,-,20566
0,0,0,-,-,20593
8842,6876,1966,1772,275500,20601
9929,6256,3673,1459,236900,20602
10920,8206,2714,1849,303800,20603
204,188,16,-,260900,20606
3714,3383,331,1714,368500,20607
273,224,49,1304,294900,20608
449,323,126,741,325000,20609
474,339,135,923,347000,20611
217,187,30,-,294800,20612
4690,4180,510,1382,349800,20613
183,183,0,-,339700,20615
2179,1927,252,1238,263100,20616
306,306,0,-,384500,20617
156,115,41,1233,314400,20618
4807,3136,1671,1580,279000,20619
586,503,83,1509,224100,20620
392,326,66,1671,311400,20621
1625,1400,225,964,330700,20622
892,887,5,-,287900,20623
510,404,106,1190,288800,20624
263,245,18,-,301500,20625
171,147,24,-,493800,20626
79,64,15,-,598200,20628
133,79,54,-,563700,20629
101,101,0,-,282700,20630
125,94,31,-,268500,20632
2766,1783,983,1150,249000,20634
3814,3287,527,1369,345100,20636
1747,1505,242,-,386400,20637
4587,4179,408,1690,430000,20639
3784,2949,835,1459,220700,20640
316,272,44,1808,356100,20645
6954,5738,1216,1262,354200,20646
5095,3768,1327,903,360300,20650
9190,5061,4129,1255,243900,20653
6641,5712,929,1683,233800,20657
356,248,108,1500,252900,20658
7703,6748,955,1406,296700,20659
28,0,28,-,-,20660
1058,978,80,1148,310900,20662
1292,907,385,1351,285200,20664
249,174,75,595,262100,20667
368,0,368,1859,-,20670
318,237,81,1361,481300,20674
760,712,48,-,317600,20675
1382,1111,271,1865,348900,20676
821,734,87,1092,392700,20677
4382,3353,1029,989,339800,20678
287,173,114,1226,235600,20680
525,446,79,-,318200,20684
2295,2009,286,1632,345200,20685
24,24,0,-,-,20686
120,103,17,-,354700,20687
900,427,473,2262,464500,20688
713,708,5,-,380900,20689
332,256,76,1336,407700,20690
457,409,48,-,348000,20692
369,308,61,1695,367200,20693
2784,2376,408,1735,321200,20695
0,0,0,-,-,20701
8802,5534,3268,1509,311000,20705
12243,8180,4063,1494,271000,20706
12127,7107,5020,1454,282400,20707
9664,3550,6114,1375,312400,20708
3403,835,2568,1217,177300,20710
2446,2233,213,845,319800,20711
3756,855,2901,1151,293100,20712
2003,1335,668,1638,282000,20714
8735,7891,844,2187,310800,20715
8446,5918,2528,1778,281200,20716
7372,6763,609,2362,377700,20720
9682,8636,1046,2104,378700,20721
1686,1196,490,1348,228200,20722
11428,7817,3611,1744,401200,20723
6581,4372,2209,1801,299500,20724
3458,2683,775,1475,320200,20732
1070,973,97,1840,317400,20733
12315,11042,1273,1931,276700,20735
3087,2887,200,1273,434000,20736
5879,2895,2984,1184,230400,20737
9604,4504,5100,1500,280500,20740
0,0,0,-,-,20742
14206,9076,5130,1238,201900,20743
18639,14442,4197,1495,286100,20744
10591,4534,6057,1244,218200,20745
11135,4356,6779,1361,206300,20746
14729,7733,6996,1239,205900,20747
14769,8156,6613,1263,235300,20748
874,788,86,1198,371900,20751
2447,2247,200,2556,435900,20754
2620,51,2569,2097,210200,20755
199,180,19,-,427300,20758
1543,1406,137,"3,500+",636300,20759
815,16,799,2328,-,20762
835,351,484,1626,335500,20763
1558,1345,213,1617,281100,20764
222,109,113,1155,503500,20765
2148,1984,164,2125,411600,20769
10257,4434,5823,1495,193000,20770
16054,13139,2915,1817,290700,20772
17084,13384,3700,1733,298900,20774
1232,1068,164,1641,456500,20776
1132,1110,22,-,656300,20777
718,621,97,-,511600,20778
483,460,23,-,481700,20779
3724,2111,1613,1220,282600,20781
11081,4509,6572,1378,273400,20782
12475,5373,7102,1311,261400,20783
9612,5947,3665,1332,224200,20784
13918,6489,7429,1398,227800,20785
3801,2879,922,1483,291500,20794
100,92,8,3100,878200,20812
12925,7112,5813,1909,714800,20814
12953,8273,4680,1976,956300,20815
6079,5031,1048,2258,921100,20816
13287,11213,2074,1994,880400,20817
793,716,77,2250,897300,20818
8816,7879,937,1642,464700,20832
2376,2240,136,2658,587900,20833
1998,1647,351,1769,499600,20837
85,78,7,-,603400,20838
23,18,5,-,-,20839
2870,2590,280,2591,587100,20841
707,588,119,985,624100,20842
19232,11185,8047,1920,571100,20850
4890,2759,2131,1691,356800,20851
20478,9361,11117,1849,490700,20852
9662,8141,1521,1399,448700,20853
16509,15211,1298,2681,909600,20854
4954,4197,757,1849,492000,20855
950,669,281,1508,750900,20860
551,551,0,-,701500,20861
111,111,0,-,757400,20862
4736,3510,1226,1859,327000,20866
217,217,0,-,790100,20868
6240,5260,980,2078,452600,20871
4335,3770,565,1408,384400,20872
21889,14100,7789,1616,304900,20874
8498,5579,2919,1755,365400,20876
12956,5533,7423,1507,333600,20877
22905,16097,6808,1729,555200,20878
8287,5605,2682,1663,306600,20879
211,190,21,1625,447300,20880
4315,4095,220,1758,568900,20882
11970,8311,3659,1520,288700,20886
7024,5627,1397,1632,604900,20895
323,309,14,-,820400,20896
177,10,167,820,-,20899
12389,8492,3897,1467,413600,20901
16667,10582,6085,1750,377500,20902
7295,2709,4586,1456,349000,20903
20662,11216,9446,1669,385600,20904
5884,5322,562,1847,468400,20905
25314,16281,9033,1665,319100,20906
20087,6611,13476,1661,541600,20910
9172,3947,5225,1214,498200,20912
9538,6012,3526,1058,221900,21001
702,0,702,1777,-,21005
11372,9088,2284,1361,244600,21009
118,0,118,1533,-,21010
7528,6517,1011,1778,432800,21012
1755,1728,27,-,430200,21013
13942,11047,2895,1161,301200,21014
10066,8554,1512,1522,327400,21015
2633,1841,792,1410,195200,21017
1102,999,103,1141,383800,21028
3450,3156,294,2513,669000,21029
10052,4693,5359,1177,381000,21030
0,0,0,-,-,21031
3224,2797,427,1175,410800,21032
1277,1128,149,903,256700,21034
2581,2450,131,2790,625700,21035
748,686,62,-,739000,21036
8136,6998,1138,1795,412900,21037
8650,6015,2635,1068,163300,21040
13715,12154,1561,1664,578000,21042
16735,11402,5333,1649,467900,21043
17697,10629,7068,1651,391800,21044
14865,10690,4175,1494,340000,21045
6295,4238,2057,1650,370800,21046
4224,3892,332,1071,378700,21047
3736,3552,184,1071,362000,21048
6400,5649,751,1364,342500,21050
135,135,0,-,391900,21051
92,87,5,-,273600,21052
1163,1017,146,1710,365300,21053
4024,3444,580,1791,381100,21054
109,109,0,-,1651800,21056
1584,1380,204,1382,448900,21057
12503,9069,3434,1229,255200,21060
20904,11319,9585,1279,242600,21061
172,172,0,-,333300,21071
5504,4649,855,959,279700,21074
10998,7659,3339,1694,342700,21075
6613,4738,1875,2030,367400,21076
158,158,0,-,331300,21077
7589,5435,2154,1029,277100,21078
194,169,25,-,361200,21082
2685,2498,187,1164,369500,21084
6298,5227,1071,1136,262700,21085
1944,1869,75,2344,392900,21087
3586,3091,495,1338,299200,21090
15444,12374,3070,1246,360700,21093
3868,3354,514,924,309700,21102
1631,1585,46,2181,517700,21104
12,12,0,-,-,21105
6455,5409,1046,1605,428100,21108
1694,1533,161,1390,517400,21111
13172,8611,4561,1749,310700,21113
9745,7598,2147,1860,364100,21114
22732,12351,10381,1411,277500,21117
2538,2242,296,1474,452900,21120
21630,18533,3097,1559,319900,21122
4925,4199,726,1400,321200,21128
123,23,100,-,-,21130
2553,2405,148,1067,527600,21131
898,838,60,1366,343100,21132
11431,7708,3723,1136,230300,21133
12754,9253,3501,1198,276500,21136
1199,1089,110,1806,470000,21140
11523,8811,2712,1455,353600,21144
9462,8651,811,1652,520300,21146
2291,1672,619,1246,391300,21152
143,121,22,-,675500,21153
2036,1800,236,1092,338200,21154
995,742,253,1462,336200,21155
145,137,8,-,322300,21156
13836,9926,3910,1047,304100,21157
7496,6028,1468,1382,319100,21158
995,830,165,668,314300,21160
1916,1761,155,1323,378900,21161
1288,1182,106,1670,363600,21162
2588,2300,288,1765,475000,21163
9164,1062,8102,1069,189600,21201
8458,1795,6663,958,230200,21202
7657,3945,3712,1525,443700,21204
5349,1796,3553,871,52500,21205
19376,11456,7920,944,150600,21206
18340,11400,6940,1082,180300,21207
15050,9709,5341,1388,251400,21208
11566,7014,4552,1279,296700,21209
5301,3166,2135,1277,436900,21210
7625,4097,3528,1170,211100,21211
12694,8708,3986,1070,276500,21212
11287,5827,5460,1073,96200,21213
7879,5915,1964,981,179400,21214
22063,10855,11208,955,122200,21215
10631,5214,5417,967,88900,21216
14238,4443,9795,863,130500,21217
18536,9189,9347,981,153700,21218
3475,2812,663,1318,276600,21219
15193,9794,5399,1158,197700,21220
16023,9199,6824,987,188700,21221
20672,13400,7272,1053,143700,21222
8373,2781,5592,922,68900,21223
19515,11329,8186,1328,195800,21224
11903,5810,6093,858,165700,21225
2618,1824,794,1276,240900,21226
12076,7383,4693,1097,207400,21227
18150,13161,4989,1285,301100,21228
17886,9708,8178,970,125700,21229
14792,7787,7005,1415,247300,21230
7476,2898,4578,1258,287100,21231
28930,17758,11172,1213,216700,21234
15402,10403,4999,1236,239200,21236
11331,7230,4101,1177,217500,21237
11814,6432,5382,1088,146700,21239
0,0,0,-,-,21240
13569,6631,6938,1240,193600,21244
0,0,0,-,-,21250
0,0,0,-,-,21251
0,0,0,-,-,21252
8032,5043,2989,1248,321900,21286
15944,9914,6030,1653,452300,21401
269,22,247,2086,-,21402
12790,7732,5058,1590,422200,21403
175,175,0,-,940100,21405
7433,6684,749,1752,410700,21409
16048,10748,5300,656,124500,21502
845,639,206,674,210700,21520
549,416,133,654,93500,21521
48,41,7,-,144500,21522
91,82,9,-,88000,21523
250,195,55,1201,152800,21524
214,189,25,647,110900,21529
694,631,63,-,159400,21530
841,666,175,555,165900,21531
5715,3479,2236,746,141900,21532
1498,1172,326,548,169500,21536
189,155,34,664,82500,21538
1018,750,268,559,89300,21539
39,31,8,525,28500,21540
573,450,123,654,249000,21541
297,189,108,593,74500,21542
89,77,12,-,133000,21543
761,667,94,762,106700,21545
5908,4468,1440,654,158500,21550
728,616,112,-,108900,21555
712,632,80,932,124000,21557
1048,896,152,806,200700,21561
1257,941,316,604,81500,21562
10603,6871,3732,1077,304100,21601
218,155,63,956,307500,21607
156,125,31,925,186600,21610
183,183,0,-,611400,21612
7296,3921,3375,846,188700,21613
3649,3034,615,1084,371000,21617
2504,1828,676,1669,323600,21619
4829,3192,1637,908,247000,21620
381,338,43,956,187500,21622
597,479,118,1144,295300,21623
67,49,18,-,277400,21624
1000,828,172,1260,289500,21625
82,68,14,-,266700,21626
15,15,0,-,37500,21627
301,199,102,1140,-,21628
3562,2573,989,1078,216500,21629
892,786,106,1054,225800,21631
2256,1390,866,768,162300,21632
57,57,0,-,415500,21634
824,651,173,749,248800,21635
386,298,88,955,202400,21636
1877,1444,433,1685,417800,21638
1599,1055,544,780,181300,21639
593,547,46,1125,217500,21640
38,19,19,950,196900,21641
2140,1667,473,941,157100,21643
55,18,37,-,-,21644
411,381,30,-,328700,21645
72,61,11,-,435700,21647
83,64,19,-,188900,21648
518,386,132,1192,141400,21649
77,68,9,-,220000,21650
1134,882,252,1037,216100,21651
75,66,9,-,543100,21652
43,43,0,-,282900,21653
579,421,158,1238,615200,21654
2010,1615,395,1122,214100,21655
287,237,50,889,314000,21657
1431,1257,174,1371,380800,21658
535,424,111,875,184400,21659
1402,969,433,942,220000,21660
1091,807,284,1060,225800,21661
216,195,21,-,718800,21662
1505,1161,344,1088,482000,21663
217,164,53,1028,135700,21664
129,129,0,-,511000,21665
4476,3786,690,1517,369100,21666
127,117,10,-,249100,21667
726,561,165,706,217700,21668
74,62,12,-,424000,21669
357,325,32,-,336000,21671
104,99,5,-,-,21672
1316,963,353,1034,319900,21673
70,70,0,-,125000,21675
190,141,49,1210,-,21676
156,149,7,-,283000,21677
713,594,119,1190,213200,21678
163,163,0,-,284600,21679
15378,10014,5364,1227,288600,21701
15677,9409,6268,1324,279800,21702
12903,8484,4419,1492,247300,21703
5138,4328,810,1898,420500,21704
0,0,0,-,-,21705
1825,1455,370,1781,414300,21710
392,319,73,766,173500,21711
3751,3053,698,821,260400,21713
60,31,29,-,344700,21714
1864,1365,499,909,205100,21716
22,10,12,-,-,21717
75,51,24,682,342300,21718
389,310,79,775,196500,21719
2035,1663,372,826,244700,21722
246,212,34,-,600000,21723
1706,1287,419,854,271200,21727
366,346,20,-,283700,21733
327,184,143,767,140800,21734
656,618,38,-,816700,21737
1114,1093,21,-,684700,21738
22955,12418,10537,796,170000,21740
13322,8278,5044,1025,216300,21742
0,0,0,-,-,21746
1520,1106,414,656,160100,21750
2158,1987,171,1428,461800,21754
2011,1875,136,1048,353000,21755
1336,1126,210,1063,288000,21756
1261,959,302,1277,279700,21757
1819,1523,296,1332,275100,21758
102,91,11,-,327800,21762
212,179,33,-,210100,21766
518,237,281,922,166900,21767
4009,3512,497,1340,402200,21769
1832,1731,101,1223,375200,21770
9856,9049,807,1685,402000,21771
1998,1852,146,1085,339300,21773
4496,4148,348,1769,364400,21774
1956,1521,435,1069,301300,21776
605,559,46,-,343200,21777
446,368,78,1323,248400,21778
372,372,0,-,331900,21779
508,377,131,1366,269300,21780
17,17,0,-,-,21781
1516,1352,164,936,247500,21782
3260,2747,513,961,231900,21783
13712,11941,1771,1170,370800,21784
3838,2960,878,1069,269700,21787
4617,3515,1102,981,244300,21788
43,37,6,-,331800,21790
2024,1641,383,897,311400,21791
3585,2857,728,1344,282300,21793
864,826,38,-,668500,21794
3717,2444,1273,940,202200,21795
2852,2565,287,1387,559700,21797
747,620,127,811,332300,21798
10842,6279,4563,855,193300,21801
0,0,0,-,-,21802
14994,7729,7265,1109,165600,21804
274,274,0,-,205400,21810
9722,7730,1992,1270,262000,21811
1023,923,100,1311,338600,21813
169,102,67,-,206500,21814
1965,1246,719,574,112900,21817
460,419,41,913,119200,21821
957,774,183,967,162800,21822
50,45,5,-,111300,21824
1911,1349,562,1040,160700,21826
184,156,28,-,186400,21829
1294,1105,189,917,156600,21830
165,93,72,933,-,21835
1124,863,261,1235,171300,21837
684,572,112,639,135000,21838
146,88,58,-,-,21840
377,260,117,918,224000,21841
4938,3629,1309,1033,294100,21842
1392,1161,231,933,165800,21849
988,753,235,1000,152900,21850
2714,1607,1107,824,155700,21851
3713,1927,1786,692,152900,21853
272,260,12,-,113600,21856
308,241,67,850,141300,21861
46,0,46,-,-,21862
1747,1232,515,815,175900,21863
294,191,103,1295,132200,21864
147,108,39,-,-,21865
28,28,0,-,-,21866
6,6,0,-,-,21867
422,333,89,825,169300,21869
733,559,174,666,146800,21871
223,121,102,677,225000,21872
841,619,222,1125,151100,21874
2401,1532,869,1086,171600,21875
0,0,0,-,-,21890
6477,4715,1762,1154,248900,21901
0,0,0,-,-,21902
2464,1481,983,947,215500,21903
2363,2009,354,851,240300,21904
3865,2962,903,1017,239800,21911
368,231,137,-,353900,21912
378,208,170,773,171800,21913
320,197,123,1099,241600,21914
1123,847,276,1114,263400,21915
0,0,0,-,-,21916
877,779,98,931,237400,21917
1364,1246,118,728,235300,21918
1302,1200,102,1107,277700,21919
122,104,18,-,160000,21920
15975,11115,4860,1106,231600,21921
78,16,62,-,-,21930
19199,12876,6323,1664,530400,22003
14730,12022,2708,2121,484200,22015
6120,5142,978,2135,363900,22025
4751,3147,1604,1518,280300,22026
658,585,73,3461,867500,22027
19455,11914,7541,1864,560400,22030
12161,6028,6133,1917,548800,22031
9798,8347,1451,2216,577000,22032
15187,9458,5729,1860,473300,22033
0,0,0,-,-,22035
5884,5520,364,"3,500+",802900,22039
10663,4582,6081,1589,376400,22041
12190,7405,4785,1751,478600,22042
9105,5190,3915,1831,593300,22043
5425,2600,2825,1443,551100,22044
6620,4766,1854,1742,693600,22046
2713,317,2396,2664,574400,22060
5867,5638,229,3138,1069600,22066
11380,7933,3447,1966,455400,22079
10457,8794,1663,3121,984200,22101
10400,5367,5033,1911,857400,22102
6707,5689,1018,1890,756500,22124
354,252,102,1667,374500,22125
1409,48,1361,1775,204500,22134
8962,5573,3389,1875,439300,22150
5521,4495,1026,2087,451600,22151
10339,8424,1915,2101,454800,22152
10151,8827,1324,2212,498100,22153
3336,1543,1793,1011,424200,22172
8482,6327,2155,1899,669500,22180
5283,4329,954,2020,728500,22181
8888,7051,1837,2143,848200,22182
0,0,0,-,-,22185
21933,12969,8964,1589,288000,22191
19835,14378,5457,1690,326900,22192
23400,18094,5306,1582,302000,22193
18605,6515,12090,2094,636500,22201
12940,3144,9796,2071,645900,22202
11736,4183,7553,2024,583300,22203
21817,8559,13258,1542,479400,22204
6690,5257,1433,1719,789100,22205
10390,5062,5328,1896,429700,22206
11804,9506,2298,1989,901800,22207
7183,2554,4629,1895,570000,22209
79,0,79,3042,-,22211
1295,869,426,2436,736300,22213
0,0,0,-,-,22214
5555,3656,1899,1815,746400,22301
8195,4338,3857,1789,406500,22302
6849,3107,3742,1726,380000,22303
21154,8703,12451,1589,351700,22304
6609,2534,4075,1616,602100,22305
11737,5285,6452,1432,423500,22306
4564,3596,968,1668,536500,22307
4478,4018,460,3090,662700,22308
11280,7104,4176,1493,414300,22309
11333,8686,2647,1986,447000,22310
7802,1322,6480,1496,519400,22311
11353,5748,5605,1700,438000,22312
17096,8289,8807,1886,663400,22314
10543,7694,2849,2172,456100,22315
10419,3746,6673,1123,341200,22401
10429,8066,2363,1371,282300,22405
8437,6119,2318,1313,354800,22406
19611,14518,5093,1393,256100,22407
9710,7204,2506,1442,271100,22408
1173,807,366,940,182500,22427
63,63,0,-,225000,22432
129,102,27,-,243800,22433
1075,908,167,682,150300,22435
332,271,61,-,174500,22436
373,272,101,-,126700,22437
82,53,29,-,119300,22438
3486,2602,884,1014,221800,22443
169,0,169,1641,-,22448
700,528,172,834,168200,22454
714,592,122,1125,131200,22460
545,447,98,719,225500,22469
2596,2070,526,677,246300,22473
224,207,17,-,155100,22476
382,191,191,863,309500,22480
1499,1095,404,674,257900,22482
8811,6788,2023,1130,294100,22485
464,422,42,-,175000,22488
1697,1362,335,884,216200,22503
160,147,13,-,240100,22504
5421,5040,381,1434,257100,22508
17,17,0,-,-,22509
576,515,61,1058,269300,22511
1048,775,273,749,198300,22514
2652,2079,573,1050,190200,22520
95,79,16,-,-,22529
6,0,6,-,-,22530
979,808,171,1218,209900,22534
250,160,90,779,199200,22535
53,53,0,-,227000,22538
991,941,50,420,421200,22539
795,699,96,-,196700,22542
5905,4972,933,1188,194600,22546
125,76,49,-,-,22548
6367,5641,726,1042,268900,22551
4696,3607,1089,1455,299100,22553
17103,12762,4341,1625,338500,22554
9376,7430,1946,1581,327600,22556
2493,1606,887,868,198000,22560
1018,865,153,1106,225500,22567
2477,1632,845,744,175800,22572
872,679,193,844,194800,22576
1171,885,286,872,283500,22578
23,23,0,-,-,22579
2044,1578,466,1007,186300,22580
10987,5132,5855,982,219900,22601
10451,8139,2312,1151,250900,22602
5667,4351,1316,1075,212000,22603
747,682,65,-,239800,22610
3374,2417,957,989,328000,22611
965,705,260,1185,323700,22620
260,230,30,1150,192900,22623
1019,765,254,1144,263200,22624
1422,1234,188,1222,250600,22625
286,216,70,1063,433300,22627
11627,8442,3185,946,229200,22630
817,710,107,482,257400,22637
159,90,69,1344,857100,22639
216,159,57,-,456300,22640
170,170,0,-,212500,22641
1641,1585,56,1031,227000,22642
95,95,0,-,244200,22643
927,812,115,788,203000,22644
1524,1183,341,819,273400,22645
86,86,0,-,532100,22646
296,222,74,-,210300,22650
563,480,83,732,260600,22652
519,438,81,-,276200,22654
7436,5551,1885,1126,228200,22655
1132,951,181,1203,251800,22656
4152,2883,1269,934,205800,22657
826,553,273,823,189500,22660
589,450,139,1295,298100,22663
3528,2101,1427,810,230400,22664
11877,7951,3926,1079,238600,22701
381,271,110,-,231300,22709
30,30,0,-,-,22711
2732,2112,620,1186,270700,22712
501,391,110,1107,255700,22713
267,231,36,1145,347400,22714
465,371,94,525,283900,22715
370,316,54,536,508100,22716
215,192,23,-,239800,22718
161,124,37,732,275000,22719
303,297,6,-,422400,22720
147,136,11,-,-,22722
74,74,0,-,275000,22723
714,642,72,1734,340100,22724
259,200,59,950,211300,22726
2165,1437,728,794,233800,22727
1126,900,226,1079,350200,22728
53,53,0,-,287500,22729
61,27,34,-,-,22730
11,11,0,-,-,22731
77,77,0,-,238800,22732
476,411,65,1125,318100,22733
1202,849,353,1104,241700,22734
920,831,89,1443,299500,22735
265,254,11,-,225000,22736
1101,838,263,1288,266500,22737
483,298,185,879,370700,22738
545,335,210,1112,289500,22740
59,31,28,-,326200,22741
616,538,78,1370,297200,22742
91,76,15,-,-,22743
521,377,144,791,368900,22747
114,63,51,1076,656300,22749
13146,6124,7022,933,253000,22801
11207,5659,5548,800,185100,22802
0,0,0,-,-,22807
284,239,45,1034,229100,22810
231,203,28,-,201300,22811
3251,2197,1054,842,219500,22812
3567,2538,1029,672,186600,22815
126,113,13,-,-,22820
2091,1638,453,688,204400,22821
2517,1847,670,765,192200,22824
4192,3203,989,789,172000,22827
661,495,166,852,128100,22830
356,292,64,718,153800,22831
467,339,128,1253,224000,22832
387,370,17,-,207100,22834
4540,3132,1408,723,180400,22835
1737,1326,411,1222,240500,22840
1124,845,279,896,252500,22841
2058,1452,606,816,159600,22842
950,810,140,-,192000,22843
2050,1332,718,716,214900,22844
9,9,0,-,-,22845
831,683,148,1169,314200,22846
426,348,78,850,262100,22847
1953,1454,499,785,160600,22849
372,307,65,1023,211200,22850
2502,1574,928,679,163900,22851
1675,991,684,737,156700,22853
14596,8070,6526,1171,327100,22901
10151,5254,4897,1086,269000,22902
14563,6358,8205,1143,340700,22903
46,11,35,871,-,22904
7119,4474,2645,1285,317600,22911
1668,1268,400,662,267200,22920
863,671,192,1016,185200,22922
1991,1411,580,1293,285200,22923
127,98,29,1077,261700,22931
3166,2414,752,1252,349900,22932
326,272,54,-,-,22935
1933,1752,181,994,368900,22936
694,608,86,1078,171000,22937
647,427,220,955,228600,22938
2142,1539,603,1271,243200,22939
533,384,149,1367,293000,22940
3587,2741,846,884,230800,22942
115,70,45,-,198400,22943
87,87,0,-,-,22946
1706,1236,470,1011,554700,22947
92,92,0,-,-,22948
645,390,255,407,164500,22949
868,592,276,954,206100,22952
1105,933,172,-,393400,22958
599,500,99,1071,277900,22959
3881,2414,1467,821,200700,22960
6227,5063,1164,1352,229200,22963
77,61,16,-,256300,22964
777,534,243,726,202800,22967
3797,3297,500,1028,236700,22968
403,336,67,818,226000,22969
618,378,240,663,201500,22971
173,101,72,476,-,22972
2500,1851,649,819,223600,22973
1656,1455,201,1068,282500,22974
239,118,121,722,225000,22976
13197,8848,4349,832,178000,22980
16,0,16,-,-,22989
3647,3011,636,726,192100,23002
382,344,38,-,89300,23004
6094,4062,2032,985,249900,23005
2312,2072,240,1422,214500,23009
478,400,78,-,327200,23011
1593,1389,204,1053,251500,23015
79,79,0,-,-,23021
461,329,132,852,151800,23022
181,147,34,-,197300,23023
3415,2943,472,1074,232300,23024
123,109,14,-,433700,23025
450,361,89,-,140300,23027
2009,1645,364,850,160500,23030
141,77,64,-,-,23032
416,349,67,991,294400,23035
742,525,217,1099,180300,23038
441,389,52,737,247900,23039
1808,1399,409,728,144600,23040
828,671,157,1098,319300,23043
41,41,0,-,161200,23045
728,589,139,1085,294800,23047
369,369,0,-,144600,23050
323,210,113,1161,188400,23055
146,114,32,-,-,23056
12255,9191,3064,1408,394400,23059
13520,10355,3165,1219,258200,23060
8118,6567,1551,904,219300,23061
1056,626,430,1047,236600,23062
1458,1215,243,1094,189300,23063
116,76,40,-,214200,23064
783,686,97,1049,203600,23065
95,77,18,-,314700,23066
138,138,0,-,175700,23068
1069,929,140,1083,243400,23069
178,178,0,-,348900,23070
715,629,86,787,277400,23071
4838,3684,1154,929,229400,23072
3743,2041,1702,940,136600,23075
333,284,49,-,279800,23076
188,144,44,778,224200,23079
814,680,134,714,157700,23083
658,538,120,1127,237200,23084
262,246,16,-,147200,23085
1215,1117,98,1184,190300,23086
1867,1568,299,1097,262800,23089
73,62,11,-,155000,23091
300,262,38,873,232500,23092
5089,3793,1296,867,187400,23093
1235,1110,125,1318,283100,23102
2012,1898,114,1133,468300,23103
418,317,101,-,175300,23106
117,95,22,-,203700,23108
1043,842,201,683,215700,23109
273,181,92,-,169900,23110
14376,11467,2909,1147,232100,23111
18809,14452,4357,1312,237900,23112
9422,7738,1684,1304,425000,23113
6864,5516,1348,1466,287500,23114
67,67,0,-,97100,23115
10122,8901,1221,1234,301400,23116
3533,2937,596,979,255500,23117
219,201,18,-,397100,23119
2656,2520,136,950,374800,23120
720,569,151,745,146400,23123
1536,1229,307,790,263000,23124
104,104,0,-,118800,23125
85,58,27,956,194400,23126
393,288,105,1101,168500,23128
218,155,63,-,475900,23129
107,89,18,-,255000,23130
173,162,11,-,-,23138
9160,8131,1029,970,255800,23139
2358,2012,346,874,219500,23140
2455,2080,375,1062,244100,23141
1217,1034,183,971,321700,23146
870,661,209,869,142800,23148
1161,785,376,694,228600,23149
4921,3662,1259,981,158900,23150
558,482,76,864,306300,23153
585,473,112,950,145800,23156
0,0,0,-,-,23160
75,65,10,-,179700,23161
72,63,9,-,421900,23163
2492,2032,460,1460,282000,23168
462,391,71,767,167800,23169
0,0,0,-,-,23173
856,609,247,683,246800,23175
187,187,0,-,157400,23176
188,154,34,-,185200,23177
174,157,17,-,-,23180
2180,1692,488,795,210100,23181
17662,12209,5453,1168,327800,23185
0,0,0,-,-,23187
16851,12050,4801,1224,312400,23188
2510,2252,258,976,317200,23192
2384,160,2224,953,324300,23219
13280,4123,9157,1004,255500,23220
7349,3714,3635,1104,370100,23221
9650,4841,4809,936,125900,23222
21109,9231,11878,917,149800,23223
13854,4930,8924,877,111500,23224
18370,7848,10522,936,202200,23225
6919,5074,1845,1303,331000,23226
11756,6150,5606,838,227500,23227
14765,7166,7599,1073,168100,23228
12771,8830,3941,1044,303800,23229
2868,1496,1372,1013,186400,23230
14044,9423,4621,963,176400,23231
12006,7947,4059,1258,338100,23233
15485,8700,6785,971,158800,23234
12943,9004,3939,1247,220000,23235
9895,8460,1435,1213,208200,23236
8126,5668,2458,1055,163400,23237
10912,6939,3973,1123,288000,23238
0,0,0,-,-,23250
7447,2463,4984,1136,197700,23294
546,338,208,648,129200,23301
71,16,55,-,-,23302
451,405,46,-,142900,23303
18,18,0,-,-,23304
423,289,134,871,220200,23306
208,92,116,727,-,23307
803,596,207,876,88500,23308
1919,1259,660,833,185200,23310
52,13,39,-,-,23313
3105,2190,915,1217,278200,23314
572,516,56,-,211700,23315
156,105,51,952,191400,23316
22085,13509,8576,1320,247000,23320
12556,9462,3094,1217,248100,23321
20037,17380,2657,1543,334600,23322
13164,10239,2925,1103,244200,23323
8715,4024,4691,941,166000,23324
6517,4272,2245,1115,204500,23325
1423,1057,366,856,251000,23336
208,115,93,-,313600,23337
265,121,144,914,147500,23347
1521,923,598,673,124500,23350
135,95,40,-,405000,23354
581,422,159,1207,181900,23356
358,242,116,-,215700,23357
32,13,19,-,-,23358
321,218,103,687,126800,23359
125,125,0,-,-,23389
173,173,0,-,133600,23395
31,28,3,-,487500,23398
137,111,26,675,-,23401
403,391,12,-,228500,23405
218,166,52,-,74200,23407
28,8,20,-,-,23408
40,20,20,-,-,23409
820,677,143,750,145100,23410
404,254,150,703,129500,23413
42,42,0,-,135400,23414
625,418,207,819,-,23415
176,125,51,-,38900,23416
1501,1167,334,854,244900,23417
429,256,173,750,185500,23418
1162,723,439,658,123300,23420
1559,840,719,808,115500,23421
72,39,33,-,240600,23422
162,136,26,881,144800,23423
49,31,18,-,185900,23426
115,89,26,738,95000,23427
6916,5463,1453,988,262900,23430
601,542,59,1035,316900,23432
546,473,73,1053,326600,23433
18016,11227,6789,990,210500,23434
10472,7831,2641,1416,274400,23435
352,343,9,-,294000,23436
1696,1395,301,833,187900,23437
620,541,79,753,268800,23438
193,178,15,-,95000,23440
43,15,28,-,-,23441
397,251,146,580,88000,23442
20219,10043,10176,1229,429000,23451
22616,13998,8618,1245,242500,23452
12115,8297,3818,1231,231000,23453
22184,14295,7889,1252,290400,23454
19690,11770,7920,1378,286900,23455
17379,15113,2266,1800,326600,23456
1615,1322,293,1144,371000,23457
288,0,288,1733,-,23459
0,0,0,-,-,23460
0,0,0,-,-,23461
24594,13341,11253,1299,200700,23462
27016,18902,8114,1322,251700,23464
174,140,34,675,110700,23480
55,55,0,-,159800,23486
2227,1717,510,749,164600,23487
99,33,66,-,62800,23488
7744,4014,3730,1126,189600,23502
13475,5359,8116,995,188500,23503
7663,2561,5102,764,173900,23504
12010,4124,7886,950,217800,23505
3420,1303,2117,1231,397400,23507
5983,2729,3254,1118,310800,23508
5021,3037,1984,1079,175000,23509
3447,766,2681,1190,366000,23510
134,11,123,1706,-,23511
11464,5705,5759,1067,150800,23513
2374,587,1787,1012,238200,23517
11916,6639,5277,1000,210500,23518
2598,1019,1579,765,174000,23523
0,0,0,-,-,23551
10315,5216,5099,914,192000,23601
15767,9031,6736,1080,208500,23602
1295,557,738,997,171500,23603
717,19,698,1679,-,23604
5674,2611,3063,948,138400,23605
11481,5272,6209,1041,240600,23606
8612,3379,5233,813,113100,23607
16115,8664,7451,1015,185500,23608
218,0,218,2083,-,23651
5482,3555,1927,1020,157300,23661
4560,3636,924,1173,317200,23662
4943,2871,2072,1023,146600,23663
4180,2649,1531,1166,206200,23664
1361,20,1341,1693,-,23665
21563,11333,10230,1073,194400,23666
15615,9576,6039,999,195700,23669
1333,726,607,930,254400,23690
31,4,27,1750,-,23691
7310,5920,1390,1393,319500,23692
8608,6270,2338,1452,342500,23693
1381,1155,226,1857,352200,23696
9123,6185,2938,1036,164700,23701
4307,1689,2618,921,132000,23702
9795,6538,3257,1109,207100,23703
7476,2867,4609,935,149500,23704
5915,2657,3258,867,164300,23707
0,0,0,-,-,23708
0,0,0,-,-,23709
1206,28,1178,1607,221900,23801
15030,7840,7190,900,136500,23803
7598,4615,2983,945,154600,23805
0,0,0,-,-,23806
736,627,109,637,105900,23821
2486,1417,1069,789,124300,23824
638,437,201,702,112500,23827
95,70,25,730,125000,23828
458,385,73,467,152500,23829
372,340,32,552,263900,23830
13515,9501,4014,1189,221300,23831
11684,10109,1575,1321,211400,23832
908,753,155,850,183800,23833
9599,6372,3227,992,166700,23834
4810,3447,1363,1355,225800,23836
1839,1262,577,739,190000,23837
5721,5405,316,1236,323500,23838
284,232,52,1038,144400,23839
973,907,66,-,132500,23840
1404,1128,276,905,180500,23841
2398,2019,379,816,219200,23842
299,243,56,-,-,23843
250,140,110,941,-,23844
180,154,26,-,226700,23845
398,302,96,637,160900,23846
4980,2963,2017,728,96700,23847
456,385,71,-,146600,23850
5399,3164,2235,835,179700,23851
355,299,56,-,89600,23856
253,229,24,-,178800,23857
10882,6174,4708,841,137000,23860
923,712,211,679,229200,23866
897,700,197,952,94100,23867
2081,1308,773,600,110300,23868
976,796,180,844,142300,23872
408,305,103,944,155400,23874
4135,2645,1490,1156,203800,23875
140,127,13,-,88300,23876
377,256,121,626,197700,23878
268,231,37,-,75500,23879
833,548,285,756,197300,23881
840,725,115,875,111000,23882
961,813,148,933,192100,23883
16,16,0,-,-,23884
1082,880,202,1026,234300,23885
160,94,66,-,315200,23887
1073,555,518,834,123800,23888
287,265,22,-,84900,23889
1342,907,435,850,145300,23890
0,0,0,-,-,23891
141,98,43,-,120300,23893
184,136,48,-,172700,23894
238,184,54,-,-,23897
826,756,70,1060,230100,23898
146,114,32,929,137500,23899
5624,3250,2374,840,160000,23901
0,0,0,-,-,23909
226,182,44,598,151900,23915
1176,900,276,400,145300,23917
1040,878,162,957,205500,23919
1440,1141,299,795,126800,23920
780,535,245,639,114400,23921
1059,588,471,771,131600,23922
1008,901,107,571,149400,23923
2267,1680,587,501,109500,23924
1705,1397,308,714,177100,23927
2345,1577,768,796,142800,23930
174,122,52,-,92800,23934
2354,1768,586,705,140100,23936
725,437,288,617,97400,23937
180,134,46,-,75800,23938
594,531,63,-,157300,23942
31,31,0,-,-,23943
1402,964,438,684,117800,23944
1409,890,519,570,108100,23947
1277,897,380,803,104500,23950
98,89,9,-,154600,23952
690,540,150,862,113800,23954
1224,852,372,714,141100,23958
461,351,110,485,82600,23959
688,563,125,-,124400,23960
241,185,56,-,110300,23962
33,33,0,-,-,23963
423,297,126,649,90200,23964
799,538,261,663,122500,23966
470,384,86,603,85200,23967
322,231,91,711,-,23968
2873,1636,1237,735,120700,23970
1693,1161,532,628,99000,23974
40,14,26,-,-,23976
293,41,252,946,1020800,24011
12297,7064,5233,768,133900,24012
3100,1402,1698,774,84800,24013
7782,5177,2605,834,166800,24014
7025,4062,2963,757,172000,24015
4217,1055,3162,725,126800,24016
9267,4883,4384,801,109400,24017
16182,11213,4969,929,217000,24018
11046,8777,2269,943,181100,24019
35,0,35,-,-,24020
1229,1006,223,656,118000,24053
2652,2208,444,558,92800,24054
5406,4142,1264,530,86400,24055
81,66,15,-,130000,24058
421,358,63,-,221100,24059
18198,7330,10868,994,295200,24060
1906,1605,301,771,181600,24064
2884,2305,579,693,190100,24065
2176,1701,475,811,148300,24066
1023,812,211,724,184000,24067
761,640,121,767,115000,24069
562,455,107,794,235200,24070
450,401,49,653,166500,24072
13012,8679,4333,839,183200,24073
429,292,137,585,214300,24076
302,243,59,813,148600,24077
2995,1796,1199,653,118200,24078
898,654,244,644,115100,24079
156,130,26,-,159700,24082
1310,967,343,937,273000,24083
4351,3283,1068,652,142200,24084
827,726,101,598,141300,24085
153,78,75,-,75000,24086
1539,1282,257,549,112900,24087
1712,1276,436,533,118800,24088
1246,848,398,676,82600,24089
1885,1547,338,1028,271300,24090
3070,2423,647,598,172700,24091
1256,956,300,683,132700,24092
82,61,21,544,177300,24093
2048,1762,286,920,173000,24095
2553,2320,233,890,217900,24101
595,499,96,312,146300,24102
1396,1218,178,694,258200,24104
178,128,50,-,-,24105
13647,9013,4634,621,95700,24112
628,540,88,-,119300,24120
4570,3951,619,898,284000,24121
676,648,28,-,142300,24122
1849,1398,451,740,96400,24124
1864,1320,544,508,159600,24127
909,793,116,864,180300,24128
11,11,0,-,-,24130
21,0,21,-,-,24131
292,86,206,753,68800,24132
1098,918,180,515,91200,24133
2032,1494,538,666,113200,24134
1397,1113,284,750,120900,24136
1252,973,279,571,258000,24137
644,575,69,-,173200,24138
217,217,0,-,154000,24139
8792,5204,3588,771,167000,24141
0,0,0,-,-,24142
553,314,239,548,132000,24147
3309,2561,748,576,107000,24148
1230,1050,180,806,225300,24149
396,330,66,654,90000,24150
8048,5690,2358,648,138400,24151
14800,10773,4027,875,181600,24153
219,133,86,772,120500,24161
780,520,260,666,145000,24162
596,398,198,551,108400,24165
106,92,14,-,104000,24167
69,69,0,-,-,24168
3688,2691,997,540,117500,24171
1153,990,163,706,118100,24174
3119,2776,343,882,245600,24175
649,627,22,-,378400,24176
7557,5383,2174,727,165400,24179
1782,1624,158,652,213400,24184
282,259,23,-,146000,24185
7132,4207,2925,682,112000,24201
4820,4066,754,658,135600,24202
7361,4707,2654,636,135000,24210
4271,3512,759,678,198700,24211
1105,722,383,610,53500,24216
153,109,44,-,53700,24217
4072,2855,1217,647,109900,24219
256,238,18,-,87900,24220
233,218,15,-,119200,24221
2375,1827,548,542,85300,24224
627,575,52,711,82100,24225
608,496,112,652,88800,24226
2696,2157,539,591,78200,24228
3436,2266,1170,612,78000,24230
1340,961,379,592,98900,24236
423,318,105,882,55700,24237
92,92,0,-,75000,24239
754,575,179,632,87400,24243
2231,1712,519,348,76900,24244
359,234,125,432,60400,24245
220,125,95,-,85700,24246
1017,831,186,433,93700,24248
628,596,32,-,78000,24250
3431,2663,768,540,94400,24251
1413,852,561,459,79300,24256
750,597,153,492,88900,24258
2303,1866,437,557,79500,24260
2532,1635,897,509,92300,24263
287,210,77,550,38600,24265
3832,2841,991,533,130400,24266
100,89,11,-,54100,24269
222,146,76,-,83500,24270
1044,757,287,549,118000,24271
284,168,116,358,77600,24272
2735,1615,1120,563,76900,24273
2195,1433,762,536,78000,24277
1833,1386,447,643,80800,24279
373,334,39,-,155100,24280
1067,830,237,613,62100,24281
282,195,87,458,52700,24282
933,684,249,420,79000,24283
798,530,268,573,107500,24290
214,193,21,478,79800,24292
3783,2705,1078,659,107700,24293
6160,4183,1977,606,111000,24301
853,599,254,789,89100,24311
736,465,271,637,85800,24312
394,339,55,-,66200,24313
638,460,178,-,85600,24314
1257,1025,232,648,124600,24315
0,0,0,-,-,24316
1587,1379,208,652,101600,24317
283,264,19,-,87100,24318
2748,2024,724,619,110900,24319
72,51,21,-,-,24322
313,249,64,-,130000,24323
718,646,72,771,152200,24324
367,267,100,-,109800,24325
569,509,60,-,110500,24326
873,774,99,-,93000,24328
1252,922,330,540,86100,24330
7370,5237,2133,603,106800,24333
2110,1642,468,634,118800,24340
3950,2874,1076,500,116400,24343
696,528,168,710,205000,24347
1716,1264,452,483,92300,24348
455,405,50,580,67600,24350
284,168,116,-,55000,24351
425,356,69,-,130000,24352
6102,3969,2133,565,89800,24354
2165,1760,405,666,103600,24360
1929,1620,309,702,114800,24361
616,529,87,361,107800,24363
313,290,23,-,123700,24366
2197,1735,462,628,129100,24368
2698,2138,560,537,72900,24370
309,254,55,538,88000,24374
613,393,220,581,76100,24375
157,142,15,-,123200,24377
548,473,75,-,102000,24378
1143,977,166,426,132100,24380
1661,1318,343,570,109900,24381
6011,4317,1694,629,151800,24382
14979,9594,5385,791,180600,24401
31,31,0,-,-,24411
15,15,0,-,-,24412
61,55,6,-,192200,24413
17,17,0,-,-,24415
3477,2391,1086,747,116200,24416
1775,1547,228,943,218100,24421
2732,1863,869,661,103000,24422
5946,4664,1282,669,100700,24426
684,401,283,517,129000,24430
928,778,150,-,98300,24431
143,101,42,-,154700,24432
35,35,0,-,"10,000-",24433
808,684,124,688,228200,24435
378,314,64,-,231300,24437
482,366,116,-,161500,24439
1033,797,236,1075,164700,24440
2548,1974,574,697,169700,24441
56,48,8,-,-,24442
1168,855,313,482,131600,24445
123,106,17,588,68500,24448
5943,4112,1831,840,246500,24450
104,72,32,-,80000,24457
197,189,8,-,170500,24458
243,243,0,-,230700,24459
591,475,116,-,167400,24460
100,78,22,-,198200,24464
775,628,147,564,206800,24465
791,749,42,538,236000,24467
689,536,153,690,210800,24471
853,554,299,678,256500,24472
431,320,111,730,-,24473
190,155,35,-,74300,24474
90,90,0,-,201900,24476
4563,3367,1196,934,200000,24477
508,424,84,1272,275000,24479
1817,1517,300,854,190900,24482
218,203,15,-,-,24483
281,248,33,-,119000,24484
114,114,0,-,169400,24485
1453,984,469,1063,192200,24486
90,70,20,-,160700,24487
10121,4744,5377,710,109300,24501
16182,8624,7558,901,159200,24502
7580,5420,2160,859,234200,24503
3794,2069,1725,724,113400,24504
2215,1421,794,662,135100,24517
1042,851,191,571,85100,24520
3891,3100,791,698,172300,24521
3694,2900,794,684,149900,24522
7944,5657,2287,721,167900,24523
578,553,25,521,154200,24526
1298,993,305,627,119300,24527
1364,937,427,670,102800,24528
734,531,203,1135,137700,24529
511,379,132,548,103400,24530
3603,2686,917,633,119600,24531
620,433,187,712,121100,24534
96,96,0,-,159800,24536
2174,1988,186,625,161200,24538
84,55,29,-,-,24539
13969,8395,5574,643,100100,24540
12163,6999,5164,625,108000,24541
1608,1160,448,696,107200,24549
3212,2737,475,721,163300,24550
9289,7670,1619,799,241800,24551
577,476,101,718,120600,24553
1629,1278,351,585,115700,24554
840,591,249,649,143800,24555
1205,978,227,869,232300,24556
3399,2682,717,543,96300,24557
2657,2002,655,664,120900,24558
136,136,0,-,158600,24562
2572,1760,812,593,98900,24563
364,295,69,508,110700,24565
487,394,93,495,86300,24566
377,329,48,-,108600,24569
8,0,8,-,-,24570
836,709,127,692,138100,24571
6454,4693,1761,758,140300,24572
1543,1332,211,699,155300,24574
2016,1543,473,566,92700,24577
416,326,90,864,226200,24578
599,531,68,1313,99700,24579
216,150,66,-,82400,24580
30,30,0,-,-,24581
2302,1761,541,871,100500,24586
3512,2798,714,754,141300,24588
896,712,184,570,136800,24589
3055,2161,894,935,190100,24590
5364,3513,1851,613,114700,24592
682,534,148,603,160400,24593
647,454,193,729,105400,24594
33,13,20,-,-,24595
493,396,97,666,113800,24597
663,520,143,607,128900,24598
275,195,80,522,108000,24599
32,32,0,-,-,24601
478,417,61,-,115500,24602
379,354,25,-,58500,24603
178,147,31,666,29400,24604
3593,2747,846,614,102100,24605
69,61,8,-,-,24606
164,149,15,-,123000,24607
2840,2198,642,637,103800,24609
112,82,30,494,68500,24612
231,171,60,-,68500,24613
2907,2229,678,645,80500,24614
1126,1006,120,496,53900,24620
425,297,128,547,66300,24622
123,111,12,-,64600,24628
2846,2227,619,681,98400,24630
853,512,341,626,63500,24631
223,191,32,-,84500,24634
253,156,97,366,58900,24635
1589,1364,225,660,133000,24637
1224,935,289,647,71700,24639
2470,1628,842,541,84700,24641
287,241,46,331,54500,24646
1133,873,260,613,79200,24649
2218,1754,464,601,117900,24651
1261,1034,227,659,79100,24656
167,125,42,757,103600,24657
8153,5709,2444,600,72100,24701
645,470,175,670,119400,24712
143,113,30,-,84400,24714
203,169,34,582,57500,24715
232,232,0,-,-,24716
28,28,0,-,-,24719
39,30,9,556,108000,24724
183,118,65,-,-,24726
91,52,39,-,-,24729
91,78,13,-,62700,24731
318,244,74,-,76400,24733
210,184,26,670,53600,24736
54,15,39,-,-,24737
93,72,21,-,138900,24738
12971,9314,3657,631,113300,24740
1156,851,305,482,67400,24747
1462,1131,331,503,46500,24801
260,208,52,524,41400,24808
209,154,55,-,24200,24811
128,104,24,-,25200,24813
299,230,69,542,43200,24815
131,113,18,-,-,24816
311,222,89,582,51000,24817
447,390,57,-,55800,24818
241,198,43,-,76700,24822
147,139,8,-,61600,24823
48,48,0,-,-,24826
526,428,98,-,70500,24827
327,249,78,412,17400,24828
68,60,8,-,29400,24830
61,53,8,-,-,24831
193,171,22,-,67900,24834
194,172,22,-,40600,24836
615,534,81,713,70500,24839
28,14,14,-,-,24843
699,580,119,406,50000,24844
177,98,79,-,86400,24845
33,33,0,-,56300,24846
127,96,31,-,-,24847
54,38,16,-,-,24848
95,86,9,-,156700,24849
327,252,75,575,-,24850
170,147,23,-,54500,24851
206,131,75,516,52700,24853
110,42,68,-,33100,24854
414,318,96,700,74200,24857
108,108,0,-,78600,24860
50,12,38,-,17500,24861
269,246,23,-,52000,24862
110,110,0,-,45600,24866
184,131,53,-,46300,24867
446,338,108,544,33900,24868
214,109,105,-,54800,24869
1260,981,279,800,58900,24870
115,100,15,-,33800,24871
293,280,13,-,27900,24872
209,139,70,-,53600,24873
1189,995,194,548,80300,24874
204,131,73,498,20800,24878
218,189,29,-,-,24879
125,108,17,-,-,24880
197,161,36,-,25500,24881
133,115,18,-,50500,24882
99,90,9,-,20400,24884
0,0,0,-,-,24887
41,41,0,-,44600,24888
526,404,122,541,31600,24892
166,162,4,-,50900,24894
32,32,0,-,-,24898
4255,2798,1457,822,167400,24901
1943,1377,566,613,93300,24910
295,260,35,525,106700,24915
269,234,35,-,95400,24916
654,462,192,615,135600,24918
105,85,20,-,55200,24920
163,137,26,-,138800,24924
273,166,107,751,185700,24925
98,82,16,-,86600,24927
516,451,65,-,149700,24931
201,169,32,-,165300,24934
283,283,0,-,108600,24935
719,618,101,-,157300,24938
407,345,62,-,89200,24941
199,164,35,-,158900,24944
149,149,0,-,-,24945
563,451,112,696,115600,24946
637,482,155,638,110100,24951
1664,1353,311,629,114900,24954
128,128,0,-,213100,24957
31,31,0,-,-,24962
1787,1360,427,606,111300,24963
701,613,88,527,86800,24966
1909,1341,568,678,104800,24970
125,102,23,-,87300,24974
474,442,32,-,148100,24976
225,182,43,-,99800,24977
266,150,116,-,80700,24981
1121,1001,120,559,104800,24983
168,112,56,-,312900,24984
2296,1513,783,643,93100,24986
288,254,34,-,131400,24991
15,15,0,-,-,25002
1078,751,327,738,109800,25003
44,37,7,-,-,25005
277,228,49,-,74900,25007
38,19,19,-,55000,25008
482,438,44,708,54800,25009
306,225,81,631,106000,25011
1753,1238,515,751,89200,25015
213,157,56,695,-,25019
123,65,58,605,70400,25021
159,134,25,-,32100,25022
168,107,61,468,67200,25024
68,68,0,-,-,25025
182,152,30,-,-,25028
142,142,0,-,54300,25030
289,235,54,-,60100,25031
835,745,90,538,76800,25033
455,376,79,100-,48100,25035
159,104,55,-,-,25036
395,302,93,665,47900,25039
215,167,48,716,111900,25040
624,496,128,415,87400,25043
86,80,6,-,84500,25044
1998,1549,449,609,94400,25045
138,73,65,594,43300,25047
37,37,0,-,58800,25048
179,123,56,524,64300,25049
94,72,22,-,83300,25051
1673,1045,628,620,83400,25053
127,109,18,-,71000,25054
178,178,0,-,47800,25057
200,174,26,-,65600,25059
111,92,19,-,45100,25060
296,264,32,-,55900,25061
87,87,0,-,54500,25062
647,547,100,548,89100,25063
4520,2671,1849,734,90400,25064
389,332,57,642,85700,25067
651,511,140,634,131600,25070
4837,3660,1177,795,118900,25071
258,179,79,-,37900,25075
166,121,45,473,18000,25076
407,398,9,-,109700,25081
597,420,177,547,164100,25082
324,300,24,-,75500,25083
377,193,184,576,61700,25085
290,243,47,721,89000,25086
71,63,8,-,-,25088
89,46,43,-,75600,25090
75,75,0,-,50100,25093
66,49,17,-,55000,25102
32,13,19,-,-,25103
237,147,90,337,58100,25106
249,145,104,431,58800,25107
171,156,15,-,90600,25108
184,155,29,-,91800,25109
193,156,37,844,76200,25110
251,197,54,-,-,25111
0,0,0,-,-,25112
335,316,19,-,77300,25113
211,149,62,-,76700,25114
75,75,0,-,27100,25115
321,258,63,581,67300,25118
108,64,44,-,56900,25119
269,147,122,-,64100,25121
1413,1091,322,580,76800,25123
724,658,66,-,69700,25124
323,273,50,-,70200,25125
49,49,0,-,75600,25126
1452,1046,406,646,108000,25130
46,46,0,-,-,25132
434,296,138,238,142900,25133
140,99,41,-,57700,25134
663,264,399,434,81200,25136
174,174,0,-,123100,25139
523,413,110,585,54000,25140
84,60,24,-,86300,25141
162,131,31,-,75400,25142
3622,2449,1173,782,102000,25143
180,159,21,-,51600,25148
113,103,10,-,-,25149
122,114,8,-,45100,25152
275,220,55,-,102200,25154
56,51,5,-,-,25156
2022,1603,419,852,125400,25159
24,24,0,-,65000,25160
110,101,9,-,100300,25161
175,140,35,669,101100,25162
467,355,112,-,86400,25164
278,232,46,683,108900,25165
817,743,74,-,103300,25168
193,110,83,632,-,25169
138,109,29,-,44400,25173
197,191,6,-,36100,25174
9953,7540,2413,687,99700,25177
23,23,0,-,-,25180
501,452,49,582,49200,25181
18,18,0,-,-,25183
0,0,0,-,-,25185
382,208,174,389,81400,25186
264,192,72,-,-,25187
216,155,61,579,33900,25193
14,0,14,-,-,25201
547,454,93,-,113000,25202
20,0,20,-,-,25203
79,50,29,-,26200,25204
267,254,13,-,73900,25205
199,156,43,-,37500,25206
401,365,36,-,53700,25208
586,395,191,494,48500,25209
43,43,0,-,-,25211
2358,2022,336,645,158400,25213
132,100,32,-,50300,25214
384,317,67,566,73900,25234
413,356,57,612,51800,25235
640,535,105,628,111900,25239
603,544,59,1104,125000,25241
271,225,46,482,88700,25243
284,265,19,-,49100,25244
273,246,27,-,88800,25245
287,214,73,657,69300,25247
1187,1077,110,-,141300,25248
169,149,20,-,114300,25251
540,478,62,-,135700,25252
857,728,129,445,81500,25253
255,246,9,-,100800,25259
662,471,191,571,65900,25260
117,91,26,-,58600,25261
359,348,11,-,96800,25262
120,90,30,-,81900,25264
621,507,114,614,76500,25265
322,246,76,293,67500,25266
240,208,32,-,-,25267
338,299,39,-,66700,25268
306,275,31,-,83900,25270
3781,2540,1241,617,121900,25271
708,684,24,-,106900,25275
3201,2344,857,471,87700,25276
138,124,14,-,138500,25285
584,470,114,-,117000,25286
320,306,14,-,59100,25287
1486,304,1182,623,143000,25301
6603,4123,2480,694,109400,25302
3256,2247,1009,714,137100,25303
3439,2106,1333,751,188000,25304
0,0,0,-,-,25305
2886,1909,977,808,79800,25306
5644,4345,1299,635,116800,25309
5002,2436,2566,606,105700,25311
6440,4584,1856,728,95300,25312
5002,3584,1418,792,142100,25313
5932,4789,1143,839,215200,25314
1451,969,482,644,72700,25315
2605,2095,510,692,100600,25320
5937,2806,3131,926,148100,25401
4847,4104,743,1131,213900,25403
8370,5721,2649,973,157300,25404
4785,3617,1168,1003,156200,25405
5099,3998,1101,740,178900,25411
3081,2471,610,1076,171700,25413
6756,5008,1748,949,240000,25414
4017,3121,896,949,188200,25419
1455,1333,122,725,176100,25420
880,724,156,783,147800,25422
5052,4103,949,1074,218300,25425
5467,4508,959,970,184600,25427
4561,3899,662,1033,160600,25428
3199,2425,774,846,213500,25430
147,65,82,-,89000,25431
84,55,29,-,74700,25432
910,586,324,656,107500,25434
129,108,21,-,146300,25437
2518,1457,1061,1082,165400,25438
673,536,137,849,164400,25442
2671,1948,723,999,285700,25443
117,52,65,-,-,25444
574,441,133,1472,260700,25446
508,457,51,-,100100,25501
535,369,166,-,73900,25502
505,369,136,639,101000,25503
5278,3607,1671,751,143500,25504
193,145,48,-,111400,25505
2020,1450,570,458,73000,25506
356,255,101,760,107400,25507
3899,3104,795,595,97800,25508
2000,1648,352,849,126400,25510
396,339,57,-,68000,25511
335,263,72,-,87100,25512
1384,1000,384,541,76700,25514
899,728,171,571,83200,25515
932,696,236,831,68100,25517
562,446,116,-,-,25520
364,310,54,-,133200,25521
1117,739,378,525,90300,25523
1088,903,185,552,59300,25524
8611,6824,1787,814,184600,25526
305,273,32,620,78200,25529
2224,1722,502,572,103500,25530
117,70,47,-,-,25534
969,748,221,-,107700,25535
748,642,106,-,100900,25537
90,41,49,-,32000,25540
3933,2941,992,654,141300,25541
1873,1630,243,775,146000,25545
464,347,117,-,91300,25547
3630,2730,900,467,89200,25550
684,507,177,810,-,25555
663,498,165,423,31300,25557
702,658,44,-,105300,25559
3076,2471,605,1013,196900,25560
436,337,99,-,79800,25564
292,266,26,-,71400,25565
281,271,10,-,105000,25567
2471,1715,756,532,77100,25570
762,576,186,729,80900,25571
456,412,44,-,123700,25573
2138,1412,726,639,83500,25601
461,388,73,790,85400,25606
438,285,153,-,64600,25607
489,424,65,507,54500,25608
420,311,109,815,59800,25611
301,272,29,-,138300,25617
831,609,222,650,50200,25621
106,106,0,-,108200,25624
531,359,172,625,84100,25625
224,154,70,-,64600,25628
271,194,77,636,67300,25630
215,150,65,-,44800,25632
153,75,78,588,64200,25634
507,384,123,568,108800,25635
305,237,68,605,74300,25637
384,318,66,-,-,25638
190,158,32,-,106400,25639
205,181,24,-,82400,25644
477,392,85,613,67100,25646
279,181,98,536,104900,25647
631,477,154,696,120200,25649
134,134,0,-,84200,25650
348,281,67,-,71400,25651
493,312,181,697,118200,25652
114,60,54,-,86200,25653
71,71,0,-,80900,25654
2777,1762,1015,589,80100,25661
245,183,62,-,-,25666
460,416,44,-,43700,25669
2363,1847,516,639,88300,25670
531,402,129,905,68100,25671
201,147,54,-,-,25672
1159,848,311,523,74300,25674
512,392,120,386,70200,25676
679,493,186,257,70600,25678
148,148,0,-,60900,25688
125,111,14,-,79400,25690
471,318,153,703,62600,25692
94,63,31,-,68200,25696
51,43,8,-,-,25699
9935,5286,4649,654,125100,25701
3199,1865,1334,575,77200,25702
2200,550,1650,722,65100,25703
6916,4599,2317,691,94200,25704
9447,5703,3744,754,121900,25705
14041,9629,4412,661,112500,25801
130,109,21,-,58300,25810
71,51,20,-,-,25811
714,579,135,624,81500,25812
2424,1778,646,727,116200,25813
285,208,77,-,-,25817
168,37,131,581,-,25818
194,170,24,-,68000,25820
1077,803,274,617,82700,25823
874,751,123,717,132300,25825
144,144,0,-,53300,25826
953,777,176,698,102700,25827
598,579,19,-,87400,25831
1726,1429,297,-,159000,25832
252,179,73,-,57300,25836
108,108,0,-,96800,25837
274,147,127,-,-,25839
3482,2772,710,759,98600,25840
173,163,10,-,110100,25841
349,282,67,-,-,25843
620,503,117,368,108800,25844
271,236,35,-,56400,25845
109,92,17,-,-,25846
153,115,38,-,-,25848
97,97,0,-,-,25849
0,0,0,-,-,25853
340,326,14,-,115800,25854
10,10,0,-,-,25855
67,24,43,-,-,25857
36,36,0,-,-,25862
134,134,0,-,106800,25864
573,494,79,1003,84300,25865
135,135,0,-,-,25868
17,17,0,-,-,25870
245,194,51,883,88600,25871
263,226,37,-,107800,25873
211,200,11,-,-,25875
28,28,0,-,-,25876
376,350,26,-,99600,25878
168,114,54,-,-,25879
2620,1793,827,575,81400,25880
940,766,174,506,65600,25882
4747,3469,1278,582,91100,25901
46,36,10,-,27500,25902
176,158,18,-,-,25904
167,135,32,-,88800,25906
28,28,0,-,-,25907
53,53,0,-,-,25908
19,8,11,-,-,25911
72,72,0,-,-,25913
132,60,72,476,-,25915
64,39,25,-,-,25916
848,698,150,706,92500,25917
1852,1517,335,762,158400,25918
54,34,20,-,-,25920
789,537,252,700,53900,25921
85,62,23,-,125000,25922
160,129,31,-,-,25928
93,72,21,-,84700,25932
10,4,6,-,-,25936
535,514,21,-,122900,25938
82,82,0,-,25800,25942
2613,1864,749,675,99400,25951
319,237,82,658,65300,25958
1479,1130,349,573,83500,25962
463,380,83,528,77400,25969
406,279,127,658,154700,25971
89,67,22,-,43800,25972
1204,1050,154,440,69500,25976
69,69,0,-,-,25977
315,186,129,499,100000,25978
314,267,47,504,145600,25979
217,156,61,-,60300,25981
646,455,191,549,75500,25984
157,133,24,594,100700,25985
124,72,52,-,-,25989
17550,12274,5276,627,116000,26003
256,193,63,744,51400,26030
782,482,300,484,68700,26031
166,116,50,511,108300,26032
1196,1035,161,619,102200,26033
2001,1354,647,629,85000,26034
1026,868,158,663,115500,26035
135,135,0,-,228400,26036
2834,2230,604,551,88300,26037
1234,1023,211,674,142800,26038
292,238,54,677,184100,26039
801,524,277,720,71100,26040
6274,4758,1516,591,95300,26041
2543,2126,417,565,97800,26047
700,457,243,725,38300,26050
531,474,57,902,98600,26055
82,82,0,-,134400,26056
1047,863,184,915,130500,26059
754,613,141,725,114500,26060
9115,6107,3008,664,92700,26062
3757,2833,924,568,92600,26070
233,140,93,561,108100,26074
148,130,18,800,49200,26075
12412,7437,4975,649,85300,26101
7249,5091,2158,717,116900,26104
5296,3916,1380,644,132500,26105
547,489,58,579,109300,26133
454,323,131,557,97700,26134
313,306,7,-,-,26136
253,222,31,-,72100,26137
62,62,0,-,53800,26138
110,90,20,-,113900,26141
944,703,241,658,152300,26142
1906,1563,343,496,83700,26143
414,308,106,370,101900,26146
777,602,175,563,89900,26147
110,91,19,-,84200,26148
931,728,203,600,88800,26149
2451,1905,546,830,162900,26150
266,215,51,-,87500,26151
44,7,37,-,-,26152
3177,2530,647,653,96900,26155
1165,870,295,685,84300,26159
390,365,25,-,80500,26160
130,130,0,-,62500,26161
3124,2273,851,757,97500,26164
359,336,23,-,125000,26167
218,208,10,-,111500,26169
2246,1831,415,701,105500,26170
1369,1006,363,610,98200,26175
167,137,30,-,68100,26178
991,826,165,764,115300,26180
2511,2235,276,740,144500,26181
803,699,104,743,134200,26184
2717,2242,475,677,143300,26187
7479,5393,2086,664,123100,26201
226,226,0,-,80800,26202
24,24,0,-,-,26203
1221,948,273,584,80800,26205
1351,902,449,432,58300,26206
364,335,29,-,61900,26208
79,34,45,854,-,26209
25,25,0,-,-,26215
144,46,98,-,-,26217
1157,1037,120,731,92000,26218
229,199,30,-,77300,26222
126,113,13,-,84700,26224
15,15,0,-,-,26228
56,49,7,-,-,26230
511,411,100,-,70700,26234
15,15,0,-,-,26236
258,181,77,-,63600,26237
359,270,89,-,84000,26238
5944,3705,2239,574,123900,26241
1758,1403,355,578,93100,26250
1483,1064,419,603,151300,26253
159,100,59,-,102200,26254
423,419,4,-,93300,26257
62,62,0,-,"10,000-",26259
605,500,105,669,172300,26260
1109,817,292,474,44200,26261
121,121,0,-,224100,26263
232,197,35,566,73100,26264
65,46,19,-,-,26266
125,96,29,-,191100,26267
17,17,0,-,-,26268
439,353,86,527,85400,26269
309,269,40,668,89700,26270
143,126,17,528,104500,26271
291,248,43,618,110000,26273
256,159,97,432,65000,26275
105,105,0,-,-,26276
177,170,7,-,53100,26278
739,568,171,505,66400,26280
14,14,0,-,-,26282
605,532,73,631,101000,26283
190,190,0,-,75900,26285
1285,1027,258,479,83600,26287
1448,1016,432,576,77500,26288
48,48,0,-,-,26291
276,218,58,490,96200,26292
273,219,54,-,69400,26293
406,361,45,-,75500,26294
35,35,0,-,-,26296
41,41,0,-,122900,26298
12009,7813,4196,674,88200,26301
299,257,42,-,111900,26320
153,132,21,588,-,26321
163,88,75,731,66000,26323
111,90,21,475,62100,26325
13,13,0,-,-,26327
6081,4871,1210,882,191700,26330
544,407,137,494,84800,26335
457,406,51,496,68200,26337
307,234,73,356,81700,26338
56,47,9,-,-,26339
85,78,7,-,120000,26342
78,59,19,-,124200,26343
351,305,46,-,81100,26346
873,691,182,843,113300,26347
44,21,23,-,-,26348
26,26,0,-,-,26349
1435,860,575,528,100800,26351
4265,3246,1019,524,87200,26354
101,101,0,-,31000,26361
1318,938,380,592,107400,26362
0,0,0,-,-,26366
298,225,73,-,76800,26369
327,280,47,-,159100,26372
457,425,32,-,150300,26374
256,201,55,-,40300,26376
190,167,23,-,84200,26377
1718,1314,404,737,155300,26378
285,285,0,-,-,26384
1607,1416,191,713,120800,26385
828,685,143,720,86100,26386
209,154,55,-,98600,26404
388,308,80,-,103400,26405
1042,925,117,863,165200,26408
408,318,90,794,73500,26410
281,223,58,-,66200,26411
247,209,38,392,59700,26412
1278,986,292,419,86200,26415
3242,2163,1079,544,110400,26416
433,336,97,558,79200,26419
51,42,9,-,-,26421
183,93,90,610,-,26422
100,100,0,-,71200,26424
520,464,56,711,63200,26425
2580,2227,353,512,94500,26426
139,114,25,-,137500,26430
2449,1979,470,621,102500,26431
63,51,12,-,56800,26435
75,41,34,-,85200,26436
170,147,23,263,75900,26437
101,65,36,-,43300,26438
420,307,113,645,107500,26440
131,131,0,-,87800,26443
1391,1254,137,601,85900,26444
584,430,154,624,58300,26447
522,473,49,-,82300,26448
306,260,46,821,93500,26451
3589,2367,1222,601,85900,26452
1281,1073,208,514,105700,26456
8068,5152,2916,720,160600,26501
14448,5019,9429,809,185400,26505
12150,9131,3019,810,218400,26508
823,598,225,813,75100,26519
376,367,9,-,151800,26520
84,66,18,578,94200,26521
2072,1672,400,653,156600,26525
1001,610,391,663,75600,26534
2054,1560,494,681,126700,26537
950,737,213,637,97700,26541
1032,883,149,519,90600,26542
78,39,39,-,-,26543
1017,784,233,673,119000,26547
16875,12277,4598,755,123200,26554
523,430,93,783,135100,26559
106,79,27,-,-,26560
225,166,59,-,-,26562
191,155,36,-,-,26563
287,225,62,754,77800,26568
1450,1228,222,592,86700,26570
913,771,142,642,70000,26571
104,104,0,-,-,26572
253,194,59,737,58100,26574
285,177,108,589,107200,26575
199,187,12,-,85600,26576
304,223,81,-,54600,26581
1782,1399,383,536,78300,26582
175,160,15,-,146600,26585
95,95,0,-,85900,26586
134,122,12,-,77300,26587
1068,882,186,643,124100,26588
273,239,34,839,127000,26590
454,384,70,613,100000,26591
1739,1336,403,520,109600,26601
405,346,59,789,94000,26610
98,71,27,-,-,26611
117,103,14,-,-,26615
72,72,0,-,85600,26617
94,76,18,-,-,26619
301,174,127,542,86100,26621
526,390,136,626,144400,26623
1119,913,206,496,96900,26624
110,54,56,-,169100,26627
144,116,28,-,-,26629
165,136,29,-,65800,26631
197,184,13,-,100000,26636
55,46,9,-,-,26638
4180,3125,1055,566,102700,26651
157,96,61,-,49000,26656
133,102,31,-,86000,26660
474,437,37,-,107800,26662
159,159,0,-,76500,26676
550,435,115,-,152600,26678
837,743,94,690,136100,26679
104,80,24,-,39600,26680
556,522,34,-,82800,26681
82,72,10,-,85500,26684
236,218,18,-,43700,26690
166,127,39,-,"10,000-",26691
2185,1615,570,502,138200,26704
297,249,48,808,136800,26705
104,89,15,538,74200,26707
780,623,157,570,120300,26710
937,655,282,664,156300,26711
215,119,96,-,-,26714
277,263,14,-,105700,26716
433,225,208,447,84400,26717
1295,927,368,548,171400,26719
30,30,0,-,167900,26720
435,203,232,527,146900,26722
5404,3648,1756,582,113900,26726
99,99,0,-,155100,26731
374,326,48,-,101100,26739
546,426,120,428,179700,26743
352,149,203,393,45600,26750
2278,1489,789,643,156300,26753
399,336,63,-,146900,26755
2567,1646,921,544,130500,26757
206,153,53,-,168800,26761
819,482,337,626,116300,26763
1637,1294,343,426,90800,26764
308,197,111,773,75900,26767
394,347,47,-,89400,26801
513,321,192,689,103100,26802
286,256,30,383,78300,26804
1175,951,224,512,129300,26807
410,217,193,661,125500,26808
157,108,49,-,233300,26810
522,466,56,490,151900,26812
144,101,43,523,102800,26814
332,296,36,-,143000,26815
127,101,26,-,-,26817
299,255,44,-,153400,26818
184,93,91,-,-,26823
733,639,94,530,191800,26833
3014,1862,1152,655,104700,26836
243,201,42,-,156500,26845
2522,1846,676,570,141500,26847
750,641,109,715,122900,26851
349,214,135,609,131300,26852
284,247,37,606,138300,26855
137,76,61,-,-,26865
291,250,41,-,85000,26866
273,228,45,481,110300,26884
5637,4990,647,907,230100,27006
842,736,106,602,107400,27007
994,942,52,-,172100,27009
2232,1725,507,605,123600,27011
10411,8902,1509,809,206700,27012
2328,1643,685,712,124900,27013
299,172,127,869,86100,27014
586,457,129,506,112200,27016
3565,2528,1037,618,127500,27017
3148,2497,651,614,157300,27018
1514,1328,186,621,118700,27019
2601,1967,634,598,123500,27020
7453,5678,1775,726,130300,27021
503,441,62,575,122300,27022
5083,4398,685,808,203700,27023
1079,816,263,700,121700,27024
4654,3844,810,682,122500,27025
1853,1087,766,527,90000,27027
9863,7135,2728,669,138000,27028
15151,10840,4311,618,110700,27030
4495,4112,383,1016,174900,27040
3252,2432,820,578,155400,27041
310,221,89,682,113300,27042
2686,2043,643,606,133700,27043
3593,2786,807,676,131500,27045
893,777,116,367,69700,27046
470,420,50,825,130800,27047
3306,2793,513,584,107900,27048
1746,1433,313,765,130900,27050
3111,2335,776,747,125300,27051
4206,3120,1086,627,125500,27052
1324,1102,222,647,132000,27053
833,738,95,781,116400,27054
5604,4301,1303,640,132100,27055
8703,2978,5725,645,124200,27101
15711,8257,7454,797,153300,27103
12814,7665,5149,808,247700,27104
14713,7244,7469,699,95800,27105
19132,10617,8515,810,177700,27106
16988,11685,5303,764,124000,27107
0,0,0,-,-,27109
0,0,0,-,-,27110
15160,9834,5326,834,130600,27127
33,19,14,-,84200,27201
8975,4103,4872,626,103700,27203
12976,10099,2877,710,122200,27205
1352,1099,253,496,153800,27207
607,523,84,925,141600,27208
1524,1113,411,568,103800,27209
483,430,53,475,117400,27212
3697,3093,604,825,158300,27214
17608,10289,7319,793,161100,27215
13970,8502,5468,775,108800,27217
1173,709,464,616,80900,27229
719,586,133,839,182500,27231
1389,1245,144,802,150600,27233
1776,1440,336,1266,244900,27235
3468,2807,661,642,117200,27239
794,632,162,525,92900,27242
1751,1507,244,702,187800,27243
4581,3221,1360,1004,172000,27244
1705,1069,636,714,98400,27248
5026,3983,1043,735,145000,27249
925,788,137,598,140400,27252
12491,8797,3694,709,142600,27253
2788,2228,560,734,121000,27258
8964,3237,5727,658,80100,27260
8535,4574,3961,794,151300,27262
8636,5535,3101,699,115000,27263
19812,13073,6739,889,167700,27265
9708,7271,2437,934,244500,27278
1240,936,304,622,139500,27281
6611,4896,1715,1010,184000,27282
1141,996,145,740,168700,27283
21647,15554,6093,765,164700,27284
9538,5862,3676,610,89500,27288
636,538,98,779,121000,27291
15191,9853,5338,660,119500,27292
15020,11466,3554,675,141900,27295
4119,3074,1045,675,136500,27298
2097,1498,599,656,101500,27299
3198,2848,350,782,153200,27301
11768,8221,3547,830,172300,27302
657,519,138,656,95500,27305
2796,2171,625,576,97700,27306
2498,2302,196,789,331500,27310
1496,1103,393,553,78900,27311
8705,6932,1773,868,293300,27312
2515,2261,254,816,155900,27313
442,373,69,626,141400,27314
967,802,165,542,116700,27315
2497,1747,750,719,113200,27316
6517,4737,1780,589,113100,27317
15904,10565,5339,666,114300,27320
2447,1939,508,507,95400,27325
1387,942,445,586,100000,27326
14208,9130,5078,733,143600,27330
11103,7957,3146,844,145900,27332
26,0,26,-,-,27340
2167,1806,361,688,93700,27341
546,457,89,837,123700,27343
6920,4217,2703,683,133400,27344
2264,1895,369,815,138800,27349
2678,2095,583,724,127700,27350
959,794,165,546,135600,27355
1303,808,495,542,101300,27356
2861,2256,605,768,154100,27357
5153,4520,633,823,304400,27358
18164,12117,6047,668,121600,27360
5406,4441,965,700,124200,27370
3276,2138,1138,529,115200,27371
3769,3316,453,859,234000,27376
3622,2654,968,952,155800,27377
2278,1466,812,442,97700,27379
7121,2706,4415,710,101200,27401
7894,4062,3832,838,176500,27403
18398,8722,9676,729,106600,27405
23826,12927,10899,775,122500,27406
19451,9000,10451,825,134600,27407
8235,5957,2278,826,220100,27408
8138,2772,5366,823,139300,27409
24534,14972,9562,924,208000,27410
11865,8366,3499,859,220900,27455
7080,5258,1822,794,156400,27501
13237,10320,2917,1221,293200,27502
1260,1144,116,-,283700,27503
5301,3681,1620,740,119100,27504
2344,1591,753,772,123100,27505
605,485,120,608,114600,27507
521,366,155,602,89800,27508
1519,847,672,827,131000,27509
6994,2342,4652,967,273800,27510
13761,9127,4634,996,228200,27511
17862,11257,6605,1077,290000,27513
9860,4675,5185,1098,432200,27514
15038,10064,4974,1166,346900,27516
10836,7235,3601,1155,374300,27517
8224,5485,2739,1174,376200,27518
18210,13898,4312,1317,380800,27519
14192,10281,3911,982,154000,27520
2262,1601,661,698,130900,27521
4788,3706,1082,938,149900,27522
4083,2786,1297,1102,343500,27523
4737,3229,1508,662,132000,27524
5481,4145,1336,786,144000,27525
15489,12249,3240,1043,219500,27526
7379,6011,1368,1555,212000,27527
17464,12304,5160,992,172400,27529
15525,8916,6609,648,128700,27530
0,0,0,-,-,27531
13124,6998,6126,843,139600,27534
6688,2860,3828,600,91600,27536
8905,6265,2640,690,97800,27537
7714,6738,976,1161,279500,27539
11789,10030,1759,1228,260000,27540
1562,1221,341,974,179000,27541
3626,2307,1319,727,101600,27542
1835,1268,567,708,107200,27544
9202,6632,2570,962,164200,27545
6833,4376,2457,770,144100,27546
9455,6666,2789,692,124600,27549
784,615,169,1020,132400,27551
835,594,241,674,72300,27553
267,126,141,686,82100,27555
89,66,23,617,-,27556
2717,1766,951,622,96600,27557
802,675,127,911,174700,27559
11732,5531,6201,1260,290300,27560
692,536,156,-,229000,27562
2208,1420,788,531,79100,27563
9446,6340,3106,707,122200,27565
282,127,155,646,121500,27568
3009,1961,1048,840,98800,27569
2021,1708,313,747,271600,27571
2877,2673,204,915,177100,27572
4771,2051,2720,631,112500,27573
5581,4619,962,638,110900,27574
6111,3868,2243,814,123400,27576
8669,5290,3379,794,139000,27577
1373,1229,144,763,153700,27581
180,36,144,478,95000,27582
2748,2461,287,789,131500,27583
22232,17135,5097,1045,283100,27587
3054,2162,892,599,91300,27589
7157,5524,1633,830,147000,27591
5880,4794,1086,846,168700,27592
6770,5609,1161,868,172200,27596
8542,6189,2353,858,149700,27597
3760,1062,2698,819,287200,27601
19852,12250,7602,994,194100,27603
18198,10147,8051,979,166600,27604
2937,1051,1886,1048,314900,27605
17952,6725,11227,953,247100,27606
8509,4383,4126,1018,386600,27607
4892,3399,1493,1054,532300,27608
15248,7897,7351,997,266400,27609
24570,14447,10123,949,151400,27610
17395,9281,8114,1060,302500,27612
17896,12019,5877,999,309700,27613
12519,9174,3345,1181,375000,27614
18127,12471,5656,1044,284800,27615
18624,11477,7147,998,179400,27616
8762,4042,4720,1184,261500,27617
9496,2763,6733,750,215900,27701
18705,11613,7092,1005,163500,27703
14158,7680,6478,895,143700,27704
20273,9322,10951,966,246700,27705
20444,9007,11437,949,220000,27707
473,414,59,1320,199600,27709
8350,7607,743,1170,202800,27712
22509,12406,10103,1027,221500,27713
8097,4036,4061,662,84900,27801
7734,4986,2748,712,140400,27803
11785,6780,5005,819,127600,27804
1598,1212,386,681,89800,27805
976,807,169,599,70900,27806
2622,1790,832,675,112000,27807
832,751,81,737,157800,27808
1795,1345,450,656,88500,27809
1926,1216,710,670,125600,27810
1137,753,384,499,89900,27812
274,170,104,693,80000,27813
806,751,55,-,96400,27814
810,622,188,620,125300,27816
2856,2024,832,782,123700,27817
530,417,113,918,64000,27818
121,99,22,590,65000,27819
1173,881,292,569,93400,27820
210,129,81,652,45000,27821
3366,2647,719,674,118200,27822
3230,2047,1183,707,62900,27823
697,449,248,832,-,27824
46,20,26,844,67100,27825
235,210,25,-,33000,27826
18,16,2,-,108300,27827
3299,2062,1237,676,115800,27828
729,473,256,638,95800,27829
1888,1353,535,742,94800,27830
1437,1013,424,756,59100,27831
1241,843,398,707,72400,27832
22858,9241,13617,731,109700,27834
2287,1915,372,697,164400,27837
1187,832,355,918,81400,27839
236,157,79,538,54100,27840
11,10,1,-,40000,27841
714,587,127,831,302700,27842
434,338,96,1000,84000,27843
1278,912,366,696,79600,27844
958,755,203,619,89200,27845
1290,971,319,560,82200,27846
329,205,124,686,49100,27847
595,414,181,757,85500,27849
3190,2360,830,685,154600,27850
1932,1582,350,657,96000,27851
1209,961,248,674,85800,27852
133,115,18,-,93900,27853
2308,1446,862,624,84500,27855
6507,4922,1585,639,133300,27856
410,333,77,690,76600,27857
22406,10240,12166,832,167100,27858
691,518,173,664,87600,27860
28,25,3,-,47200,27861
310,190,120,880,128900,27862
4770,3416,1354,893,119400,27863
1960,1197,763,646,77600,27864
845,784,61,-,103900,27865
373,159,214,948,65800,27866
945,649,296,777,61100,27869
10660,6440,4220,696,98700,27870
1866,1241,625,678,70500,27871
207,130,77,613,42300,27872
157,115,42,903,90600,27873
1757,1147,610,644,73900,27874
284,224,60,-,-,27875
681,514,167,700,100200,27876
818,374,444,753,75700,27878
117,93,24,781,134700,27879
1151,922,229,738,128200,27880
32,16,16,686,-,27881
2858,1877,981,708,93800,27882
1361,970,391,648,85400,27883
445,445,0,-,80500,27884
374,347,27,-,78000,27885
8386,5190,3196,661,89100,27886
909,645,264,709,83800,27888
10860,7179,3681,688,129200,27889
997,514,483,612,91000,27890
2063,1512,551,770,83700,27891
5807,3943,1864,647,87900,27892
15340,7114,8226,709,97400,27893
8244,5947,2297,847,167500,27896
800,426,374,449,75000,27897
14646,8855,5791,860,158900,27909
4632,2887,1745,688,89000,27910
453,289,164,972,263300,27915
381,310,71,1359,224100,27916
334,158,176,747,137100,27917
503,366,137,681,167100,27919
533,345,188,891,314000,27920
1857,1352,505,1148,216300,27921
391,355,36,814,81500,27922
256,155,101,662,220600,27923
1297,1190,107,921,77000,27924
1432,1095,337,756,117100,27925
578,483,95,1040,132600,27926
384,295,89,825,494400,27927
830,597,233,693,91000,27928
662,638,24,-,270100,27929
5014,3511,1503,742,126900,27932
637,507,130,515,166200,27935
426,329,97,793,197600,27936
1628,1323,305,814,153800,27937
577,397,180,818,121800,27938
888,628,260,1008,161500,27939
243,224,19,-,209000,27941
336,288,48,938,69100,27942
211,202,9,-,393800,27943
5215,3837,1378,829,167400,27944
441,414,27,-,120700,27946
556,485,71,856,259500,27947
4713,3016,1697,1110,245300,27948
3208,2707,501,1249,404700,27949
805,718,87,984,191200,27950
421,248,173,859,136600,27953
3000,2071,929,923,247900,27954
165,146,19,-,295000,27956
594,513,81,-,107000,27957
3796,3360,436,1229,265600,27958
1298,863,435,1296,317300,27959
121,46,75,1003,-,27960
3106,1684,1422,618,86100,27962
287,205,82,1272,335600,27964
272,225,47,-,138300,27965
364,244,120,680,200000,27966
114,95,19,675,56100,27967
92,24,68,-,-,27968
1320,883,437,595,85600,27970
98,71,27,-,353800,27972
513,366,147,861,210700,27973
468,343,125,1085,219000,27974
1314,1238,76,1222,225600,27976
93,62,31,-,174100,27978
632,499,133,752,127700,27979
844,754,90,-,122600,27980
678,340,338,981,195300,27981
40,31,9,-,-,27982
3551,2410,1141,643,80700,27983
155,68,87,870,157100,27985
532,342,190,628,86800,27986
10649,7197,3452,662,126800,28001
432,373,59,859,139500,28006
259,216,43,750,71300,28007
572,373,199,623,84900,28009
8667,5849,2818,818,172700,28012
4829,2932,1897,701,103400,28016
0,0,0,-,-,28017
2050,1619,431,660,104800,28018
0,0,0,-,-,28019
817,666,151,837,83200,28020
5270,3804,1466,675,124500,28021
5609,4122,1487,781,147300,28023
19907,13273,6634,815,159500,28025
22089,15573,6516,877,195100,28027
11636,8195,3441,1194,275800,28031
1177,723,454,863,147000,28032
1251,1108,143,715,117500,28033
6307,4418,1889,677,119400,28034
5793,4538,1255,1030,381900,28036
7868,6232,1636,813,295300,28037
25,11,14,-,-,28039
3169,2465,704,668,93900,28040
8297,4932,3365,605,103000,28043
12449,6670,5779,783,93600,28052
15000,7506,7494,797,125300,28054
12402,9855,2547,815,158600,28056
1172,948,224,731,122800,28071
463,326,137,609,151600,28072
2022,1246,776,622,84700,28073
6003,5414,589,1360,258300,28075
194,108,86,489,32400,28076
203,120,83,677,83100,28077
21600,15912,5688,1196,266900,28078
12063,10167,1896,1215,199900,28079
2921,2323,598,679,136800,28080
9704,5879,3825,809,132900,28081
9207,5604,3603,865,119900,28083
10132,7009,3123,674,112700,28086
1030,752,278,812,133000,28088
24,18,6,-,-,28089
3410,2693,717,675,101600,28090
977,714,263,519,88400,28091
15180,10892,4288,685,132100,28092
2387,1817,570,753,160400,28097
1327,889,438,678,123400,28098
280,201,79,818,142300,28101
28,24,4,-,74500,28102
3896,2915,981,802,157100,28103
10315,9445,870,1214,298900,28104
17053,12243,4810,1111,225400,28105
2791,2292,499,766,202600,28107
33,33,0,-,105800,28108
65,28,37,585,115400,28109
18212,12630,5582,897,169000,28110
9315,6912,2403,876,150800,28112
2882,2196,686,694,86000,28114
12975,9261,3714,835,185100,28115
14591,10683,3908,1106,369800,28117
1203,776,427,638,53600,28119
7819,5903,1916,769,145600,28120
2329,1931,398,821,177000,28124
887,747,140,817,199400,28125
2879,2336,543,697,154100,28127
3003,2241,762,677,115700,28128
2269,1887,382,635,145000,28129
900,655,245,760,130900,28133
4400,2350,2050,1042,185200,28134
1660,1170,490,704,73900,28135
1107,946,161,690,146400,28137
3746,2819,927,711,110800,28138
8069,6156,1913,595,124400,28139
9356,4864,4492,741,120100,28144
10636,8066,2570,720,148100,28146
8922,5907,3015,764,136900,28147
10927,7146,3781,671,110800,28150
9573,6205,3368,704,116300,28152
1087,666,421,780,96500,28159
1256,812,444,625,89300,28160
1979,1443,536,718,154200,28163
5746,4634,1112,672,169000,28164
3641,2896,745,765,159100,28166
1071,930,141,-,123600,28167
3856,3189,667,622,120800,28168
48,21,27,585,-,28169
4660,2732,1928,715,93900,28170
16737,15011,1726,1116,355800,28173
2923,1986,937,787,142100,28174
6442,2165,4277,1367,269400,28202
7746,2679,5067,1237,446900,28203
3163,929,2234,1116,395200,28204
19544,8139,11405,843,188800,28205
4695,1568,3127,784,93200,28206
3819,2920,899,1117,852800,28207
13762,4476,9286,801,90900,28208
10336,5621,4715,981,309700,28209
20658,11233,9425,993,277800,28210
12487,7434,5053,1048,418800,28211
15714,5205,10509,884,124100,28212
15353,7303,8050,906,145500,28213
13849,10382,3467,1088,137400,28214
20485,12227,8258,948,137900,28215
19283,10605,8678,1042,126900,28216
10316,3088,7228,983,108500,28217
15873,10872,5001,1124,328500,28226
19810,13324,6486,977,161900,28227
0,0,0,-,-,28244
15338,5450,9888,1062,154300,28262
29239,17843,11396,1144,166800,28269
12828,9239,3589,1221,316400,28270
13780,6923,6857,1108,160500,28273
26012,18515,7497,1358,316900,28277
8811,6563,2248,1219,234400,28278
0,0,0,-,-,28280
0,0,0,-,-,28282
7010,2420,4590,651,90000,28301
13000,6192,6808,826,129900,28303
14389,8045,6344,933,115100,28304
2870,1543,1327,830,192600,28305
15048,9246,5802,854,152500,28306
4860,33,4827,1182,159900,28307
22,0,22,1161,-,28308
0,0,0,-,-,28310
14587,6803,7784,820,150700,28311
7248,4819,2429,659,124800,28312
23082,10195,12887,926,126400,28314
4885,2908,1977,796,140900,28315
1766,1489,277,605,89300,28318
3962,2526,1436,606,82100,28320
1344,1045,299,791,169500,28323
194,136,58,814,72700,28325
7105,3984,3121,1267,146500,28326
5951,4925,1026,730,179800,28327
10092,6294,3798,660,94900,28328
148,113,35,-,58500,28330
97,45,52,725,92500,28332
3834,2626,1208,684,69600,28333
9763,6271,3492,682,108500,28334
4344,2844,1500,692,90400,28337
1851,1321,530,651,75300,28338
2838,1904,934,755,89600,28339
3959,2667,1292,499,68400,28340
1467,977,490,719,81600,28341
79,64,15,875,105900,28342
513,294,219,615,74300,28343
1137,862,275,703,84900,28344
4867,3067,1800,599,75700,28345
532,344,188,661,73700,28347
12373,8448,3925,877,146400,28348
1220,981,239,718,102800,28349
70,70,0,-,-,28350
1782,1404,378,675,72600,28351
9494,5452,4042,631,88500,28352
1900,1514,386,1035,160200,28356
983,748,235,563,94800,28357
13472,7577,5895,657,84100,28358
4852,3370,1482,629,78800,28360
498,322,176,775,56700,28363
5122,3783,1339,559,64900,28364
6022,4020,2002,671,87900,28365
2119,1595,524,578,91300,28366
18,8,10,575,135700,28367
1100,831,269,607,63900,28369
2372,1668,704,859,91300,28371
4588,2860,1728,590,78500,28372
1015,693,322,906,132900,28373
7667,6391,1276,1634,299200,28374
41,29,12,825,101800,28375
14364,9536,4828,819,145200,28376
4338,2543,1795,581,64100,28377
10568,6904,3664,616,86100,28379
2719,1930,789,690,84200,28382
2959,2214,745,549,62500,28383
4114,2934,1180,579,66500,28384
992,746,246,655,80500,28385
1889,1286,603,606,59500,28386
6760,3823,2937,840,251700,28387
8312,3780,4532,890,127500,28390
2115,1692,423,739,117100,28391
682,537,145,774,115900,28392
783,467,316,570,68400,28393
2126,1480,646,715,159600,28394
867,707,160,770,119500,28395
1066,785,281,693,85700,28396
2796,1535,1261,577,77900,28398
828,682,146,672,100000,28399
10216,3563,6653,834,146600,28401
17517,5404,12113,859,243200,28403
13545,7975,5570,987,197800,28405
12654,10523,2131,1180,262100,28409
14027,10976,3051,1119,254900,28411
16731,9616,7115,941,196700,28412
1436,994,442,818,113100,28420
507,402,105,690,95300,28421
3156,2453,703,776,201400,28422
897,673,224,737,83100,28423
29,6,23,634,90000,28424
3925,2655,1270,759,134700,28425
2813,1662,1151,1150,321700,28428
2880,2223,657,820,158900,28429
778,634,144,611,64800,28430
2878,1967,911,512,71900,28431
746,475,271,547,103700,28432
2002,1486,516,645,90200,28433
611,407,204,542,115500,28434
968,817,151,576,86300,28435
811,600,211,768,99000,28436
694,524,170,555,75300,28438
590,448,142,378,66300,28439
1433,813,620,528,74200,28441
708,542,166,627,82200,28442
7690,6447,1243,968,229800,28443
878,791,87,834,83100,28444
2868,2010,858,1157,197900,28445
564,453,111,580,126900,28447
385,235,150,-,-,28448
809,625,184,1617,405800,28449
1000,736,264,822,173600,28450
13383,9973,3410,1008,162800,28451
367,228,139,781,58800,28452
1280,886,394,645,67100,28453
815,560,255,1110,116400,28454
743,648,95,680,101000,28455
1548,1266,282,709,91800,28456
3702,2980,722,755,151900,28457
2736,1817,919,627,85800,28458
4062,2452,1610,1134,214600,28460
8618,6866,1752,917,264000,28461
5437,4169,1268,766,153000,28462
3566,2359,1207,598,81000,28463
956,667,289,763,74500,28464
3403,2608,795,980,274600,28465
4117,3005,1112,606,116200,28466
4689,4324,365,1061,189300,28467
2393,1946,447,909,249400,28468
2744,2249,495,858,339000,28469
5029,3523,1506,786,153400,28470
7570,5116,2454,602,89600,28472
1829,1556,273,644,101500,28478
2312,1535,777,787,166500,28479
1211,712,499,1394,759700,28480
7995,3790,4205,651,82600,28501
8729,5706,3023,749,108600,28504
812,715,97,-,84100,28508
676,545,131,698,180700,28510
291,204,87,761,169600,28511
1606,1165,441,934,364900,28512
4006,2569,1437,602,99300,28513
913,556,357,619,97100,28515
5113,3650,1463,832,184000,28516
3342,2299,1043,710,116900,28518
145,93,52,-,165600,28519
195,160,35,-,142500,28520
944,743,201,846,140700,28521
932,664,268,705,112000,28523
161,137,24,-,121000,28524
1075,705,370,643,80900,28525
1219,747,472,677,80600,28526
453,422,31,-,122900,28527
214,159,55,788,155300,28528
872,586,286,749,124600,28529
2779,1686,1093,680,84600,28530
630,537,93,626,209200,28531
8178,4022,4156,1021,141500,28532
19,0,19,-,-,28533
42,18,24,-,-,28537
803,421,382,778,83800,28538
5874,3642,2232,1020,140700,28539
17572,9365,8207,866,148300,28540
1952,11,1941,1176,-,28543
2256,606,1650,981,125000,28544
16603,8385,8218,899,155500,28546
2135,6,2129,1279,-,28547
5705,4073,1632,711,96800,28551
67,67,0,-,-,28552
155,143,12,-,179200,28553
86,86,0,-,38800,28554
1780,1188,592,680,131900,28555
475,383,92,-,159400,28556
6716,4349,2367,865,231200,28557
11349,7634,3715,766,152200,28560
16258,10756,5502,896,184900,28562
9071,6765,2306,821,155800,28570
1230,1001,229,935,271700,28571
2435,1746,689,598,87700,28572
955,688,267,655,116100,28573
6353,4450,1903,1045,144100,28574
262,207,55,1297,301300,28575
129,117,12,-,150600,28577
2154,1405,749,584,78000,28578
240,219,21,-,170400,28579
4137,2875,1262,624,88700,28580
116,116,0,-,-,28581
733,666,67,-,174200,28582
100,79,21,921,101000,28583
4846,3428,1418,981,218900,28584
1533,1139,394,511,91600,28585
3069,2300,769,510,87200,28586
172,94,78,665,96000,28587
98,68,30,-,181800,28589
9533,6951,2582,881,167600,28590
1832,1338,494,1175,363000,28594
19993,12933,7060,683,158700,28601
11235,7283,3952,668,128800,28602
3000,2221,779,853,234500,28604
1450,991,459,857,394900,28605
695,579,116,460,95700,28606
12747,6177,6570,824,260100,28607
2311,1951,360,722,138500,28609
3790,2918,872,799,109200,28610
494,354,140,-,65000,28611
4819,3563,1256,601,104300,28612
8553,5976,2577,695,135100,28613
890,724,166,520,99800,28615
71,55,16,-,163000,28616
976,613,363,509,168700,28617
960,764,196,856,175000,28618
610,398,212,697,94500,28619
4097,2765,1332,650,123400,28621
892,759,133,595,103200,28622
717,576,141,714,126800,28623
597,516,81,-,99600,28624
14638,10847,3791,742,143300,28625
1141,978,163,1156,201500,28626
374,286,88,684,131000,28627
154,94,60,738,98600,28628
0,0,0,-,-,28629
8004,5925,2079,645,118900,28630
330,269,61,-,162200,28631
1830,1423,407,757,106000,28634
1576,1204,372,640,96900,28635
1891,1395,496,608,113000,28636
661,421,240,643,127300,28637
4554,3347,1207,650,116500,28638
2066,1353,713,580,180200,28640
2428,1638,790,529,98900,28642
1583,1213,370,666,109800,28643
479,381,98,-,138400,28644
18200,12620,5580,621,105600,28645
224,171,53,-,-,28646
41,35,6,-,184700,28647
436,397,39,-,128200,28649
4358,3281,1077,734,128500,28650
2729,2132,597,538,113400,28651
0,0,0,-,-,28652
1452,1291,161,526,128300,28654
21204,15152,6052,645,117600,28655
4207,3245,962,671,130800,28657
10094,6902,3192,728,122100,28658
8409,5588,2821,615,113500,28659
854,707,147,693,161200,28660
58,36,22,-,-,28662
257,228,29,-,186000,28663
934,776,158,591,124100,28665
132,22,110,523,-,28666
197,114,83,785,81400,28667
159,151,8,-,410800,28668
1215,867,348,665,134600,28669
1268,1020,248,530,129500,28670
185,116,69,657,146200,28671
0,0,0,-,-,28672
2482,2067,415,1020,277300,28673
3021,2136,885,600,127000,28675
1624,1274,350,684,145700,28676
12912,8211,4701,728,117600,28677
2216,1690,526,746,146700,28678
810,531,279,684,197400,28679
9478,7307,2171,606,133900,28681
555,425,130,614,446200,28682
660,529,131,611,99300,28683
922,682,240,1025,172700,28684
751,684,67,913,89500,28685
613,556,57,532,135500,28689
3540,2720,820,609,117500,28690
1572,1333,239,764,208600,28692
828,560,268,798,133900,28693
3414,2575,839,649,149900,28694
5515,4031,1484,629,158100,28697
832,733,99,769,182800,28698
1505,1224,281,605,217500,28701
194,157,37,786,227700,28702
8227,5345,2882,1046,224200,28704
2891,2228,663,566,132900,28705
75,54,21,-,-,28707
225,174,51,-,160000,28708
874,694,180,676,178200,28709
5705,3783,1922,732,217400,28711
8348,5969,2379,669,206400,28712
3425,2450,975,643,132100,28713
7055,5193,1862,605,139600,28714
10058,7392,2666,781,185600,28715
7183,5223,1960,686,160700,28716
731,500,231,598,338400,28717
204,155,49,-,176300,28718
2843,2027,816,612,100700,28719
47,22,25,-,214300,28720
4181,2950,1231,735,173600,28721
2952,1836,1116,809,197200,28722
3326,1445,1881,645,221700,28723
9,5,4,-,-,28725
1307,577,730,740,141400,28726
1503,1318,185,-,166800,28729
3548,2743,805,881,212700,28730
3781,3013,768,900,212600,28731
7272,5685,1587,1028,209900,28732
7,0,7,-,-,28733
11942,8779,3163,712,149400,28734
163,98,65,573,-,28735
413,279,134,862,343300,28736
9369,7046,2323,792,234400,28739
534,416,118,427,123300,28740
1849,1335,514,890,476200,28741
1137,948,189,774,198500,28742
888,585,303,603,153700,28743
307,278,29,-,291100,28745
1113,922,191,700,263500,28746
952,728,224,673,168500,28747
4625,3666,959,714,166100,28748
13,13,0,-,-,28749
1718,1449,269,807,194600,28751
12101,8268,3833,599,107700,28752
4321,3296,1025,676,154800,28753
3316,2508,808,638,186600,28754
1726,1361,365,721,185500,28756
72,72,0,-,396400,28757
2899,2377,522,808,234000,28759
3168,2388,780,648,128700,28761
2723,2108,615,594,104500,28762
1285,1001,284,702,160900,28763
505,439,66,-,200600,28766
3020,2468,552,730,229100,28768
3140,2576,564,596,122300,28771
524,512,12,-,151200,28772
1249,1059,190,868,253600,28773
569,440,129,974,374000,28774
136,94,42,-,-,28775
3550,2881,669,561,146700,28777
4058,2782,1276,811,151400,28778
7323,5467,1856,761,179900,28779
413,320,93,668,165100,28781
3090,2352,738,959,222700,28782
692,361,331,631,150400,28783
3249,2459,790,766,220400,28785
9662,6514,3148,694,168700,28786
8411,6928,1483,760,219500,28787
2305,1478,827,917,150500,28789
1238,1069,169,904,162200,28790
6626,4951,1675,849,200600,28791
13924,8523,5401,767,157900,28792
6637,2493,4144,753,279600,28801
15156,7679,7477,1060,239800,28803
8381,5431,2950,1043,316600,28804
9033,5236,3797,835,231600,28805
17359,10252,7107,898,181600,28806
2090,1613,477,463,102300,28901
594,532,62,-,139700,28902
4047,3004,1043,689,163000,28904
1204,1030,174,692,153500,28905
7787,6232,1555,733,158800,28906
533,478,55,-,131300,28909
826,598,228,473,70600,29001
2387,1855,532,847,63000,29003
3796,2670,1126,689,84500,29006
886,754,132,732,81400,29009
4269,2950,1319,650,69400,29010
740,608,132,566,123000,29014
579,422,157,581,66300,29015
7117,5839,1278,1303,241600,29016
1182,949,233,573,90200,29018
9233,6975,2258,669,124400,29020
761,589,172,532,114400,29030
504,433,71,683,74100,29031
1789,1407,382,824,71600,29032
5428,3154,2274,862,118800,29033
8329,7638,691,1228,270800,29036
376,200,176,908,91900,29037
845,700,145,716,77000,29038
1189,916,273,637,75600,29039
3597,2637,960,724,114100,29040
1905,1323,582,675,64100,29042
2078,1672,406,623,85500,29044
9193,7296,1897,1037,153200,29045
118,109,9,-,-,29046
1507,1241,266,567,83800,29047
2050,1642,408,766,92600,29048
240,200,40,-,103800,29051
729,437,292,727,58600,29052
6729,4742,1987,862,74000,29053
3598,2982,616,716,168300,29054
1622,1272,350,690,65500,29055
876,687,189,558,70400,29056
1767,1449,318,652,104700,29058
2252,1587,665,574,75300,29059
5332,4086,1246,1070,115600,29061
47,17,30,-,-,29062
13398,10997,2401,1192,165500,29063
280,248,32,-,82200,29065
3509,2556,953,664,89200,29067
1974,1440,534,629,73200,29069
5710,4759,951,643,130900,29070
21296,16861,4435,1003,212400,29072
16973,13397,3576,856,132300,29073
58,58,0,-,-,29074
986,823,163,675,194000,29075
5877,5006,871,671,121100,29078
25,0,25,-,-,29079
1080,799,281,417,63100,29080
558,427,131,681,83400,29081
181,165,16,-,60600,29082
1123,957,166,636,75400,29101
7125,5349,1776,638,98900,29102
526,413,113,685,84000,29104
491,352,139,661,74700,29105
1153,943,210,713,64000,29107
7603,4893,2710,734,83200,29108
634,525,109,525,71500,29111
1668,1308,360,564,64900,29112
518,448,70,495,55800,29113
737,537,200,558,69900,29114
10611,5861,4750,658,87800,29115
0,0,0,-,-,29117
6594,4559,2035,699,141500,29118
18,11,7,-,-,29122
2905,2388,517,747,91100,29123
913,667,246,836,65800,29125
947,847,100,683,132700,29126
3718,3066,652,806,167400,29127
1910,1630,280,683,73900,29128
1083,680,403,588,94100,29129
2362,1906,456,854,162200,29130
353,286,67,1044,89400,29133
3279,2497,782,773,99600,29135
736,579,157,595,74100,29137
3740,2449,1291,643,82700,29138
1976,1428,548,694,99500,29142
318,252,66,939,66300,29145
635,548,87,689,72400,29146
0,0,0,-,-,29147
3069,2256,813,448,90800,29148
16348,8929,7419,723,122000,29150
588,0,588,1140,-,29152
5838,4089,1749,871,92200,29153
11144,8213,2931,828,131500,29154
3334,2469,865,743,84600,29160
4048,2913,1135,744,88500,29161
1172,847,325,510,97500,29162
686,470,216,696,78400,29163
1847,1410,437,627,81400,29164
352,287,65,492,88200,29166
1406,1128,278,807,58700,29168
10579,5226,5353,862,139600,29169
8165,6229,1936,883,130300,29170
3655,2529,1126,772,100100,29172
160,145,15,-,76500,29175
1286,1030,256,625,53900,29178
5518,3938,1580,697,104700,29180
7705,2166,5539,999,155000,29201
180,116,64,1536,284200,29202
14934,7241,7693,822,89900,29203
7466,4134,3332,779,133900,29204
10874,5274,5600,794,260400,29205
8118,5435,2683,1002,238300,29206
3,3,0,-,-,29207
0,0,0,-,-,29208
13585,8243,5342,926,140900,29209
16511,6288,10223,824,120000,29210
12097,8488,3609,998,166700,29212
20559,11180,9379,956,143200,29223
0,0,0,-,-,29225
16854,11969,4885,1197,166600,29229
13584,7294,6290,795,125700,29301
6579,5034,1545,815,150900,29302
8734,4179,4555,675,84000,29303
6571,2788,3783,685,95200,29306
8164,5021,3143,765,138100,29307
9538,7225,2313,842,138900,29316
251,236,15,-,34300,29320
1277,997,280,761,58200,29321
3147,2617,530,726,150000,29322
5150,4162,988,716,110800,29323
125,65,60,-,36000,29324
5578,3730,1848,754,87100,29325
73,43,30,-,-,29329
3150,2119,1031,681,89900,29330
83,83,0,-,51000,29331
1081,927,154,616,68500,29332
182,114,68,723,60000,29333
4764,3338,1426,891,147100,29334
1702,1422,280,858,75100,29335
13,13,0,-,-,29338
7720,5610,2110,631,82700,29340
7320,4937,2383,683,131600,29341
105,89,16,-,73900,29346
11648,9614,2034,759,137100,29349
568,405,163,522,51900,29351
1726,1346,380,602,79900,29353
343,338,5,-,84000,29355
3410,2781,629,714,146900,29356
8168,5330,2838,658,92800,29360
259,140,119,723,40500,29364
3776,3302,474,799,135300,29365
50,50,0,-,-,29368
5233,4594,639,847,163500,29369
327,297,30,1000,89000,29370
1508,1105,403,623,73100,29372
145,117,28,1325,27900,29373
1280,982,298,784,141000,29374
28,13,15,-,-,29375
2870,2318,552,784,143900,29376
453,231,222,702,57100,29377
53,0,53,-,-,29378
7498,4955,2543,590,78100,29379
1830,1528,302,671,89000,29384
2944,2188,756,733,105100,29385
5623,3952,1671,647,105900,29388
3856,1885,1971,1409,940100,29401
8527,3070,5457,1079,362800,29403
371,0,371,1423,-,29404
9903,4071,5832,869,130500,29405
12392,4408,7984,903,128500,29406
15040,8239,6801,986,255300,29407
15,0,15,950,-,29409
8104,4908,3196,977,205700,29410
16502,11571,4931,1225,279200,29412
16550,10331,6219,1162,222200,29414
10404,4979,5425,925,141500,29418
8524,5738,2786,1091,175900,29420
0,0,0,-,-,29423
0,0,0,-,-,29424
543,458,85,780,159800,29426
1055,979,76,961,311700,29429
2511,1960,551,733,130800,29431
1160,962,198,463,72200,29432
232,214,18,-,111400,29434
1734,1509,225,805,89100,29435
1728,1248,480,707,89100,29436
1176,963,213,686,118900,29437
1051,953,98,978,307200,29438
1027,568,459,1000,626000,29439
10447,7577,2870,691,128900,29440
20708,13308,7400,1047,159200,29445
403,368,35,-,84000,29446
790,547,243,831,92600,29448
3542,2882,660,694,197400,29449
1202,986,216,779,90400,29450
1934,1562,372,1938,791200,29451
147,109,38,655,51200,29452
432,342,90,798,104800,29453
8956,7114,1842,1191,324700,29455
10685,6861,3824,1099,145100,29456
1108,874,234,898,117300,29458
13006,10099,2907,848,164700,29461
21446,13780,7666,1438,395200,29464
12680,10752,1928,1596,407300,29466
758,527,231,548,84000,29468
538,499,39,665,272800,29469
1939,1402,537,862,150900,29470
573,510,63,679,89200,29471
2678,2065,613,893,119600,29472
978,863,115,772,72700,29474
1046,871,175,525,82300,29475
2508,1951,557,755,98400,29477
2483,1742,741,627,109100,29479
674,564,110,532,54700,29481
769,659,110,2181,1248900,29482
28245,20429,7816,951,174200,29483
19194,13476,5718,1115,190800,29485
1093,948,145,772,293800,29487
8457,5244,3213,709,91100,29488
4836,3403,1433,1588,482400,29492
39,34,5,-,78300,29493
18234,10942,7292,751,163800,29501
9834,7218,2616,846,149900,29505
7070,4131,2939,621,101600,29506
3965,3089,876,640,74700,29510
1982,1345,637,744,143600,29511
6279,4051,2228,566,63600,29512
331,217,114,745,56700,29516
509,363,146,541,77200,29518
120,112,8,-,60000,29519
5690,3798,1892,549,95300,29520
753,427,326,534,57200,29525
15997,11235,4762,833,155200,29526
9607,6703,2904,725,124900,29527
963,791,172,498,81300,29530
8212,5258,2954,640,85500,29532
5691,3370,2321,542,72300,29536
2028,1532,496,658,68000,29540
3472,2910,562,874,107200,29541
173,124,49,-,93300,29543
2006,1535,471,783,126800,29544
583,423,160,694,68600,29545
990,695,295,545,72000,29546
1056,728,328,563,54800,29547
12551,8592,3959,643,90700,29550
3400,2770,630,621,72000,29554
2084,1539,545,535,92100,29555
4988,3316,1672,632,68200,29556
4964,2990,1974,663,75600,29560
1029,700,329,473,62800,29563
297,191,106,680,46900,29564
2536,1944,592,554,64900,29565
7563,5789,1774,819,173100,29566
219,147,72,671,41400,29567
5610,4544,1066,953,152100,29568
6255,4773,1482,767,98500,29569
1327,950,377,444,52300,29570
5514,3653,1861,552,83200,29571
4541,3071,1470,859,260700,29572
4399,3078,1321,430,73000,29574
7840,5940,1900,880,197300,29575
13323,11104,2219,1118,194100,29576
13117,6765,6352,859,163000,29577
15072,9692,5380,1045,191900,29579
500,415,85,631,56300,29580
1976,1412,564,518,88500,29581
7957,5580,2377,945,257700,29582
1956,1570,386,595,68100,29583
1017,688,329,660,58300,29584
6841,5364,1477,1127,323600,29585
16522,11457,5065,909,164300,29588
830,612,218,894,52200,29590
1977,1323,654,543,66100,29591
364,286,78,-,44600,29592
696,496,200,605,49300,29593
36,22,14,-,85000,29594
944,729,215,1025,55200,29596
5172,1700,3472,740,290000,29601
14134,8842,5292,786,145600,29605
16431,8054,8377,930,186100,29607
11871,6919,4952,754,172700,29609
11147,5872,5275,717,86400,29611
0,0,0,-,-,29613
73,4,69,480,-,29614
16414,8964,7450,898,215400,29615
10458,5809,4649,714,118300,29617
4925,3789,1136,532,104800,29620
16134,10963,5171,833,164300,29621
6273,3139,3134,612,68500,29624
12194,7913,4281,774,128600,29625
4979,3942,1037,744,116000,29626
6796,4880,1916,616,103900,29627
953,643,310,591,49900,29628
6380,3002,3378,690,123400,29630
5522,2475,3047,904,211300,29631
58,0,58,1008,-,29634
586,561,25,-,171300,29635
1110,923,187,755,84400,29638
401,289,112,740,108900,29639
11932,8346,3586,727,116300,29640
12371,9826,2545,808,170400,29642
941,888,53,-,240000,29643
7275,5642,1633,786,135600,29644
3722,2831,891,738,85100,29645
10567,5929,4638,615,103500,29646
10306,6666,3640,713,148200,29649
13397,9331,4066,972,212200,29650
17362,12796,4566,726,155700,29651
1850,1538,312,646,113900,29653
3852,2957,895,607,88600,29654
2884,2302,582,674,86500,29655
5781,4590,1191,722,102700,29657
168,168,0,-,101500,29658
43,25,18,560,-,29659
2103,1522,581,660,96700,29661
6175,4136,2039,898,148700,29662
931,789,142,557,150100,29664
94,21,73,-,-,29665
2622,2121,501,637,94400,29666
111,104,7,-,103300,29667
4630,3550,1080,645,104400,29669
3679,2455,1224,644,140600,29670
7047,5774,1273,681,117000,29671
5327,4071,1256,787,243500,29672
10405,7656,2749,742,147400,29673
2601,2324,277,756,227700,29676
8860,5790,3070,718,131700,29678
10892,8680,2212,1013,168800,29680
19272,16552,2720,1034,213700,29681
1440,1162,278,608,115900,29682
80,80,0,-,77600,29683
1582,1221,361,663,86700,29684
708,636,72,-,169900,29685
323,246,77,-,138600,29686
15779,11232,4547,806,148200,29687
1674,1444,230,764,203600,29689
7914,6007,1907,695,143300,29690
4392,2973,1419,624,105100,29691
1964,1393,571,678,53200,29692
5769,4202,1567,640,124100,29693
1977,1444,533,799,171100,29696
5082,3727,1355,693,115500,29697
3667,2502,1165,656,70700,29702
1643,1267,376,440,155200,29704
7415,5256,2159,596,87800,29706
10658,9735,923,1340,282100,29707
11359,9193,2166,1189,303800,29708
2608,2163,445,545,69200,29709
13180,10210,2970,962,188900,29710
759,657,102,735,110400,29712
1191,920,271,665,91700,29714
11119,8431,2688,990,217100,29715
487,428,59,499,122000,29717
1543,1195,348,515,87300,29718
16659,11966,4693,695,117600,29720
19,0,19,538,-,29724
588,480,108,758,119100,29726
623,483,140,540,45400,29727
4029,2430,1599,676,91000,29728
793,676,117,586,92400,29729
21666,12386,9280,836,134400,29730
22923,15642,7281,898,169400,29732
0,0,0,-,-,29733
920,865,55,675,77400,29741
961,834,127,604,99500,29742
457,274,183,627,-,29743
11146,8775,2371,713,147300,29745
10337,6112,4225,759,123400,29801
16322,12863,3459,912,187500,29803
2405,2012,393,629,124900,29805
1167,826,341,677,87800,29809
1879,1194,685,615,50300,29810
4197,2923,1274,653,83900,29812
502,288,214,720,57100,29816
1829,1331,498,552,63800,29817
644,499,145,475,60300,29819
519,411,108,579,114900,29821
2509,1735,774,537,122100,29824
73,53,20,438,54300,29826
1110,698,412,600,56500,29827
343,241,102,314,66800,29828
4257,3148,1109,722,141500,29829
1621,1311,310,657,81500,29831
2121,1401,720,555,103000,29832
655,406,249,637,52800,29834
3155,2356,799,713,129400,29835
227,217,10,-,49800,29836
196,174,22,-,191700,29838
126,126,0,-,66000,29840
13161,8646,4515,749,131800,29841
2856,2095,761,653,87700,29842
537,427,110,672,77700,29843
80,78,2,-,150000,29844
402,295,107,633,68300,29845
1751,1379,372,778,87000,29847
269,231,38,521,95400,29848
105,76,29,478,-,29849
131,111,20,-,44400,29850
2967,2184,783,722,85200,29851
2624,1855,769,566,69400,29853
1048,837,211,683,86600,29856
5517,4734,783,780,179000,29860
0,0,0,-,-,29899
6000,3458,2542,909,198500,29902
0,0,0,-,-,29904
10,0,10,-,-,29905
8398,3773,4625,1000,126700,29906
4897,3762,1135,1217,242700,29907
8999,8131,868,1383,284700,29909
14347,9759,4588,1224,269200,29910
573,491,82,538,73000,29911
0,0,0,-,-,29912
193,185,8,-,614100,29915
537,470,67,-,68700,29916
1651,1247,404,505,70600,29918
4067,3328,739,981,208300,29920
78,58,20,525,47100,29921
230,192,38,-,39200,29922
180,147,33,639,48100,29923
1706,1226,480,540,100700,29924
10398,8075,2323,1148,427500,29926
2921,1686,1235,953,139600,29927
7796,6002,1794,1182,555300,29928
455,372,83,589,77800,29929
99,82,17,585,111500,29932
353,287,66,-,122900,29934
1815,622,1193,1046,163900,29935
5273,3679,1594,788,113000,29936
154,142,12,-,38000,29939
1438,1185,253,635,113700,29940
261,191,70,-,-,29941
212,176,36,-,200000,29943
1664,1198,466,574,80000,29944
1994,1651,343,631,60100,29945
2687,1622,1065,760,286300,30002
21669,16393,5276,1301,373800,30004
12823,8825,3998,1392,395200,30005
10618,5600,5018,969,142800,30008
6563,3698,2865,1339,272000,30009
4762,3606,1156,1087,141100,30011
9171,4878,4293,891,104100,30012
9376,6395,2981,960,165100,30013
13150,7791,5359,860,140700,30014
17695,12926,4769,1120,112100,30016
7386,6360,1026,1301,243400,30017
13568,11979,1589,1597,220600,30019
7208,1607,5601,859,126000,30021
23603,16785,6818,1320,369700,30022
22974,19819,3155,1565,306700,30024
3378,2650,728,954,167200,30025
8067,6913,1154,1124,237400,30028
11323,6971,4352,969,371500,30030
17751,8054,9697,920,93800,30032
12952,7306,5646,1121,268600,30033
15891,9798,6093,967,102900,30034
8126,4067,4059,1001,98900,30035
13971,7035,6936,1035,121200,30038
14301,10952,3349,1262,150100,30039
22485,18496,3989,1206,280900,30040
21693,18555,3138,1222,324800,30041
27447,19558,7889,1204,184400,30043
27356,17554,9802,1156,154200,30044
11062,9431,1631,1450,173600,30045
12524,6894,5630,938,148800,30046
20562,15363,5199,1156,183500,30047
20361,16335,4026,1179,167200,30052
4070,3213,857,951,161400,30054
1012,845,167,931,151100,30055
915,737,178,763,154400,30056
19664,11309,8355,1076,104000,30058
13003,5374,7629,935,128700,30060
23675,18577,5098,1231,286800,30062
17616,14402,3214,1087,244800,30064
19757,15746,4011,1234,227600,30066
20143,7933,12210,1057,298600,30067
12009,10032,1977,1189,376500,30068
174,39,135,675,65400,30070
7413,3488,3925,1033,162400,30071
342,230,112,786,154000,30072
19424,15784,3640,1221,364300,30075
16447,9831,6616,1143,286400,30076
10962,8326,2636,1190,179500,30078
1110,488,622,929,133900,30079
24922,11022,13900,1060,244700,30080
11281,7187,4094,1156,229300,30082
19973,9016,10957,922,106900,30083
13898,9321,4577,1046,191100,30084
13925,11511,2414,1229,169700,30087
9900,5791,4109,971,102100,30088
13952,6954,6998,1062,307700,30092
18040,5529,12511,976,114900,30093
11189,8839,2350,1066,151300,30094
25553,10874,14679,1156,181400,30096
15807,11609,4198,1386,382200,30097
19705,15178,4527,1203,209800,30101
14184,10147,4037,1019,160400,30102
5681,3720,1961,746,123400,30103
1448,1058,390,821,100000,30104
754,646,108,746,152400,30105
8322,4481,3841,1028,132200,30106
4921,4314,607,995,209900,30107
2902,1954,948,681,100700,30108
4839,3200,1639,688,125100,30110
2401,1926,475,780,111300,30113
18528,12641,5887,946,243400,30114
13268,11118,2150,1158,259700,30115
8428,6202,2226,832,125200,30116
13854,6681,7173,775,119400,30117
0,0,0,-,-,30118
14243,8904,5339,877,152700,30120
8702,4958,3744,879,130300,30121
9243,4550,4693,1020,109500,30122
1209,879,330,689,132900,30124
8867,5569,3298,681,111600,30125
14851,10597,4254,1032,189700,30126
21659,17816,3843,1180,172900,30127
12949,9506,3443,980,170500,30132
14910,9721,5189,957,122300,30134
21511,16424,5087,1100,157700,30135
637,427,210,768,105700,30137
1470,1069,401,738,96900,30139
8295,6374,1921,1061,151200,30141
8647,6751,1896,884,212900,30143
20010,11351,8659,1181,177200,30144
2575,2280,295,1061,160500,30145
1657,1093,564,713,103900,30147
221,201,20,-,159100,30148
45,0,45,858,-,30149
15123,11215,3908,1179,240000,30152
6669,4160,2509,753,98100,30153
16606,13203,3403,1072,136600,30157
13499,7731,5768,652,125400,30161
0,0,0,-,-,30164
15058,8741,6317,756,132100,30165
9355,4282,5073,883,109700,30168
993,840,153,747,97900,30170
1207,933,274,694,123800,30171
1994,1383,611,657,111300,30173
2072,1571,501,853,146200,30175
2703,1678,1025,637,125800,30176
361,286,75,823,120100,30177
1130,942,188,845,128900,30178
6112,4688,1424,852,108900,30179
13118,9469,3649,980,143000,30180
983,768,215,577,116300,30182
1755,1377,378,1081,220200,30183
2568,2210,358,925,159400,30184
1467,1159,308,868,98700,30185
2855,2476,379,1120,159800,30187
22680,17244,5436,1331,199400,30188
13446,10680,2766,1257,222000,30189
4288,2816,1472,632,129500,30204
1060,919,141,715,247500,30205
1098,979,119,1055,153300,30206
11006,6381,4625,1004,138300,30213
10707,8749,1958,1084,200100,30214
12483,10796,1687,1146,242500,30215
852,566,286,936,80500,30216
3607,2435,1172,642,106500,30217
583,552,31,-,78600,30218
1855,1230,625,993,118400,30220
1612,1020,592,569,87900,30222
13140,7600,5540,781,105200,30223
9293,6024,3269,894,125700,30224
13037,9579,3458,1102,133100,30228
3391,2287,1104,842,107500,30230
7792,5767,2025,793,138200,30233
704,422,282,908,90500,30234
15839,8570,7269,915,115500,30236
11987,7011,4976,996,88000,30238
10704,6344,4360,766,144600,30240
8315,4110,4205,862,116600,30241
8133,6524,1609,1130,153800,30248
38,0,38,-,-,30250
874,540,334,764,112700,30251
13867,11780,2087,1282,175800,30252
18660,10902,7758,1055,153700,30253
837,697,140,581,114200,30256
1764,1374,390,723,127700,30257
903,758,145,821,141700,30258
1010,822,188,1089,174000,30259
8284,4068,4216,912,84800,30260
21566,13400,8166,920,173400,30263
12836,9707,3129,1186,195800,30265
3352,2396,956,956,112400,30268
13252,9848,3404,1337,300700,30269
4874,3612,1262,1164,88900,30273
12544,5064,7480,895,74000,30274
0,0,0,-,-,30275
5260,4546,714,1067,204000,30276
7713,6965,748,1327,216900,30277
24101,15363,8738,1069,136400,30281
27,22,5,-,-,30284
203,162,41,-,85000,30285
9007,5556,3451,615,83700,30286
3182,2341,841,904,88600,30288
23,9,14,917,237500,30289
3002,2504,498,885,248000,30290
8153,2820,5333,875,85000,30291
1956,1734,222,739,169100,30292
1226,984,242,638,61400,30293
13554,10221,3333,1056,126900,30294
1503,1114,389,647,146400,30295
9050,5491,3559,1136,89200,30296
8973,3714,5259,837,60600,30297
1279,284,995,911,149600,30303
11816,6681,5135,1318,568800,30305
10684,6085,4599,1199,569100,30306
8970,4844,4126,1121,458200,30307
10626,3056,7570,1214,246400,30308
13480,6359,7121,1242,296300,30309
11022,4302,6720,918,92700,30310
13843,5042,8801,804,101100,30311
11331,3863,7468,1027,235900,30312
2103,702,1401,941,227200,30313
7398,2143,5255,842,76300,30314
11769,4025,7744,800,97400,30315
13063,8111,4952,1117,202000,30316
5578,3520,2058,949,268400,30317
20763,7898,12865,1039,193800,30318
18519,10121,8398,1392,449900,30319
0,0,0,-,-,30322
13948,5427,8521,1243,334000,30324
3393,1147,2246,1726,290800,30326
9333,7265,2068,1365,879600,30327
15923,8884,7039,1314,379100,30328
11503,2832,8671,1193,293000,30329
23468,11418,12050,914,150600,30331
0,0,0,-,-,30332
0,0,0,-,-,30334
138,7,131,1078,-,30336
5390,1555,3835,799,161700,30337
13891,8914,4977,1348,426800,30338
11840,3819,8021,1226,328200,30339
9407,4245,5162,965,167900,30340
12243,5559,6684,1090,266500,30341
12397,5926,6471,1181,556100,30342
13096,5499,7597,969,94000,30344
9966,5162,4804,1169,366500,30345
3346,101,3245,1449,248900,30346
25276,13793,11483,902,125900,30349
16849,5845,11004,1090,438500,30350
6153,1903,4250,894,89300,30354
5270,3001,2269,989,267200,30360
1782,584,1198,1573,215200,30363
5039,3304,1735,598,81000,30401
564,393,171,710,112700,30410
853,520,333,459,46500,30411
32,26,6,-,150000,30412
685,519,166,629,98800,30413
2579,1955,624,782,114200,30415
4051,2634,1417,628,83300,30417
423,336,87,456,52500,30420
1504,1083,421,509,71800,30421
69,14,55,632,-,30423
487,416,71,756,79400,30425
258,142,116,716,61700,30426
4174,2960,1214,608,114200,30427
989,697,292,471,54900,30428
67,46,21,835,-,30429
1829,1025,804,556,72600,30434
4420,2878,1542,549,80600,30436
19,11,8,-,-,30438
4036,2344,1692,576,88400,30439
732,510,222,685,77500,30441
2960,1970,990,540,60000,30442
1226,796,430,540,59400,30445
430,342,88,594,63800,30446
17,17,0,-,65000,30448
49,29,20,725,65500,30449
872,681,191,820,84000,30450
17,14,3,-,178100,30451
490,409,81,805,79300,30452
2476,1493,983,532,57800,30453
309,254,55,-,69200,30454
196,153,43,-,79100,30455
769,594,175,390,68500,30456
2310,1594,716,559,69900,30457
15989,6201,9788,792,140500,30458
0,0,0,-,-,30460
5113,3521,1592,772,141500,30461
16,10,6,-,-,30464
4598,3157,1441,588,85300,30467
156,132,24,436,111100,30470
1897,1291,606,501,60100,30471
982,797,185,430,85900,30473
6670,4016,2654,587,108300,30474
0,0,0,-,-,30475
1061,595,466,506,63800,30477
9365,3604,5761,791,152200,30501
8195,4055,4140,890,161300,30504
15491,12236,3255,999,207700,30506
8154,5717,2437,875,128700,30507
2299,1762,537,653,96600,30510
1314,978,336,631,116700,30511
8129,6463,1666,682,195600,30512
4863,3566,1297,700,172900,30513
717,569,148,843,75200,30516
4292,3621,671,1176,212800,30517
16308,11959,4349,1076,199100,30518
13680,10254,3426,1401,213900,30519
1700,1257,443,676,115100,30520
1966,1608,358,529,101500,30521
432,422,10,-,173800,30522
5050,3923,1127,809,152400,30523
3025,2112,913,653,145900,30525
1581,1248,333,976,198600,30527
9095,6465,2630,739,147200,30528
3977,2466,1511,745,114000,30529
2041,1643,398,808,130000,30530
3618,2468,1150,724,138100,30531
9565,6035,3530,862,184500,30533
10303,8029,2274,867,199400,30534
2760,2071,689,754,150400,30535
3399,2594,805,828,187200,30536
601,443,158,408,192000,30537
982,770,212,730,88500,30538
7139,5139,2000,694,151800,30540
556,454,102,577,187800,30541
12091,9271,2820,1060,189700,30542
1437,1190,247,951,118100,30543
340,242,98,943,172100,30545
3049,2519,530,648,205000,30546
1204,975,229,594,150300,30547
6198,5522,676,1055,262700,30548
8382,6321,2061,797,174800,30549
650,532,118,850,196800,30552
3059,2040,1019,711,135300,30553
2617,2009,608,839,134400,30554
958,608,350,375,113400,30555
1683,1339,344,752,107900,30557
1977,1480,497,839,122100,30558
1911,1509,402,980,175700,30559
1960,1704,256,880,164800,30560
422,311,111,664,69800,30562
1988,1643,345,769,129300,30563
1238,960,278,718,160400,30564
1516,1316,200,721,134300,30565
2771,1877,894,888,135300,30566
1223,941,282,967,192000,30567
703,459,244,775,157000,30568
1852,1557,295,1014,203300,30571
410,372,38,-,122700,30572
81,73,8,-,299300,30573
346,258,88,823,130000,30575
902,801,101,683,158500,30576
8051,5519,2532,609,99800,30577
10,0,10,-,-,30581
1697,1347,350,739,172500,30582
9089,3018,6071,774,96900,30601
0,0,0,-,-,30602
16033,5061,10972,806,162800,30605
17162,7702,9460,841,196500,30606
3445,2083,1362,758,145400,30607
0,0,0,-,-,30609
513,369,144,931,152200,30619
4110,3527,583,1145,144500,30620
1863,1635,228,913,279400,30621
4187,3002,1185,979,205100,30622
84,82,2,-,109200,30623
1250,911,339,620,60400,30624
981,725,256,880,225800,30625
1004,828,176,403,88200,30627
2516,2082,434,746,135500,30628
1806,1247,559,754,107300,30629
913,645,268,488,103900,30630
704,503,201,538,64700,30631
3190,2389,801,682,113300,30633
943,831,112,589,102000,30634
5936,4188,1748,578,83900,30635
828,758,70,1042,164700,30641
4818,3494,1324,678,356500,30642
6145,4470,1675,651,128900,30643
2535,1638,897,751,133000,30646
1197,887,310,595,89900,30648
4353,3270,1083,847,219900,30650
8784,4991,3793,853,150600,30655
5504,4359,1145,902,186400,30656
341,247,94,729,83900,30660
3383,2031,1352,587,105100,30662
1077,760,317,568,184000,30663
21,19,2,-,-,30664
30,14,16,767,-,30665
3186,2373,813,888,145600,30666
394,325,69,838,96600,30667
653,528,125,508,69500,30668
1250,848,402,723,76700,30669
3188,2103,1085,625,86000,30673
6734,5536,1198,911,231000,30677
573,477,96,-,121100,30678
13911,9498,4413,929,135500,30680
2499,1906,593,838,135900,30683
13906,8388,5518,675,121400,30701
11918,7826,4092,668,98400,30705
6056,4580,1476,708,111300,30707
77,62,15,-,83400,30708
2449,1963,486,540,162300,30710
1396,1167,229,675,85300,30711
9528,4802,4726,717,162800,30720
17782,10642,7140,676,105600,30721
1570,1209,361,711,144100,30725
0,0,0,-,-,30726
7738,5509,2229,634,113400,30728
784,581,203,667,59600,30730
967,728,239,494,101500,30731
739,520,219,754,102000,30733
1423,1110,313,753,127100,30734
2182,1632,550,632,115000,30735
15699,12862,2837,763,152800,30736
1478,1246,232,1082,143100,30738
1785,1514,271,875,173700,30739
3181,2531,650,761,159200,30740
11534,7280,4254,745,85800,30741
2916,1355,1561,677,115700,30742
494,315,179,760,150500,30746
5804,3804,2000,599,82500,30747
1309,1087,222,987,264700,30750
29,29,0,-,72400,30751
3373,2409,964,610,116100,30752
2524,1728,796,611,53600,30753
3260,2386,874,753,117600,30755
81,24,57,-,75000,30756
985,678,307,837,100700,30757
1875,1586,289,640,176400,30802
319,257,62,510,78800,30803
946,704,242,711,85600,30805
51,48,3,-,57600,30807
1620,1213,407,643,82200,30808
13838,11309,2529,1350,237000,30809
694,523,171,530,60800,30810
0,0,0,-,-,30812
12683,9373,3310,1159,167400,30813
2544,2044,500,755,117900,30814
13767,9524,4243,956,104200,30815
654,495,159,647,116300,30816
3299,2341,958,721,120800,30817
260,200,60,-,90000,30818
463,354,109,655,72800,30820
332,266,66,539,53200,30821
238,171,67,-,37600,30822
625,558,67,443,48400,30823
6530,3803,2727,622,116700,30824
1728,1075,653,543,63700,30828
5046,3436,1610,560,90100,30830
1324,767,557,517,67900,30833
6501,2136,4365,639,60800,30901
249,249,0,-,168800,30903
10258,4875,5383,730,102000,30904
1022,7,1015,1252,-,30905
19903,11389,8514,818,83300,30906
18218,13330,4888,946,151900,30907
17496,8668,8828,824,146900,30909
0,0,0,-,-,30912
1042,710,332,474,70500,31001
1068,806,262,514,66600,31002
40,39,1,-,65000,31003
6023,4639,1384,973,156700,31005
2017,1372,645,599,65300,31006
423,358,65,267,62200,31007
7339,5322,2017,936,136600,31008
541,425,116,638,66000,31009
301,253,48,533,93400,31011
541,370,171,425,52600,31012
4471,3219,1252,577,91600,31014
7691,4481,3210,630,85700,31015
560,415,145,-,74200,31016
633,471,162,523,66500,31017
421,325,96,638,80900,31018
831,606,225,665,96300,31019
662,511,151,835,59500,31020
10217,5744,4473,589,106700,31021
532,434,98,679,108300,31022
5656,3594,2062,543,78300,31023
8167,6133,2034,692,164000,31024
429,404,25,730,145700,31025
3453,2278,1175,624,57000,31027
2308,1683,625,1016,146900,31028
5730,4199,1531,677,140400,31029
6218,3948,2270,623,98100,31030
2243,1743,500,635,73200,31031
5137,4126,1011,848,146400,31032
890,714,176,810,71800,31033
470,395,75,650,75000,31035
4257,2641,1616,666,121300,31036
1303,763,540,662,49700,31037
257,226,31,-,188400,31038
0,0,0,-,-,31039
296,206,90,621,63100,31041
530,445,85,761,77600,31042
1165,809,356,463,62800,31044
30,21,9,-,-,31045
1186,1103,83,400,162400,31046
4448,3598,850,979,185800,31047
660,518,142,618,79200,31049
367,258,109,771,-,31050
86,51,35,340,59000,31051
3122,2741,381,835,148200,31052
594,434,160,671,50800,31054
2353,1352,1001,510,60400,31055
895,614,281,567,83700,31057
595,511,84,639,83900,31058
892,723,169,621,67500,31060
16046,8695,7351,686,113100,31061
13,0,13,-,-,31062
1858,1133,725,556,75500,31063
3533,2486,1047,781,118000,31064
406,314,92,343,80600,31065
529,434,95,659,150600,31066
78,72,6,-,34700,31067
1421,869,552,574,42600,31068
7144,4455,2689,794,141200,31069
364,261,103,444,84800,31070
479,380,99,483,68400,31071
574,441,133,589,68500,31072
1012,765,247,736,68400,31075
1339,978,361,510,58700,31076
589,427,162,548,70800,31077
1174,750,424,621,67300,31078
815,623,192,647,81600,31079
80,40,40,-,-,31081
3802,2630,1172,685,86700,31082
131,99,32,521,43600,31083
18,18,0,-,-,31084
402,295,107,865,106600,31085
3010,2406,604,776,66100,31087
20345,13384,6961,926,134300,31088
1948,1192,756,655,70100,31089
305,214,91,445,74300,31090
1364,901,463,343,68200,31091
2943,1777,1166,544,97400,31092
11343,5713,5630,790,92300,31093
475,376,99,584,93000,31094
2304,1592,712,524,62300,31096
530,412,118,845,100000,31097
983,0,983,1162,-,31098
3300,729,2571,573,72800,31201
11841,5686,6155,741,91000,31204
8963,3900,5063,693,62100,31206
4,4,0,-,-,31207
13670,7592,6078,887,193800,31210
6348,3662,2686,688,92900,31211
0,0,0,-,-,31213
5705,4491,1214,844,139500,31216
6061,3728,2333,668,68500,31217
5449,3482,1967,880,157600,31220
1774,628,1146,718,120300,31301
3172,2356,816,805,144500,31302
793,610,183,860,176600,31303
0,0,0,-,-,31304
2502,1764,738,675,107700,31305
339,330,9,-,135600,31307
2704,2052,652,975,129700,31308
276,141,135,706,94500,31309
6124,5208,916,883,155200,31312
15845,7328,8517,958,122000,31313
0,0,0,-,-,31314
2466,11,2455,1222,-,31315
3732,2727,1005,757,131100,31316
216,205,11,-,151500,31318
3155,2308,847,998,122000,31320
2479,1950,529,698,131000,31321
9418,5643,3775,1200,191900,31322
531,417,114,720,84500,31323
8564,5747,2817,1409,238500,31324
7303,5049,2254,1018,170200,31326
164,164,0,-,-,31327
1434,944,490,1182,480300,31328
3190,2270,920,872,122100,31329
3051,2572,479,915,114900,31331
8068,2461,5607,907,239400,31401
11644,5429,6215,926,114600,31404
14085,7223,6862,1014,183400,31405
13462,7697,5765,994,169500,31406
4742,3098,1644,1139,187900,31407
3175,1105,2070,774,117300,31408
0,0,0,-,-,31409
9815,7460,2355,1206,244400,31410
3927,3624,303,1329,477600,31411
4607,1767,2840,767,79100,31415
21445,10412,11033,998,157200,31419
5951,3078,2873,629,77000,31501
7995,5432,2563,644,84900,31503
3574,2484,1090,532,78600,31510
777,609,168,526,89000,31512
5948,4180,1768,529,72000,31513
5285,3893,1392,630,97100,31516
267,235,32,-,88500,31518
1268,994,274,560,67100,31519
9143,4258,4885,727,88500,31520
7311,5327,1984,1244,361200,31522
5240,4304,936,779,149900,31523
0,0,0,-,-,31524
11057,6079,4978,882,137300,31525
322,256,66,1057,365200,31527
274,242,32,-,61400,31532
6085,3403,2682,552,100000,31533
4186,3111,1075,622,86000,31535
2902,2088,814,577,83100,31537
5000,3630,1370,538,78600,31539
1028,757,271,540,65300,31542
1659,1375,284,373,66600,31543
320,225,95,603,63100,31544
5937,3368,2569,612,99000,31545
2391,1559,832,610,124100,31546
127,0,127,1213,-,31547
7471,4423,3048,936,148200,31548
942,612,330,607,38300,31549
305,227,78,-,62600,31550
409,231,178,461,-,31551
345,345,0,-,40600,31552
1830,1482,348,618,72800,31553
1781,1419,362,601,59500,31554
1004,860,144,572,94300,31555
22,20,2,-,-,31556
1126,812,314,650,100300,31557
7912,4175,3737,985,167200,31558
1033,753,280,498,116200,31560
97,97,0,-,-,31561
739,582,157,498,80600,31562
480,395,85,647,77900,31563
789,703,86,1030,163400,31565
1288,1179,109,691,63700,31566
282,172,110,-,129700,31567
376,330,46,-,118100,31568
2134,1623,511,820,140600,31569
11938,5388,6550,637,82400,31601
13071,5439,7632,787,135900,31602
7869,4830,3039,984,154000,31605
1272,1003,269,496,78200,31606
3747,2524,1223,681,107400,31620
773,588,185,446,67400,31622
32,27,5,-,83800,31623
500,434,66,512,72900,31624
522,391,131,600,104000,31625
1402,1011,391,757,106900,31626
115,81,34,608,99600,31627
261,173,88,1818,-,31629
190,124,66,389,44500,31630
166,156,10,471,48800,31631
4255,3209,1046,951,131200,31632
2170,1516,654,516,68500,31634
2172,1124,1048,622,82200,31635
3639,2327,1312,662,131100,31636
1198,872,326,708,73700,31637
478,316,162,649,68700,31638
4095,2946,1149,544,88200,31639
691,502,189,726,121100,31641
1624,1172,452,520,63000,31642
3383,2518,865,626,89300,31643
2054,1339,715,666,109900,31645
1331,858,473,786,58300,31647
390,202,188,740,52600,31648
499,446,53,928,94700,31649
1291,863,428,562,57700,31650
0,0,0,-,-,31698
0,0,0,-,-,31699
7465,2512,4953,620,73700,31701
11263,5113,6150,661,72100,31705
10556,4229,6327,748,113100,31707
6324,3160,3164,696,98000,31709
268,192,76,-,70300,31711
510,325,185,545,64000,31712
2412,1662,750,535,73500,31714
951,753,198,670,78900,31716
3477,2024,1453,615,65800,31719
138,89,49,683,86000,31720
7872,5768,2104,889,164900,31721
141,102,39,534,56900,31722
3508,2252,1256,608,81300,31730
567,474,93,686,135600,31733
362,225,137,708,131300,31735
829,616,213,623,95000,31738
176,85,91,850,88000,31743
1079,763,316,580,73800,31744
69,52,17,-,46700,31747
856,560,296,609,85600,31749
6880,4298,2582,625,83300,31750
301,284,17,-,94100,31756
3992,2799,1193,857,150300,31757
8602,6059,2543,868,151700,31763
525,418,107,708,77000,31764
1159,904,255,454,91500,31765
7871,3957,3914,680,84300,31768
2081,1300,781,534,80100,31771
148,118,30,-,135900,31772
1349,1056,293,759,117600,31773
2238,1577,661,494,70200,31774
1050,828,222,553,69900,31775
1029,852,177,548,88600,31778
3113,1998,1115,618,88600,31779
764,560,204,601,69200,31780
693,512,181,538,72800,31781
356,341,15,675,72000,31783
250,180,70,705,101800,31784
547,405,142,620,90600,31787
3460,2205,1255,564,109800,31788
372,317,55,713,100300,31789
583,414,169,699,81300,31790
4676,2810,1866,684,93000,31791
9425,5506,3919,819,133100,31792
3545,2484,1061,647,153200,31793
9877,4880,4997,592,95500,31794
786,630,156,721,74300,31795
501,363,138,626,101800,31796
292,204,88,-,45900,31798
1142,993,149,777,102300,31801
2243,1461,782,500,83800,31803
2124,2010,114,1258,216000,31804
1032,676,356,554,81300,31805
1882,1240,642,701,95600,31806
1149,975,174,1026,171700,31807
2523,2219,304,1047,221600,31808
106,71,35,528,91700,31810
2188,1878,310,1081,207700,31811
234,192,42,-,-,31812
171,123,48,-,-,31814
755,492,263,529,64100,31815
2043,1187,856,752,79600,31816
3568,3082,486,1248,266000,31820
87,77,10,-,44200,31821
2204,1494,710,826,145700,31822
312,281,31,-,145100,31823
721,554,167,563,33400,31824
963,700,263,564,58600,31825
974,751,223,781,98800,31826
925,688,237,449,56700,31827
349,321,28,-,255600,31829
891,515,376,768,119200,31830
1317,1132,185,495,161900,31831
81,50,31,-,63300,31832
2902,1815,1087,750,110800,31833
449,367,82,484,70200,31836
3097,605,2492,576,145400,31901
7218,2365,4853,665,57800,31903
13273,6579,6694,851,161200,31904
3493,5,3488,1447,-,31905
8821,3687,5134,722,128900,31906
19846,11284,8562,872,110900,31907
15037,7612,7425,1021,158700,31909
10362,8292,2070,1416,242700,32003
2070,1678,392,801,74900,32008
1190,1030,160,1084,154900,32009
5164,4159,1005,847,157900,32011
6887,5683,1204,839,120200,32024
7540,4719,2821,812,109700,32025
0,0,0,-,-,32026
1736,1447,289,1250,136300,32033
14562,10978,3584,1189,294400,32034
3900,3292,608,841,99700,32038
2334,1936,398,698,131600,32040
8775,6722,2053,889,168000,32043
798,661,137,869,78200,32044
3251,2539,712,904,124600,32046
2646,1812,834,572,68800,32052
1185,1006,179,838,74600,32053
3500,2431,1069,555,88900,32054
6106,4062,2044,770,105800,32055
1218,988,230,661,104800,32058
975,824,151,728,81000,32059
8366,6152,2214,748,100600,32060
101,81,20,-,189700,32061
863,731,132,429,79300,32062
4478,3323,1155,777,133600,32063
2195,1002,1193,654,82300,32064
12429,9007,3422,1223,174600,32065
1748,1389,359,603,110100,32066
18501,14604,3897,1126,142500,32068
1121,847,274,725,89200,32071
120,120,0,-,71300,32072
15042,9556,5486,990,157600,32073
220,25,195,1209,95000,32079
9863,6825,3038,1105,327100,32080
3798,3040,758,1692,358600,32081
12638,10158,2480,1298,473300,32082
517,295,222,673,88800,32083
12685,7890,4795,995,172400,32084
11329,8492,2837,1088,195600,32086
1328,1021,307,742,70700,32087
5586,3675,1911,757,86400,32091
11471,9833,1638,1677,263900,32092
956,760,196,-,82500,32094
3169,2368,801,1222,216800,32095
1120,850,270,577,97200,32096
6263,4958,1305,1244,173300,32097
1084,909,175,693,115900,32102
2776,1913,863,739,113400,32110
2758,1959,799,538,80200,32112
2066,1786,280,782,73700,32113
13381,4252,9129,822,91900,32114
9760,4941,4819,859,80700,32117
8931,5357,3574,896,202500,32118
9961,6009,3952,937,123100,32119
1451,1225,226,1725,211100,32124
12920,9591,3329,1080,161900,32127
7782,6588,1194,1283,230200,32128
9487,6280,3207,1104,113800,32129
2017,1567,450,957,148200,32130
1796,1291,505,785,133100,32131
3174,2420,754,852,115100,32132
33,33,0,-,-,32133
2999,2343,656,689,73200,32134
3583,2975,608,1045,226700,32136
15979,12662,3317,1158,217000,32137
505,472,33,-,60900,32139
439,404,35,-,67600,32140
7351,5968,1383,1039,136300,32141
1855,1464,391,771,81300,32145
197,137,60,-,21600,32147
4010,2772,1238,705,59600,32148
108,85,23,-,158500,32157
15174,12433,2741,967,170700,32159
30398,29237,1161,1422,260300,32162
16032,11836,4196,1150,173700,32164
10958,8338,2620,957,193300,32168
5343,4063,1280,1226,325600,32169
21393,16495,4898,1006,182000,32174
7005,5340,1665,1107,201600,32176
9836,6457,3379,676,87100,32177
3149,2311,838,677,67300,32179
1201,915,286,706,109900,32180
744,606,138,904,76200,32181
628,461,167,577,139800,32187
2798,2488,310,891,73700,32189
418,299,119,607,174200,32190
370,283,87,570,110300,32193
1422,1160,262,1006,113900,32195
1747,203,1544,562,117300,32202
3861,1083,2778,898,158600,32204
12744,6152,6592,866,123700,32205
6756,2794,3962,756,73600,32206
14726,7378,7348,840,149100,32207
12204,6971,5233,872,75000,32208
12849,6210,6639,741,60800,32209
23294,12698,10596,914,108700,32210
12856,5958,6898,816,108900,32211
295,0,295,1471,-,32212
15518,7597,7921,1020,133100,32216
8092,4354,3738,856,174300,32217
20589,13318,7271,972,145800,32218
4157,3398,759,927,120600,32219
4805,3834,971,966,135600,32220
9806,7233,2573,1200,147800,32221
3299,2484,815,1195,164800,32222
9524,7694,1830,1157,243100,32223
14810,8783,6027,1233,262300,32224
20037,13994,6043,1217,194500,32225
5453,4484,969,1576,194900,32226
429,4,425,1481,-,32227
0,0,0,-,-,32228
9399,5326,4073,1066,245700,32233
2249,1660,589,829,109800,32234
21138,12585,8553,997,112000,32244
19709,10580,9129,1146,151600,32246
12470,8451,4019,1161,312100,32250
4513,2194,2319,871,57900,32254
19610,7436,12174,1120,264200,32256
15419,9591,5828,1003,179800,32257
11669,8589,3080,1285,211300,32258
15200,12988,2212,1715,322300,32259
2864,1943,921,1263,349800,32266
11625,6355,5270,931,150400,32277
12648,3881,8767,946,142700,32301
20853,10482,10371,995,144400,32303
16834,2325,14509,877,84900,32304
7681,4611,3070,826,97200,32305
10371,5498,4873,991,199900,32308
12179,9663,2516,1113,244600,32309
6004,2777,3227,780,100400,32310
8041,4972,3069,1170,188900,32311
12396,10121,2275,1215,282500,32312
5354,4811,543,1340,239300,32317
1517,1049,468,670,141400,32320
1509,1132,377,563,60800,32321
1143,824,319,720,115200,32322
137,80,57,-,44800,32323
1646,1078,568,637,84000,32324
9514,7707,1807,848,135700,32327
1337,1080,257,977,147000,32328
209,122,87,758,71700,32330
1601,1344,257,639,72100,32331
590,381,209,645,50800,32332
4573,3550,1023,731,122400,32333
816,619,197,589,68400,32334
621,568,53,666,91000,32336
3901,2730,1171,627,96300,32340
1253,951,302,892,130500,32343
4985,3739,1246,809,146400,32344
762,507,255,831,115500,32346
3006,2592,414,609,87700,32347
3589,2722,867,617,73200,32348
513,454,59,578,117900,32350
6684,4352,2332,642,87200,32351
2355,1725,630,647,101100,32352
97,73,24,1096,127500,32355
60,60,0,-,-,32356
907,765,142,688,144600,32358
742,449,293,965,129200,32359
77,71,6,-,82700,32361
0,0,0,-,-,32399
9443,4742,4701,837,124200,32401
865,0,865,1471,-,32403
13897,9199,4698,893,150300,32404
12519,6897,5622,931,169000,32405
4098,2122,1976,1193,218600,32407
7074,4355,2719,1039,221700,32408
3634,3058,576,706,145000,32409
537,383,154,1181,209700,32410
5969,4096,1873,1072,217800,32413
760,606,154,666,68200,32420
1923,1589,334,717,70200,32421
449,380,69,-,83500,32423
1969,1604,365,494,86900,32424
4699,3539,1160,639,93400,32425
393,314,79,693,72700,32426
421,377,44,525,86900,32427
5643,4391,1252,770,112000,32428
368,323,45,-,75500,32430
1621,1226,395,650,78300,32431
21,21,0,-,-,32432
6194,4221,1973,780,100100,32433
2885,2090,795,718,131700,32435
304,198,106,-,55000,32437
1430,1262,168,-,70200,32438
3679,2512,1167,963,202400,32439
2030,1446,584,680,102800,32440
1447,991,456,587,85600,32442
1179,928,251,643,81900,32443
7901,5672,2229,973,188500,32444
524,402,122,646,87000,32445
3970,2683,1287,697,143500,32446
0,0,0,-,-,32447
4014,2515,1499,603,87400,32448
217,204,13,-,70400,32449
1789,1290,499,733,78700,32455
3134,2276,858,1112,178100,32456
5893,4196,1697,1327,362900,32459
1477,1112,365,563,87500,32460
11,11,0,-,-,32461
1346,1063,283,601,83100,32462
58,38,20,488,81400,32463
1771,1611,160,394,78300,32464
2334,1773,561,779,96900,32465
1893,1665,228,956,106800,32466
4482,2241,2241,770,116600,32501
1310,736,574,854,117300,32502
11904,7167,4737,864,147500,32503
9221,5199,4022,938,152800,32504
10682,5412,5270,849,64200,32505
14096,7803,6293,973,110700,32506
12583,7134,5449,925,147200,32507
531,0,531,1235,-,32508
0,0,0,-,-,32509
0,0,0,-,-,32511
16923,8533,8390,948,134200,32514
14382,10643,3739,1056,121000,32526
0,0,0,-,-,32530
2085,1782,303,1035,143600,32531
9936,8246,1690,974,161200,32533
5992,4273,1719,955,106900,32534
1774,1120,654,655,82300,32535
8615,5833,2782,1039,187200,32536
9314,6612,2702,949,149800,32539
7726,4775,2951,1396,335700,32541
668,0,668,1392,-,32542
274,0,274,1369,-,32544
14357,6710,7647,975,169500,32547
9298,5069,4229,976,163700,32548
3850,2755,1095,1145,354300,32550
3889,2941,948,1338,394400,32561
9711,7276,2435,1101,216400,32563
966,775,191,898,180400,32564
2133,1744,389,873,106900,32565
13842,10297,3545,1262,212700,32566
1307,1064,243,721,120800,32567
1008,861,147,702,138100,32568
4798,3206,1592,1062,172900,32569
11391,7869,3522,886,132500,32570
11870,9139,2731,986,165800,32571
1722,1479,243,669,136000,32577
12323,9509,2814,1112,268500,32578
4405,2971,1434,1132,255800,32579
1563,1085,478,1063,203500,32580
8913,6615,2298,979,131800,32583
7765,2259,5506,820,135200,32601
1813,354,1459,825,267300,32603
10013,7120,2893,1102,175100,32605
9193,4707,4486,1129,197500,32606
12310,3992,8318,860,191700,32607
19366,7404,11962,936,220800,32608
6752,3794,2958,850,96000,32609
6,0,6,-,-,32612
5665,4242,1423,1053,163700,32615
431,198,233,737,88900,32616
1598,1306,292,545,133600,32617
2876,2316,560,716,157700,32618
1816,1520,296,766,105100,32619
2028,1479,549,634,58900,32621
391,331,60,774,78900,32622
691,553,138,650,124100,32625
3448,2502,946,641,90600,32626
1365,975,390,651,79100,32628
154,154,0,-,296900,32631
28,17,11,-,-,32639
4536,3551,985,714,106600,32640
4746,2822,1924,824,94500,32641
4101,3467,634,897,149700,32643
163,152,11,-,130400,32648
5730,4337,1393,908,180200,32653
5523,4341,1182,889,106300,32656
94,74,20,1156,108300,32658
282,230,52,964,76100,32664
2433,1944,489,804,121100,32666
1620,1308,312,720,243100,32667
1985,1552,433,808,139800,32668
4660,3889,771,962,180800,32669
4476,3569,907,659,63700,32680
81,81,0,-,64900,32681
64,59,5,-,-,32683
1766,1265,501,592,110900,32686
126,126,0,-,-,32692
4362,3243,1119,645,83500,32693
837,593,244,680,95000,32694
4556,3508,1048,744,115400,32696
117,9,108,885,-,32697
9369,4877,4492,1054,153700,32701
1197,690,507,-,67700,32702
16836,10404,6432,1035,142900,32703
14069,9011,5058,1109,136500,32707
16169,12076,4093,1188,227700,32708
761,688,73,-,118500,32709
15646,12828,2818,1186,211700,32712
8277,7000,1277,1021,167500,32713
14264,6515,7749,1110,160500,32714
12036,8178,3858,904,156100,32720
13759,9281,4478,1009,150700,32724
16676,12836,3840,1076,122000,32725
8701,5555,3146,815,133200,32726
2457,1071,1386,977,126400,32730
1596,1498,98,940,295900,32732
1924,1654,270,1260,132900,32735
3518,3078,440,845,225200,32736
15015,11258,3757,1141,121100,32738
1529,1275,254,936,124600,32744
15664,10377,5287,1330,275000,32746
8651,6142,2509,1149,198800,32750
8671,6028,2643,1241,261600,32751
4113,3658,455,826,149800,32754
10972,7630,3342,974,189400,32757
1245,920,325,744,146900,32759
9032,5553,3479,1036,98400,32763
1265,1133,132,1047,163000,32764
20405,14336,6069,1337,251700,32765
4986,4448,538,1473,295100,32766
1076,852,224,721,84900,32767
18457,11519,6938,1101,168800,32771
10482,6203,4279,1008,108700,32773
3943,3053,890,1218,182300,32776
8979,6767,2212,892,131000,32778
10445,8481,1964,1349,290900,32779
15394,10258,5136,875,129300,32780
4296,3189,1107,730,132500,32784
10628,7133,3495,1093,414100,32789
20480,9688,10792,1076,190400,32792
8119,6182,1937,888,109300,32796
1257,1109,148,1075,70500,32798
7291,1718,5573,1212,303700,32801
9009,5058,3951,1162,236700,32803
7832,4972,2860,1150,278000,32804
7921,2660,5261,772,100300,32805
11200,6587,4613,1044,222300,32806
11383,5326,6057,1007,119500,32807
17662,6855,10807,930,86600,32808
9329,4644,4685,944,128000,32809
12815,6510,6305,1047,108900,32810
15262,3743,11519,1043,83000,32811
14278,7834,6444,1051,189600,32812
3416,1690,1726,1660,425300,32814
11833,6307,5526,1151,176900,32817
16740,9372,7368,1019,141100,32818
10394,6496,3898,1255,286100,32819
2998,2603,395,1243,213000,32820
7281,2837,4444,1248,170000,32821
22742,8979,13763,1037,105600,32822
12919,8713,4206,1374,173500,32824
19888,12145,7743,1153,175500,32825
8043,4223,3820,999,143300,32826
3603,2142,1461,1532,276500,32827
20904,13072,7832,1395,234700,32828
6346,4765,1581,1388,201400,32829
6,0,6,-,-,32830
34,9,25,-,-,32831
7140,4513,2627,1482,290700,32832
3173,2546,627,1108,206000,32833
16418,6624,9794,1210,211300,32835
6683,4417,2266,1165,401200,32836
18066,10111,7955,1326,204200,32837
18665,4291,14374,1000,109400,32839
10925,5209,5716,853,122200,32901
5972,4727,1245,1193,302500,32903
11273,8600,2673,1214,178200,32904
9813,4961,4852,873,101100,32905
14826,11401,3425,1096,124900,32907
3899,3092,807,1292,121600,32908
10708,8416,2292,991,123100,32909
5299,2985,2314,834,202400,32920
5765,2364,3401,694,87800,32922
421,0,421,1365,-,32925
8507,6744,1763,889,136800,32926
9241,7866,1375,1026,122700,32927
7077,4681,2396,1083,295100,32931
7175,6055,1120,1125,214800,32934
17495,10388,7107,924,123500,32935
11131,8280,2851,1234,243000,32937
14939,12412,2527,1335,243900,32940
2055,1445,610,782,154800,32948
915,864,51,-,288600,32949
1685,1580,105,870,254000,32950
5051,4246,805,1335,301800,32951
8400,6797,1603,1108,240200,32952
9672,6784,2888,912,219100,32953
15120,11277,3843,1168,179200,32955
11026,8889,2137,993,155800,32958
8453,4717,3736,847,137300,32960
9186,7001,2185,927,119800,32962
7344,6697,647,1313,580600,32963
7723,5605,2118,998,110500,32966
7455,5299,2156,909,183200,32967
4573,4198,375,1126,227400,32968
116,83,33,-,59900,32970
4533,3940,593,767,79000,32976
142,102,40,1688,283300,33001
6722,3109,3613,1193,183700,33004
18751,9891,8860,1157,170900,33009
15146,4666,10480,929,180300,33010
23840,11079,12761,1058,174400,33012
9578,5557,4021,1067,200500,33013
13800,5917,7883,1173,213400,33014
21053,11466,9587,1259,221100,33015
14680,8011,6669,1274,171900,33016
13378,9963,3415,1442,224000,33018
6816,5072,1744,1468,393800,33019
18217,6237,11980,991,174500,33020
17847,11726,6121,1222,240400,33021
20191,13217,6974,1203,170200,33023
23433,15731,7702,1296,196100,33024
23332,10983,12349,1382,201600,33025
11120,9100,2020,1684,240500,33026
21093,16881,4212,1425,297200,33027
8191,6370,1821,2026,350900,33028
12931,11305,1626,2452,354000,33029
9167,3711,5456,955,171300,33030
1725,1468,257,1560,346400,33031
11814,6619,5195,1199,176300,33032
14954,7627,7327,1213,163300,33033
4812,1720,3092,949,97500,33034
4574,1940,2634,1398,162700,33035
1483,1178,305,1362,645100,33036
4526,3426,1100,1383,389200,33037
110,110,0,-,259400,33039
12815,5556,7259,1640,463000,33040
2892,2131,761,1694,457200,33042
2142,1484,658,1325,357300,33043
3748,2196,1552,1278,367900,33050
368,225,143,1332,487500,33051
9205,4285,4920,856,117500,33054
11372,8561,2811,1305,163600,33055
9744,6179,3565,1126,147100,33056
12624,5471,7153,1084,206100,33060
11877,8189,3688,1269,324500,33062
21434,14588,6846,1338,152900,33063
20360,13112,7248,1194,159100,33064
17586,9102,8484,1219,232400,33065
8578,6874,1704,1178,109400,33066
9125,6507,2618,1615,413300,33067
15545,8636,6909,1311,150800,33068
10385,5105,5280,1249,141200,33069
2051,1422,629,1509,453500,33070
12596,8109,4487,1470,329400,33071
10840,6291,4549,1592,289100,33073
11006,8803,2203,2320,462100,33076
0,0,0,-,-,33101
264,222,42,-,"2,000,000+",33109
115,0,115,2071,-,33122
20356,5434,14922,974,190300,33125
17988,5973,12015,1171,167300,33126
9608,2616,6992,930,165500,33127
3040,226,2814,764,-,33128
5911,2698,3213,1778,438800,33129
11596,1696,9900,984,272600,33130
9158,2965,6193,2161,452400,33131
5737,1406,4331,1886,459100,33132
13377,6468,6909,1368,548500,33133
16251,8688,7563,1304,432800,33134
14412,2991,11421,942,246700,33135
5465,780,4685,784,154100,33136
9559,2574,6985,1512,308200,33137
11925,5435,6490,897,387000,33138
20521,6963,13558,1367,386200,33139
9375,5373,4002,1607,592900,33140
18112,5489,12623,1192,292700,33141
18575,4881,13694,870,139000,33142
11962,6586,5376,1244,529300,33143
8872,5389,3483,1236,261200,33144
11367,5731,5636,1366,313800,33145
4018,3020,998,2229,827800,33146
13704,6491,7213,949,118800,33147
4602,3347,1255,2721,1137100,33149
9085,3012,6073,837,161500,33150
6242,3218,3024,1747,565700,33154
14260,10370,3890,1304,300900,33155
10886,7860,3026,1543,812700,33156
19371,12992,6379,1118,252800,33157
2046,1938,108,2382,608300,33158
19409,10804,8605,1456,276900,33160
16132,6302,9830,1035,189900,33161
12912,6894,6018,1037,164800,33162
16410,11159,5251,1301,265300,33165
7653,3795,3858,1165,296100,33166
5763,3150,2613,1092,161000,33167
6734,4803,1931,1275,161100,33168
11635,6237,5398,1052,166900,33169
3832,2184,1648,1158,226600,33170
13648,6118,7530,1378,142300,33172
10999,7737,3262,1388,278800,33173
9366,5460,3906,1235,221400,33174
15300,11574,3726,1447,262400,33175
17213,11624,5589,1338,362500,33176
14394,10713,3681,1371,210100,33177
14287,7326,6961,1900,350400,33178
15678,9659,6019,1171,136600,33179
14872,9594,5278,1776,361300,33180
7321,2773,4548,1148,236200,33181
3854,3361,493,1787,293600,33182
11938,7894,4044,1413,207100,33183
6406,4856,1550,1333,213100,33184
8052,6895,1157,2097,323700,33185
21505,14847,6658,1573,252900,33186
4973,4538,435,1805,294300,33187
7763,4721,3042,994,218300,33189
4478,1993,2485,1210,228700,33190
14383,9354,5029,1371,230500,33193
1453,1184,269,1737,296800,33194
13241,8751,4490,1737,275700,33196
7571,3600,3971,1842,544700,33301
9417,3234,6183,1152,354400,33304
6568,4247,2321,1252,372600,33305
1707,1132,575,989,468400,33306
15195,10532,4663,1271,364700,33308
12776,7814,4962,1170,160900,33309
21987,9094,12893,1050,120700,33311
17828,10084,7744,1227,211100,33312
19558,8404,11154,1070,105100,33313
8648,3946,4702,1213,154700,33314
6334,3276,3058,1259,263100,33315
4962,2898,2064,1098,573700,33316
12317,9119,3198,1235,270100,33317
17825,11508,6317,1194,106700,33319
19949,14633,5316,1344,148100,33321
16175,12876,3299,1543,134500,33322
6823,4806,2017,1846,283800,33323
18908,10571,8337,1572,199000,33324
9264,7094,2170,1562,249000,33325
10997,7436,3561,1790,343100,33326
6569,5198,1371,2668,482400,33327
10291,8128,2163,1442,322700,33328
4675,4215,460,2408,504100,33330
7430,6377,1053,2131,443300,33331
3175,2907,268,2449,573200,33332
12294,6699,5595,1096,233900,33334
11275,5900,5375,1351,182900,33351
11221,4263,6958,1150,212600,33401
4415,2117,2298,1105,153200,33403
9947,5426,4521,1081,129700,33404
7180,4013,3167,1132,226400,33405
8389,5229,3160,1203,176800,33406
10659,4582,6077,1026,153600,33407
8799,6588,2211,1235,315000,33408
11077,4909,6168,1137,137000,33409
15188,9910,5278,1450,286700,33410
23765,17605,6160,1313,247300,33411
5100,4380,720,1827,311500,33412
4951,3149,1802,1371,216400,33413
19620,14357,5263,1681,330900,33414
16342,9008,7334,1096,99900,33415
13933,8185,5748,1042,67100,33417
16467,12973,3494,1580,367800,33418
9443,5778,3665,1496,165100,33426
13630,9717,3913,1514,246400,33428
7253,2423,4830,617,110400,33430
7222,4857,2365,1546,356500,33431
9969,6070,3899,1463,568200,33432
18714,12283,6431,1665,274300,33433
9690,8036,1654,975,218000,33434
13694,8037,5657,1347,139800,33435
17922,12803,5119,1385,190300,33436
18229,15876,2353,1475,256400,33437
100,62,38,-,67700,33438
6347,4111,2236,783,73300,33440
11285,5535,5750,1129,197000,33441
13425,9108,4317,1511,120000,33442
8252,4466,3786,1189,248300,33444
13318,8316,5002,1461,178400,33445
12713,11023,1690,981,237700,33446
3822,3535,287,1926,386600,33449
9915,7922,1993,990,235000,33455
20565,14569,5996,1480,328000,33458
11087,4706,6381,996,176800,33460
14964,7294,7670,1095,108400,33461
12032,7133,4899,1102,171800,33462
17668,12444,5224,1231,158700,33463
19621,17084,2537,1337,260500,33467
7100,6007,1093,1283,336600,33469
7754,7042,712,1700,277600,33470
2087,1428,659,729,79200,33471
7946,7220,726,2074,257700,33472
3246,2794,452,2877,513300,33473
2540,1120,1420,552,97000,33476
7534,6174,1360,1456,368800,33477
4457,4252,205,2085,357800,33478
5607,4728,879,1572,792100,33480
6066,4290,1776,1476,475100,33483
14096,11099,2997,1323,113600,33484
9022,6972,2050,1464,372800,33486
8731,6847,1884,1659,359800,33487
622,295,327,764,84600,33493
9722,8531,1191,1729,366700,33496
5003,4700,303,2644,387000,33498
26,26,0,-,-,33503
10166,6250,3916,1046,147600,33510
21893,10805,11088,1157,173800,33511
3766,3034,732,704,91900,33513
615,432,183,802,75900,33514
178,145,33,680,92100,33521
6441,4311,2130,782,106700,33523
7324,5302,2022,793,127900,33525
4732,3413,1319,911,214600,33527
4855,3016,1839,983,151700,33534
1880,1396,484,590,81900,33538
3784,2669,1115,736,69900,33540
8896,7092,1804,902,68600,33541
9656,6705,2951,788,67200,33542
8672,7049,1623,1351,192700,33543
8831,6141,2690,1408,228300,33544
5399,3944,1455,1442,180800,33545
7748,6369,1379,1603,298100,33547
2414,2067,347,1134,339000,33548
6420,4976,1444,1067,207100,33549
7779,6963,816,1202,359300,33556
8227,5493,2734,1014,315200,33558
6641,3792,2849,1052,166200,33559
9682,5061,4621,896,112500,33563
5989,4658,1331,949,133800,33565
6770,4976,1794,939,169700,33566
3660,2704,956,698,177300,33567
9203,7520,1683,1270,187800,33569
8847,6381,2466,875,148600,33570
7048,5731,1317,1561,238600,33572
12263,9881,2382,1794,150900,33573
1977,1783,194,796,173100,33576
17869,9571,8298,1153,166100,33578
9535,7238,2297,1569,191200,33579
9076,7070,2006,1058,149200,33584
453,411,42,-,108700,33585
4033,2630,1403,770,96600,33592
12429,9898,2531,1277,168100,33594
9910,8430,1480,1619,243500,33596
3022,2531,491,802,96000,33597
5046,3725,1321,771,187300,33598
7470,2859,4611,1570,272000,33602
8377,4501,3876,897,147600,33603
14869,7235,7634,890,118400,33604
6989,2774,4215,847,84500,33605
7880,3739,4141,1285,452900,33606
10576,4116,6460,1155,120500,33607
8616,4540,4076,1106,304000,33609
15596,6614,8982,932,88200,33610
14972,8230,6742,1053,222200,33611
18352,6446,11906,820,109200,33612
13988,4260,9728,792,134200,33613
18079,6842,11237,931,134500,33614
17352,9663,7689,1024,141500,33615
6355,2829,3526,1186,176600,33616
18033,6875,11158,926,139400,33617
11136,7147,3989,1031,264400,33618
12478,5897,6581,1065,91600,33619
9,0,9,-,-,33620
588,0,588,2049,-,33621
14697,9722,4975,1135,192000,33624
10005,6513,3492,1211,182800,33625
11004,7073,3931,1380,331900,33626
10382,8221,2161,1195,446400,33629
7260,4517,2743,1206,150800,33634
6966,4136,2830,1301,162300,33635
6284,2572,3712,1047,132500,33637
23820,13674,10146,1234,275800,33647
8701,3010,5691,816,304200,33701
12968,8068,4900,963,137700,33702
10479,7820,2659,1160,169900,33703
7310,5064,2246,978,327800,33704
10707,5645,5062,990,155900,33705
8439,6211,2228,1104,369100,33706
12315,8158,4157,988,172100,33707
8523,6075,2448,1111,270100,33708
11152,7924,3228,893,96300,33709
13582,10191,3391,949,164300,33710
7144,4053,3091,1089,135100,33711
9406,4778,4628,948,147700,33712
12700,8167,4533,1058,135400,33713
8194,4884,3310,931,81300,33714
3756,3266,490,1493,365000,33715
8845,1661,7184,1169,109800,33716
0,0,0,-,-,33744
9134,4951,4183,966,162700,33755
13010,7696,5314,875,162800,33756
7727,4280,3447,1112,151000,33759
6528,3114,3414,967,120000,33760
8904,7054,1850,903,151200,33761
2604,2039,565,1210,207100,33762
8865,6125,2740,1053,107400,33763
11225,7830,3395,994,156900,33764
5876,2574,3302,957,132000,33765
4205,3350,855,1615,410100,33767
11822,6677,5145,964,148600,33770
13889,7430,6459,922,73100,33771
10143,7474,2669,1089,170000,33772
7315,5193,2122,1010,148000,33773
8089,5714,2375,976,180200,33774
4990,4526,464,1354,252500,33776
6906,5341,1565,1197,160100,33777
5978,4657,1321,1041,119300,33778
10323,6027,4296,886,126700,33781
9484,6959,2525,1082,126700,33782
2982,2047,935,1275,393500,33785
772,674,98,2378,558900,33786
12373,6348,6025,788,68800,33801
11917,7317,4600,960,129200,33803
8830,4390,4440,913,76000,33805
10929,7353,3576,1000,147100,33809
16890,13033,3857,1024,134900,33810
7652,5175,2477,1016,154200,33811
4266,3495,771,1002,164200,33812
12474,10215,2259,1122,187300,33813
5485,2996,2489,738,24300,33815
10402,7525,2877,846,120500,33823
8785,6176,2609,723,79800,33825
839,713,126,881,132300,33827
9198,6180,3018,820,99600,33830
1689,1122,567,680,80600,33834
8158,5930,2228,1116,150300,33837
1258,677,581,870,102400,33838
1054,689,365,823,99900,33839
2724,2071,653,719,77600,33841
3428,2706,722,726,72300,33843
11755,7621,4134,819,107900,33844
33,30,3,-,-,33847
301,97,204,-,53400,33848
322,322,0,-,-,33849
3176,2030,1146,889,83100,33850
329,295,34,1048,95900,33851
8483,6806,1677,703,109300,33852
4169,2071,2098,735,106000,33853
125,71,54,620,38900,33854
0,0,0,-,-,33855
273,0,273,520,-,33856
822,562,260,567,92200,33857
4073,2666,1407,835,92900,33859
7732,5847,1885,922,112000,33860
168,94,74,-,84400,33865
232,232,0,-,69800,33867
3770,3110,660,889,88400,33868
8827,5615,3212,677,69400,33870
7202,5664,1538,873,84400,33872
4531,3005,1526,664,82200,33873
4756,3943,813,838,111900,33875
2037,1693,344,926,89200,33876
112,38,74,683,-,33877
13077,8448,4629,843,92400,33880
12659,8547,4112,767,84500,33881
12033,8595,3438,1051,159200,33884
1394,1115,279,780,78700,33890
3023,1733,1290,1319,169700,33896
6123,4245,1878,1285,140200,33897
6276,4914,1362,841,101800,33898
8532,3819,4713,791,153100,33901
10632,8133,2499,820,87400,33903
13610,9964,3646,1029,208100,33904
11048,7059,3989,938,136300,33905
9199,3980,5219,982,135200,33907
17181,12376,4805,1364,243400,33908
9124,5515,3609,1119,155400,33909
7509,6329,1180,1175,250500,33912
7853,6420,1433,1307,288800,33913
14224,10433,3791,1161,246700,33914
7834,2699,5135,892,89700,33916
12424,10112,2312,801,84400,33917
13996,10071,3925,1103,185400,33919
1881,1564,317,755,246500,33920
379,332,47,-,944400,33921
1631,1333,298,947,169700,33922
64,49,15,-,-,33924
10739,9149,1590,1407,282600,33928
333,233,100,675,100400,33930
5683,4752,931,1093,299900,33931
6420,4415,2005,714,81700,33935
7936,4921,3015,853,96000,33936
103,103,0,-,-,33944
0,0,0,-,-,33945
1050,906,144,1477,370700,33946
3919,3330,589,1158,223700,33947
6913,5659,1254,918,153400,33948
10788,8671,2117,920,267200,33950
13728,9255,4473,925,117200,33952
2649,2322,327,955,211000,33953
3435,2772,663,1217,172400,33954
4389,3937,452,1055,225200,33955
1714,1552,162,1111,189700,33956
3575,3046,529,1502,705900,33957
341,291,50,-,121800,33960
0,0,0,-,-,33965
3874,2611,1263,990,244900,33966
8123,5936,2187,1122,178500,33967
6915,4455,2460,1029,130100,33971
4529,3151,1378,985,123000,33972
3757,697,3060,885,185000,33973
4464,2546,1918,1045,125700,33974
4519,2734,1785,1069,113000,33976
5718,4119,1599,831,131100,33980
4380,3645,735,1088,198000,33981
4089,3385,704,738,111500,33982
5942,4705,1237,958,185200,33983
11296,7768,3528,1075,177800,33990
7339,5257,2082,1227,221300,33991
7883,5843,2040,1229,184600,33993
0,0,0,-,-,34101
5413,3763,1650,1138,858400,34102
6116,4838,1278,1330,654000,34103
10289,7075,3214,1098,229100,34104
7590,5335,2255,1445,391700,34105
7953,6346,1607,1253,666300,34108
11144,6579,4565,1231,377000,34109
10930,8464,2466,1452,352500,34110
12013,8884,3129,986,194400,34112
7649,5512,2137,1181,264500,34113
6923,5671,1252,1236,222300,34114
9614,4845,4769,1094,212500,34116
4581,4128,453,1213,260000,34117
12478,9394,3084,1404,402600,34119
9667,8086,1581,1409,270100,34120
7079,5880,1199,1155,450700,34134
17421,13670,3751,1161,247000,34135
144,64,80,-,-,34137
61,61,0,-,-,34138
206,183,23,794,120500,34139
111,59,52,-,-,34140
20,4,16,-,-,34141
6165,2576,3589,761,114200,34142
8560,7291,1269,1531,523200,34145
1800,1643,157,2197,388000,34201
8948,6870,2078,1820,393300,34202
13660,10113,3547,1032,177200,34203
12325,6960,5365,899,115700,34205
14524,8360,6164,895,64500,34207
11872,6481,5391,970,155900,34208
14378,10570,3808,1121,200900,34209
7632,4548,3084,1035,174700,34210
2809,2514,295,1633,374500,34211
6563,5201,1362,1374,321100,34212
212,172,40,-,604800,34215
482,431,51,1109,703500,34216
2714,1922,792,1182,476600,34217
7840,7075,765,1678,240500,34219
15356,12002,3354,1011,129900,34221
5238,4185,1053,986,77500,34222
8600,6844,1756,919,203000,34223
7439,5777,1662,918,137000,34224
3820,3522,298,1471,709300,34228
3393,2929,464,1122,388800,34229
14139,8781,5358,1084,191300,34231
13436,9210,4226,1272,187900,34232
7657,5927,1730,1303,235700,34233
8837,4590,4247,896,107200,34234
6399,4887,1512,1181,206400,34235
6592,3838,2754,963,639800,34236
6914,3656,3258,1021,113700,34237
9779,7489,2290,1417,340300,34238
6805,4628,2177,1122,248100,34239
4048,3721,327,1225,386600,34240
5778,4962,816,1257,332500,34241
3820,3264,556,1384,656500,34242
12847,9388,3459,1350,245800,34243
1749,1617,132,1367,276200,34251
9779,6363,3416,666,80400,34266
54,22,32,-,-,34268
1919,1705,214,878,124600,34269
8820,7079,1741,908,251600,34275
10292,7963,2329,1081,172800,34285
6388,5126,1262,1234,151300,34286
11133,8122,3011,962,126900,34287
4274,3367,907,1222,180700,34288
1393,594,799,1051,190900,34289
2011,1646,365,1187,158400,34291
7626,5866,1760,1331,277900,34292
16619,13689,2930,1169,199700,34293
5749,4287,1462,755,90000,34420
4204,3130,1074,720,101700,34428
3517,2883,634,885,107500,34429
3380,2735,645,819,99500,34431
5702,4877,825,894,129800,34432
2753,2416,337,818,117800,34433
3151,2540,611,1149,127300,34434
3441,2817,624,681,85000,34436
6483,5781,702,768,156500,34442
0,0,0,-,-,34445
7470,6652,818,973,132800,34446
4764,3593,1171,645,75100,34448
1264,875,389,492,82800,34449
4974,3612,1362,724,113800,34450
4993,4097,896,827,106100,34452
4470,3452,1018,889,98900,34453
4249,3313,936,690,154700,34461
7886,6175,1711,810,143000,34465
7900,4670,3230,791,92100,34470
9806,6371,3435,855,162400,34471
10419,7586,2833,928,90800,34472
6468,4660,1808,990,142300,34473
6744,3134,3610,943,113200,34474
3978,1906,2072,685,73600,34475
9475,8431,1044,849,134000,34476
5378,3708,1670,853,89500,34479
6511,4962,1549,763,145900,34480
9416,8272,1144,879,102300,34481
7358,5639,1719,805,131000,34482
1429,960,469,759,204900,34484
4017,3066,951,662,50600,34488
11617,10088,1529,926,158200,34491
279,221,58,970,145800,34498
9035,6398,2637,750,97500,34601
2572,2219,353,720,136000,34602
3783,3153,630,743,137800,34604
11343,8518,2825,918,108000,34606
3981,3189,792,956,189400,34607
12803,9087,3716,942,115800,34608
15323,12113,3210,1070,141000,34609
4842,4034,808,897,123900,34610
8205,7028,1177,964,87400,34613
2638,2357,281,1040,138000,34614
2166,1826,340,1535,203900,34637
8144,6407,1737,1433,227900,34638
9602,7685,1917,1206,220200,34639
10526,6577,3949,843,88400,34652
14423,8789,5634,938,84100,34653
8919,6750,2169,939,140000,34654
16464,13052,3412,1109,199900,34655
44,34,10,-,-,34661
15138,10832,4306,870,116100,34667
18998,11716,7282,900,72100,34668
4869,3893,976,968,121500,34669
8591,6138,2453,1107,212700,34677
35,22,13,-,140300,34679
402,402,0,-,422700,34681
13144,9973,3171,1113,235200,34683
13248,8632,4616,1196,165600,34684
7235,5422,1813,1297,319600,34685
2841,2598,243,2011,315300,34688
11039,7541,3498,865,166500,34689
5422,3495,1927,945,67900,34690
8442,5611,2831,963,75000,34691
7357,6202,1155,1142,231100,34695
18022,12013,6009,1006,158700,34698
978,728,250,832,97000,34705
20124,15327,4797,1244,201300,34711
6998,3471,3527,1113,157100,34714
5547,3862,1685,1169,187100,34715
5093,3829,1264,928,103600,34731
1382,1237,145,1254,231000,34734
5718,4436,1282,1128,160600,34736
936,777,159,1027,210100,34737
194,146,48,-,91400,34739
15402,4481,10921,995,128800,34741
11241,7169,4072,1169,150100,34743
14697,9017,5680,1181,178100,34744
12378,7903,4475,1283,165500,34746
6243,3072,3171,1371,293600,34747
17615,12790,4825,864,138200,34748
1675,1377,298,860,104700,34753
1140,934,206,1069,259700,34756
10259,6871,3388,1122,156000,34758
11379,8119,3260,1177,158100,34759
269,236,33,1016,206600,34760
14679,10068,4611,1158,204500,34761
187,187,0,-,115700,34762
7951,5184,2767,1000,126500,34769
5109,4577,532,1156,245800,34771
8682,7270,1412,1327,191500,34772
1075,712,363,1311,166100,34773
11316,9642,1674,858,261600,34785
13383,9651,3732,1678,422000,34786
19539,13842,5697,1049,262200,34787
7987,6575,1412,908,71500,34788
367,354,13,-,201800,34797
1562,1343,219,1072,169600,34945
2289,1476,813,842,68400,34946
4167,1667,2500,913,89300,34947
3835,3135,700,1034,265500,34949
5855,2428,3427,745,75900,34950
6698,5631,1067,901,89300,34951
16652,11399,5253,1137,109900,34952
20968,16432,4536,1251,163800,34953
2080,1274,806,776,81400,34956
10689,7898,2791,1048,210200,34957
5379,3624,1755,674,87300,34972
9469,7246,2223,746,95100,34974
1819,1076,743,942,176500,34981
9698,6457,3241,969,100600,34982
13642,10481,3161,1286,149800,34983
5344,4243,1101,1298,154300,34984
10760,8634,2126,1250,198500,34986
3008,2015,993,1613,262200,34987
11733,10068,1665,1406,325300,34990
6938,3914,3024,988,148100,34994
5731,4784,947,1136,221200,34996
17163,13103,4060,1063,208500,34997
4460,3557,903,897,151900,35004
2792,2015,777,879,92700,35005
1087,853,234,711,81000,35006
8628,7012,1616,954,161500,35007
8142,5350,2792,605,97100,35010
18,0,18,-,-,35013
1541,1303,238,971,93500,35014
6339,4781,1558,602,129500,35016
810,665,145,821,116500,35019
9995,5349,4646,704,68700,35020
8255,6652,1603,905,171100,35022
8597,6427,2170,809,116100,35023
2958,2021,937,576,111700,35031
17,15,2,-,71700,35032
1372,1219,153,578,123200,35033
973,688,285,744,61200,35034
476,476,0,-,132600,35035
126,30,96,238,80000,35036
6197,4924,1273,1018,141100,35040
2153,1521,632,626,134600,35042
3567,3350,217,1365,233600,35043
3186,2020,1166,558,100800,35044
5847,4195,1652,632,109400,35045
1946,1547,399,773,111500,35046
1335,1135,200,609,132900,35049
3054,2202,852,637,161000,35051
0,0,0,-,-,35052
848,756,92,830,157500,35053
1786,1558,228,545,165700,35054
7953,4987,2966,626,121100,35055
4838,3966,872,678,142200,35057
3788,2794,994,532,121800,35058
141,123,18,-,33900,35060
524,327,197,1079,74200,35061
2968,2440,528,755,118400,35062
1406,1249,157,683,74100,35063
4657,2773,1884,714,95900,35064
3506,2474,1032,942,136500,35068
110,75,35,800,81900,35070
6146,4948,1198,903,158300,35071
1903,1572,331,482,81700,35072
881,754,127,946,84000,35073
0,0,0,-,-,35074
4781,3563,1218,630,99500,35077
710,580,130,565,144600,35078
3230,2822,408,641,125400,35079
6115,5678,437,1185,178900,35080
0,0,0,-,-,35082
1373,1071,302,689,104500,35083
3134,2405,729,708,88200,35085
818,462,356,640,101800,35087
781,570,211,639,100300,35089
965,864,101,1012,182900,35091
5301,4234,1067,763,154000,35094
2975,2452,523,840,100600,35096
650,536,114,745,130600,35097
405,389,16,-,89500,35098
5923,5283,640,729,186800,35111
96,96,0,-,104700,35112
3022,2566,456,896,202800,35114
5445,3630,1815,768,121700,35115
1697,1463,234,805,155400,35116
1963,1679,284,911,152300,35117
1146,933,213,722,126600,35118
70,45,25,-,-,35119
4851,4172,679,684,142900,35120
5648,3823,1825,669,123400,35121
9329,7755,1574,1027,181000,35124
4064,2755,1309,653,115100,35125
7782,6576,1206,962,144100,35126
3688,3240,448,1067,151000,35127
4592,3386,1206,770,166700,35128
1228,978,250,679,77400,35130
1543,1162,381,556,116100,35131
1312,1242,70,527,116900,35133
739,544,195,735,182900,35135
775,631,144,273,128100,35136
64,56,8,-,-,35139
1280,1169,111,583,162800,35143
3748,3238,510,653,169400,35146
2099,1879,220,1188,170700,35147
1027,691,336,681,96000,35148
207,171,36,-,-,35149
7131,4591,2540,565,84900,35150
2835,2436,399,723,91100,35151
10134,6892,3242,544,85500,35160
1319,1087,232,720,102700,35171
1159,814,345,628,70300,35172
9454,8488,966,1084,221400,35173
2028,1767,261,517,114500,35175
393,298,95,675,65700,35176
1423,1296,127,599,84800,35178
3316,2749,567,736,128100,35179
5333,4682,651,595,132500,35180
264,253,11,-,76400,35183
1829,1435,394,760,88300,35184
1860,1593,267,1197,155800,35186
7,7,0,-,-,35187
1033,807,226,869,118900,35188
1596,250,1346,589,182800,35203
4574,1724,2850,554,60300,35204
9682,2625,7057,733,171200,35205
6583,3305,3278,798,76200,35206
3357,1803,1554,505,60400,35207
5442,2987,2455,882,73900,35208
12730,5554,7176,917,307600,35209
5867,3929,1938,861,132300,35210
11335,5534,5801,737,79100,35211
4998,2075,2923,566,125300,35212
5487,4179,1308,1201,519000,35213
7311,5498,1813,730,102100,35214
18191,9823,8368,827,98100,35215
14861,7856,7005,968,270100,35216
5024,2817,2207,685,78600,35217
2850,1091,1759,755,63800,35218
1906,1262,644,828,60300,35221
4062,2280,1782,679,224500,35222
4081,3516,565,1403,479900,35223
2121,1303,818,774,68100,35224
13410,10695,2715,1154,256400,35226
3794,2278,1516,869,68000,35228
0,0,0,-,-,35229
858,161,697,1117,216800,35233
2069,935,1134,616,62000,35234
8102,5762,2340,937,121300,35235
20995,14772,6223,1046,344800,35242
7736,4730,3006,1151,339200,35243
12971,8762,4209,1095,284400,35244
196,58,138,570,83200,35254
11195,3854,7341,741,110600,35401
7948,3932,4016,842,124400,35404
16259,8986,7273,830,170700,35405
6575,5169,1406,977,328000,35406
372,320,52,525,91000,35441
1925,1408,517,512,92100,35442
716,425,291,610,45300,35443
1395,1116,279,752,100600,35444
718,559,159,857,115800,35446
1235,945,290,398,82500,35447
1116,886,230,784,154000,35452
3879,3271,608,778,134600,35453
1132,976,156,712,120200,35456
0,0,0,-,-,35457
226,172,54,-,141700,35458
386,309,77,515,74300,35459
286,184,102,625,-,35460
799,688,111,387,89000,35461
1687,1130,557,443,77500,35462
684,625,59,-,117300,35463
238,149,89,256,-,35464
2051,1491,560,520,96100,35466
87,56,31,-,-,35469
1838,905,933,552,114600,35470
6333,4245,2088,846,169200,35473
2297,1920,377,752,119200,35474
5199,4508,691,784,184400,35475
2830,1455,1375,738,134900,35476
56,56,0,-,-,35477
436,368,68,1316,150000,35480
1519,1049,470,360,80000,35481
1277,1000,277,985,118900,35490
3774,2314,1460,619,84900,35501
3369,2618,751,701,103100,35503
5138,3935,1203,619,139600,35504
1075,817,258,467,87400,35540
1448,1311,137,604,138100,35541
498,430,68,672,83200,35542
545,415,130,537,58100,35543
281,239,42,521,41700,35544
39,30,9,-,-,35545
1582,1251,331,403,82100,35546
748,563,185,374,65600,35548
1502,1111,391,531,65200,35549
2157,1488,669,603,73700,35550
302,273,29,220,-,35552
1607,1317,290,425,66100,35553
448,364,84,-,71200,35554
3902,2785,1117,546,88100,35555
6,6,0,-,-,35559
1975,1424,551,441,108100,35563
835,634,201,701,88700,35564
5221,3974,1247,536,68400,35565
4685,3468,1217,556,94600,35570
374,302,72,505,67900,35571
457,384,73,-,139100,35572
694,633,61,400,84600,35574
431,334,97,513,67200,35575
1340,996,344,455,79100,35576
7,7,0,-,-,35577
2252,1934,318,642,76700,35578
1306,1067,239,334,71400,35579
1402,1135,267,574,78300,35580
1926,1364,562,638,76700,35581
1642,1157,485,436,80400,35582
149,115,34,779,48000,35584
599,437,162,757,120600,35585
1864,1352,512,391,77500,35586
328,290,38,-,63300,35587
1969,1438,531,406,70400,35592
700,583,117,457,87900,35593
2882,2076,806,554,101900,35594
12559,7564,4995,619,97000,35601
12833,8698,4135,628,167300,35603
812,653,159,452,149800,35610
10066,6094,3972,592,122500,35611
7249,6513,736,793,173700,35613
3049,2271,778,661,89100,35614
73,70,3,-,-,35615
1698,1330,368,661,83800,35616
835,556,279,386,76400,35618
1648,1355,293,638,94200,35619
3159,2556,603,624,130100,35620
1286,1096,190,495,103600,35621
2752,2346,406,734,87800,35622
14925,6921,8004,608,101200,35630
8553,6961,1592,797,138300,35633
3878,3419,459,765,169200,35634
9459,7442,2017,635,131400,35640
1394,1209,185,606,100900,35643
5202,4317,885,638,155200,35645
1761,1341,420,454,87700,35646
385,294,91,518,101900,35647
1235,1041,194,573,113600,35648
31,31,0,-,430000,35649
5409,4252,1157,523,111500,35650
530,409,121,706,106000,35651
3633,2867,766,698,122100,35652
3810,2403,1407,606,97100,35653
3088,2196,892,616,92900,35654
4051,2341,1710,644,87700,35660
6863,5302,1561,730,142100,35661
2752,2275,477,658,116600,35670
942,611,331,542,-,35671
2380,1935,445,587,93000,35672
2697,2344,353,528,111300,35673
7076,5259,1817,644,109800,35674
666,512,154,825,90000,35677
2086,1582,504,745,115600,35739
1404,988,416,478,102800,35740
1204,921,283,983,271300,35741
854,697,157,572,105200,35744
107,91,16,-,145800,35745
268,235,33,-,-,35746
2106,1651,455,562,123800,35747
2607,2188,419,589,156700,35748
7830,6891,939,1174,175600,35749
4831,3883,948,763,120900,35750
75,57,18,-,159700,35751
987,736,251,812,87200,35752
1923,1481,442,517,152300,35754
276,170,106,578,200000,35755
4764,4346,418,995,201000,35756
5547,4694,853,967,197000,35757
17483,11612,5871,906,228700,35758
2896,2647,249,1030,182300,35759
1865,1452,413,745,122300,35760
4696,4110,586,813,142100,35761
6163,5786,377,1139,268300,35763
226,165,61,-,98800,35764
1409,1143,266,489,91500,35765
67,54,13,-,-,35766
4512,3034,1478,615,101000,35768
3937,2869,1068,627,143800,35769
1488,1040,448,667,128800,35771
1684,1123,561,506,86900,35772
4727,3671,1056,881,118500,35773
69,61,8,-,-,35774
263,196,67,-,72400,35775
1286,1098,188,639,87600,35776
9918,6587,3331,778,248200,35801
10180,6098,4082,798,224000,35802
11192,9001,2191,905,174400,35803
9097,2858,6239,602,75600,35805
9756,4538,5218,905,238900,35806
310,0,310,1266,-,35808
11331,7418,3913,818,86000,35810
10894,8665,2229,838,156300,35811
6458,1413,5045,647,90500,35816
3616,1984,1632,887,220400,35824
0,0,0,-,-,35896
7607,4901,2706,577,104100,35901
6719,4237,2482,641,88400,35903
5318,4246,1072,624,67400,35904
2310,1765,545,579,119200,35905
4094,2559,1535,733,151900,35906
3291,2936,355,847,160100,35907
7255,4549,2706,624,105500,35950
4375,2975,1400,665,87200,35951
2640,2100,540,542,77200,35952
2841,2340,501,679,103900,35953
4367,3147,1220,644,84900,35954
3179,2633,546,665,105000,35956
5636,3579,2057,619,107300,35957
1416,1119,297,616,109200,35958
1938,1465,473,584,104200,35959
4307,3319,988,560,123900,35960
2405,1600,805,508,93900,35961
2959,2067,892,621,78100,35962
431,314,117,-,64200,35963
1515,1158,357,632,95600,35966
6018,3880,2138,598,119900,35967
1558,1234,324,560,102800,35968
2100,1596,504,630,96800,35971
379,359,20,-,109400,35972
1254,1048,206,635,81100,35973
554,363,191,525,86700,35974
85,72,13,-,-,35975
6787,5134,1653,614,157700,35976
1852,1406,446,563,82100,35978
657,474,183,-,123500,35979
1773,1410,363,594,74500,35980
723,576,147,229,104100,35981
1590,1241,349,580,155900,35983
661,556,105,843,173000,35984
3132,2232,900,574,117800,35986
1001,800,201,570,86500,35987
635,443,192,638,92100,35988
1310,1022,288,568,98300,35989
35,14,21,900,-,35990
839,645,194,531,79500,36003
551,421,130,344,80900,36005
486,445,41,-,88200,36006
958,698,260,451,87400,36009
1879,1247,632,539,79500,36010
203,186,17,-,366700,36013
1530,980,550,486,78500,36016
694,487,207,435,66000,36017
380,306,74,771,161100,36020
4478,3866,612,726,167200,36022
2079,1704,375,725,125800,36024
1462,896,566,875,133300,36025
358,297,61,-,158900,36026
6004,3518,2486,591,106100,36027
681,568,113,563,104700,36028
377,336,41,-,157800,36029
171,160,11,-,52000,36030
97,92,5,-,67300,36031
940,675,265,520,68300,36032
1483,1077,406,575,69000,36033
331,292,39,488,50000,36034
639,529,110,-,109500,36035
814,660,154,671,81700,36036
4754,3190,1564,593,97100,36037
13,13,0,-,-,36038
45,45,0,-,84500,36039
1443,881,562,619,59700,36040
441,385,56,-,71500,36041
701,571,130,684,89800,36042
1259,1031,228,921,112500,36043
594,562,32,761,86400,36046
548,469,79,-,-,36047
528,388,140,575,63800,36048
2320,1443,877,531,75000,36049
740,605,135,859,62500,36051
143,128,15,-,430000,36052
675,459,216,465,68100,36053
5769,3872,1897,837,135600,36054
3656,3367,289,1076,276000,36064
7888,4718,3170,1116,176100,36066
10290,7733,2557,776,119900,36067
849,685,164,541,86700,36069
213,170,43,613,72900,36071
865,664,201,658,84700,36075
4835,3419,1416,606,112500,36078
3621,2495,1126,694,123700,36079
923,844,79,-,179500,36080
6301,3120,3181,616,118500,36081
0,0,0,-,-,36082
3592,2225,1367,568,75200,36083
1283,523,760,641,80100,36088
2723,1796,927,626,62500,36089
1455,1081,374,535,77000,36091
7323,5042,2281,776,130700,36092
3915,3449,466,1231,225400,36093
2869,865,2004,663,74200,36104
3989,2559,1430,798,66900,36105
6316,3597,2719,943,156300,36106
3177,1247,1930,765,65600,36107
7921,4396,3525,588,66100,36108
9858,7375,2483,950,116700,36109
4284,2244,2040,812,59300,36110
4963,2791,2172,838,138700,36111
0,0,0,-,-,36112
275,0,275,1494,-,36113
256,0,256,1332,-,36115
17178,8900,8278,823,104600,36116
21945,13132,8813,949,177400,36117
7510,4401,3109,559,65100,36201
6927,4876,2051,806,142500,36203
159,91,68,-,255500,36205
4556,3348,1208,630,94000,36206
8395,5788,2607,710,138300,36207
1820,1530,290,742,119900,36250
2098,1463,635,426,85700,36251
345,320,25,-,71800,36255
668,581,87,575,109200,36256
519,402,117,476,122400,36258
1530,1188,342,621,115700,36260
561,440,121,479,74500,36262
204,124,80,683,89200,36263
3361,2487,874,529,111800,36264
7548,4658,2890,593,144400,36265
2119,1628,491,526,101000,36266
23,8,15,-,-,36267
2394,1980,414,759,100000,36268
442,323,119,541,82400,36269
2243,1931,312,702,87500,36271
5214,4079,1135,532,84500,36272
1227,911,316,712,142200,36273
4412,3174,1238,574,78600,36274
853,653,200,449,83000,36276
1928,1522,406,808,103800,36277
1913,1334,579,663,126500,36278
1035,950,85,670,155100,36279
1435,1107,328,810,90400,36280
14101,8640,5461,703,108400,36301
11812,6802,5010,673,138800,36303
6168,4143,2025,891,178300,36305
2555,2063,492,561,89800,36310
963,831,132,604,76100,36311
2309,1757,552,663,95800,36312
160,117,43,-,162500,36313
214,197,17,613,116300,36314
714,621,93,636,136800,36316
221,171,50,495,69000,36317
577,488,89,675,71800,36318
844,671,173,617,77700,36319
1387,1131,256,611,87500,36320
601,449,152,767,91600,36321
3455,1953,1502,668,106400,36322
2965,2033,932,587,98500,36323
13967,8569,5398,794,167900,36330
2351,1545,806,546,100300,36340
570,486,84,570,70700,36343
2204,1602,602,582,97300,36344
3277,2666,611,622,140600,36345
510,394,116,582,94300,36346
2650,1569,1081,626,120300,36350
1416,1077,339,697,109000,36351
1895,1474,421,762,143400,36352
715,608,107,531,89400,36353
7698,5077,2621,590,109600,36360
1299,0,1299,1269,-,36362
359,256,103,638,83200,36370
275,187,88,765,124500,36371
232,211,21,-,65400,36373
373,345,28,-,118200,36374
2752,2174,578,704,79000,36375
797,617,180,715,84700,36376
2986,2167,819,572,81600,36401
4278,2994,1284,631,106900,36420
3995,3153,842,564,119000,36421
443,302,141,536,36800,36425
6018,4322,1696,562,89300,36426
734,587,147,363,66100,36432
98,89,9,-,63500,36435
215,147,68,-,60200,36436
238,149,89,807,133100,36439
1417,1116,301,530,79000,36441
1358,1014,344,478,78800,36442
345,191,154,-,62100,36444
1716,1154,562,504,83300,36445
180,118,62,847,57900,36446
1956,1347,609,551,130100,36451
906,667,239,592,83600,36453
8,8,0,-,-,36454
127,93,34,621,46100,36455
535,387,148,371,58300,36456
3763,2201,1562,485,100400,36460
3904,2842,1062,556,92000,36467
109,23,86,-,-,36470
449,265,184,508,56400,36471
9,8,1,-,158300,36473
1283,1120,163,548,74300,36474
815,651,164,623,62800,36475
17,15,2,-,-,36476
1699,1178,521,529,64800,36477
582,388,194,664,87300,36480
90,31,59,-,-,36481
288,199,89,-,72000,36482
142,137,5,-,64300,36483
5964,4184,1780,588,104000,36502
669,506,163,1089,113400,36505
6955,4789,2166,635,126600,36507
622,327,295,726,77200,36509
285,228,57,-,-,36511
0,0,0,-,-,36512
293,180,113,-,-,36513
931,754,177,547,86700,36518
2034,1778,256,779,115600,36521
2443,1810,633,780,107600,36522
944,687,257,826,98800,36523
477,405,72,775,109900,36524
658,478,180,818,108500,36525
11828,8339,3489,1057,193700,36526
5189,3639,1550,1140,281200,36527
531,470,61,993,227500,36528
105,105,0,-,136600,36529
2835,2170,665,874,167000,36530
11841,9314,2527,1025,235100,36532
12153,8423,3730,781,155200,36535
156,156,0,-,16300,36538
293,202,91,705,-,36539
235,161,74,-,64100,36540
5311,4737,574,1052,103700,36541
6432,4036,2396,980,246700,36542
65,65,0,-,93400,36543
3847,2990,857,810,98900,36544
3666,2435,1231,549,94800,36545
430,358,72,-,108500,36548
1983,1823,160,948,135500,36549
156,123,33,-,-,36550
3039,2303,736,958,139700,36551
958,842,116,732,103800,36553
329,288,41,865,279600,36555
222,158,64,-,-,36556
1364,1213,151,443,58600,36558
42,32,10,-,-,36559
1250,883,367,612,77000,36560
2922,2207,715,1110,296900,36561
509,476,33,-,112000,36562
36,36,0,-,-,36564
4878,3403,1475,776,134900,36567
86,86,0,-,163200,36568
335,296,39,-,78000,36569
5440,3875,1565,898,135100,36571
2267,1971,296,969,152900,36572
298,298,0,-,115600,36574
7055,5749,1306,878,142100,36575
1558,1191,367,915,156400,36576
500,464,36,694,168500,36578
412,333,79,529,158500,36579
1834,1436,398,698,136200,36580
12,12,0,-,-,36581
8940,6653,2287,733,117500,36582
327,278,49,-,179700,36583
297,257,40,-,-,36584
341,252,89,600,159700,36585
3438,3145,293,967,106300,36587
0,0,0,-,-,36590
617,83,534,491,198400,36602
2716,1065,1651,544,78000,36603
4135,2290,1845,787,157400,36604
10061,5791,4270,780,76000,36605
7835,4119,3716,795,97100,36606
2621,1368,1253,768,107000,36607
14489,8505,5984,837,152500,36608
10762,4890,5872,780,142200,36609
3937,1976,1961,679,50000,36610
2112,1151,961,901,79200,36611
1626,800,826,712,63500,36612
4167,3292,875,802,98500,36613
0,0,0,-,-,36615
0,0,0,-,-,36616
5036,2888,2148,807,74100,36617
6373,5242,1131,838,112000,36618
5716,4483,1233,896,131500,36619
0,0,0,-,-,36688
7647,5301,2346,941,145100,36693
18544,12743,5801,998,181000,36695
9111,5623,3488,633,88000,36701
5043,2479,2564,583,78100,36703
339,243,96,795,23800,36720
152,79,73,-,90700,36722
93,55,38,-,-,36723
1799,972,827,474,94400,36726
14,14,0,-,-,36727
126,106,20,-,-,36728
3407,2119,1288,504,116800,36732
459,378,81,-,75900,36736
327,272,55,-,77900,36738
456,349,107,532,56000,36740
690,576,114,760,63700,36742
2667,1696,971,436,82600,36744
1261,892,369,614,88500,36748
291,225,66,-,94200,36749
1042,777,265,619,114400,36750
218,169,49,603,34300,36751
596,495,101,673,88800,36752
17,0,17,-,-,36753
144,72,72,-,179200,36754
1593,1280,313,551,81000,36756
522,358,164,669,74500,36758
685,488,197,546,61800,36759
402,320,82,-,78800,36761
67,56,11,-,78600,36763
488,436,52,890,63100,36765
11,11,0,-,-,36766
679,501,178,459,50700,36767
322,256,66,525,53800,36768
968,646,322,507,68800,36769
205,99,106,445,100700,36773
368,287,81,754,45300,36775
546,484,62,-,93800,36776
1020,855,165,468,59700,36782
300,251,49,428,71800,36783
2820,1719,1101,534,112700,36784
589,451,138,661,63800,36785
1084,692,392,508,52600,36786
81,81,0,-,48600,36790
477,388,89,-,97200,36792
131,127,4,-,58200,36793
10131,5891,4240,676,154700,36801
6455,4730,1725,767,106200,36804
15409,7526,7883,851,243500,36830
9718,4066,5652,845,98400,36832
0,0,0,-,-,36849
1160,929,231,394,55000,36850
906,737,169,728,94100,36852
3345,2709,636,686,157200,36853
5905,3770,2135,771,99900,36854
661,580,81,491,113700,36855
2288,1781,507,1406,208700,36856
146,123,23,612,90300,36858
22,22,0,-,-,36859
667,543,124,504,60400,36860
1308,1088,220,639,149400,36861
2536,1692,844,562,73000,36862
4844,3145,1699,662,93700,36863
15,15,0,-,63600,36865
1712,1322,390,543,70400,36866
9543,4727,4816,802,130800,36867
8085,4672,3413,737,108300,36869
7276,5061,2215,883,126600,36870
511,420,91,-,89200,36871
3029,2624,405,902,152000,36874
1539,1143,396,800,108800,36875
4803,3219,1584,852,138900,36877
752,670,82,564,191000,36879
193,118,75,509,34900,36901
1695,1144,551,545,83400,36904
757,612,145,676,73200,36907
806,736,70,318,81600,36908
19,0,19,-,-,36910
890,703,187,563,62400,36912
45,45,0,-,40600,36913
283,212,71,-,49200,36915
297,237,60,439,64300,36916
725,644,81,503,55800,36919
402,377,25,592,60600,36921
177,141,36,-,52100,36922
1291,929,362,502,49200,36925
1628,1390,238,980,236500,37010
953,674,279,758,114100,37012
34509,18628,15881,975,157600,37013
906,862,44,823,534100,37014
6490,4709,1781,944,152000,37015
443,288,155,768,229300,37016
933,740,193,1060,67000,37018
255,227,28,525,83700,37019
1995,1629,366,697,144200,37020
2130,1748,382,801,122400,37022
492,405,87,856,161300,37023
2039,1759,280,676,132500,37025
885,724,161,681,125000,37026
18844,16012,2832,1410,511700,37027
358,316,42,-,138000,37028
2206,1896,310,742,226200,37029
2839,1828,1011,516,126700,37030
1460,1329,131,786,154900,37031
1576,1176,400,1026,168300,37032
3133,2293,840,625,114700,37033
2756,2351,405,896,155600,37034
1416,1259,157,763,148400,37035
2073,1535,538,651,127800,37036
2688,2233,455,867,170000,37037
17612,9717,7895,874,151800,37040
27308,14684,12624,934,129400,37042
17364,12099,5265,883,191700,37043
1644,1420,224,1169,345900,37046
828,666,162,756,114800,37047
2286,1968,318,947,200900,37048
1239,967,272,855,169800,37049
575,446,129,514,113200,37050
1303,1051,252,721,116800,37051
1049,812,237,839,163300,37052
10378,6751,3627,732,143200,37055
406,334,72,709,123100,37057
3131,2132,999,580,127200,37058
534,379,155,731,87000,37059
870,740,130,896,174600,37060
1686,1268,418,640,93500,37061
3950,3141,809,958,202100,37062
20306,15747,4559,1122,361600,37064
17894,12147,5747,872,200200,37066
10984,6998,3986,1433,409900,37067
7015,6192,823,1897,420500,37069
12868,8710,4158,947,187900,37072
5261,3983,1278,860,164100,37073
2832,2014,818,597,117500,37074
24065,17463,6602,1091,234400,37075
16541,9301,7240,1016,175400,37076
243,169,74,556,118000,37078
803,465,338,700,119600,37079
2871,2264,607,867,172100,37080
2346,2008,338,1107,207700,37082
5843,4235,1608,583,116800,37083
1911,1611,300,740,173100,37085
10719,7388,3331,1136,135200,37086
16268,10865,5403,824,206600,37087
5443,4261,1182,1022,201200,37090
8475,5678,2797,676,108800,37091
891,596,295,619,137100,37095
2353,1931,422,549,87300,37096
932,759,173,562,76500,37097
2239,1790,449,689,90000,37098
2459,1848,611,638,110500,37101
13131,8740,4391,619,108800,37110
16486,7265,9221,864,139000,37115
300,226,74,682,238100,37118
20108,16691,3417,1190,250100,37122
6449,5054,1395,884,189500,37127
17512,11814,5698,1109,194700,37128
19923,14150,5773,1017,188300,37129
21849,9680,12169,877,174300,37130
0,0,0,-,-,37132
1102,918,184,816,97300,37134
3857,3628,229,2095,362400,37135
1200,1000,200,630,70800,37137
9229,7351,1878,1047,179700,37138
24,24,0,-,-,37140
486,373,113,989,154100,37141
717,541,176,651,153800,37142
1521,1329,192,853,191000,37143
1151,933,218,664,105900,37144
727,582,145,545,116300,37145
2352,1946,406,1141,181700,37146
8323,6155,2168,786,137900,37148
976,819,157,685,156600,37149
2005,1449,556,534,104500,37150
206,183,23,-,150600,37151
2059,1851,208,1068,220100,37153
12276,7664,4612,734,126000,37160
30,22,8,-,70000,37165
5234,3250,1984,608,129300,37166
20706,13633,7073,893,166400,37167
241,241,0,-,-,37171
10864,7604,3260,816,153400,37172
11500,8971,2529,1228,234500,37174
360,317,43,743,118900,37175
908,712,196,664,92200,37178
4414,3969,445,1373,272200,37179
1292,1091,201,756,134000,37180
595,455,140,682,116100,37181
1174,960,214,640,146100,37183
2232,1763,469,744,170300,37184
3389,2616,773,626,101300,37185
3311,2460,851,685,117200,37186
2716,1984,732,794,136700,37187
5320,4529,791,963,174200,37188
1441,1126,315,1048,184700,37189
3401,2507,894,641,159500,37190
1510,1221,289,788,143200,37191
561,208,353,1388,273300,37201
6882,1634,5248,1179,298500,37203
5653,3336,2317,1164,433200,37204
11140,7743,3397,1271,485400,37205
10848,5483,5365,804,267200,37206
14003,8069,5934,834,133100,37207
7119,2404,4715,774,175400,37208
14744,6991,7753,1023,245900,37209
6969,2044,4925,715,140100,37210
30298,14100,16198,943,184500,37211
6904,2677,4227,1180,485600,37212
8,0,8,-,-,37213
13698,8207,5491,1050,155600,37214
9783,7783,2000,1360,571100,37215
8144,5572,2572,975,204500,37216
12880,5327,7553,899,144300,37217
5508,3667,1841,838,150200,37218
790,250,540,1521,312200,37219
2314,2035,279,1472,403700,37220
16856,11617,5239,1210,248600,37221
596,22,574,885,-,37228
0,0,0,-,-,37240
0,0,0,-,-,37243
0,0,0,-,-,37246
471,370,101,567,77500,37301
1740,1398,342,730,268500,37302
9696,6659,3037,630,137400,37303
378,323,55,825,46500,37305
1007,806,201,670,132300,37306
2015,1521,494,655,106300,37307
1173,1052,121,574,159800,37308
873,706,167,773,108900,37309
1826,1620,206,598,163200,37310
10427,4881,5546,673,127900,37311
13115,8393,4722,838,176900,37312
477,376,101,425,88700,37313
0,0,0,-,-,37315
1118,810,308,654,115900,37317
737,499,238,488,79900,37318
7272,4964,2308,664,114900,37321
3220,2611,609,667,112800,37322
12032,9408,2624,783,126300,37323
2268,1331,937,588,107600,37324
657,551,106,813,146900,37325
154,82,72,505,86700,37326
4271,3179,1092,677,140900,37327
514,393,121,567,97500,37328
2199,1769,430,659,108900,37329
2877,2370,507,768,111100,37330
2968,2177,791,613,106800,37331
933,774,159,584,125000,37332
232,194,38,-,70000,37333
9243,6418,2825,679,118600,37334
1116,866,250,824,97200,37335
1844,1452,392,-,168400,37336
800,609,191,390,61700,37337
1481,947,534,616,87100,37338
755,637,118,665,84000,37339
284,231,53,817,100400,37340
4394,3823,571,916,153000,37341
1290,1072,218,648,102600,37342
16775,12708,4067,821,170300,37343
901,685,216,648,104400,37345
2955,2128,827,692,128300,37347
374,264,110,612,151100,37348
749,669,80,1125,541400,37350
123,15,108,1148,-,37351
1309,1074,235,613,180400,37352
1818,1453,365,920,155000,37353
6632,4955,1677,593,112500,37354
9969,6857,3112,710,129100,37355
1001,565,436,591,157200,37356
2090,1617,473,545,126700,37357
301,263,38,577,116800,37359
635,538,97,772,125500,37360
571,444,127,770,151000,37361
1336,960,376,697,121200,37362
13942,11061,2881,944,210600,37363
470,395,75,480,58200,37365
331,266,65,748,150000,37366
3670,2703,967,578,121600,37367
475,448,27,-,85200,37369
1949,1545,404,484,136700,37370
1036,876,160,713,146500,37373
833,695,138,685,128400,37374
1082,760,322,905,267400,37375
162,143,19,-,108000,37376
5717,4820,897,1214,325200,37377
10851,9075,1776,688,161100,37379
2595,1706,889,601,118700,37380
3696,2857,839,624,130100,37381
3220,2806,414,596,126900,37385
1231,890,341,517,76900,37387
10676,7051,3625,656,117700,37388
636,568,68,575,114700,37391
27,17,10,-,88300,37394
64,37,27,-,-,37396
4026,3278,748,645,112600,37397
5835,4229,1606,573,138200,37398
2181,96,2085,329,363600,37402
1327,473,854,850,317500,37403
4747,2224,2523,712,105800,37404
7193,3959,3234,997,238800,37405
5753,2666,3087,658,93900,37406
3427,1117,2310,700,64300,37407
803,290,513,651,263200,37408
1027,650,377,734,150600,37409
1512,458,1054,549,70600,37410
7244,4460,2784,728,107400,37411
8817,4828,3989,810,119500,37412
10955,5962,4993,808,146800,37415
6272,3907,2365,807,138400,37416
2663,1960,703,699,188900,37419
19241,11506,7735,987,177400,37421
15396,8510,6886,675,140300,37601
16125,8435,7690,713,147400,37604
0,0,0,-,-,37614
8795,6114,2681,730,187000,37615
2061,1806,255,579,113000,37616
5410,4441,969,604,152000,37617
5374,4249,1125,585,131300,37618
16191,11746,4445,659,114600,37620
1572,1291,281,540,100800,37640
3727,3048,679,681,104000,37641
6093,4685,1408,657,124600,37642
14216,9722,4494,613,112900,37643
2084,1576,508,685,132300,37645
5124,3612,1512,618,109900,37650
1761,1390,371,704,122100,37656
392,305,87,521,78100,37657
1892,1470,422,593,111900,37658
11272,9134,2138,741,150900,37659
17626,10774,6852,612,118700,37660
6078,4734,1344,690,166200,37663
11491,8498,2993,639,150300,37664
2557,1632,925,701,91900,37665
221,149,72,358,102000,37680
2375,1700,675,620,132400,37681
77,30,47,-,-,37682
4857,3709,1148,502,125200,37683
3450,2813,637,656,157200,37686
1916,1681,235,497,83300,37687
462,374,88,485,105600,37688
1553,1423,130,732,132800,37690
293,161,132,500,103500,37691
2088,1605,483,555,149100,37692
708,554,154,622,119800,37694
3081,2164,917,730,124400,37701
1553,1272,281,779,184100,37705
2759,2255,504,579,105300,37708
1530,1143,387,666,134200,37709
415,370,45,567,63000,37710
2025,1492,533,547,95200,37711
642,447,195,660,96200,37713
1782,1132,650,587,98800,37714
287,207,80,402,67700,37715
10567,7387,3180,705,148000,37716
55,18,37,-,-,37719
5036,4124,912,904,142100,37721
2300,1836,464,555,125200,37722
372,312,60,670,89000,37723
1129,678,451,610,99700,37724
6764,5441,1323,784,162300,37725
773,687,86,490,85300,37726
981,789,192,567,97400,37727
563,495,68,620,51600,37729
4,4,0,-,-,37730
300,284,16,-,87900,37731
103,69,34,-,91400,37732
31,31,0,-,180700,37733
2327,1976,351,771,177300,37737
2359,1464,895,754,173700,37738
2324,1981,343,697,187400,37742
10039,7250,2789,538,126600,37743
6919,4522,2397,569,132200,37745
6867,4881,1986,653,101300,37748
2305,1779,526,661,119100,37752
338,205,133,472,124000,37753
1954,1556,398,884,106900,37754
1338,860,478,478,80600,37755
1153,783,370,460,64800,37756
3645,2672,973,599,129700,37757
4687,2640,2047,647,133700,37760
1314,774,540,371,74100,37762
6449,5223,1226,733,164200,37763
3518,2530,988,723,156900,37764
206,190,16,-,111900,37765
7368,4966,2402,595,81600,37766
2144,1402,742,529,83800,37769
918,760,158,675,107500,37770
5865,3969,1896,774,126400,37771
5110,3966,1144,936,226300,37772
7716,6302,1414,683,229400,37774
4973,3185,1788,661,198900,37777
1344,1001,343,569,101500,37779
10480,7265,3215,763,170100,37801
12573,10131,2442,738,188300,37803
9026,6620,2406,820,157400,37804
1095,794,301,722,108700,37806
3647,2611,1036,597,110400,37807
810,672,138,770,93400,37809
674,525,149,567,106100,37810
1479,1254,225,621,109900,37811
6804,4385,2419,662,109400,37813
12692,8086,4606,715,139100,37814
2230,1639,591,560,90900,37818
260,191,69,639,108500,37819
2839,2270,569,703,121200,37820
9143,5723,3420,525,101400,37821
3777,2580,1197,483,91400,37825
1909,1614,295,647,116100,37826
607,451,156,743,213400,37828
745,604,141,700,87200,37829
12419,7528,4891,756,149800,37830
4071,3306,765,632,108600,37840
3774,2634,1140,529,100400,37841
1561,1250,311,654,123600,37843
194,132,62,-,69700,37845
1891,1395,496,589,98800,37846
905,760,145,553,73300,37847
106,97,9,-,99800,37848
9999,7875,2124,857,167400,37849
27,27,0,-,-,37851
951,676,275,531,86100,37852
1630,1059,571,826,126900,37853
5297,3858,1439,645,99900,37854
8248,6242,2006,547,105500,37857
1584,1146,438,533,133900,37860
3344,2457,887,597,112200,37861
8543,4672,3871,717,183900,37862
2896,1686,1210,759,163100,37863
8464,6471,1993,800,163800,37865
677,577,100,554,207600,37866
1966,1436,530,434,83400,37869
2047,1550,497,652,100400,37870
3580,2713,867,741,130200,37871
620,492,128,644,108300,37872
1827,1274,553,535,87900,37873
5251,3682,1569,680,105600,37874
12390,9252,3138,738,162300,37876
3561,2906,655,709,133300,37877
214,178,36,488,102400,37878
4304,3152,1152,600,99900,37879
1340,1088,252,549,138100,37880
805,711,94,461,90200,37881
1231,982,249,703,188100,37882
2299,1777,522,617,153400,37885
1735,1406,329,682,170100,37886
1906,1366,540,672,92700,37887
1127,946,181,668,109000,37888
2745,1968,777,608,134500,37890
1431,1044,387,641,115800,37891
804,568,236,660,81700,37892
1372,260,1112,906,293100,37902
7100,2629,4471,879,171000,37909
10321,5098,5223,770,117200,37912
8425,5416,3009,823,115800,37914
2918,533,2385,445,80100,37915
2671,52,2619,824,220600,37916
11248,5173,6075,696,97100,37917
17392,12055,5337,776,151100,37918
12810,6850,5960,831,277800,37919
16944,10900,6044,732,127800,37920
10897,6597,4300,853,123200,37921
12848,10824,2024,1198,310400,37922
12826,7290,5536,941,190100,37923
4720,3643,1077,730,130500,37924
11245,8102,3143,1026,201200,37931
6566,4886,1680,1138,225600,37932
9553,8235,1318,1204,305900,37934
6393,5686,707,878,173400,37938
1738,1168,570,624,100800,38001
12961,11125,1836,1376,221700,38002
3489,2895,594,1116,185300,38004
1827,1139,688,739,105000,38006
14,14,0,-,-,38007
3451,2077,1374,594,89000,38008
3410,2648,762,929,136400,38011
5519,3034,2485,607,109700,38012
909,582,327,566,109400,38015
18264,9558,8706,1112,161600,38016
18463,14399,4064,1217,285300,38017
13665,9013,4652,1118,158500,38018
6000,3343,2657,673,114700,38019
18,18,0,-,-,38021
2023,1437,586,902,136100,38023
11082,6369,4713,646,101700,38024
2529,2373,156,1216,324100,38028
0,0,0,-,-,38029
284,80,204,804,74800,38030
1141,847,294,614,89100,38034
168,18,150,431,-,38036
610,455,155,627,71700,38037
664,526,138,692,86900,38039
2006,1234,772,647,79800,38040
993,605,388,579,72700,38041
383,260,123,621,81200,38042
332,278,54,530,114700,38044
23,16,7,-,320000,38046
50,33,17,-,-,38047
1539,1165,374,818,91900,38049
195,130,65,656,91900,38050
1489,1098,391,581,82700,38052
10010,6782,3228,855,127700,38053
38,0,38,1975,-,38054
1393,1033,360,676,138500,38057
3574,2375,1199,903,151500,38058
2964,2274,690,684,98700,38059
3914,3481,433,1135,164900,38060
277,236,41,-,114400,38061
6729,3707,3022,640,84400,38063
1031,844,187,727,217500,38066
519,476,43,763,89200,38067
4019,2713,1306,583,156000,38068
946,748,198,540,78400,38069
131,93,38,-,-,38070
1270,937,333,722,86600,38075
360,296,64,713,211300,38076
55,38,17,-,204800,38077
1132,698,434,535,75800,38079
1184,755,429,501,72000,38080
7045,1966,5079,1187,234600,38103
12545,4019,8526,735,189100,38104
3131,417,2714,642,64200,38105
9384,4624,4760,709,52400,38106
6753,3246,3507,746,82500,38107
6359,2788,3571,730,47200,38108
16517,10319,6198,827,65600,38109
16802,7698,9104,782,93700,38111
6510,2960,3550,760,112500,38112
9819,4287,5532,729,54800,38114
16672,3680,12992,845,88000,38115
14369,7227,7142,811,94000,38116
11045,8906,2139,1096,181100,38117
12813,6195,6618,876,70400,38118
9948,5158,4790,1003,165700,38119
6444,4613,1831,1090,292100,38120
9360,4673,4687,880,69800,38122
13755,8665,5090,1111,148800,38125
2001,301,1700,544,45300,38126
14679,7337,7342,856,58700,38127
15732,6968,8764,862,80700,38128
0,0,0,-,-,38131
0,0,0,-,-,38132
7421,5682,1739,1162,144500,38133
14952,7039,7913,915,118600,38134
10516,8541,1975,1231,164800,38135
9937,7989,1948,1174,266900,38138
5557,5248,309,2293,373000,38139
7515,5145,2370,1188,92700,38141
0,0,0,-,-,38152
4243,3060,1183,669,92200,38201
759,491,268,668,77100,38220
1396,1202,194,571,81600,38221
1289,1045,244,672,101700,38222
320,265,55,469,77700,38224
2622,1987,635,566,86500,38225
115,115,0,-,67900,38226
1196,829,367,571,82300,38229
1538,1124,414,607,71500,38230
665,550,115,650,79200,38231
759,638,121,477,80400,38232
1121,821,300,582,86600,38233
145,109,36,569,103100,38235
279,248,31,754,79700,38236
6095,3519,2576,606,117300,38237
1045,743,302,630,69500,38240
377,313,64,324,81200,38241
8383,5956,2427,596,99700,38242
1037,784,253,632,88800,38251
386,312,74,714,111300,38253
24,18,6,-,62200,38254
992,635,357,584,67100,38255
1333,1165,168,608,96000,38256
1886,1381,505,470,86200,38257
589,388,201,584,72500,38258
324,216,108,581,76500,38259
1470,1033,437,650,94100,38260
6733,4157,2576,586,96700,38261
12876,6823,6053,709,85000,38301
19828,12883,6945,929,150500,38305
2177,1758,419,547,85500,38310
330,284,46,-,100000,38311
1096,961,135,708,100500,38313
1356,1072,284,585,76300,38315
1291,1034,257,627,83000,38316
1071,793,278,567,61600,38317
207,113,94,467,58700,38318
4352,3083,1269,606,95100,38320
858,686,172,645,88300,38321
1208,984,224,780,86900,38326
183,117,66,541,63600,38327
228,196,32,531,88500,38328
1345,1046,299,615,104900,38329
1764,1322,442,591,70000,38330
510,489,21,475,84200,38332
165,157,8,-,89100,38333
749,621,128,444,85100,38334
489,383,106,692,79800,38337
261,210,51,705,103400,38339
4567,3318,1249,686,113600,38340
871,704,167,594,82800,38341
593,465,128,572,52100,38342
5970,4175,1795,668,97900,38343
3122,2306,816,561,96100,38344
950,701,249,809,87700,38345
108,48,60,-,126000,38347
475,416,59,555,92100,38348
6827,4802,2025,608,97100,38351
237,154,83,461,108200,38352
2158,1643,515,1070,162300,38355
1083,849,234,588,85200,38356
954,711,243,572,90400,38357
4425,3202,1223,704,107900,38358
144,117,27,531,84600,38359
442,362,80,731,109700,38361
424,330,94,1103,89200,38362
2320,1655,665,541,86100,38363
8,0,8,-,-,38365
663,532,131,747,132300,38366
1218,925,293,735,97800,38367
780,573,207,685,79600,38368
686,555,131,564,81300,38369
339,248,91,439,69400,38370
434,344,90,615,85500,38371
6593,4680,1913,604,113000,38372
892,601,291,536,87600,38374
3651,2441,1210,567,95800,38375
107,99,8,-,75800,38376
554,422,132,612,102400,38379
247,195,52,629,84200,38380
486,332,154,653,100000,38381
3927,2498,1429,636,94600,38382
92,78,14,-,113600,38387
769,591,178,683,88800,38388
325,242,83,572,91800,38390
452,344,108,677,81700,38391
232,232,0,-,88400,38392
21783,14061,7722,748,147400,38401
735,589,146,502,98800,38425
1010,698,312,546,112200,38449
1156,915,241,458,93400,38450
1571,1363,208,723,158000,38451
457,410,47,-,102900,38452
156,156,0,-,185800,38453
414,321,93,-,94300,38454
61,52,9,575,142500,38455
1495,1243,252,673,103000,38456
320,249,71,525,91300,38457
186,162,24,720,47400,38459
487,354,133,723,79600,38460
469,403,66,776,81500,38461
3846,2995,851,493,90200,38462
1136,902,234,567,72100,38463
8797,6088,2709,613,107200,38464
1952,1597,355,650,96800,38468
1575,1247,328,604,92300,38469
171,158,13,-,114400,38471
1192,1026,166,580,106200,38472
454,333,121,607,95500,38473
3186,2295,891,650,92200,38474
194,186,8,-,105600,38475
439,350,89,-,261900,38476
1185,989,196,561,122900,38477
6931,4352,2579,627,127600,38478
413,329,84,570,77400,38481
649,551,98,838,173000,38482
2213,1702,511,629,110100,38483
2475,1933,542,490,89400,38485
351,296,55,-,93100,38486
521,318,203,770,161600,38487
1067,917,150,483,145200,38488
16612,8151,8461,646,155900,38501
396,372,24,-,145900,38504
0,0,0,-,-,38505
11260,8730,2530,738,157400,38506
670,601,69,563,68200,38541
10,0,10,-,-,38542
258,220,38,-,94700,38543
2739,2024,715,647,122400,38544
590,390,200,510,131800,38545
765,678,87,765,122800,38547
263,194,69,446,141200,38548
1594,1220,374,432,121400,38549
1646,1111,535,422,107000,38551
101,82,19,-,163900,38552
953,765,188,813,99100,38553
427,389,38,568,107100,38554
7982,5012,2970,638,140400,38555
5147,3670,1477,473,102700,38556
4410,3841,569,929,202200,38558
499,423,76,700,115200,38559
451,408,43,513,112100,38560
2657,2051,606,484,96100,38562
1148,872,276,632,119100,38563
197,170,27,-,71000,38564
474,466,8,-,59100,38565
266,258,8,-,100000,38567
898,657,241,525,83700,38568
94,94,0,-,57300,38569
3928,2740,1188,477,116200,38570
5648,4514,1134,590,131200,38571
4838,4287,551,653,113400,38572
832,760,72,-,141000,38573
3260,2427,833,513,128200,38574
453,393,60,578,92200,38575
503,377,126,528,78600,38577
71,62,9,-,130000,38578
303,233,70,775,115100,38579
547,457,90,-,123900,38580
1435,1248,187,575,94500,38581
608,571,37,748,140100,38582
8854,6927,1927,629,97500,38583
1386,1167,219,402,86800,38585
607,526,81,573,101600,38587
369,278,91,-,158200,38588
64,26,38,-,-,38589
906,708,198,492,81200,38601
1227,975,252,529,64200,38603
5399,3790,1609,720,96600,38606
1157,830,327,589,76100,38610
6042,4693,1349,689,120200,38611
6800,3363,3437,589,66400,38614
241,153,88,306,59200,38617
4465,3657,808,719,91200,38618
2175,1408,767,609,68600,38619
1233,1075,158,776,59600,38620
547,347,200,634,42200,38621
225,110,115,553,-,38622
98,86,12,-,41300,38623
415,283,132,548,77900,38625
582,388,194,540,96400,38626
329,245,84,-,51300,38627
736,564,172,430,107300,38629
64,38,26,-,-,38630
445,191,254,517,49600,38631
9425,7860,1565,1017,185400,38632
712,559,153,535,69800,38633
5352,3692,1660,608,81800,38635
9468,5504,3964,1000,98800,38637
447,201,246,363,43800,38639
833,704,129,604,179000,38641
778,713,65,652,79500,38642
930,463,467,492,52200,38643
98,59,39,619,34100,38644
530,282,248,690,69400,38645
1282,978,304,587,56900,38646
314,295,19,-,73900,38647
1296,975,321,641,73500,38650
2683,2313,370,944,179000,38651
6159,4226,1933,680,100800,38652
17955,14263,3692,1110,184400,38654
17357,9686,7671,875,198000,38655
780,702,78,932,73500,38658
992,774,218,704,84600,38659
794,726,68,-,93800,38661
4612,3338,1274,570,87500,38663
1344,159,1185,751,130500,38664
783,646,137,-,85500,38665
2702,2018,684,592,58500,38666
4966,3438,1528,661,121400,38668
369,276,93,771,42400,38670
13415,8146,5269,971,117200,38671
4396,3845,551,1595,190400,38672
312,263,49,692,-,38673
283,242,41,-,81400,38674
2202,1070,1132,670,101500,38676
39,0,39,665,-,38677
2170,1458,712,834,138600,38680
2308,1759,549,338,61800,38683
494,484,10,-,124200,38685
8875,4585,4290,660,82200,38701
0,0,0,-,-,38702
4630,2573,2057,704,69200,38703
0,0,0,-,-,38704
275,181,94,589,27500,38720
401,272,129,491,59100,38721
168,96,72,500,60500,38722
9,9,0,-,-,38723
331,174,157,538,49600,38725
193,113,80,560,24600,38726
843,615,228,747,135500,38730
48,9,39,-,-,38731
6570,3607,2963,676,109900,38732
159,127,32,669,64600,38736
1090,520,570,407,63200,38737
66,0,66,-,-,38738
100,66,34,578,47800,38740
350,207,143,-,-,38744
38,21,17,-,91700,38745
152,59,93,573,51500,38746
1547,928,619,484,74000,38748
9,2,7,-,-,38749
4022,2353,1669,676,71600,38751
514,357,157,593,102400,38753
529,305,224,520,82400,38754
2425,1421,1004,691,70400,38756
356,257,99,832,96900,38759
353,190,163,586,64000,38760
770,413,357,543,66500,38761
919,398,521,473,83300,38762
100,53,47,762,58300,38764
24,24,0,-,-,38765
30,30,0,-,71200,38767
35,5,30,-,-,38768
728,350,378,471,72600,38769
1056,526,530,617,77400,38771
53,47,6,-,55000,38772
1172,759,413,447,80700,38773
803,443,360,419,65500,38774
557,341,216,535,59900,38778
113,55,58,294,78300,38781
11179,6706,4473,725,122700,38801
7068,4064,3004,687,150500,38804
4982,3611,1371,635,101500,38821
3085,2199,886,513,103600,38824
1875,1582,293,745,150000,38826
1186,877,309,556,105200,38827
1602,1247,355,568,118300,38828
6872,4760,2112,541,88100,38829
991,696,295,572,52600,38833
11307,7683,3624,623,94800,38834
506,421,85,-,60400,38838
1075,742,333,620,72800,38841
4418,3182,1236,647,92200,38843
71,68,3,-,-,38844
923,768,155,658,77700,38846
1133,951,182,715,64200,38847
252,243,9,-,68900,38848
2222,1781,441,733,96600,38849
1100,795,305,458,64700,38850
2992,2185,807,564,63300,38851
3724,2761,963,560,97100,38852
1774,1315,459,648,82800,38855
757,719,38,1200,111200,38856
1454,1252,202,594,125400,38857
2717,2143,574,578,84700,38858
304,270,34,-,86200,38859
2253,1573,680,561,62700,38860
821,668,153,701,98900,38862
7179,5050,2129,673,104100,38863
714,595,119,772,74300,38864
1809,1461,348,531,71800,38865
4570,3565,1005,496,143700,38866
2046,1485,561,624,81400,38868
161,85,76,809,101800,38869
1050,839,211,654,98600,38870
630,507,123,766,117200,38871
1055,885,170,514,68800,38873
622,462,160,506,104200,38876
998,761,237,611,67900,38878
306,50,256,644,86000,38879
6654,4402,2252,623,94500,38901
142,120,22,-,67700,38913
260,198,62,495,58300,38914
1579,1085,494,479,68300,38915
2100,1330,770,559,71700,38916
1266,877,389,411,81800,38917
289,213,76,-,61300,38920
1600,1227,373,394,68200,38921
1356,1133,223,554,66300,38922
448,406,42,-,90000,38923
310,211,99,463,47000,38924
1238,910,328,504,75100,38925
503,431,72,-,47000,38927
81,55,26,433,32500,38928
571,442,129,782,69000,38929
8627,4542,4085,519,85700,38930
638,533,105,654,90400,38940
1386,507,879,624,69400,38941
14,14,0,-,-,38943
192,140,52,482,56600,38944
17,0,17,-,-,38945
86,60,26,625,48500,38946
185,173,12,500,-,38947
1186,1014,172,488,31600,38948
84,74,10,-,112500,38949
239,199,40,-,71000,38950
561,461,100,-,56500,38951
155,91,64,-,75000,38952
150,150,0,-,93000,38953
403,224,179,575,76400,38954
309,210,99,220,73600,38957
0,0,0,-,-,38958
222,188,34,-,79400,38961
54,30,24,-,-,38962
422,300,122,613,77200,38963
42,22,20,-,-,38964
3494,2481,1013,589,91400,38965
308,185,123,716,53100,38966
2790,2014,776,609,95200,38967
2142,1211,931,533,60000,39038
838,616,222,736,83400,39039
1296,1005,291,668,79900,39040
1370,1074,296,568,128700,39041
13669,11353,2316,935,159400,39042
1640,1513,127,689,94100,39044
482,459,23,-,88100,39045
9838,5856,3982,776,152600,39046
14778,12285,2493,1261,186400,39047
6057,4315,1742,640,80800,39051
127,91,36,-,-,39054
9292,6174,3118,946,158600,39056
719,539,180,779,70100,39057
4103,3175,928,757,89800,39059
0,0,0,-,-,39061
199,122,77,634,81800,39062
1131,647,484,580,55100,39063
1523,1235,288,521,96400,39066
507,457,50,-,43800,39067
1637,945,692,407,58600,39069
2091,1644,447,713,140200,39071
6977,5523,1454,788,134900,39073
5523,3810,1713,655,69200,39074
346,309,37,331,91200,39078
527,312,215,605,61800,39079
375,303,72,535,66100,39082
3492,2561,931,657,89700,39083
601,493,108,-,43400,39086
25,15,10,-,-,39088
4964,3153,1811,537,80700,39090
975,833,142,577,84200,39092
1282,1004,278,613,87800,39094
2784,1727,1057,449,46600,39095
495,322,173,588,49600,39096
271,149,122,446,-,39097
678,596,82,722,62100,39108
14997,13962,1035,1298,262100,39110
3125,2173,952,617,91500,39111
151,64,87,265,-,39113
3489,2944,545,739,85500,39114
18,10,8,-,-,39115
644,503,141,-,61700,39116
3884,2843,1041,718,80200,39117
2020,1646,374,805,79800,39119
11653,7332,4321,581,91300,39120
1009,729,280,742,83400,39140
178,169,9,-,49700,39144
1941,1609,332,752,133800,39145
776,612,164,653,63400,39146
557,515,42,-,96900,39149
2173,1404,769,604,66500,39150
448,329,119,635,55700,39152
1516,1270,246,463,74300,39153
3278,2821,457,816,156300,39154
158,158,0,-,-,39156
10697,4938,5759,995,182900,39157
1324,765,559,400,58200,39159
1096,853,243,536,43100,39160
28,23,5,-,"10,000-",39162
148,96,52,246,59500,39166
0,0,0,-,-,39167
2762,2107,655,590,72700,39168
925,435,490,290,40100,39169
3726,3404,322,700,182400,39170
41,19,22,-,-,39174
1635,1378,257,778,76400,39175
738,577,161,380,85300,39176
55,17,38,-,-,39177
409,329,80,-,104100,39179
12743,8105,4638,682,108900,39180
5658,3554,2104,638,129000,39183
1224,938,286,570,75900,39189
2775,2397,378,722,100000,39191
500,414,86,1010,64000,39192
0,0,0,-,-,39193
6093,3412,2681,569,76800,39194
259,12,247,1192,-,39201
3556,896,2660,757,172900,39202
1992,905,1087,626,48600,39203
6138,2526,3612,720,70100,39204
10150,4843,5307,817,97600,39206
11390,7203,4187,814,120100,39208
9654,4484,5170,751,63600,39209
10080,6638,3442,997,159900,39211
11612,7362,4250,886,87000,39212
8580,4684,3896,655,62600,39213
1652,823,829,776,221000,39216
0,0,0,-,-,39217
2461,1408,1053,880,124400,39218
3393,1556,1837,1056,191700,39232
0,0,0,-,-,39269
4740,3697,1043,1113,134700,39272
10294,6127,4167,618,76500,39301
8327,5638,2689,803,144800,39305
6185,3730,2455,672,70000,39307
0,0,0,-,-,39309
591,489,102,799,122200,39320
621,621,0,-,58200,39322
566,451,115,584,68300,39323
2579,2296,283,598,109200,39325
271,176,95,903,74500,39326
1510,1152,358,629,111800,39327
1850,1246,604,339,67500,39328
965,878,87,1083,99000,39330
531,498,33,572,78100,39332
1146,1080,66,-,55000,39335
497,399,98,-,73300,39336
823,732,91,385,105700,39337
1447,1256,191,626,58700,39338
5913,4230,1683,637,79700,39339
2412,1722,690,528,56300,39341
534,157,377,829,94400,39342
2568,1937,631,615,69500,39345
915,656,259,623,74400,39346
687,551,136,526,89900,39347
391,321,70,-,-,39348
9214,6717,2497,668,79100,39350
195,183,12,-,102500,39352
783,650,133,754,54700,39354
2721,2200,521,627,75400,39355
280,247,33,-,-,39356
559,416,143,300,51600,39358
129,93,36,631,128600,39359
1390,1151,239,541,54700,39360
608,488,120,555,45600,39361
1184,1035,149,471,57200,39362
624,458,166,591,47900,39363
1075,846,229,-,87100,39364
2518,1950,568,602,75300,39365
497,471,26,-,67900,39366
5801,4518,1283,534,80300,39367
16400,7107,9293,714,91800,39401
15379,9742,5637,943,186000,39402
0,0,0,-,-,39406
1106,893,213,526,61800,39421
2072,1699,373,687,73200,39422
1037,906,131,653,67400,39423
737,517,220,553,99600,39425
6323,5304,1019,925,139000,39426
610,495,115,506,67400,39427
3276,2624,652,662,73700,39428
6339,4756,1583,609,83400,39429
4622,3671,951,717,98600,39437
1727,1498,229,609,72000,39439
7798,4266,3532,648,78100,39440
7990,6381,1609,557,90300,39443
1352,1151,201,625,76900,39451
8615,7197,1418,669,101300,39452
3668,2725,943,600,92400,39455
422,370,52,611,151800,39456
1261,982,279,598,65100,39459
301,301,0,-,76200,39461
407,307,100,522,84900,39462
944,887,57,726,107800,39464
7453,5536,1917,841,141600,39465
10323,7230,3093,731,121100,39466
4524,3732,792,645,101800,39470
2159,1512,647,707,86200,39474
4986,3674,1312,845,155300,39475
2876,2414,462,622,98200,39476
272,220,52,638,100000,39477
815,598,217,533,74200,39478
2068,1708,360,644,117800,39479
1039,824,215,685,110100,39480
542,463,79,829,83800,39481
3740,3175,565,913,143100,39482
2383,2063,320,712,74000,39483
8989,3281,5708,804,87500,39501
19685,12708,6977,852,141100,39503
7375,3538,3837,874,147200,39507
7237,4593,2644,807,136700,39520
3535,2960,575,989,163000,39525
3364,1449,1915,760,104500,39530
7437,2142,5295,785,144700,39531
13509,8333,5176,949,172000,39532
0,0,0,-,-,39534
3962,1455,2507,935,111600,39540
6179,4004,2175,875,122100,39553
3230,2896,334,954,102800,39556
6891,4384,2507,972,138500,39560
802,610,192,-,120400,39561
6411,5351,1060,723,113300,39562
5152,3503,1649,794,89100,39563
14054,10117,3937,969,150300,39564
6578,5672,906,916,156100,39565
4116,2451,1665,743,116000,39567
5209,4000,1209,867,170800,39571
529,488,41,655,114800,39572
2995,2579,416,725,108700,39573
4660,3995,665,937,152300,39574
2336,1365,971,722,131000,39576
3476,2482,994,678,109200,39577
4318,2108,2210,743,99300,39581
8438,5886,2552,709,96700,39601
2667,2212,455,673,101300,39629
330,147,183,459,72400,39630
1300,986,314,372,56400,39631
396,328,68,213,56800,39633
80,80,0,-,67600,39635
1337,1030,307,625,54700,39638
1557,1288,269,1266,107300,39641
417,341,76,1054,89800,39643
2086,1886,200,680,87100,39645
466,466,0,-,124100,39647
7949,4683,3266,637,90100,39648
3055,2404,651,729,76900,39652
1058,775,283,706,72300,39653
1980,1566,414,657,100300,39654
308,293,15,-,53800,39656
744,604,140,626,92000,39657
1101,809,292,520,62400,39661
488,437,51,-,89400,39662
1121,803,318,1022,88000,39663
879,729,150,743,73300,39664
501,458,43,586,73500,39665
3573,2876,697,653,101100,39666
4973,4546,427,545,97600,39667
243,227,16,-,86300,39668
1488,1246,242,545,65300,39669
5119,2568,2551,595,105300,39701
8395,5574,2821,797,115100,39702
5602,2952,2650,858,156600,39705
4350,3101,1249,556,76300,39730
1469,1019,450,381,104700,39735
115,64,51,488,69000,39736
64,64,0,-,104300,39737
922,680,242,552,67300,39739
1957,1570,387,772,140300,39740
606,533,73,961,73400,39741
619,509,110,440,73700,39743
2168,1475,693,504,75200,39744
294,258,36,760,-,39745
1268,1039,229,564,107600,39746
792,659,133,494,62300,39747
986,734,252,670,67400,39750
538,478,60,703,58600,39751
1151,1018,133,485,75000,39752
328,307,21,665,67500,39755
761,609,152,893,48900,39756
16288,8393,7895,760,153900,39759
10,10,0,-,-,39760
19,0,19,-,-,39762
1031,794,237,975,93500,39766
323,279,44,-,47500,39767
691,626,65,588,87500,39769
36,30,6,-,84000,39771
613,428,185,682,66300,39772
6207,4232,1975,681,90000,39773
625,494,131,497,74100,39776
794,573,221,404,49300,39813
703,491,212,639,64400,39815
3683,2016,1667,578,95700,39817
4350,2471,1879,684,136000,39819
3063,2090,973,633,85500,39823
183,146,37,-,73500,39824
451,278,173,541,157500,39825
157,103,54,813,93000,39826
1523,901,622,740,122500,39827
5300,2924,2376,793,108400,39828
949,756,193,662,89000,39834
93,68,25,-,-,39836
2494,1683,811,652,89400,39837
2124,1154,970,574,58600,39840
308,226,82,551,56700,39841
2964,1707,1257,627,89600,39842
3061,2156,905,716,76600,39845
755,474,281,438,50600,39846
812,473,339,409,52700,39851
979,755,224,672,69200,39854
393,298,95,439,64000,39859
479,280,199,636,127400,39861
565,401,164,571,72100,39862
216,163,53,565,80300,39866
201,172,29,-,83300,39867
808,555,253,471,79700,39870
150,120,30,700,67200,39877
32,28,4,-,88800,39885
691,476,215,397,84100,39886
1288,977,311,711,68600,39897
861,753,108,1052,164000,40003
11592,8879,2713,686,144700,40004
1870,1478,392,680,111800,40006
55,55,0,-,-,40007
1331,1063,268,712,152400,40008
380,309,71,646,80700,40009
193,132,61,-,349500,40010
965,726,239,761,113300,40011
180,162,18,-,100400,40012
1913,1756,157,726,163300,40013
6925,6067,858,908,271700,40014
1510,849,661,777,118800,40019
71,64,7,-,127800,40020
319,308,11,-,265200,40022
1752,1674,78,1357,291900,40023
19,19,0,-,875000,40025
1918,1753,165,1250,286000,40026
7473,5815,1658,761,214300,40031
5073,3566,1507,612,101200,40033
75,41,34,-,-,40036
980,839,141,625,110000,40037
133,112,21,675,115000,40040
248,51,197,950,-,40041
1530,1092,438,763,95600,40045
690,660,30,-,159500,40046
7710,6660,1050,768,167900,40047
0,0,0,-,-,40048
0,0,0,-,-,40049
591,319,272,694,113200,40050
1801,1338,463,611,116700,40051
206,154,52,-,116700,40052
825,594,231,973,173900,40055
1341,1250,91,1088,170700,40056
1414,967,447,732,115400,40057
39,23,16,-,105400,40058
6837,6247,590,1597,396500,40059
416,308,108,633,137900,40060
111,102,9,-,86200,40062
0,0,0,-,-,40063
11147,6974,4173,821,172200,40065
1868,1421,447,843,250700,40067
884,740,144,719,156400,40068
3136,2288,848,577,105800,40069
152,152,0,-,166200,40070
5709,4594,1115,619,187100,40071
528,375,153,689,132200,40075
915,812,103,921,159800,40076
132,123,9,-,167700,40077
955,808,147,588,87900,40078
468,377,91,945,90500,40104
797,650,147,844,155500,40107
4592,3567,1025,713,151000,40108
745,686,59,1018,154500,40109
8,0,8,-,-,40110
598,447,151,245,70900,40111
228,224,4,-,116000,40115
935,693,242,750,121700,40117
3393,2371,1022,801,98600,40118
755,665,90,678,104700,40119
2425,0,2425,1137,-,40121
190,130,60,279,105600,40140
906,754,152,772,122100,40142
2277,1679,598,544,97700,40143
664,539,125,537,124900,40144
280,238,42,-,102500,40145
1444,1007,437,645,83400,40146
1466,1088,378,758,133200,40150
375,367,8,-,129200,40152
449,181,268,619,67400,40155
279,236,43,-,87800,40157
9131,4788,4343,724,122700,40160
64,28,36,-,-,40161
2177,1738,439,752,192300,40162
12994,10086,2908,781,162600,40165
154,123,31,-,97900,40170
156,147,9,-,63100,40171
5463,4191,1272,838,142400,40175
372,357,15,-,89900,40176
528,379,149,730,88600,40177
153,104,49,-,96700,40178
2689,160,2529,315,262500,40202
9048,1289,7759,488,80700,40203
7175,3258,3917,827,183300,40204
10530,7676,2854,844,259800,40205
9704,4918,4786,781,194800,40206
13805,9688,4117,992,282000,40207
6411,1484,4927,732,84000,40208
105,16,89,864,-,40209
5364,2074,3290,590,59200,40210
8787,3725,5062,732,65900,40211
6584,2849,3735,715,61100,40212
6955,4266,2689,758,103500,40213
17783,9045,8738,727,124900,40214
7881,3373,4508,782,77600,40215
16821,10665,6156,701,110300,40216
5924,3643,2281,760,136900,40217
13453,6698,6755,762,130200,40218
15395,8681,6714,723,124600,40219
14463,9048,5415,870,168200,40220
9899,5750,4149,902,254200,40222
9277,6752,2525,1034,253000,40223
6372,5418,954,813,151500,40228
13975,10632,3343,936,126100,40229
0,0,0,-,-,40231
12363,8652,3711,1101,248300,40241
4778,3321,1457,998,188700,40242
4741,3323,1418,1025,198100,40243
11903,10104,1799,1205,322500,40245
10488,7787,2701,843,121100,40258
14037,10719,3318,892,117200,40272
138,37,101,1053,406300,40280
14493,11106,3387,908,168600,40291
15733,12362,3371,900,192400,40299
186,125,61,623,72200,40310
2828,1987,841,589,85300,40311
2172,1378,794,618,82200,40312
1255,592,663,624,81300,40313
169,169,0,-,71700,40316
1140,884,256,534,75900,40322
17251,11845,5406,817,169600,40324
450,390,60,720,102400,40328
7819,5609,2210,610,138900,40330
0,0,0,-,-,40334
4985,3475,1510,575,74200,40336
1903,1558,345,596,96100,40337
0,0,0,-,-,40339
8421,6388,2033,710,138400,40342
323,292,31,-,-,40346
1029,739,290,857,192200,40347
230,118,112,519,80000,40348
32,32,0,-,110000,40350
7539,4643,2896,624,129500,40351
8475,5402,3073,675,125400,40353
16053,10047,6006,817,165300,40356
367,345,22,-,99100,40358
2540,1747,793,568,99300,40359
2380,1627,753,613,78200,40360
7475,4640,2835,730,146500,40361
0,0,0,-,-,40363
1079,941,138,622,190600,40370
1241,987,254,616,73300,40371
903,688,215,754,150400,40372
704,489,215,651,94500,40374
17,17,0,-,-,40376
1399,957,442,728,144000,40379
2635,1899,736,676,81400,40380
9016,6463,2553,740,191900,40383
1121,847,274,750,81800,40385
896,743,153,583,81800,40387
2199,1175,1024,706,149500,40390
14061,9204,4857,700,138700,40391
1078,742,336,593,64900,40402
9282,6339,2943,682,130600,40403
0,0,0,-,-,40404
1459,1013,446,610,77700,40409
1553,1267,286,441,86400,40419
9069,5776,3293,667,153000,40422
43,0,43,-,-,40434
2056,1712,344,601,99100,40437
841,608,233,724,84100,40440
606,406,200,530,75000,40442
5848,4488,1360,667,136200,40444
338,257,81,478,80100,40445
3253,2373,880,505,66400,40447
32,15,17,-,-,40448
3881,2933,948,526,92400,40456
432,350,82,814,47900,40460
1310,936,374,738,152400,40461
525,519,6,-,91700,40464
755,507,248,570,102300,40468
706,537,169,706,54700,40472
22697,12516,10181,672,160400,40475
87,63,24,-,119000,40481
4566,3183,1383,609,103300,40484
989,887,102,341,103700,40486
1588,1279,309,779,85100,40489
12421,7053,5368,817,322800,40502
12293,8013,4280,910,174300,40503
11065,3860,7205,690,138900,40504
11237,6397,4840,663,112500,40505
0,0,0,-,-,40506
1340,246,1094,605,305200,40507
9406,2142,7264,716,114500,40508
15647,9506,6141,926,229600,40509
351,279,72,867,387100,40510
12288,7592,4696,870,143900,40511
4292,3393,899,1115,324100,40513
5790,4865,925,1196,194600,40514
14390,9044,5346,973,210300,40515
1243,858,385,926,167200,40516
16050,5890,10160,834,130600,40517
21092,13341,7751,726,139700,40601
0,0,0,-,-,40604
11921,7595,4326,575,102900,40701
2136,1654,482,664,71100,40729
1378,878,500,465,62200,40734
326,231,95,-,-,40737
1130,874,256,523,91400,40740
8854,5799,3055,617,112800,40741
49,49,0,-,-,40743
6911,5057,1854,669,110600,40744
925,871,54,-,75600,40759
172,119,53,489,24000,40763
5959,3865,2094,600,71000,40769
506,374,132,447,55800,40771
199,176,23,-,51300,40801
934,600,334,614,59800,40806
171,143,28,680,49600,40807
18,18,0,-,65000,40808
485,345,140,384,38500,40810
257,219,38,-,50500,40813
551,408,143,833,49600,40815
14,0,14,-,-,40816
20,13,7,-,-,40818
249,228,21,-,66900,40819
287,243,44,-,26300,40820
1632,995,637,406,46400,40823
182,73,109,605,-,40824
312,248,64,544,71700,40826
313,247,66,-,81500,40827
1340,969,371,467,53600,40828
120,68,52,-,-,40829
81,73,8,-,40800,40830
2208,1312,896,409,71100,40831
116,95,21,-,51200,40840
113,102,11,-,82000,40843
53,27,26,-,-,40844
278,253,25,-,39300,40845
127,119,8,-,38100,40847
182,141,41,-,71800,40849
422,228,194,485,46000,40854
311,202,109,665,60500,40855
294,261,33,-,44000,40856
156,128,28,-,56500,40858
180,173,7,-,46300,40862
247,205,42,-,31500,40863
178,141,37,-,76000,40865
491,342,149,-,40500,40868
162,135,27,-,-,40870
940,725,215,700,57200,40873
209,161,48,-,29100,40874
443,363,80,-,33500,40902
198,164,34,575,53300,40903
4231,2651,1580,600,77300,40906
136,79,57,533,54500,40913
94,59,35,511,-,40914
303,244,59,529,114800,40915
134,100,34,-,-,40921
261,202,59,-,55400,40923
92,67,25,-,50800,40927
1149,896,253,651,63700,40935
125,91,34,-,52200,40939
180,159,21,-,-,40940
153,56,97,564,60500,40941
272,190,82,-,82100,40943
80,68,12,-,-,40946
400,263,137,604,99800,40949
279,156,123,546,77100,40953
161,104,57,-,44200,40958
6667,4796,1871,504,56000,40962
20,8,12,-,-,40964
5417,2999,2418,534,80400,40965
536,412,124,100-,37700,40972
3784,2657,1127,411,51500,40977
25,25,0,-,-,40979
153,125,28,-,36500,40982
140,108,32,-,100800,40983
222,131,91,-,-,40988
52,52,0,-,29600,40995
144,96,48,1060,-,40997
6096,5346,750,863,178200,41001
932,665,267,557,113900,41002
922,649,273,665,96600,41003
1755,1246,509,609,101500,41004
8511,6466,2045,956,181400,41005
1507,1161,346,733,110900,41006
1538,1302,236,693,192300,41007
2546,1566,980,592,124300,41008
1303,1082,221,675,117600,41010
11967,5041,6926,686,162900,41011
2821,1267,1554,719,79900,41014
8042,5453,2589,700,115300,41015
2502,1507,995,761,94100,41016
14822,10895,3927,775,192500,41017
10414,6627,3787,871,116200,41018
2165,1404,761,787,124600,41030
6049,4140,1909,585,132700,41031
621,595,26,-,155500,41033
400,317,83,578,112800,41034
3796,2718,1078,678,119300,41035
1100,781,319,530,81700,41039
2793,1955,838,682,92000,41040
3043,1968,1075,531,113300,41041
20394,13158,7236,889,147300,41042
696,570,126,682,152200,41043
377,314,63,735,104400,41044
582,436,146,781,113200,41045
395,331,64,671,85200,41046
4850,4030,820,1150,215700,41048
883,672,211,660,95300,41049
9839,8202,1637,959,162600,41051
38,38,0,-,-,41052
724,601,123,620,117300,41055
5508,3574,1934,585,108900,41056
928,813,115,781,169000,41059
9,9,0,-,-,41062
1153,1051,102,706,163100,41063
829,589,240,469,89400,41064
8558,3914,4644,730,116200,41071
2515,1764,751,830,120600,41073
2050,1221,829,789,97000,41074
6606,4492,2114,791,212800,41075
7244,5625,1619,927,161200,41076
800,647,153,945,252700,41080
550,406,144,521,94100,41083
288,178,110,839,81700,41085
996,833,163,667,99800,41086
6560,6007,553,1703,249200,41091
1228,1068,160,810,169900,41092
1016,877,139,505,68800,41093
5174,3794,1380,929,196000,41094
1209,672,537,677,114600,41095
2447,1533,914,732,116300,41097
801,606,195,689,85800,41098
0,0,0,-,-,41099
7782,4826,2956,623,89300,41101
7962,5829,2133,681,116300,41102
477,456,21,-,110400,41121
467,323,144,439,84100,41124
3881,3053,828,584,119200,41129
160,152,8,-,60900,41132
57,46,11,-,82000,41135
3268,2239,1029,730,92600,41139
750,637,113,638,53000,41141
34,34,0,-,-,41142
5398,4074,1324,565,93200,41143
3795,3090,705,612,93500,41144
177,75,102,720,-,41146
234,204,30,233,53100,41149
206,139,67,331,42400,41159
5219,4165,1054,585,74900,41164
514,399,115,635,87200,41166
964,913,51,-,79600,41168
2197,1566,631,650,136200,41169
1507,1142,365,460,84700,41171
480,277,203,486,85500,41174
2091,1580,511,687,94000,41175
3247,2314,933,370,73200,41179
492,409,83,564,56100,41180
609,537,72,717,99200,41183
852,660,192,679,65000,41189
81,81,0,-,155300,41201
373,243,130,-,69800,41203
199,166,33,-,-,41204
160,148,12,-,46100,41214
404,310,94,629,107500,41216
746,643,103,584,55400,41219
932,821,111,762,82400,41222
2119,1478,641,467,96000,41224
109,109,0,-,75300,41226
4614,3570,1044,547,80000,41230
361,172,189,651,64500,41231
273,197,76,700,68700,41232
215,191,24,-,78300,41234
265,229,36,-,93200,41238
2566,1434,1132,606,106000,41240
464,361,103,367,43400,41250
178,136,42,-,106600,41254
435,317,118,505,102100,41255
1022,854,168,681,87100,41256
182,131,51,629,102700,41257
320,128,192,362,114700,41260
426,369,57,-,66000,41262
170,108,62,656,101400,41263
165,105,60,-,106000,41264
652,528,124,822,86600,41265
287,230,57,391,34300,41267
292,225,67,630,65000,41268
108,100,8,-,78300,41271
230,121,109,344,-,41274
2507,1629,878,499,61100,41301
2697,1959,738,550,66400,41311
1790,1335,455,349,63600,41314
22,22,0,-,53300,41317
399,297,102,655,77500,41332
4345,3102,1243,476,51800,41339
510,405,105,414,33500,41348
289,218,71,517,74200,41352
139,102,37,-,52800,41360
180,142,38,489,68600,41365
19,19,0,-,-,41366
56,31,25,-,92500,41367
164,143,21,-,70700,41385
14,4,10,-,-,41390
11,11,0,-,-,41397
154,120,34,637,84000,41408
174,93,81,-,-,41421
453,359,94,563,80700,41425
244,178,66,-,42200,41464
4584,3146,1438,562,66500,41465
3751,2769,982,564,77400,41472
9615,5939,3676,672,104600,41501
263,175,88,611,122500,41503
353,239,114,671,108000,41512
158,123,35,-,62000,41513
1327,765,562,695,68300,41514
45,45,0,-,-,41517
589,510,79,-,93300,41519
2186,1821,365,517,58400,41522
82,82,0,-,-,41524
19,19,0,-,-,41526
373,277,96,682,138000,41527
413,332,81,-,68400,41528
373,337,36,-,74400,41531
121,106,15,-,-,41534
203,173,30,-,93100,41535
2071,1481,590,392,64400,41537
16,16,0,-,-,41538
635,515,120,662,80100,41539
113,85,28,-,54000,41540
131,95,36,-,131500,41543
352,294,58,636,59100,41544
195,147,48,-,-,41547
382,274,108,422,62900,41548
812,778,34,-,67700,41553
415,319,96,568,67300,41554
310,219,91,-,70600,41555
726,602,124,657,92400,41557
318,268,50,-,32800,41558
85,70,15,-,52200,41559
146,113,33,-,-,41560
1128,804,324,590,66600,41562
162,119,43,-,47700,41563
349,305,44,555,90500,41564
345,316,29,-,45500,41566
100,91,9,-,-,41567
415,350,65,-,-,41568
228,197,31,-,35600,41571
1587,1284,303,667,89900,41572
328,261,67,642,-,41601
345,272,73,-,74100,41602
554,390,164,762,60400,41603
220,180,40,-,76000,41604
325,325,0,-,101900,41605
362,285,77,-,44300,41606
228,204,24,714,-,41607
33,24,9,-,26700,41612
261,197,64,-,52800,41615
276,199,77,-,66000,41616
137,130,7,-,103200,41619
131,88,43,-,97100,41621
112,74,38,-,119100,41622
537,385,152,645,77200,41630
514,394,120,527,85800,41631
229,151,78,-,-,41632
1084,723,361,681,91700,41635
376,246,130,666,58700,41636
409,327,82,721,46800,41640
316,181,135,585,87600,41642
29,29,0,-,-,41643
587,444,143,360,42900,41645
531,362,169,535,75100,41647
1037,637,400,539,66900,41649
171,143,28,-,40400,41650
4405,2782,1623,515,98100,41653
370,280,90,-,56200,41655
169,146,23,-,56300,41659
224,189,35,-,89900,41660
195,181,14,-,-,41663
387,204,183,694,61000,41666
229,193,36,-,37400,41667
238,171,67,564,42000,41669
6893,4865,2028,546,78600,41701
111,111,0,-,-,41712
50,50,0,-,-,41713
113,113,0,-,48200,41714
356,315,41,-,-,41719
207,163,44,722,34000,41721
574,481,93,686,55900,41722
591,533,58,-,70300,41723
70,58,12,-,55900,41725
270,234,36,-,58900,41727
16,0,16,-,-,41729
408,359,49,450,60700,41731
61,37,24,-,-,41735
45,36,9,-,-,41739
431,343,88,525,67700,41740
131,121,10,-,-,41745
202,142,60,-,81300,41746
1418,1145,273,474,56800,41749
150,138,12,-,64300,41751
116,100,16,-,126100,41754
111,80,31,-,77500,41759
3,3,0,-,-,41760
19,19,0,-,-,41762
275,173,102,536,47500,41763
298,245,53,-,47300,41764
59,59,0,-,61300,41766
54,39,15,-,27000,41772
608,474,134,625,44900,41773
926,668,258,575,71100,41774
9,6,3,-,-,41775
435,335,100,477,45000,41776
398,279,119,-,49100,41777
248,217,31,469,101900,41804
186,159,27,-,58600,41810
144,134,10,-,65900,41812
350,298,52,-,51500,41815
79,51,28,-,-,41817
162,110,52,-,51400,41819
281,245,36,-,42900,41821
853,573,280,383,47800,41822
478,309,169,541,27400,41824
264,122,142,-,52900,41825
310,310,0,-,61900,41826
348,290,58,-,66700,41828
418,369,49,470,76000,41831
123,102,21,-,86400,41832
229,120,109,-,52000,41833
156,156,0,-,73100,41834
391,312,79,-,59200,41835
379,231,148,586,51600,41836
494,387,107,680,69900,41837
219,205,14,-,45700,41838
589,389,200,603,50100,41839
420,283,137,577,46000,41840
339,254,85,-,39300,41843
423,225,198,328,41400,41844
86,60,26,-,-,41845
237,221,16,-,30800,41847
0,0,0,-,-,41848
37,37,0,-,51600,41849
257,187,70,-,-,41855
3474,2488,986,576,72300,41858
182,135,47,-,66900,41859
42,24,18,-,"10,000-",41861
325,290,35,446,53100,41862
12440,8158,4282,689,152700,42001
11820,7626,4194,613,107000,42003
849,813,36,-,121300,42020
626,430,196,613,75300,42021
87,87,0,-,-,42022
963,764,199,649,86000,42023
552,388,164,567,97800,42024
8160,6413,1747,614,121200,42025
815,734,81,-,152300,42027
251,245,6,-,101700,42028
2468,1964,504,659,107900,42029
1114,912,202,511,62500,42031
86,66,20,725,55000,42032
387,342,45,661,98000,42035
578,546,32,481,93800,42036
29,23,6,-,-,42037
2149,1667,482,470,131000,42038
693,619,74,316,94500,42039
332,293,39,830,152800,42040
1933,1244,689,507,70200,42041
1518,1241,277,681,138900,42044
962,674,288,708,98600,42045
164,89,75,-,-,42047
793,616,177,913,102000,42048
613,497,116,497,109900,42049
1129,718,411,457,47200,42050
1263,1095,168,637,77400,42051
2109,1893,216,789,123100,42053
260,253,7,-,153800,42054
1113,1036,77,483,99900,42055
784,575,209,559,114300,42056
877,705,172,880,107600,42058
10,10,0,-,-,42060
36,36,0,-,-,42061
3322,2707,615,503,85400,42064
9238,6170,3068,629,97000,42066
194,187,7,-,79700,42069
11830,6748,5082,656,134400,42071
533,439,94,462,96300,42076
766,591,175,333,72900,42078
564,542,22,-,103100,42079
983,700,283,467,87600,42081
636,497,139,596,128000,42082
113,72,41,-,-,42083
58,14,44,611,-,42084
366,326,40,425,75000,42085
1740,1208,532,588,137700,42086
851,664,187,667,77600,42087
913,765,148,720,83300,42088
21397,10489,10908,718,113700,42101
19,9,10,-,-,42102
8277,5482,2795,776,204900,42103
13122,8179,4943,762,172400,42104
960,646,314,544,77800,42120
1701,1547,154,921,196800,42122
276,237,39,625,83400,42123
0,0,0,-,-,42124
2594,1701,893,567,98300,42127
2774,2052,722,488,77200,42129
80,55,25,-,-,42130
636,518,118,576,100000,42133
6603,4035,2568,734,129200,42134
425,334,91,605,76100,42140
12258,7932,4326,669,116300,42141
78,58,20,-,-,42151
118,75,43,799,-,42153
196,156,40,655,108600,42154
98,81,17,-,97300,42156
131,97,34,559,64600,42157
501,454,47,-,138500,42159
655,506,149,884,75100,42160
37,0,37,-,-,42163
6328,4563,1765,659,107000,42164
992,830,162,605,74700,42166
3380,2421,959,503,76200,42167
544,481,63,706,124800,42170
2706,2081,625,700,107900,42171
899,622,277,629,96900,42202
182,123,59,833,112500,42204
2098,1580,518,676,113000,42206
606,509,97,578,67900,42207
1778,1422,356,590,84600,42210
5566,4573,993,602,121300,42211
176,137,39,586,145500,42214
438,378,60,652,114100,42215
1328,1023,305,693,82900,42217
2517,1898,619,556,92500,42220
4376,16,4360,1245,-,42223
265,243,22,-,116400,42232
989,580,409,585,107900,42234
293,238,55,829,106900,42236
16540,8923,7617,671,115800,42240
95,61,34,675,68500,42254
1744,1423,321,633,84100,42256
410,363,47,525,90700,42259
4254,3065,1189,608,88900,42261
2969,802,2167,849,109000,42262
381,300,81,534,-,42265
819,593,226,543,133300,42266
216,179,37,635,109600,42273
911,731,180,663,141200,42274
278,154,124,780,76400,42275
6115,3818,2297,573,106900,42276
137,109,28,-,-,42280
112,90,22,-,78500,42285
503,304,199,763,115500,42286
18037,11021,7016,713,120500,42301
15710,10644,5066,673,119900,42303
3280,2255,1025,521,88900,42320
87,78,9,-,52200,42321
26,26,0,-,-,42322
332,255,77,754,78500,42323
417,375,42,186,75800,42324
822,676,146,569,79400,42325
173,173,0,-,87200,42326
1450,1199,251,589,115400,42327
538,476,62,646,80700,42328
3260,2280,980,520,74200,42330
38,38,0,-,72800,42332
452,336,116,-,98900,42333
800,682,118,479,57400,42337
11,11,0,-,-,42338
320,304,16,-,69200,42339
662,504,158,484,84000,42343
428,335,93,-,-,42344
4106,3144,962,535,108300,42345
2351,1788,563,490,98300,42347
1972,1511,461,582,122400,42348
502,433,69,571,59500,42349
602,498,104,496,83700,42350
1576,1215,361,607,106700,42351
923,716,207,579,86600,42352
97,69,28,529,70300,42354
752,700,52,725,109500,42355
0,0,0,-,-,42356
201,170,31,-,81900,42361
2161,1931,230,863,160400,42366
287,224,63,636,77400,42367
440,404,36,-,89200,42368
90,70,20,658,39200,42369
0,0,0,-,-,42370
213,202,11,-,107100,42371
692,579,113,535,101300,42372
145,133,12,-,-,42374
2267,1870,397,747,110700,42376
1064,881,183,631,132300,42378
998,747,251,613,82100,42404
1407,1121,286,597,101900,42406
2729,1986,743,480,59500,42408
952,781,171,585,84100,42409
549,320,229,711,60000,42410
569,485,84,527,95500,42411
1228,1106,122,1006,142000,42413
15588,9125,6463,642,120500,42420
10679,6936,3743,689,110700,42431
452,368,84,-,137500,42436
3086,2072,1014,615,94100,42437
370,300,70,625,55600,42440
617,472,145,618,98900,42441
1242,971,271,552,93100,42442
4632,3335,1297,552,97100,42445
1633,1080,553,489,54400,42450
326,198,128,-,69400,42451
858,676,182,650,152800,42452
207,154,53,839,43600,42453
1138,770,368,624,90900,42455
645,541,104,435,86900,42456
467,401,66,-,107300,42458
1638,1126,512,521,76700,42459
516,305,211,535,53300,42461
427,358,69,831,99600,42462
33,33,0,-,36900,42463
689,604,85,583,82500,42464
7538,4341,3197,574,87100,42501
9266,6788,2478,653,134300,42503
210,200,10,-,40000,42516
1130,912,218,770,89100,42518
1457,1155,302,592,53800,42519
595,443,152,433,74200,42528
319,188,131,768,92900,42533
3968,3122,846,483,79000,42539
266,260,6,-,-,42541
2353,1811,542,671,101100,42544
1778,1343,435,507,122100,42553
181,117,64,-,65000,42565
243,209,34,-,80400,42566
2382,1662,720,785,72100,42567
4007,2797,1210,536,66700,42602
5,5,0,-,-,42603
2087,1570,517,511,101600,42629
97,33,64,-,-,42631
7751,5617,2134,519,80800,42633
527,414,113,438,61600,42634
1268,932,336,514,63400,42635
21,0,21,-,-,42638
5162,3779,1383,553,81600,42642
1427,1063,364,547,57300,42647
1040,804,236,660,75800,42649
1868,1177,691,659,55200,42653
20074,12592,7482,764,164800,42701
563,451,112,499,111500,42712
648,532,116,495,87500,42713
127,127,0,-,89300,42715
612,538,74,921,96200,42716
2699,1892,807,437,90200,42717
9663,6181,3482,598,108200,42718
1292,1026,266,553,87800,42721
201,189,12,-,99700,42722
1829,1492,337,810,152800,42724
1937,1502,435,602,100500,42726
6134,4601,1533,499,89100,42728
604,384,220,736,118200,42729
49,49,0,-,73400,42731
719,586,133,804,89300,42732
442,327,115,501,85500,42733
771,682,89,798,137300,42740
157,121,36,-,62300,42741
3791,2817,974,526,75400,42743
697,615,82,656,72600,42746
3348,2373,975,692,107100,42748
2099,1400,699,493,93700,42749
287,239,48,418,63200,42753
5752,3906,1846,554,103800,42754
1169,874,295,716,87800,42757
17,10,7,-,-,42758
91,22,69,-,-,42762
193,138,55,473,74500,42764
2527,1858,669,450,91900,42765
984,700,284,619,115200,42776
397,348,49,618,81300,42782
854,571,283,661,95900,42784
80,80,0,-,169300,42788
1052,920,132,1472,195200,43001
1877,1477,400,1192,152500,43002
1023,760,263,754,140400,43003
9558,7152,2406,920,168400,43004
93,67,26,-,-,43005
240,210,30,817,99000,43006
1070,687,383,675,98600,43008
782,648,134,1094,190200,43009
102,71,31,822,86800,43010
2891,2374,517,663,183600,43011
397,361,36,769,153200,43013
1305,864,441,622,142200,43014
19648,13750,5898,906,188700,43015
14587,8194,6393,1134,268500,43016
14678,10166,4512,1142,332400,43017
3423,2761,662,740,134500,43019
3848,3622,226,1252,360100,43021
1135,863,272,772,208400,43022
3899,3331,568,1045,278100,43023
2149,1644,505,654,164400,43025
22972,16689,6283,998,195300,43026
3032,2651,381,919,141900,43028
198,149,49,918,161700,43029
52,52,0,-,-,43030
5035,4016,1019,874,193100,43031
21,11,10,-,-,43032
128,92,36,706,100000,43033
8595,6796,1799,1062,289500,43035
120,66,54,682,82500,43036
119,59,60,760,75000,43037
11671,8447,3224,887,183600,43040
1901,1504,397,773,126600,43044
683,563,120,1020,161100,43045
1413,1089,324,894,175600,43046
11333,7200,4133,717,121800,43050
9445,6741,2704,1232,327500,43054
24590,15010,9580,726,125900,43055
7298,5533,1765,848,141500,43056
954,705,249,808,126000,43060
1531,1377,154,1087,243900,43061
10403,8361,2042,1066,179500,43062
4740,4112,628,865,233200,43064
14871,13266,1605,1106,320000,43065
545,520,25,1055,199300,43066
586,568,18,-,155600,43067
21626,12723,8903,918,139100,43068
53,53,0,-,60400,43070
720,586,134,860,141500,43071
2239,1810,429,665,125400,43072
4352,3567,785,1040,243600,43074
3483,2801,682,857,152000,43076
122,76,46,729,101800,43077
8476,5662,2814,690,124900,43078
1881,1467,414,649,142500,43080
23968,15284,8684,1066,187300,43081
11667,10517,1150,1210,296700,43082
278,249,29,763,122000,43084
10298,7233,3065,1086,238200,43085
113,79,34,617,79200,43101
1631,1255,376,776,164000,43102
3933,3061,872,780,161100,43103
2906,2352,554,981,177200,43105
671,426,245,717,84400,43106
1242,1039,203,878,121900,43107
41,31,10,-,93100,43109
13904,8567,5337,933,162100,43110
140,140,0,-,77000,43111
1616,1403,213,766,236500,43112
9205,6127,3078,770,144000,43113
546,409,137,756,124800,43115
506,449,57,1050,181200,43116
60,33,27,-,-,43117
10133,7204,2929,907,144000,43119
24014,17404,6610,966,155200,43123
5598,3249,2349,944,145300,43125
188,133,55,782,111900,43126
95,57,38,-,106300,43127
884,563,321,694,86300,43128
23404,14968,8436,767,138100,43130
1608,1225,383,563,117000,43135
266,179,87,896,197100,43136
807,654,153,785,124500,43137
7400,5214,2186,576,118300,43138
7667,5112,2555,799,156100,43140
60,29,31,692,63000,43142
2081,1531,550,672,128600,43143
169,120,49,518,49400,43144
755,571,184,814,111800,43145
3091,2691,400,888,181300,43146
13808,11329,2479,1118,199100,43147
832,557,275,712,155500,43148
1004,879,125,777,139900,43149
790,674,116,826,135500,43150
90,70,20,850,86700,43151
328,206,122,612,85300,43152
345,261,84,752,156300,43153
1130,829,301,861,137200,43154
975,801,174,838,146800,43155
59,56,3,625,80000,43156
203,112,91,886,97500,43157
102,102,0,-,58600,43158
9237,5434,3803,708,110300,43160
2539,1880,659,760,136400,43162
732,509,223,846,132900,43164
11877,1974,9903,937,225500,43201
9576,2948,6628,906,193800,43202
3601,1047,2554,683,89400,43203
16545,7787,8758,873,99500,43204
5345,1861,3484,680,116900,43205
9967,4592,5375,911,117300,43206
17589,10019,7570,852,85100,43207
11681,6681,5000,822,228000,43209
338,0,338,599,-,43210
8357,3193,5164,774,53300,43211
10512,4113,6399,961,297900,43212
14334,4964,9370,811,98600,43213
12424,7792,4632,899,228300,43214
8890,1801,7089,1051,252700,43215
760,46,714,901,28800,43217
11319,5379,5940,845,88600,43219
11812,6471,5341,951,296300,43220
13354,9666,3688,1135,263400,43221
1235,362,873,689,48000,43222
8274,3739,4535,759,79600,43223
17068,7732,9336,718,86600,43224
9525,4454,5071,834,78700,43227
21211,9705,11506,824,115100,43228
20689,8399,12290,803,122100,43229
22986,14735,8251,1052,173700,43230
7885,4062,3823,936,133900,43231
18032,7259,10773,771,94600,43232
17621,9836,7785,1055,224800,43235
1896,749,1147,1155,200500,43240
20320,13176,7144,704,86900,43302
1191,1011,180,886,123100,43310
7576,4995,2581,748,121100,43311
1096,971,125,855,150600,43314
2514,2012,502,709,135200,43315
2430,1814,616,623,114300,43316
36,30,6,675,85000,43317
1537,1180,357,747,132600,43318
371,371,0,-,160500,43319
691,537,154,679,117700,43320
99,86,13,850,110900,43321
132,105,27,692,77500,43322
306,247,59,764,114100,43323
1274,1073,201,831,162400,43324
5233,3646,1587,601,93800,43326
63,40,23,603,68900,43330
2190,1762,428,666,89200,43331
730,506,224,818,92400,43332
249,213,36,-,110400,43333
2262,1870,392,759,150300,43334
0,0,0,-,-,43336
414,401,13,858,97900,43337
3838,3032,806,542,145200,43338
627,502,125,736,121800,43340
453,361,92,921,93800,43341
1147,1032,115,844,127200,43342
523,374,149,491,127800,43343
2180,1751,429,766,133400,43344
292,243,49,763,129800,43345
572,500,72,729,136800,43347
848,542,306,558,89700,43348
4248,2772,1476,630,112000,43351
512,438,74,779,136700,43356
1587,1298,289,585,156700,43357
1030,853,177,830,121100,43358
325,281,44,625,108800,43359
691,557,134,742,181100,43360
13466,6219,7247,689,173200,43402
9,0,9,-,-,43403
735,543,192,853,99800,43406
274,270,4,-,114200,43407
121,116,5,688,83600,43408
4051,2950,1101,713,112000,43410
1815,1500,315,726,156500,43412
555,484,71,760,104800,43413
1204,937,267,655,138200,43416
12471,8424,4047,657,108600,43420
1718,1365,353,733,117000,43430
1725,1331,394,731,109900,43431
540,524,16,-,136300,43432
18,18,0,-,-,43433
21,16,5,1083,70000,43434
500,448,52,600,121400,43435
190,120,70,864,112500,43437
104,97,7,-,292700,43438
17,17,0,-,-,43439
2506,2048,458,780,173900,43440
457,342,115,857,113200,43442
756,627,129,694,151600,43443
430,406,24,-,136500,43445
45,45,0,-,234100,43446
1298,1156,142,758,131600,43447
3285,2465,820,757,129600,43449
1355,1048,307,809,162000,43450
422,307,115,781,141100,43451
6201,4585,1616,651,154700,43452
214,182,32,735,408300,43456
539,419,120,584,100600,43457
157,126,31,525,87600,43458
2634,1904,730,677,134500,43460
493,380,113,856,104100,43462
17,8,9,-,-,43463
415,328,87,625,97100,43464
2476,1850,626,726,101400,43465
794,592,202,835,106800,43466
32,23,9,-,67500,43467
106,88,18,-,92700,43468
1162,871,291,667,139700,43469
324,239,85,642,100800,43501
2520,1830,690,624,138000,43502
478,448,30,744,157300,43504
37,28,9,558,80000,43505
6187,4563,1624,689,97500,43506
399,372,27,665,128000,43511
11304,8295,3009,720,113300,43512
3304,2843,461,638,135900,43515
1082,830,252,795,96000,43516
1614,1325,289,607,110000,43517
1012,867,145,721,104300,43518
96,70,26,-,66700,43519
1176,845,331,617,83000,43521
1193,1053,140,773,161400,43522
0,0,0,-,-,43523
502,413,89,578,96900,43524
438,379,59,1125,164400,43525
2305,1881,424,599,107700,43526
763,637,126,633,92500,43527
6323,4643,1680,868,179100,43528
111,83,28,770,46900,43529
135,60,75,574,105000,43531
1552,1363,189,691,136400,43532
624,520,104,641,126300,43533
707,585,122,647,89200,43534
309,282,27,796,119500,43535
110,110,0,-,-,43536
11206,8056,3150,781,168300,43537
535,408,127,539,121100,43540
64,59,5,-,86100,43541
1340,1250,90,-,263800,43542
3301,2684,617,641,86100,43543
5904,4292,1612,654,122400,43545
95,80,15,-,187500,43547
257,230,27,807,105000,43548
537,432,105,597,109900,43549
15565,10541,5024,914,195200,43551
57,49,8,-,114200,43553
1020,704,316,740,93100,43554
82,73,9,-,99500,43555
664,562,102,633,103700,43556
926,788,138,703,125300,43557
5199,4491,708,772,145700,43558
11891,9422,2469,831,185200,43560
175,130,45,839,132400,43565
2902,2434,468,1097,183600,43566
5014,3482,1532,742,136600,43567
1104,914,190,750,111800,43569
1314,992,322,621,96100,43570
2704,2344,360,772,206300,43571
4371,669,3702,386,32000,43604
10219,4531,5688,641,40600,43605
10182,5308,4874,722,120700,43606
9248,4533,4715,676,54700,43607
4995,2792,2203,725,41400,43608
8891,3808,5083,658,47200,43609
1843,970,873,687,49300,43610
7942,5043,2899,676,82100,43611
11743,6590,5153,727,67000,43612
13790,8902,4888,736,91100,43613
14268,8128,6140,690,115500,43614
18040,9716,8324,780,102900,43615
8549,5922,2627,622,136800,43616
2710,2280,430,862,202600,43617
3050,2351,699,815,129800,43619
2565,699,1866,504,83000,43620
9201,5624,3577,677,120600,43623
23159,14461,8698,664,107700,43701
26,0,26,-,-,43711
2734,2226,508,490,102600,43713
794,664,130,575,106600,43716
102,87,15,658,68000,43717
1272,1051,221,546,111400,43718
1065,829,236,610,93700,43719
523,431,92,735,111100,43720
0,0,0,-,-,43721
100,100,0,-,65600,43722
2017,1244,773,576,81500,43723
2865,2317,548,631,89700,43724
8432,5593,2839,625,107000,43725
388,351,37,-,96400,43727
510,359,151,601,65300,43728
869,800,69,525,88300,43730
2095,1494,601,570,74100,43731
666,575,91,388,104800,43732
0,0,0,-,-,43733
678,506,172,721,106000,43734
178,97,81,630,72200,43735
31,27,4,-,-,43736
38,22,16,621,60000,43738
835,720,115,681,154300,43739
117,88,29,805,100000,43740
504,413,91,-,131700,43746
347,263,84,938,79000,43747
931,708,223,584,98200,43748
1016,855,161,-,101600,43749
83,83,0,-,-,43750
617,467,150,633,133100,43754
727,578,149,1038,99000,43755
2248,1534,714,566,92700,43756
1204,989,215,632,89500,43758
25,16,9,571,33800,43759
801,606,195,825,158700,43760
22,22,0,-,-,43761
1754,1294,460,664,151700,43762
3204,2006,1198,615,88400,43764
602,440,162,617,69600,43766
430,412,18,-,137800,43767
131,86,45,904,88800,43768
614,526,88,715,85400,43771
652,541,111,650,75600,43772
1350,1126,224,607,105200,43773
1790,1376,414,519,79500,43777
413,363,50,654,112600,43778
409,355,54,850,98300,43779
790,706,84,658,122800,43780
262,208,54,756,55700,43782
1863,1529,334,631,148500,43783
18,13,5,-,71700,43786
1163,973,190,526,94100,43787
269,222,47,549,128100,43788
2304,1664,640,577,82500,43793
383,339,44,-,125700,43802
936,677,259,602,183700,43804
55,20,35,-,-,43805
336,259,77,502,82900,43811
7705,5330,2375,576,87500,43812
1523,1268,255,633,120000,43821
1758,1380,378,731,115900,43822
1392,1123,269,630,151100,43824
2360,1732,628,637,156800,43830
2877,2102,775,714,91300,43832
58,52,6,525,69000,43836
668,550,118,678,99000,43837
484,413,71,922,142400,43840
142,122,20,-,71300,43842
579,532,47,-,156700,43843
1488,1246,242,690,111900,43844
1877,1489,388,588,88000,43845
880,691,189,848,83700,43901
31,13,18,-,-,43902
868,700,168,513,102800,43903
91,54,37,-,-,43905
3572,2486,1086,621,86000,43906
2406,1864,542,613,93100,43907
619,459,160,784,79800,43908
1228,1117,111,790,126800,43910
2756,1914,842,524,81700,43912
721,387,334,483,69300,43913
39,39,0,-,99300,43914
545,498,47,579,103800,43915
1294,1186,108,658,74500,43917
9257,6084,3173,614,80500,43920
155,48,107,551,-,43925
121,82,39,513,60000,43926
41,32,9,-,60000,43927
0,0,0,-,-,43928
360,269,91,905,79000,43930
128,102,26,-,-,43931
336,292,44,613,62000,43932
829,669,160,600,91800,43933
218,198,20,-,71200,43934
3685,2566,1119,538,79300,43935
2211,1808,403,578,74800,43938
209,187,22,988,68900,43939
104,96,8,-,-,43940
1211,985,226,536,90400,43942
1251,1020,231,567,87100,43943
851,721,130,546,101800,43944
1235,917,318,592,96800,43945
826,707,119,563,116200,43946
2139,1723,416,634,94900,43947
204,155,49,511,65000,43948
5371,4211,1160,734,143000,43950
40,40,0,-,-,43951
7300,3898,3402,596,83500,43952
4802,3211,1591,713,116200,43953
170,102,68,675,54600,43961
32,28,4,-,80000,43962
569,369,200,607,81700,43963
3876,2815,1061,583,90000,43964
0,0,0,-,-,43967
2659,1852,807,467,73500,43968
21,21,0,-,-,43970
529,303,226,550,79500,43971
65,65,0,-,-,43972
843,654,189,574,91500,43973
37,36,1,-,80000,43974
678,560,118,681,87900,43976
838,651,187,783,75700,43977
273,147,126,912,57800,43983
44,33,11,-,71700,43985
788,610,178,664,87900,43986
993,759,234,644,82700,43988
8342,7099,1243,896,148000,44001
1766,1331,435,508,89700,44003
13520,8017,5503,663,88300,44004
639,443,196,-,153700,44010
7866,6401,1465,1199,265800,44011
9288,7492,1796,1256,229300,44012
7174,4901,2273,765,130100,44017
2223,1728,495,839,171600,44021
6861,5904,957,1361,346500,44022
6511,5953,558,1215,289300,44023
9171,7597,1574,735,220700,44024
4437,4148,289,1082,221700,44026
3282,2971,311,957,192400,44028
5947,4209,1738,608,95000,44030
644,601,43,832,100600,44032
26968,16574,10394,727,102500,44035
12417,10615,1802,1075,164900,44039
1181,1138,43,1339,431700,44040
6102,4356,1746,632,112900,44041
4252,3651,601,926,169100,44044
152,80,72,945,124000,44045
748,642,106,684,179500,44046
3256,2718,538,583,124700,44047
868,651,217,505,104400,44048
99,74,25,721,91000,44049
2431,2077,354,743,165200,44050
11607,6160,5447,667,74700,44052
7844,5164,2680,671,129100,44053
4822,3716,1106,951,124000,44054
7501,3939,3562,692,65000,44055
4563,4215,348,786,203000,44056
7388,5522,1866,882,130300,44057
25266,21119,4147,908,166900,44060
4095,3043,1052,689,170300,44062
669,605,64,690,193000,44064
1735,1380,355,879,206000,44065
8079,6679,1400,976,184000,44067
13134,9653,3481,874,147600,44070
1822,1639,183,924,278300,44072
3890,2609,1281,781,169900,44074
1723,1158,565,672,132300,44076
21828,15729,6099,834,156500,44077
70,27,43,-,-,44080
2604,2311,293,911,170100,44081
613,489,124,637,154500,44082
1191,1055,136,838,137600,44084
1277,1132,145,861,124400,44085
964,857,107,758,181700,44086
8315,6011,2304,1070,206100,44087
6631,4862,1769,866,142500,44089
4611,3383,1228,703,159000,44090
7631,5433,2198,798,122900,44092
434,410,24,-,105800,44093
16256,10414,5842,888,176700,44094
14057,10446,3611,825,120800,44095
648,623,25,-,168600,44099
0,0,0,-,-,44101
18777,6309,12468,695,63100,44102
7096,2210,4886,582,51600,44103
8906,2450,6456,437,45600,44104
15476,7642,7834,698,49200,44105
11068,3323,7745,736,154200,44106
24622,10947,13675,740,140500,44107
9510,4347,5163,662,56400,44108
17198,7966,9232,694,74500,44109
9107,3463,5644,632,50500,44110
17413,9878,7535,716,84700,44111
10006,3967,6039,619,59800,44112
9161,2277,6884,830,168500,44113
3787,259,3528,811,77600,44114
3662,280,3382,537,84500,44115
9002,6461,2541,858,223000,44116
4922,2048,2874,647,89400,44117
15409,9155,6254,903,145700,44118
5470,2979,2491,735,77600,44119
16085,7014,9071,732,92100,44120
13855,9002,4853,869,96800,44121
13394,8654,4740,1174,228700,44122
8029,4302,3727,756,78200,44123
17296,11508,5788,919,151700,44124
11442,7736,3706,884,74500,44125
7183,5223,1960,739,148200,44126
2006,658,1348,636,30500,44127
12701,6786,5915,816,67300,44128
11771,8214,3557,796,102600,44129
21997,13895,8102,775,125600,44130
8225,7585,640,1074,174700,44131
6725,3013,3712,825,81600,44132
12772,9255,3517,863,195700,44133
15842,12354,3488,840,107800,44134
11806,7208,4598,695,77700,44135
10473,7654,2819,936,196100,44136
9385,5760,3625,903,68800,44137
9236,7335,1901,958,155300,44138
8762,7258,1504,1187,273300,44139
6062,5571,491,991,218800,44140
5546,4686,860,1462,256400,44141
7603,5854,1749,906,112200,44142
10775,7715,3060,789,186200,44143
9737,5850,3887,709,89500,44144
13751,10125,3626,1095,241900,44145
13534,7641,5893,785,100700,44146
7587,6255,1332,840,224500,44147
7417,6820,597,1092,198400,44149
2583,2061,522,832,166700,44201
7805,6476,1329,1439,235200,44202
16515,11489,5026,730,104800,44203
16927,13419,3508,854,169000,44212
851,688,163,591,166500,44214
878,753,125,913,146000,44215
3464,3145,319,788,155600,44216
1480,1199,281,758,124400,44217
13192,7477,5715,809,111700,44221
7486,5753,1733,787,146300,44223
16269,10952,5317,957,170400,44224
3444,2961,483,756,146200,44230
3643,3101,542,719,142100,44231
2910,2910,0,-,307300,44233
1294,1110,184,771,185100,44234
580,512,68,100-,199100,44235
9122,7917,1205,2035,316600,44236
15905,7786,8119,801,149000,44240
7039,4893,2146,992,141100,44241
0,0,0,-,-,44243
443,356,87,853,108300,44250
377,330,47,1098,224100,44251
1075,989,86,968,199500,44253
1983,1388,595,590,140600,44254
3120,2477,643,801,142800,44255
23713,18508,5205,903,201200,44256
5098,4058,1040,802,152300,44260
2002,1514,488,684,153300,44262
1123,894,229,960,238700,44264
0,0,0,-,-,44265
13392,9215,4177,740,117600,44266
3285,2295,990,710,121900,44270
1895,1454,441,905,157700,44272
2837,2470,367,698,173400,44273
122,91,31,-,179900,44274
1260,1070,190,728,163900,44275
664,595,69,700,135200,44276
7135,5486,1649,774,160600,44278
1728,1524,204,1277,261300,44280
12347,9354,2993,820,176200,44281
9,9,0,-,-,44285
2325,2175,150,876,304500,44286
2615,2189,426,770,119700,44287
1404,863,541,757,104100,44288
6335,3637,2698,783,77600,44301
2536,969,1567,614,86400,44302
3532,2012,1520,715,146000,44303
1437,149,1288,808,83400,44304
9464,5539,3925,725,72300,44305
8958,4143,4815,689,61800,44306
3330,998,2332,617,58400,44307
290,9,281,525,-,44308
9866,4003,5863,701,68400,44310
2943,606,2337,635,51200,44311
13252,9685,3567,764,97500,44312
12012,6948,5064,791,149300,44313
8447,4402,4045,731,62300,44314
9611,7242,2369,819,144000,44319
8682,5012,3670,697,75600,44320
5978,4310,1668,1019,219200,44321
7420,5840,1580,1202,235000,44333
1090,943,147,873,157100,44401
1226,935,291,581,128400,44402
1765,1542,223,641,111100,44403
649,559,90,616,110700,44404
3379,2264,1115,636,62000,44405
8725,7418,1307,731,186400,44406
4496,3359,1137,656,148900,44408
7583,6107,1476,735,133100,44410
752,648,104,978,141200,44411
1024,830,194,570,166000,44412
2880,2317,563,823,89900,44413
702,584,118,658,130300,44417
555,467,88,518,147700,44418
6705,4724,1981,609,94800,44420
931,764,167,654,117900,44423
6504,5191,1313,644,98900,44425
504,423,81,769,110000,44427
1206,1088,118,515,115600,44428
1186,805,381,773,110400,44429
1414,1125,289,695,77600,44430
1772,1416,356,758,95100,44431
4416,3301,1115,659,99800,44432
1484,1222,262,679,101200,44436
1834,1395,439,744,91700,44437
1750,1164,586,644,65800,44438
41,10,31,-,95000,44439
1993,1588,405,565,125500,44440
671,628,43,-,119800,44441
1632,1352,280,518,121400,44442
582,534,48,-,145500,44443
4263,2922,1341,643,111400,44444
1405,1186,219,573,112900,44445
8836,4932,3904,665,81400,44446
464,381,83,-,156300,44449
725,594,131,725,111300,44450
1248,986,262,635,155000,44451
1202,942,260,694,163000,44452
408,294,114,-,99700,44454
612,579,33,633,112200,44455
10555,7639,2916,642,120000,44460
1572,1392,180,775,150200,44470
4327,3099,1228,649,70300,44471
1495,1215,280,865,124900,44473
4343,3641,702,587,117000,44481
11101,6915,4186,663,85700,44483
9852,6726,3126,657,120200,44484
6826,3647,3179,643,52600,44485
363,204,159,686,74800,44490
995,916,79,763,153800,44491
14,14,0,-,-,44493
3980,2301,1679,712,30400,44502
491,0,491,235,-,44503
1870,886,984,795,66200,44504
7554,4501,3053,550,71400,44505
1049,761,288,606,13900,44506
1937,854,1083,633,22100,44507
5203,2963,2240,632,47200,44509
947,366,581,630,18200,44510
8694,6304,2390,648,79900,44511
14851,9849,5002,657,114100,44512
9486,7643,1843,897,143400,44514
12107,7322,4785,644,98100,44515
13997,8879,5118,666,99100,44601
2200,1705,495,695,169900,44606
50,43,7,-,108600,44607
875,671,204,686,109800,44608
1654,1412,242,683,122400,44609
64,55,9,-,-,44610
736,656,80,625,142400,44611
2140,1601,539,741,151800,44612
755,522,233,668,93200,44613
5082,3993,1089,779,151800,44614
3986,3042,944,689,121300,44615
2224,1702,522,703,161700,44618
601,533,68,747,139400,44620
1801,1167,634,643,87000,44621
7524,5346,2178,778,128600,44622
1353,1192,161,480,188700,44624
601,420,181,738,168400,44625
1164,945,219,793,114900,44626
1586,1296,290,411,219600,44627
417,345,72,737,120500,44628
955,768,187,705,112000,44629
3590,2781,809,745,167100,44632
809,668,141,802,172600,44633
816,671,145,918,147900,44634
1133,855,278,656,131400,44637
586,423,163,574,172200,44638
78,52,26,925,90000,44640
8083,6129,1954,722,142200,44641
1271,1077,194,767,129500,44643
2051,1604,447,674,127600,44644
845,684,161,871,154300,44645
18838,12850,5988,714,130700,44646
7528,5770,1758,719,106500,44647
221,191,30,-,114000,44651
16,16,0,-,-,44652
236,147,89,582,77500,44653
5912,4332,1580,626,195800,44654
1205,1000,205,639,97000,44656
3971,2917,1054,657,113300,44657
42,36,6,417,106800,44659
68,53,15,-,77000,44661
3584,2959,625,673,122700,44662
10202,6603,3599,731,122200,44663
1116,924,192,748,158800,44666
5450,3881,1569,722,130500,44667
532,472,60,903,127600,44669
103,86,17,-,86800,44670
136,105,31,-,-,44671
2103,1187,916,700,81300,44672
895,796,99,884,110600,44675
1767,1439,328,658,123800,44676
979,690,289,761,135900,44677
132,54,78,-,-,44678
1780,1295,485,827,146100,44680
2429,1814,615,604,179100,44681
411,286,125,600,86800,44682
3330,2312,1018,687,75500,44683
10350,8564,1786,837,173000,44685
11,6,5,-,-,44687
1195,913,282,618,99800,44688
206,156,50,688,110000,44689
63,53,10,-,159200,44690
17890,12000,5890,682,142400,44691
22,22,0,-,72500,44693
642,533,109,484,98700,44695
102,87,15,704,227600,44697
354,295,59,619,110100,44699
562,9,553,276,-,44702
3651,1328,2323,658,54900,44703
1478,742,736,530,59300,44704
7412,4167,3245,629,66700,44705
7173,5121,2052,715,96700,44706
3946,1901,2045,541,76400,44707
10900,7066,3834,833,118400,44708
8461,4979,3482,669,111400,44709
4168,2228,1940,743,72800,44710
3768,2532,1236,716,94000,44714
5061,3351,1710,743,223600,44718
15977,11604,4373,813,164100,44720
5560,4587,973,808,156800,44721
2336,2029,307,791,110300,44730
385,329,56,581,122500,44802
457,366,91,499,107300,44804
12694,8535,4159,714,117200,44805
885,640,245,662,88500,44807
166,142,24,-,102400,44809
4903,3663,1240,641,111700,44811
3174,2503,671,701,123000,44813
980,858,122,747,159600,44814
283,223,60,606,80200,44815
18,18,0,-,-,44816
589,500,89,706,113900,44817
910,718,192,578,85700,44818
7457,5094,2363,651,92100,44820
1135,939,196,701,124300,44822
1644,1409,235,643,145500,44824
28,25,3,-,73500,44825
664,556,108,639,137600,44826
2914,2078,836,628,85900,44827
22,12,10,-,-,44828
7685,5494,2191,620,75000,44830
7121,5092,2029,608,84400,44833
939,718,221,805,92900,44836
1603,1241,362,626,123300,44837
98,80,18,763,95000,44838
5286,3986,1300,806,177100,44839
1095,893,202,769,143500,44840
206,169,37,715,89800,44841
2189,1484,705,619,115200,44842
834,699,135,735,150900,44843
234,196,38,740,90000,44844
1136,919,217,914,159600,44846
1397,1078,319,670,130900,44847
915,703,212,725,97400,44849
23,15,8,-,-,44850
1874,1419,455,710,107400,44851
527,439,88,591,151700,44853
677,462,215,712,93200,44854
434,353,81,633,124200,44855
89,82,7,-,78800,44856
9418,6407,3011,653,129900,44857
557,455,102,730,140600,44859
34,34,0,-,-,44861
1484,1239,245,493,122100,44864
1118,812,306,671,91400,44865
822,695,127,1039,146800,44866
926,811,115,815,125700,44867
16940,10475,6465,666,104000,44870
121,95,26,633,82700,44874
5836,3890,1946,687,105100,44875
947,752,195,695,128100,44878
1015,956,59,-,126400,44880
11,11,0,-,-,44881
1260,1035,225,720,100500,44882
10932,7536,3396,675,107000,44883
344,293,51,613,85000,44887
2875,2309,566,795,160700,44889
4340,2878,1462,630,103100,44890
0,0,0,-,-,44901
1788,826,962,520,42100,44902
9679,6874,2805,671,112800,44903
5629,3907,1722,682,142700,44904
4668,3284,1384,655,78700,44905
7235,4567,2668,650,85800,44906
6702,3801,2901,608,89400,44907
230,82,148,707,45000,45001
4995,3661,1334,805,212400,45002
236,165,71,819,100800,45003
12283,8491,3792,797,132100,45005
23960,17004,6956,834,174500,45011
20830,15122,5708,779,144600,45013
17212,10661,6551,864,147900,45014
4641,2960,1681,786,90300,45015
7608,6041,1567,731,145300,45030
163,101,62,723,98400,45032
102,86,16,925,58200,45033
478,399,79,1290,254800,45034
12266,8775,3491,825,195200,45036
8816,7104,1712,1169,192100,45039
19509,15462,4047,1248,243100,45040
20,0,20,-,-,45041
10635,7712,2923,851,131000,45042
19399,11357,8042,768,151200,45044
3394,2560,834,1041,160900,45050
0,0,0,-,-,45051
1531,1258,273,686,230900,45052
1100,1077,23,-,258400,45053
1037,989,48,565,236600,45054
8120,3751,4369,779,187600,45056
244,164,80,831,102100,45062
1053,945,108,822,122000,45064
1774,1400,374,875,222400,45065
8589,7554,1035,937,228200,45066
5029,3439,1590,900,134700,45067
4240,3506,734,831,233200,45068
18546,14747,3799,1186,211200,45069
86,61,25,738,66300,45070
1059,561,498,512,91600,45101
8655,6138,2517,792,150700,45102
12348,8687,3661,774,158900,45103
4632,3661,971,687,128700,45106
3543,2627,916,773,131000,45107
112,112,0,-,186700,45111
24,21,3,-,82500,45112
1291,1036,255,740,166800,45113
54,54,0,-,-,45115
1368,1101,267,842,153300,45118
1189,859,330,439,111500,45120
3456,2362,1094,577,115800,45121
4066,3373,693,917,126100,45122
3579,2364,1215,592,101600,45123
1500,1272,228,686,109800,45130
108,81,27,828,80500,45131
138,83,55,563,63500,45132
9542,6641,2901,696,112900,45133
1801,1301,500,614,119500,45135
20285,16006,4279,1011,228300,45140
1394,1109,285,807,108700,45142
1891,1262,629,519,91300,45144
11,11,0,-,-,45145
538,322,216,822,117300,45146
78,69,9,-,79600,45147
520,390,130,994,100700,45148
12649,9265,3384,773,171800,45150
4144,3466,678,1017,192000,45152
651,584,67,793,133100,45153
3300,2587,713,710,122600,45154
109,85,24,757,70900,45155
25,19,6,-,-,45156
3571,2915,656,699,160700,45157
133,78,55,743,78200,45158
1237,882,355,769,109800,45159
400,133,267,438,110400,45160
1016,817,199,735,176100,45162
98,62,36,797,66500,45164
13,13,0,-,-,45166
1494,970,524,658,112200,45167
684,490,194,743,88700,45168
1782,1154,628,681,93900,45169
2343,1851,492,756,141000,45171
46,37,9,-,82600,45172
798,738,60,1800,507100,45174
3424,2483,941,733,134800,45176
9079,5719,3360,705,138600,45177
7615,1990,5625,950,341000,45202
1471,218,1253,292,165900,45203
2481,834,1647,694,64800,45204
7070,2288,4782,689,67800,45205
5909,1780,4129,637,181500,45206
2327,906,1421,683,78100,45207
8976,5518,3458,948,343300,45208
5707,2240,3467,772,227200,45209
16076,7527,8549,696,103900,45211
10266,4592,5674,717,125900,45212
5449,3158,2291,637,153900,45213
3573,699,2874,598,62100,45214
12691,7108,5583,818,133500,45215
4025,1801,2224,722,77600,45216
2981,1528,1453,727,96500,45217
1527,1119,408,905,115000,45218
6135,1281,4854,805,105600,45219
6486,1869,4617,737,251000,45220
5808,2306,3502,662,108500,45223
9316,5718,3598,663,114500,45224
3957,646,3311,497,56000,45225
2616,1516,1100,840,263100,45226
8450,4032,4418,807,128300,45227
6007,1587,4420,544,116300,45229
11592,8321,3271,712,163200,45230
16526,11045,5481,802,103400,45231
2525,490,2035,374,78600,45232
5862,4954,908,664,201400,45233
11004,6841,4163,889,139600,45236
9179,4071,5108,730,98200,45237
18767,10821,7946,626,117800,45238
11516,7128,4388,768,116700,45239
10085,6432,3653,919,118700,45240
9875,7508,2367,924,204500,45241
8626,6992,1634,1142,280800,45242
5499,4876,623,1113,382000,45243
10318,8221,2097,842,238000,45244
8219,5586,2633,867,162100,45245
6072,3293,2779,977,131100,45246
9333,7434,1899,843,194700,45247
9608,8246,1362,817,138500,45248
5419,3417,2002,1146,327800,45249
8528,6067,2461,946,114300,45251
1868,1790,78,1278,205700,45252
8631,6285,2346,1019,188800,45255
36,13,23,-,-,45301
1384,1189,195,731,174700,45302
856,632,224,659,94800,45303
2685,2064,621,680,119800,45304
4270,3454,816,961,193900,45305
1003,783,220,651,144200,45306
114,83,31,775,81200,45307
1656,1335,321,632,113000,45308
5293,3940,1353,768,141500,45309
91,88,3,-,107700,45310
2240,1765,475,740,122100,45311
520,459,61,1086,166900,45312
1383,980,403,635,188900,45314
1650,1371,279,685,157900,45315
36,27,9,825,104200,45316
298,225,73,688,120600,45317
2152,1632,520,734,139700,45318
151,109,42,817,121900,45319
6034,4269,1765,661,116200,45320
330,249,81,789,88900,45321
8751,6961,1790,778,113600,45322
2290,1805,485,722,125100,45323
16713,8252,8461,793,116500,45324
971,864,107,904,153200,45325
392,346,46,912,128100,45326
3604,2873,731,883,154200,45327
226,150,76,745,75200,45328
385,285,100,775,91800,45330
9745,6388,3357,649,105000,45331
316,277,39,727,111300,45332
483,369,114,689,144100,45333
859,605,254,660,102800,45334
2576,1999,577,858,149200,45335
58,48,10,1111,107100,45336
696,596,100,675,160300,45337
2012,1698,314,704,135900,45338
554,458,96,773,134800,45339
238,232,6,-,148400,45340
1603,1300,303,726,82900,45341
15439,9943,5496,873,140000,45342
5908,4535,1373,766,104100,45344
2326,1501,825,685,102800,45345
852,679,173,807,88100,45346
1822,1378,444,696,101300,45347
367,289,78,844,156700,45348
124,72,52,817,101900,45349
30,26,4,-,85000,45350
92,81,11,686,145500,45351
91,60,31,588,62200,45352
72,72,0,-,-,45353
214,179,35,908,89700,45354
10094,6512,3582,701,93600,45356
120,96,24,625,91800,45358
702,582,120,606,126800,45359
189,120,69,640,69200,45360
135,104,31,821,93300,45361
487,436,51,606,143100,45362
570,510,60,750,172900,45363
11780,7486,4294,715,126000,45365
1932,1352,580,595,119000,45368
1303,1052,251,790,153800,45369
979,920,59,800,268400,45370
7610,5698,1912,818,168000,45371
154,94,60,695,88700,45372
13956,9111,4845,767,144800,45373
6806,4273,2533,661,140400,45377
125,114,11,708,70000,45378
1837,1499,338,608,150600,45380
2081,1624,457,714,128800,45381
445,338,107,742,96500,45382
2904,2072,832,767,124700,45383
109,88,21,1131,123500,45384
15784,11108,4676,701,128000,45385
2507,1827,680,820,229600,45387
266,239,27,-,158900,45388
196,139,57,792,76000,45389
1345,823,522,538,76100,45390
4365,1585,2780,595,56200,45402
6067,2687,3380,707,52900,45403
4091,1941,2150,695,57500,45404
8106,3118,4988,638,61000,45405
9130,4542,4588,649,59800,45406
3083,1802,1281,886,151900,45409
6891,3148,3743,685,68800,45410
8930,5560,3370,694,106500,45414
5557,3621,1936,762,121200,45415
2261,1539,722,921,63400,45416
12375,6228,6147,652,50100,45417
689,573,116,783,113100,45418
6478,4553,1925,726,153100,45419
11844,6515,5329,677,82500,45420
19282,13845,5437,891,113200,45424
6956,3028,3928,715,80700,45426
0,0,0,-,-,45428
11660,8060,3600,836,141700,45429
2810,2384,426,1097,170600,45430
11967,5753,6214,1045,134700,45431
6460,4711,1749,787,115600,45432
582,27,555,1241,-,45433
4461,4091,370,1113,191800,45434
4035,2192,1843,826,83700,45439
9026,6074,2952,837,167200,45440
8020,4537,3483,792,103400,45449
12752,9688,3064,895,224900,45458
12316,8867,3449,913,191900,45459
6218,5293,925,718,157600,45502
14179,8631,5548,722,111900,45503
6790,4446,2344,783,114900,45504
8263,4174,4089,644,70900,45505
5385,2818,2567,698,71200,45506
20785,14007,6778,725,116500,45601
1987,1421,566,598,86200,45612
1223,910,313,778,113300,45613
1835,1467,368,644,104700,45614
599,483,116,539,72100,45616
61,61,0,-,-,45617
6,6,0,-,-,45618
2894,2098,796,772,100700,45619
434,367,67,-,83500,45620
133,85,48,717,57600,45621
60,60,0,-,-,45622
1227,971,256,582,101200,45623
0,0,0,-,-,45624
1987,1499,488,668,117800,45628
975,708,267,682,85900,45629
28,15,13,-,-,45630
5959,4401,1558,651,109300,45631
713,563,150,595,82100,45634
47,47,0,-,84500,45636
8522,5853,2669,629,87400,45638
6493,4212,2281,767,98900,45640
0,0,0,-,-,45642
1827,1608,219,750,144100,45644
1135,962,173,783,91300,45645
103,88,15,-,-,45646
891,709,182,535,81100,45647
4583,3527,1056,630,108300,45648
161,103,58,-,66900,45650
2304,1514,790,582,90700,45651
1416,1166,250,528,108600,45652
1742,1443,299,803,135700,45653
353,343,10,-,94500,45654
2635,1920,715,643,93700,45656
855,514,341,567,70000,45657
881,618,263,598,103300,45658
920,668,252,653,86100,45659
3007,2124,883,604,105600,45660
2859,2085,774,590,90600,45661
12390,6538,5852,568,76800,45662
2428,1868,560,521,80400,45663
3991,3104,887,793,139400,45669
135,111,24,569,-,45671
599,508,91,916,104400,45672
146,85,61,908,79000,45673
131,74,57,631,115600,45674
470,375,95,-,94100,45678
850,623,227,649,110300,45679
5006,3359,1647,650,115300,45680
565,529,36,742,110700,45681
897,734,163,522,87800,45682
904,740,164,701,109600,45684
371,257,114,516,156500,45685
1384,1060,324,666,83200,45686
226,139,87,1004,69600,45688
5626,3603,2023,714,113400,45690
3336,2368,968,564,84000,45692
3329,2033,1296,559,103300,45693
4529,3584,945,613,138000,45694
226,173,53,586,59200,45695
640,499,141,-,109800,45696
1870,1546,324,568,114800,45697
152,103,49,572,69000,45698
11136,5061,6075,778,160600,45701
2244,1799,445,620,127600,45710
432,359,73,682,124000,45711
4151,3114,1037,627,114100,45714
904,667,237,595,99800,45715
189,156,33,700,72000,45716
447,227,220,658,53700,45719
12,12,0,-,-,45721
1464,1225,239,824,91400,45723
759,711,48,-,121700,45724
257,222,35,-,48100,45727
538,476,62,859,112900,45729
1697,1218,479,631,78300,45732
213,141,72,714,63400,45734
618,538,80,728,113800,45735
146,85,61,727,59200,45740
319,264,55,505,69400,45741
1223,1004,219,715,160000,45742
633,589,44,632,114300,45743
1075,908,167,576,99900,45744
559,435,124,836,104600,45745
237,194,43,-,52000,45746
11378,7489,3889,647,123600,45750
1539,1063,476,571,59100,45760
771,579,192,681,77200,45761
3100,1854,1246,711,75100,45764
436,354,82,-,150500,45766
1051,812,239,435,104400,45767
696,603,93,511,144100,45768
2619,1946,673,547,100300,45769
243,222,21,-,54200,45770
1399,1090,309,549,85500,45771
699,594,105,-,89300,45772
54,54,0,-,125000,45773
421,341,80,853,117900,45775
311,255,56,753,108700,45776
317,248,69,943,117600,45778
253,203,50,572,87100,45779
1320,622,698,706,113900,45780
171,120,51,525,50000,45782
1365,1068,297,540,134100,45784
1352,1178,174,715,120600,45786
37,37,0,-,-,45787
452,429,23,631,118500,45788
62,62,0,-,-,45789
8782,5029,3753,635,77700,45801
6016,3210,2806,588,59500,45804
9364,5645,3719,753,114800,45805
4317,3458,859,713,123700,45806
4803,3732,1071,671,139300,45807
157,100,57,750,68800,45808
45,40,5,-,83300,45809
2638,1608,1030,703,118700,45810
730,507,223,629,62400,45812
1439,1126,313,592,100000,45813
1094,832,262,864,147100,45814
158,134,24,-,96000,45816
2592,1891,701,638,156100,45817
104,72,32,920,82500,45819
181,160,21,647,90700,45820
555,490,65,794,93300,45821
8109,5942,2167,670,136200,45822
194,153,41,571,173200,45826
727,686,41,605,151800,45827
2371,1879,492,579,135200,45828
2212,1883,329,725,120100,45830
1261,1076,185,708,111600,45831
1143,1011,132,594,108900,45832
4280,3181,1099,738,116200,45833
227,202,25,-,99600,45835
529,457,72,600,95300,45836
17,17,0,-,-,45838
24211,15775,8436,726,138100,45840
328,252,76,763,159300,45841
1462,1177,285,646,96100,45843
1244,1069,175,692,164600,45844
1106,1009,97,618,190800,45845
1483,1277,206,510,142500,45846
402,345,57,825,96100,45849
1235,1026,209,637,157700,45850
259,215,44,550,114000,45851
489,337,152,697,177600,45853
161,120,41,850,83200,45854
62,53,9,775,91900,45855
1981,1514,467,696,121800,45856
1184,933,251,727,147100,45858
195,147,48,625,61800,45859
833,668,165,582,165700,45860
70,55,15,761,73600,45861
625,516,109,693,88200,45862
438,357,81,727,95500,45863
73,63,10,825,105500,45864
1885,1572,313,673,168000,45865
77,50,27,731,85000,45866
380,325,55,800,118800,45867
264,244,20,740,143200,45868
1747,1472,275,615,169800,45869
57,36,21,-,91700,45870
747,523,224,723,150700,45871
1542,1066,476,620,88100,45872
873,681,192,658,82200,45873
918,762,156,645,76600,45874
4408,3373,1035,619,169100,45875
323,250,73,652,152400,45876
828,637,191,695,134400,45877
2450,1716,734,589,89300,45879
1076,844,232,625,84600,45880
473,380,93,893,153700,45881
1053,890,163,685,106000,45882
1265,1025,240,661,198500,45883
54,0,54,-,-,45884
5164,3699,1465,721,135600,45885
243,177,66,651,64500,45886
1651,1269,382,718,104500,45887
72,59,13,1094,83200,45888
492,479,13,900,167400,45889
212,188,24,667,93600,45890
6219,4384,1835,658,103500,45891
259,199,60,538,89500,45894
7261,5581,1680,636,131100,45895
785,701,84,905,119400,45896
24,24,0,-,-,45897
467,422,45,644,77200,45898
70,60,10,-,56300,45899
4171,3185,986,727,90000,46001
6916,5430,1486,847,96900,46011
7925,5365,2560,762,97100,46012
7990,5248,2742,734,81500,46013
7424,3226,4198,667,41500,46016
2315,1826,489,712,89100,46017
1221,1058,163,673,134400,46030
859,750,109,810,148300,46031
18668,12668,6000,1130,294600,46032
13415,12219,1196,1196,320000,46033
2707,2303,404,758,159900,46034
394,318,76,734,86300,46035
4795,3293,1502,707,78100,46036
13844,11813,2031,1270,284700,46037
16607,12115,4492,1151,191200,46038
230,193,37,855,108200,46039
3926,3289,637,824,199700,46040
8465,5947,2518,699,96400,46041
1146,927,219,723,99400,46044
40,40,0,-,-,46045
30,0,30,-,-,46047
849,671,178,916,100800,46048
330,263,67,763,89700,46049
787,613,174,767,113200,46050
1222,956,266,795,116800,46051
9411,6547,2864,763,129700,46052
3913,3633,280,1088,213600,46055
931,815,116,763,120800,46056
493,282,211,676,120100,46057
772,583,189,763,118400,46058
14366,10035,4331,1030,174400,46060
12931,10311,2620,927,191700,46062
157,121,36,790,57300,46063
5001,3980,1021,880,153600,46064
1245,967,278,785,153800,46065
1168,1062,106,784,119100,46068
2970,2166,804,764,165300,46069
865,712,153,650,100400,46070
1383,1151,232,728,153600,46071
3742,2817,925,723,107800,46072
10737,8740,1997,1101,259600,46074
2119,1553,566,1327,193300,46075
657,516,141,675,79500,46076
9766,8207,1559,1212,361700,46077
81,59,22,1100,120500,46103
428,371,57,740,110900,46104
777,598,179,800,122500,46105
2116,1580,536,975,149800,46106
5068,3002,2066,761,95200,46107
182,131,51,721,170800,46110
87,53,34,1028,66900,46111
13084,10468,2616,1043,176000,46112
5543,4433,1110,1020,140300,46113
759,586,173,543,120500,46115
251,217,34,-,151500,46117
1934,1565,369,976,151900,46118
2131,1644,487,704,124000,46120
2043,1837,206,682,155700,46121
5771,4287,1484,865,173200,46122
12099,9928,2171,1092,185200,46123
3146,1949,1197,723,102700,46124
22,16,6,-,-,46125
1943,1704,239,959,154200,46126
104,94,10,-,57400,46127
739,625,114,850,116400,46128
930,779,151,788,179300,46130
11700,7952,3748,821,128600,46131
270,210,60,935,103900,46133
6687,4461,2226,697,118300,46135
15446,10756,4690,853,152800,46140
11257,8493,2764,834,162900,46142
20475,13377,7098,940,169500,46143
80,67,13,-,68600,46144
30,24,6,-,-,46146
1226,995,231,814,159700,46147
1959,1491,468,695,110100,46148
803,680,123,822,164700,46149
329,255,74,761,92300,46150
11789,8708,3081,745,148200,46151
91,54,37,-,-,46155
525,453,72,796,86800,46156
1394,1229,165,787,157300,46157
8349,6394,1955,836,147600,46158
2435,2064,371,826,150900,46160
1099,828,271,698,139100,46161
219,169,50,-,119600,46162
4499,4195,304,832,192200,46163
1649,1462,187,885,159100,46164
581,494,87,948,169500,46165
632,438,194,954,103800,46166
2218,2025,193,905,182200,46167
12607,8929,3678,994,172800,46168
659,638,21,-,107500,46171
952,713,239,895,115700,46172
4281,2849,1432,648,96000,46173
254,161,93,798,65200,46175
11070,7442,3628,761,113500,46176
374,317,57,856,177500,46180
1701,1439,262,939,202800,46181
590,495,95,730,119800,46182
17,17,0,-,-,46183
4738,4073,665,1158,112800,46184
677,579,98,1043,138300,46186
12737,5399,7338,770,69100,46201
9336,2324,7012,922,230700,46202
14493,7785,6708,809,78700,46203
3437,700,2737,1070,282300,46204
11403,5388,6015,820,155000,46205
8567,3991,4576,785,103900,46208
10016,4725,5291,824,116500,46214
1260,293,967,972,196100,46216
12236,8891,3345,986,133900,46217
11496,5101,6395,832,58400,46218
15546,8602,6944,786,99600,46219
16825,10728,6097,932,200000,46220
9284,5863,3421,825,100700,46221
12145,4984,7161,822,61100,46222
13367,4681,8686,729,101800,46224
2527,1153,1374,845,68000,46225
17890,8230,9660,792,85300,46226
22706,10350,12356,785,122000,46227
5668,4415,1253,849,153500,46228
10812,6459,4353,877,112800,46229
3484,3230,254,1359,118600,46231
10203,8121,2082,1136,144600,46234
11904,5777,6127,703,101000,46235
10416,9054,1362,1298,175800,46236
14815,10019,4796,925,132400,46237
9580,7934,1646,1013,144400,46239
9321,4310,5011,944,206800,46240
10888,6249,4639,797,77200,46241
9278,4012,5266,921,174900,46250
15067,6465,8602,788,112700,46254
10271,7133,3138,837,192500,46256
3636,3447,189,1336,199300,46259
13054,6503,6551,833,174800,46260
10830,4890,5940,878,134000,46268
2850,2498,352,1255,290600,46278
3220,2169,1051,1212,161500,46280
114,114,0,-,361800,46290
329,284,45,863,456900,46301
4924,3939,985,860,179000,46303
9328,7009,2319,945,180000,46304
22811,18959,3852,983,193500,46307
5020,4232,788,819,152500,46310
7875,7226,649,1026,207900,46311
10256,4491,5765,673,73300,46312
7062,4743,2319,853,132400,46319
5150,2146,3004,710,66900,46320
8756,7529,1227,1072,217700,46321
9533,7472,2061,1017,155400,46322
8062,5242,2820,892,90500,46323
8459,5362,3097,943,88700,46324
3782,2428,1354,815,83700,46327
376,346,30,-,143200,46340
3781,3193,588,676,163800,46341
11691,9117,2574,861,129900,46342
66,49,17,915,103500,46345
498,331,167,680,66500,46346
1822,1565,257,866,167200,46347
452,384,68,948,121500,46348
1232,1031,201,770,156600,46349
17224,12464,4760,696,141000,46350
6345,5448,897,983,173700,46356
17753,11252,6501,740,105700,46360
370,278,92,-,149200,46365
2167,1733,434,559,95300,46366
15131,10521,4610,887,143500,46368
1308,1159,149,743,164100,46371
5328,5229,99,842,272800,46373
337,298,39,640,131000,46374
9345,7604,1741,954,215800,46375
109,77,32,783,79600,46376
136,85,51,-,100400,46377
86,86,0,-,69500,46379
72,48,24,-,162500,46381
716,705,11,-,175300,46382
15671,10270,5401,889,187200,46383
14566,12335,2231,991,205000,46385
1197,1106,91,827,146000,46390
2158,1883,275,696,171600,46391
2904,2418,486,803,156500,46392
117,76,41,-,111400,46393
4675,2851,1824,835,116900,46394
2607,1084,1523,494,59000,46402
5707,3113,2594,729,99000,46403
6981,4313,2668,738,69600,46404
3863,2708,1155,913,79800,46405
3799,2026,1773,786,54600,46406
4848,2062,2786,645,51600,46407
6338,3591,2747,806,66600,46408
2887,1374,1513,910,59500,46409
15520,9641,5879,976,128600,46410
1264,968,296,764,98700,46501
9,9,0,-,-,46502
1385,1113,272,575,126700,46504
3455,2526,929,657,148900,46506
3396,2670,726,757,156100,46507
64,58,6,-,75000,46508
1537,1215,322,654,120700,46510
1669,1326,343,649,136400,46511
16377,11415,4962,804,118600,46514
11715,6570,5145,705,108000,46516
8567,5334,3233,689,127100,46517
729,594,135,688,115100,46524
11637,7602,4035,751,125300,46526
8540,6408,2132,772,151900,46528
10580,9545,1035,1191,211400,46530
580,514,66,813,111900,46531
736,620,116,770,108300,46532
4292,3303,989,677,103400,46534
1249,1011,238,750,148300,46536
219,192,27,541,78100,46537
1462,1342,120,719,185300,46538
943,786,157,675,89300,46539
3576,3201,375,891,180000,46540
1423,1070,353,570,121300,46542
904,728,176,818,214900,46543
12620,8273,4347,719,101400,46544
10841,5153,5688,720,111500,46545
4326,3121,1205,669,166700,46550
2527,2146,381,590,154700,46552
1216,1089,127,608,147900,46553
2072,1639,433,716,141200,46554
1253,879,374,739,164800,46555
239,0,239,714,-,46556
4438,3800,638,912,148900,46561
1949,1503,446,638,136600,46562
8913,6553,2360,701,124700,46563
2418,2059,359,732,245700,46565
3775,2999,776,760,168400,46567
357,290,67,442,141700,46570
1359,1107,252,600,272300,46571
1390,1048,342,767,147900,46573
3482,2940,542,687,109000,46574
8398,6098,2300,725,134400,46580
5118,3872,1246,847,139900,46582
1777,1054,723,696,165400,46590
55,55,0,-,-,46595
2365,562,1803,481,75600,46601
3588,2094,1494,756,50800,46613
12372,9090,3282,621,120800,46614
5766,3606,2160,737,81200,46615
2239,1145,1094,841,75700,46616
3739,2448,1291,899,123200,46617
7507,5246,2261,767,73500,46619
9892,6521,3371,774,106400,46628
2596,2118,478,705,123100,46635
6273,4103,2170,791,124300,46637
3247,2560,687,673,116400,46701
939,781,158,617,108600,46702
7005,4956,2049,738,143800,46703
12,12,0,-,-,46704
665,466,199,394,89200,46705
7444,5615,1829,689,131900,46706
1632,1323,309,620,125500,46710
2514,1843,671,494,119600,46711
5907,4321,1586,583,118400,46714
1774,1450,324,745,89800,46721
3080,2482,598,623,134300,46723
9274,7317,1957,665,142500,46725
479,419,60,-,124000,46730
221,175,46,536,-,46731
1128,661,467,862,92100,46732
7663,5738,1925,599,113400,46733
3217,2779,438,739,143300,46737
3167,2200,967,695,90600,46738
1316,1021,295,619,126000,46740
1505,1325,180,638,155500,46741
1366,1152,214,606,165900,46742
727,631,96,951,150500,46743
800,680,120,744,148700,46745
1786,1295,491,795,122400,46746
1143,1048,95,732,126800,46747
1819,1684,135,948,173300,46748
10521,7901,2620,671,99800,46750
6127,4186,1941,649,112500,46755
162,162,0,-,92400,46759
528,440,88,734,97900,46760
3810,3044,766,630,140200,46761
750,687,63,-,182000,46763
519,489,30,990,120700,46764
1808,1623,185,1037,199500,46765
360,276,84,726,130900,46766
2747,1965,782,682,95000,46767
1148,977,171,689,128800,46770
0,0,0,-,-,46771
808,728,80,778,147300,46772
1248,1070,178,733,113700,46773
6115,4623,1492,803,109300,46774
618,526,92,578,89600,46776
2370,2020,350,692,120500,46777
809,633,176,597,96100,46779
293,273,20,600,99900,46781
2416,2137,279,700,171300,46783
874,693,181,864,136100,46784
455,387,68,848,126100,46785
33,33,0,-,-,46786
1485,1192,293,587,101900,46787
1154,1035,119,770,170000,46788
378,338,40,919,146300,46791
1547,1213,334,897,106300,46792
1608,1325,283,737,110000,46793
703,561,142,644,102500,46794
2342,1939,403,812,173100,46795
1454,1280,174,791,113800,46797
629,583,46,738,131500,46798
99,90,9,-,28200,46799
4535,1500,3035,627,55100,46802
3480,1393,2087,639,39200,46803
11978,8648,3330,834,154800,46804
9149,5042,4107,652,83800,46805
8732,4750,3982,742,50200,46806
6453,4002,2451,734,80600,46807
8162,4652,3510,638,79400,46808
4045,2376,1669,577,84600,46809
4235,3809,426,930,274400,46814
10642,7739,2903,735,119500,46815
7406,3906,3500,600,78200,46816
7649,6527,1122,843,132900,46818
3996,2850,1146,736,101800,46819
12161,7650,4511,795,120200,46825
14104,10110,3994,789,120200,46835
7929,7128,801,1148,209600,46845
16125,10811,5314,633,88600,46901
15765,10331,5434,697,101700,46902
1136,862,274,653,101400,46910
523,448,75,949,94400,46911
438,398,40,623,137900,46913
507,409,98,600,88000,46914
250,198,52,605,108800,46915
696,574,122,590,110000,46917
987,761,226,678,120600,46919
437,423,14,-,123200,46920
9,9,0,-,-,46922
3194,2528,666,683,121100,46923
683,575,108,841,94500,46926
1781,1409,372,565,90200,46928
1131,886,245,602,108500,46929
27,20,7,775,76000,46930
80,57,23,738,61700,46931
1413,1214,199,772,103300,46932
2590,1790,800,777,80900,46933
2272,1900,372,789,121100,46936
1216,980,236,781,84200,46938
800,645,155,579,76300,46939
1032,856,176,780,88700,46940
417,383,34,600,90800,46941
91,29,62,558,-,46943
29,16,13,-,-,46946
10730,7472,3258,636,79000,46947
278,245,33,731,87900,46950
733,644,89,593,101300,46951
8229,5475,2754,670,95300,46952
8470,5271,3199,677,71200,46953
239,173,66,539,61800,46957
273,252,21,-,86700,46958
261,159,102,703,67400,46959
429,309,120,729,96800,46960
91,62,29,-,-,46961
3609,2459,1150,704,98700,46962
53,33,20,506,-,46967
40,40,0,-,-,46968
8687,5619,3068,707,79200,46970
652,540,112,838,107300,46974
5697,4425,1272,636,98200,46975
828,723,105,693,97300,46978
1781,1581,200,729,141900,46979
903,735,168,703,102000,46982
114,88,26,-,145200,46984
630,414,216,700,119800,46985
690,558,132,584,99100,46986
382,312,70,657,116800,46987
366,297,69,653,85900,46988
1354,996,358,637,146700,46989
245,237,8,-,130400,46990
704,547,157,724,67100,46991
6949,5144,1805,648,93000,46992
1078,903,175,687,91000,46994
2756,2151,605,642,90700,46996
55,47,8,-,45700,46998
4084,3095,989,726,152800,47001
445,250,195,682,82300,47003
4476,3412,1064,702,172200,47006
148,83,65,-,185400,47010
225,188,37,-,94300,47011
4059,3058,1001,652,149500,47012
291,225,66,856,150600,47016
174,161,13,-,176800,47017
1665,1252,413,755,147400,47018
405,254,151,889,184300,47020
1136,1050,86,769,211900,47022
544,445,99,883,97500,47023
1151,934,217,653,98400,47024
8546,6535,2011,732,160400,47025
725,584,141,629,145800,47030
2111,1709,402,761,135500,47031
1101,1008,93,942,126800,47032
51,44,7,-,96000,47034
159,159,0,-,-,47035
338,299,39,728,195300,47036
1701,1239,462,658,116300,47037
653,434,219,688,131300,47038
2223,1726,497,755,128200,47040
2374,2042,332,684,158300,47041
1789,1377,412,549,120200,47042
2432,1716,716,640,113600,47043
2367,2036,331,677,183000,47060
2756,2139,617,771,84700,47102
21,21,0,-,-,47104
1696,1483,213,897,141800,47106
859,631,228,506,106300,47108
163,163,0,-,120700,47110
5571,4117,1454,779,147800,47111
6477,4929,1548,689,146400,47112
133,106,27,1536,155000,47114
927,796,131,516,126900,47115
241,241,0,-,67900,47116
1564,1439,125,705,119600,47117
1255,1061,194,397,87600,47118
4081,3872,209,852,243900,47119
363,307,56,826,89700,47120
3616,3273,343,800,198600,47122
37,37,0,-,-,47123
1455,1335,120,698,184000,47124
630,518,112,845,92000,47125
1548,1245,303,830,148300,47126
8239,4597,3642,766,102600,47129
17810,12449,5361,789,125900,47130
450,406,44,944,139500,47135
1540,1422,118,775,162600,47136
550,469,81,498,80600,47137
1881,1647,234,734,116700,47138
1007,801,206,633,95100,47140
543,487,56,727,156000,47141
384,381,3,-,99700,47142
1004,888,116,629,181400,47143
725,606,119,612,97100,47145
362,277,85,787,152600,47147
19296,11984,7312,763,126900,47150
18,7,11,-,-,47160
1241,1077,164,844,144300,47161
322,266,56,-,104900,47162
714,671,43,-,138600,47163
1581,1210,371,559,98800,47164
2284,1821,463,638,111100,47165
516,461,55,-,106600,47166
5713,4150,1563,633,103600,47167
5395,3866,1529,763,105800,47170
6277,5060,1217,968,162700,47172
373,347,26,-,75400,47175
442,389,53,-,110000,47177
17518,11678,5840,894,131900,47201
10394,8061,2333,785,158400,47203
1954,1404,550,734,126500,47220
573,389,184,832,96000,47223
203,164,39,-,155000,47224
65,42,23,786,67800,47226
811,714,97,714,119400,47227
1125,888,237,636,87100,47229
612,552,60,754,91800,47230
409,377,32,908,126400,47231
1071,908,163,864,116300,47232
580,499,81,763,132300,47234
561,493,68,-,105800,47235
8430,5817,2613,765,127300,47240
2089,1432,657,749,111500,47243
277,238,39,933,107200,47244
1608,1269,339,754,116800,47246
64,52,12,-,90000,47247
9019,6195,2824,712,121300,47250
646,530,116,659,77100,47260
77,56,21,900,91000,47263
526,469,57,-,133100,47264
7855,5592,2263,715,96700,47265
216,199,17,-,98300,47270
828,641,187,892,103000,47272
618,580,38,1100,127800,47273
11825,8268,3557,739,123200,47274
305,269,36,-,107700,47280
534,440,94,802,124700,47281
166,134,32,645,98000,47282
1299,937,362,789,112700,47283
11410,7390,4020,665,58500,47302
10312,5163,5149,705,74200,47303
13396,9004,4392,810,114900,47304
1747,670,1077,595,53300,47305
3,0,3,-,-,47306
1643,1289,354,555,88000,47320
63,43,20,875,80400,47324
232,198,34,486,91700,47325
637,555,82,671,100800,47326
1777,1273,504,659,82100,47327
2176,1697,479,851,116500,47330
9123,6232,2891,678,81100,47331
1309,1044,265,801,110100,47334
321,249,72,531,66400,47335
1354,987,367,619,66700,47336
59,48,11,663,71100,47337
1106,842,264,776,82800,47338
233,208,25,-,150500,47339
1174,943,231,647,84600,47340
829,615,214,778,97600,47341
1125,899,226,581,79500,47342
42,30,12,1063,72900,47344
491,386,105,657,110900,47345
1471,1243,228,683,98600,47346
3923,3010,913,617,68700,47348
150,121,29,738,76400,47351
374,323,51,900,95200,47352
2149,1601,548,809,118200,47353
488,396,92,586,98000,47354
1159,928,231,732,83800,47355
2243,1829,414,696,122900,47356
407,328,79,807,83200,47357
377,325,52,825,87000,47358
1309,976,333,584,74100,47359
510,467,43,475,109100,47360
87,69,18,700,66800,47361
10896,7374,3522,679,87400,47362
13,13,0,-,-,47367
1302,1089,213,630,88500,47368
565,464,101,548,75500,47369
4898,3549,1349,615,95000,47371
981,757,224,560,62800,47373
18343,11496,6847,658,96000,47374
701,519,182,553,72300,47380
72,37,35,525,48100,47381
90,57,33,525,40600,47382
1103,909,194,912,116800,47383
660,548,112,720,87600,47384
614,498,116,721,97700,47385
546,532,14,628,127500,47386
254,205,49,840,105300,47387
119,94,25,658,85600,47388
2139,1534,605,546,64200,47390
531,463,68,921,136600,47393
3358,2429,929,632,83400,47394
2793,2184,609,683,127800,47396
17513,9444,8069,956,221300,47401
13995,8055,5940,829,138800,47403
9616,5004,4612,784,153600,47404
3,3,0,-,-,47405
0,0,0,-,-,47406
9058,3252,5806,880,185400,47408
149,69,80,807,70400,47420
11061,8592,2469,681,113300,47421
3578,2958,620,542,114400,47424
299,266,33,-,106500,47427
3530,2868,662,710,133800,47429
504,455,49,-,89900,47431
1978,1470,508,676,89800,47432
1686,1247,439,686,116600,47433
0,0,0,-,-,47434
642,531,111,669,108400,47436
52,52,0,-,82900,47437
1632,1269,363,631,68800,47438
3850,2876,974,586,82600,47441
435,321,114,656,97000,47443
4292,3417,875,579,95800,47446
3010,2369,641,884,182800,47448
104,97,7,494,102500,47449
483,343,140,489,92400,47451
1863,1387,476,551,105700,47452
236,209,27,-,83800,47453
2982,2178,804,615,84000,47454
31,31,0,-,-,47455
592,469,123,906,109800,47456
54,44,10,-,72100,47457
8,8,0,-,-,47458
1438,1247,191,758,129300,47459
4507,3569,938,701,120900,47460
1570,1358,212,684,139000,47462
79,53,26,389,70300,47464
283,242,41,563,95300,47465
23,23,0,-,-,47467
563,507,56,-,216600,47468
677,515,162,558,92600,47469
727,600,127,691,105700,47470
995,786,209,383,90000,47471
6831,4678,2153,646,98900,47501
1570,1068,502,597,56100,47512
920,783,137,480,113200,47513
102,95,7,-,-,47514
410,376,34,-,153200,47515
440,360,80,416,103600,47516
227,224,3,-,145300,47519
1273,829,444,556,83400,47520
255,237,18,-,162900,47521
102,69,33,675,55000,47522
1256,977,279,484,109800,47523
177,150,27,631,-,47524
186,158,28,-,166100,47525
660,556,104,-,116800,47527
188,157,31,655,43000,47528
458,346,112,641,71800,47529
340,330,10,-,129500,47531
1758,1472,286,658,153300,47532
243,182,61,-,59500,47535
0,0,0,-,-,47536
366,334,32,812,114900,47537
491,341,150,650,99600,47541
3697,2646,1051,552,129100,47542
8536,6603,1933,566,156500,47546
255,242,13,-,131900,47550
332,323,9,-,124800,47551
113,113,0,-,-,47552
3131,2465,666,540,113800,47553
677,495,182,631,111600,47557
1339,1216,123,625,183100,47558
642,463,179,435,106000,47561
1571,1142,429,566,127800,47562
618,550,68,-,130000,47564
2456,2009,447,617,95600,47567
296,227,69,471,81300,47568
102,102,0,-,-,47574
447,325,122,655,201400,47575
123,89,34,-,88100,47576
489,445,44,527,121300,47577
365,301,64,810,89900,47578
1038,870,168,540,169300,47579
119,119,0,-,205400,47580
1687,1489,198,478,94900,47581
74,62,12,633,62500,47584
190,132,58,674,86300,47585
4542,3445,1097,601,105800,47586
235,212,23,538,76200,47588
249,231,18,-,66500,47590
10396,6204,4192,688,100800,47591
35,28,7,-,-,47596
354,289,65,604,119600,47597
1296,1040,256,780,69900,47598
5704,4747,957,667,124300,47601
2020,1435,585,845,107300,47610
488,435,53,419,96000,47611
316,241,75,600,80100,47612
1056,970,86,535,138900,47613
723,485,238,807,83600,47615
99,90,9,-,52500,47616
674,568,106,718,121200,47619
5170,4016,1154,677,130500,47620
13680,10884,2796,876,171000,47630
817,691,126,765,145800,47631
1122,916,206,746,131900,47633
939,803,136,639,86400,47634
2215,1675,540,717,111300,47635
493,428,65,538,131300,47637
1448,1309,139,626,165000,47638
1508,1352,156,624,206000,47639
387,361,26,-,69500,47640
1718,1251,467,718,129700,47648
609,537,72,833,102400,47649
20,15,5,513,66300,47654
2048,1575,473,708,88800,47660
1348,1181,167,640,110100,47665
747,658,89,720,67100,47666
4872,3375,1497,647,94900,47670
56,38,18,785,102300,47683
174,75,99,591,256900,47708
7963,4455,3508,643,88900,47710
13044,9878,3166,801,123700,47711
10497,6758,3739,765,131400,47712
4435,1931,2504,664,61500,47713
13642,8003,5639,743,85600,47714
13149,6359,6790,800,134700,47715
6948,5885,1063,821,150900,47720
6256,5780,476,1292,194100,47725
13395,7402,5993,723,112700,47802
8618,5602,3016,863,105900,47803
4603,2709,1894,698,65600,47804
4810,3683,1127,719,103900,47805
4795,1519,3276,652,50800,47807
0,0,0,-,-,47809
403,343,60,672,79300,47832
469,455,14,-,99200,47833
7980,5993,1987,652,100300,47834
15,15,0,-,-,47836
471,368,103,347,78800,47837
670,473,197,647,80800,47838
679,554,125,645,127900,47840
859,671,188,583,86100,47841
4143,2936,1207,558,73000,47842
177,156,21,425,88200,47846
458,383,75,606,95900,47847
722,634,88,745,72800,47848
132,114,18,-,111500,47849
961,788,173,658,87200,47850
49,25,24,730,81700,47853
298,298,0,-,107300,47854
168,138,30,721,55200,47855
137,118,19,920,67300,47857
261,218,43,-,154700,47858
320,280,40,912,76700,47859
156,128,28,655,34300,47860
257,213,44,631,109200,47861
541,409,132,599,68800,47862
76,48,28,-,-,47863
97,93,4,-,-,47865
220,220,0,-,86100,47866
1267,915,352,781,99700,47868
45,0,45,-,-,47869
76,62,14,594,76500,47871
2883,2086,797,485,106800,47872
1439,1163,276,666,76500,47874
0,0,0,-,-,47876
1211,922,289,651,69100,47879
37,37,0,-,-,47880
177,119,58,714,60200,47881
3478,2292,1186,668,89400,47882
62,53,9,-,46100,47884
3533,2777,756,662,83800,47885
1890,361,1529,657,162800,47901
7071,3179,3892,771,82700,47904
17103,10423,6680,806,146200,47905
23148,10237,12911,876,190200,47906
0,0,0,-,-,47907
16420,10458,5962,816,130300,47909
13,12,1,-,-,47916
176,132,44,780,76000,47917
2497,1745,752,640,102500,47918
907,850,57,664,151000,47920
429,325,104,730,65000,47921
566,379,187,682,79600,47922
1418,1102,316,779,118600,47923
91,91,0,-,-,47924
101,92,9,-,61900,47925
459,413,46,714,108800,47926
815,635,180,744,67100,47928
288,240,48,725,104300,47929
485,366,119,656,121500,47930
2111,1652,459,624,114600,47932
11200,7577,3623,641,124800,47933
653,543,110,905,130000,47940
566,422,144,833,116300,47941
284,246,38,700,79600,47942
316,75,241,968,170200,47943
1470,1046,424,649,89100,47944
935,770,165,688,106300,47946
561,353,208,626,80800,47948
535,464,71,779,86800,47949
322,192,130,889,119200,47950
952,572,380,723,91400,47951
1218,988,230,684,89700,47952
844,718,126,821,121500,47954
325,235,90,678,79500,47955
656,517,139,643,82800,47957
75,61,14,595,61400,47958
1000,763,237,628,83600,47959
6190,4812,1378,705,114700,47960
782,560,222,735,108800,47963
56,45,11,438,72500,47964
210,172,38,914,85900,47965
161,155,6,625,42300,47966
250,195,55,908,109200,47967
390,363,27,850,122900,47968
50,34,16,950,58900,47969
777,567,210,796,103100,47970
692,564,128,735,82700,47971
517,374,143,643,85300,47974
337,241,96,709,103100,47975
872,651,221,680,115900,47977
4258,2964,1294,727,142100,47978
431,376,55,673,96300,47980
302,250,52,829,206800,47981
81,73,8,750,57900,47982
132,86,46,-,67100,47983
1669,1300,369,597,83600,47987
475,414,61,675,86700,47989
644,529,115,816,94300,47990
430,322,108,838,79300,47991
574,547,27,-,147500,47992
1461,1169,292,755,112700,47993
161,123,38,663,68300,47994
648,542,106,686,110400,47995
51,42,9,665,84300,47997
5332,4170,1162,847,137600,48001
1212,1122,90,1016,174900,48002
2337,2026,311,876,168100,48003
2061,1864,197,700,181600,48005
1466,1355,111,830,159700,48006
8982,6713,2269,1414,467700,48009
1537,1203,334,855,121100,48014
3618,1786,1832,614,63700,48015
5634,4059,1575,841,156100,48017
12502,7914,4588,1056,64700,48021
944,899,45,644,154100,48022
2021,1654,367,1061,167000,48023
5790,5229,561,1328,366500,48025
6170,4343,1827,756,128000,48026
1237,1103,134,1047,155500,48027
532,517,15,-,283200,48028
7107,3598,3509,928,55500,48030
795,732,63,863,155600,48032
7712,3074,4638,1026,102000,48033
7168,1446,5722,1042,163600,48034
14648,8592,6056,905,114000,48035
9216,6671,2545,772,113400,48036
19853,12501,7352,916,163600,48038
3181,2503,678,798,125200,48039
4191,3268,923,770,123200,48040
1708,1375,333,774,168100,48041
10115,9919,196,1688,251300,48042
6785,3830,2955,719,87000,48043
18863,17039,1824,1216,240800,48044
11403,7879,3524,853,163400,48045
15646,12283,3363,879,192400,48047
2545,1997,548,952,115200,48048
2156,1923,233,850,148000,48049
647,585,62,1085,231400,48050
6150,5083,1067,850,154900,48051
2913,2482,431,871,180100,48054
5966,4461,1505,794,145200,48059
16393,9312,7081,766,85500,48060
3415,2759,656,658,174600,48062
1498,1224,274,891,200700,48063
1483,1370,113,867,178300,48064
4139,3530,609,967,225400,48065
19622,12328,7294,955,71600,48066
12370,8076,4294,1080,196500,48067
1058,1003,55,1444,295900,48069
2447,2377,70,1729,321400,48070
12868,7592,5276,889,91300,48071
6504,5299,1205,1067,172800,48072
16196,10849,5347,941,188600,48073
3493,3110,383,681,119800,48074
9176,5305,3871,996,118000,48075
9832,7147,2685,1117,143800,48076
4920,4089,831,694,164700,48079
10617,7537,3080,955,106400,48080
8911,7260,1651,963,121600,48081
7224,6093,1131,1017,113900,48082
9234,5608,3626,1015,197700,48083
6613,3156,3457,1122,304200,48084
8550,7810,740,1428,268200,48085
9063,7398,1665,892,121300,48088
12041,6543,5498,921,59500,48089
11947,7977,3970,866,70500,48091
10428,7929,2499,899,121000,48092
9957,7385,2572,826,116800,48093
7230,5957,1273,1206,261400,48094
1983,1797,186,870,310000,48095
1603,1447,156,970,191200,48096
2023,1552,471,697,115300,48097
7123,6434,689,1162,360300,48098
10928,9244,1684,973,108900,48101
23323,15753,7570,1220,299900,48103
15925,6204,9721,1247,299900,48104
14651,7094,7557,1186,330700,48105
10961,5570,5391,935,237600,48108
0,0,0,-,-,48109
16465,11228,5237,870,152000,48111
7688,7257,431,955,253300,48114
11123,9177,1946,951,239000,48116
3715,3389,326,923,157000,48117
4999,3923,1076,1033,236800,48118
2239,824,1415,991,150500,48120
3769,2176,1593,822,60100,48122
11987,9251,2736,1023,121700,48124
7663,5676,1987,1001,68600,48125
12703,7016,5687,974,115000,48126
12820,9069,3751,984,121300,48127
3885,3287,598,1329,149300,48128
5494,4809,685,1131,305400,48130
2978,2153,825,831,153500,48131
2259,1965,294,846,115500,48133
7949,6489,1460,768,163600,48134
10511,8578,1933,1007,88300,48135
1939,1852,87,1161,204600,48137
4088,3738,350,967,259500,48138
92,68,24,-,214300,48139
1235,1113,122,685,183800,48140
9348,4456,4892,808,44300,48141
0,0,0,-,-,48143
3903,3520,383,997,176600,48144
1284,1139,145,981,162100,48145
14408,9868,4540,859,64700,48146
10297,8761,1536,1133,146900,48150
12466,9925,2541,964,189400,48152
14423,12843,1580,1061,184000,48154
624,448,176,592,115600,48157
2961,2474,487,711,208800,48158
904,825,79,777,142700,48159
4277,3485,792,887,167300,48160
10529,7793,2736,725,111100,48161
11259,7760,3499,743,139700,48162
2965,2757,208,1020,215200,48164
2767,2086,681,1265,221200,48165
4143,3621,522,1011,110700,48166
8995,6606,2389,1143,284900,48167
8022,7298,724,1355,413900,48168
8251,7468,783,893,216400,48169
16479,12528,3951,888,273000,48170
4708,3793,915,809,152600,48173
11559,8219,3340,824,78500,48174
8163,6819,1344,760,277700,48176
71,37,34,-,105200,48177
12475,10862,1613,923,255200,48178
1402,1101,301,1030,177300,48179
23666,15423,8243,846,81200,48180
8446,7352,1094,762,164900,48182
17378,12597,4781,754,140000,48183
6622,3710,2912,732,68700,48184
21584,11689,9895,827,113900,48185
13512,9101,4411,878,94900,48186
17930,12708,5222,988,219200,48187
14637,11872,2765,1243,229900,48188
5586,4441,1145,946,178800,48189
49,49,0,-,-,48190
1387,1169,218,1267,170000,48191
11113,8069,3044,761,89700,48192
6194,4077,2117,766,133500,48193
12650,8056,4594,824,95400,48195
25435,12784,12651,908,174100,48197
16021,8727,7294,846,95900,48198
8167,700,7467,565,227800,48201
7570,1991,5579,634,80200,48202
9814,4028,5786,651,34700,48203
9420,4607,4813,756,31000,48204
12916,5281,7635,928,30600,48205
6380,3037,3343,723,48100,48206
11453,2680,8773,795,81000,48207
3965,1444,2521,607,59300,48208
10125,4878,5247,670,38500,48209
9011,4985,4026,722,29700,48210
2199,820,1379,708,30100,48211
10952,6259,4693,686,42800,48212
8282,4025,4257,664,28700,48213
9849,3717,6132,677,50800,48214
4855,2129,2726,735,52700,48215
2371,881,1490,580,73900,48216
2810,1667,1143,770,46600,48217
2821,1598,1223,633,34800,48218
19038,10066,8972,836,42700,48219
11002,6754,4248,914,126800,48220
14866,9451,5415,853,66900,48221
9398,5164,4234,778,59500,48223
14399,8080,6319,917,41700,48224
5389,3177,2212,1038,67700,48225
3795,501,3294,1160,203400,48226
15180,8300,6880,829,45300,48227
18744,9842,8902,820,32000,48228
3696,2061,1635,782,37900,48229
6450,4922,1528,1010,329600,48230
0,0,0,-,-,48233
12530,7097,5433,796,35300,48234
17293,10264,7029,873,48800,48235
11168,9882,1286,1255,243200,48236
11601,6702,4899,989,90600,48237
10601,5218,5383,764,34800,48238
13459,10079,3380,1068,72500,48239
6819,4802,2017,1161,65100,48240
0,0,0,-,-,48242
0,0,0,-,-,48243
5512,4846,666,1561,443900,48301
6265,5421,844,968,424800,48302
6379,5624,755,1383,346000,48304
9706,8963,743,1157,368900,48306
17709,11590,6119,1145,233300,48307
10925,8885,2040,1235,272400,48309
14892,10686,4206,1034,167500,48310
13455,9306,4149,852,155000,48312
13172,9627,3545,921,164800,48313
8319,6016,2303,986,202900,48314
10565,9185,1380,1061,255500,48315
10633,8409,2224,941,225200,48316
11574,7025,4549,967,157100,48317
2286,1526,760,959,160100,48320
12434,9141,3293,1680,261700,48322
6611,6002,609,1863,325400,48323
6400,5769,631,1228,287000,48324
9351,4342,5009,1023,138000,48326
9347,6282,3065,796,151300,48327
11159,6817,4342,796,130200,48328
9859,8409,1450,1144,155600,48329
8387,6517,1870,1437,277400,48331
8119,4854,3265,1221,216100,48334
10642,4372,6270,1030,247800,48335
11106,7491,3615,853,163500,48336
9842,3952,5890,782,49800,48340
6593,2986,3607,824,66300,48341
6890,2727,4163,720,56400,48342
9062,6502,2560,1044,190000,48346
8554,8129,425,1304,290700,48348
2750,2494,256,881,219500,48350
2511,2155,356,733,202100,48353
3322,3012,310,1022,195400,48356
3190,2888,302,881,205500,48357
3518,2469,1049,1072,230200,48359
4253,3548,705,1028,256200,48360
5871,4869,1002,940,221000,48362
2000,1931,69,1179,345400,48363
1728,1603,125,1163,251500,48367
690,617,73,-,318400,48370
8918,7682,1236,887,220500,48371
4934,4398,536,1892,398200,48374
8549,5583,2966,1336,238000,48375
7516,3530,3986,999,242200,48377
2521,2440,81,-,257200,48380
5432,4037,1395,996,258900,48381
8193,7601,592,1298,268100,48382
4848,4531,317,1220,217000,48383
6896,6051,845,886,206000,48386
10117,7457,2660,1108,187900,48390
7160,3954,3206,683,203800,48393
0,0,0,-,-,48397
596,525,71,833,95900,48401
36,36,0,-,-,48411
2079,1905,174,743,152300,48412
2948,2309,639,619,100000,48413
979,813,166,883,116800,48414
3833,3259,574,739,132400,48415
1837,1485,352,601,115600,48416
975,900,75,926,101900,48417
1528,1353,175,747,156600,48418
1027,850,177,750,94400,48419
8844,7081,1763,644,107600,48420
2437,2246,191,882,124200,48421
2674,2072,602,715,96500,48422
13862,9202,4660,678,125900,48423
390,312,78,550,88000,48426
1122,885,237,610,86400,48427
1853,1633,220,998,214000,48428
3742,2852,890,690,101000,48429
14705,11491,3214,971,183000,48430
281,259,22,883,100200,48432
10203,8767,1436,775,121500,48433
36,30,6,-,100000,48434
680,611,69,631,111000,48435
1428,1314,114,781,150200,48436
272,179,93,592,83200,48437
2642,2407,235,1073,190200,48438
19281,13879,5402,774,154500,48439
70,53,17,-,-,48440
1689,1338,351,479,94700,48441
7890,6331,1559,967,159700,48442
3307,2416,891,810,151500,48444
527,417,110,608,81400,48445
11864,9005,2859,765,134800,48446
1142,936,206,726,93800,48449
2295,1985,310,613,119400,48450
5244,4722,522,771,170900,48451
1926,1456,470,612,94300,48453
461,432,29,833,95700,48454
3122,2778,344,815,225900,48455
332,299,33,469,94200,48456
2980,2601,379,687,102800,48457
7889,5355,2534,694,55100,48458
913,765,148,600,130200,48460
3061,2522,539,780,142300,48461
4926,4489,437,1040,216400,48462
1866,1663,203,725,105900,48463
794,711,83,854,129000,48464
266,216,50,513,115900,48465
600,495,105,623,85600,48466
1130,984,146,586,130800,48467
584,521,63,628,92400,48468
585,464,121,504,132600,48469
325,270,55,596,97300,48470
2237,1604,633,588,90200,48471
651,565,86,875,107400,48472
8745,7483,1262,841,125500,48473
1039,871,168,652,105500,48475
193,181,12,933,85300,48476
138,6,132,660,-,48502
11331,6420,4911,684,43500,48503
11089,6430,4659,757,33000,48504
8621,5009,3612,670,22700,48505
11272,7431,3841,685,44100,48506
12958,8002,4956,689,54200,48507
3758,3342,416,932,85800,48509
3006,1933,1073,804,80300,48519
3890,2301,1589,709,42700,48529
8203,5106,3097,748,79300,48532
0,0,0,-,-,48551
0,0,0,-,-,48553
0,0,0,-,-,48554
14769,9422,5347,655,39900,48601
12003,7434,4569,694,49700,48602
11836,7627,4209,826,123100,48603
4149,2812,1337,821,80200,48604
635,313,322,550,38000,48607
4988,4343,645,675,124300,48609
1359,1225,134,738,90000,48610
2566,2035,531,746,127600,48611
3979,3312,667,614,90700,48612
387,337,50,904,110600,48613
563,478,85,786,96400,48614
1218,953,265,608,84100,48615
2928,2427,501,627,105200,48616
3428,2524,904,583,111700,48617
2218,1793,425,595,89100,48618
255,235,20,857,96500,48619
494,386,108,617,102200,48621
2518,2202,316,773,101000,48622
4756,4060,696,972,153700,48623
6635,5514,1121,583,104800,48624
5533,4533,1000,567,71700,48625
2289,1983,306,720,132000,48626
43,41,2,-,-,48627
932,845,87,751,117200,48628
3351,2558,793,642,101800,48629
14,14,0,-,-,48630
1747,1590,157,622,117300,48631
2104,1845,259,729,80600,48632
92,87,5,-,-,48633
1885,1734,151,675,111500,48634
766,683,83,751,93300,48635
396,371,25,702,85300,48636
1263,1105,158,710,106800,48637
5679,3677,2002,719,111800,48638
13305,9753,3552,705,144000,48640
13149,9528,3621,824,137200,48642
1881,1515,366,668,78700,48647
533,491,42,750,97700,48649
3093,2707,386,739,103200,48650
2416,1988,428,644,106200,48651
639,587,52,588,102100,48652
4598,3972,626,701,103800,48653
965,827,138,531,89300,48654
2440,2018,422,650,103500,48655
1833,1540,293,590,62500,48656
3350,2984,366,831,122700,48657
2140,1591,549,557,85800,48658
1067,901,166,620,84800,48659
4549,3599,950,675,104000,48661
639,569,70,921,101500,48662
0,0,0,-,-,48667
628,508,120,858,70700,48701
1490,1265,225,614,102500,48703
290,246,44,528,87200,48705
16430,13066,3364,666,101400,48706
11282,8011,3271,591,73700,48708
0,0,0,-,-,48710
439,383,56,632,89800,48720
243,237,6,-,125700,48721
1320,1188,132,680,92000,48722
4979,3753,1226,656,91300,48723
205,171,34,-,70900,48724
1126,909,217,536,112900,48725
2290,1911,379,639,92600,48726
445,418,27,1025,92800,48727
140,129,11,-,121600,48728
607,544,63,828,102900,48729
2102,1490,612,588,106300,48730
660,484,176,521,87200,48731
4790,3277,1513,619,108600,48732
698,615,83,723,84300,48733
3176,2412,764,646,175100,48734
458,378,80,588,71900,48735
587,511,76,608,73300,48737
634,571,63,612,125800,48738
1923,1731,192,626,92800,48739
1044,864,180,721,101300,48740
802,646,156,664,97500,48741
793,707,86,547,89800,48742
33,33,0,-,74500,48743
1704,1404,300,710,101000,48744
530,442,88,516,71300,48745
3302,2917,385,770,118000,48746
636,593,43,933,126000,48747
896,771,125,626,92400,48748
443,393,50,662,91300,48749
3802,2900,902,620,82000,48750
357,317,40,491,76300,48754
1396,1129,267,674,117900,48755
2016,1657,359,638,57800,48756
1548,1334,214,635,111900,48757
1397,1135,262,546,79900,48759
512,431,81,745,95900,48760
472,401,71,410,74900,48761
488,480,8,920,120400,48762
2028,1739,289,686,106500,48763
323,287,36,688,78900,48765
545,483,62,806,80900,48766
798,730,68,711,91800,48767
3792,3022,770,640,103300,48768
820,711,109,561,81300,48770
4946,3181,1765,632,89500,48801
629,525,104,670,96400,48806
306,255,51,750,85900,48807
2321,1826,495,929,167100,48808
4098,3107,991,659,103200,48809
1220,911,309,606,92300,48811
8200,6283,1917,756,135900,48813
837,729,108,793,138900,48815
33,27,6,-,81000,48816
2399,1632,767,783,102300,48817
1042,818,224,757,90700,48818
955,864,91,930,152500,48819
6419,5218,1201,873,205100,48820
2505,2327,178,724,167400,48821
1128,1085,43,771,171400,48822
19816,8222,11594,911,183600,48823
0,0,0,-,-,48825
6158,4954,1204,811,144400,48827
1209,825,384,615,85200,48829
1375,1068,307,755,111100,48831
556,501,55,698,90000,48832
761,624,137,753,114300,48834
1046,899,147,711,146700,48835
5018,4188,830,880,162800,48836
8018,6284,1734,760,162500,48837
7120,5106,2014,728,118100,48838
5830,3720,2110,780,175600,48840
284,270,14,1042,97500,48841
8939,6384,2555,827,147600,48842
16776,12708,4068,983,216300,48843
375,319,56,595,93900,48845
6112,4306,1806,760,100100,48846
2297,1705,592,743,96200,48847
2989,2690,299,783,163400,48848
2367,1906,461,649,118800,48849
1659,1390,269,581,91000,48850
867,721,146,715,113000,48851
57,34,23,710,48700,48852
260,197,63,500,87800,48853
7269,5758,1511,919,161400,48854
5469,4908,561,997,203900,48855
416,248,168,781,80000,48856
977,841,136,815,115900,48857
17218,8626,8592,727,133600,48858
558,393,165,671,87400,48860
585,488,97,706,110700,48861
9073,5706,3367,946,222400,48864
740,524,216,832,96300,48865
1852,1536,316,638,117600,48866
11263,7899,3364,677,97700,48867
61,45,16,-,76100,48870
711,598,113,745,125800,48871
2700,2120,580,786,129300,48872
566,504,62,633,125000,48873
43,34,9,-,80800,48874
3788,3150,638,856,145300,48875
1573,1231,342,695,114200,48876
931,786,145,673,81400,48877
571,510,61,694,108300,48878
6777,5253,1524,735,150200,48879
2453,1749,704,607,86400,48880
2362,1952,410,591,146300,48881
2776,2338,438,640,115700,48883
1706,1396,310,703,96500,48884
337,280,57,508,113900,48885
818,662,156,602,84600,48886
2375,1926,449,686,105700,48888
509,441,68,958,101800,48889
812,706,106,725,138400,48890
1133,884,249,658,104400,48891
1690,1384,306,892,136900,48892
2103,1853,250,810,127700,48893
615,545,70,673,162200,48894
4498,3745,753,772,198900,48895
69,53,16,820,52100,48896
549,433,116,806,135800,48897
10402,6948,3454,747,87100,48906
15849,8431,7418,843,75200,48910
15806,7934,7872,755,86200,48911
7787,3635,4152,826,88000,48912
3638,1948,1690,842,74300,48915
14636,8226,6410,849,139700,48917
0,0,0,-,-,48921
1545,75,1470,673,106800,48933
9042,4530,4512,739,86200,49001
8311,5675,2636,645,138400,49002
6253,4684,1569,864,109500,49004
10009,4058,5951,791,120500,49006
4364,1239,3125,685,54300,49007
6695,3943,2752,712,145900,49008
18697,12088,6609,794,207300,49009
6755,5380,1375,797,117800,49010
808,708,100,823,105500,49011
1372,1177,195,706,161600,49012
1960,1468,492,656,87000,49013
8364,6224,2140,755,117200,49014
10942,7472,3470,796,115100,49015
8956,6581,2375,752,99200,49017
2489,2090,399,781,122100,49021
12972,6983,5989,668,91600,49022
11678,7930,3748,835,161800,49024
934,760,174,641,112700,49026
82,67,15,775,155900,49027
2494,1928,566,677,96900,49028
587,526,61,788,99200,49029
843,677,166,641,89300,49030
2966,2234,732,720,132000,49031
1117,909,208,638,114700,49032
660,589,71,781,190200,49033
1017,928,89,645,138200,49034
8841,6310,2531,713,103600,49036
8542,4450,4092,640,61200,49037
3767,2764,1003,736,127900,49038
1336,906,430,703,117300,49040
1921,1516,405,586,102800,49042
857,551,306,586,88000,49043
1919,1438,481,774,99000,49045
3409,2783,626,760,143600,49046
6032,4446,1586,593,104300,49047
9765,6065,3700,770,97800,49048
576,544,32,906,130600,49050
900,852,48,947,140200,49051
352,288,64,669,103100,49052
2705,2142,563,603,146700,49053
2354,1944,410,653,109700,49055
1294,1080,214,833,80900,49056
2308,1722,586,686,86400,49057
7467,5653,1814,817,119800,49058
656,547,109,516,252800,49060
611,552,59,-,124400,49061
1444,1126,318,629,121500,49064
2535,2141,394,745,132500,49065
252,217,35,775,118800,49066
1768,1481,287,845,120500,49067
6110,4516,1594,713,137500,49068
974,865,109,638,130300,49070
3283,2912,371,869,189300,49071
1255,1040,215,769,138700,49072
1873,1422,451,734,99600,49073
59,0,59,402,-,49074
52,29,23,-,81500,49075
1440,1127,313,728,137700,49076
3590,2806,784,662,124700,49078
5332,4081,1251,663,137800,49079
6103,4960,1143,714,144800,49080
2313,1928,385,733,93800,49082
2996,2477,519,723,211400,49083
7,0,7,-,-,49084
10014,7357,2657,793,184600,49085
2413,2168,245,717,194600,49087
1316,1193,123,1022,180000,49088
619,493,126,640,73400,49089
6193,4426,1767,670,151600,49090
7720,5444,2276,720,105800,49091
778,603,175,779,98500,49092
7263,5388,1875,687,114600,49093
1654,1354,300,628,86400,49094
868,727,141,775,197400,49095
1208,1028,180,804,115400,49096
4061,3489,572,811,161100,49097
2496,1945,551,661,115300,49098
2157,1553,604,677,116800,49099
1243,1055,188,780,158000,49101
518,397,121,1278,165700,49102
3533,2136,1397,657,153100,49103
0,0,0,-,-,49104
2137,1643,494,708,168600,49106
4195,2993,1202,621,121600,49107
1320,1124,196,790,117700,49111
3823,3188,635,746,142800,49112
724,597,127,770,118800,49113
232,232,0,-,385200,49115
126,126,0,-,347500,49116
1775,1399,376,843,262300,49117
48,43,5,-,82900,49119
14899,10905,3994,693,108000,49120
1003,825,178,599,191100,49125
502,416,86,811,126000,49126
4450,3474,976,848,182000,49127
1506,1227,279,774,152900,49128
270,232,38,741,341700,49129
719,526,193,833,223100,49130
15392,11541,3851,724,142000,49201
8638,4360,4278,701,64900,49202
15397,10173,5224,774,90500,49203
926,750,176,712,125900,49220
14690,10404,4286,729,106400,49221
5239,3656,1583,644,71100,49224
479,401,78,713,88800,49227
2256,1832,424,761,117100,49228
1265,1140,125,779,165800,49229
4404,3763,641,918,168200,49230
894,708,186,757,137000,49232
986,832,154,825,146600,49233
1172,1054,118,842,193300,49234
805,658,147,755,106800,49235
1857,1590,267,677,145100,49236
1098,936,162,728,130900,49237
653,468,185,845,121300,49238
3624,3160,464,813,197100,49240
1021,920,101,725,130200,49241
5648,3689,1959,655,99700,49242
1846,1329,517,665,96600,49245
1340,1237,103,538,168300,49246
2222,1780,442,851,93900,49247
327,270,57,933,103100,49248
1664,1446,218,800,148300,49249
2424,2012,412,714,97300,49250
2304,1997,307,835,122300,49251
1050,731,319,645,95800,49252
1394,1255,139,914,182200,49253
1301,1002,299,742,100600,49254
697,575,122,799,86800,49255
1597,1198,399,772,86700,49256
803,714,89,948,113800,49259
130,110,20,-,49800,49261
493,360,133,652,76100,49262
39,30,9,-,140000,49263
729,676,53,850,142400,49264
2121,1850,271,850,177000,49265
1285,1083,202,811,105500,49266
1570,1234,336,738,172000,49267
426,320,106,650,104500,49268
2320,1985,335,743,112200,49269
2113,1825,288,857,166100,49270
793,643,150,807,105300,49271
1040,970,70,687,160400,49272
1307,1052,255,725,106300,49274
319,281,38,1048,116000,49276
1386,1210,176,821,135800,49277
291,245,46,980,124700,49279
154,132,22,956,-,49282
1257,975,282,607,150500,49283
1137,879,258,787,99300,49284
2117,1783,334,691,151600,49285
5861,4568,1293,769,141000,49286
737,701,36,958,179500,49287
527,413,114,681,69100,49288
80,55,25,811,66800,49289
6612,6228,384,1421,332900,49301
2892,2707,185,833,241000,49302
340,310,30,1025,116400,49303
1624,1228,396,528,75100,49304
862,714,148,592,93500,49305
3724,3609,115,907,194900,49306
6813,3989,2824,629,122000,49307
744,607,137,703,77100,49309
1087,967,120,671,117000,49310
151,134,17,525,73300,49312
8032,7086,946,890,215800,49315
7622,6652,970,1009,214800,49316
550,492,58,704,124100,49318
6196,5226,970,735,139400,49319
38,34,4,-,50000,49320
6714,4087,2627,755,152200,49321
531,429,102,806,105400,49322
3409,3266,143,582,167400,49323
627,556,71,800,128700,49325
1628,1419,209,693,110800,49326
3142,2503,639,721,118200,49327
1435,1274,161,632,146100,49328
3026,2661,365,796,109900,49329
1802,1549,253,718,135000,49330
6299,5313,986,826,170800,49331
1214,1044,170,593,97100,49332
4249,3551,698,915,167400,49333
158,158,0,-,159600,49335
1578,1339,239,768,92800,49336
4946,4097,849,703,106500,49337
656,572,84,750,101400,49338
911,818,93,779,128900,49339
1094,899,195,525,101400,49340
12395,11250,1145,876,205800,49341
767,615,152,687,112800,49342
2109,1683,426,688,126400,49343
1434,1131,303,811,158600,49344
5019,4063,956,731,150200,49345
2327,2130,197,902,157400,49346
510,420,90,727,101000,49347
4607,3608,999,826,156200,49348
3088,2521,567,658,82900,49349
6297,3066,3231,934,173100,49401
570,497,73,765,93900,49402
908,840,68,939,201700,49403
3122,2615,507,688,145900,49404
562,511,51,678,121900,49405
368,303,65,1306,341900,49406
3679,3022,657,734,133300,49408
841,635,206,722,95400,49410
644,588,56,670,118800,49411
4218,3423,795,564,116000,49412
2721,2425,296,785,145500,49415
12234,9702,2532,818,164100,49417
10727,7972,2755,778,172000,49418
2649,2487,162,948,183300,49419
2348,1711,637,628,97300,49420
2273,1942,331,613,84700,49421
16479,11043,5436,827,145600,49423
17674,13312,4362,866,164500,49424
1297,1002,295,806,102400,49425
11907,10566,1341,883,190900,49426
10002,8369,1633,900,159600,49428
7513,5439,2074,693,136500,49431
17,17,0,-,-,49434
1401,1223,178,875,173100,49435
665,585,80,570,167000,49436
2743,2249,494,651,121500,49437
588,82,506,496,106300,49440
15369,10687,4682,757,103600,49441
14964,9467,5497,693,70200,49442
9949,7040,2909,681,80500,49444
7975,7183,792,818,128500,49445
964,891,73,618,108200,49446
1361,1268,93,838,175500,49448
1163,990,173,712,213200,49449
1080,608,472,663,108900,49450
2114,1832,282,629,125500,49451
730,627,103,763,84900,49452
1234,998,236,733,288800,49453
1745,1428,317,667,113000,49454
1841,1360,481,672,97500,49455
7751,5936,1815,811,187300,49456
3749,3303,446,729,121500,49457
55,52,3,-,114000,49458
483,397,86,711,82700,49459
2870,2698,172,745,200700,49460
3580,2894,686,693,143700,49461
9986,8676,1310,888,167800,49464
15225,5960,9265,826,117700,49503
15173,9178,5995,791,118500,49504
13080,8495,4585,850,123700,49505
12085,8947,3138,931,207800,49506
12318,6974,5344,861,86900,49507
15084,8791,6293,877,141500,49508
10022,6923,3099,715,94600,49509
7476,3144,4332,837,170600,49512
11470,6356,5114,809,122700,49519
11190,8714,2476,881,171400,49525
8747,5953,2794,810,165000,49534
3991,2178,1813,793,144500,49544
12590,8401,4189,939,250700,49546
11768,8205,3563,795,82200,49548
8672,6481,2191,705,97300,49601
90,67,23,694,54100,49611
499,453,46,1042,160700,49612
296,271,25,875,158500,49613
1051,950,101,758,135600,49614
1705,1444,261,686,175000,49615
715,538,177,610,124400,49616
1309,1193,116,547,175900,49617
312,284,28,950,105000,49618
423,382,41,1000,95400,49619
1000,817,183,938,125800,49620
1284,1148,136,967,200000,49621
1140,927,213,638,124500,49622
417,388,29,592,85100,49623
502,454,48,685,98800,49625
151,143,8,-,75500,49626
95,85,10,-,241700,49627
76,66,10,-,118800,49628
1064,825,239,788,244300,49629
658,599,59,535,261200,49630
2420,1914,506,524,95600,49631
471,363,108,775,88600,49632
1582,1358,224,724,104400,49633
26,26,0,-,82700,49634
1533,1307,226,697,202500,49635
197,197,0,-,673300,49636
1290,1168,122,856,140600,49637
339,290,49,507,88600,49638
840,717,123,753,95100,49639
658,592,66,784,173000,49640
339,256,83,417,67900,49642
2603,2304,299,792,159800,49643
911,863,48,656,91500,49644
635,568,67,830,88100,49645
3420,2533,887,664,99900,49646
858,818,40,635,325700,49648
2229,1980,249,892,136400,49649
1225,1158,67,900,162700,49650
3242,2629,613,751,104300,49651
773,633,140,917,242600,49653
339,277,62,850,387700,49654
1201,1075,126,725,99200,49655
574,502,72,715,76300,49656
1342,1101,241,655,117200,49657
2647,2242,405,680,81900,49659
5725,4438,1287,632,117500,49660
2245,1811,434,677,104700,49663
792,710,82,717,238800,49664
1638,1361,277,588,84200,49665
63,63,0,-,-,49666
221,184,37,839,77100,49667
1372,1063,309,780,89000,49668
939,842,97,656,284800,49670
20,20,0,-,195800,49674
448,383,65,613,197900,49675
1489,1271,218,640,161200,49676
2818,2157,661,587,82600,49677
478,426,52,544,99200,49679
639,536,103,717,96200,49680
1676,1417,259,711,262600,49682
807,670,137,632,102700,49683
16174,12064,4110,962,200200,49684
13852,10297,3555,877,202500,49686
1012,897,115,696,115700,49688
578,526,52,863,97600,49689
2904,2385,519,949,216700,49690
453,288,165,625,154800,49701
341,270,71,580,100000,49705
1859,1521,338,726,122800,49706
9973,7365,2608,577,93300,49707
1575,1414,161,555,89900,49709
250,200,50,462,154000,49710
3380,2724,656,730,158800,49712
838,735,103,958,154200,49713
1275,1066,209,525,124200,49715
355,328,27,1057,162500,49716
117,93,24,-,363000,49717
347,308,39,800,113700,49718
673,505,168,529,158900,49719
3952,3052,900,688,174200,49720
6284,5013,1271,663,109700,49721
142,111,31,-,147100,49722
426,378,48,830,128800,49724
348,313,35,292,107900,49725
568,491,77,515,164000,49726
2975,2495,480,683,119800,49727
122,107,15,-,114400,49728
605,505,100,703,112500,49729
831,748,83,750,115700,49730
964,803,161,853,103800,49733
7928,6222,1706,756,129300,49735
251,228,23,-,94400,49736
4180,3207,973,714,90200,49738
3131,2700,431,901,225300,49740
325,304,21,588,106400,49743
377,368,9,-,96700,49744
419,373,46,389,120800,49745
1464,1279,185,579,102000,49746
835,717,118,669,126500,49747
75,66,9,538,100000,49748
1873,1480,393,630,140700,49749
851,778,73,806,124500,49751
205,155,50,-,76300,49752
884,831,53,489,101700,49753
893,729,164,720,146200,49755
1670,1514,156,781,82600,49756
369,147,222,490,525000,49757
694,658,36,758,111600,49759
318,295,23,1090,116900,49760
346,305,41,929,116500,49762
101,30,71,644,-,49764
1741,1547,194,579,87900,49765
944,742,202,516,89800,49766
147,120,27,-,133300,49768
673,484,189,848,96700,49769
7518,4998,2520,779,183000,49770
797,707,90,625,121700,49774
53,48,5,-,116700,49775
805,688,117,494,91800,49776
858,829,29,1125,170200,49777
2088,1695,393,535,83700,49779
712,633,79,950,101100,49780
1850,1191,659,572,115700,49781
280,251,29,644,207800,49782
7853,4965,2888,640,106900,49783
1055,433,622,637,81600,49788
110,101,9,758,120200,49791
129,108,21,-,139300,49793
876,686,190,642,89000,49795
197,151,46,731,-,49796
959,851,108,751,94500,49799
4851,3755,1096,630,98800,49801
2756,1894,862,664,90100,49802
73,73,0,-,155400,49805
253,248,5,-,174100,49806
1353,1191,162,741,124000,49807
123,107,16,-,208900,49808
402,339,63,582,103500,49812
563,506,57,653,86900,49814
196,172,24,470,66300,49815
277,265,12,-,115500,49816
216,196,20,630,146400,49817
428,403,25,758,137000,49818
13,13,0,-,106300,49819
105,85,20,520,150700,49820
576,517,59,634,104600,49821
107,86,21,700,122400,49822
88,83,5,-,145800,49825
112,96,16,-,118800,49826
362,301,61,536,126800,49827
7747,5537,2210,547,92900,49829
309,292,17,893,100500,49831
154,134,20,-,162300,49833
93,84,9,-,110300,49834
404,369,35,1016,114600,49835
391,352,39,575,118400,49836
4034,3486,548,550,108800,49837
221,184,37,978,113100,49838
141,119,22,-,151400,49839
291,265,26,754,129300,49840
2904,1879,1025,628,104300,49841
466,377,89,495,84000,49847
60,57,3,-,102300,49848
5140,4204,936,564,98900,49849
55,48,7,575,81700,49852
529,489,40,600,108200,49853
2538,1931,607,620,105800,49854
12499,7511,4988,719,177200,49855
5729,4271,1458,559,91400,49858
269,251,18,625,141100,49861
1564,1261,303,572,109600,49862
68,68,0,-,43300,49863
36,26,10,-,60000,49864
3038,2394,644,606,140000,49866
1764,1288,476,637,77200,49868
1652,1323,329,877,78800,49870
215,179,36,563,63400,49871
68,62,6,-,95000,49872
35,35,0,-,-,49873
384,289,95,472,110800,49874
379,355,24,-,82200,49876
15,13,2,-,48300,49877
1522,1331,191,606,124800,49878
442,401,41,600,80300,49879
449,410,39,823,94800,49880
143,122,21,817,82300,49881
42,36,6,-,72000,49883
178,166,12,-,76900,49884
852,767,85,655,157400,49885
239,208,31,750,83800,49886
1113,913,200,599,97900,49887
238,226,12,925,106800,49891
857,765,92,639,143900,49892
705,637,68,525,108900,49893
253,234,19,-,153200,49894
245,222,23,-,167000,49895
541,383,158,470,119700,49896
157,129,28,1328,49700,49901
72,67,5,-,36300,49902
46,38,8,-,71400,49903
642,553,89,845,121400,49905
694,490,204,579,102300,49908
178,159,19,461,81700,49910
1264,978,286,368,59600,49911
462,400,62,481,102200,49912
2796,2156,640,523,68500,49913
202,179,23,757,46100,49915
1045,878,167,698,145500,49916
101,98,3,-,51100,49917
56,41,15,408,259600,49918
107,99,8,-,75000,49919
1841,1583,258,576,90300,49920
100,68,32,746,102500,49921
275,208,67,892,116900,49922
193,164,29,381,77400,49925
217,204,13,775,72500,49927
80,79,1,-,49600,49929
2634,1573,1061,657,119500,49930
3152,1457,1695,729,146000,49931
333,290,43,710,64000,49934
2906,2290,616,453,71000,49935
3449,2555,894,520,65100,49938
90,74,16,-,59700,49942
1057,875,182,495,110200,49945
1719,1436,283,556,84100,49946
273,263,10,-,133000,49947
219,215,4,-,66900,49948
612,521,91,425,101400,49950
45,35,10,-,89400,49952
1277,1082,195,448,69900,49953
159,154,5,-,56900,49955
366,353,13,-,117400,49958
177,118,59,527,51700,49959
85,75,10,375,54500,49960
40,38,2,-,63300,49961
94,94,0,-,117500,49962
371,256,115,605,87600,49963
168,167,1,-,-,49965
225,205,20,-,87500,49967
936,766,170,533,65800,49968
603,497,106,653,176800,49969
124,124,0,-,104700,49970
227,217,10,575,42200,49971
252,215,37,844,223200,50001
600,429,171,648,121200,50002
2792,2334,458,739,231200,50003
360,324,36,746,92300,50005
664,489,175,605,95500,50006
171,167,4,-,165300,50007
418,333,85,521,71300,50008
6947,5187,1760,840,180300,50009
14356,7301,7055,829,175000,50010
0,0,0,-,-,50011
12,0,12,633,-,50012
12314,3895,8419,915,245500,50014
568,411,157,612,77800,50020
10127,7301,2826,1121,194400,50021
3837,2529,1308,641,100400,50022
12160,9395,2765,879,207500,50023
1440,1113,327,617,66900,50025
290,236,54,634,83500,50026
111,84,27,600,58300,50027
614,469,145,921,126900,50028
238,211,27,488,53200,50029
129,129,0,-,-,50032
6,3,3,-,-,50033
138,113,25,555,85400,50034
2339,1987,352,973,192600,50035
6966,5140,1826,665,123600,50036
52,52,0,-,121400,50038
104,82,22,542,105600,50039
23,23,0,-,-,50041
136,105,31,925,76500,50042
407,305,102,492,78300,50044
564,485,79,965,153600,50046
2272,1829,443,760,163400,50047
353,291,62,614,74400,50048
2879,2139,740,678,84400,50049
308,247,61,445,69200,50050
149,115,34,343,57500,50051
60,53,7,-,57500,50052
1228,988,240,592,130400,50054
362,305,57,900,151000,50055
526,423,103,810,124000,50056
91,91,0,-,90600,50057
846,630,216,556,106100,50058
1022,830,192,505,85800,50060
594,510,84,808,298600,50061
286,233,53,-,108400,50062
974,792,182,806,171300,50063
34,31,3,-,42500,50064
279,157,122,-,70600,50065
107,78,29,-,90000,50066
104,80,24,563,48400,50067
96,84,12,-,70000,50068
402,309,93,680,131600,50069
575,514,61,908,136300,50070
448,370,78,533,58400,50071
918,758,160,832,170700,50072
513,386,127,598,146700,50073
220,188,32,425,321400,50074
344,247,97,750,92800,50075
715,586,129,491,64400,50076
68,48,20,1188,38600,50078
15,15,0,-,45600,50101
56,56,0,-,68300,50102
166,143,23,525,70300,50103
38,28,10,-,86700,50104
401,318,83,673,187800,50105
410,322,88,569,104700,50106
496,382,114,629,71400,50107
208,145,63,525,50900,50108
1154,1021,133,675,240300,50109
4715,3728,987,1007,212100,50111
4506,2941,1565,713,146400,50112
1087,767,320,576,99800,50115
113,109,4,-,64200,50116
56,49,7,-,206800,50117
410,386,24,863,115400,50118
179,119,60,646,152100,50119
116,106,10,-,88300,50120
509,419,90,525,99000,50122
324,241,83,375,69900,50123
1517,1221,296,728,174500,50124
7694,5578,2116,756,172300,50125
2850,2097,753,694,98600,50126
8,8,0,-,-,50127
153,124,29,529,105200,50128
2178,1554,624,546,97200,50129
642,525,117,541,111200,50130
8189,5958,2231,1119,245500,50131
97,82,15,713,57100,50132
181,131,50,494,46200,50133
255,180,75,693,164900,50134
669,536,133,754,111900,50135
201,161,40,656,82900,50136
4789,3421,1368,602,110400,50138
551,472,79,575,122900,50139
1055,597,458,550,87900,50140
246,157,89,908,99600,50141
391,289,102,682,117700,50142
245,191,54,434,149000,50143
1048,675,373,505,84200,50144
165,155,10,800,103500,50146
200,175,25,472,56900,50147
175,151,24,592,97500,50148
426,361,65,713,136300,50149
436,389,47,546,85600,50150
238,212,26,940,127300,50151
335,265,70,662,112800,50153
140,109,31,683,106000,50154
150,108,42,758,69400,50155
1804,1497,307,728,148200,50156
406,302,104,588,80000,50157
11920,8014,3906,682,102600,50158
177,134,43,625,108600,50160
757,647,110,796,161800,50161
488,379,109,681,111900,50162
401,261,140,541,65100,50163
224,181,43,343,75000,50164
69,67,2,-,-,50165
631,532,99,711,135000,50166
204,163,41,725,117000,50167
275,230,45,680,154300,50168
1031,720,311,671,158400,50169
1140,926,214,604,129300,50170
1135,916,219,656,145400,50171
285,199,86,645,135800,50173
569,476,93,738,86200,50174
3358,2394,964,674,141600,50201
196,147,49,440,75000,50206
875,713,162,579,120000,50207
8008,5546,2462,703,110200,50208
626,543,83,842,174000,50210
4634,3455,1179,791,190000,50211
1347,1076,271,685,123700,50212
2838,1798,1040,728,105800,50213
316,222,94,-,207200,50214
1034,877,157,702,231600,50216
268,182,86,627,65500,50217
82,72,10,867,68600,50218
5053,3423,1630,855,192500,50219
3393,2078,1315,736,102900,50220
191,186,5,-,161000,50222
256,176,80,423,88500,50223
1191,881,310,622,131100,50225
1936,1694,242,1124,258900,50226
9,8,1,-,28300,50227
1004,788,216,780,142000,50228
319,308,11,-,283700,50229
439,337,102,398,111100,50230
79,61,18,790,103100,50231
185,159,26,752,159500,50232
598,530,68,800,141700,50233
252,228,24,542,133300,50234
183,144,39,636,78900,50235
615,521,94,650,159600,50236
1223,1109,114,588,216700,50237
484,420,64,600,83800,50238
33,22,11,-,46700,50239
1136,920,216,923,212500,50240
178,127,51,597,133000,50242
91,83,8,640,98600,50243
661,536,125,801,166300,50244
296,221,75,525,94200,50246
871,709,162,611,141100,50247
1848,1250,598,709,182500,50248
514,402,112,733,109200,50249
948,750,198,678,105200,50250
500,370,130,773,131100,50251
76,62,14,-,169000,50252
106,106,0,-,117300,50254
31,31,0,-,43600,50255
207,155,52,564,95100,50256
409,329,80,793,119100,50257
460,377,83,481,62200,50258
917,784,133,950,184800,50261
183,176,7,-,73700,50262
8034,6217,1817,1069,219400,50263
172,143,29,-,61000,50264
13268,8748,4520,913,186500,50265
13143,7312,5831,995,228800,50266
442,318,124,683,57700,50268
246,170,76,767,79200,50271
48,41,7,-,41700,50272
3414,2424,990,821,155300,50273
123,84,39,-,80000,50274
293,245,48,578,130200,50275
1025,809,216,748,168500,50276
219,149,70,577,83600,50277
310,271,39,641,110100,50278
3953,411,3542,761,265300,50309
13291,8942,4349,845,144200,50310
5894,2988,2906,681,140100,50311
7574,4582,2992,753,188100,50312
6513,4700,1813,873,104200,50313
4035,1624,2411,737,88200,50314
13960,8928,5032,775,110900,50315
5784,3353,2431,774,88500,50316
14464,10038,4426,847,109300,50317
0,0,0,-,-,50319
7756,5150,2606,851,153100,50320
3465,2040,1425,794,192900,50321
12852,9280,3572,861,178700,50322
4566,4326,240,1603,309600,50323
2151,1529,622,956,182500,50324
6487,5029,1458,920,243800,50325
4329,3203,1126,943,198000,50327
13043,8398,4645,680,112400,50401
158,121,37,461,106000,50420
1430,1059,371,531,90800,50421
1210,972,238,529,81400,50423
654,552,102,531,69800,50424
24,20,4,-,53600,50426
4113,3099,1014,658,159200,50428
236,184,52,525,63300,50430
88,72,16,600,60000,50431
124,92,32,460,58000,50432
101,95,6,-,86300,50433
180,150,30,833,85000,50434
297,258,39,636,98400,50435
2498,1897,601,547,109700,50436
1725,1288,437,602,144400,50438
83,75,8,613,54200,50439
271,217,54,498,102000,50440
2227,1527,700,679,85300,50441
137,117,20,650,142200,50444
227,184,43,511,129600,50446
497,392,105,496,63100,50447
332,288,44,532,96700,50448
287,200,87,527,60000,50449
1276,829,447,577,111000,50450
216,185,31,575,58400,50451
298,202,96,663,85700,50452
215,186,29,579,101700,50453
40,40,0,-,53300,50454
193,184,9,606,95000,50455
722,538,184,488,82600,50456
157,144,13,575,88000,50457
929,812,117,618,101900,50458
1260,1030,230,615,98700,50459
143,122,21,-,-,50460
2365,1929,436,589,121700,50461
242,190,52,688,96800,50464
100,73,27,500,31100,50465
632,558,74,525,93700,50466
47,39,8,575,119600,50467
651,546,105,490,151200,50468
646,566,80,480,134900,50469
132,87,45,565,61700,50470
309,236,73,619,84600,50471
895,783,112,525,118000,50472
120,111,9,625,-,50473
713,581,132,579,91000,50475
305,235,70,513,85800,50476
119,114,5,575,77500,50477
347,297,50,617,71000,50478
266,210,56,539,69500,50479
369,321,48,743,61000,50480
369,297,72,757,160400,50482
294,248,46,448,85700,50483
183,151,32,458,51900,50484
11363,7352,4011,625,97300,50501
451,355,96,567,78200,50510
3293,2487,806,658,137700,50511
739,561,178,537,77500,50514
106,78,28,436,47100,50515
266,234,32,700,100000,50516
398,315,83,500,102500,50517
173,136,37,594,114500,50518
278,224,54,575,77600,50519
41,37,4,-,-,50520
89,52,37,-,-,50521
304,275,29,567,63000,50522
268,202,66,544,72700,50523
235,168,67,711,110500,50524
1465,1048,417,683,80700,50525
121,103,18,-,64200,50527
165,120,45,700,90400,50528
351,288,63,700,82000,50529
480,360,120,503,117200,50530
120,101,19,-,106100,50531
374,278,96,502,89600,50532
1626,1103,523,674,70900,50533
438,265,173,554,84500,50535
1822,1355,467,588,113900,50536
245,183,62,521,71200,50538
234,196,38,617,58900,50539
377,334,43,485,67300,50540
356,263,93,529,65600,50541
397,316,81,600,66400,50542
626,495,131,533,96800,50543
177,149,28,373,63700,50544
90,86,4,-,-,50545
132,102,30,-,57500,50546
2456,1674,782,605,122100,50548
45,36,9,-,65000,50551
788,565,223,583,67900,50554
128,115,13,-,95700,50556
336,241,95,621,76000,50557
310,264,46,547,63200,50558
129,96,33,752,57100,50559
233,160,73,550,45000,50560
170,128,42,463,46300,50561
187,143,44,585,57000,50562
1178,895,283,549,94900,50563
178,142,36,584,48800,50565
169,154,15,-,106300,50566
111,91,20,617,103900,50567
633,494,139,491,96100,50568
335,257,78,546,67700,50569
93,73,20,1028,76300,50570
180,134,46,492,80000,50571
26,22,4,-,44300,50573
957,752,205,526,81000,50574
500,388,112,499,64100,50575
144,112,32,394,93800,50576
190,153,37,480,57100,50577
302,206,96,663,47100,50578
1009,764,245,550,72400,50579
420,246,174,540,75000,50581
130,101,29,675,69500,50582
1293,944,349,617,79500,50583
513,422,91,709,93800,50585
133,116,17,713,88000,50586
4414,2587,1827,641,127700,50588
400,321,79,708,51600,50590
162,142,20,1042,82200,50591
25,24,1,-,30000,50593
105,77,28,529,94600,50594
3914,2679,1235,649,97500,50595
563,412,151,625,119400,50597
375,309,66,564,77000,50598
183,134,49,494,78800,50599
1067,808,259,489,86000,50601
682,514,168,569,97500,50602
253,217,36,475,83800,50603
807,670,137,607,110700,50604
121,59,62,630,-,50605
326,259,67,555,84700,50606
177,148,29,480,116300,50607
169,143,26,740,89200,50609
152,128,24,563,103900,50611
156,143,13,-,231500,50612
16148,10471,5677,818,176700,50613
4478,2982,1496,552,103700,50616
996,743,253,545,115100,50619
19,16,3,-,-,50620
648,488,160,710,138200,50621
1375,1149,226,620,183600,50622
721,618,103,645,172100,50624
411,325,86,578,70500,50625
713,587,126,638,158900,50626
1326,1002,324,667,92900,50627
473,373,100,468,75000,50628
829,712,117,660,138400,50629
890,683,207,609,87200,50630
443,408,35,585,86400,50632
159,128,31,742,63300,50633
344,256,88,549,144100,50634
674,535,139,546,98500,50635
778,644,134,575,90600,50636
1470,1178,292,614,128800,50638
595,420,175,557,99600,50641
202,162,40,688,98000,50642
1009,888,121,791,178900,50643
3560,2719,841,711,136700,50644
433,359,74,412,87000,50645
723,619,104,596,200600,50647
1692,1436,256,564,162700,50648
334,268,66,623,90000,50650
1412,1149,263,713,140400,50651
43,38,5,700,53300,50652
250,198,52,569,87100,50653
185,146,39,381,130900,50654
295,251,44,525,83500,50655
987,813,174,493,117600,50658
2369,1746,623,639,111100,50659
513,430,83,706,122200,50660
2925,2045,880,647,75200,50662
22,22,0,-,-,50664
1245,974,271,633,144800,50665
435,348,87,600,121400,50666
294,273,21,563,170200,50667
494,448,46,547,139500,50668
1022,815,207,615,136000,50669
842,661,181,665,140600,50670
69,60,9,-,71300,50671
258,204,54,670,92700,50672
66,54,12,775,82000,50673
1465,1254,211,583,119800,50674
946,688,258,699,121500,50675
833,682,151,529,104200,50676
4443,3486,957,656,171500,50677
537,458,79,531,87900,50680
204,182,22,653,84000,50681
675,543,132,460,120900,50682
13089,8662,4427,675,146000,50701
8387,5390,2997,751,110500,50702
7644,4469,3175,702,70600,50703
3444,2403,1041,755,100700,50707
4050,2747,1303,584,93600,50801
729,537,192,636,95300,50830
959,773,186,618,75800,50833
37,37,0,-,-,50835
151,112,39,438,40000,50836
169,142,27,638,56700,50837
19,19,0,-,-,50839
235,184,51,714,64800,50840
1179,922,257,429,85300,50841
41,39,2,-,85000,50842
213,152,61,638,80800,50843
333,261,72,710,67100,50845
455,334,121,548,75900,50846
44,41,3,-,36400,50847
171,140,31,617,58200,50848
1136,854,282,482,90000,50849
854,542,312,554,91900,50851
313,233,80,663,75000,50853
1057,765,292,573,84900,50854
112,97,15,-,104700,50857
334,286,48,525,90500,50858
249,194,55,688,80800,50859
74,65,9,390,102100,50860
91,87,4,767,-,50861
73,59,14,767,47200,50862
119,70,49,488,57100,50863
916,684,232,612,66100,50864
989,747,242,553,111600,51001
1187,873,314,664,112900,51002
714,583,131,707,135500,51003
414,323,91,613,85200,51004
669,562,107,570,93500,51005
447,347,100,465,62400,51006
205,185,20,669,156900,51007
54,52,2,-,88800,51008
79,63,16,488,54500,51009
155,134,21,-,81300,51010
34,26,8,-,38300,51011
2777,1969,808,548,91500,51012
198,174,24,673,90000,51014
557,504,53,550,84400,51016
171,163,8,425,89500,51018
332,268,64,396,92600,51019
245,212,33,495,72600,51020
322,258,64,574,96400,51022
1190,961,229,586,83700,51023
715,605,110,744,187200,51024
839,673,166,533,94200,51025
318,275,43,663,113300,51026
491,403,88,747,107100,51027
804,664,140,630,139100,51028
165,150,15,342,49500,51029
656,582,74,575,170100,51030
5003,3765,1238,619,152100,51031
155,127,28,548,59700,51033
844,680,164,548,92000,51034
691,558,133,556,103700,51035
255,225,30,938,141400,51036
188,142,46,532,72500,51037
725,653,72,675,147500,51038
1014,776,238,716,146500,51039
1609,886,723,574,100700,51040
2388,1944,444,725,164200,51041
101,82,19,538,106300,51044
759,620,139,617,98300,51046
312,272,40,550,78200,51047
257,189,68,417,67700,51048
197,173,24,288,51800,51049
1039,823,216,615,130500,51050
37,28,9,332,-,51051
355,277,78,636,123600,51052
438,371,67,544,73600,51053
1937,1451,486,863,208900,51054
645,513,132,579,145300,51055
150,131,19,713,148900,51056
400,306,94,609,77900,51058
270,195,75,415,53900,51060
270,218,52,832,113000,51061
235,198,37,613,117000,51062
488,385,103,723,80700,51063
445,11,434,458,-,51101
6029,3646,2383,719,79400,51103
8533,5431,3102,778,128600,51104
3647,1755,1892,565,63400,51105
10651,7521,3130,766,120000,51106
2091,1738,353,784,138100,51108
1234,823,411,736,93300,51109
55,0,55,726,-,51111
2576,1555,1021,652,152000,51201
98,91,7,592,80400,51230
143,94,49,572,70000,51231
319,253,66,631,78400,51232
491,441,50,625,114300,51234
511,443,68,900,133600,51235
668,545,123,758,83900,51237
417,386,31,655,112700,51238
1088,907,181,658,156500,51239
762,581,181,741,165600,51240
657,608,49,713,181400,51241
85,80,5,-,105000,51242
401,293,108,754,71400,51243
27,27,0,-,57000,51244
516,365,151,532,90300,51245
1337,1141,196,515,132400,51246
1825,1368,457,596,161000,51247
812,666,146,577,107800,51248
1425,1029,396,581,98100,51249
2763,2160,603,724,195500,51250
5500,3612,1888,627,123600,51301
607,386,221,817,185900,51331
228,170,58,-,126000,51333
2888,2239,649,688,89700,51334
462,376,86,668,91300,51338
24,14,10,517,32500,51341
502,378,124,491,80000,51342
144,90,54,734,108300,51343
174,114,60,-,76000,51345
1034,809,225,590,80500,51346
613,516,97,693,133500,51347
225,191,34,830,72300,51350
1959,1507,452,698,174200,51351
420,352,68,575,75800,51354
446,339,107,819,249200,51355
254,200,54,573,83600,51357
485,375,110,467,83400,51358
4056,3091,965,721,188600,51360
66,58,8,744,80000,51363
332,252,80,916,77900,51364
134,131,3,-,85800,51365
161,135,26,-,67400,51366
5219,3778,1441,577,146500,51401
330,301,29,825,131900,51430
181,152,29,590,57900,51431
206,151,55,488,104200,51433
327,260,67,520,115000,51436
431,354,77,614,67900,51439
135,128,7,-,104800,51440
188,158,30,525,96400,51441
3290,2203,1087,635,109300,51442
687,546,141,610,117900,51443
97,79,18,600,84000,51444
1276,841,435,366,111400,51445
256,182,74,596,59400,51446
118,93,25,615,104500,51447
210,163,47,625,73600,51448
931,713,218,554,80800,51449
709,594,115,556,152400,51450
57,49,8,-,45600,51451
278,258,20,568,55700,51453
613,482,131,465,89500,51454
1027,737,290,562,103800,51455
632,528,104,616,77200,51458
33,31,2,-,48300,51459
473,378,95,555,79000,51461
452,357,95,591,69300,51462
214,174,40,725,123100,51463
334,280,54,508,86200,51465
397,330,67,436,85200,51466
284,264,20,-,101400,51467
13812,8166,5646,805,98100,51501
14894,10466,4428,791,175400,51503
1483,1126,357,821,99800,51510
88,67,21,560,34100,51520
827,635,192,646,131100,51521
167,132,35,605,61800,51523
453,374,79,714,151000,51525
611,590,21,920,234600,51526
202,175,27,488,101000,51527
351,260,91,495,65200,51528
764,531,233,536,91800,51529
330,253,77,639,112500,51530
297,237,60,475,131600,51531
280,195,85,536,87800,51532
385,248,137,626,100000,51533
3293,2500,793,723,170400,51534
820,652,168,566,95800,51535
192,177,15,-,82800,51536
2771,2178,593,620,107400,51537
148,118,30,1000,92400,51540
144,133,11,767,83800,51541
375,326,49,-,223100,51542
248,184,64,552,74700,51543
322,263,59,691,86000,51544
150,125,25,656,34200,51545
1166,974,192,702,116000,51546
142,136,6,725,189300,51548
203,159,44,800,132800,51549
57,54,3,-,68200,51550
726,606,120,728,159900,51551
139,108,31,625,150000,51552
382,304,78,688,145800,51553
78,75,3,-,107300,51554
2121,1563,558,727,123000,51555
167,135,32,1066,107600,51556
362,318,44,613,115500,51557
209,182,27,533,62700,51558
691,537,154,746,151100,51559
831,589,242,610,129600,51560
601,555,46,-,150200,51561
172,152,20,-,171400,51562
269,193,76,805,102400,51563
214,164,50,550,76000,51564
206,161,45,594,109600,51565
3005,1926,1079,690,81700,51566
468,347,121,632,122900,51570
213,169,44,-,123200,51571
200,151,49,433,57600,51572
448,352,96,663,104400,51573
561,455,106,795,179400,51575
762,646,116,742,208600,51576
473,335,138,725,97200,51577
30,25,5,-,65800,51578
990,740,250,670,115900,51579
2551,1785,766,599,92500,51601
92,79,13,-,74200,51630
129,106,23,775,66000,51631
2731,1997,734,562,93200,51632
175,137,38,638,73800,51636
88,75,13,-,43800,51637
555,466,89,592,82000,51638
380,268,112,611,86100,51639
667,465,202,592,74700,51640
112,95,17,-,131900,51645
345,286,59,575,70500,51646
52,51,1,-,48100,51647
93,79,14,688,140600,51648
115,101,14,625,85000,51649
160,146,14,875,54200,51650
663,498,165,654,96300,51652
621,432,189,657,120100,51653
189,159,30,934,155800,51654
26,21,5,-,-,51656
17514,10770,6744,718,124400,52001
6384,4712,1672,886,200100,52002
5367,4584,783,839,176500,52003
165,115,50,719,83400,52030
2177,1780,397,675,143300,52031
550,525,25,775,205800,52032
1265,925,340,650,161100,52033
464,416,48,510,111000,52035
470,420,50,596,116900,52037
208,172,36,900,138000,52038
357,349,8,458,262000,52039
2306,1896,410,593,166300,52040
694,638,56,663,139400,52041
611,493,118,516,128400,52042
1018,755,263,668,101400,52043
43,20,23,-,150000,52044
893,750,143,708,162200,52045
861,690,171,781,162300,52046
283,223,60,675,120300,52047
173,134,39,661,123400,52048
620,430,190,606,101600,52049
215,167,48,725,87700,52050
1330,991,339,634,138400,52052
408,361,47,419,155600,52053
353,284,69,690,168600,52054
3247,2588,659,547,120200,52057
3756,2747,1009,614,102300,52060
384,300,84,663,140600,52064
449,371,78,945,122900,52065
42,31,11,-,75000,52066
1531,1367,164,700,245100,52068
652,482,170,540,114600,52069
392,330,62,719,122900,52070
111,99,12,656,128400,52072
500,444,56,891,265100,52073
145,133,12,469,135600,52074
942,695,247,583,98800,52076
159,108,51,543,97500,52077
281,267,14,470,124100,52078
408,348,60,600,165800,52079
5034,3824,1210,645,173200,52101
860,576,284,626,148500,52132
258,235,23,700,111500,52133
176,138,38,586,58800,52134
331,303,28,521,93800,52135
2486,1927,559,604,128800,52136
284,242,42,525,63900,52140
624,498,126,558,102400,52141
543,374,169,653,102600,52142
547,500,47,609,131700,52144
460,433,27,943,149400,52146
468,406,62,458,90800,52147
801,602,199,599,144700,52151
416,361,55,389,116500,52154
536,474,62,488,110100,52155
271,250,21,725,103400,52156
861,646,215,642,133900,52157
122,91,31,607,102700,52158
1026,824,202,758,118500,52159
452,356,96,393,128800,52160
665,570,95,567,134400,52161
1292,765,527,621,105900,52162
133,115,18,458,71700,52163
107,96,11,495,109600,52164
326,257,69,408,152200,52165
52,45,7,-,77500,52166
111,99,12,814,91900,52168
158,134,24,525,93200,52169
202,167,35,564,111800,52170
321,264,57,475,137500,52171
2644,2041,603,516,115500,52172
1589,1140,449,544,96800,52175
510,435,75,493,160700,52201
344,306,38,563,175000,52202
831,731,100,511,184900,52203
3394,2530,864,683,137600,52205
853,786,67,559,226800,52206
165,138,27,558,79500,52207
1345,1033,312,522,91700,52208
444,348,96,788,143400,52209
262,212,50,766,117000,52210
1086,770,316,727,120100,52211
94,65,29,850,55000,52212
1521,1276,245,732,176700,52213
1478,1243,235,619,173900,52214
271,246,25,-,116300,52215
585,412,173,621,103100,52216
236,195,41,-,103400,52217
670,551,119,671,133600,52218
85,59,26,708,89400,52219
153,153,0,-,140200,52220
103,97,6,625,179700,52221
256,219,37,294,86100,52222
506,432,74,628,164600,52223
780,669,111,679,145100,52224
145,133,12,-,90600,52225
1105,980,125,695,206700,52227
1209,1128,81,963,210100,52228
285,227,58,641,88100,52229
88,75,13,600,67700,52231
88,63,25,729,79700,52232
2915,1794,1121,820,140000,52233
316,198,118,933,147600,52235
271,260,11,-,215100,52236
597,470,127,665,137500,52237
14634,7384,7250,961,178700,52240
7914,4273,3641,861,208200,52241
0,0,0,-,-,52242
9018,5813,3205,995,214300,52245
10220,4440,5780,870,236900,52246
2005,1543,462,628,171900,52247
748,561,187,694,112000,52248
447,328,119,683,124200,52249
246,221,25,439,70300,52251
1303,1112,191,720,171200,52253
362,270,92,521,83400,52254
573,436,137,674,102500,52255
125,123,2,-,198400,52257
1555,1077,478,602,112200,52301
15925,12352,3573,677,162600,52302
235,203,32,661,-,52305
710,599,111,806,118900,52306
60,33,27,-,119600,52307
87,73,14,280,73500,52308
165,147,18,536,86000,52309
2671,2009,662,658,143700,52310
48,27,21,588,56300,52312
139,109,30,631,89200,52313
1701,1458,243,779,198300,52314
528,425,103,561,149500,52315
715,578,137,764,103700,52316
7535,5338,2197,1120,212900,52317
389,352,37,696,117000,52318
490,369,121,754,97000,52320
207,154,53,560,78600,52321
1199,1120,79,907,145500,52322
425,311,114,613,72700,52323
673,602,71,975,182500,52324
385,355,30,775,186400,52325
205,162,43,805,96200,52326
1165,1004,161,697,214600,52327
1034,1001,33,975,271900,52328
370,320,50,647,140900,52329
304,253,51,631,125400,52330
782,656,126,696,181100,52332
2475,2185,290,691,285900,52333
68,68,0,-,168800,52334
334,297,37,700,70100,52335
982,864,118,723,148300,52336
267,190,77,668,96600,52337
1242,1124,118,1104,283000,52338
1513,979,534,649,84100,52339
1164,746,418,972,197900,52340
428,349,79,736,275300,52341
1233,935,298,732,88800,52342
575,486,89,592,150600,52345
452,343,109,538,141500,52346
630,435,195,606,97600,52347
32,32,0,-,61100,52348
2986,2443,543,572,134300,52349
484,461,23,639,207500,52351
643,570,73,580,153400,52352
3807,2450,1357,819,123800,52353
155,125,30,-,164000,52354
124,111,13,-,82500,52355
960,776,184,684,147800,52356
1438,1239,199,706,162000,52358
81,56,25,-,66700,52359
1816,1289,527,487,163600,52361
374,296,78,541,88800,52362
981,204,777,601,156300,52401
17301,12097,5204,782,142800,52402
9714,7480,2234,679,141200,52403
16190,10705,5485,692,128900,52404
10696,7788,2908,759,139600,52405
2708,2666,42,-,279500,52411
12138,8563,3575,637,80100,52501
486,387,99,616,114300,52530
2447,1732,715,612,97200,52531
595,457,138,588,84100,52533
122,95,27,740,85600,52534
404,346,58,552,86600,52535
491,386,105,478,134600,52536
2656,2146,510,642,111200,52537
541,394,147,622,88900,52540
159,131,28,1313,108600,52542
106,83,23,-,135300,52543
3270,2294,976,552,79000,52544
44,37,7,-,47300,52548
268,256,12,675,80500,52549
198,136,62,-,55100,52550
219,219,0,-,108200,52551
331,261,70,680,133200,52552
760,637,123,647,97700,52553
584,464,120,725,60200,52554
157,146,11,688,70000,52555
5178,3272,1906,665,119900,52556
0,0,0,-,-,52557
183,154,29,671,123300,52560
347,249,98,575,96800,52561
625,370,255,629,72500,52563
738,578,160,491,99400,52565
73,68,5,-,55600,52566
325,269,56,772,86900,52567
315,287,28,788,111400,52569
307,284,23,625,70000,52570
635,532,103,707,98000,52571
468,354,114,727,70700,52572
42,42,0,-,72200,52573
351,292,59,563,61700,52574
265,219,46,819,103800,52576
6287,4215,2072,617,107200,52577
233,198,35,368,76800,52580
122,108,14,-,81000,52581
126,110,16,-,60000,52583
165,121,44,650,62800,52584
418,341,77,1023,88400,52585
203,142,61,637,95700,52586
0,0,0,-,-,52588
394,301,93,483,66000,52590
1341,1061,280,584,97600,52591
63,56,7,-,83600,52593
118,104,14,720,78600,52594
144,82,62,683,86200,52595
12581,8818,3763,755,98200,52601
213,146,67,650,118800,52619
351,289,62,562,92700,52620
275,204,71,740,86100,52621
761,654,107,652,138700,52623
132,115,17,-,83000,52624
1054,807,247,642,113300,52625
580,483,97,529,72600,52626
5321,4020,1301,631,88200,52627
192,153,39,808,58200,52630
5082,3523,1559,615,71100,52632
308,239,69,678,127000,52635
955,732,223,585,110000,52637
210,174,36,813,139600,52638
800,634,166,610,109400,52639
569,460,109,613,106600,52640
4696,3109,1587,686,123700,52641
157,118,39,821,128100,52644
1333,1078,255,675,96900,52645
133,109,24,805,87300,52646
75,56,19,584,86700,52647
369,309,60,650,84600,52649
261,228,33,-,146400,52650
277,229,48,377,79900,52651
1308,1070,238,596,116400,52653
628,471,157,561,99100,52654
1788,1312,476,746,99300,52655
1036,878,158,583,158300,52656
24,16,8,640,95000,52657
373,357,16,-,147800,52658
562,433,129,625,94500,52659
80,80,0,-,66000,52660
35,28,7,-,86700,52701
376,257,119,-,122900,52720
303,274,29,556,110400,52721
14496,11228,3268,931,201500,52722
1866,1767,99,811,219900,52726
153,118,35,-,173500,52727
432,369,63,550,109300,52728
347,298,49,700,133200,52729
2233,1841,392,595,117500,52730
310,274,36,585,120200,52731
11521,8078,3443,637,96700,52732
165,142,23,661,78300,52737
1453,1001,452,583,91800,52738
239,142,97,684,72900,52739
3097,2307,790,724,158000,52742
255,183,72,831,143000,52745
366,260,106,878,162800,52746
798,599,199,802,154300,52747
3515,2661,854,703,202300,52748
375,355,20,725,154500,52749
208,198,10,910,160600,52750
355,303,52,700,146500,52751
196,163,33,830,102500,52752
2056,1648,408,794,238300,52753
577,514,63,660,161000,52754
875,642,233,627,170400,52755
783,736,47,897,247400,52756
90,81,9,900,89300,52757
70,57,13,1018,136500,52758
197,160,37,-,171000,52760
11771,8294,3477,812,126500,52761
169,137,32,755,125500,52765
394,357,37,685,120300,52766
84,84,0,-,-,52767
597,504,93,815,183700,52768
264,222,42,717,163700,52769
2101,1633,468,706,143900,52772
981,767,214,600,143200,52773
42,31,11,723,89400,52774
1578,1104,474,631,129600,52776
478,379,99,813,103500,52777
1778,1332,446,636,139900,52778
612,8,604,674,-,52801
3939,2542,1397,692,71900,52802
8806,5454,3352,750,121800,52803
10834,7451,3383,734,114400,52804
10847,7234,3613,758,135600,52806
6428,3387,3041,713,252700,52807
788,689,99,824,177800,53001
869,745,124,915,205900,53002
52,47,5,-,155100,53003
1217,987,230,896,202100,53004
7556,6649,907,1577,279500,53005
670,542,128,816,180800,53006
895,450,445,717,162500,53007
2994,2502,492,780,191800,53010
932,766,166,817,187700,53011
7351,5729,1622,826,294100,53012
1301,1003,298,743,183600,53013
3327,2509,818,636,155300,53014
1025,926,99,770,151300,53015
138,110,28,657,106100,53016
2123,2035,88,1086,302600,53017
3105,2410,695,1052,344700,53018
764,703,61,812,170200,53019
1654,1286,368,708,211600,53020
1959,1540,419,784,227000,53021
7657,6010,1647,996,244300,53022
527,475,52,864,196100,53023
6821,4707,2114,938,236700,53024
8987,6717,2270,789,209000,53027
7738,6113,1625,959,350800,53029
0,0,0,-,-,53031
1834,1272,562,863,145500,53032
2115,2050,65,940,258100,53033
686,468,218,828,173000,53034
915,752,163,820,172300,53035
1134,866,268,935,228700,53036
3703,2916,787,949,213800,53037
1590,1211,379,912,201800,53038
1628,1194,434,726,164300,53039
2980,2355,625,893,218800,53040
2877,2365,512,534,153500,53042
957,854,103,882,231300,53044
8482,7020,1462,1456,322900,53045
487,414,73,792,158900,53046
15,15,0,-,195800,53047
1389,798,591,771,160300,53048
1069,959,110,479,222400,53049
2827,1879,948,662,145200,53050
15011,11218,3793,1000,235300,53051
648,549,99,535,171600,53057
1482,990,492,1123,353100,53058
750,601,149,700,229000,53059
2170,1731,439,801,124100,53061
642,580,62,808,166100,53063
908,721,187,688,180600,53065
13372,10576,2796,912,277000,53066
353,336,17,-,360700,53069
1891,1600,291,716,169600,53070
10617,7628,2989,1060,278800,53072
6089,4204,1885,685,180300,53073
5408,3507,1901,832,188400,53074
1332,1037,295,671,189200,53075
1232,1083,149,1074,347400,53076
711,613,98,957,257100,53078
597,504,93,619,155000,53079
2330,1743,587,693,197300,53080
18180,10883,7297,636,108900,53081
8111,5976,2135,764,161000,53083
5004,3594,1410,734,155900,53085
3332,2715,617,920,251200,53086
183,120,63,736,120600,53088
7333,5925,1408,969,276000,53089
8798,6554,2244,878,180400,53090
804,669,135,634,152200,53091
8661,6981,1680,982,340900,53092
768,688,80,808,184600,53093
7562,4705,2857,764,159500,53094
11728,8324,3404,828,196600,53095
1990,1810,180,1196,362000,53097
4634,3290,1344,872,162300,53098
1503,1390,113,1082,240100,53103
2200,1801,399,884,237700,53104
11381,8650,2731,937,203200,53105
1291,1233,58,888,184400,53108
7572,4217,3355,796,146700,53110
980,728,252,1037,159600,53114
6318,4106,2212,824,162000,53115
2863,2393,470,1218,290700,53118
2040,1837,203,1082,275600,53119
3926,3138,788,819,226100,53120
7407,5250,2157,817,193500,53121
2307,2191,116,929,360800,53122
852,745,107,950,360800,53125
2701,2237,464,1038,241900,53126
3117,2423,694,1042,154400,53128
5939,4020,1919,892,199500,53129
3182,1911,1271,1055,220300,53130
13358,10402,2956,995,227800,53132
621,548,73,1071,223100,53137
1069,941,128,891,191300,53139
11567,5290,6277,814,125300,53140
12036,8955,3081,948,170400,53142
9024,4992,4032,862,123700,53143
9778,5355,4423,893,182000,53144
3095,2882,213,1098,242000,53146
6953,4756,2197,903,206900,53147
7428,6282,1146,845,273000,53149
9411,7799,1612,1037,273000,53150
13657,9883,3774,1138,241700,53151
912,803,109,775,247700,53153
14081,8518,5563,1007,214200,53154
1189,886,303,723,189200,53156
6476,5307,1169,1047,201200,53158
308,168,140,1186,157500,53167
3341,2649,692,1099,167600,53168
923,681,242,842,194000,53170
8628,5199,3429,806,156400,53172
2663,2041,622,1009,157800,53177
1157,899,258,856,205500,53178
2363,1934,429,1251,164300,53179
2715,2085,630,877,191700,53181
3321,2407,914,857,207700,53182
1053,843,210,1063,288600,53183
1663,1053,610,819,193200,53184
7053,6029,1024,957,245300,53185
13821,7582,6239,871,190300,53186
14444,9649,4795,884,220900,53188
9728,7775,1953,992,263400,53189
6422,3157,3265,736,190100,53190
1194,888,306,883,248400,53191
50,50,0,-,-,53192
55,35,20,775,178100,53195
15338,3223,12115,921,234500,53202
865,157,708,1295,284500,53203
13047,3515,9532,748,73000,53204
3435,1094,2341,584,72000,53205
8239,2765,5474,791,48100,53206
16525,9650,6875,884,153700,53207
12304,4283,8021,754,130700,53208
18339,8681,9658,827,92000,53209
9703,3668,6035,846,93700,53210
14322,5859,8463,981,316000,53211
13146,3825,9321,818,121300,53212
11519,6566,4953,956,223300,53213
15823,7930,7893,809,130000,53214
19329,8731,10598,766,99800,53215
13196,5946,7250,829,88800,53216
11668,8919,2749,1232,328900,53217
14029,6187,7842,872,80100,53218
14963,9435,5528,754,136200,53219
11557,6785,4772,836,152700,53220
15883,9428,6455,841,142400,53221
11372,7575,3797,828,138800,53222
12623,6919,5704,857,120200,53223
7743,3967,3776,973,137400,53224
9706,3770,5936,855,117300,53225
8271,5258,3013,1000,221700,53226
10976,5206,5770,825,152800,53227
6354,3693,2661,1080,193400,53228
4497,174,4323,659,81400,53233
4537,2252,2285,718,149300,53235
0,0,0,-,-,53295
13257,9477,3780,851,154300,53402
10231,5654,4577,805,107600,53403
5484,2571,2913,755,100600,53404
9815,6411,3404,913,117300,53405
11050,7918,3132,798,179200,53406
65,65,0,-,-,53501
1003,711,292,689,177900,53502
811,608,203,805,170100,53503
818,641,177,623,150400,53504
169,138,31,1019,163900,53505
437,321,116,671,96100,53506
858,727,131,753,212900,53507
2068,1633,435,1047,218300,53508
591,429,162,665,150200,53510
18895,12139,6756,775,98400,53511
955,754,201,723,228000,53515
927,788,139,817,187900,53516
704,608,96,923,249400,53517
599,493,106,586,119500,53518
2625,2057,568,714,139000,53520
1464,1286,178,1043,233200,53521
434,367,67,650,142900,53522
2033,1650,383,917,232200,53523
1485,1093,392,773,147500,53525
253,198,55,714,122900,53526
3795,3165,630,1085,264300,53527
2335,1795,540,887,281700,53528
801,601,200,920,257100,53529
1820,1260,560,725,120900,53530
1679,1311,368,856,234000,53531
5490,4198,1292,930,234600,53532
2959,2032,927,806,177400,53533
4900,3563,1337,704,164200,53534
3449,2383,1066,809,188500,53536
292,231,61,761,98700,53537
7513,5360,2153,824,168600,53538
116,87,29,-,68300,53540
368,288,80,391,130000,53541
724,563,161,547,127900,53543
291,245,46,708,170700,53544
9796,6015,3781,776,130100,53545
12500,9288,3212,822,141300,53546
7569,5286,2283,736,130400,53548
4079,2669,1410,788,162200,53549
414,374,40,800,162000,53550
3405,2245,1160,953,191900,53551
220,160,60,568,99100,53553
414,321,93,756,122700,53554
3512,2717,795,821,255100,53555
1138,918,220,696,131400,53556
156,115,41,659,110200,53557
4638,3886,752,958,249400,53558
2229,1684,545,939,191400,53559
1496,1161,335,788,230500,53560
800,702,98,1038,285800,53561
10978,6704,4274,976,347900,53562
4314,3277,1037,845,175500,53563
2058,1505,553,689,183200,53565
6492,4218,2274,701,144300,53566
488,395,93,700,140400,53569
1126,843,283,678,165800,53570
98,98,0,-,193100,53571
4089,2992,1097,890,262400,53572
1291,1000,291,682,116500,53573
1499,1278,221,741,198800,53574
5907,4725,1182,844,252500,53575
904,651,253,686,152100,53576
581,442,139,673,183800,53577
2570,1870,700,1034,230600,53578
714,540,174,863,159800,53579
209,169,40,558,99000,53580
4438,3076,1362,628,132100,53581
465,390,75,719,161000,53582
2301,1625,676,675,215100,53583
883,570,313,731,156300,53585
920,648,272,589,109600,53586
502,406,96,600,113300,53587
1749,1342,407,744,199700,53588
7913,6077,1836,914,213900,53589
15350,9458,5892,1010,235900,53590
8837,6554,2283,1144,343200,53593
2123,1686,437,705,167000,53594
6944,5453,1491,985,309000,53597
1008,742,266,1121,256600,53598
23,14,9,-,128100,53599
13,13,0,-,-,53702
15383,2226,13157,1045,294900,53703
20525,11280,9245,954,184200,53704
11818,5963,5855,982,305300,53705
112,0,112,954,-,53706
20204,12846,7358,981,266200,53711
9963,2636,7327,865,166700,53713
7369,4326,3043,919,171400,53714
5296,845,4451,1226,253400,53715
8086,5686,2400,896,208500,53716
6174,3060,3114,1045,301600,53717
5742,3798,1944,1199,217600,53718
13849,7052,6797,1082,232500,53719
2387,770,1617,1092,431500,53726
0,0,0,-,-,53792
378,316,62,509,97600,53801
21,16,5,-,95000,53802
513,412,101,735,109100,53803
526,412,114,540,111000,53804
2106,1447,659,602,111300,53805
734,601,133,462,105400,53806
1884,1490,394,669,157800,53807
485,339,146,668,139600,53808
1566,1160,406,595,117000,53809
152,133,19,363,130100,53810
1255,948,307,711,162900,53811
2335,1607,728,536,136400,53813
271,232,39,645,163900,53816
69,55,14,807,82500,53817
5347,2910,2437,755,164900,53818
981,810,171,564,149100,53820
3371,2392,979,566,128200,53821
176,133,43,369,118000,53825
459,349,110,523,112700,53826
92,79,13,1071,140600,53827
6070,3882,2188,734,146200,53901
1422,968,454,710,88200,53910
514,411,103,1165,195200,53911
8643,5439,3204,753,161300,53913
9246,6175,3071,771,139100,53916
1008,844,164,640,151100,53919
185,166,19,928,161600,53920
384,316,68,682,181300,53922
729,619,110,721,158900,53923
586,444,142,700,160000,53924
3198,2339,859,802,193200,53925
493,418,75,525,153900,53926
46,35,11,-,81300,53928
1058,793,265,585,122400,53929
505,414,91,750,144400,53930
92,68,24,733,108900,53931
978,725,253,963,192200,53932
1256,900,356,706,176900,53933
1819,1515,304,664,104200,53934
117,93,24,725,116000,53935
586,516,70,800,99400,53936
358,309,49,530,161000,53937
111,91,20,686,102100,53939
1180,1022,158,760,171200,53941
392,270,122,670,157500,53943
821,660,161,683,135100,53944
1786,1396,390,708,155500,53946
78,66,12,530,109100,53947
3205,2378,827,748,127000,53948
2591,2092,499,657,141700,53949
1915,1481,434,700,126700,53950
897,705,192,758,149200,53951
1324,1114,210,708,142400,53952
103,66,37,770,58400,53953
2844,2368,476,801,177200,53954
2397,1912,485,730,206300,53955
1292,998,294,693,143300,53956
5329,3627,1702,773,152400,53959
1429,1134,295,893,173100,53960
319,282,37,766,180100,53961
4877,3427,1450,697,134100,53963
1417,1091,326,769,143600,53964
4265,2943,1322,704,162200,53965
959,744,215,536,103200,53968
114,79,35,738,154200,53969
3208,2633,575,721,157000,54001
2590,1769,821,920,179000,54002
343,316,27,955,226600,54003
941,741,200,736,136600,54004
1274,1033,241,591,147300,54005
301,255,46,811,139200,54006
484,383,101,584,164100,54007
1006,766,240,950,166900,54009
16,0,16,-,-,54010
2599,2041,558,697,183700,54011
1339,1034,305,906,164900,54013
856,760,96,875,176000,54014
1322,1017,305,893,173900,54015
12137,9129,3008,1057,269300,54016
6552,4934,1618,862,190200,54017
2794,2149,645,814,179400,54020
2514,2042,472,844,224100,54021
8211,5184,3027,808,222900,54022
1492,1224,268,945,213900,54023
2112,1596,516,709,162700,54024
2651,2049,602,906,206800,54025
770,616,154,734,206100,54026
351,323,28,950,178000,54027
920,716,204,767,163700,54028
511,480,31,-,273200,54082
1067,968,99,770,180900,54101
425,366,59,570,117900,54102
205,185,20,-,121200,54103
569,509,60,775,117100,54104
2024,1715,309,672,164600,54106
1373,1089,284,610,152500,54107
2051,1661,390,699,140500,54110
942,775,167,729,165500,54111
1045,802,243,623,119700,54112
1378,1231,147,771,160600,54113
2435,2011,424,654,132300,54114
17173,11423,5750,863,193500,54115
241,201,40,729,116500,54119
110,95,15,488,148200,54120
1391,1180,211,520,145100,54121
103,92,11,631,117200,54123
1528,1167,361,637,110600,54124
276,220,56,411,82700,54125
1400,1131,269,756,183800,54126
20,8,12,-,68000,54127
639,525,114,597,116700,54128
1386,1193,193,659,162400,54129
10193,7267,2926,811,157600,54130
987,692,295,409,93200,54135
2710,1889,821,721,139500,54136
472,452,20,-,152100,54137
421,376,45,685,163600,54138
1245,1049,196,736,155700,54139
3897,2606,1291,770,140000,54140
853,780,73,728,190600,54141
6888,4588,2300,725,102700,54143
611,557,54,641,155400,54149
353,150,203,529,54300,54150
1507,1304,203,550,92900,54151
2933,2162,771,638,113600,54153
2374,1749,625,602,151700,54154
2629,2140,489,637,188900,54155
705,589,116,655,98500,54156
2353,1571,782,652,123500,54157
619,583,36,967,143900,54159
105,78,27,731,129200,54160
1247,1022,225,627,137800,54161
3435,2653,782,718,173300,54162
3066,2340,726,612,171300,54165
7336,5104,2232,615,131500,54166
1052,1017,35,795,222800,54169
1358,1176,182,642,167300,54170
1332,1318,14,-,232400,54171
1649,1428,221,1017,229800,54173
1294,1041,253,680,128200,54174
477,432,45,671,184100,54175
1429,1141,288,549,130300,54177
1255,977,278,840,172600,54180
2199,1603,596,582,122100,54201
695,586,109,792,277300,54202
728,630,98,678,181600,54204
775,698,77,611,159600,54205
64,54,10,-,123100,54207
2357,1970,387,619,191200,54208
610,515,95,856,277300,54209
426,339,87,725,250600,54210
140,117,23,575,407900,54211
491,452,39,750,349100,54212
534,455,79,679,141000,54213
110,68,42,636,141100,54214
2718,2093,625,603,149700,54216
2793,2274,519,768,181200,54217
17063,11989,5074,653,116600,54220
602,521,81,650,178800,54227
1087,892,195,667,131800,54228
1783,1581,202,922,186300,54229
1807,1571,236,518,159600,54230
350,267,83,525,114200,54232
809,649,160,975,298600,54234
8064,5977,2087,756,171500,54235
6504,4639,1865,649,100600,54241
884,758,126,744,159500,54245
399,351,48,675,298500,54246
918,806,112,638,156900,54247
9207,6228,2979,715,145200,54301
12914,6457,6457,681,108700,54302
11946,5408,6538,652,112900,54303
12479,7483,4996,712,125400,54304
0,0,0,-,-,54307
13398,8812,4586,808,186200,54311
14440,12071,2369,840,203700,54313
13147,8615,4532,692,133800,54401
10472,6787,3685,673,138600,54403
1122,785,337,560,111200,54405
1340,1109,231,732,176700,54406
604,544,60,725,194400,54407
439,368,71,546,124500,54408
5732,4132,1600,608,89500,54409
829,755,74,581,152400,54410
1894,1664,230,662,142800,54411
840,710,130,625,162500,54412
70,52,18,475,100000,54413
1259,1058,201,596,135300,54414
683,519,164,539,101000,54416
18,18,0,-,80000,54417
396,330,66,763,120800,54418
465,365,100,595,156300,54420
1249,886,363,591,114400,54421
377,301,76,536,106300,54422
860,788,72,679,193000,54423
725,683,42,710,170200,54424
785,582,203,666,108000,54425
1612,1378,234,630,153000,54426
477,376,101,675,142800,54427
464,384,80,531,161200,54428
54,46,8,625,121400,54430
723,596,127,617,120700,54433
945,811,134,678,146900,54435
775,666,109,738,119100,54436
1100,844,256,554,118800,54437
1212,1090,122,706,157700,54440
323,299,24,-,187800,54441
417,378,39,792,163900,54442
896,743,153,578,174400,54443
1134,858,276,617,113700,54446
214,169,45,630,104200,54447
1657,1423,234,630,173200,54448
11526,7815,3711,641,151200,54449
164,95,69,525,62600,54450
5084,3865,1219,624,133800,54451
8140,6169,1971,609,121200,54452
539,406,133,741,123000,54454
6932,5790,1142,791,162700,54455
2553,1966,587,601,113800,54456
3571,3089,482,783,123400,54457
37,29,8,629,110900,54458
528,476,52,705,109500,54459
983,780,203,585,97100,54460
172,148,24,719,111500,54462
259,235,24,750,184800,54463
299,283,16,538,162100,54465
1194,967,227,525,141500,54466
5649,3580,2069,809,168200,54467
681,535,146,715,97400,54469
905,680,225,547,129900,54470
696,649,47,-,186100,54471
1106,937,169,704,163000,54473
1678,1190,488,663,125300,54474
682,597,85,586,149400,54475
7553,4827,2726,788,147700,54476
1468,1237,231,600,135100,54479
577,393,184,626,107400,54480
11525,6348,5177,668,135300,54481
3809,3169,640,774,173400,54482
1963,1622,341,575,156500,54484
146,122,24,643,163500,54485
1006,795,211,515,115400,54486
4467,3699,768,709,165500,54487
463,373,90,548,135800,54488
654,550,104,525,138100,54489
365,288,77,528,133800,54490
756,626,130,592,118300,54491
265,247,18,800,134400,54493
11741,9078,2663,737,126100,54494
3446,2012,1434,666,89600,54495
881,721,160,575,116400,54498
1209,904,305,574,123700,54499
8224,6624,1600,756,142300,54501
554,481,73,583,123800,54511
427,356,71,850,233300,54512
200,173,27,619,113500,54513
841,715,126,566,147300,54514
214,200,14,950,94300,54515
43,42,1,-,220000,54517
627,579,48,884,228800,54519
1939,1271,668,488,126700,54520
3804,2962,842,716,187600,54521
361,223,138,448,158200,54524
119,76,43,562,67500,54525
355,299,56,623,94600,54526
461,388,73,504,86300,54527
479,455,24,596,192600,54529
359,328,31,677,78500,54530
580,553,27,1036,217800,54531
1150,807,343,466,75700,54534
103,86,17,-,45700,54536
213,204,9,-,115200,54537
1509,901,608,556,189900,54538
564,510,54,778,169000,54539
463,381,82,396,217800,54540
481,352,129,550,123400,54541
219,197,22,468,89000,54542
481,397,84,685,347600,54545
535,400,135,517,72200,54546
792,577,215,635,217900,54547
2120,1804,316,782,228400,54548
274,234,40,500,77500,54550
2060,1511,549,516,109000,54552
495,396,99,667,191700,54554
2309,1792,517,703,138800,54555
582,468,114,471,89300,54556
471,443,28,825,305000,54557
997,781,216,754,198300,54558
344,235,109,413,93800,54559
285,234,51,761,147100,54560
6,6,0,-,-,54561
855,728,127,719,247600,54562
311,264,47,742,123900,54563
196,191,5,-,119700,54564
33,28,5,-,-,54565
590,468,122,545,146600,54566
2357,1712,645,674,171400,54568
20046,10919,9127,798,145700,54601
6352,3327,3025,664,128700,54603
713,542,171,629,159700,54610
489,356,133,583,100500,54611
1905,1273,632,774,148200,54612
809,708,101,650,112700,54613
1116,869,247,686,158000,54614
4031,2929,1102,651,124800,54615
989,709,280,602,120900,54616
796,672,124,884,137100,54618
1196,970,226,686,160900,54619
517,439,78,708,183000,54621
896,758,138,675,136500,54622
816,703,113,714,161500,54623
649,575,74,642,148400,54624
122,78,44,571,137500,54625
536,441,95,594,129900,54626
748,605,143,622,154500,54627
426,369,57,695,148500,54628
1117,873,244,673,167400,54629
1683,1236,447,678,155600,54630
706,624,82,576,114200,54631
469,424,45,750,167300,54632
1692,1296,396,640,134000,54634
787,605,182,688,137000,54635
5256,4158,1098,866,191800,54636
94,63,31,538,88100,54637
575,461,114,638,135300,54638
967,741,226,618,144600,54639
1,1,0,-,-,54641
817,618,199,750,150000,54642
0,0,0,-,-,54643
572,482,90,775,174000,54644
31,20,11,808,70000,54645
1601,1291,310,854,111300,54646
577,455,122,680,124200,54648
9827,7196,2631,845,172600,54650
532,443,89,547,108500,54651
383,313,70,617,135800,54652
311,238,73,771,139600,54653
46,37,9,-,93400,54654
698,519,179,618,151200,54655
7266,5223,2043,780,139200,54656
146,122,24,600,120000,54657
1087,870,217,795,167600,54658
553,406,147,639,154100,54659
6403,3944,2459,826,146200,54660
1583,1231,352,681,174900,54661
638,510,128,662,110500,54664
3535,2469,1066,636,147200,54665
1105,836,269,813,147200,54666
1869,1449,420,739,141800,54667
3048,2401,647,811,188100,54669
574,485,89,700,155800,54670
15904,9259,6645,782,173000,54701
17515,10781,6734,806,140800,54703
3133,2068,1065,787,159700,54720
573,471,102,633,134500,54721
1434,1072,362,682,149200,54722
530,426,104,683,159500,54723
3051,2293,758,702,151500,54724
1129,888,241,722,123300,54725
664,541,123,742,120400,54726
1961,1609,352,698,143000,54727
2582,2103,479,684,158000,54728
13532,9079,4453,803,165100,54729
1930,1633,297,721,164000,54730
247,204,43,630,107900,54731
1181,906,275,655,113000,54732
493,392,101,731,137500,54733
338,302,36,725,153700,54734
1637,1266,371,569,133800,54736
235,192,43,933,160400,54737
1229,1007,222,589,186800,54738
1810,1428,382,878,170100,54739
804,613,191,638,141300,54740
663,536,127,588,128500,54741
1740,1437,303,692,170500,54742
836,756,80,672,185200,54745
312,242,70,745,115500,54746
1057,676,381,691,134000,54747
554,466,88,544,131800,54748
482,382,100,738,174300,54749
429,381,48,819,176000,54750
9513,5639,3874,730,156000,54751
799,561,238,573,119300,54754
2978,2206,772,729,152800,54755
405,326,79,725,159200,54756
1311,1109,202,772,161400,54757
1862,1475,387,668,139700,54758
626,515,111,642,146200,54759
113,52,61,618,153100,54760
460,341,119,687,153800,54761
512,415,97,667,131300,54762
474,404,70,671,136500,54763
11,9,2,-,-,54765
629,530,99,750,122500,54766
1376,1115,261,914,175300,54767
1773,1241,532,591,119300,54768
288,262,26,-,196700,54769
828,667,161,728,151400,54770
1548,1187,361,627,119600,54771
392,285,107,672,139000,54772
1325,984,341,600,140000,54773
3016,2231,785,663,146600,54801
544,376,168,697,103600,54805
4807,3166,1641,671,121400,54806
947,787,160,695,165900,54810
2060,1430,630,690,106200,54812
255,222,33,667,164500,54813
1104,751,353,536,160300,54814
1062,899,163,752,166000,54817
1104,868,236,521,110600,54819
330,289,41,688,154200,54820
643,568,75,661,181700,54821
1866,1460,406,826,144500,54822
955,696,259,733,154900,54824
315,281,34,808,176600,54826
142,135,7,-,174000,54827
363,251,112,575,151300,54828
2253,1739,514,613,160500,54829
1528,1343,185,650,164200,54830
191,140,51,539,157600,54832
444,357,87,671,116500,54835
393,351,42,1086,158200,54836
1581,1269,312,582,132300,54837
538,470,68,692,188900,54838
121,108,13,-,130800,54839
1980,1560,420,704,131900,54840
139,122,17,679,88700,54841
53,47,6,-,151000,54842
5166,3665,1501,666,172800,54843
147,140,7,-,193200,54844
49,48,1,-,129500,54845
197,181,16,579,105700,54846
1068,918,150,702,173200,54847
2618,1816,802,674,97500,54848
819,714,105,736,175000,54849
90,82,8,-,204500,54850
1817,1431,386,691,151100,54853
394,345,49,753,156300,54854
248,232,16,675,160000,54855
655,600,55,636,126400,54856
21,12,9,-,-,54857
760,505,255,626,119600,54858
815,646,169,757,147000,54859
55,21,34,370,-,54861
130,110,20,563,120300,54862
541,458,83,890,178600,54864
235,219,16,525,121200,54865
199,136,63,670,80800,54867
6902,4797,2105,681,151800,54868
711,646,65,738,198800,54870
1319,1021,298,569,139300,54871
1268,916,352,689,131200,54872
1369,1133,236,650,171300,54873
1479,1347,132,1017,157500,54874
515,430,85,729,124000,54875
652,485,167,717,167000,54876
13100,7690,5410,745,123200,54880
599,535,64,742,150500,54888
1106,796,310,604,139000,54889
1476,1179,297,684,156600,54891
1741,1366,375,705,159400,54893
424,358,66,772,154300,54895
749,627,122,723,131400,54896
13799,6825,6974,730,120500,54901
10102,6244,3858,651,111300,54902
8855,6916,1939,757,191700,54904
848,734,114,600,139800,54909
10487,6136,4351,735,133600,54911
7753,5620,2133,852,247400,54913
13033,8042,4991,715,142500,54914
16803,11713,5090,719,163500,54915
442,396,46,678,112900,54921
550,447,103,686,132400,54922
3776,2677,1099,638,128300,54923
227,174,53,802,195300,54927
159,151,8,-,125900,54928
3760,2819,941,656,124600,54929
652,545,107,648,129800,54930
120,107,13,-,139500,54931
497,473,24,675,182500,54932
107,64,43,745,86700,54933
150,89,61,-,111300,54934
17605,10445,7160,697,124000,54935
7427,5881,1546,864,176700,54937
1727,1560,167,682,190700,54940
1113,849,264,691,190400,54941
3305,2913,392,895,220800,54942
844,727,117,615,126500,54943
3271,2825,446,711,202800,54944
1539,1189,350,584,147800,54945
0,0,0,-,-,54946
1088,1003,85,846,189000,54947
98,80,18,825,157100,54948
1409,1092,317,657,142900,54949
1195,961,234,606,114900,54950
11072,7280,3792,728,139100,54952
18181,12729,5452,787,156500,54956
1185,1103,82,543,143000,54960
5735,3981,1754,689,150500,54961
496,422,74,580,145100,54962
2670,2015,655,788,165500,54963
374,329,45,1007,226800,54964
608,552,56,810,164600,54965
771,598,173,692,136800,54966
191,127,64,575,91300,54967
1235,966,269,708,122800,54968
1237,914,323,635,110100,54970
4624,3135,1489,752,132600,54971
554,467,87,661,164300,54974
590,509,81,753,177000,54977
591,544,47,1007,168000,54979
63,44,19,-,147500,54980
6513,4491,2022,714,142500,54981
2987,2324,663,677,141000,54982
1803,1469,334,751,146300,54983
1344,1094,250,710,146500,54984
0,0,0,-,-,54985
2114,1749,365,650,194900,54986
1145,1094,51,1239,425200,55001
897,647,250,955,217100,55003
1483,1405,78,1273,212600,55005
1536,1144,392,817,128700,55006
860,763,97,828,141000,55007
5656,4317,1339,883,168900,55008
3261,2579,682,874,235100,55009
3723,3639,84,1483,238900,55011
760,667,93,953,228400,55012
2704,2252,452,774,243900,55013
9910,8653,1257,1139,219300,55014
11864,10389,1475,1204,223800,55016
297,277,20,1438,171800,55017
386,374,12,1094,271000,55018
731,665,66,1219,211400,55019
1272,1253,19,1865,326400,55020
10909,7756,3153,795,164100,55021
11811,10368,1443,1190,222800,55024
9107,7127,1980,1018,244300,55025
172,169,3,-,273400,55026
1166,982,184,888,210100,55027
40,40,0,-,92000,55029
539,486,53,830,159700,55030
728,672,56,840,272000,55031
1274,1196,78,519,222700,55032
11736,8991,2745,881,225700,55033
40,31,9,781,59000,55036
1976,1320,656,680,125700,55037
7505,6635,870,1331,264700,55038
4875,4082,793,970,173100,55040
3387,2713,674,857,177900,55041
3154,2988,166,1088,400200,55042
1456,1313,143,1008,230000,55043
17711,15426,2285,1332,317500,55044
2901,2510,391,864,214100,55045
1857,1613,244,1422,197300,55046
953,832,121,1476,384600,55047
893,778,115,745,161000,55049
3827,2912,915,771,147200,55051
799,687,112,869,156200,55052
428,408,20,1056,208000,55053
850,760,90,1026,289400,55054
1331,798,533,877,185500,55055
4923,4302,621,899,186900,55056
8177,5879,2298,778,233200,55057
11532,8561,2971,760,156900,55060
3556,2817,739,732,158200,55063
433,380,53,1117,245600,55065
7787,5301,2486,767,170500,55066
10337,8844,1493,1215,233800,55068
1805,1332,473,766,167400,55069
2663,2258,405,954,173400,55070
2154,1685,469,927,169100,55071
1303,934,369,751,124800,55072
1194,1106,88,870,325900,55073
850,710,140,996,191900,55074
8094,5341,2753,898,169100,55075
8854,6511,2343,1096,197700,55076
5091,3174,1917,983,339600,55077
3177,2899,278,1094,214200,55079
972,925,47,1303,215600,55080
13859,11135,2724,1162,314800,55082
636,508,128,818,185100,55084
176,155,21,1188,187500,55085
139,129,10,-,123900,55087
693,599,94,1220,390200,55088
731,651,80,783,279300,55089
151,126,25,1393,125000,55090
3981,3470,511,1146,211600,55092
4488,955,3533,1123,170700,55101
8799,3797,5002,881,189200,55102
4923,1729,3194,739,160000,55103
16825,8575,8250,863,205100,55104
10814,7308,3506,926,315600,55105
17795,9460,8335,902,140800,55106
5236,2900,2336,841,167200,55107
6292,3121,3171,966,255900,55108
13292,8762,4530,936,193500,55109
16360,12739,3621,1038,227900,55110
13,0,13,531,-,55111
17303,11826,5477,928,222100,55112
17745,11172,6573,954,231300,55113
1708,400,1308,981,207400,55114
3370,2875,495,1140,324700,55115
11216,5859,5357,990,293500,55116
16178,9030,7148,882,175600,55117
12007,7969,4038,913,225900,55118
15254,9417,5837,931,164700,55119
1855,1473,382,1117,336800,55120
3654,1699,1955,1080,209400,55121
13375,9326,4049,1087,231800,55122
9562,7363,2199,1193,307800,55123
19238,15229,4009,1232,230900,55124
16119,12626,3493,1374,275200,55125
11201,9158,2043,1203,249100,55126
7434,6367,1067,1224,271000,55127
11525,8789,2736,1081,202200,55128
8324,6670,1654,1686,371600,55129
5425,1854,3571,788,144200,55130
92,56,36,1089,191700,55150
0,0,0,-,-,55155
4113,3301,812,1038,207200,55301
2926,2518,408,618,214400,55302
17647,12894,4753,1031,213200,55303
16046,14801,1245,1439,264100,55304
9595,5137,4458,1262,305800,55305
6381,4129,2252,1170,247100,55306
1306,941,365,625,141300,55307
3170,2677,493,1128,207300,55308
6157,5510,647,928,191000,55309
575,534,41,521,100400,55310
13330,11646,1684,1547,341100,55311
636,546,90,839,122600,55312
8620,6609,2011,978,219200,55313
505,414,91,550,129400,55314
1863,1724,139,933,317100,55315
8736,7456,1280,1158,219700,55316
7668,6579,1089,1265,331800,55317
10035,7154,2881,1022,259100,55318
1960,1847,113,1122,233800,55319
1919,1621,298,841,198000,55320
1798,1333,465,747,169300,55321
1199,1058,141,1079,258900,55322
478,411,67,969,249600,55324
1702,1413,289,700,221100,55325
1264,1238,26,-,255900,55327
3392,2835,557,614,271600,55328
825,621,204,711,140900,55329
13219,11081,2138,1105,215700,55330
7013,5891,1122,951,481900,55331
753,564,189,635,100500,55332
324,241,83,459,76300,55333
1188,847,341,702,124600,55334
664,560,104,675,97100,55335
3062,2480,582,827,150200,55336
18172,11581,6591,1090,220300,55337
401,378,23,883,153500,55338
378,319,59,683,191100,55339
2505,2326,179,1397,408800,55340
1043,1005,38,574,274100,55341
781,645,136,733,105100,55342
11741,5259,6482,1035,227200,55343
7218,2389,4829,1229,230000,55344
8913,7182,1731,1152,332300,55345
6385,5643,742,1594,315800,55346
11498,10314,1184,1481,384600,55347
1567,1176,391,789,187800,55349
7673,5766,1907,806,153600,55350
3322,2543,779,1051,260400,55352
1268,1119,149,634,190700,55353
1029,886,143,496,156600,55354
3910,2889,1021,724,148600,55355
1967,1627,340,1002,534200,55356
1249,1132,117,669,355200,55357
1949,1643,306,748,205500,55358
2288,1951,337,875,344700,55359
928,823,105,1298,225300,55360
6805,5414,1391,986,206700,55362
1699,1389,310,874,167500,55363
6163,4953,1210,878,298400,55364
205,117,88,528,75600,55366
382,321,61,731,211400,55367
895,555,340,621,200900,55368
14704,11738,2966,1317,225800,55369
298,270,28,957,211000,55370
6106,4835,1271,861,170900,55371
11747,10253,1494,1176,305500,55372
2076,1655,421,862,201000,55373
4985,4264,721,1260,291500,55374
1556,1397,159,920,291700,55375
5287,4710,577,963,232000,55376
10024,8482,1542,1145,277000,55378
14243,10869,3374,1197,244500,55379
819,667,152,544,153200,55381
1460,1314,146,945,233000,55382
1005,241,764,1059,382400,55384
527,408,119,650,112300,55385
2464,2315,149,982,403900,55386
4678,3820,858,933,274200,55387
2218,1754,464,649,207000,55388
1009,875,134,532,149000,55389
959,817,142,1005,203900,55390
6680,5267,1413,1289,508100,55391
1137,906,231,595,143600,55395
866,686,180,726,119800,55396
1093,853,240,959,193600,55397
5322,4764,558,1018,198900,55398
5672,2348,3324,1546,323000,55401
288,0,288,1355,-,55402
11036,2266,8770,863,295300,55403
12443,1763,10680,750,200100,55404
7270,2657,4613,883,325700,55405
15263,10283,4980,919,208400,55406
14445,8084,6361,975,194300,55407
15162,3742,11420,971,249500,55408
4855,2941,1914,1028,234400,55409
8523,6597,1926,1189,387200,55410
9468,3966,5502,918,137000,55411
8751,5036,3715,959,135400,55412
6528,2556,3972,990,218300,55413
10826,1982,8844,965,270900,55414
1582,629,953,1370,363600,55415
15813,8168,7645,1188,315500,55416
10920,8749,2171,1007,238200,55417
13172,8770,4402,960,203800,55418
10579,8367,2212,1122,314300,55419
9048,5888,3160,982,191600,55420
11390,6703,4687,908,162000,55421
12630,8490,4140,1067,194800,55422
15044,9452,5592,963,197600,55423
3483,3184,299,1077,647900,55424
3806,1897,1909,994,196900,55425
12110,7353,4757,1064,226200,55426
9473,6789,2684,969,219800,55427
11859,6958,4901,932,175000,55428
10167,5361,4806,928,154800,55429
7883,5004,2879,979,140100,55430
8098,5439,2659,1173,236300,55431
12313,7964,4349,924,171800,55432
13493,9538,3955,1047,170100,55433
11437,9601,1836,990,171900,55434
6844,3276,3568,1273,243200,55435
5579,4262,1317,1335,459000,55436
7904,5686,2218,1106,259200,55437
7373,5586,1787,1180,278300,55438
3489,3115,374,1145,475800,55439
7874,4437,3437,1115,311500,55441
5570,4276,1294,1453,316400,55442
10841,8416,2425,1113,223600,55443
5012,4371,641,998,184400,55444
3780,3387,393,1426,195500,55445
9096,6995,2101,1381,368300,55446
8503,6504,1999,1243,313700,55447
10297,8587,1710,1187,190700,55448
9713,8466,1247,1421,262600,55449
12,12,0,-,-,55450
3259,363,2896,654,135000,55454
0,0,0,-,-,55455
27,27,0,-,215600,55601
103,91,12,-,123900,55602
296,264,32,621,158000,55603
1641,1272,369,606,252900,55604
341,163,178,654,114400,55605
149,135,14,-,370000,55606
49,47,2,-,208300,55607
117,117,0,-,365300,55609
303,252,51,1277,247100,55612
101,88,13,-,192600,55613
1118,980,138,690,110500,55614
165,115,50,723,225000,55615
3277,2640,637,648,169300,55616
213,196,17,1266,211400,55702
335,300,35,547,144100,55703
416,310,106,439,121200,55704
1403,1138,265,509,85300,55705
866,696,170,659,77000,55706
1364,1155,209,730,157400,55707
415,277,138,519,77600,55708
1614,1361,253,736,161500,55709
579,541,38,328,180100,55710
214,175,39,725,156800,55711
225,202,23,780,135000,55712
472,391,81,556,78300,55713
160,118,42,790,61400,55716
154,149,5,-,230200,55717
1300,1062,238,670,181900,55718
2541,1975,566,536,91700,55719
6515,4961,1554,639,150500,55720
1529,1403,126,720,192100,55721
460,336,124,705,127900,55722
1043,875,168,631,154500,55723
360,343,17,-,159300,55724
76,73,3,-,395000,55725
444,329,115,950,175700,55726
2946,2300,646,566,167600,55731
638,593,45,825,108000,55732
1694,1526,168,942,221000,55733
2696,1986,710,686,109800,55734
723,633,90,575,164000,55735
677,571,106,478,125600,55736
206,194,12,-,103900,55738
1555,1325,230,571,114700,55741
180,177,3,-,169100,55742
8535,6422,2113,630,162600,55744
7387,5344,2043,547,105700,55746
667,512,155,447,129600,55748
186,164,22,1075,152000,55749
952,855,97,803,65600,55750
689,650,39,894,133200,55751
170,160,10,-,143800,55752
434,381,53,1005,62600,55753
161,151,10,-,169800,55756
317,282,35,775,141200,55757
69,62,7,-,61200,55758
1574,1243,331,663,187700,55760
265,239,26,-,135800,55763
253,177,76,350,75500,55764
348,299,49,577,100300,55765
14,14,0,-,-,55766
1454,1048,406,703,152600,55767
1343,869,474,492,141700,55768
1064,823,241,826,133600,55769
768,588,180,626,103100,55771
40,12,28,681,-,55772
638,604,34,-,163000,55775
1504,1364,140,1083,212100,55779
87,66,21,725,164100,55780
334,331,3,-,289200,55781
215,191,24,629,71800,55782
939,869,70,687,162200,55783
49,43,6,-,118800,55784
92,88,4,-,150000,55785
168,134,34,512,88000,55786
276,232,44,725,166100,55787
960,752,208,875,207500,55790
4742,2928,1814,565,88500,55792
281,248,33,718,146300,55793
578,472,106,822,141700,55795
585,538,47,1167,169000,55797
276,225,51,706,158400,55798
1404,429,975,427,289800,55802
7204,6205,999,1086,202000,55803
5809,4988,821,1049,192800,55804
4763,1461,3302,723,116100,55805
4223,1750,2473,703,103000,55806
4390,3067,1323,701,112700,55807
2581,1745,836,706,116900,55808
3562,3117,445,734,151700,55810
10705,7332,3373,943,187800,55811
3523,1650,1873,809,202100,55812
0,0,0,-,-,55814
22067,14988,7079,989,176000,55901
9913,7188,2725,1004,269900,55902
10194,7274,2920,757,148900,55904
0,0,0,-,-,55905
7281,5911,1370,771,225000,55906
568,474,94,492,123600,55909
529,422,107,806,169000,55910
11415,7960,3455,717,109200,55912
1450,1228,222,708,142500,55917
387,320,67,461,106300,55918
483,389,94,-,157700,55919
2711,2437,274,913,208000,55920
1959,1597,362,659,155400,55921
331,258,73,431,103500,55922
1848,1418,430,690,198500,55923
547,467,80,713,141000,55924
435,402,33,900,206800,55925
291,235,56,500,160200,55926
1563,1182,381,636,145300,55927
460,403,57,875,167600,55929
151,136,15,813,111500,55931
823,632,191,577,178200,55932
93,79,14,725,115600,55933
1218,1019,199,607,189000,55934
316,271,45,615,187500,55935
688,553,135,662,126500,55936
782,624,158,544,133200,55939
1041,848,193,543,164300,55940
402,335,67,841,152800,55941
1350,1106,244,653,159400,55943
2800,2314,486,630,170500,55944
522,475,47,1022,178600,55945
1346,1045,301,802,158900,55946
3167,2513,654,702,191300,55947
752,627,125,563,173300,55949
67,52,15,-,81300,55950
613,486,127,600,113500,55951
938,712,226,639,159000,55952
373,292,81,689,106800,55953
601,508,93,725,98500,55954
935,858,77,921,257400,55955
762,645,117,691,208100,55956
257,208,49,809,185200,55957
880,762,118,667,142100,55959
1301,1200,101,769,289100,55960
151,134,17,525,112000,55961
329,260,69,633,170800,55962
2033,1520,513,927,213400,55963
1723,1439,284,643,152000,55964
1088,852,236,602,146900,55965
368,347,21,858,189100,55967
51,38,13,950,157100,55968
403,348,55,694,169800,55969
373,316,57,759,126300,55970
1205,946,259,648,161200,55971
1724,1382,342,609,187500,55972
111,95,16,750,157800,55973
922,717,205,606,115700,55974
1836,1497,339,589,132800,55975
3035,2436,599,810,177900,55976
71,55,16,-,173200,55977
343,276,67,594,180000,55979
1765,1363,402,682,184200,55981
170,156,14,644,143800,55982
648,487,161,673,155400,55983
737,606,131,803,142500,55985
13605,8829,4776,646,150400,55987
391,336,55,525,105700,55990
517,429,88,719,250500,55991
2081,1562,519,666,190000,55992
18411,10260,8151,821,173500,56001
6098,4415,1683,803,180400,56003
9091,6585,2506,650,100900,56007
570,490,80,607,115600,56009
508,403,105,597,137500,56010
2947,2604,343,775,208700,56011
2045,1427,618,562,94700,56013
297,227,70,750,68900,56014
408,381,27,448,102000,56016
635,545,90,747,194600,56017
355,296,59,575,115700,56019
53,53,0,-,61900,56020
420,349,71,761,191000,56021
31,31,0,-,22800,56022
225,178,47,449,86400,56023
1187,801,386,1130,170600,56024
198,181,17,675,107200,56025
772,658,114,773,157800,56026
359,283,76,583,53500,56027
525,468,57,617,230000,56028
315,273,42,575,92800,56029
5337,3777,1560,583,131200,56031
126,102,24,700,55000,56032
170,144,26,490,65500,56033
208,171,37,1000,154800,56034
136,120,16,514,126100,56035
760,664,96,600,110000,56036
653,561,92,636,180400,56037
377,319,58,633,110800,56039
464,392,72,650,147600,56041
253,215,38,596,97900,56042
232,207,25,616,94700,56043
871,729,142,707,189600,56044
378,326,52,639,111800,56045
50,36,14,744,93300,56046
69,53,16,631,87500,56047
1524,1308,216,703,156900,56048
642,537,105,713,201700,56050
311,262,49,667,57000,56051
313,295,18,908,226400,56052
362,319,43,613,121800,56054
1608,1266,342,761,163600,56055
36,35,1,-,55000,56056
1610,1245,365,805,168600,56057
2286,1789,497,676,161700,56058
166,127,39,507,70200,56060
1284,884,400,684,112500,56062
1160,965,195,667,274400,56063
1047,815,232,661,146800,56065
425,367,58,525,117900,56068
1779,1450,329,802,160200,56069
4252,3511,741,874,250000,56071
894,737,157,528,120700,56072
6905,5420,1485,601,146700,56073
783,655,128,696,172500,56074
69,59,10,725,62900,56075
180,145,35,911,141400,56078
291,241,50,439,143500,56080
2365,1720,645,599,98300,56081
4697,3212,1485,909,177200,56082
384,327,57,364,90700,56083
2227,1690,537,575,137400,56085
1266,1030,236,601,94300,56087
752,587,165,620,92800,56088
87,62,25,575,51400,56089
297,230,67,830,118500,56090
139,118,21,575,108800,56091
4891,3625,1266,612,150000,56093
1271,1003,268,683,177700,56096
1551,1220,331,595,94600,56097
906,663,243,601,85900,56098
2570,1986,584,616,100200,56101
753,621,132,538,109600,56110
178,150,28,525,106700,56111
99,87,12,675,89400,56113
133,115,18,763,76100,56114
529,442,87,603,118300,56115
312,238,74,650,157100,56116
113,85,28,742,112500,56117
167,150,17,425,112500,56118
399,334,65,500,112700,56119
375,316,59,625,66800,56120
266,222,44,625,71100,56121
252,169,83,697,91000,56122
217,188,29,1036,102100,56123
39,35,4,-,29500,56125
163,135,28,550,68100,56127
798,656,142,743,120700,56128
324,272,52,488,68900,56129
979,774,205,751,112400,56131
216,178,38,629,202400,56132
193,158,35,540,93300,56134
535,425,110,613,86500,56136
473,380,93,625,89500,56137
375,317,58,598,105200,56138
174,154,20,525,140600,56139
27,22,5,-,55000,56140
127,112,15,375,85000,56141
429,315,114,581,75200,56142
1926,1372,554,621,121700,56143
527,439,88,663,87400,56144
241,207,34,525,56100,56145
30,27,3,-,64400,56146
86,67,19,633,83800,56147
545,424,121,535,129100,56149
1070,889,181,677,105700,56150
361,329,32,575,110500,56151
603,469,134,536,86400,56152
113,102,11,-,60000,56153
144,126,18,1071,86000,56155
2462,1724,738,655,150700,56156
303,263,40,713,109800,56157
182,152,30,531,102300,56158
1122,803,319,751,80500,56159
90,79,11,475,66400,56160
155,142,13,750,81700,56161
100,95,5,442,76300,56162
2394,1677,717,560,94900,56164
162,149,13,675,119300,56165
93,86,7,763,95000,56166
332,265,67,625,90400,56167
341,287,54,742,116500,56168
273,227,46,669,123800,56169
304,251,53,606,79600,56170
775,585,190,675,95900,56171
1378,1121,257,507,100800,56172
150,114,36,650,107100,56173
152,118,34,550,56000,56174
1266,963,303,467,87700,56175
439,355,84,567,74300,56176
21,21,0,-,-,56177
716,582,134,584,101800,56178
503,366,137,488,83000,56180
432,367,65,591,90800,56181
562,456,106,466,74600,56183
231,198,33,764,85200,56185
150,116,34,463,98000,56186
5020,3192,1828,702,136400,56187
8906,5658,3248,703,151200,56201
97,83,14,842,128100,56207
976,633,343,558,64300,56208
931,766,165,652,147100,56209
1,1,0,-,-,56210
206,170,36,537,73800,56211
225,198,27,521,69200,56212
328,251,77,627,73100,56214
1979,1245,734,648,116900,56215
275,245,30,763,115300,56216
220,206,14,875,115200,56218
415,330,85,597,49100,56219
1219,959,260,671,101000,56220
266,199,67,463,86600,56221
768,576,192,620,109200,56222
554,407,147,615,90700,56223
150,139,11,850,77500,56224
324,260,64,750,88600,56225
89,85,4,-,123200,56226
86,83,3,-,114400,56227
424,330,94,689,83600,56228
687,540,147,666,157900,56229
334,292,42,628,89300,56230
172,150,22,1000,110700,56231
1082,840,242,555,81400,56232
230,191,39,594,98200,56235
159,143,16,-,91000,56236
224,186,38,475,72600,56237
219,206,13,338,131900,56239
434,348,86,546,88800,56240
1719,1274,445,584,119800,56241
642,496,146,700,134500,56243
475,373,102,589,119800,56244
228,182,46,620,100000,56245
357,285,72,455,81400,56248
141,123,18,550,75600,56249
344,273,71,578,151700,56251
487,354,133,614,115900,56252
479,437,42,700,169500,56253
135,116,19,506,88000,56255
1164,879,285,552,80200,56256
261,227,34,666,52100,56257
5986,3559,2427,627,149300,56258
377,311,66,661,87200,56260
271,219,52,495,78300,56262
221,193,28,440,105400,56263
879,728,151,683,111100,56264
3154,2176,978,596,106200,56265
650,521,129,538,85500,56266
2610,1599,1011,732,163700,56267
437,372,65,583,74300,56270
465,383,82,666,113300,56271
2022,1702,320,783,210100,56273
55,53,2,-,92500,56274
129,111,18,-,115600,56276
1305,912,393,665,116100,56277
1196,868,328,480,104900,56278
482,418,64,744,175000,56279
202,167,35,636,91300,56280
261,224,37,717,128400,56281
581,456,125,719,131900,56282
2582,1828,754,694,109800,56283
851,715,136,544,91000,56284
437,346,91,595,82300,56285
29,28,1,-,55700,56287
1953,1718,235,743,256900,56288
309,287,22,494,227600,56289
181,156,25,567,112500,56291
231,208,23,558,100000,56292
478,392,86,532,117900,56293
32,29,3,-,52500,56294
126,104,22,675,81700,56295
957,771,186,580,81500,56296
356,276,80,583,86200,56297
11870,6220,5650,808,180400,56301
10838,6601,4237,714,140100,56303
6494,3293,3201,703,140900,56304
1971,1633,338,633,175300,56307
11216,7829,3387,752,203100,56308
508,427,81,708,159800,56309
2016,1837,179,718,211600,56310
271,214,57,638,123700,56311
964,754,210,767,157800,56312
36,24,12,1208,75000,56313
454,403,51,820,166000,56314
622,543,79,576,176400,56315
580,480,100,604,135900,56316
457,437,20,775,212000,56318
554,496,58,764,173800,56319
3182,2779,403,894,200100,56320
0,0,0,-,-,56321
265,192,73,566,89600,56323
446,404,42,550,213100,56324
79,63,16,844,131600,56325
635,540,95,558,150900,56326
289,276,13,863,259100,56327
69,48,21,718,90000,56328
2679,2295,384,597,174100,56329
640,560,80,880,165900,56330
758,698,60,685,179400,56331
617,587,30,719,251900,56332
2588,1997,591,707,186800,56334
88,83,5,-,95200,56335
636,574,62,556,221300,56336
687,645,42,850,174000,56338
482,357,125,553,123300,56339
949,794,155,544,181600,56340
1237,1042,195,664,163900,56342
437,398,39,605,156100,56343
6142,4462,1680,671,151800,56345
2712,2083,629,672,131400,56347
331,283,48,667,142100,56349
249,232,17,-,140600,56350
2301,1795,506,812,154800,56352
3464,2754,710,720,149900,56353
589,531,58,663,198900,56354
218,186,32,725,175000,56355
126,111,15,755,119600,56356
409,384,25,1054,209800,56357
1239,1070,169,900,159200,56358
1440,938,502,693,138800,56359
1598,1334,264,717,161400,56360
949,802,147,653,135400,56361
2504,1983,521,628,164200,56362
62,24,38,800,112500,56363
2053,1757,296,733,167100,56364
2471,2257,214,719,179300,56367
1730,1588,142,652,211600,56368
301,133,168,647,144200,56369
40,35,5,850,114600,56371
1156,970,186,671,176200,56373
3224,2603,621,738,177600,56374
338,304,34,755,164000,56375
126,121,5,188,128600,56376
7058,4789,2269,928,191800,56377
3039,2106,933,548,164900,56378
6795,4699,2096,695,162700,56379
1033,831,202,581,149800,56381
588,514,74,483,172800,56382
155,78,77,618,112500,56384
362,287,75,760,140600,56385
287,221,66,525,186300,56386
3300,1208,2092,813,143500,56387
41,40,1,-,95000,56389
12188,8547,3641,732,172400,56401
3197,2169,1028,960,195100,56425
4186,3433,753,642,177300,56431
814,684,130,760,170200,56433
87,80,7,825,143800,56434
1147,988,159,675,147500,56435
39,29,10,-,142200,56436
536,420,116,680,94800,56437
1076,931,145,575,141200,56438
542,427,115,491,105300,56440
1528,1073,455,793,111100,56441
1033,905,128,847,341600,56442
595,543,52,845,215300,56443
1327,1146,181,521,227500,56444
606,496,110,484,106600,56446
455,411,44,1039,243900,56447
144,136,8,-,261100,56448
689,654,35,975,202300,56449
426,342,84,877,141300,56450
910,791,119,700,251700,56452
333,280,53,719,123600,56453
717,554,163,716,127600,56455
19,15,4,-,152100,56456
148,119,29,731,174200,56458
1335,1171,164,783,171400,56461
1749,1448,301,640,145600,56464
866,824,42,954,228000,56465
1415,1097,318,654,140100,56466
1069,947,122,813,222700,56467
1882,1667,215,818,275900,56468
554,525,29,788,163800,56469
4526,3458,1068,546,183300,56470
3216,2675,541,707,206700,56472
1443,1244,199,850,170000,56473
1805,1383,422,674,147300,56474
631,512,119,696,140400,56475
1078,911,167,650,129600,56477
2187,1651,536,589,118600,56479
819,706,113,574,129700,56481
2853,2056,797,632,114300,56482
1616,1206,410,659,179100,56484
7359,5362,1997,762,192900,56501
941,709,232,488,87900,56510
781,680,101,690,198400,56511
1407,1123,284,637,163100,56514
1358,1142,216,706,277800,56515
93,77,16,455,85000,56516
104,86,18,1063,77100,56517
125,106,19,844,166700,56518
112,84,28,725,100000,56519
1825,1227,598,490,110800,56520
282,240,42,719,126300,56521
162,146,16,1000,74300,56522
219,176,43,613,115500,56523
302,270,32,833,200000,56524
46,46,0,-,110000,56525
305,273,32,525,121900,56527
706,650,56,815,227800,56528
1629,1146,483,683,171400,56529
865,685,180,654,87600,56531
114,101,13,1000,135200,56533
502,451,51,939,181600,56534
541,457,84,493,161400,56535
191,177,14,460,145300,56536
8200,5761,2439,636,148800,56537
817,674,143,754,117100,56540
4,4,0,-,-,56541
1212,841,371,716,130000,56542
87,79,8,900,101600,56543
1904,1628,276,704,174300,56544
305,271,34,656,104300,56545
99,96,3,-,181300,56546
917,810,107,536,184900,56547
320,269,51,558,99500,56548
1776,1466,310,818,205500,56549
192,167,25,583,73800,56550
873,692,181,617,141100,56551
155,134,21,470,117500,56552
112,108,4,-,116300,56553
1077,947,130,647,227200,56554
456,341,115,597,109900,56556
1038,673,365,568,86400,56557
16370,10351,6019,782,173500,56560
19,19,0,-,-,56565
177,91,86,328,68300,56566
1329,994,335,638,138900,56567
73,64,9,-,104400,56568
489,365,124,366,113700,56569
473,417,56,884,172900,56570
796,704,92,861,225000,56571
2196,1759,437,608,200400,56572
2682,2070,612,740,179300,56573
82,68,14,-,105600,56574
316,258,58,525,133300,56575
311,253,58,850,251800,56576
2,2,0,-,-,56577
282,267,15,-,227700,56578
517,449,68,653,104600,56579
523,506,17,650,168200,56580
109,89,20,623,64700,56581
40,40,0,-,50000,56583
578,460,118,635,80000,56584
435,347,88,775,126500,56585
801,716,85,725,204500,56586
588,515,73,625,213200,56587
222,212,10,525,192900,56588
768,575,193,544,124800,56589
135,105,30,723,86800,56590
47,40,7,288,95000,56591
187,168,19,700,84400,56592
0,0,0,-,-,56593
204,185,19,719,163400,56594
13328,9080,4248,720,167600,56601
1836,1327,509,656,122900,56621
1079,833,246,628,146700,56623
120,86,34,650,101300,56626
154,109,45,418,54300,56627
832,711,121,672,172200,56628
86,80,6,-,166700,56629
792,607,185,586,108400,56630
1734,1154,580,540,105300,56633
635,538,97,488,124600,56634
2019,1627,392,654,155600,56636
93,76,17,829,150000,56637
195,174,21,817,175000,56639
118,100,18,325,175000,56641
339,305,34,363,98200,56644
186,153,33,-,153800,56646
321,290,31,806,138000,56647
4115,3217,898,588,111000,56649
289,250,39,375,118300,56650
234,194,40,856,115300,56651
183,170,13,600,152400,56652
600,492,108,807,108100,56653
75,60,15,-,126700,56654
741,632,109,396,270500,56655
162,149,13,-,222300,56657
0,0,0,-,-,56658
20,19,1,-,171900,56659
124,109,15,-,106000,56660
404,344,60,523,99500,56661
287,268,19,-,253300,56662
71,71,0,-,90500,56663
249,93,156,520,-,56666
248,223,25,964,196700,56667
45,30,15,-,150000,56668
149,134,15,1281,166200,56669
364,220,144,526,64600,56670
888,406,482,581,63000,56671
940,763,177,660,172600,56672
284,233,51,838,104300,56673
645,584,61,664,149400,56676
453,428,25,550,144100,56678
80,76,4,-,159400,56680
136,101,35,657,173800,56681
282,258,24,883,172400,56683
118,96,22,525,115900,56684
48,42,6,-,116700,56685
385,371,14,-,78200,56686
29,29,0,-,114100,56687
64,57,7,-,135200,56688
5442,3960,1482,633,134700,56701
257,214,43,550,88800,56710
17,0,17,-,-,56711
397,349,48,492,99300,56713
497,410,87,613,99000,56714
142,125,17,330,104500,56715
3492,2405,1087,662,122100,56716
6,6,0,-,46000,56720
4042,2824,1218,722,183700,56721
149,126,23,729,163600,56722
377,296,81,638,175000,56723
73,64,9,-,95000,56724
356,313,43,667,103800,56725
664,547,117,550,110200,56726
276,240,36,542,113500,56727
601,483,118,571,86300,56728
55,52,3,-,40000,56729
32,24,8,850,65000,56731
502,350,152,513,80500,56732
188,173,15,635,62900,56733
203,162,41,413,45200,56734
286,247,39,517,78700,56735
505,451,54,670,192200,56736
405,343,62,432,102600,56737
566,496,70,468,129000,56738
0,0,0,-,-,56741
349,296,53,525,83600,56742
221,182,39,475,106700,56744
283,220,63,625,105700,56748
1018,834,184,442,116500,56750
2198,1710,488,706,141000,56751
229,185,44,593,123300,56754
43,43,0,-,56100,56755
272,232,40,639,112000,56756
395,302,93,489,75700,56757
172,152,20,-,90000,56758
97,83,14,340,87300,56759
152,110,42,713,100000,56760
194,172,22,883,120500,56761
1060,780,280,606,110700,56762
2051,1523,528,642,115000,56763
800,625,175,510,107800,57001
375,315,60,625,144400,57002
732,654,78,828,164500,57003
1343,959,384,585,146400,57004
4063,3105,958,879,206600,57005
9640,5166,4474,697,171900,57006
206,199,7,-,201800,57010
478,326,152,535,130900,57012
1796,1390,406,657,155500,57013
594,463,131,425,94700,57014
320,289,31,-,125500,57015
294,282,12,950,170600,57016
659,512,147,569,169700,57017
537,447,90,725,152600,57018
507,443,64,1276,177400,57020
97,92,5,-,106300,57021
1807,1498,309,818,167000,57022
174,155,19,633,65000,57024
1156,902,254,793,140300,57025
473,347,126,815,121000,57026
44,27,17,-,68100,57027
1381,955,426,507,102600,57028
837,579,258,556,84600,57029
1090,920,170,656,187800,57030
321,250,71,550,112200,57031
2311,2048,263,820,201000,57032
1870,1493,377,835,205700,57033
303,261,42,503,117600,57034
466,416,50,823,139000,57035
309,266,43,825,77000,57036
432,294,138,559,120700,57037
622,586,36,442,162100,57038
1260,1012,248,765,139800,57039
161,148,13,575,52500,57040
75,75,0,-,77800,57041
3560,2453,1107,538,154600,57042
599,453,146,729,89600,57043
505,397,108,379,66800,57045
301,258,43,661,109300,57046
122,79,43,686,73200,57047
435,355,80,500,149000,57048
2670,1701,969,841,225800,57049
104,98,6,-,-,57050
118,93,25,545,42500,57051
101,69,32,380,85600,57052
764,647,117,822,149300,57053
213,197,16,625,73200,57054
432,366,66,841,237800,57055
89,87,2,-,68100,57057
795,600,195,672,113400,57058
600,446,154,408,70000,57059
37,29,8,-,57900,57061
491,382,109,450,88500,57062
380,308,72,577,83800,57063
2033,1570,463,909,212700,57064
169,130,39,663,93100,57065
702,481,221,538,84600,57066
139,122,17,1038,270000,57067
589,524,65,768,159300,57068
4535,2108,2427,721,143200,57069
648,422,226,588,102900,57070
1217,931,286,727,157600,57071
235,204,31,713,134400,57072
276,224,52,675,88300,57073
451,380,71,750,248400,57075
110,98,12,-,111400,57076
553,503,50,765,145600,57077
7833,4865,2968,613,144500,57078
13840,9613,4227,740,157100,57103
11704,4506,7198,627,102600,57104
9486,6418,3068,775,156900,57105
18492,11117,7375,819,172200,57106
3793,2843,950,814,154900,57107
8182,6106,2076,952,277700,57108
6356,4249,2107,839,222200,57110
0,0,0,-,-,57117
0,0,0,-,-,57197
10994,7026,3968,687,171300,57201
855,640,215,543,131500,57212
261,242,19,-,121900,57213
27,25,2,-,59400,57214
478,408,70,564,99600,57216
100,93,7,-,52500,57217
153,151,2,-,151100,57218
251,216,35,448,82600,57219
261,207,54,638,127100,57220
279,207,72,475,85600,57221
511,432,79,613,133700,57223
59,42,17,560,-,57224
840,609,231,525,80300,57225
864,646,218,444,120800,57226
126,125,1,-,122500,57227
829,712,117,334,117000,57231
156,140,16,-,-,57232
55,42,13,-,55000,57233
540,473,67,717,92600,57234
325,264,61,685,146900,57235
44,43,1,-,-,57236
256,196,60,421,82500,57237
237,164,73,512,150000,57238
107,95,12,-,158700,57239
381,302,79,598,124600,57241
125,97,28,-,164800,57242
278,219,59,632,91200,57243
50,48,2,-,98000,57245
87,80,7,-,59000,57246
117,92,25,-,296900,57247
334,282,52,575,123200,57248
418,332,86,363,105600,57249
73,61,12,-,-,57251
2161,1804,357,635,122000,57252
174,126,48,608,45000,57255
48,43,5,-,48800,57256
221,131,90,463,77000,57257
75,66,9,-,47100,57258
174,146,28,490,113000,57259
404,322,82,765,110900,57260
152,140,12,533,87500,57261
1800,982,818,574,87800,57262
206,159,47,509,93600,57263
100,85,15,635,95000,57264
90,78,12,-,107100,57265
250,183,67,492,79300,57266
189,169,20,550,78600,57268
147,134,13,-,128400,57269
311,138,173,515,60000,57270
89,69,20,724,118800,57271
95,86,9,418,74400,57272
512,333,179,476,73300,57273
1279,927,352,535,87800,57274
445,372,73,614,129100,57276
288,238,50,625,82400,57278
513,426,87,553,96500,57279
8171,4878,3293,719,144200,57301
474,415,59,830,118300,57311
263,208,55,675,72900,57312
596,451,145,472,68000,57313
326,244,82,596,71100,57314
461,385,76,480,75000,57315
263,164,99,488,49300,57317
342,246,96,553,108300,57319
175,141,34,581,91300,57321
168,118,50,682,76700,57322
131,89,42,465,-,57323
124,104,20,633,109400,57324
1354,909,445,533,155800,57325
479,344,135,651,108700,57328
104,77,27,525,115300,57329
222,196,26,475,78000,57330
150,130,20,540,143300,57331
265,245,20,550,117100,57332
353,271,82,686,104300,57334
150,107,43,515,73900,57335
79,69,10,-,156300,57337
382,127,255,505,45000,57339
118,94,24,-,101400,57340
47,37,10,-,-,57341
240,212,28,421,75200,57342
43,40,3,-,87500,57344
522,432,90,615,85700,57345
22,8,14,-,-,57346
228,185,43,688,147500,57348
611,491,120,517,75000,57349
6458,4128,2330,576,104600,57350
352,296,56,388,110700,57353
513,349,164,631,80200,57355
585,395,190,468,53700,57356
25,25,0,-,-,57358
340,270,70,592,90000,57359
52,5,47,521,-,57361
1017,646,371,510,114900,57362
366,283,83,657,100400,57363
8,8,0,-,-,57364
266,213,53,648,154400,57365
927,708,219,651,104800,57366
87,63,24,600,181300,57367
438,311,127,617,100200,57368
963,676,287,544,112900,57369
300,213,87,668,75000,57370
66,48,18,-,62000,57371
179,140,39,-,117500,57373
124,116,8,471,94300,57374
329,291,38,600,71200,57375
441,381,60,506,46800,57376
32,32,0,-,-,57379
1154,710,444,485,86300,57380
249,173,76,625,85000,57381
650,438,212,468,77700,57382
347,274,73,625,57200,57383
380,347,33,514,111100,57384
504,359,145,514,72000,57385
111,103,8,-,98200,57386
13806,8648,5158,648,155900,57401
42,40,2,-,-,57420
45,28,17,-,84400,57421
133,83,50,-,84700,57422
100,95,5,-,52800,57424
22,22,0,-,-,57426
272,236,36,-,130800,57427
274,237,37,282,61300,57428
49,35,14,-,47500,57429
929,691,238,564,108900,57430
169,153,16,-,81500,57432
146,126,20,-,87300,57433
182,162,20,-,113200,57434
122,114,8,-,80000,57435
175,155,20,608,55700,57436
660,518,142,659,54800,57437
589,418,171,625,83200,57438
41,41,0,-,-,57439
168,137,31,556,72500,57440
249,227,22,675,108100,57441
803,634,169,614,88400,57442
842,643,199,826,159400,57445
167,139,28,366,57000,57446
155,133,22,610,38600,57448
66,66,0,-,226700,57449
260,229,31,525,76200,57450
870,726,144,643,168600,57451
108,92,16,-,53800,57452
236,202,34,767,75600,57454
30,29,1,-,59000,57455
331,262,69,425,54000,57456
37,37,0,-,-,57457
140,105,35,498,77900,57460
141,129,12,725,101000,57461
143,126,17,525,112500,57465
81,56,25,-,95000,57466
111,92,19,505,47100,57467
137,86,51,632,80000,57468
1468,966,502,565,78000,57469
29,16,13,-,52000,57470
264,224,40,508,101700,57471
389,304,85,702,67100,57472
79,79,0,-,117500,57473
61,60,1,-,80000,57474
55,48,7,-,65000,57475
185,139,46,738,110200,57476
42,33,9,-,85000,57477
222,184,38,639,166500,57479
164,140,24,-,74400,57481
7112,4579,2533,624,174700,57501
74,47,27,-,50800,57520
56,36,20,-,27700,57521
228,170,58,667,-,57522
499,332,167,563,76500,57523
380,278,102,538,75800,57528
153,121,32,-,99000,57529
82,73,9,-,57500,57531
1257,988,269,664,161900,57532
880,643,237,522,66500,57533
102,80,22,-,-,57534
145,96,49,439,54500,57536
38,30,8,-,-,57537
109,97,12,620,66300,57538
35,30,5,-,-,57540
80,28,52,563,-,57541
410,315,95,279,60500,57543
184,166,18,725,94100,57544
50,50,0,-,32500,57547
369,133,236,512,48300,57548
718,458,260,551,69500,57551
204,182,22,-,64400,57552
69,38,31,-,-,57553
1246,555,691,426,38500,57555
294,207,87,428,79500,57559
126,84,42,417,23000,57560
14,12,2,-,-,57562
101,41,60,380,32800,57563
414,328,86,525,125000,57564
318,115,203,494,66900,57566
664,525,139,485,80800,57567
277,231,46,633,66000,57568
135,125,10,-,83600,57569
522,202,320,430,36900,57570
5,2,3,-,-,57571
437,182,255,387,27500,57572
45,33,12,-,-,57574
102,49,53,-,64200,57576
307,83,224,538,52900,57577
449,321,128,450,43500,57579
1812,1228,584,575,95500,57580
24,21,3,-,45000,57584
94,58,36,-,60000,57585
1646,1080,566,608,86800,57601
212,166,46,594,63300,57620
79,18,61,422,-,57621
85,28,57,435,12500,57622
300,188,112,564,57900,57623
1212,651,561,556,62100,57625
362,262,100,583,82600,57626
16,16,0,-,116700,57630
168,148,20,522,98800,57631
287,256,31,250,73300,57632
158,109,49,505,65000,57633
47,47,0,-,137500,57634
43,10,33,383,-,57636
831,629,202,542,71700,57638
84,25,59,423,38800,57639
83,47,36,-,199200,57640
148,102,46,470,40000,57641
577,261,316,405,51900,57642
128,107,21,-,74100,57644
81,68,13,725,86700,57645
107,101,6,-,61900,57646
183,145,38,442,65900,57648
81,54,27,278,56700,57649
10,3,7,-,-,57650
60,34,26,-,78900,57651
100,62,38,561,53800,57652
267,190,77,544,74000,57656
76,64,12,638,55000,57657
104,51,53,375,39200,57658
34,30,4,-,-,57660
26,13,13,-,129200,57661
18193,10200,7993,728,146800,57701
14571,11008,3563,926,228500,57702
5784,4958,826,907,159700,57703
1036,4,1032,1040,-,57706
151,60,91,580,83100,57714
149,92,57,484,56700,57716
3299,2400,899,668,131800,57717
2886,2541,345,937,158500,57718
2862,1885,977,867,145400,57719
316,213,103,544,86200,57720
175,169,6,-,97500,57722
62,54,8,342,84000,57724
85,49,36,-,215300,57725
2490,1911,579,862,213100,57730
1084,732,352,576,158200,57732
615,461,154,654,59200,57735
73,68,5,725,-,57738
34,0,34,-,-,57741
958,861,97,1076,216900,57744
982,755,227,583,208700,57745
2691,1987,704,615,144200,57747
134,89,45,386,131300,57748
90,70,20,506,109600,57750
310,246,64,508,200000,57751
421,267,154,543,15000,57752
1765,1162,603,654,118100,57754
46,46,0,-,72000,57755
170,90,80,291,-,57756
59,32,27,-,-,57758
74,74,0,-,-,57759
516,398,118,604,75600,57760
462,418,44,618,150700,57761
298,257,41,625,88800,57762
105,84,21,521,66700,57763
408,237,171,427,19500,57764
77,51,26,-,154000,57766
39,39,0,-,153100,57767
1507,1399,108,1118,197900,57769
1187,555,632,523,17800,57770
443,224,219,476,18400,57772
102,89,13,475,150400,57773
102,91,11,-,-,57775
0,0,0,-,-,57776
53,53,0,-,85800,57779
47,41,6,-,-,57780
31,26,5,-,54300,57782
6822,3997,2825,712,211700,57783
4223,2988,1235,554,166300,57785
135,112,23,-,-,57787
111,73,38,-,259200,57788
398,292,106,663,124300,57790
109,96,13,-,75000,57791
75,75,0,-,174000,57792
829,707,122,806,192900,57793
132,43,89,521,-,57794
4,0,4,-,-,57799
13,13,0,-,170800,58001
23,23,0,-,52100,58002
112,104,8,-,188300,58004
277,272,5,-,247600,58005
219,158,61,580,137500,58006
27,23,4,-,-,58007
78,72,6,-,153600,58008
15,15,0,-,-,58009
157,142,15,425,145000,58011
1080,818,262,678,176800,58012
55,47,8,-,41700,58013
123,111,12,-,143100,58015
56,53,3,-,141300,58016
167,146,21,517,71600,58017
129,123,6,-,198800,58018
151,135,16,560,165400,58021
660,464,196,655,100000,58027
47,47,0,-,101000,58029
268,224,44,500,84700,58030
221,194,27,921,102900,58031
342,225,117,559,106500,58032
158,133,25,375,102200,58033
147,119,28,338,50400,58035
119,119,0,-,159200,58036
156,126,30,406,159100,58038
470,292,178,687,119600,58040
656,556,100,393,87900,58041
572,550,22,1304,219600,58042
81,72,9,-,92500,58043
917,650,267,553,156800,58045
268,222,46,570,100000,58046
1488,1427,61,554,288700,58047
223,189,34,644,114900,58048
190,172,18,-,125000,58049
609,512,97,578,220800,58051
257,209,48,608,181300,58052
546,408,138,497,55900,58053
1333,880,453,548,128200,58054
99,89,10,-,-,58056
36,34,2,-,67500,58057
45,37,8,-,49600,58058
489,435,54,946,187200,58059
505,394,111,648,108900,58060
150,131,19,398,108700,58061
64,59,5,-,-,58062
124,92,32,-,114600,58063
200,154,46,572,98000,58064
11,11,0,-,-,58065
127,108,19,331,70900,58067
182,149,33,-,127900,58068
53,48,5,-,95000,58069
189,157,32,408,122800,58071
3697,2267,1430,658,124100,58072
4046,2470,1576,565,124300,58075
0,0,0,-,-,58076
249,231,18,500,174500,58077
13188,8958,4230,826,218100,58078
163,163,0,-,195200,58079
381,333,48,775,107900,58081
13479,6709,6770,665,170900,58102
23864,8819,15045,731,165400,58103
16060,7990,8070,935,258800,58104
0,0,0,-,-,58105
17748,8846,8902,804,207100,58201
0,0,0,-,-,58202
7606,2808,4798,746,146600,58203
747,2,745,1298,-,58204
0,0,0,-,-,58205
193,147,46,575,59100,58210
303,216,87,471,77800,58212
155,131,24,-,154900,58214
43,37,6,-,37800,58216
334,273,61,914,164000,58218
16,16,0,-,162500,58219
1008,764,244,584,107300,58220
136,128,8,475,65600,58222
124,121,3,-,101400,58223
26,26,0,-,94200,58224
452,359,93,488,93500,58225
227,182,45,642,79400,58227
369,259,110,631,129000,58228
47,30,17,775,-,58229
362,296,66,545,62000,58230
176,145,31,-,53700,58231
97,81,16,-,-,58233
169,132,37,681,100000,58235
2363,1585,778,606,92200,58237
77,70,7,-,-,58238
20,20,0,-,110300,58239
483,383,100,559,114700,58240
73,66,7,-,-,58241
246,222,24,608,68600,58243
68,51,17,671,71700,58244
1196,965,231,547,103900,58249
123,105,18,585,74100,58250
831,597,234,590,155200,58251
234,182,52,379,71700,58254
302,263,39,857,163400,58256
855,537,318,617,117600,58257
102,97,5,1063,135200,58258
200,159,41,555,84500,58259
81,78,3,-,93300,58260
483,390,93,729,86000,58261
27,17,10,-,-,58262
200,166,34,-,110000,58265
68,61,7,-,103400,58266
582,472,110,560,118300,58267
93,79,14,479,45000,58269
836,641,195,600,84600,58270
304,232,72,550,87900,58271
103,78,25,456,85000,58272
118,112,6,425,72100,58273
380,302,78,443,118200,58274
262,225,37,819,119300,58275
235,182,53,639,72400,58276
94,77,17,-,-,58277
704,652,52,600,194200,58278
35,35,0,-,-,58281
701,506,195,517,71100,58282
4356,2526,1830,546,136400,58301
19,11,8,-,-,58311
2142,1368,774,342,71400,58316
103,101,2,-,52400,58317
1802,1334,468,702,167300,58318
49,39,10,-,123400,58321
10,10,0,-,-,58323
613,442,171,524,82200,58324
28,25,3,-,-,58325
146,124,22,742,193300,58327
1006,756,250,322,66800,58329
135,108,27,471,62200,58330
55,51,4,-,102800,58331
174,154,20,522,80000,58332
434,120,314,391,24500,58335
46,41,5,-,-,58338
16,7,9,-,106300,58339
1216,969,247,439,91300,58341
36,27,9,-,-,58343
429,301,128,543,98100,58344
47,37,10,-,56300,58345
302,225,77,472,84400,58346
332,253,79,517,92800,58348
212,140,72,550,86700,58351
206,155,51,500,78800,58352
35,23,12,-,-,58353
26,26,0,-,44300,58355
806,523,283,482,74900,58356
109,87,22,-,83200,58357
120,96,24,-,85000,58361
9,9,0,-,-,58362
37,35,2,-,53900,58363
124,105,19,450,63800,58365
477,332,145,510,85000,58366
624,412,212,478,89400,58367
1763,1241,522,641,113500,58368
482,404,78,288,68600,58369
382,226,156,445,49300,58370
49,46,3,-,48000,58372
250,199,51,392,59600,58374
137,99,38,660,49400,58377
99,34,65,470,158300,58379
197,169,28,425,37200,58380
113,101,12,650,97500,58381
74,71,3,-,126900,58382
288,248,40,425,70000,58384
78,70,8,1075,76700,58385
58,58,0,-,82000,58386
7789,4810,2979,676,140100,58401
0,0,0,-,-,58402
0,0,0,-,-,58405
508,413,95,500,76000,58413
66,63,3,-,251500,58415
185,138,47,330,83600,58416
173,143,30,836,57800,58418
118,110,8,-,201400,58420
1259,934,325,523,142300,58421
59,38,21,-,90000,58422
21,19,2,-,-,58423
138,127,11,-,85200,58424
591,423,168,432,100400,58425
68,63,5,-,163400,58426
106,85,21,-,-,58428
195,141,54,613,122900,58429
51,47,4,-,-,58430
35,32,3,-,57500,58431
441,339,102,511,103100,58433
805,549,256,463,95800,58436
345,277,68,759,72500,58438
61,60,1,-,125000,58439
57,45,12,-,59500,58440
147,106,41,-,95000,58441
218,199,19,391,70800,58442
87,68,19,575,75000,58443
112,92,20,385,50000,58444
70,52,18,757,80000,58445
145,96,49,375,50700,58448
88,71,17,535,61700,58451
11,0,11,-,-,58452
207,143,64,413,64600,58454
174,147,27,338,64600,58455
250,214,36,514,71000,58456
507,370,137,631,103700,58458
112,100,12,500,48200,58460
202,146,56,839,70000,58461
337,247,90,290,59800,58463
121,106,15,-,70000,58464
161,116,45,647,97500,58466
242,177,65,613,79300,58467
219,189,30,754,115800,58472
1171,816,355,634,117900,58474
89,62,27,-,-,58475
130,108,22,534,84000,58476
82,65,17,-,91000,58477
68,48,20,444,32500,58478
67,62,5,-,137500,58479
143,108,35,686,95000,58480
135,125,10,-,239300,58481
466,340,126,524,119300,58482
138,119,19,375,82500,58483
16,13,3,-,-,58484
105,82,23,525,112500,58486
173,135,38,339,61000,58487
107,102,5,-,78000,58488
93,74,19,1063,71300,58490
197,157,40,-,77200,58492
125,97,28,425,82100,58494
664,500,164,531,71500,58495
100,66,34,425,-,58496
126,100,26,1058,89400,58497
13538,7829,5709,788,214300,58501
12982,9726,3256,920,299000,58503
11046,8062,2984,770,213400,58504
0,0,0,-,-,58505
119,104,15,563,129200,58520
222,199,23,825,309500,58521
1534,1251,283,573,174100,58523
48,45,3,-,109400,58524
166,52,114,486,80000,58528
276,227,49,669,65800,58529
493,426,67,548,156600,58530
201,189,12,-,213700,58531
102,72,30,890,105800,58532
478,390,88,538,84200,58533
280,238,42,805,83800,58535
672,239,433,476,91900,58538
1098,860,238,586,150600,58540
200,154,46,613,87900,58541
121,110,11,675,85000,58542
250,221,29,421,85900,58544
1593,1339,254,810,173500,58545
87,82,5,-,114300,58549
840,666,174,392,110300,58552
11186,7914,3272,849,205700,58554
399,380,19,-,226700,58558
99,96,3,-,191700,58559
78,64,14,481,150000,58560
473,381,92,650,80900,58561
194,175,19,350,87300,58562
900,738,162,693,134800,58563
53,51,2,-,66400,58564
130,118,12,-,155500,58565
48,43,5,-,-,58566
176,121,55,525,56900,58568
42,40,2,-,70000,58569
158,134,24,1208,95000,58570
236,206,30,456,121100,58571
117,106,11,533,216700,58572
260,239,21,400,64200,58573
394,297,97,678,117300,58575
402,327,75,687,145800,58576
856,706,150,769,192500,58577
553,446,107,438,166500,58579
123,98,25,1042,100000,58580
113,89,24,-,51000,58581
10395,6663,3732,931,239200,58601
46,36,10,867,187500,58620
660,441,219,646,119600,58621
708,544,164,850,159500,58622
997,716,281,610,179400,58623
114,84,30,-,-,58625
130,116,14,1000,118300,58626
73,62,11,-,179200,58627
265,191,74,1321,150800,58630
476,377,99,690,114200,58631
91,48,43,475,162500,58632
82,68,14,-,383300,58634
339,262,77,722,153300,58636
471,389,82,763,95800,58638
810,592,218,489,164400,58639
619,481,138,792,193400,58640
48,48,0,-,312000,58641
127,92,35,1018,202400,58642
102,76,26,617,44000,58643
130,68,62,821,220000,58645
529,414,115,875,89400,58646
426,370,56,590,161000,58647
190,121,69,504,72300,58649
174,143,31,575,101700,58650
241,194,47,-,101300,58651
497,426,71,1313,159000,58652
313,262,51,616,114000,58653
115,91,24,-,108900,58654
224,184,40,1031,201000,58655
204,191,13,731,165600,58656
14032,8658,5374,895,214900,58701
0,0,0,-,-,58702
8845,5300,3545,958,220700,58703
1662,38,1624,1681,-,58704
0,0,0,-,-,58705
0,0,0,-,-,58707
260,215,45,607,98800,58710
92,59,33,-,118300,58711
69,48,21,-,103600,58712
12,11,1,-,-,58713
78,72,6,-,137500,58716
369,320,49,600,179000,58718
260,180,80,730,113900,58721
576,454,122,1243,197300,58722
112,93,19,375,113900,58723
129,108,21,1113,109800,58725
107,81,26,-,107500,58727
581,440,141,724,161300,58730
112,96,16,1563,115900,58731
135,132,3,-,196900,58733
112,105,7,-,103900,58734
182,180,2,-,314700,58735
293,236,57,515,65200,58736
78,67,11,-,46300,58737
303,219,84,805,171300,58740
274,245,29,541,124300,58741
40,32,8,-,70000,58744
525,427,98,686,120800,58746
66,51,15,775,-,58748
229,188,41,888,162800,58750
96,57,39,485,113900,58752
46,38,8,-,-,58755
71,60,11,367,141700,58756
211,103,108,425,87500,58757
121,120,1,-,85400,58758
350,292,58,427,123400,58759
117,89,28,1071,127100,58760
406,315,91,675,111700,58761
123,104,19,525,107700,58762
1263,776,487,577,166500,58763
200,148,52,-,150000,58765
77,69,8,-,233900,58768
92,76,16,630,155400,58769
446,267,179,778,145300,58770
235,168,67,1299,155300,58771
91,75,16,-,68800,58772
339,267,72,917,152200,58773
87,33,54,325,101600,58775
110,64,46,1163,67100,58776
95,94,1,-,160000,58778
212,160,52,581,106600,58779
241,213,28,696,190100,58781
184,152,32,456,120000,58782
179,149,30,696,97100,58783
1121,828,293,719,195500,58784
546,419,127,1320,202100,58785
84,79,5,-,112100,58787
593,494,99,414,83900,58788
151,125,26,744,71200,58789
754,575,179,563,175900,58790
123,116,7,-,159500,58792
236,158,78,502,102100,58793
57,43,14,-,111300,58794
94,62,32,633,189600,58795
11357,6773,4584,928,246500,58801
106,106,0,-,112500,58830
174,144,30,1225,214300,58831
25,24,1,-,106800,58833
65,63,2,-,152000,58835
65,46,19,1167,187500,58838
166,160,6,-,258800,58843
85,68,17,-,137900,58844
138,105,33,496,160800,58845
118,105,13,-,197300,58847
340,265,75,683,200500,58849
691,531,160,1054,205900,58852
84,54,30,558,95000,58853
2570,1383,1187,1147,217500,58854
77,61,16,978,305600,58856
689,548,141,808,193800,59001
76,48,28,1056,150000,59002
384,166,218,498,106400,59003
396,282,114,525,-,59006
85,69,16,617,190600,59007
153,121,32,786,95000,59008
46,38,8,-,162500,59010
1299,966,333,670,215400,59011
88,41,47,935,-,59012
86,67,19,-,-,59013
725,530,195,684,170500,59014
163,153,10,675,149400,59015
257,161,96,759,90800,59016
226,194,32,-,264500,59018
1633,1310,323,766,224500,59019
27,24,3,-,266700,59020
444,262,182,521,72900,59022
182,115,67,-,120500,59024
20,9,11,138,237500,59025
78,62,16,-,141200,59026
366,240,126,884,315400,59027
250,159,91,642,320300,59028
355,315,40,725,148400,59029
642,377,265,679,315500,59030
87,69,18,-,103700,59031
160,117,43,539,108600,59032
116,105,11,-,282700,59033
1842,1104,738,741,120000,59034
92,57,35,693,80400,59035
568,357,211,569,88500,59036
648,580,68,1048,174300,59037
314,217,97,590,98300,59038
19,13,6,-,-,59039
723,583,140,756,208700,59041
757,434,323,552,66800,59043
4650,3612,1038,740,205600,59044
178,130,48,800,85000,59046
5747,4079,1668,732,223900,59047
400,300,100,488,77300,59050
78,51,27,750,-,59052
125,57,68,-,352500,59053
127,103,24,531,150500,59054
43,18,25,-,-,59055
326,314,12,-,302700,59057
22,22,0,-,187500,59058
60,41,19,-,-,59059
108,87,21,575,439300,59061
10,4,6,-,-,59062
785,611,174,582,224000,59063
58,14,44,-,-,59064
60,56,4,-,900000,59065
155,90,65,406,100000,59066
97,51,46,708,110400,59067
1694,1273,421,831,262000,59068
218,176,42,822,253100,59069
385,318,67,657,262200,59070
62,56,6,-,460000,59071
1902,1314,588,704,168100,59072
138,102,36,806,117500,59074
56,36,20,580,110700,59075
31,17,14,-,295800,59076
32,28,4,-,275000,59077
77,59,18,-,102100,59078
1223,1061,162,721,228600,59079
4,4,0,-,-,59081
17,9,8,-,229200,59082
41,31,10,-,137500,59085
417,318,99,633,234800,59086
180,125,55,481,109700,59087
646,474,172,831,202400,59088
126,71,55,475,108000,59089
16846,9658,7188,723,168500,59101
20912,13689,7223,904,203400,59102
11895,8767,3128,847,219800,59105
6317,5037,1280,1154,338800,59106
1508,926,582,435,120100,59201
61,56,5,-,155000,59211
198,156,42,570,183900,59212
196,123,73,273,68300,59213
49,36,13,-,-,59214
454,365,89,600,115200,59215
79,46,33,-,-,59217
324,248,76,775,201500,59218
104,89,15,944,100900,59219
686,489,197,650,182900,59221
48,37,11,-,76300,59222
172,137,35,674,203700,59223
194,92,102,364,72500,59225
148,107,41,892,135400,59226
2067,1598,469,489,152400,59230
268,135,133,692,27000,59231
10,9,1,-,205000,59240
218,181,37,575,102700,59241
32,18,14,-,118800,59242
106,65,41,622,123400,59243
8,6,2,-,-,59244
165,127,38,800,150500,59247
282,229,53,814,129800,59248
86,68,18,483,102300,59250
38,34,4,-,115000,59252
36,36,0,-,-,59253
982,765,217,714,161200,59254
1037,454,583,327,83600,59255
35,35,0,-,302800,59256
49,22,27,-,"10,000-",59257
55,31,24,-,103800,59258
155,119,36,521,77900,59259
64,42,22,-,170500,59260
243,192,51,345,67900,59261
263,182,81,690,165900,59262
765,573,192,671,121900,59263
3504,2145,1359,847,222400,59270
109,89,20,-,85800,59274
163,107,56,561,83000,59275
19,19,0,-,-,59276
4763,3342,1421,725,156000,59301
75,66,9,-,-,59311
13,11,2,-,135400,59312
1015,674,341,739,152400,59313
42,28,14,-,-,59314
44,41,3,-,102500,59315
533,334,199,550,111800,59317
47,30,17,-,118200,59318
24,13,11,-,-,59322
826,754,72,818,129100,59323
409,350,59,705,98100,59324
96,72,24,-,-,59326
1208,904,304,549,161000,59327
3763,2584,1179,655,157800,59330
76,49,27,-,-,59332
7,7,0,-,-,59333
84,52,32,538,160000,59336
307,257,50,446,92300,59337
38,32,6,-,230000,59338
69,58,11,-,110700,59339
62,41,21,-,-,59343
177,136,41,830,112500,59344
112,99,13,-,82300,59347
470,415,55,-,87200,59349
69,60,9,-,110700,59351
497,394,103,825,110100,59353
18,11,7,-,-,59354
6620,3419,3201,598,145700,59401
10620,8799,1821,744,185300,59404
13441,7451,5990,730,165400,59405
279,166,113,513,183900,59410
124,80,44,-,128300,59411
618,507,111,525,166000,59412
510,322,188,521,96000,59414
174,136,38,-,129200,59416
2350,1350,1000,411,75400,59417
60,25,35,-,-,59418
57,36,21,550,120000,59419
70,68,2,-,277800,59420
767,598,169,685,222400,59421
1031,642,389,689,155600,59422
34,31,3,-,205000,59424
1400,1038,362,713,128700,59425
1498,894,604,613,123200,59427
178,132,46,632,95900,59430
55,46,9,717,84000,59432
237,195,42,667,89700,59433
209,144,65,568,122200,59434
778,581,197,653,172800,59436
80,32,48,-,112500,59440
32,26,6,-,325000,59441
811,529,282,541,142800,59442
222,195,27,-,205000,59443
99,41,58,-,89300,59444
243,180,63,650,90000,59446
126,85,41,495,169600,59447
175,85,90,419,55900,59448
209,162,47,725,152600,59450
86,68,18,-,-,59451
211,170,41,594,153600,59452
116,94,22,575,86700,59453
110,84,26,867,77800,59454
143,48,95,-,-,59456
4018,2760,1258,717,137900,59457
95,79,16,-,68100,59460
10,10,0,-,-,59461
59,56,3,-,-,59462
76,72,4,-,246200,59463
177,136,41,550,112500,59464
15,8,7,706,85000,59465
36,24,12,-,-,59466
48,37,11,-,246900,59467
249,191,58,837,198600,59468
66,60,6,-,160700,59469
130,100,30,650,164600,59471
265,173,92,875,121500,59472
1310,729,581,555,141300,59474
129,104,25,-,157000,59477
393,249,144,521,119900,59479
203,148,55,1167,155700,59480
223,158,65,683,119000,59482
206,181,25,681,215100,59483
52,33,19,-,117500,59484
214,212,2,-,219400,59485
396,307,89,525,124700,59486
506,414,92,585,157500,59487
141,105,36,500,99400,59489
5028,3131,1897,638,139900,59501
448,309,139,446,116500,59520
1008,414,594,304,66500,59521
672,404,268,548,117100,59522
932,653,279,518,129300,59523
255,172,83,472,67100,59524
122,81,41,578,86100,59525
781,393,388,467,66900,59526
319,159,160,419,49300,59527
100,67,33,-,69400,59528
77,47,30,617,170800,59529
36,32,4,-,27100,59530
114,88,26,-,-,59531
99,73,26,-,89500,59532
33,13,20,-,-,59535
6,2,4,-,-,59537
1269,886,383,559,132400,59538
153,132,21,719,77100,59540
58,38,20,358,70000,59542
88,42,46,277,-,59544
12,4,8,-,-,59545
43,39,4,-,-,59546
22,19,3,-,-,59547
13674,7687,5987,783,218500,59601
10074,8445,1629,962,235700,59602
101,87,14,375,157800,59631
674,497,177,693,153900,59632
97,94,3,-,287000,59633
1860,1707,153,1034,321900,59634
2739,1992,747,813,186000,59635
0,0,0,-,-,59636
239,214,25,-,265300,59638
497,418,79,618,171300,59639
58,58,0,-,201900,59640
21,6,15,-,-,59642
250,196,54,503,154800,59643
1694,1385,309,642,172900,59644
676,487,189,610,127600,59645
149,141,8,-,243200,59647
259,192,67,685,230200,59648
14751,9665,5086,606,130700,59701
19,17,2,-,390000,59703
113,75,38,750,235000,59710
4093,2899,1194,515,118400,59711
94,54,40,613,164100,59713
7430,5362,2068,902,241100,59714
14122,7365,6757,854,398100,59715
832,566,266,1363,379700,59716
13860,8733,5127,1119,295300,59718
119,119,0,-,427800,59720
200,149,51,823,192200,59721
1891,1280,611,560,132500,59722
35,20,15,-,-,59724
3372,2223,1149,588,192800,59725
111,95,16,950,204700,59727
172,151,21,613,204800,59728
1079,798,281,781,321100,59729
847,590,257,898,459800,59730
54,49,5,-,193800,59731
84,33,51,792,191100,59732
64,45,19,-,255000,59733
100,77,23,-,-,59735
45,23,22,625,212500,59736
124,91,33,709,113700,59739
150,133,17,-,410200,59740
1656,1252,404,1001,260800,59741
61,46,15,-,145800,59743
53,39,14,-,195800,59745
54,48,6,-,277800,59746
84,80,4,-,204200,59747
73,70,3,-,162500,59748
689,562,127,707,206900,59749
191,177,14,-,217100,59750
126,79,47,589,193800,59751
1441,1074,367,745,229600,59752
391,284,107,825,179500,59754
95,82,13,775,184100,59755
0,0,0,-,-,59756
854,435,419,580,258300,59758
1610,1318,292,671,211100,59759
112,78,34,591,203800,59760
141,85,56,538,221200,59761
125,99,26,-,307500,59762
13849,5583,8266,769,235300,59801
9300,4256,5044,740,253100,59802
6629,5122,1507,814,287700,59803
3216,2083,1133,1049,323800,59804
7868,5217,2651,900,235200,59808
651,504,147,939,211100,59820
974,758,216,627,202500,59821
740,573,167,1017,267500,59823
542,325,217,664,231100,59824
917,756,161,832,235900,59825
226,205,21,613,305600,59826
109,89,20,-,161900,59827
2096,1712,384,735,280300,59828
1008,772,236,625,237300,59829
45,32,13,-,-,59830
188,128,60,458,102300,59831
343,226,117,510,165500,59832
2104,1781,323,951,301400,59833
877,783,94,637,335300,59834
164,128,36,525,242300,59837
6050,3954,2096,780,203600,59840
178,124,54,515,156700,59841
9,9,0,-,-,59842
96,61,35,597,258300,59843
289,232,57,627,256700,59844
573,403,170,474,112300,59845
509,492,17,-,314500,59846
2132,1771,361,687,242700,59847
64,46,18,411,175000,59848
91,61,30,-,115800,59851
370,299,71,548,175500,59853
102,71,31,625,272500,59854
362,109,253,675,-,59855
111,89,22,675,123600,59856
570,427,143,590,219200,59858
1320,1036,284,701,224600,59859
4263,3051,1212,665,225800,59860
33,25,8,-,95900,59863
2522,1709,813,641,185300,59864
1288,978,310,661,173800,59865
370,240,130,708,152100,59866
28,8,20,-,-,59867
758,624,134,635,218200,59868
4199,3310,889,730,266900,59870
106,56,50,-,279200,59871
861,630,231,339,161000,59872
1513,1035,478,815,253300,59873
602,545,57,550,214600,59874
1552,1122,430,782,251700,59875
20312,14232,6080,797,229900,59901
250,237,13,-,237500,59910
3521,2865,656,966,337000,59911
5770,4167,1603,717,210900,59912
267,204,63,-,190300,59913
115,92,23,788,225000,59914
134,61,73,-,-,59915
68,62,6,-,246700,59916
1839,1493,346,691,199800,59917
280,236,44,706,-,59918
224,176,48,-,-,59919
674,584,90,844,280300,59920
994,708,286,999,289700,59922
4126,3146,980,657,165200,59923
471,408,63,879,254800,59925
163,116,47,-,-,59926
151,117,34,-,274000,59927
106,98,8,-,291700,59928
146,117,29,-,239100,59929
192,163,29,-,176300,59930
153,124,29,-,548100,59931
527,496,31,-,231800,59932
22,19,3,-,-,59933
233,215,18,-,268000,59934
1552,1278,274,574,187000,59935
142,118,24,938,354500,59936
5856,4051,1805,841,343000,59937
9093,7163,1930,984,198600,60002
19912,15794,4118,1292,345500,60004
12637,8208,4429,1149,323200,60005
13503,9820,3683,1149,260900,60007
8363,5954,2409,1239,217000,60008
16435,14638,1797,1466,528300,60010
3838,3472,366,2048,309600,60012
9105,7924,1181,1190,220300,60013
17393,13444,3949,1228,214400,60014
9612,8341,1271,1765,506900,60015
22880,15022,7858,1087,217700,60016
10139,7147,2992,961,236300,60018
4374,3065,1309,924,130700,60020
2027,1685,342,946,247400,60021
3068,2893,175,1178,935600,60022
14910,12185,2725,1216,428300,60025
5293,3696,1597,1724,576700,60026
149,137,12,-,821000,60029
14167,10958,3209,1163,209500,60030
13708,10050,3658,1188,247100,60031
4542,2960,1582,972,143400,60033
782,511,271,1019,162500,60034
11497,9505,1992,1659,574300,60035
2022,794,1228,1129,362400,60040
3433,2755,678,1080,172200,60041
3273,2673,600,1300,158800,60042
812,743,69,2938,1046200,60043
3815,2694,1121,1381,479300,60044
7317,6390,927,1837,844700,60045
12263,10100,2163,1265,212000,60046
13698,12473,1225,1452,434100,60047
10368,8674,1694,1238,444100,60048
12384,8835,3549,1157,171800,60050
8762,7136,1626,1208,194300,60051
8278,7655,623,1722,290500,60053
20630,14301,6329,1040,304400,60056
12674,9771,2903,1254,241500,60060
10118,6923,3195,1450,336700,60061
15705,13046,2659,1613,491400,60062
5149,2254,2895,927,99100,60064
15396,11923,3473,1252,348800,60067
14117,11594,2523,1297,407100,60068
3265,2646,619,2563,455100,60069
5925,3907,2018,982,262700,60070
1408,950,458,917,210900,60071
334,311,23,1125,310800,60072
18696,14581,4115,1254,150300,60073
14477,8822,5655,1093,224100,60074
10733,8416,2317,1228,301400,60076
10209,6378,3831,1141,252100,60077
3456,2950,506,1330,272100,60081
3538,2845,693,1671,256900,60083
6196,4754,1442,1130,214700,60084
23075,9593,13482,887,99700,60085
9357,5980,3377,1028,129700,60087
1150,0,1150,1617,-,60088
15662,12272,3390,1481,314400,60089
14233,8732,5501,1195,181800,60090
9600,8470,1130,1509,658700,60091
6906,6126,780,1759,900900,60093
2656,1968,688,1088,190000,60096
4196,3504,692,1109,157700,60097
12451,8251,4200,999,189400,60098
10494,6574,3920,985,126400,60099
13235,8896,4339,968,231200,60101
11344,9943,1401,1540,251400,60102
13867,12321,1546,1470,266800,60103
6141,4385,1756,1074,120000,60104
6901,3702,3199,1075,210900,60106
13167,11070,2097,1604,174600,60107
8924,6421,2503,1232,292000,60108
225,150,75,1210,170100,60109
11234,7724,3510,1037,158200,60110
101,93,8,-,274200,60111
1329,1102,227,977,144400,60112
140,82,58,909,110300,60113
16025,6131,9894,848,153900,60115
6265,4645,1620,1203,264400,60118
3616,3066,550,1350,292700,60119
15309,9893,5416,1038,159000,60120
16153,10150,6003,977,162700,60123
7537,6916,621,1987,289200,60124
16772,13509,3263,1515,390700,60126
74,54,20,967,150000,60129
6992,3502,3490,984,229600,60130
6329,4591,1738,829,181000,60131
11254,8328,2926,1255,173100,60133
10414,8643,1771,1453,336000,60134
2618,1764,854,1044,178700,60135
2347,2169,178,1215,256100,60136
14186,11327,2859,1000,381700,60137
11513,7158,4355,1165,174500,60139
5784,5176,608,1584,239000,60140
24,0,24,-,-,60141
11346,10364,982,1204,240500,60142
4089,2975,1114,1273,321000,60143
31,24,7,-,250000,60144
943,718,225,1064,196500,60145
973,708,265,729,147300,60146
20409,15112,5297,1243,249300,60148
679,526,153,929,139300,60150
1521,1177,344,1344,222700,60151
4519,3479,1040,961,202200,60152
7474,4585,2889,938,138700,60153
6632,5913,719,1380,225300,60154
3227,2127,1100,936,148400,60155
9663,7961,1702,1403,210900,60156
891,891,0,-,350600,60157
7680,3691,3989,928,173700,60160
3013,1865,1148,1012,154900,60162
1744,1478,266,967,172100,60163
6549,4741,1808,923,163900,60164
1321,740,581,1055,118700,60165
11752,7687,4065,1211,209000,60169
4020,2402,1618,913,190300,60171
9015,7006,2009,1333,243300,60172
5774,1948,3826,1339,321000,60173
12506,8541,3965,1148,273800,60174
8020,7681,339,1815,391600,60175
4243,2725,1518,922,183800,60176
7672,6315,1357,1320,217000,60177
8315,5533,2782,994,193800,60178
636,443,193,1669,257900,60180
10621,7511,3110,1185,225700,60181
907,859,48,-,548200,60184
10683,7824,2859,1061,251800,60185
9830,7308,2522,1231,338300,60187
15212,10309,4903,1142,238300,60188
11600,8838,2762,1395,355600,60189
4264,3929,335,1746,304800,60190
5047,4137,910,1279,222400,60191
5512,4969,543,2221,338600,60192
15634,12070,3564,1305,253600,60193
7517,5422,2095,1443,215700,60194
2232,747,1485,1307,217300,60195
15339,8999,6340,1415,465700,60201
13388,7151,6237,1217,295600,60202
1503,1389,114,1415,411700,60203
1490,338,1152,1845,197400,60301
13722,7817,5905,1026,389700,60302
6317,4382,1935,1139,361600,60304
3909,3403,506,1273,575900,60305
3053,2607,446,848,180500,60401
20633,12236,8397,937,178700,60402
6870,4524,2346,1043,160200,60403
6391,5609,782,1476,238900,60404
9081,4718,4363,843,110400,60406
632,484,148,910,135800,60407
2130,1554,576,874,160900,60408
13583,7383,6200,934,101300,60409
4089,3712,377,1301,203300,60410
20069,12592,7477,900,97100,60411
5050,2634,2416,962,153300,60415
3380,2482,898,951,182200,60416
5958,5066,892,983,172300,60417
7512,4828,2684,1219,94300,60419
2190,1440,750,674,135300,60420
1471,1299,172,1016,174200,60421
3523,3079,444,2054,228200,60422
10304,9712,592,1342,303400,60423
916,697,219,875,147100,60424
3120,2364,756,986,127900,60425
10626,5350,5276,834,72000,60426
4233,2870,1363,1129,88400,60428
5843,3877,1966,1354,106800,60429
7788,6041,1747,1124,160500,60430
7671,6683,988,1373,175800,60431
6248,3208,3040,899,102500,60432
5586,3332,2254,1008,106600,60433
18189,11520,6669,921,148800,60435
6008,3635,2373,1037,113000,60436
74,52,22,-,106300,60437
11500,7669,3831,976,125600,60438
8361,6950,1411,1033,347700,60439
16268,12266,4002,1267,179000,60440
11734,9751,1983,1144,203200,60441
3370,2876,494,1284,238400,60442
7675,6273,1402,1227,149900,60443
643,435,208,926,173800,60444
10763,8191,2572,967,144200,60445
11723,9795,1928,1470,171100,60446
4539,3979,560,1485,193100,60447
8648,7778,870,1059,291900,60448
3510,3285,225,889,199500,60449
8552,5431,3121,938,211200,60450
11500,10362,1138,1080,274200,60451
10587,8307,2280,1034,186300,60452
21472,17076,4396,1037,191100,60453
5592,4098,1494,939,164300,60455
1877,1481,396,861,110000,60456
4875,3520,1355,927,215600,60457
5185,2720,2465,958,166000,60458
9090,7096,1994,1024,174200,60459
495,382,113,750,113100,60460
1947,1675,272,1628,228500,60461
15452,13247,2205,1182,260000,60462
5529,5192,337,1871,276100,60463
3830,3292,538,1647,371900,60464
6954,5390,1564,985,187900,60465
8579,5224,3355,1091,70600,60466
9691,9335,356,1223,323800,60467
2176,1789,387,878,199500,60468
1852,1283,569,1038,103300,60469
245,197,48,833,126100,60470
5193,2832,2361,1044,142800,60471
1709,803,906,805,69400,60472
7335,6165,1170,1397,149600,60473
371,281,90,813,130600,60474
4269,2787,1482,858,109400,60475
1063,759,304,818,114000,60476
15097,11607,3490,1105,201100,60477
5761,4303,1458,1198,132100,60478
314,240,74,1130,164500,60479
2050,1708,342,1079,326600,60480
4654,3560,1094,844,169400,60481
4105,2745,1360,887,161700,60482
2454,1425,1029,959,114500,60484
8731,8044,687,1085,254700,60487
5855,5630,225,1892,274800,60490
7985,7442,543,1616,311800,60491
3391,1853,1538,866,160000,60501
8086,6204,1882,1555,278700,60502
5267,4664,603,1744,228800,60503
13171,8133,5038,1406,192200,60504
21227,11947,9280,1032,113500,60505
17527,11385,6142,968,164800,60506
10999,8630,2369,1145,295700,60510
611,530,81,1097,242100,60511
690,581,109,-,173900,60512
6943,5444,1499,1073,233900,60513
3828,2900,928,962,457900,60514
11386,8566,2820,1091,348200,60515
11695,9216,2479,1295,331700,60516
12714,8730,3984,1189,255300,60517
1379,987,392,737,129500,60518
11,5,6,-,-,60519
1024,783,241,882,200100,60520
5913,5037,876,1791,863900,60521
4358,3676,682,665,678100,60523
11527,9095,2432,1040,339600,60525
5069,3502,1567,1107,333200,60526
11521,9038,2483,1365,428000,60527
186,154,32,688,122900,60530
687,546,141,832,172200,60531
12061,7280,4781,1243,307500,60532
3905,2364,1541,929,156300,60534
58,42,16,1111,164300,60536
259,236,23,840,184200,60537
9042,7402,1640,1284,183400,60538
0,0,0,-,-,60539
15848,11973,3875,1424,400300,60540
1253,1047,206,902,250500,60541
6290,4986,1304,974,232900,60542
12602,10454,2148,1243,231300,60543
9374,7456,1918,1626,213000,60544
4377,3055,1322,871,159900,60545
5858,4347,1511,957,281400,60546
4217,3336,881,968,168900,60548
186,128,58,-,176800,60549
631,423,208,798,166500,60550
1604,1271,333,815,189600,60551
1824,1367,457,1144,182200,60552
287,226,61,904,162500,60553
4327,3827,500,1278,273400,60554
4953,4027,926,1391,208200,60555
645,486,159,795,160300,60556
34,34,0,-,-,60557
4376,4191,185,1784,553300,60558
10353,5644,4709,1069,279300,60559
8199,6673,1526,1101,242500,60560
9251,7708,1543,1150,313400,60561
15087,8349,6738,1379,324900,60563
13138,11579,1559,1832,441700,60564
13697,12223,1474,1341,377700,60565
6955,6220,735,1933,316700,60585
13573,12546,1027,1689,202400,60586
8400,3269,5131,2045,502600,60601
596,157,439,2506,-,60602
563,301,262,2390,678900,60603
400,154,246,1960,506800,60604
13239,7017,6222,1950,387900,60605
1979,914,1065,2177,441900,60606
12663,5746,6917,1761,357300,60607
25372,9175,16197,865,239900,60608
19960,7728,12232,798,163200,60609
23301,8652,14649,1501,416100,60610
20487,9535,10952,1881,477300,60611
13200,3520,9680,972,245500,60612
26251,10378,15873,1303,324700,60613
33591,14357,19234,1512,545400,60614
20470,6050,14420,1073,217900,60615
23924,8352,15572,1000,294400,60616
27837,15967,11870,807,127300,60617
35275,15662,19613,1134,355600,60618
26056,10841,15215,860,151900,60619
25425,11769,13656,865,135000,60620
11022,2721,8301,815,107600,60621
23608,8723,14885,1384,450700,60622
25118,8496,16622,830,148600,60623
11976,3038,8938,907,155500,60624
29445,11864,17581,1094,329700,60625
22190,5250,16940,953,190500,60626
23324,13165,10159,944,116800,60628
31223,17735,13488,893,152900,60629
20959,13283,7676,1025,287700,60630
11908,8942,2966,1173,340400,60631
24526,13187,11339,847,166200,60632
4695,3187,1508,902,117500,60633
25963,18575,7388,1023,240500,60634
11222,5199,6023,868,93900,60636
18991,4789,14202,916,178100,60637
20100,15436,4664,951,199600,60638
25264,11489,13775,971,204300,60639
34482,10669,23813,970,280600,60640
24555,12418,12137,981,271100,60641
9103,3452,5651,1543,395400,60642
18105,13356,4749,968,187300,60643
16119,4645,11474,889,150100,60644
16185,8020,8165,1025,259500,60645
10759,7931,2828,943,381200,60646
34251,12935,21316,1164,356000,60647
20538,4600,15938,850,165000,60649
19283,8134,11149,959,155200,60651
13211,10951,2260,1007,162500,60652
14260,3397,10863,741,240300,60653
11635,4607,7028,1956,445500,60654
10106,8637,1469,1068,240200,60655
11730,7409,4321,1056,268900,60656
36818,14269,22549,1431,404600,60657
12866,5178,7688,1099,282400,60659
20576,7503,13073,950,225900,60660
5776,1746,4030,1901,349600,60661
8934,6933,2001,974,268400,60706
15639,10148,5491,958,234900,60707
4268,3647,621,1831,385700,60712
10976,8224,2752,1086,265900,60714
8523,5359,3164,935,163300,60803
22302,10805,11497,875,139100,60804
7089,5599,1490,994,182600,60805
10734,4697,6037,730,89600,60827
12716,7697,5019,816,107500,60901
201,151,50,765,83400,60910
557,414,143,721,135400,60911
177,146,31,781,85900,60912
664,584,80,651,179800,60913
10080,7273,2807,940,169800,60914
3897,2461,1436,814,115500,60915
189,157,32,950,143900,60917
362,314,48,675,85600,60918
190,142,48,775,83900,60919
64,47,17,950,80800,60920
568,356,212,648,81400,60921
819,629,190,844,131300,60922
675,505,170,549,114200,60924
16,16,0,-,65000,60926
836,647,189,739,149200,60927
320,261,59,686,89900,60928
342,239,103,579,83600,60929
340,282,58,850,132000,60930
227,171,56,655,92500,60931
35,27,8,-,76100,60932
115,90,25,580,86900,60933
124,91,33,413,147500,60934
383,352,31,1229,210800,60935
1804,1222,582,620,120600,60936
804,567,237,667,103600,60938
1298,1035,263,1091,210400,60940
794,628,166,644,167300,60941
2474,1656,818,498,67800,60942
73,70,3,-,66300,60945
174,134,40,646,69200,60946
643,568,75,673,154700,60948
225,157,68,732,81500,60949
4446,3112,1334,850,176200,60950
331,259,72,794,111300,60951
254,204,50,634,80500,60952
1025,824,201,540,80300,60953
2176,1612,564,860,143900,60954
641,516,125,663,99000,60955
2190,1577,613,594,108300,60957
808,418,390,729,82300,60958
453,334,119,760,78600,60959
394,304,90,638,66000,60960
298,258,40,1053,121100,60961
256,176,80,729,54300,60962
721,493,228,611,73200,60963
1998,1527,471,754,126100,60964
659,511,148,673,66000,60966
138,109,29,625,81300,60968
14,9,5,-,77500,60969
3175,2197,978,569,85700,60970
177,115,62,725,71000,60973
142,116,26,700,68100,60974
452,388,64,564,151700,61001
720,477,243,738,119200,61006
218,167,51,682,171300,61007
12258,9307,2951,783,131800,61008
2992,2410,582,718,173300,61010
871,804,67,1348,202400,61011
807,614,193,925,123600,61012
172,157,15,530,90500,61013
512,400,112,763,104700,61014
344,320,24,583,158500,61015
2089,1706,383,786,163500,61016
468,364,104,594,101900,61018
1349,1213,136,859,154600,61019
1040,867,173,794,146600,61020
8678,6411,2267,662,119400,61021
1059,857,202,674,147400,61024
1975,1539,436,641,141500,61025
8,0,8,-,-,61027
1006,708,298,671,136900,61028
970,705,265,658,101100,61030
606,497,109,661,116600,61031
13180,8342,4838,640,85900,61032
3086,2501,585,748,205000,61036
37,37,0,-,90600,61037
420,382,38,-,214300,61038
381,294,87,640,128100,61039
523,373,150,514,88400,61041
262,184,78,438,119100,61042
38,27,11,921,119800,61043
118,91,27,466,94800,61044
1181,957,224,625,140100,61046
865,696,169,720,159300,61047
1712,1274,438,560,117800,61048
220,199,21,781,162500,61049
165,153,12,-,77200,61050
664,496,168,657,107400,61051
394,362,32,862,180800,61052
1226,942,284,509,97100,61053
1762,1118,644,585,97700,61054
60,60,0,-,116700,61057
69,51,18,770,82100,61059
650,449,201,605,106900,61060
3047,2228,819,548,149000,61061
708,629,79,655,118800,61062
1763,1332,431,836,124000,61063
1424,1149,275,685,102600,61064
3481,2849,632,1262,144700,61065
281,247,34,806,114500,61067
5525,3567,1958,744,120100,61068
514,437,77,583,143800,61070
5848,4296,1552,723,86200,61071
4552,3833,719,743,159100,61072
7159,6047,1112,1047,164800,61073
1993,1451,542,630,77100,61074
442,373,69,685,147100,61075
21,21,0,-,-,61077
509,418,91,493,114800,61078
53,45,8,-,-,61079
3765,2917,848,677,128700,61080
8877,6353,2524,652,99300,61081
1151,972,179,921,162000,61084
1438,1146,292,645,104100,61085
747,551,196,496,88700,61087
2274,1967,307,689,154500,61088
329,275,54,656,111900,61089
25,25,0,-,-,61091
7793,3995,3798,686,68100,61101
6421,4338,2083,700,76600,61102
10089,5217,4872,687,83100,61103
7626,2578,5048,661,56900,61104
13193,8791,4402,865,124700,61107
11142,7699,3443,783,95900,61108
10720,6618,4102,694,99200,61109
9813,6655,3158,820,112400,61111
100,0,100,2947,-,61112
6425,4763,1662,939,144700,61114
8703,6690,2013,883,113600,61115
15510,10153,5357,688,100100,61201
506,405,101,677,127200,61230
2273,1591,682,633,107500,61231
517,482,35,742,139900,61232
600,419,181,680,115300,61234
592,526,66,779,107500,61235
45,35,10,-,104500,61236
1282,1071,211,808,112200,61238
532,189,343,725,96100,61239
2547,2306,241,1125,171900,61240
2628,2316,312,743,124800,61241
455,381,74,754,131100,61242
105,98,7,-,132100,61243
9070,6117,2953,614,111300,61244
994,837,157,669,132300,61250
141,141,0,-,140400,61251
2411,1854,557,611,131000,61252
4350,3616,734,640,172100,61254
812,673,139,956,140300,61256
471,396,75,677,114400,61257
83,71,12,-,56000,61258
438,356,82,988,171700,61259
424,322,102,630,85500,61260
337,285,52,733,86600,61261
510,479,31,689,145500,61262
248,195,53,347,95400,61263
4904,3753,1151,655,118600,61264
18879,12377,6502,710,117100,61265
2862,2336,526,714,120600,61270
572,440,132,502,97000,61272
1345,1167,178,674,149900,61273
84,51,33,-,89700,61274
1761,1538,223,868,167700,61275
35,35,0,-,128100,61276
1246,983,263,687,109300,61277
145,131,14,620,163200,61278
416,330,86,925,109500,61279
931,827,104,769,163900,61281
3202,1914,1288,714,113600,61282
548,407,141,624,93200,61283
887,763,124,-,176600,61284
664,556,108,695,136200,61285
4303,2770,1533,822,87100,61301
1546,1148,398,703,101700,61310
102,89,13,-,109200,61311
198,159,39,965,111900,61312
90,48,42,-,136400,61313
352,245,107,808,68500,61314
86,59,27,908,45000,61315
130,111,19,928,85800,61316
183,149,34,750,87900,61317
296,227,69,1056,121200,61318
453,391,62,731,115200,61319
315,264,51,772,122200,61320
114,92,22,-,81200,61321
516,347,169,652,56400,61322
33,30,3,-,60000,61323
47,47,0,-,81900,61324
386,339,47,950,118700,61325
988,800,188,650,111300,61326
515,359,156,767,158800,61327
9,9,0,-,-,61328
512,441,71,698,99300,61329
581,469,112,744,127200,61330
10,10,0,-,-,61331
46,46,0,-,81800,61332
124,120,4,-,90000,61333
291,236,55,910,91500,61334
204,158,46,675,133300,61335
176,150,26,550,112500,61336
152,126,26,900,83000,61337
131,99,32,635,79700,61338
131,105,26,625,120300,61340
2985,2267,718,815,143900,61341
3383,2476,907,540,124900,61342
157,118,39,675,70000,61344
323,297,26,821,108700,61345
33,33,0,-,59000,61346
1924,1494,430,546,115500,61348
332,267,65,816,92700,61349
9897,6673,3224,760,140400,61350
507,379,128,731,138400,61353
4672,3315,1357,700,119100,61354
4672,3391,1281,602,125200,61356
132,113,19,525,70800,61358
134,118,16,756,83300,61359
1334,1020,314,887,165600,61360
479,353,126,646,80500,61361
2363,1717,646,584,112100,61362
115,80,35,400,85000,61363
7829,5738,2091,612,89700,61364
349,252,97,773,128500,61367
604,535,69,708,101800,61368
694,579,115,580,81700,61369
573,433,140,804,129800,61370
59,48,11,625,109400,61372
890,752,138,782,169000,61373
65,56,9,-,86300,61374
522,508,14,540,123600,61375
884,666,218,669,113100,61376
616,416,200,755,111300,61377
198,169,29,995,115900,61378
564,480,84,680,89800,61379
13752,8176,5576,606,76900,61401
1550,1075,475,502,73900,61410
192,154,38,-,113600,61411
583,514,69,679,74900,61412
410,349,61,525,98500,61413
368,271,97,605,71700,61414
689,573,116,666,85700,61415
111,82,29,415,30000,61416
154,147,7,-,86000,61417
268,226,42,625,87000,61418
72,61,11,-,75400,61419
488,395,93,588,84600,61420
480,397,83,596,84900,61421
1215,921,294,419,69400,61422
240,199,41,-,127800,61423
46,27,19,-,95000,61424
176,166,10,-,109700,61425
41,41,0,-,119600,61426
848,712,136,713,78800,61427
386,386,0,-,212500,61428
356,262,94,646,106800,61430
155,128,27,547,57800,61431
233,215,18,633,82800,61432
41,37,4,-,-,61433
1335,1031,304,497,76000,61434
39,39,0,-,-,61435
366,276,90,628,142500,61436
403,329,74,703,105600,61437
338,274,64,675,111000,61438
110,104,6,688,73800,61439
301,292,9,756,78600,61440
445,381,64,525,85000,61441
317,221,96,385,58000,61442
5709,3666,2043,571,63500,61443
362,339,23,597,82800,61447
1490,1178,312,664,102500,61448
189,169,20,475,60400,61449
716,604,112,572,71400,61450
167,153,14,-,127100,61451
120,111,9,-,62400,61452
297,211,86,583,62600,61453
233,183,50,500,65600,61454
7435,4396,3039,677,106500,61455
346,287,59,561,76900,61458
156,133,23,752,114200,61459
140,109,31,675,85000,61460
4418,3088,1330,576,81600,61462
523,412,111,596,91400,61465
148,110,38,653,74400,61466
400,329,71,636,103200,61467
26,26,0,-,-,61468
938,755,183,544,82000,61469
173,163,10,617,66500,61470
38,38,0,-,53300,61471
232,207,25,565,115200,61472
642,488,154,637,76800,61473
94,84,10,-,75400,61474
87,66,21,621,150000,61475
173,136,37,-,81800,61476
266,203,63,743,-,61477
123,117,6,-,158100,61478
41,41,0,-,56600,61479
521,349,172,571,84200,61480
283,255,28,725,66000,61482
883,699,184,607,82100,61483
321,289,32,613,53000,61484
234,196,38,764,78000,61485
569,464,105,584,116100,61486
449,373,76,552,86800,61488
384,286,98,695,82700,61489
499,394,105,739,94500,61490
842,658,184,600,90700,61491
671,576,95,513,57400,61501
309,238,71,647,108100,61516
1302,1122,180,765,223800,61517
106,78,28,643,78800,61519
6450,4546,1904,614,91300,61520
4569,3533,1036,689,140200,61523
123,80,43,793,60000,61524
3146,2615,531,932,259900,61525
298,287,11,-,204700,61526
1110,925,185,1139,235700,61528
1051,853,198,540,126700,61529
2542,1945,597,581,153600,61530
1344,1150,194,672,105600,61531
250,231,19,725,73600,61532
942,787,155,685,123100,61533
724,625,99,633,139300,61534
522,506,16,-,198500,61535
1166,919,247,677,142900,61536
1131,911,220,615,95900,61537
105,83,22,673,65500,61539
1118,913,205,534,95600,61540
52,46,6,-,63600,61541
1480,1219,261,533,87300,61542
61,51,10,-,46000,61543
254,214,40,1063,63300,61544
296,270,26,725,105300,61545
1653,1404,249,677,116400,61546
1554,1449,105,789,173400,61547
4360,3681,679,963,203500,61548
7393,5654,1739,903,191000,61550
74,65,9,-,110300,61552
86,68,18,604,56300,61553
17263,12634,4629,687,107800,61554
1117,930,187,792,150500,61559
271,255,16,-,158000,61560
1037,850,187,662,125000,61561
0,0,0,-,-,61562
221,158,63,652,62100,61563
373,303,70,687,76900,61564
640,581,59,735,136900,61565
251,208,43,777,81100,61567
1422,1169,253,722,180900,61568
437,428,9,-,133700,61569
628,489,139,752,97700,61570
9963,7713,2250,788,162000,61571
493,388,105,675,107000,61572
617,117,500,519,191300,61602
6395,3246,3149,716,69500,61603
12736,8252,4484,720,89500,61604
5786,2284,3502,656,38300,61605
2153,798,1355,695,132500,61606
4504,3865,639,845,128700,61607
2194,1605,589,821,83200,61610
10924,8290,2634,703,136200,61611
12714,8257,4457,805,145300,61614
10014,6042,3972,859,181500,61615
2726,1528,1198,717,86500,61616
5,0,5,-,-,61625
15182,7865,7317,755,116800,61701
14499,9927,4572,911,199200,61704
4641,3858,783,834,260400,61705
63,55,8,767,81300,61720
252,196,56,730,116400,61721
194,149,45,743,101300,61722
1001,840,161,729,99700,61723
213,176,37,750,101900,61724
561,539,22,750,162900,61725
1061,772,289,771,117800,61726
4028,3025,1003,528,98500,61727
447,355,92,686,101300,61728
417,374,43,700,173500,61729
156,130,26,740,111500,61730
62,62,0,-,122100,61731
780,672,108,734,146500,61732
362,286,76,847,153800,61733
1094,824,270,646,119000,61734
204,187,17,629,134900,61735
632,564,68,909,195400,61736
212,179,33,696,132400,61737
1554,1227,327,798,135700,61738
1930,1370,560,611,115700,61739
661,518,143,723,117600,61740
598,470,128,633,107800,61741
448,387,61,583,217300,61742
81,75,6,-,112500,61743
705,613,92,678,129300,61744
1596,1323,273,791,165800,61745
593,441,152,828,138600,61747
1093,1015,78,763,188900,61748
231,203,28,690,74100,61749
73,57,16,-,87900,61750
56,48,8,-,115000,61751
1741,1349,392,670,146800,61752
1158,999,159,690,162800,61753
461,361,100,763,109500,61754
1837,1595,242,687,173800,61755
878,734,144,570,94100,61756
625,478,147,812,120900,61759
1008,840,168,730,93800,61760
19461,10952,8509,835,165600,61761
5230,3617,1613,671,108000,61764
242,206,36,600,88800,61769
452,367,85,696,100200,61770
329,310,19,775,120600,61771
95,48,47,-,154200,61772
195,143,52,666,72100,61773
398,354,44,769,114100,61774
125,103,22,772,95000,61775
572,526,46,679,178300,61776
327,270,57,698,100600,61777
275,224,51,434,79100,61778
11260,3843,7417,802,147900,61801
8384,4973,3411,810,118600,61802
128,99,29,630,95000,61810
195,156,39,767,85600,61811
175,147,28,558,94300,61812
762,583,179,732,89600,61813
427,360,67,743,99700,61814
108,82,26,863,109700,61815
193,177,16,740,86300,61816
1084,859,225,793,108700,61817
604,502,102,500,93700,61818
13998,3124,10874,848,145300,61820
13265,7615,5650,893,136500,61821
9848,7089,2759,1131,215800,61822
151,129,22,695,82100,61830
71,68,3,-,88900,61831
14408,8605,5803,676,62800,61832
963,734,229,675,65500,61833
2723,2376,347,652,118100,61834
287,210,77,652,83500,61839
336,291,45,983,253300,61840
520,469,51,575,109700,61841
1197,940,257,781,115700,61842
884,728,156,731,137300,61843
361,327,34,765,97800,61844
148,130,18,1063,152900,61845
2064,1584,480,681,73500,61846
466,424,42,700,145100,61847
88,58,30,606,57600,61848
737,615,122,792,119700,61849
189,176,13,613,86000,61850
144,116,28,619,94200,61851
79,73,6,-,62500,61852
5116,4111,1005,1032,203700,61853
511,423,88,828,120200,61854
43,43,0,-,169600,61855
3056,2471,585,975,167000,61856
110,92,18,579,56800,61857
1242,1005,237,678,89700,61858
466,428,38,925,137300,61859
187,155,32,650,166200,61862
304,284,20,925,121700,61863
613,520,93,875,158800,61864
542,421,121,668,92100,61865
5426,2912,2514,731,95600,61866
512,399,113,681,74900,61870
133,121,12,1275,144400,61871
355,271,84,678,109800,61872
2454,2116,338,736,170800,61873
3386,1639,1747,867,212800,61874
335,279,56,862,161300,61875
306,257,49,464,75400,61876
747,602,145,886,149300,61877
647,471,176,600,93900,61878
1329,1172,157,596,147900,61880
322,283,39,683,81200,61882
1694,1287,407,596,72100,61883
488,430,58,668,193800,61884
1478,1005,473,687,107100,61910
1596,1113,483,652,115800,61911
558,468,90,630,89300,61912
615,496,119,711,89000,61913
807,641,166,557,92200,61914
287,207,80,769,61800,61917
382,336,46,763,138200,61919
9398,5017,4381,650,103200,61920
1007,816,191,506,82300,61924
239,222,17,1097,97700,61925
354,285,69,629,65200,61928
290,216,74,500,82200,61929
249,185,64,675,66000,61930
468,348,120,684,96500,61931
196,151,45,600,66300,61932
457,343,114,508,66000,61933
100,100,0,-,53300,61936
839,636,203,567,84500,61937
9111,5967,3144,638,89000,61938
114,96,18,585,19600,61940
28,0,28,-,-,61941
526,383,143,622,68200,61942
684,532,152,616,86700,61943
5243,3805,1438,615,83600,61944
79,67,12,463,63800,61949
3265,2415,850,616,122800,61951
2523,1802,721,679,111100,61953
77,53,24,927,57700,61955
1088,848,240,675,99100,61956
802,626,176,712,77900,61957
643,526,117,532,184700,62001
13439,8699,4740,767,90600,62002
209,204,5,-,118800,62006
695,520,175,664,69000,62009
4529,3202,1327,738,145100,62010
76,64,12,500,155000,62011
2540,2215,325,679,156000,62012
212,163,49,625,120700,62013
1609,1268,341,718,115000,62014
208,190,18,-,114600,62015
1407,1043,364,663,95000,62016
440,352,88,709,79000,62017
1270,780,490,760,63900,62018
177,142,35,846,71700,62019
426,415,11,-,180800,62021
449,418,31,-,111400,62022
41,39,2,-,71300,62023
4315,2912,1403,821,103700,62024
12024,8855,3169,924,210800,62025
225,201,24,606,96300,62027
272,215,57,688,124700,62028
56,33,23,569,47900,62030
335,314,21,643,112500,62031
267,251,16,625,81100,62032
1958,1410,548,649,82800,62033
5476,4102,1374,951,202100,62034
6744,5534,1210,894,137900,62035
348,296,52,675,153900,62036
868,714,154,683,163300,62037
17916,12378,5538,736,85500,62040
821,659,162,488,104400,62044
127,123,4,233,128700,62045
278,210,68,872,180600,62046
620,473,147,465,106600,62047
684,510,174,755,72200,62048
2403,1878,525,661,83200,62049
169,118,51,618,33900,62050
356,307,49,720,84300,62051
5036,3796,1240,593,128600,62052
195,133,62,654,64500,62053
296,237,59,556,85900,62054
3971,2892,1079,606,89500,62056
364,256,108,638,78300,62058
275,106,169,342,32000,62059
1956,908,1048,697,45600,62060
757,572,185,762,167400,62061
3321,2631,690,1012,192400,62062
472,404,68,667,110600,62063
52,52,0,-,-,62065
1067,854,213,914,154700,62067
1303,1158,145,762,72800,62069
36,36,0,-,-,62070
474,425,49,698,139000,62074
1400,1123,277,640,75400,62075
54,43,11,-,77500,62076
123,108,15,700,49100,62077
32,28,4,-,45000,62078
89,89,0,-,-,62079
1000,886,114,566,79600,62080
143,127,16,650,101000,62081
1020,769,251,586,69200,62082
112,94,18,-,133500,62083
674,402,272,755,78300,62084
77,63,14,950,59300,62085
616,528,88,633,82100,62086
798,479,319,770,71900,62087
2942,2005,937,651,109800,62088
178,130,48,600,85000,62089
481,156,325,725,41400,62090
115,90,25,-,-,62091
1132,899,233,529,57200,62092
185,136,49,731,53100,62093
421,386,35,603,49400,62094
4469,2757,1712,761,85000,62095
1078,961,117,832,185800,62097
25,25,0,-,30800,62098
2618,728,1890,336,63600,62201
2742,1824,918,825,53800,62203
3385,1220,2165,443,51900,62204
3581,1886,1695,793,54300,62205
5564,2614,2950,799,48600,62206
3344,1385,1959,570,43800,62207
6995,5006,1989,998,122000,62208
525,458,67,588,136500,62214
610,458,152,727,163500,62215
1033,829,204,776,167200,62216
341,226,115,776,81300,62217
603,555,48,879,195800,62218
412,319,93,770,104300,62219
7747,4953,2794,831,106900,62220
11746,7759,3987,855,164800,62221
7038,5276,1762,809,109100,62223
1367,4,1363,1432,-,62225
12235,7911,4324,780,118500,62226
2607,2216,391,1106,157700,62230
2926,2406,520,771,131000,62231
2634,2108,526,855,94100,62232
2650,1934,716,576,94400,62233
13260,9109,4151,841,135700,62234
5159,4248,911,831,207200,62236
976,830,146,651,98500,62237
243,173,70,757,55500,62238
1995,1453,542,819,83600,62239
570,450,120,707,68300,62240
438,383,55,692,112500,62241
499,463,36,740,84100,62242
2311,2000,311,901,169800,62243
464,409,55,917,220900,62244
704,584,120,725,157000,62245
3224,2334,890,650,131500,62246
137,100,37,716,122700,62248
6125,4527,1598,720,167300,62249
197,172,25,669,93900,62250
266,205,61,583,88500,62253
2413,1672,741,805,146900,62254
405,342,63,731,141200,62255
1156,881,275,670,86600,62257
3299,2474,825,973,162400,62258
2781,2317,464,782,207200,62260
63,63,0,-,-,62261
696,634,62,618,76400,62262
2110,1582,528,630,113200,62263
1407,1087,320,765,137600,62264
1747,1432,315,1045,142900,62265
52,52,0,-,224000,62266
262,199,63,679,156300,62268
11703,8463,3240,965,189800,62269
867,696,171,707,115000,62271
641,522,119,637,103200,62272
137,97,40,880,103600,62273
2542,1903,639,475,81400,62274
1436,1228,208,781,143100,62275
567,480,87,613,86600,62277
2517,1984,533,703,158500,62278
6,6,0,-,-,62279
163,129,34,-,89300,62280
919,793,126,1090,198100,62281
178,157,21,825,119200,62282
248,213,35,913,127400,62284
1657,1456,201,761,170600,62285
2686,1935,751,635,95700,62286
1206,880,326,634,120200,62288
129,86,43,814,76000,62289
356,247,109,661,59200,62292
1732,1327,405,767,166200,62293
5183,3934,1249,782,184700,62294
545,456,89,850,162200,62295
139,118,21,-,184500,62297
6683,5420,1263,818,194000,62298
13905,8164,5741,604,96000,62301
7844,6572,1272,688,169000,62305
295,268,27,512,80900,62311
911,703,208,465,68200,62312
159,141,18,-,68600,62313
244,171,73,434,70300,62314
210,188,22,-,53400,62316
110,99,11,-,121600,62319
792,611,181,800,119800,62320
1690,1338,352,539,91800,62321
99,91,8,-,96500,62323
459,380,79,350,76700,62324
196,164,32,700,139500,62325
964,760,204,577,85600,62326
798,686,112,564,76000,62330
61,48,13,671,66400,62334
9,7,2,-,56300,62336
477,390,87,-,165400,62338
359,294,65,472,93500,62339
665,538,127,638,70900,62340
1443,1042,401,662,104300,62341
302,253,49,528,52000,62343
21,15,6,-,-,62344
178,154,24,490,86700,62345
81,76,5,-,77600,62346
777,682,95,717,142700,62347
69,69,0,-,88100,62348
233,198,35,525,114100,62349
719,592,127,718,115800,62351
102,83,19,665,63900,62352
1527,1166,361,566,87800,62353
642,487,155,910,103700,62354
366,333,33,369,63300,62355
175,122,53,425,63300,62356
133,63,70,508,74200,62357
297,285,12,-,111000,62358
87,87,0,-,87900,62359
662,500,162,721,92500,62360
163,122,41,589,83600,62361
156,132,24,325,52500,62362
2564,1883,681,578,91500,62363
240,211,29,575,88600,62365
649,526,123,494,62200,62366
379,289,90,544,53900,62367
163,150,13,-,80600,62370
105,99,6,-,89300,62373
159,146,13,575,74700,62374
113,107,6,-,153900,62375
467,316,151,644,99400,62376
410,339,71,651,86400,62378
742,598,144,548,77800,62379
105,91,14,267,26900,62380
7623,5545,2078,580,142100,62401
408,356,52,547,86100,62410
1655,1275,380,670,111500,62411
152,114,38,813,81100,62413
735,617,118,563,107500,62414
1294,937,357,548,71000,62417
714,603,111,597,74100,62418
133,130,3,-,41300,62419
2046,1502,544,671,77800,62420
202,167,35,808,78800,62421
444,351,93,648,82900,62422
244,209,35,-,151900,62423
847,767,80,887,133200,62424
228,213,15,-,72900,62425
334,295,39,663,60200,62426
680,512,168,540,111300,62427
1131,893,238,515,82900,62428
422,333,89,621,66000,62431
172,160,12,-,90800,62432
401,363,38,-,74600,62433
162,152,10,-,80400,62434
256,187,69,611,93800,62436
120,112,8,-,88200,62438
3339,2376,963,653,70200,62439
506,455,51,648,84600,62440
2880,2033,847,706,120000,62441
1216,933,283,620,81800,62442
613,539,74,814,140200,62443
129,111,18,-,150800,62444
432,339,93,569,89600,62445
160,148,12,-,87300,62446
1517,1276,241,546,91600,62447
2225,1708,517,579,100600,62448
1313,1050,263,581,77100,62449
5150,3433,1717,536,86700,62450
914,687,227,514,71700,62451
136,98,38,668,83300,62452
4235,3227,1008,614,88200,62454
790,614,176,561,78000,62458
125,112,13,-,70000,62459
498,425,73,547,76500,62460
304,270,34,525,163400,62461
343,291,52,520,110500,62462
500,422,78,474,86800,62463
370,348,22,556,97500,62465
1136,760,376,614,79200,62466
1397,1213,184,655,176300,62467
1077,773,304,643,106100,62468
209,185,24,-,163000,62469
3245,2464,781,640,89800,62471
568,521,47,669,80400,62473
395,352,43,692,80600,62474
175,175,0,-,63800,62475
710,635,75,384,70900,62476
364,302,62,621,62200,62477
143,143,0,-,78100,62478
299,241,58,598,157400,62479
207,168,39,537,55000,62480
177,174,3,-,-,62481
1141,1025,116,720,128300,62501
747,568,179,491,81400,62510
162,145,17,-,150900,62512
623,479,144,778,93500,62513
96,96,0,-,73300,62514
409,316,93,708,127300,62515
73,64,9,638,51700,62517
127,100,27,-,95900,62518
52,52,0,-,66700,62519
680,599,81,779,165600,62520
14808,10818,3990,707,101400,62521
6160,4085,2075,677,81200,62522
460,7,453,314,-,62523
14256,8919,5337,657,78800,62526
693,515,178,742,106900,62530
770,621,149,649,104400,62531
60,60,0,-,88500,62532
380,274,106,585,98500,62533
569,425,144,766,85700,62534
1259,1111,148,1550,206700,62535
349,285,64,-,220200,62536
31,31,0,-,77300,62537
144,113,31,618,58900,62538
539,483,56,613,94700,62539
666,504,162,576,80700,62540
23,23,0,-,64400,62541
219,131,88,708,103600,62543
647,560,87,594,97300,62544
483,442,41,694,126500,62545
584,498,86,631,86000,62546
329,293,36,717,86500,62547
1044,889,155,497,120100,62548
2412,1892,520,638,138700,62549
1070,890,180,656,100000,62550
253,211,42,506,84600,62551
194,171,23,644,85000,62553
574,465,109,725,137500,62554
183,168,15,600,86900,62555
127,121,6,680,69400,62556
3103,2365,738,578,80000,62557
1339,1044,295,873,138600,62558
543,432,111,756,79700,62560
2179,1635,544,775,131000,62561
2107,1856,251,831,187600,62563
3215,2462,753,480,88500,62565
453,356,97,794,92700,62567
6541,4607,1934,663,92200,62568
214,177,37,446,70200,62570
570,498,72,600,66300,62571
226,201,25,550,99200,62572
670,540,130,528,105000,62573
139,120,19,-,128800,62601
71,55,16,573,49300,62610
451,376,75,478,105100,62611
790,600,190,663,96000,62612
1561,1238,323,762,138800,62613
2071,1716,355,802,123200,62615
310,203,107,675,64800,62617
2952,2099,853,604,70800,62618
484,337,147,531,73300,62621
19,9,10,-,-,62622
217,208,9,-,75700,62624
332,302,30,-,174000,62625
2897,2145,752,649,114100,62626
424,357,67,520,76100,62627
340,267,73,716,91300,62628
5098,4048,1050,1045,188000,62629
143,132,11,-,82500,62630
108,88,20,750,87800,62631
289,251,38,738,82400,62633
302,235,67,500,98800,62634
298,241,57,742,110300,62635
539,437,102,737,99200,62638
150,137,13,-,89200,62639
1529,1229,300,744,115100,62640
633,489,144,688,94400,62642
238,158,80,727,91400,62643
2121,1583,538,604,78100,62644
157,122,35,622,103000,62649
10590,6861,3729,686,111200,62650
232,167,65,578,59600,62655
6951,4702,2249,690,99000,62656
604,464,140,695,116800,62661
119,102,17,525,67100,62663
1312,982,330,558,79000,62664
569,446,123,533,69400,62665
242,209,33,592,107100,62666
190,136,54,725,74800,62667
591,482,109,542,84500,62668
1195,961,234,667,151000,62670
229,155,74,571,79500,62671
105,95,10,825,68300,62672
195,170,25,738,85500,62673
602,465,137,618,108200,62674
2583,1889,694,661,155700,62675
977,817,160,747,145200,62677
2148,1637,511,609,83900,62681
404,345,59,636,69600,62682
1969,1658,311,869,208300,62684
887,759,128,709,119100,62685
260,192,68,756,84700,62688
223,179,44,721,72600,62689
1641,1240,401,592,95700,62690
871,642,229,575,78400,62691
852,764,88,688,86300,62692
578,516,62,775,159300,62693
1251,992,259,527,98800,62694
98,76,22,678,100000,62695
559,11,548,576,-,62701
15668,9636,6032,752,79600,62702
12246,7104,5142,770,84000,62703
18870,11320,7550,771,133900,62704
3200,2738,462,790,150200,62707
7138,6104,1034,924,237800,62711
4142,3255,887,777,216500,62712
8670,6085,2585,625,70300,62801
397,325,72,380,95100,62803
1471,1177,294,505,80600,62806
344,259,85,446,69800,62807
533,396,137,722,79500,62808
66,57,9,-,61700,62809
364,298,66,613,102200,62810
106,95,11,535,34300,62811
4618,3129,1489,656,74900,62812
761,674,87,733,76000,62814
143,131,12,417,59500,62815
542,403,139,616,69600,62816
230,149,81,617,81800,62817
108,104,4,-,71300,62818
178,147,31,681,49800,62819
57,49,8,-,42500,62820
3202,2439,763,574,77000,62821
1267,844,423,669,61600,62822
760,629,131,469,83800,62823
688,562,126,496,61700,62824
74,59,15,621,52500,62825
591,447,144,568,64900,62827
573,500,73,569,114700,62828
0,0,0,-,-,62829
554,392,162,454,109800,62830
206,183,23,470,102600,62831
3838,2764,1074,527,77400,62832
148,137,11,-,-,62833
374,297,77,440,46200,62835
253,219,34,693,94100,62836
4015,2826,1189,579,77100,62837
659,551,108,567,62400,62838
2677,1977,700,508,79600,62839
39,38,1,-,93900,62841
310,246,64,594,61400,62842
56,51,5,-,39200,62843
871,687,184,452,71600,62844
232,153,79,625,86300,62846
293,185,108,618,76800,62848
814,719,95,645,81300,62849
129,123,6,-,112200,62850
108,73,35,-,91000,62851
41,36,5,438,43300,62852
339,315,24,780,69800,62853
653,551,102,725,73900,62854
205,135,70,685,47500,62856
1193,963,230,581,86200,62858
2395,1838,557,576,89400,62859
217,188,29,538,83500,62860
60,45,15,-,18100,62861
149,123,26,910,54600,62862
4239,3115,1124,588,78500,62863
10401,7164,3237,627,89500,62864
809,786,23,-,102900,62865
238,193,45,478,65500,62867
597,536,61,673,75800,62868
1180,950,230,335,74000,62869
809,676,133,593,63900,62870
256,213,43,350,81000,62871
368,339,29,694,86000,62872
205,169,36,708,44400,62874
480,420,60,475,80900,62875
76,70,6,-,80000,62876
245,198,47,750,89400,62877
175,163,12,-,44700,62878
38,29,9,629,29500,62879
301,233,68,510,76600,62880
4608,3330,1278,608,78300,62881
958,740,218,583,60600,62882
300,259,41,382,119600,62883
1134,843,291,618,78900,62884
350,300,50,-,94500,62885
123,112,11,-,75000,62886
121,103,18,-,55600,62887
864,693,171,598,79100,62888
324,279,45,505,125200,62889
1047,869,178,679,82800,62890
259,237,22,661,56800,62891
152,130,22,-,118800,62892
433,372,61,594,82400,62893
408,339,69,579,143500,62894
821,684,137,680,90700,62895
5234,3495,1739,576,68100,62896
158,137,21,1300,85000,62897
840,761,79,665,111600,62898
781,644,137,538,71900,62899
10521,3587,6934,674,121600,62901
2065,1350,715,735,156700,62902
1095,551,544,672,161400,62903
253,229,24,-,105400,62905
2582,1992,590,475,92800,62906
869,744,125,627,113900,62907
196,172,24,559,67300,62908
1025,894,131,497,61200,62910
431,381,50,752,77200,62912
1103,658,445,308,31700,62914
139,103,36,865,70300,62915
351,302,49,493,108500,62916
1037,757,280,580,68400,62917
4076,2902,1174,795,142600,62918
331,300,31,458,65700,62919
1360,1127,233,466,124500,62920
163,144,19,669,44300,62921
1092,961,131,596,131800,62922
163,141,22,693,85600,62923
1190,777,413,767,81900,62924
897,720,177,611,89300,62926
148,102,46,723,42300,62927
77,44,33,408,73300,62928
2408,1736,672,652,60100,62930
615,490,125,360,71100,62931
654,506,148,646,74800,62932
562,295,267,694,125200,62933
417,348,69,372,61100,62934
663,482,181,445,78800,62935
1096,892,204,339,77100,62938
1320,1086,234,672,120900,62939
115,104,11,375,-,62940
329,272,57,1067,90800,62941
275,169,106,514,46400,62942
184,154,30,-,92000,62943
5314,3810,1504,549,79600,62946
181,166,15,-,88000,62947
5364,3863,1501,626,86000,62948
307,200,107,350,54400,62949
101,101,0,-,62600,62950
2013,1547,466,508,68400,62951
1219,974,245,567,102700,62952
102,65,37,600,45600,62953
144,95,49,-,110200,62954
304,258,46,525,53300,62956
362,258,104,771,58300,62957
887,611,276,663,131600,62958
11032,7651,3381,712,126800,62959
4721,3289,1432,728,86100,62960
13,13,0,-,-,62961
8,3,5,-,-,62962
232,115,117,505,33800,62963
594,437,157,401,55300,62964
32,22,10,500,46500,62965
6423,4417,2006,602,97100,62966
120,113,7,-,64200,62967
156,140,16,-,60500,62969
305,243,62,471,67000,62970
397,349,48,-,103300,62972
567,509,58,761,95700,62974
160,93,67,-,80500,62975
161,142,19,-,97100,62976
280,241,39,712,140100,62977
520,401,119,439,74500,62979
337,247,90,327,54300,62982
625,506,119,707,49900,62983
746,543,203,420,68900,62984
389,366,23,-,115300,62985
453,386,67,617,68800,62987
490,402,88,474,68200,62988
302,242,60,292,105600,62990
262,160,102,557,70700,62992
214,171,43,698,88800,62994
1638,1236,402,551,92400,62995
175,148,27,-,74300,62996
217,150,67,667,57600,62997
154,128,26,-,84500,62998
664,485,179,541,52400,62999
6337,5546,791,1068,544200,63005
13866,10667,3199,879,153300,63010
14029,11449,2580,1198,261600,63011
3854,3488,366,955,148800,63012
686,631,55,-,163500,63013
346,311,35,757,169000,63014
1011,847,164,688,120200,63015
2941,2617,324,881,144200,63016
16834,13046,3788,1137,352800,63017
1771,1080,691,837,123900,63019
7733,5775,1958,726,122300,63020
21673,17819,3854,1055,231200,63021
2189,1765,424,787,152900,63023
4822,4008,814,1021,262600,63025
16780,13858,2922,835,190700,63026
9900,7817,2083,777,152700,63028
82,65,17,-,157600,63030
18049,13295,4754,1022,99300,63031
17337,11146,6191,936,104700,63033
6662,6287,375,1462,164000,63034
397,292,105,543,130000,63036
1285,1007,278,768,131700,63037
2490,2313,177,1000,410000,63038
308,261,47,1092,141800,63039
3007,2621,386,1168,295000,63040
216,209,7,-,169000,63041
8584,4742,3842,851,99800,63042
9124,6151,2973,993,156100,63043
4087,2914,1173,864,159900,63044
0,0,0,-,-,63045
19,19,0,-,-,63047
1335,1133,202,954,152800,63048
6274,5424,850,808,153800,63049
6071,5189,882,828,170100,63050
5269,4165,1104,912,148800,63051
9496,7833,1663,881,170700,63052
22,11,11,735,-,63053
1060,781,279,798,242500,63055
816,726,90,576,182100,63056
0,0,0,-,-,63057
815,707,108,625,119600,63060
62,62,0,-,135200,63061
2049,1655,394,704,153000,63068
5808,4315,1493,734,189400,63069
3100,2074,1026,666,114900,63070
412,309,103,448,63000,63071
1087,880,207,885,181700,63072
309,295,14,-,659400,63073
6477,3321,3156,798,87100,63074
4376,2960,1416,730,129200,63077
21,21,0,-,-,63079
5405,3422,1983,729,122200,63080
7223,5236,1987,666,161100,63084
307,251,56,641,170400,63087
3891,2436,1455,969,176200,63088
2180,1905,275,1140,157400,63089
8662,6340,2322,719,189900,63090
494,424,70,539,156400,63091
2095,293,1802,1013,211100,63101
995,0,995,868,-,63102
4405,616,3789,876,169800,63103
9404,3482,5922,819,194900,63104
6566,3781,2785,1172,573500,63105
4603,615,3988,582,105600,63106
4091,1769,2322,719,49600,63107
10747,2997,7750,902,318200,63108
13669,7993,5676,785,165300,63109
8013,3267,4746,812,168400,63110
8514,3306,5208,736,81800,63111
8335,3155,5180,832,143800,63112
4415,1820,2595,732,65800,63113
14547,8723,5824,859,84500,63114
7512,3763,3749,761,55000,63115
19275,10738,8537,717,113400,63116
4336,2403,1933,940,234600,63117
11284,4057,7227,779,124100,63118
13854,10428,3426,1003,222300,63119
3241,1669,1572,793,49000,63120
10473,5846,4627,822,74800,63121
16095,12944,3151,1048,308000,63122
22513,16418,6095,801,144100,63123
4644,3366,1278,1025,771600,63124
13729,9490,4239,789,119400,63125
6370,5413,957,879,189800,63126
2026,1448,578,1829,398500,63127
12707,9970,2737,955,220200,63128
22007,17129,4878,788,204300,63129
12213,7115,5098,959,249600,63130
6331,5853,478,1746,552300,63131
5435,2953,2482,989,244600,63132
3063,1070,1993,805,54900,63133
5515,2826,2689,948,67700,63134
8130,4976,3154,940,78900,63135
17496,8371,9125,864,68400,63136
7198,3730,3468,997,64100,63137
7375,3739,3636,710,94300,63138
11036,6361,4675,759,141100,63139
121,23,98,714,-,63140
8482,6464,2018,1168,391500,63141
5046,2229,2817,710,151900,63143
4313,2885,1428,1200,215700,63144
13767,8060,5707,1053,204000,63146
3821,2202,1619,719,64900,63147
0,0,0,-,-,63155
19626,12977,6649,851,162800,63301
19490,14433,5057,1016,204000,63303
14924,13290,1634,1246,221900,63304
70,48,22,605,191700,63330
541,465,76,685,346100,63332
299,189,110,813,60700,63333
2648,1891,757,638,113400,63334
542,380,162,528,130600,63336
375,304,71,624,115500,63339
1284,1220,64,-,346000,63341
1574,1145,429,712,137000,63343
575,448,127,636,138000,63344
220,173,47,344,85000,63345
956,739,217,774,98900,63347
2262,2147,115,797,262200,63348
677,573,104,824,201700,63349
200,178,22,375,80000,63350
681,550,131,765,148100,63351
515,332,183,556,79000,63352
1967,1297,670,664,85300,63353
1860,1538,322,713,177300,63357
501,395,106,598,115100,63359
1837,1148,689,605,103900,63361
2404,1588,816,895,148500,63362
757,574,183,668,107800,63363
18187,14664,3523,938,186800,63366
8488,7007,1481,1081,247900,63367
15612,13042,2570,1242,231200,63368
720,562,158,748,139700,63369
3,3,0,-,-,63370
197,155,42,883,152000,63373
28249,23335,4914,993,172900,63376
905,754,151,839,143500,63377
8485,6590,1895,830,159800,63379
213,180,33,939,183000,63381
1407,921,486,572,70000,63382
5769,4577,1192,793,142300,63383
673,497,176,708,74600,63384
13923,11795,2128,960,218400,63385
189,150,39,917,83100,63386
31,27,4,-,-,63387
327,282,45,-,67600,63388
2310,1834,476,813,150200,63389
3949,3047,902,819,185200,63390
8738,5448,3290,661,109000,63401
232,196,36,573,76400,63430
131,115,16,-,108900,63431
217,188,29,-,66200,63432
25,25,0,-,-,63433
207,116,91,525,62000,63434
1532,1087,445,542,86900,63435
514,387,127,659,113100,63436
620,467,153,488,68500,63437
159,131,28,703,111000,63438
32,28,4,-,-,63439
443,322,121,551,80800,63440
470,372,98,603,126900,63441
172,141,31,313,77400,63443
1548,1099,449,603,86000,63445
250,203,47,583,72300,63446
447,269,178,368,73200,63447
583,444,139,595,93000,63448
34,34,0,-,-,63450
86,77,9,-,49300,63451
523,401,122,485,74000,63452
181,142,39,633,98000,63453
331,253,78,673,113300,63454
1819,1261,558,577,98100,63456
112,109,3,-,150500,63457
63,46,17,-,102100,63458
1494,1290,204,763,135900,63459
157,128,29,-,51000,63460
2228,1609,619,626,122500,63461
668,563,105,408,134500,63462
240,185,55,538,150500,63463
14,14,0,-,-,63464
169,145,24,682,140300,63465
8,8,0,-,-,63467
952,669,283,557,69000,63468
487,367,120,607,92100,63469
289,225,64,736,125400,63471
254,161,93,455,54500,63472
105,100,5,-,79600,63473
201,141,60,435,110200,63474
8132,4413,3719,610,124800,63501
381,314,67,545,73300,63530
145,121,24,363,70300,63531
552,464,88,542,63000,63532
288,242,46,533,86300,63533
294,239,55,443,59200,63534
35,35,0,-,114000,63535
366,282,84,320,96700,63536
747,585,162,501,73900,63537
103,94,9,-,178600,63538
73,64,9,-,80000,63539
43,42,1,-,23900,63540
114,84,30,525,140000,63541
104,88,16,-,58600,63543
270,237,33,683,78400,63544
372,270,102,518,73800,63545
589,503,86,368,108900,63546
183,144,39,538,71100,63547
509,346,163,608,69200,63548
925,692,233,490,107900,63549
113,96,17,713,23300,63551
3135,2076,1059,480,97100,63552
1280,896,384,468,81000,63555
1350,965,385,616,83900,63556
82,77,5,-,106900,63557
280,235,45,1048,85500,63558
593,485,108,575,75700,63559
67,55,12,475,59000,63560
454,329,125,639,64100,63561
247,140,107,424,141700,63563
1448,1019,429,552,87800,63565
45,45,0,-,43500,63566
98,60,38,506,-,63567
6218,4050,2168,588,83900,63601
536,383,153,511,77000,63620
459,284,175,363,110800,63621
412,400,12,-,84000,63622
303,270,33,675,82300,63623
1661,1305,356,650,89800,63624
149,138,11,-,116300,63625
501,442,59,-,98800,63626
1425,1058,367,491,166200,63627
5271,3689,1582,604,126300,63628
518,410,108,388,101200,63629
1279,1161,118,-,60500,63630
409,348,61,708,122300,63631
248,183,65,656,89600,63633
294,209,85,353,61900,63636
752,604,148,604,82300,63637
1106,800,306,579,105000,63638
10486,7261,3225,710,136100,63640
4515,3235,1280,548,102600,63645
474,420,54,729,87600,63648
1536,1108,428,594,85100,63650
507,302,205,728,52200,63653
238,208,30,-,101300,63654
649,496,153,675,81800,63655
159,132,27,505,108300,63656
1231,1093,138,530,71300,63660
571,549,22,-,100300,63662
259,120,139,618,79700,63663
3405,2441,964,480,97500,63664
87,78,9,-,92300,63665
59,59,0,-,-,63666
4409,3279,1130,683,149100,63670
728,640,88,761,122000,63673
39,39,0,-,-,63674
94,94,0,-,61800,63675
14397,8752,5645,732,156500,63701
3584,1521,2063,764,74600,63703
1216,981,235,565,93800,63730
333,287,46,643,97800,63732
283,193,90,535,50900,63735
1401,1136,265,588,88300,63736
40,19,21,-,-,63738
113,106,7,-,108300,63739
1800,1263,537,546,98200,63740
23,18,5,-,55000,63742
26,26,0,-,177300,63743
56,40,16,-,60000,63744
12,6,6,675,-,63745
38,20,18,-,-,63746
166,142,24,-,135000,63747
438,372,66,666,120300,63748
4,4,0,-,-,63750
542,474,68,730,125900,63751
9379,7241,2138,789,159900,63755
73,61,12,-,151800,63758
260,225,35,367,161300,63760
61,61,0,-,151300,63763
2189,1530,659,596,93500,63764
488,397,91,607,161200,63766
266,169,97,623,79800,63767
548,491,57,833,131900,63769
54,49,5,1292,84300,63770
1077,829,248,485,100700,63771
38,11,27,-,-,63774
6550,4912,1638,650,133400,63775
2476,1827,649,725,124500,63780
471,454,17,669,121000,63781
136,107,29,-,71800,63782
64,64,0,-,134400,63783
65,56,9,-,64600,63784
344,260,84,771,111900,63785
298,203,95,509,67300,63787
9422,6169,3253,634,104300,63801
72,57,15,-,40500,63820
371,266,105,546,49100,63821
1060,734,326,590,76500,63822
571,413,158,545,73700,63823
45,12,33,782,103600,63824
1661,1163,498,565,98200,63825
25,18,7,-,61700,63826
331,258,73,693,63500,63827
71,48,23,-,35800,63828
466,297,169,542,46100,63829
2933,1372,1561,545,80200,63830
64,41,23,-,-,63833
2238,1203,1035,667,74500,63834
603,379,224,419,33900,63837
158,54,104,582,50000,63839
5531,3625,1906,653,102600,63841
2222,1456,766,478,79100,63845
605,455,150,640,76500,63846
45,27,18,-,-,63847
546,361,185,688,54100,63848
48,22,26,-,68300,63849
1589,801,788,585,62000,63851
478,342,136,594,65300,63852
87,56,31,636,33300,63853
455,368,87,399,75700,63855
5336,3197,2139,523,94600,63857
82,74,8,-,-,63860
660,404,256,630,65900,63862
2501,1419,1082,614,65900,63863
136,75,61,778,37300,63866
433,343,90,467,77800,63867
314,164,150,577,59600,63868
1452,781,671,537,95800,63869
386,222,164,725,50000,63870
1920,1140,780,559,69200,63873
188,121,67,654,37500,63874
919,633,286,597,64800,63876
1308,760,548,559,86800,63877
40,33,7,-,34400,63878
268,182,86,519,48000,63879
43,34,9,-,45000,63880
185,122,63,590,36700,63882
13653,8253,5400,691,113400,63901
0,0,0,-,-,63902
505,385,120,381,47600,63932
1540,1114,426,470,61400,63933
29,29,0,-,-,63934
3866,2997,869,492,94000,63935
312,191,121,722,62800,63936
1069,759,310,561,86000,63937
542,370,172,536,-,63939
536,436,100,500,78200,63940
124,103,21,-,101800,63941
253,197,56,438,98100,63942
257,185,72,626,70800,63943
704,552,152,576,88400,63944
349,266,83,613,132900,63945
94,59,35,-,-,63951
174,157,17,511,136500,63952
711,539,172,534,68000,63953
344,238,106,469,42900,63954
67,59,8,-,71000,63955
539,457,82,415,75500,63956
2404,1747,657,570,72000,63957
1163,922,241,542,105500,63960
627,464,163,542,70800,63961
18,0,18,-,-,63962
314,234,80,569,55100,63964
1220,947,273,515,123100,63965
984,836,148,828,73100,63966
789,581,208,477,59100,63967
271,202,69,664,109100,64001
1355,1145,210,681,159200,64011
10099,6879,3220,1017,133700,64012
8939,6333,2606,963,146400,64014
11520,8521,2999,907,156800,64015
1760,1317,443,754,114400,64016
194,147,47,725,67100,64017
370,303,67,631,193100,64018
980,808,172,1004,134900,64019
1458,1072,386,585,121000,64020
242,217,25,722,67700,64021
80,72,8,-,100000,64022
6494,4551,1943,684,126300,64024
6340,4404,1936,970,173300,64029
9567,4863,4704,779,104000,64030
2991,2711,280,1283,172900,64034
401,308,93,681,87300,64035
120,89,31,736,45000,64036
2455,1574,881,683,108600,64037
2547,1989,558,623,128800,64040
1614,1480,134,859,182100,64048
9189,4443,4746,698,83400,64050
8822,5118,3704,792,83000,64052
2115,1019,1096,809,48400,64053
1663,910,753,711,76500,64054
14769,10259,4510,887,113600,64055
5830,3876,1954,834,103500,64056
5988,3651,2337,865,150500,64057
2423,1719,704,957,119800,64058
4937,3889,1048,1132,212800,64060
1296,1118,178,825,169100,64061
1993,1720,273,841,152400,64062
7786,5256,2530,945,150500,64063
6402,5426,976,1090,254200,64064
11,0,11,613,-,64065
11,6,5,-,-,64066
2343,1570,773,641,112800,64067
13835,10390,3445,898,170800,64068
1253,1092,161,1132,213500,64070
278,241,37,564,85400,64071
196,149,47,795,84700,64072
266,226,40,810,147500,64074
4459,3256,1203,874,153300,64075
3644,2807,837,648,146600,64076
628,510,118,728,118300,64077
3565,2995,570,790,170900,64078
4989,3371,1618,1021,215900,64079
4755,3605,1150,882,189700,64080
9451,7144,2307,1132,222100,64081
5287,4769,518,1332,255600,64082
8493,6977,1516,1080,188800,64083
643,584,59,764,164000,64084
3312,2200,1112,577,111800,64085
8399,6372,2027,952,180400,64086
535,471,64,936,153900,64088
4600,3770,830,840,194200,64089
44,36,8,-,45000,64090
0,0,0,-,-,64092
10345,5355,4990,719,152300,64093
435,273,162,594,91100,64096
568,418,150,613,121700,64097
1315,954,361,850,189300,64098
11,11,0,-,-,64101
0,0,0,-,-,64102
3028,300,2728,1042,180100,64105
3940,690,3250,786,178600,64106
3988,1394,2594,1002,188600,64108
4485,1812,2673,725,116400,64109
6720,3155,3565,843,138100,64110
9909,2440,7469,806,160800,64111
4787,2144,2643,1091,306000,64112
4913,4568,345,1605,347300,64113
12346,7555,4791,972,158900,64114
7448,3310,4138,812,145400,64116
5917,3123,2794,881,103300,64117
16898,9672,7226,870,137400,64118
10851,8338,2513,925,131200,64119
144,109,35,748,15800,64120
3346,2046,1300,745,60900,64123
4210,1959,2251,690,56600,64124
627,278,349,769,43700,64125
2382,893,1489,725,44200,64126
6299,2528,3771,709,41100,64127
4744,1966,2778,729,38900,64128
3911,1840,2071,784,70600,64129
8533,4413,4120,773,54500,64130
10118,5133,4985,823,143200,64131
5463,2400,3063,786,59000,64132
14343,9361,4982,888,101400,64133
8717,4298,4419,953,82300,64134
928,373,555,842,158300,64136
4417,2369,2048,894,110400,64137
10325,6198,4127,795,99800,64138
583,487,96,1110,283900,64139
2089,1732,357,1071,226800,64145
722,632,90,608,160600,64146
176,0,176,606,-,64147
142,142,0,-,326100,64149
1387,446,941,663,201200,64150
10793,6507,4286,957,192700,64151
10453,8308,2145,953,222900,64152
2392,1289,1103,1137,190100,64153
4425,2159,2266,1062,222200,64154
8324,6303,2021,956,169900,64155
2634,2020,614,1148,240200,64156
6151,5733,418,1435,233700,64157
1800,968,832,936,213300,64158
128,93,35,894,81000,64161
341,164,177,540,94200,64163
136,81,55,-,357500,64164
52,39,13,-,268500,64165
98,82,16,-,239300,64166
130,130,0,-,377600,64167
0,0,0,-,-,64192
599,529,70,736,157000,64401
1062,758,304,533,81300,64402
28,20,8,-,-,64420
309,259,50,912,102700,64421
165,98,67,-,118800,64422
328,293,35,489,80200,64423
1801,1222,579,535,81100,64424
181,138,43,484,78200,64426
296,214,82,411,112800,64427
322,254,68,492,67500,64428
3645,2216,1429,732,128700,64429
344,286,58,616,159300,64430
168,122,46,483,85000,64431
31,30,1,-,65000,64432
35,33,2,-,62500,64433
183,150,33,425,140600,64434
339,308,31,1050,156100,64436
286,230,56,638,86400,64437
91,80,11,-,-,64438
605,511,94,680,208100,64439
260,223,37,620,123400,64440
99,92,7,-,105600,64441
311,233,78,622,82700,64442
458,366,92,680,232400,64443
548,457,91,638,141200,64444
143,103,40,620,75000,64445
475,343,132,463,76900,64446
410,373,37,702,147000,64448
230,205,25,663,63400,64449
189,126,63,438,80000,64451
73,71,2,-,61300,64453
958,786,172,834,163800,64454
162,127,35,336,71900,64455
597,463,134,458,61600,64456
74,59,15,821,170800,64457
66,49,17,720,73200,64458
206,206,0,-,150800,64459
287,205,82,614,69700,64461
649,472,177,762,90700,64463
1804,1401,403,678,137500,64465
216,154,62,456,65300,64466
103,79,24,-,78500,64467
5742,2621,3121,633,138800,64468
989,702,287,507,102700,64469
778,512,266,419,128000,64470
156,130,26,440,63300,64471
632,481,151,591,87200,64473
370,265,105,561,90300,64474
138,92,46,581,67700,64475
125,92,33,788,82000,64476
1520,1172,348,808,117100,64477
390,324,66,614,115300,64479
118,88,30,706,-,64480
442,345,97,575,64200,64481
990,699,291,460,98100,64482
239,190,49,681,114200,64483
423,314,109,724,120700,64484
3082,2219,863,723,121200,64485
211,147,64,509,60400,64486
311,221,90,626,73200,64487
787,554,233,444,100300,64489
819,590,229,786,142900,64490
844,571,273,572,73900,64491
738,596,142,894,184100,64492
261,222,39,857,138200,64493
374,292,82,600,81400,64494
17,14,3,-,65000,64496
141,120,21,675,156300,64497
150,118,32,626,52900,64498
30,23,7,-,36300,64499
4464,1810,2654,655,79100,64501
4859,3354,1505,754,100800,64503
4145,2959,1186,783,82100,64504
5093,3460,1633,752,125400,64505
8920,5398,3522,766,164900,64506
5123,3360,1763,757,102300,64507
4544,2842,1702,626,111800,64601
206,181,25,686,84900,64620
152,130,22,520,70000,64622
182,154,28,463,74600,64623
639,473,166,669,78500,64624
210,158,52,435,75000,64625
2371,1651,720,550,83300,64628
225,202,23,511,60000,64630
343,286,57,340,60000,64631
199,152,47,393,61100,64632
1983,1377,606,554,88200,64633
243,196,47,779,75000,64635
118,93,25,713,44200,64636
233,200,33,423,91700,64637
244,209,35,814,100500,64638
105,77,28,-,65000,64639
1219,927,292,498,103900,64640
284,222,62,421,77500,64641
354,279,75,656,63700,64642
450,357,93,554,91200,64643
1207,875,332,633,104800,64644
63,51,12,317,134800,64645
87,69,18,425,56800,64646
143,105,38,581,82800,64647
689,550,139,475,113800,64648
311,282,29,-,122700,64649
274,187,87,671,102000,64650
272,191,81,752,86100,64651
178,153,25,475,63600,64652
289,230,59,562,72000,64653
18,18,0,-,-,64654
125,96,29,755,-,64655
123,98,25,285,84400,64656
119,88,31,341,65800,64657
1263,960,303,484,84100,64658
340,247,93,606,97500,64659
186,168,18,745,63200,64660
391,270,121,525,85800,64661
209,183,26,805,125900,64664
113,96,17,525,-,64667
706,531,175,541,86900,64668
415,318,97,474,100000,64670
848,604,244,673,128100,64671
81,75,6,-,67200,64672
902,722,180,529,80300,64673
211,178,33,413,95000,64674
81,76,5,-,50000,64676
245,206,39,464,57500,64679
70,57,13,-,71700,64681
131,116,15,-,77500,64682
3252,2070,1182,607,87800,64683
95,73,22,-,76500,64686
197,165,32,613,59200,64688
237,177,60,753,89400,64689
5737,3666,2071,822,155000,64701
1459,1075,384,679,122300,64720
188,165,23,-,99200,64722
298,256,42,900,111700,64723
789,550,239,464,84600,64724
968,779,189,810,148200,64725
157,130,27,1052,134600,64726
197,149,48,725,97000,64728
2748,1789,959,597,110600,64730
489,383,106,719,122600,64733
766,694,72,863,254500,64734
5721,4057,1664,674,102400,64735
421,345,76,446,77300,64738
316,262,54,817,142500,64739
826,679,147,597,72700,64740
110,93,17,600,-,64741
929,726,203,854,161100,64742
75,50,25,475,78900,64743
3368,2379,989,589,84900,64744
96,66,30,818,110200,64745
561,433,128,749,138400,64746
1503,1158,345,705,128800,64747
594,410,184,519,74700,64748
143,117,26,-,-,64750
289,232,57,675,86300,64752
1032,780,252,631,85900,64755
266,207,59,670,86300,64756
3340,2295,1045,532,104800,64759
528,424,104,738,108500,64761
618,415,203,527,71100,64762
698,535,163,706,71800,64763
16,15,1,-,-,64765
237,189,48,-,83600,64767
199,134,65,390,55000,64769
424,314,110,565,83100,64770
261,222,39,589,67000,64771
5538,3469,2069,642,107000,64772
1677,1184,493,465,98300,64776
207,161,46,638,126600,64778
1028,872,156,396,71800,64779
261,212,49,447,205900,64780
28,26,2,-,-,64781
337,281,56,534,68100,64783
479,411,68,661,63100,64784
667,478,189,795,87300,64788
315,233,82,553,83600,64790
15544,8646,6898,750,115600,64801
14452,9863,4589,718,133500,64804
275,183,92,575,64800,64830
2260,1745,515,656,109700,64831
314,268,46,970,121400,64832
32,24,8,-,105000,64833
3307,2579,728,854,137400,64834
666,514,152,646,71800,64835
8641,5796,2845,738,114600,64836
1227,1026,201,580,116000,64840
224,207,17,686,94400,64841
308,199,109,489,83400,64842
1040,816,224,637,66800,64843
1732,1331,401,673,89600,64844
210,65,145,545,36500,64847
288,240,48,541,118800,64848
55,47,8,833,88300,64849
8772,5876,2896,670,110100,64850
1372,719,653,520,81500,64854
883,747,136,1022,108300,64855
1530,1060,470,690,113400,64856
130,109,21,856,78800,64857
52,52,0,-,-,64858
542,427,115,752,109700,64859
545,474,71,608,115400,64861
1163,869,294,613,80500,64862
555,334,221,495,80000,64863
2235,1642,593,674,107500,64865
498,368,130,667,115000,64866
496,368,128,737,58900,64867
5783,3769,2014,726,111700,64870
420,369,51,476,85900,64873
311,178,133,540,86400,64874
130,120,10,-,96000,65001
2348,1685,663,722,194200,65010
742,620,122,-,145600,65011
1347,891,456,597,116000,65013
889,615,274,581,120800,65014
570,494,76,718,154100,65016
425,402,23,-,-,65017
2896,2212,684,571,118600,65018
5365,4039,1326,750,171700,65020
677,630,47,480,144500,65023
469,413,56,523,104700,65024
263,193,70,596,150500,65025
4547,3118,1429,661,119600,65026
685,623,62,-,123100,65032
284,229,55,-,176300,65034
663,577,86,420,154300,65035
2069,1682,387,808,159800,65037
1021,914,107,495,263100,65039
538,490,48,638,160400,65040
2411,1889,522,600,139600,65041
4249,3290,959,825,131500,65043
489,444,45,450,121100,65046
429,304,125,479,107900,65047
99,99,0,-,105100,65048
2584,2029,555,733,220600,65049
215,176,39,638,193800,65050
1834,1325,509,547,134000,65051
1279,1049,230,911,169800,65052
593,541,52,950,224600,65053
292,286,6,-,148600,65054
359,299,60,338,161500,65058
297,252,45,684,144600,65059
293,259,34,683,59400,65061
5,5,0,-,-,65062
1309,1013,296,831,167900,65063
188,166,22,492,161700,65064
2578,1820,758,647,227600,65065
2560,2000,560,650,117800,65066
118,118,0,-,-,65067
303,256,47,739,138900,65068
328,300,28,-,126900,65069
488,419,69,535,191200,65072
1055,809,246,606,143500,65074
324,277,47,388,149500,65075
267,237,30,-,159000,65076
194,157,37,-,114500,65077
1533,1231,302,571,87700,65078
1567,1410,157,644,214800,65079
443,423,20,-,171000,65080
1134,773,361,492,95600,65081
377,323,54,568,150900,65082
79,79,0,-,58900,65083
2448,1614,834,621,97400,65084
438,349,89,522,162200,65085
10742,7003,3739,641,154700,65101
16045,10478,5567,624,152300,65109
15903,4605,11298,830,175800,65201
19452,11250,8202,848,149200,65202
23851,14260,9591,820,223000,65203
0,0,0,-,-,65215
268,223,45,613,-,65230
1229,967,262,639,116700,65231
122,102,20,-,59100,65232
4220,2811,1409,669,135400,65233
598,421,177,392,82100,65236
324,248,76,800,90800,65237
431,366,65,806,89100,65239
3235,2476,759,596,121900,65240
708,635,73,736,154200,65243
135,132,3,-,115300,65244
31,21,10,-,-,65246
228,220,8,-,74700,65247
1482,1099,383,736,114100,65248
232,196,36,775,121200,65250
7105,4502,2603,632,124500,65251
756,648,108,507,108200,65254
1559,1154,405,768,159300,65255
581,558,23,730,166600,65256
632,551,81,610,63000,65257
171,142,29,450,119600,65258
1004,855,149,573,98400,65259
218,210,8,575,127300,65260
371,257,114,471,65500,65261
313,206,107,725,161400,65262
766,606,160,630,88900,65263
261,223,38,391,155300,65264
6121,3948,2173,647,101600,65265
5736,4026,1710,624,93900,65270
746,472,274,442,100000,65274
1140,865,275,480,93700,65275
574,434,140,616,116900,65276
66,51,15,613,59600,65278
724,627,97,742,228300,65279
119,99,20,575,-,65280
1076,795,281,567,82400,65281
68,68,0,-,76500,65282
206,174,32,371,134400,65283
994,818,176,839,156800,65284
225,184,41,-,150000,65285
48,45,3,-,56100,65286
165,155,10,-,145800,65287
13112,8490,4622,704,108400,65301
860,30,830,971,-,65305
30,27,3,-,112500,65320
215,147,68,642,105500,65321
224,187,37,661,88500,65322
371,299,72,396,86300,65323
642,545,97,439,149100,65324
1340,1154,186,629,112600,65325
948,836,112,442,127400,65326
113,89,24,725,94700,65327
159,134,25,-,122500,65329
174,147,27,488,68900,65330
496,427,69,700,118500,65332
266,226,40,606,108200,65333
361,299,62,550,119900,65334
96,83,13,-,-,65335
2304,1333,971,803,130300,65336
719,453,266,614,116100,65337
1157,899,258,604,93800,65338
245,197,48,597,80500,65339
5749,3810,1939,648,111600,65340
99,83,16,659,147900,65344
167,82,85,684,204300,65345
237,176,61,621,122700,65347
535,421,114,560,102300,65348
1067,740,327,569,61500,65349
662,544,118,649,116500,65350
980,701,279,613,83500,65351
322,249,73,536,-,65354
4543,3637,906,622,117700,65355
1757,1402,355,629,85600,65360
12275,6833,5442,704,138800,65401
23,23,0,-,140600,65436
1067,755,312,553,112600,65438
136,105,31,-,-,65439
127,122,5,-,121000,65440
2161,1590,571,662,117500,65441
10,10,0,-,-,65443
399,345,54,-,106800,65444
139,121,18,-,175700,65446
135,108,27,-,118800,65449
1001,776,225,738,119400,65452
3227,2161,1066,568,119500,65453
294,244,50,-,121400,65456
85,62,23,-,-,65457
2687,2006,681,696,119300,65459
42,26,16,-,-,65461
605,525,80,617,99900,65462
398,356,42,-,111200,65463
326,295,31,-,119000,65464
621,432,189,431,107100,65466
68,68,0,-,-,65468
392,346,46,441,89500,65470
2221,0,2221,1282,-,65473
119,64,55,-,-,65479
1759,1145,614,565,115000,65483
14,14,0,-,-,65484
1362,1127,235,609,120400,65486
63,63,0,-,68300,65501
53,43,10,-,-,65529
355,337,18,-,154800,65534
554,390,164,494,85100,65535
11519,7640,3879,630,113700,65536
71,71,0,-,-,65541
1980,1489,491,534,83700,65542
134,115,19,-,161900,65543
2217,1480,737,514,98000,65548
1389,1127,262,675,82800,65550
703,522,181,925,144700,65552
501,409,92,473,69900,65555
2255,1615,640,583,110500,65556
32,32,0,-,-,65557
3601,2515,1086,704,125100,65559
5661,3861,1800,507,105700,65560
48,48,0,-,65000,65564
1988,1544,444,593,108300,65565
344,287,57,615,74800,65566
535,457,78,657,96600,65567
228,215,13,910,54500,65570
966,670,296,619,111000,65571
366,290,76,652,138800,65580
819,657,162,599,120700,65582
4090,2246,1844,910,154100,65583
4238,1531,2707,995,155900,65584
35,35,0,-,-,65586
1080,759,321,494,73600,65588
96,96,0,-,-,65589
463,370,93,-,130400,65590
461,359,102,707,182000,65591
264,230,34,621,95000,65601
91,67,24,929,-,65603
1421,1019,402,647,150300,65604
4978,3587,1391,679,87800,65605
1390,1102,288,459,70500,65606
3638,2631,1007,570,91200,65608
328,261,67,580,82600,65609
1948,1555,393,607,155500,65610
869,597,272,858,206900,65611
561,430,131,741,150000,65612
6747,4003,2744,667,129600,65613
234,187,47,532,120700,65614
11114,5382,5732,804,153500,65616
474,347,127,732,96500,65617
127,64,63,-,80800,65618
2930,2475,455,738,138900,65619
83,83,0,-,-,65620
3349,2246,1103,624,107100,65622
10,8,2,-,45000,65623
667,567,100,828,121800,65624
2904,2110,794,730,107500,65625
646,495,151,610,76800,65626
273,255,18,-,120400,65627
258,228,30,-,110700,65629
116,114,2,-,380600,65630
1930,1515,415,896,124500,65631
1006,704,302,682,127600,65632
1561,1175,386,597,106200,65633
306,249,57,543,76500,65634
205,171,34,620,86300,65635
552,487,65,772,130900,65637
169,156,13,-,117600,65638
312,252,60,-,120800,65640
457,400,57,477,172200,65641
864,638,226,582,113300,65644
751,614,137,493,86400,65646
758,544,214,623,98300,65647
2264,1896,368,646,133500,65648
644,482,162,608,69700,65649
553,518,35,833,104600,65650
1322,1018,304,595,122000,65652
2490,1831,659,698,101200,65653
92,62,30,456,67000,65654
1397,1014,383,489,98200,65655
2054,1652,402,654,146100,65656
53,32,21,-,98600,65657
680,583,97,460,138500,65658
65,65,0,-,-,65660
1101,895,206,521,67200,65661
550,431,119,-,56800,65662
906,701,205,591,144600,65663
59,32,27,613,73300,65664
1252,931,321,600,127300,65667
769,603,166,392,91500,65668
812,666,146,634,154300,65669
3506,2066,1440,682,145400,65672
1048,746,302,609,78900,65674
184,121,63,645,115100,65676
939,626,313,612,121500,65679
549,500,49,577,85600,65680
747,656,91,604,166700,65681
865,621,244,637,82000,65682
266,215,51,367,83900,65685
1931,1574,357,735,166200,65686
1761,1197,564,508,119700,65689
85,74,11,-,98300,65690
538,451,87,485,129900,65692
126,108,18,-,66800,65702
1434,997,437,470,113500,65704
1490,984,506,738,89400,65705
5829,3924,1905,599,121900,65706
834,696,138,553,105600,65707
4457,3061,1396,634,109900,65708
450,349,101,477,150500,65710
4078,2677,1401,545,85100,65711
3430,2255,1175,546,120500,65712
873,717,156,545,83800,65713
12073,8683,3390,779,173600,65714
23,5,18,-,-,65715
985,707,278,539,89900,65717
282,262,20,-,85700,65720
11208,8049,3159,785,154400,65721
581,438,143,533,108100,65722
1282,959,323,615,102000,65723
699,595,104,730,84900,65724
1068,927,141,695,155000,65725
71,71,0,-,188400,65727
0,0,0,-,-,65728
135,101,34,-,182300,65729
24,24,0,-,-,65730
183,127,56,694,81200,65731
336,283,53,692,141300,65732
308,290,18,-,119700,65733
1138,913,225,582,99000,65734
31,23,8,-,-,65735
3506,2816,690,727,171100,65737
6828,4634,2194,783,130100,65738
461,423,38,941,153000,65739
1410,939,471,665,71300,65740
4665,3571,1094,705,172100,65742
42,40,2,-,86300,65744
1081,763,318,619,81900,65745
2514,2027,487,590,110200,65746
1634,1343,291,568,166700,65747
137,95,42,369,74400,65752
1940,1532,408,668,131200,65753
345,289,56,-,189100,65754
182,138,44,-,-,65755
217,201,16,755,152300,65756
2762,2201,561,780,151800,65757
541,434,107,700,89300,65759
265,262,3,-,46400,65760
543,473,70,504,131900,65761
121,105,16,-,83000,65762
529,489,40,-,73700,65764
47,42,5,-,56700,65766
783,587,196,498,89900,65767
152,106,46,498,146000,65768
990,722,268,807,99000,65769
1189,960,229,723,136100,65770
517,440,77,-,200800,65771
730,618,112,653,99300,65772
264,234,30,-,61500,65773
421,301,120,575,100400,65774
10215,6778,3437,636,107300,65775
133,103,30,-,72300,65777
205,156,49,595,140400,65778
805,633,172,610,91400,65779
3172,2528,644,768,144200,65781
22,22,0,-,-,65783
4,4,0,-,-,65784
2261,1557,704,766,107300,65785
800,644,156,570,117600,65786
665,508,157,687,193100,65787
148,122,26,-,78900,65788
673,539,134,565,113100,65789
366,347,19,-,144100,65790
1843,1336,507,442,85700,65791
2537,1964,573,455,92700,65793
18298,9776,8522,682,101600,65802
17182,9448,7734,684,102100,65803
18127,10525,7602,729,149000,65804
5644,765,4879,622,76900,65806
24698,11436,13262,773,121000,65807
4686,4096,590,852,263300,65809
9257,6683,2574,861,196900,65810
4588,3073,1515,634,91400,66002
2699,2108,591,888,199400,66006
2362,1898,464,1023,216200,66007
109,97,12,-,90400,66008
363,309,54,525,97700,66010
4292,3260,1032,797,190100,66012
778,712,66,950,307100,66013
116,48,68,-,-,66014
312,221,91,565,82100,66015
102,102,0,-,106300,66016
161,135,26,378,75400,66017
2272,1531,741,742,221000,66018
166,0,166,-,-,66019
451,369,82,741,181400,66020
968,848,120,1044,151100,66021
502,364,138,668,87900,66023
387,216,171,586,70300,66024
2647,1787,860,960,169600,66025
240,211,29,900,131600,66026
1460,9,1451,1655,-,66027
8092,5482,2610,1025,174500,66030
0,0,0,-,-,66031
2131,1453,678,715,88600,66032
251,188,63,540,89700,66033
325,217,108,548,77200,66035
219,201,18,825,95000,66039
1429,956,473,623,84700,66040
320,279,41,638,110600,66041
306,279,27,669,109900,66042
3107,2200,907,1042,174400,66043
10380,3930,6450,784,152000,66044
0,0,0,-,-,66045
7818,3628,4190,819,160900,66046
8425,3897,4528,902,224700,66047
13301,8435,4866,829,134100,66048
12218,7231,4987,979,223800,66049
830,733,97,847,180100,66050
1041,890,151,1273,180000,66052
2865,2228,637,944,201200,66053
1203,946,257,812,156700,66054
760,643,117,659,87000,66056
146,122,24,542,49100,66058
463,333,130,672,90800,66060
21271,15048,6223,850,212300,66061
27385,20431,6954,1033,219200,66062
2172,1516,656,647,99200,66064
1058,830,228,823,144700,66066
6139,4035,2104,751,116400,66067
1070,968,102,879,131100,66070
5117,3946,1171,707,176400,66071
491,489,2,-,130100,66072
1006,799,207,845,145200,66073
1105,779,326,674,85200,66075
822,680,142,759,138800,66076
485,409,76,656,148400,66078
298,259,39,856,140700,66079
357,288,69,778,83900,66080
3250,2737,513,798,209300,66083
2744,2576,168,1168,354200,66085
3561,2888,673,688,192300,66086
858,658,200,579,95000,66087
958,780,178,573,118100,66088
1027,759,268,771,119000,66090
130,99,31,-,-,66091
1351,1105,246,773,148200,66092
274,229,45,1289,103000,66093
173,110,63,542,66700,66094
373,288,85,721,87600,66095
565,401,164,488,110000,66097
4698,1817,2881,680,51400,66101
10487,4950,5537,755,66200,66102
5983,2094,3889,838,86200,66103
9240,5522,3718,893,73400,66104
781,476,305,717,42200,66105
8364,5524,2840,800,99100,66106
7995,6522,1473,1155,159300,66109
3544,2676,868,891,97800,66111
5404,2608,2796,866,108100,66112
0,0,0,-,-,66115
0,0,0,-,-,66118
8000,3691,4309,881,155800,66202
8311,5018,3293,844,157000,66203
8982,4280,4702,975,148100,66204
6023,4789,1234,1123,191100,66205
4046,3722,324,1720,384400,66206
5930,4548,1382,1306,259900,66207
9104,7506,1598,1307,246900,66208
8244,5883,2361,1156,371600,66209
8494,4636,3858,1093,230200,66210
2175,1386,789,1225,430300,66211
14473,8647,5826,955,170800,66212
11569,7428,4141,1114,310300,66213
5268,2596,2672,841,189900,66214
10781,6816,3965,999,200100,66215
8945,7387,1558,1047,211800,66216
2477,1343,1134,966,316400,66217
2649,2360,289,1434,265800,66218
4940,2232,2708,1102,240500,66219
2661,2510,151,1289,388100,66220
5688,4519,1169,1177,426000,66221
9537,5747,3790,1290,279900,66223
4491,4026,465,1130,452300,66224
4457,4018,439,1032,243300,66226
2135,1936,199,1620,256500,66227
724,614,110,732,120700,66401
1199,973,226,714,163600,66402
303,264,39,697,143800,66403
159,83,76,551,254900,66404
194,147,47,363,87700,66406
164,82,82,838,154500,66407
155,111,44,720,105700,66408
1220,1131,89,1143,223200,66409
467,371,96,548,83800,66411
75,70,5,-,112500,66412
721,559,162,644,90400,66413
1211,873,338,805,99300,66414
351,300,51,408,76100,66415
224,182,42,-,123500,66416
143,106,37,707,105000,66417
170,158,12,-,152500,66418
183,159,24,-,85000,66419
142,99,43,805,112500,66422
374,293,81,521,84500,66423
256,203,53,508,83800,66424
172,149,23,475,68500,66425
468,385,83,568,86300,66427
176,165,11,910,108000,66428
203,203,0,-,134700,66429
249,225,24,384,73900,66431
128,83,45,706,100800,66432
1930,1368,562,671,93900,66434
2421,1642,779,577,131900,66436
71,71,0,-,77300,66438
1169,741,428,530,77100,66439
689,592,97,735,154100,66440
10571,4709,5862,959,139600,66441
3810,28,3782,1220,-,66442
348,313,35,625,123000,66449
631,502,129,769,99700,66451
137,124,13,-,69300,66501
17683,7271,10412,861,176600,66502
6390,3827,2563,1039,242500,66503
21,0,21,-,-,66506
474,415,59,645,155500,66507
1961,1335,626,518,101200,66508
1032,746,286,759,135100,66509
313,232,81,624,98600,66510
1224,1056,168,729,134200,66512
393,309,84,637,192500,66514
184,175,9,656,80700,66515
157,140,17,508,81100,66516
778,254,524,915,96200,66517
53,51,2,-,109600,66518
230,198,32,920,125000,66520
727,557,170,576,97000,66521
16,10,6,-,47100,66522
1677,1082,595,509,108700,66523
944,760,184,901,148600,66524
269,231,38,632,111400,66526
88,57,31,582,87500,66527
381,286,95,811,127500,66528
603,485,118,825,147100,66531
225,191,34,957,87300,66532
566,418,148,850,129100,66533
1473,965,508,632,117000,66534
968,851,117,713,178000,66535
1103,892,211,782,149500,66536
447,405,42,717,102600,66537
1484,1213,271,485,125600,66538
1013,794,219,596,164500,66539
188,152,36,688,105800,66540
87,68,19,-,49200,66541
1162,1128,34,-,153600,66542
485,419,66,881,134100,66543
216,168,48,-,83600,66544
446,417,29,548,178400,66546
3435,2506,929,814,175500,66547
380,303,77,640,78000,66548
653,539,114,542,155300,66549
248,174,74,634,71300,66550
196,169,27,700,75000,66552
242,207,35,967,158100,66554
803,152,651,626,44500,66603
9799,5442,4357,748,97300,66604
6942,4599,2343,711,106100,66605
5285,2728,2557,807,80900,66606
3027,1515,1512,626,40300,66607
2179,1265,914,777,59000,66608
3230,2299,931,649,108300,66609
3572,3350,222,1580,235100,66610
4615,2412,2203,846,105400,66611
1263,214,1049,478,49400,66612
13862,8836,5026,797,144200,66614
1359,847,512,945,192800,66615
2397,1581,816,695,65000,66616
3359,2877,482,838,152700,66617
3624,3238,386,859,163300,66618
889,363,526,1017,78500,66619
7,7,0,-,-,66621
0,0,0,-,-,66622
4729,3242,1487,590,84200,66701
240,223,17,738,59600,66710
284,231,53,550,38800,66711
766,527,239,617,80600,66712
2095,1530,565,621,71000,66713
101,100,1,-,-,66714
158,116,42,700,44200,66716
253,236,17,475,49300,66717
4631,3110,1521,586,76700,66720
414,348,66,725,65200,66724
2251,1692,559,536,88500,66725
16,8,8,-,-,66728
117,106,11,-,-,66732
807,583,224,685,65700,66733
78,59,19,-,123600,66734
207,188,19,-,88800,66735
1659,1148,511,678,73900,66736
109,106,3,-,102900,66738
2024,1515,509,731,68800,66739
141,132,9,-,63100,66740
69,69,0,-,-,66741
1547,1074,473,817,93800,66743
98,93,5,-,51700,66746
1030,799,231,560,86100,66748
3258,2148,1110,578,82700,66749
319,280,39,675,53900,66751
414,310,104,464,62800,66753
136,101,35,-,-,66754
413,331,82,509,56500,66755
329,243,86,375,31700,66756
1446,984,462,556,65000,66757
96,79,17,550,32500,66758
0,0,0,-,-,66760
129,115,14,-,84600,66761
9601,4890,4711,705,89800,66762
1267,912,355,761,128200,66763
276,208,68,479,105900,66767
157,132,25,447,49200,66769
418,305,113,619,75200,66770
399,333,66,539,94300,66771
112,105,7,-,72100,66772
360,299,61,667,57700,66773
82,68,14,-,159700,66775
492,368,124,661,80900,66776
279,230,49,475,39600,66777
0,0,0,-,-,66778
251,189,62,448,81500,66779
233,210,23,-,73100,66780
441,366,75,642,82300,66781
74,53,21,-,32000,66782
1030,826,204,578,54800,66783
11395,6079,5316,641,99400,66801
81,73,8,-,-,66830
243,198,45,600,102800,66833
338,275,63,625,80800,66834
539,424,115,647,92600,66835
53,53,0,-,40800,66838
1643,1196,447,625,124800,66839
290,229,61,533,95800,66840
140,93,47,481,80500,66842
81,76,5,-,85600,66843
503,390,113,538,74000,66845
1386,1023,363,608,104700,66846
181,158,23,600,86700,66849
79,62,17,718,-,66850
271,173,98,517,29300,66851
271,211,60,675,80400,66852
190,168,22,500,-,66853
302,215,87,718,69300,66854
703,553,150,613,124800,66856
446,321,125,635,78300,66857
198,168,30,593,63000,66858
101,86,15,755,77100,66859
613,429,184,616,73000,66860
1273,1057,216,624,85400,66861
55,43,12,438,106300,66862
20,16,4,-,-,66863
174,157,17,575,72800,66864
521,412,109,698,116200,66865
646,450,196,510,69100,66866
306,255,51,588,126600,66868
310,232,78,579,99000,66869
46,46,0,-,32500,66870
518,438,80,575,85100,66871
406,300,106,738,96300,66872
114,106,8,513,-,66873
2558,1748,810,624,83800,66901
62,55,7,-,-,66930
60,52,8,-,83300,66932
160,146,14,613,69500,66933
1138,811,327,488,68700,66935
155,140,15,-,46300,66936
337,283,54,482,67400,66937
475,401,74,596,75700,66938
278,219,59,586,68900,66939
163,132,31,590,50500,66940
105,92,13,644,46700,66941
85,65,20,-,34400,66942
188,141,47,385,49000,66943
88,52,36,469,37500,66944
394,332,62,756,84100,66945
55,53,2,-,102200,66946
204,178,26,527,60700,66948
368,288,80,415,50400,66949
359,278,81,443,71300,66951
169,139,30,594,37500,66952
271,204,67,428,71800,66953
43,32,11,-,-,66955
518,401,117,490,59100,66956
102,82,20,-,17300,66958
121,100,21,-,28300,66959
79,55,24,528,13100,66960
169,147,22,473,113500,66962
65,51,14,-,31300,66963
91,73,18,425,35500,66964
349,280,69,450,63200,66966
890,665,225,473,67800,66967
695,546,149,424,78000,66968
38,38,0,-,83000,66970
421,385,36,775,183200,67001
5139,4108,1031,1222,178400,67002
1091,794,297,804,66800,67003
322,223,99,664,90400,67004
6355,3913,2442,668,78600,67005
259,186,73,730,78100,67008
367,246,121,559,61000,67009
5222,3490,1732,700,136300,67010
10,10,0,-,-,67012
1052,758,294,772,83700,67013
167,149,18,940,102800,67016
843,744,99,879,196000,67017
67,46,21,-,-,67018
496,421,75,689,86200,67019
605,442,163,616,94700,67020
16,11,5,-,84200,67021
664,512,152,526,58200,67022
113,101,12,725,77500,67023
334,236,98,531,46500,67024
1313,1094,219,738,143800,67025
1662,1437,225,816,158000,67026
143,95,48,817,107500,67028
440,353,87,550,73200,67029
851,760,91,929,178100,67030
922,748,174,697,109900,67031
402,307,95,550,86100,67035
25,17,8,-,98300,67036
10832,8016,2816,891,160100,67037
257,224,33,529,71800,67038
1246,965,281,680,122300,67039
106,96,10,-,92000,67041
6647,4425,2222,711,102700,67042
1464,997,467,524,58400,67045
290,241,49,678,50800,67047
40,40,0,-,156800,67049
603,539,64,700,157200,67050
176,150,26,579,64500,67051
2574,2131,443,1004,164500,67052
286,230,56,475,87400,67053
552,333,219,650,169800,67054
52,33,19,-,"10,000-",67055
1080,854,226,600,127300,67056
89,64,25,420,56700,67057
742,565,177,645,68700,67058
319,248,71,607,88100,67059
5326,4057,1269,887,107000,67060
70,53,17,943,-,67061
1738,1144,594,587,147000,67062
1319,1055,264,601,91300,67063
82,65,17,1104,66800,67065
169,151,18,740,85800,67066
698,649,49,950,161500,67067
1765,1297,468,669,88700,67068
426,327,99,527,81500,67070
79,70,9,-,"10,000-",67071
81,54,27,856,34300,67072
136,114,22,488,81700,67073
658,513,145,676,95200,67074
1636,1081,555,749,162100,67101
75,69,6,-,120200,67103
1046,676,370,569,79400,67104
67,53,14,575,47500,67105
106,80,26,-,115600,67106
1217,951,266,478,147800,67107
591,464,127,720,118700,67108
167,117,50,564,84500,67109
3265,2711,554,768,126500,67110
104,88,16,725,110300,67111
98,86,12,300,58600,67112
8571,6100,2471,728,107000,67114
706,431,275,593,152900,67117
273,227,46,742,84500,67118
554,415,139,463,90100,67119
547,509,38,-,158300,67120
53,53,0,-,-,67122
300,205,95,696,83800,67123
3131,2117,1014,704,87800,67124
237,207,30,392,65000,67127
130,91,39,386,-,67131
181,167,14,-,91000,67132
2282,1904,378,823,149900,67133
139,117,22,825,66400,67134
1105,854,251,879,154700,67135
228,210,18,475,52100,67137
136,121,15,590,71300,67138
333,273,60,700,76900,67140
200,173,27,1016,86000,67142
9,7,2,-,-,67143
966,771,195,775,122400,67144
747,592,155,703,92100,67146
3706,3220,486,895,163700,67147
348,342,6,-,220200,67149
24,14,10,-,18300,67150
198,163,35,806,83500,67151
3609,2431,1178,685,79800,67152
453,347,106,807,145800,67154
71,55,16,-,164100,67155
5317,3488,1829,697,97200,67156
60,48,12,-,55000,67159
998,105,893,837,-,67202
12525,6348,6177,697,93900,67203
7818,5907,1911,694,102400,67204
6050,5318,732,982,219400,67205
7236,4637,2599,877,235400,67206
11221,5646,5575,797,135900,67207
7311,4130,3181,795,114300,67208
5157,3709,1448,855,144400,67209
3172,1263,1909,656,131200,67210
8105,3581,4524,678,70900,67211
18415,12116,6299,836,137200,67212
8742,3942,4800,736,66700,67213
6047,2138,3909,642,50000,67214
2023,1857,166,1208,145200,67215
8932,5316,3616,736,68600,67216
11584,7819,3765,789,81500,67217
9561,4510,5051,722,84700,67218
4432,3060,1372,905,96900,67219
5543,3259,2284,763,143700,67220
214,207,7,-,285700,67223
7814,4721,3093,936,196200,67226
102,102,0,-,270000,67227
739,733,6,-,307900,67228
3713,3497,216,1684,291000,67230
179,179,0,-,285000,67232
4069,3939,130,1648,215900,67235
0,0,0,-,-,67260
5246,3577,1669,667,86700,67301
562,415,147,601,90100,67330
60,50,10,408,66200,67332
1180,894,286,594,73000,67333
23,23,0,-,24600,67334
1371,1081,290,651,71500,67335
687,438,249,670,54800,67336
5089,3379,1710,590,68200,67337
150,113,37,775,43300,67340
119,119,0,-,101100,67341
367,298,69,588,82600,67342
323,291,32,661,67400,67344
63,48,15,-,-,67345
161,146,15,485,62700,67346
192,175,17,-,257700,67347
472,360,112,425,49000,67349
184,171,13,-,56600,67351
217,173,44,575,44300,67352
244,198,46,706,53600,67353
317,241,76,531,83700,67354
65,60,5,738,85000,67355
1034,796,238,559,60000,67356
4926,3328,1598,631,75300,67357
162,127,35,-,-,67360
757,595,162,617,64800,67361
42,42,0,-,62000,67363
101,88,13,705,65500,67364
20817,13585,7232,738,124200,67401
4115,2989,1126,650,125000,67410
390,335,55,733,163700,67416
103,84,19,-,66300,67417
61,58,3,-,-,67418
1963,1311,652,587,94500,67420
556,470,86,753,133800,67422
126,92,34,620,69100,67423
272,215,57,533,163600,67425
173,151,22,565,56100,67427
589,517,72,775,121400,67428
334,274,60,535,56700,67430
934,659,275,745,143100,67431
2352,1882,470,580,93100,67432
299,260,39,720,77100,67436
490,338,152,452,77500,67437
104,93,11,650,72300,67438
1280,976,304,617,113900,67439
418,328,90,919,74900,67441
79,73,6,-,186300,67442
719,590,129,740,151800,67443
239,205,34,436,61300,67444
273,228,45,572,55900,67445
254,220,34,403,75000,67446
110,90,20,738,74300,67447
533,418,115,817,150000,67448
1309,921,388,608,68200,67449
259,207,52,658,66500,67450
381,265,116,840,76600,67451
74,68,6,-,52900,67452
263,208,55,733,81700,67454
825,665,160,442,73400,67455
1773,1190,583,676,167200,67456
344,219,125,640,77900,67457
82,58,24,665,69300,67458
116,96,20,646,55600,67459
6449,4460,1989,746,138700,67460
516,417,99,619,88300,67464
426,341,85,544,56500,67466
1068,846,222,585,88800,67467
105,90,15,825,67100,67468
150,113,37,1085,93000,67470
828,576,252,537,71700,67473
94,70,24,-,37500,67474
86,71,15,-,63800,67475
28,27,1,-,-,67478
661,579,82,605,117200,67480
221,180,41,571,61800,67481
36,36,0,-,73600,67482
155,122,33,525,60700,67483
349,308,41,492,81800,67484
170,137,33,425,90700,67485
579,437,142,900,141800,67487
403,307,96,625,73800,67490
157,129,28,658,140600,67491
97,72,25,777,72900,67492
9715,5661,4054,645,65700,67501
10087,7555,2532,795,129700,67502
1045,620,425,497,100600,67505
127,122,5,-,76900,67510
152,142,10,-,72700,67511
82,60,22,-,50000,67512
22,22,0,-,33300,67513
370,260,110,625,56200,67514
15,12,3,-,-,67515
174,153,21,425,65000,67516
31,24,7,-,115000,67518
108,65,43,443,-,67519
143,122,21,-,93300,67520
72,48,24,-,32500,67521
791,598,193,634,128600,67522
183,132,51,659,51100,67523
256,199,57,520,28100,67524
427,331,96,540,77300,67525
1204,977,227,709,80200,67526
166,123,43,700,55600,67529
8066,5304,2762,621,91500,67530
807,619,188,729,96300,67543
1165,780,385,663,84700,67544
93,81,12,-,56800,67545
1031,766,265,745,150000,67546
769,614,155,521,59900,67547
636,453,183,559,82700,67548
2096,1456,640,552,78400,67550
261,211,50,500,62300,67552
75,67,8,-,34200,67553
1663,1203,460,539,76400,67554
151,126,25,-,60000,67556
219,196,23,630,47000,67557
14,11,3,-,-,67559
742,596,146,618,79200,67560
511,388,123,626,67500,67561
138,123,15,481,87500,67563
100,84,16,546,60000,67564
220,196,24,611,65500,67565
200,178,22,780,73300,67566
271,207,64,415,48800,67567
118,108,10,625,92500,67568
524,441,83,745,89700,67570
218,191,27,531,63600,67572
89,61,28,-,91700,67573
115,87,28,450,53900,67574
203,161,42,633,49200,67575
867,732,135,677,82000,67576
563,441,122,629,51900,67578
1207,887,320,514,92300,67579
122,105,17,382,41500,67581
351,279,72,497,45600,67583
144,109,35,531,49600,67584
9705,5667,4038,680,166500,67601
164,128,36,383,55300,67621
305,213,92,496,80300,67622
101,84,17,516,-,67623
172,137,35,400,55000,67625
69,63,6,-,81700,67626
30,24,6,-,-,67628
84,58,26,-,-,67629
75,68,7,-,85000,67631
88,62,26,388,82000,67632
120,81,39,463,49400,67634
59,48,11,-,29400,67635
1134,924,210,663,109500,67637
133,111,22,300,62500,67638
73,67,6,-,89400,67639
246,202,44,630,110400,67640
846,676,170,463,77800,67642
123,80,43,634,52200,67643
119,95,24,756,38400,67644
285,260,25,600,72900,67645
341,285,56,525,70800,67646
129,91,38,434,53900,67647
274,186,88,521,61300,67648
108,93,15,425,54200,67649
109,96,13,363,60000,67650
221,179,42,456,46100,67651
145,112,33,516,41400,67653
1274,959,315,879,72400,67654
25,15,10,-,-,67656
161,112,49,507,69000,67657
70,51,19,-,151100,67658
54,50,4,-,66300,67659
17,15,2,-,88800,67660
1354,1031,323,562,86400,67661
1070,849,221,624,87300,67663
131,112,19,-,63300,67664
2268,1733,535,584,95500,67665
67,62,5,-,102400,67667
770,618,152,493,60300,67669
697,535,162,641,144200,67671
1192,944,248,598,83700,67672
39,34,5,-,62200,67673
27,27,0,-,-,67674
68,65,3,-,41000,67675
2679,1969,710,491,118900,67701
767,549,218,627,92700,67730
317,222,95,508,74100,67731
225,167,58,568,96500,67732
110,101,9,-,89000,67733
137,81,56,574,46300,67734
2455,1586,869,708,85300,67735
105,76,29,717,85000,67736
203,173,30,536,79000,67737
261,213,48,591,79400,67738
73,68,5,-,39200,67739
798,606,192,531,107500,67740
139,83,56,597,69400,67741
58,49,9,-,-,67743
93,76,17,-,93800,67744
143,130,13,-,62900,67745
95,90,5,-,71700,67747
979,747,232,787,96400,67748
1103,779,324,591,68100,67749
121,100,21,-,-,67751
548,391,157,602,80700,67752
185,140,45,619,93000,67753
925,769,156,606,88700,67756
230,190,40,533,91300,67757
423,328,95,506,87600,67758
94,74,20,-,93300,67761
88,68,20,438,88300,67762
182,131,51,431,60500,67764
9931,6147,3784,719,108300,67801
428,301,127,547,57000,67831
392,276,116,653,82100,67834
999,664,335,677,133600,67835
44,23,21,-,48800,67836
338,225,113,533,94500,67837
346,303,43,625,64100,67838
638,538,100,512,80000,67839
39,30,9,-,22100,67840
123,114,9,-,70900,67841
189,130,59,573,64400,67842
122,0,122,-,-,67843
381,253,128,614,91200,67844
11584,7008,4576,737,124400,67846
163,116,47,461,49400,67849
200,121,79,581,55000,67850
827,701,126,490,144800,67851
301,225,76,663,99000,67853
569,404,165,670,88300,67854
657,508,149,506,76800,67855
48,28,20,-,175000,67857
257,196,61,743,76100,67859
842,620,222,666,112800,67860
768,555,213,704,83200,67861
149,120,29,740,-,67862
129,79,50,390,78100,67863
779,594,185,600,85300,67864
459,308,151,771,108900,67865
652,521,131,629,122500,67867
144,119,25,-,77000,67868
534,372,162,754,97800,67869
430,318,112,746,84400,67870
2118,1581,537,830,136600,67871
473,415,58,693,147000,67876
816,665,151,676,114900,67877
786,556,230,625,86700,67878
494,320,174,692,86100,67879
2663,2094,569,634,101900,67880
157,77,80,708,157100,67882
7252,4733,2519,721,100300,67901
816,564,252,583,97900,67950
1749,1256,493,640,106000,67951
196,158,38,575,105400,67952
73,43,30,-,113400,67953
255,174,81,681,86200,67954
41,36,5,-,82500,68001
932,766,166,643,168900,68002
1809,1349,460,761,192200,68003
385,276,109,543,92900,68004
9371,5226,4145,795,133600,68005
3287,2871,416,1041,220400,68007
4995,3662,1333,698,168600,68008
10,0,10,-,-,68010
144,138,6,-,113100,68014
467,392,75,872,145200,68015
201,182,19,1143,226600,68016
688,582,106,731,151900,68017
226,210,16,-,153900,68018
205,170,35,732,79500,68019
290,236,54,550,75000,68020
7903,6087,1816,1059,298800,68022
1044,849,195,950,280200,68023
12213,7491,4722,727,128500,68025
4168,3509,659,908,237600,68028
366,230,136,585,121600,68029
359,275,84,854,113200,68030
788,601,187,629,127600,68031
147,128,19,825,166300,68033
272,226,46,1313,148300,68034
94,72,22,628,52200,68036
806,663,143,837,174500,68037
623,469,154,526,90100,68038
319,84,235,529,49200,68039
153,128,25,-,128800,68040
418,320,98,725,139500,68041
37,32,5,825,76700,68042
211,188,23,767,100000,68044
713,539,174,765,86700,68045
9815,7338,2477,866,198500,68046
715,579,136,666,112200,68047
4920,3855,1065,791,165800,68048
286,237,49,713,93700,68050
114,86,28,715,53300,68055
707,526,181,548,86600,68057
117,104,13,475,145000,68058
1187,1064,123,894,193500,68059
982,719,263,584,100400,68061
116,87,29,617,136000,68062
107,87,20,480,86100,68063
1548,1005,543,804,189100,68064
631,510,121,778,176800,68065
2150,1520,630,634,156700,68066
314,200,114,555,31600,68067
24,23,1,-,117500,68068
1166,914,252,1125,221300,68069
235,195,40,633,135800,68070
543,222,321,563,80000,68071
28,17,11,763,71000,68072
702,626,76,857,168500,68073
3447,472,2975,931,281600,68102
14016,7783,6233,828,100000,68104
9492,4067,5425,722,117700,68105
9560,5872,3688,841,131100,68106
9382,5560,3822,770,91500,68107
5170,2444,2726,819,87600,68108
3111,1397,1714,743,65800,68110
8001,3133,4868,860,62800,68111
4336,2953,1383,887,94800,68112
196,0,196,1143,-,68113
8075,3925,4150,948,167900,68114
10816,8449,2367,1082,217300,68116
3157,2266,891,959,109400,68117
3515,3037,478,1140,258700,68118
4022,3324,698,1064,143300,68122
11520,6523,4997,1074,177000,68123
6583,4356,2227,1020,178300,68124
10233,4602,5631,782,148500,68127
7654,4501,3153,940,152500,68128
7719,5959,1760,1223,257700,68130
5495,1512,3983,752,109900,68131
5991,3037,2954,683,240700,68132
3526,3236,290,1475,240000,68133
12405,6397,6008,794,132600,68134
9448,8489,959,1363,219500,68135
5756,4976,780,1194,219400,68136
10293,7080,3213,1015,146900,68137
4641,3551,1090,816,142900,68138
1403,1259,144,1155,210800,68142
10144,7059,3085,857,159600,68144
3712,2778,934,934,126500,68147
2460,1995,465,769,183800,68152
10075,6102,3973,879,201400,68154
2349,1785,564,940,143200,68157
11869,7589,4280,955,152500,68164
0,0,0,-,-,68178
562,469,93,873,215200,68301
128,120,8,-,50800,68303
157,141,16,1050,240200,68304
1697,1116,581,635,126200,68305
162,118,44,492,105600,68307
53,37,16,600,48500,68309
6126,3758,2368,644,105400,68310
270,249,21,828,119600,68313
228,166,62,1032,104200,68314
36,35,1,-,78600,68315
210,165,45,597,119800,68316
657,611,46,967,172600,68317
201,161,40,853,66800,68318
226,180,46,675,92500,68319
161,124,37,-,118800,68320
157,153,4,-,109000,68321
215,178,37,415,66200,68322
147,127,20,-,115800,68323
71,30,41,624,-,68324
105,98,7,-,51300,68325
100,76,24,622,64700,68326
122,114,8,442,47000,68327
211,166,45,688,140900,68328
226,170,56,568,71100,68329
335,288,47,684,165300,68331
55,52,3,-,-,68332
2935,1856,1079,743,107100,68333
198,163,35,438,55700,68335
203,182,21,-,158300,68336
149,129,20,533,71300,68337
129,118,11,425,77500,68338
481,422,59,-,263300,68339
387,278,109,629,65500,68340
409,325,84,744,114000,68341
202,170,32,490,97100,68342
410,322,88,761,107100,68343
179,164,15,718,156300,68344
126,121,5,-,61100,68345
202,148,54,539,168800,68346
946,920,26,863,211400,68347
137,96,41,450,211100,68348
420,370,50,753,145700,68349
103,90,13,-,53900,68350
360,268,92,645,80900,68351
2268,1538,730,571,68100,68352
386,291,95,541,72800,68354
2316,1784,532,500,77800,68355
165,148,17,850,118500,68357
609,570,39,541,256900,68358
572,480,92,708,130400,68359
207,168,39,1341,142900,68360
984,716,268,566,77900,68361
37,37,0,-,-,68362
41,32,9,570,109100,68364
115,97,18,579,150500,68365
378,317,61,1066,156000,68366
123,98,25,513,65000,68367
189,173,16,840,234200,68368
1010,714,296,556,87600,68370
663,530,133,682,118200,68371
1069,902,167,898,186500,68372
39,34,5,375,-,68375
670,453,217,439,60800,68376
186,164,22,-,93100,68377
307,279,28,625,111300,68378
27,25,2,-,70500,68379
41,34,7,-,34000,68380
72,58,14,-,-,68381
8,7,1,-,65000,68382
285,231,54,735,150400,68401
503,413,90,940,225000,68402
56,45,11,700,115600,68403
354,330,24,-,283900,68404
1272,796,476,673,165800,68405
224,160,64,663,62100,68406
300,232,68,740,168300,68407
311,249,62,800,134400,68409
3625,2464,1161,647,119000,68410
242,212,30,719,118600,68413
136,93,43,575,152800,68414
304,277,27,600,88400,68415
106,79,27,483,37900,68416
122,103,19,832,-,68417
463,389,74,829,165200,68418
102,76,26,740,132500,68419
623,450,173,512,73300,68420
334,238,96,509,81100,68421
192,163,29,765,145300,68422
407,368,39,643,221600,68423
355,287,68,542,105100,68424
456,433,23,575,312500,68428
552,492,60,1318,247600,68430
214,190,24,-,59500,68431
95,66,29,520,32700,68433
3233,2219,1014,676,159800,68434
241,189,52,642,78200,68436
118,103,15,572,61500,68437
50,43,7,-,114600,68438
206,142,64,665,111200,68439
46,44,2,-,55000,68440
78,77,1,-,123200,68441
143,131,12,675,61500,68442
477,407,70,629,90900,68443
27,25,2,-,55000,68444
39,35,4,600,52500,68445
1140,834,306,666,133200,68446
228,190,38,530,50000,68447
153,118,35,708,80000,68448
949,632,317,641,82500,68450
37,31,6,-,27800,68452
144,106,38,810,48800,68453
229,173,56,642,152100,68454
241,219,22,-,233600,68455
461,334,127,840,134200,68456
112,101,11,461,42700,68457
67,59,8,683,98300,68458
328,235,93,675,124100,68460
242,193,49,-,379800,68461
1456,1186,270,661,164700,68462
616,480,136,642,135600,68463
234,210,24,607,53100,68464
859,620,239,641,107700,68465
779,580,199,614,57900,68466
3824,2562,1262,639,136800,68467
11529,5993,5536,625,140600,68502
6120,1884,4236,697,96300,68503
7734,2752,4982,809,113900,68504
7109,4419,2690,843,139900,68505
12960,7919,5041,893,162800,68506
6060,4166,1894,751,133700,68507
4812,457,4355,561,108200,68508
9193,5330,3863,663,142200,68510
5240,3503,1737,947,204400,68512
75,21,54,-,-,68514
16687,12307,4380,909,219200,68516
133,133,0,-,303600,68517
618,592,26,1345,329900,68520
13169,7882,5287,845,150600,68521
4322,3215,1107,841,145600,68522
505,458,47,-,302600,68523
2021,1221,800,796,126300,68524
2262,1910,352,1166,291900,68526
299,299,0,-,367200,68527
2545,1526,1019,916,139700,68528
36,36,0,-,454500,68531
236,236,0,-,326700,68532
11192,7817,3375,680,138600,68601
1128,847,281,581,123900,68620
262,244,18,-,136100,68621
164,119,45,396,116400,68622
109,104,5,-,29700,68623
373,352,21,685,146600,68624
291,243,48,713,112500,68626
306,274,32,722,70000,68627
325,257,68,661,73200,68628
585,473,112,471,91600,68629
171,146,25,475,111100,68631
1626,1125,501,676,101600,68632
502,399,103,558,85800,68633
189,161,28,1000,89700,68634
197,177,20,-,155500,68635
588,482,106,591,84600,68636
150,99,51,581,72100,68637
794,606,188,495,80500,68638
621,463,158,532,85500,68640
460,354,106,524,103400,68641
718,554,164,769,160500,68642
469,358,111,528,120600,68643
268,233,35,579,152800,68644
270,230,40,581,92900,68647
155,142,13,713,144100,68648
803,611,192,688,124800,68649
555,462,93,568,99200,68651
276,231,45,605,67000,68652
267,219,48,963,89500,68653
213,158,55,782,64700,68654
69,60,9,788,-,68655
319,290,29,840,112800,68658
64,51,13,528,78500,68659
515,373,142,613,87400,68660
2282,1425,857,629,98600,68661
515,407,108,639,110400,68662
318,257,61,711,70700,68663
165,111,54,782,65900,68664
378,320,58,636,78000,68665
587,462,125,571,100400,68666
60,55,5,-,-,68667
173,148,25,510,88200,68669
12537,8135,4402,647,129100,68701
311,262,49,771,113400,68710
126,116,10,-,72500,68711
963,721,242,597,106700,68713
566,419,147,528,89200,68714
600,486,114,655,140400,68715
429,291,138,592,74700,68716
85,81,4,-,88800,68717
763,552,211,588,79100,68718
54,45,9,675,55000,68719
116,84,32,754,74000,68720
240,180,60,333,55100,68722
203,168,35,561,90000,68723
58,47,11,-,130100,68724
223,182,41,580,69200,68725
279,237,42,525,100600,68726
311,246,65,505,87800,68727
103,82,21,525,62200,68728
844,656,188,588,90500,68729
772,635,137,551,141600,68730
993,742,251,585,116200,68731
110,90,20,1125,64400,68732
550,390,160,547,89600,68733
34,29,5,-,103100,68734
366,280,86,577,64300,68735
206,165,41,-,139800,68736
1204,1011,193,623,127600,68739
412,344,68,765,148200,68740
303,251,52,683,153400,68741
67,51,16,719,32000,68742
223,198,25,588,173800,68743
666,487,179,655,98800,68745
197,161,36,506,34200,68746
63,51,12,625,92800,68747
1014,715,299,695,89400,68748
28,21,7,-,59000,68749
29,27,2,-,57500,68751
342,285,57,573,135900,68752
41,35,6,-,135400,68753
125,110,15,-,106800,68755
819,564,255,525,80400,68756
322,293,29,800,90900,68757
564,414,150,605,74000,68758
108,88,20,525,46700,68759
526,314,212,356,65800,68760
149,134,15,588,22500,68761
2087,1368,719,677,119700,68763
367,293,74,467,67000,68764
567,457,110,597,99800,68765
230,196,34,463,100900,68766
1266,1054,212,581,113500,68767
239,195,44,700,89700,68768
809,663,146,606,72700,68769
606,503,103,567,96500,68770
617,467,150,661,97400,68771
64,40,24,-,84300,68773
105,91,14,-,153800,68774
5308,3254,2054,687,113700,68776
334,282,52,525,82600,68777
247,175,72,575,61300,68778
1048,855,193,527,112500,68779
466,328,138,517,108300,68780
620,427,193,564,88200,68781
408,300,108,579,66600,68783
726,560,166,655,85800,68784
102,91,11,394,122300,68785
450,346,104,470,79800,68786
2406,1320,1086,676,135700,68787
1998,1325,673,642,128600,68788
66,60,6,-,-,68789
354,263,91,590,88800,68790
761,519,242,682,107700,68791
171,142,29,628,96000,68792
10884,6333,4551,709,107500,68801
9580,5991,3589,712,161500,68803
357,291,66,810,84900,68810
247,199,48,538,113100,68812
222,176,46,642,95000,68813
400,304,96,615,56900,68814
279,201,78,594,117200,68815
113,98,15,425,120600,68816
150,134,16,554,78900,68817
2207,1740,467,650,141400,68818
185,137,48,-,88300,68820
37,17,20,442,51300,68821
2082,1398,684,602,105800,68822
997,781,216,380,101000,68823
503,389,114,648,140600,68824
449,332,117,704,121300,68825
1616,1079,537,550,86800,68826
278,222,56,768,89500,68827
113,94,19,635,115000,68828
303,259,44,635,141100,68831
800,614,186,796,205400,68832
182,105,77,717,115400,68833
69,55,14,613,73800,68834
238,175,63,708,101000,68835
628,500,128,764,100900,68836
77,57,20,-,116300,68837
125,116,9,-,66300,68838
1165,848,317,793,134300,68840
243,223,20,721,123800,68841
243,171,72,548,67200,68842
317,292,25,850,115200,68843
92,82,10,-,116700,68844
7882,4474,3408,779,190000,68845
131,103,28,688,80500,68846
7051,4352,2699,730,153900,68847
0,0,0,-,-,68849
4196,2608,1588,734,98900,68850
251,197,54,608,67200,68852
703,564,139,495,83000,68853
354,274,80,1007,126500,68854
194,151,43,588,68800,68855
260,160,100,739,79500,68856
126,104,22,564,70000,68858
296,243,53,350,74200,68859
146,126,20,850,58800,68860
36,30,6,-,91100,68861
1313,928,385,623,95700,68862
456,345,111,588,100400,68863
458,345,113,597,111100,68864
367,323,44,-,147900,68865
371,303,68,821,171900,68866
880,657,223,589,106800,68869
209,177,32,635,228900,68870
102,75,27,-,118800,68871
311,297,14,-,127600,68872
1474,1067,407,568,129900,68873
425,314,111,579,70400,68874
286,239,47,448,80700,68875
628,447,181,591,100300,68876
164,100,64,706,105000,68878
161,127,34,600,110600,68879
19,9,10,-,-,68881
170,122,48,660,41700,68882
977,739,238,585,130200,68883
10594,6941,3653,658,111300,68901
763,578,185,572,87800,68920
551,410,141,629,82600,68922
39,38,1,-,75000,68923
492,429,63,550,128000,68924
231,194,37,850,200000,68925
356,227,129,443,45600,68926
557,383,174,785,116000,68927
156,132,24,539,80000,68928
71,69,2,-,34200,68929
578,464,114,439,117600,68930
189,171,18,588,51800,68932
413,311,102,517,80200,68933
48,43,5,-,-,68934
308,208,100,512,77500,68935
131,87,44,500,37100,68936
723,542,181,638,139700,68937
242,214,28,568,73200,68938
529,407,122,482,59300,68939
240,189,51,650,170400,68940
329,294,35,769,97100,68941
151,113,38,538,32000,68942
125,103,22,-,29200,68943
486,319,167,602,82700,68944
103,100,3,-,126600,68945
9,7,2,-,-,68946
313,261,52,519,85400,68947
145,114,31,597,46800,68948
2783,1905,878,548,119300,68949
172,111,61,579,86400,68950
49,41,8,-,-,68952
21,5,16,-,-,68954
769,644,125,594,170300,68955
512,421,91,688,103000,68956
282,245,37,538,66000,68957
249,203,46,754,115600,68958
1683,1103,580,715,136500,68959
76,68,8,-,46000,68960
366,304,62,538,64200,68961
38,33,5,-,29000,68964
355,260,95,535,57700,68966
401,282,119,520,58700,68967
27,25,2,-,62100,68969
615,474,141,350,54300,68970
183,147,36,595,175800,68971
62,60,2,-,-,68972
152,143,9,625,96900,68973
81,73,8,-,71300,68974
45,45,0,-,100900,68975
128,86,42,545,121900,68976
112,108,4,-,52900,68977
997,700,297,481,57100,68978
807,633,174,640,103400,68979
157,120,37,755,113900,68980
140,120,20,-,64400,68981
287,210,77,625,88500,68982
3878,2865,1013,597,93400,69001
220,181,39,731,79500,69020
652,442,210,482,78900,69021
785,589,196,606,97200,69022
150,139,11,-,115900,69023
518,393,125,662,81200,69024
437,287,150,595,91600,69025
82,74,8,-,-,69026
22,22,0,-,-,69027
329,260,69,655,101900,69028
158,134,24,386,70000,69029
100,62,38,670,52900,69030
187,144,43,525,58600,69032
1085,875,210,639,136800,69033
408,335,73,642,83900,69034
40,28,12,-,63300,69036
37,35,2,-,-,69037
240,180,60,688,79300,69038
36,18,18,-,-,69039
312,228,84,620,56200,69040
54,37,17,-,29700,69041
25,10,15,-,141700,69042
209,167,42,705,45300,69043
354,233,121,480,49300,69044
508,355,153,575,69900,69045
94,87,7,-,52500,69046
12430,7646,4784,680,132200,69101
529,413,116,524,120100,69120
159,100,59,667,101700,69121
284,213,71,606,72500,69122
378,296,82,648,134800,69123
156,87,69,610,-,69125
414,349,65,653,138800,69127
87,79,8,875,138500,69128
549,413,136,723,80200,69129
2154,1409,745,668,99100,69130
248,202,46,1091,90000,69131
59,43,16,-,-,69132
183,140,43,883,75000,69133
172,141,31,608,106600,69134
67,30,37,-,-,69135
1628,1215,413,675,104000,69138
789,593,196,684,108900,69140
164,120,44,723,82200,69141
34,29,5,-,73000,69142
565,473,92,735,130400,69143
59,52,7,-,-,69144
1323,842,481,681,83400,69145
197,150,47,-,119000,69146
311,247,64,621,81700,69147
63,50,13,-,65000,69148
325,260,65,407,74400,69149
146,126,20,700,86000,69150
354,286,68,546,110000,69151
356,264,92,620,90000,69152
2739,1716,1023,594,108100,69153
533,476,57,492,83300,69154
501,348,153,615,85700,69155
282,220,62,785,91500,69156
23,23,0,-,85000,69157
50,34,16,431,41400,69161
3425,2339,1086,682,125400,69162
387,283,104,560,115200,69163
787,581,206,717,116700,69165
295,199,96,531,126400,69166
161,103,58,638,112500,69167
119,90,29,632,57300,69168
235,190,45,667,98300,69169
122,89,33,610,114800,69170
3,3,0,-,-,69171
1788,1124,664,711,128500,69201
1229,895,334,488,80900,69210
256,98,158,675,68300,69211
116,76,40,386,52700,69212
98,64,34,-,104300,69214
42,29,13,-,70800,69216
154,122,32,638,63600,69217
105,73,32,-,56900,69218
48,15,33,-,-,69219
10,8,2,-,48000,69220
84,52,32,-,-,69221
4107,2907,1200,574,109100,69301
23,18,5,-,-,69331
120,95,25,-,54400,69333
843,679,164,718,89300,69334
13,7,6,-,-,69335
1097,725,372,701,89500,69336
2680,1496,1184,645,127800,69337
750,587,163,504,76300,69339
55,46,9,-,-,69340
4201,3148,1053,742,122700,69341
1038,663,375,559,78300,69343
191,131,60,428,139700,69345
270,212,58,538,87100,69346
575,487,88,642,74600,69347
615,478,137,591,92600,69348
173,146,27,342,57500,69350
106,46,60,-,109600,69351
275,211,64,847,88900,69352
13,11,2,-,-,69353
53,38,15,-,-,69354
70,67,3,850,95000,69355
704,509,195,654,93100,69356
1519,1130,389,684,115600,69357
815,533,282,700,97000,69358
586,404,182,644,62300,69360
6943,4418,2525,733,115600,69361
19,19,0,-,-,69365
92,69,23,-,102700,69366
104,92,12,-,90000,69367
17732,9216,8516,882,219400,70001
8709,4385,4324,921,276400,70002
16022,12247,3775,882,182300,70003
11519,7230,4289,961,275900,70005
5975,3807,2168,984,254600,70006
1422,1318,104,920,177700,70030
502,461,41,784,154000,70031
1688,1133,555,885,139600,70032
482,443,39,-,117500,70036
5993,3637,2356,1175,251200,70037
109,98,11,-,107300,70038
908,640,268,847,139900,70039
393,362,31,788,90300,70040
1098,951,147,931,65200,70041
7424,4280,3144,884,141300,70043
4610,3850,760,1028,219300,70047
871,582,289,648,99900,70049
42,42,0,-,83100,70050
826,666,160,-,123300,70051
1336,1031,305,921,150500,70052
6550,3025,3525,852,155600,70053
13712,7942,5770,993,166700,70056
1619,1217,402,675,156900,70057
13521,8933,4588,962,141700,70058
6085,3149,2936,864,140600,70062
19257,11955,7302,978,183300,70065
891,797,94,1104,155500,70067
11424,8730,2694,980,162600,70068
4585,3890,695,1097,194700,70070
1457,1061,396,750,128000,70071
19641,14150,5491,921,142000,70072
1672,1319,353,881,167500,70075
55,15,40,-,-,70076
1227,991,236,898,157500,70079
553,492,61,-,159000,70080
118,113,5,-,74800,70082
885,760,125,574,81300,70083
2621,2067,554,720,116600,70084
1661,1479,182,764,99400,70085
769,563,206,745,83400,70086
2950,1879,1071,683,165300,70087
2669,2062,607,539,122200,70090
121,83,38,-,101600,70091
2346,1795,551,790,132100,70092
10999,6775,4224,905,105500,70094
1433,199,1234,1354,370800,70112
3701,810,2891,742,167700,70113
9820,4196,5624,863,148800,70114
15290,7403,7887,1111,419600,70115
6180,2340,3840,922,259900,70116
11495,5363,6132,898,166600,70117
12728,6015,6713,974,321600,70118
16381,5273,11108,979,241300,70119
5453,2942,2511,871,178300,70121
14258,8218,6040,936,179400,70122
11903,7191,4712,1063,238400,70123
8186,5738,2448,1357,390400,70124
6143,2593,3550,974,305700,70125
9627,4731,4896,921,153300,70126
9420,4154,5266,858,151500,70127
7144,4616,2528,911,167100,70128
3092,1911,1181,770,145800,70129
7939,2567,5372,1150,367400,70130
12058,6765,5293,864,172200,70131
0,0,0,-,-,70139
0,0,0,-,-,70163
16652,11763,4889,782,162400,70301
2582,2182,400,690,118300,70339
43,43,0,-,-,70340
1529,1033,496,804,99300,70341
1760,1166,594,685,106800,70342
1848,1613,235,686,169800,70343
2093,1795,298,563,87300,70344
3513,2770,743,854,122200,70345
3951,2691,1260,577,115200,70346
55,55,0,-,190300,70352
489,432,57,-,69100,70353
1790,1505,285,736,109700,70354
358,323,35,-,79500,70355
819,671,148,681,87000,70356
1057,678,379,769,89600,70357
335,220,115,645,174500,70358
3070,2399,671,779,151200,70359
10770,7204,3566,979,207300,70360
8145,5417,2728,703,112100,70363
11375,7802,3573,905,154500,70364
1073,761,312,710,112900,70372
2621,2112,509,689,137300,70373
2530,1788,742,746,120900,70374
34,34,0,-,172200,70375
1539,1315,224,627,82300,70377
8756,5208,3548,759,112100,70380
2515,2014,501,665,112100,70390
70,70,0,-,-,70391
3223,2099,1124,840,108600,70392
319,319,0,-,137800,70393
5479,4371,1108,688,136800,70394
1895,1591,304,1007,121800,70395
305,221,84,-,153100,70397
7439,3684,3755,789,163500,70401
0,0,0,-,-,70402
10918,6548,4370,801,153400,70403
3176,2684,492,1009,194800,70420
5577,4311,1266,646,113500,70422
1807,1451,356,613,81900,70426
7538,4999,2539,563,82300,70427
2037,1835,202,734,218100,70431
13914,10093,3821,1079,240800,70433
6667,6081,586,992,198200,70435
303,236,67,-,204000,70436
3194,2728,466,913,214600,70437
7176,5288,1888,597,94400,70438
1597,1232,365,617,94800,70441
36,36,0,-,-,70442
3654,2700,954,741,91600,70443
3813,2984,829,767,93200,70444
4143,3616,527,1042,152600,70445
2715,2076,639,730,166800,70446
4271,3917,354,1193,265600,70447
9273,7542,1731,1171,247700,70448
1538,1370,168,948,137900,70449
1189,966,223,714,69100,70450
10,10,0,-,-,70451
4670,3634,1036,735,143600,70452
272,256,16,-,66700,70453
11088,8717,2371,805,162500,70454
370,331,39,-,-,70455
829,615,214,673,78100,70456
14158,10353,3805,1012,170900,70458
7793,5571,2222,966,147300,70460
10002,7408,2594,899,197900,70461
2150,1833,317,828,147300,70462
93,85,8,700,114600,70463
189,142,47,-,150000,70464
226,152,74,818,31300,70465
3297,2218,1079,796,99100,70466
7910,5837,2073,1059,287100,70471
11332,5268,6064,719,102700,70501
11128,7877,3251,999,229400,70503
17369,8918,8451,829,164000,70506
6199,4116,2083,801,143400,70507
15970,10686,5284,954,243900,70508
9292,6688,2604,648,106200,70510
3438,2816,622,654,94700,70512
163,51,112,-,-,70513
902,553,349,752,71200,70514
1105,804,301,481,79900,70515
198,198,0,-,113000,70516
9900,7793,2107,687,121100,70517
5538,4429,1109,861,205500,70518
92,92,0,-,-,70519
6806,5494,1312,649,154900,70520
399,327,72,840,87200,70523
128,105,23,455,82400,70524
5336,3747,1589,587,91000,70525
6785,4352,2433,617,102900,70526
799,579,220,658,83600,70528
4216,2949,1267,697,110400,70529
495,439,56,-,117400,70531
967,699,268,545,82400,70532
2661,2164,497,639,93500,70533
291,215,76,707,64000,70534
6659,4351,2308,617,103000,70535
214,177,37,-,-,70537
4949,3146,1803,700,81600,70538
167,132,35,620,98900,70541
1493,1304,189,638,88900,70542
1756,1372,384,547,125000,70543
4323,2942,1381,655,79100,70544
5884,4058,1826,594,105600,70546
3875,3031,844,585,90000,70548
1488,1002,486,568,106700,70549
53,53,0,-,-,70550
654,420,234,798,75700,70552
1892,1199,693,500,103600,70554
2861,2346,515,757,147700,70555
117,77,40,256,76800,70556
0,0,0,-,-,70558
927,736,191,602,76700,70559
14821,9113,5708,712,85800,70560
6867,5419,1448,855,158300,70563
14055,9444,4611,622,104000,70570
42,42,0,-,-,70575
251,173,78,673,76300,70576
1511,1187,324,691,69200,70577
6161,4430,1731,596,103300,70578
69,33,36,-,-,70580
306,283,23,-,78500,70581
6908,5476,1432,642,108000,70582
4411,3285,1126,775,120600,70583
2901,2250,651,570,117800,70584
81,66,15,600,88000,70585
7467,4773,2694,535,91200,70586
1229,944,285,486,110600,70589
1888,1367,521,686,118300,70591
8211,6913,1298,1027,194700,70592
13577,6893,6684,692,112200,70601
14329,10096,4233,984,208300,70605
10979,6370,4609,777,103300,70607
7406,6193,1213,838,180500,70611
4829,3002,1827,803,87000,70615
721,640,81,685,119100,70630
203,192,11,-,90000,70631
233,233,0,-,123900,70632
2474,1807,667,592,90800,70633
9490,6919,2571,703,130000,70634
262,194,68,-,58400,70637
250,215,35,363,73900,70638
164,151,13,-,82900,70639
147,105,42,482,61500,70640
100,87,13,-,-,70643
37,37,0,-,-,70644
530,479,51,839,123900,70645
191,136,55,-,73200,70646
3517,2700,817,743,122200,70647
2604,2040,564,747,103200,70648
100,100,0,-,105500,70650
122,102,20,-,83200,70651
897,710,187,713,75000,70652
1352,1051,301,356,75500,70653
89,89,0,-,"10,000-",70654
990,725,265,646,85400,70655
1377,1169,208,-,67600,70656
1782,1689,93,760,121200,70657
305,271,34,775,85400,70658
590,320,270,876,135900,70659
524,456,68,-,68800,70660
970,853,117,-,73600,70661
128,128,0,-,108300,70662
10659,7774,2885,789,121600,70663
4100,3386,714,838,161100,70665
2544,1805,739,631,87100,70668
3810,2970,840,820,127000,70669
7915,6785,1130,864,160800,70706
1692,1305,387,1026,180900,70710
1628,1349,279,658,150600,70711
194,50,144,859,20000,70712
7066,5197,1869,929,136600,70714
529,446,83,-,115300,70715
1708,1330,378,775,199000,70719
294,101,193,746,59300,70721
2170,1746,424,713,163000,70722
474,371,103,903,110500,70723
645,576,69,-,165200,70725
19860,15077,4783,881,159500,70726
275,195,80,-,-,70729
1345,1200,145,739,114700,70730
481,420,61,-,85200,70732
594,478,116,803,112500,70733
2380,1895,485,1159,202500,70734
213,154,59,-,116000,70736
15691,11540,4151,989,170300,70737
4858,4399,459,718,213500,70739
634,510,124,490,97100,70740
61,56,5,-,-,70743
2250,1795,455,811,100500,70744
79,52,27,-,52900,70747
1602,1236,366,699,84400,70748
595,433,162,1023,169700,70749
607,449,158,571,68300,70750
339,204,135,-,220400,70752
389,241,148,850,81800,70753
4270,3384,886,871,133800,70754
772,682,90,647,136200,70755
159,130,29,-,-,70756
1123,949,174,437,88800,70757
626,514,112,679,95500,70759
2446,1470,976,700,129700,70760
313,234,79,-,107400,70761
392,326,66,-,170700,70762
1466,1254,212,563,199200,70763
5957,4489,1468,739,123200,70764
5786,4123,1663,797,162400,70767
14258,12650,1608,1104,216900,70769
1158,1041,117,725,169000,70770
383,338,45,613,83300,70772
95,63,32,-,141000,70773
3731,3209,522,897,157700,70774
3627,2776,851,857,217500,70775
1122,924,198,695,228000,70776
1608,1283,325,826,139500,70777
1305,1080,225,932,177300,70778
567,496,71,-,151200,70780
126,77,49,-,-,70782
1164,1094,70,675,163700,70783
7417,6215,1202,780,160600,70785
0,0,0,-,-,70787
1563,1089,474,643,142100,70788
266,214,52,561,92300,70789
8954,6706,2248,914,205700,70791
30,0,30,-,-,70801
10089,3822,6267,719,75800,70802
23,0,23,-,-,70803
9706,4401,5305,711,79000,70805
12451,5439,7012,753,207800,70806
5737,2878,2859,688,78000,70807
13054,7698,5356,978,295700,70808
10922,5808,5114,1138,268900,70809
15270,10601,4669,1093,259000,70810
4767,3144,1623,827,113400,70811
3610,2159,1451,915,109000,70812
5210,3640,1570,830,140600,70814
10671,6752,3919,817,162700,70815
17587,8447,9140,929,180100,70816
12772,10075,2697,1145,228000,70817
3615,2876,739,836,190300,70818
1620,1211,409,881,133000,70819
7646,1649,5997,884,233700,70820
0,0,0,-,-,70836
1784,1102,682,504,85000,71001
532,449,83,769,80600,71003
257,206,51,843,138700,71004
4551,3844,707,860,198200,71006
350,350,0,-,88100,71007
332,277,55,338,81000,71008
802,590,212,615,62900,71016
725,540,185,404,59800,71018
3069,2203,866,538,87200,71019
377,203,174,513,49100,71021
1271,1056,215,687,101600,71023
775,589,186,344,85700,71024
619,463,156,814,93600,71027
611,411,200,348,98800,71028
62,53,9,-,154400,71029
690,543,147,-,149300,71030
473,302,171,753,73100,71031
868,675,193,609,145400,71032
1386,1149,237,707,109100,71033
102,88,14,625,77500,71034
7307,5898,1409,842,157600,71037
1731,1010,721,610,70300,71038
570,540,30,-,68000,71039
3133,1965,1168,623,78800,71040
210,189,21,-,101000,71043
294,252,42,838,75800,71044
264,233,31,550,85200,71045
496,454,42,-,153100,71046
4321,3741,580,746,166500,71047
23,23,0,-,45800,71048
1130,842,288,655,84700,71049
953,784,169,616,129500,71051
3694,2281,1413,556,82800,71052
7563,4907,2656,680,87500,71055
1063,825,238,708,131300,71060
701,386,315,445,123800,71061
325,225,100,-,-,71063
1483,1215,268,485,58700,71064
496,359,137,262,80100,71065
1454,973,481,727,87000,71067
1591,1257,334,474,73000,71068
247,206,41,1042,40000,71069
717,625,92,634,58600,71070
986,768,218,769,104000,71071
553,480,73,689,70200,71072
976,703,273,475,99600,71073
2607,1784,823,560,65500,71075
2485,2035,450,699,161400,71078
83,83,0,-,-,71079
2141,1388,753,477,67000,71082
2979,814,2165,605,67900,71101
2628,916,1712,657,58700,71103
6224,2887,3337,794,123300,71104
9784,5285,4499,958,177900,71105
13094,9014,4080,773,225200,71106
11741,7333,4408,729,118200,71107
6506,3428,3078,746,70200,71108
8038,3608,4430,665,64400,71109
892,21,871,1407,-,71110
16963,9332,7631,913,199000,71111
13037,8050,4987,926,151800,71112
6951,3967,2984,885,216000,71115
10206,6329,3877,815,147000,71118
4363,3381,982,882,139000,71119
5141,2794,2347,793,138600,71129
8835,4737,4098,726,197900,71201
8691,3932,4759,620,65100,71202
13503,7728,5775,769,138000,71203
0,0,0,-,-,71209
513,454,59,425,90000,71219
8597,5455,3142,577,83600,71220
1327,914,413,389,65700,71222
134,119,15,-,34100,71223
2546,2174,372,803,140700,71225
698,418,280,391,127600,71226
1520,1213,307,847,110300,71227
458,312,146,683,98000,71229
2586,1670,916,545,73600,71232
101,56,45,569,46300,71233
1474,1314,160,614,130100,71234
1791,1404,387,667,102300,71235
535,377,158,514,59900,71237
1074,979,95,771,99100,71238
3254,2605,649,533,101300,71241
77,53,24,-,215000,71243
1618,555,1063,612,87000,71245
397,208,189,458,74700,71247
84,39,45,-,43000,71250
3213,2105,1108,521,82800,71251
101,58,43,458,55000,71253
2192,896,1296,474,57000,71254
314,255,59,279,95000,71256
670,533,137,668,83300,71259
1150,944,206,490,89800,71260
517,424,93,372,85400,71261
3149,2335,814,528,84700,71263
501,444,57,626,122100,71264
466,387,79,556,71700,71266
990,907,83,529,102500,71268
4373,2606,1767,624,93200,71269
12121,6081,6040,689,163700,71270
0,0,0,-,-,71272
891,694,197,622,73600,71275
49,44,5,-,109700,71276
662,610,52,333,37500,71277
20,0,20,-,-,71279
1488,1114,374,804,161100,71280
3724,2078,1646,528,65600,71282
139,121,18,-,77400,71286
12991,8004,4987,765,145100,71291
7843,5312,2531,715,94200,71292
5081,3331,1750,553,86500,71295
8257,3968,4289,763,118200,71301
5400,3101,2299,714,98400,71302
8541,4619,3922,908,182000,71303
25,25,0,-,-,71316
2267,1485,782,759,79100,71322
356,311,45,1069,90300,71323
390,268,122,348,67300,71325
439,299,140,485,50100,71326
1462,985,477,692,95400,71327
2572,2116,456,803,157100,71328
357,294,63,805,81300,71331
251,146,105,293,102800,71333
3347,1840,1507,495,77900,71334
628,432,196,524,89700,71336
53,53,0,-,-,71339
337,268,69,488,76900,71340
1188,938,250,596,138300,71341
2765,1940,825,557,97500,71342
2979,2358,621,503,74100,71343
39,0,39,-,-,71345
1006,659,347,599,152500,71346
1868,1235,633,573,118400,71350
4122,2849,1273,594,88300,71351
684,499,185,593,85500,71353
757,556,201,573,125000,71354
1235,902,333,660,82500,71355
316,282,34,-,87200,71356
731,460,271,488,80900,71357
438,339,99,414,67900,71358
12778,7928,4850,760,145900,71360
702,577,125,545,84800,71362
706,426,280,427,50000,71366
509,433,76,-,78400,71367
566,317,249,488,99500,71368
1010,555,455,533,68100,71369
719,549,170,-,71100,71371
2523,1736,787,536,79000,71373
493,311,182,434,62400,71375
82,56,26,-,-,71377
919,570,349,457,69200,71378
84,84,0,-,-,71401
1493,1226,267,710,125600,71403
311,228,83,568,85900,71404
2169,1507,662,857,129300,71405
27,27,0,-,55500,71406
354,251,103,692,114300,71407
2165,1586,579,646,125000,71409
45,25,20,400,-,71410
1309,632,677,615,93000,71411
55,23,32,555,-,71414
384,220,164,611,79200,71416
1965,1199,766,671,86200,71417
2455,1712,743,563,68700,71418
869,693,176,347,74900,71419
624,529,95,-,79200,71422
1640,1138,502,929,132500,71423
350,282,68,951,112800,71424
82,31,51,-,80900,71425
90,62,28,814,76700,71426
157,136,21,-,102000,71427
1153,975,178,613,112700,71429
992,664,328,669,96000,71430
458,327,131,585,69400,71432
1567,1257,310,592,82600,71433
1280,1111,169,627,54600,71435
607,486,121,-,73100,71438
681,479,202,550,115000,71439
239,142,97,633,105700,71441
8335,4975,3360,855,119400,71446
520,377,143,-,80800,71447
3533,2449,1084,522,112500,71449
441,326,115,710,107500,71450
32,32,0,-,52700,71452
992,587,405,645,82700,71454
43,43,0,-,-,71455
415,211,204,645,-,71456
10181,4537,5644,687,142200,71457
3503,35,3468,1074,-,71459
950,436,514,728,96400,71461
681,513,168,582,46800,71462
3084,2165,919,464,73300,71463
1072,865,207,581,67000,71465
259,196,63,850,85900,71466
1662,1223,439,662,92700,71467
374,201,173,618,67400,71468
907,686,221,733,72400,71469
133,133,0,-,-,71472
163,136,27,-,54300,71473
216,166,50,725,135300,71474
344,278,66,539,73300,71479
219,177,42,-,59200,71480
3541,2178,1363,601,72200,71483
818,638,180,658,240000,71485
2103,1528,575,575,70400,71486
5576,2804,2772,628,57900,71601
6473,4386,2087,742,102000,71602
12794,8441,4353,712,85000,71603
243,173,70,579,44400,71630
178,141,37,-,63200,71631
4735,3269,1466,619,73200,71635
1300,836,464,639,60800,71638
2522,1454,1068,573,55100,71639
1316,856,460,542,50500,71640
219,179,40,620,33700,71642
467,334,133,418,65500,71643
400,268,132,469,58600,71644
2473,2018,455,623,69400,71646
925,562,363,527,76900,71647
30,30,0,-,-,71651
488,290,198,569,57800,71652
1907,1313,594,579,75600,71653
1802,1015,787,458,63600,71654
5651,3596,2055,644,96200,71655
229,182,47,531,-,71658
43,37,6,-,-,71659
310,295,15,-,73600,71660
148,122,26,-,43100,71661
73,0,73,-,-,71662
312,234,78,494,69600,71663
2271,1668,603,621,104100,71665
25,6,19,-,-,71666
2956,2225,731,566,70500,71667
579,426,153,513,46500,71670
3515,2181,1334,587,76800,71671
265,211,54,806,55500,71674
815,607,208,769,91100,71675
271,181,90,361,44200,71676
69,43,26,658,69000,71677
7573,4831,2742,560,72900,71701
15,0,15,-,-,71711
925,666,259,366,54800,71720
42,27,15,-,51700,71722
147,129,18,-,41700,71724
236,195,41,450,50400,71725
714,601,113,333,62100,71726
12440,8678,3762,655,86000,71730
609,515,94,-,69200,71740
2221,1373,848,670,66800,71742
1670,1192,478,627,90600,71743
1241,1031,210,634,74400,71744
161,122,39,413,66300,71745
379,316,63,425,44500,71747
978,888,90,582,75600,71749
355,320,35,579,100900,71751
400,216,184,525,52600,71752
6317,3915,2402,685,88300,71753
201,201,0,-,107300,71758
249,186,63,627,57000,71759
973,780,193,744,57500,71762
691,619,72,450,63800,71763
913,733,180,455,55900,71764
909,778,131,515,53700,71765
286,206,80,545,57900,71766
1500,1126,374,587,75300,71770
1,1,0,-,-,71772
5825,3775,2050,637,81200,71801
12,12,0,-,-,71820
3769,2534,1235,541,75100,71822
26,22,4,-,60000,71823
234,219,15,725,68800,71825
396,294,102,410,63500,71826
278,260,18,517,53300,71827
3483,2639,844,552,79500,71832
783,599,184,608,76900,71833
608,437,171,757,69000,71834
601,527,74,563,64500,71835
1143,852,291,536,63300,71836
2013,1662,351,617,119400,71837
451,341,110,-,49300,71838
127,91,36,403,-,71839
474,391,83,638,69000,71841
893,669,224,500,68300,71842
881,578,303,274,66200,71845
1146,808,338,553,74200,71846
248,188,60,-,74500,71847
806,548,258,571,93400,71851
3701,2398,1303,533,97100,71852
99,74,25,541,-,71853
14272,8612,5660,716,109100,71854
248,205,43,-,-,71855
1916,1310,606,664,65500,71857
935,763,172,675,55100,71858
185,153,32,-,100800,71859
1003,658,345,500,52500,71860
849,703,146,571,74400,71861
205,124,81,591,55800,71862
66,51,15,-,47900,71865
202,159,43,838,104200,71866
11683,6792,4891,656,121200,71901
7452,6471,981,1056,188300,71909
19414,12727,6687,753,134800,71913
1361,1121,240,525,72500,71921
37,29,8,-,48800,71922
6213,3603,2610,592,109100,71923
1641,1447,194,633,101500,71929
457,369,88,489,144300,71933
213,200,13,-,70300,71935
726,549,177,543,75700,71937
749,561,188,535,58600,71940
865,744,121,541,83600,71941
1832,1365,467,429,76300,71943
341,255,86,422,69300,71944
593,453,140,423,106200,71945
955,722,233,-,101200,71949
395,359,36,514,82600,71950
52,52,0,-,-,71952
5782,4497,1285,559,90600,71953
754,547,207,579,46800,71956
1355,1086,269,526,118400,71957
960,653,307,526,87000,71958
238,216,22,-,104500,71959
651,530,121,625,72900,71960
389,291,98,638,91900,71961
376,257,119,344,58400,71962
1312,1007,305,742,142800,71964
124,102,22,963,150000,71965
1526,1379,147,786,116700,71968
144,112,32,-,218100,71969
381,364,17,-,118800,71970
173,133,40,-,78600,71971
133,92,41,588,85900,71972
548,367,181,471,63600,71973
0,0,0,-,-,71998
0,0,0,-,-,71999
231,198,33,813,86700,72001
5887,4961,926,774,143300,72002
348,295,53,750,60200,72003
443,311,132,483,52000,72004
67,40,27,505,46400,72005
1202,713,489,480,64400,72006
2516,1972,544,780,141700,72007
2633,1742,891,596,81400,72010
1450,1291,159,726,112500,72011
4763,3201,1562,781,138700,72012
804,657,147,658,76900,72013
26,21,5,-,26300,72014
10659,7124,3535,792,120600,72015
1211,1147,64,678,110000,72016
327,228,99,503,43900,72017
9382,7695,1687,746,170300,72019
1595,1352,243,569,54300,72020
1646,942,704,525,66000,72021
6774,4459,2315,869,153200,72022
13829,9229,4600,794,149200,72023
1350,1011,339,644,89500,72024
312,279,33,618,87200,72025
126,97,29,-,55600,72026
588,506,82,425,90000,72027
865,472,393,367,51300,72029
265,231,34,-,104300,72030
2900,2159,741,519,108100,72031
11772,7202,4570,774,136700,72032
19049,9941,9108,777,169500,72034
0,0,0,-,-,72035
356,250,106,545,27000,72036
13,7,6,-,-,72037
35,28,7,-,160700,72038
824,597,227,698,122200,72039
1289,928,361,430,64000,72040
612,419,193,625,52600,72041
2079,1300,779,600,67500,72042
298,267,31,607,188600,72044
544,309,235,688,125600,72045
1721,1051,670,582,95200,72046
369,324,45,800,99600,72047
16,16,0,-,68600,72048
266,186,80,772,75000,72051
394,272,122,631,68000,72055
324,254,70,831,117800,72057
6042,4518,1524,785,154700,72058
14,14,0,-,-,72059
247,121,126,583,67400,72060
26,26,0,-,157100,72061
611,513,98,509,105000,72063
1160,827,333,639,71200,72064
1721,1383,338,757,121300,72065
1167,846,321,686,124600,72067
142,87,55,771,77000,72068
602,472,130,463,71600,72069
562,500,62,668,101500,72070
186,167,19,-,83600,72072
467,313,154,-,73300,72073
70,55,15,695,70700,72074
13870,8109,5761,760,111200,72076
243,243,0,-,62200,72079
201,179,22,-,67100,72080
2742,1973,769,676,97900,72081
752,441,311,549,53500,72082
88,55,33,829,82800,72083
472,357,115,555,55900,72084
76,45,31,575,64100,72085
3711,2732,979,762,124000,72086
753,624,129,-,156300,72087
1240,1060,180,890,114900,72088
0,0,0,-,-,72099
1133,788,345,495,74400,72101
1160,887,273,674,90400,72102
4691,3520,1171,825,106000,72103
8457,5884,2573,661,87100,72104
1981,1481,500,796,126900,72106
69,59,10,-,93200,72107
38,38,0,-,-,72108
4358,2703,1655,629,101500,72110
429,376,53,800,141700,72111
3569,2292,1277,570,67000,72112
10470,6037,4433,890,214500,72113
5012,1310,3702,641,69400,72114
9317,5973,3344,868,171300,72116
5027,3028,1999,777,81200,72117
8291,4938,3353,780,97200,72118
0,0,0,-,-,72119
12956,9148,3808,828,148700,72120
1447,1280,167,686,86200,72121
200,200,0,-,252100,72122
171,106,65,475,24100,72123
346,269,77,688,61400,72125
1274,860,414,633,94700,72126
1032,757,275,736,89200,72127
295,242,53,844,110200,72128
492,427,65,615,78500,72129
281,247,34,-,130700,72130
1875,1546,329,675,129900,72131
1316,939,377,869,99200,72132
128,94,34,542,48800,72134
971,830,141,1284,246000,72135
473,438,35,-,121600,72136
951,736,215,730,90000,72137
107,49,58,250,53600,72139
186,165,21,675,79700,72140
256,182,74,-,74400,72141
1004,820,184,757,195200,72142
12833,7973,4860,692,141500,72143
0,0,0,-,-,72149
4866,3762,1104,728,136100,72150
198,136,62,-,154500,72152
923,732,191,625,88500,72153
231,148,83,-,96700,72156
519,434,85,749,124500,72157
4165,2441,1724,681,88400,72160
13,13,0,-,-,72165
100,73,27,-,-,72166
543,471,72,856,95000,72167
154,99,55,-,-,72168
79,56,23,-,40000,72169
110,70,40,532,56700,72170
3139,2637,502,800,144100,72173
139,104,35,425,58000,72175
3462,2212,1250,763,119300,72176
165,140,25,-,87500,72179
14,5,9,-,-,72181
602,241,361,975,343600,72201
4838,1565,3273,778,109800,72202
11406,6565,4841,807,90500,72204
10727,5375,5352,856,159600,72205
9060,5742,3318,691,88600,72206
4902,3177,1725,817,267600,72207
10909,5159,5750,773,79200,72209
6539,4201,2338,836,168300,72210
9580,5388,4192,893,183700,72211
5120,4352,768,993,280300,72212
8929,5868,3061,1031,338500,72223
4879,3234,1645,860,183200,72227
9780,4590,5190,694,84300,72301
49,29,20,-,57500,72311
9002,5338,3664,644,84200,72315
23,23,0,-,-,72320
67,37,30,819,75800,72321
76,55,21,-,33400,72322
929,672,257,636,71700,72324
19,9,10,-,-,72325
804,529,275,663,48700,72326
729,489,240,545,112500,72327
13,13,0,-,-,72328
51,12,39,-,-,72329
202,138,64,847,58300,72330
1169,750,419,593,76300,72331
10,2,8,-,-,72332
337,128,209,493,35400,72333
6113,3448,2665,609,67200,72335
6,6,0,-,-,72338
55,35,20,-,-,72339
30,22,8,-,57900,72340
87,70,17,708,61700,72341
1934,711,1223,549,94700,72342
299,225,74,1035,39600,72346
319,213,106,311,39500,72347
1057,624,433,442,84400,72348
492,293,199,619,48400,72350
205,118,87,625,69500,72351
14,14,0,-,-,72353
895,502,393,522,62600,72354
1005,729,276,675,65600,72355
443,199,244,568,45400,72358
215,103,112,437,26500,72359
2654,1377,1277,516,71000,72360
5448,3700,1748,805,151100,72364
1227,740,487,466,64400,72365
840,395,445,615,43500,72366
27,0,27,-,-,72367
505,364,141,524,57000,72368
3314,1469,1845,624,76800,72370
828,569,259,670,65000,72372
552,316,236,437,52500,72373
380,287,93,-,63000,72374
683,522,161,685,66300,72376
13,0,13,-,-,72377
16,16,0,-,-,72379
69,69,0,-,-,72383
351,164,187,473,56700,72384
738,508,230,540,54800,72386
118,67,51,318,86100,72389
3201,1335,1866,583,70700,72390
221,179,42,388,52900,72392
257,148,109,499,50000,72394
467,277,190,492,84700,72395
4874,3301,1573,700,85700,72396
21740,11158,10582,730,133400,72401
10284,6740,3544,772,166700,72404
157,113,44,554,53100,72410
869,576,293,689,83700,72411
259,195,64,-,89300,72412
214,161,53,585,48300,72413
132,86,46,443,85000,72414
496,380,116,532,75700,72415
2077,1481,596,625,116200,72416
1920,1321,599,771,117100,72417
569,358,211,515,51400,72419
252,138,114,650,70000,72421
1997,1288,709,505,64100,72422
23,18,5,669,34000,72424
143,125,18,-,45200,72425
80,51,29,655,88300,72426
87,48,39,581,65600,72427
25,15,10,833,-,72428
170,112,58,491,52500,72429
130,111,19,925,60500,72430
186,125,61,528,47800,72431
2431,1750,681,615,86300,72432
1332,827,505,476,64000,72433
802,650,152,450,76900,72434
190,157,33,435,47600,72435
327,289,38,775,74900,72436
1378,961,417,819,74800,72437
963,594,369,482,56500,72438
105,66,39,489,75000,72440
46,36,10,-,-,72441
1787,1075,712,570,89400,72442
1214,918,296,638,69500,72443
780,584,196,517,84000,72444
33,25,8,-,56800,72445
822,574,248,479,79900,72447
91,69,22,715,29900,72449
14571,9559,5012,717,115900,72450
74,62,12,700,46700,72453
2136,1516,620,623,83500,72454
5169,3579,1590,592,86000,72455
208,144,64,684,49200,72456
66,42,24,479,75700,72457
313,282,31,-,100400,72458
618,501,117,492,89300,72459
301,261,40,500,59000,72460
1534,1146,388,535,73700,72461
178,95,83,367,51000,72462
23,15,8,425,-,72464
639,441,198,428,65400,72466
0,0,0,-,-,72467
414,324,90,500,80000,72469
82,56,26,-,47500,72470
458,345,113,557,58400,72471
3648,2325,1323,592,83700,72472
1006,761,245,587,65100,72473
2419,1419,1000,576,84000,72476
154,139,15,-,84800,72478
611,408,203,609,59600,72479
505,451,54,484,69200,72482
10026,6937,3089,623,113500,72501
1103,818,285,672,65800,72512
1067,838,229,448,88900,72513
0,0,0,-,-,72515
163,131,32,-,-,72517
1096,804,292,571,80000,72519
78,60,18,-,-,72520
2035,1323,712,549,80200,72521
192,168,24,-,74800,72522
510,361,149,544,65500,72523
119,72,47,-,107400,72524
72,58,14,606,-,72526
170,170,0,-,131700,72527
7,7,0,-,-,72528
2033,1555,478,714,77300,72529
674,557,117,538,107200,72530
503,478,25,-,128100,72531
586,421,165,434,76900,72532
209,195,14,467,75200,72533
558,491,67,451,93200,72534
193,171,22,480,76900,72536
325,275,50,790,113200,72537
139,117,22,-,136000,72538
66,66,0,-,-,72539
118,90,28,625,-,72540
1832,1545,287,536,99700,72542
5081,3513,1568,672,138500,72543
228,195,33,-,102500,72544
60,42,18,-,-,72546
275,205,70,-,116400,72550
19,17,2,-,-,72553
1157,827,330,463,106200,72554
48,48,0,-,-,72555
1252,990,262,556,82000,72556
3710,2772,938,585,124100,72560
304,255,49,650,109000,72561
940,633,307,648,85900,72562
235,140,95,-,65300,72564
250,198,52,575,84300,72565
244,238,6,-,62900,72566
89,63,26,-,77700,72567
502,381,121,1052,58300,72568
109,76,33,-,81200,72569
96,96,0,-,138300,72571
52,52,0,-,-,72572
93,60,33,-,-,72573
1820,1310,510,490,86800,72576
224,180,44,381,102100,72577
26,26,0,-,-,72578
483,309,174,631,90900,72579
479,409,70,-,120100,72581
711,535,176,538,76500,72583
266,249,17,-,82400,72584
113,113,0,-,-,72585
33,16,17,-,-,72587
12021,8341,3680,629,115300,72601
545,404,141,529,110900,72611
3676,2877,799,576,112400,72616
92,38,54,427,152800,72617
952,721,231,529,124200,72619
359,342,17,-,94400,72623
152,146,6,-,116900,72624
580,458,122,576,151900,72626
351,303,48,506,82300,72628
213,175,38,664,76700,72629
109,94,15,446,90000,72630
1929,1638,291,750,172600,72631
1933,1495,438,634,155100,72632
637,595,42,625,110800,72633
1725,1246,479,540,114900,72634
1444,1057,387,698,103900,72635
10,10,0,-,225000,72636
2769,1987,782,559,87500,72638
241,187,54,-,85100,72639
90,77,13,-,-,72640
1098,875,223,394,103500,72641
1008,817,191,736,129400,72642
1186,971,215,657,116700,72644
844,644,200,515,96500,72645
222,208,14,-,204400,72648
1793,1407,386,513,90600,72650
600,413,187,544,83700,72651
12620,9314,3306,669,131800,72653
165,151,14,-,73100,72655
753,583,170,643,120900,72658
261,203,58,650,88700,72660
243,185,58,-,-,72661
1061,906,155,711,118000,72662
89,61,28,-,122700,72663
92,92,0,-,165000,72666
181,181,0,-,219900,72668
22,20,2,-,-,72669
52,52,0,-,427800,72670
101,70,31,575,53300,72672
562,490,72,499,71800,72675
170,96,74,508,70000,72677
22,22,0,-,-,72679
312,278,34,584,84400,72680
177,171,6,-,74200,72682
151,110,41,-,61900,72683
486,405,81,655,80600,72685
43,43,0,-,-,72686
2453,1915,538,640,121000,72687
16254,6723,9531,739,198900,72701
14573,5974,8599,702,209200,72703
9861,5770,4091,904,174300,72704
18289,10723,7566,881,215100,72712
5026,4294,732,975,150700,72714
7340,6332,1008,889,160900,72715
349,302,47,-,150000,72717
907,839,68,674,263100,72718
3842,2134,1708,998,144500,72719
178,117,61,-,57600,72721
1276,871,405,650,111100,72722
1979,1525,454,862,126200,72727
83,83,0,-,137500,72729
3256,1986,1270,873,162600,72730
1772,1520,252,714,162400,72732
2904,1944,960,753,138900,72734
2308,1711,597,813,161400,72736
862,718,144,969,116300,72738
193,137,56,742,156300,72739
3540,2546,994,616,106400,72740
291,222,69,-,135600,72742
2059,1437,622,556,107200,72744
4580,3018,1562,757,149900,72745
69,59,10,-,"10,000-",72747
29,22,7,-,-,72749
2374,1952,422,1023,126500,72751
148,148,0,-,52200,72752
3354,2563,791,763,151600,72753
15270,9352,5918,707,141000,72756
14017,8730,5287,939,198800,72758
145,131,14,-,-,72760
7549,4502,3047,706,138700,72761
14461,9336,5125,827,163800,72762
17798,8471,9327,687,142100,72764
372,282,90,642,86100,72768
273,204,69,-,87500,72769
401,361,40,-,101400,72773
2318,1896,422,641,146700,72774
342,300,42,-,124100,72776
6735,2287,4448,641,110300,72801
7963,6409,1554,728,156500,72802
896,628,268,590,69800,72821
2407,1835,572,668,88400,72823
588,447,141,723,83000,72824
19,15,4,-,-,72826
75,75,0,-,-,72827
20,20,0,-,-,72828
5706,3703,2003,611,101100,72830
410,282,128,463,69200,72832
1305,891,414,507,113500,72833
3714,2645,1069,630,119500,72834
303,248,55,-,78600,72835
2674,2289,385,564,111400,72837
47,47,0,-,60900,72838
166,116,50,-,65700,72839
868,718,150,688,75000,72840
58,49,9,-,-,72841
453,324,129,676,73500,72842
987,819,168,581,88300,72843
519,475,44,610,117700,72845
1436,1131,305,537,100200,72846
1094,815,279,809,97700,72847
281,242,39,793,82500,72851
60,49,11,-,53100,72852
801,521,280,533,69400,72853
349,270,79,670,79200,72854
2397,1697,700,501,87000,72855
152,131,21,-,78800,72856
557,423,134,545,88800,72857
1551,1249,302,541,118900,72858
273,204,69,-,-,72860
636,549,87,710,103300,72863
454,392,62,616,107100,72865
9011,3534,5477,562,91700,72901
11269,5431,5838,647,159100,72903
7879,4413,3466,640,75000,72904
5398,3384,2014,804,138200,72908
3200,2487,713,817,196600,72916
5436,4312,1124,632,142400,72921
1838,1077,761,839,97500,72923
281,203,78,614,79000,72926
3187,2166,1021,567,94800,72927
240,216,24,625,106300,72928
140,102,38,-,46700,72930
708,599,109,636,87900,72932
2044,1622,422,628,90600,72933
319,285,34,480,111000,72934
162,107,55,542,74300,72935
5401,4421,980,716,124000,72936
1394,1177,217,717,86200,72937
552,486,66,725,101400,72938
1014,900,114,595,79600,72940
2050,1624,426,728,110000,72941
916,659,257,593,78900,72943
1171,958,213,691,95900,72944
103,71,32,515,63800,72945
1535,1385,150,558,87200,72946
1758,1465,293,567,84700,72947
125,125,0,-,86400,72948
3592,2577,1015,596,101800,72949
90,82,8,-,133300,72950
428,316,112,581,86800,72951
1052,855,197,727,107600,72952
138,84,54,-,84700,72955
13079,9241,3838,696,111800,72956
2770,1981,789,486,68500,72958
1031,923,108,-,138600,72959
358,284,74,546,68500,73002
8878,5251,3627,1045,163900,73003
354,295,59,663,115600,73004
3183,1980,1203,562,71800,73005
1252,964,288,677,84600,73006
915,831,84,1565,371200,73007
7938,4514,3424,784,117800,73008
506,367,139,538,84100,73009
6589,5569,1020,774,160900,73010
148,110,38,638,50600,73011
11947,10188,1759,1598,217400,73012
18758,14662,4096,1115,205700,73013
661,509,152,788,110400,73014
1070,734,336,497,61000,73015
636,563,73,846,157800,73016
650,533,117,513,78900,73017
7795,5029,2766,673,86500,73018
0,0,0,-,-,73019
8511,7213,1298,928,171400,73020
107,104,3,-,90600,73021
273,197,76,722,89400,73024
3717,3579,138,758,321700,73025
3890,3513,377,861,171600,73026
495,413,82,653,115300,73027
1471,1188,283,778,98300,73028
641,480,161,472,92100,73029
1631,1089,542,684,114300,73030
124,101,23,550,80800,73032
140,92,48,675,63800,73033
16347,11584,4763,833,259200,73034
6606,4233,2373,722,111900,73036
738,590,148,493,80000,73038
710,446,264,534,75700,73040
122,89,33,563,52500,73041
433,329,104,631,84000,73042
86,81,5,-,55400,73043
8180,5865,2315,753,137400,73044
4032,3193,839,808,150600,73045
1470,1115,355,707,104600,73047
897,688,209,659,86500,73048
2230,1838,392,687,145700,73049
39,10,29,558,-,73050
2867,2224,643,756,113800,73051
2609,1921,688,687,89900,73052
279,204,75,531,103600,73053
1440,1189,251,771,142400,73054
3942,3041,901,625,113400,73055
158,139,19,564,59600,73056
930,642,288,609,85500,73057
83,68,15,-,96700,73058
1107,909,198,691,102900,73059
632,498,134,707,110200,73061
594,477,117,427,54000,73062
245,211,34,680,97500,73063
8079,6465,1614,955,154800,73064
2996,2499,497,646,178700,73065
122,86,36,515,77500,73066
876,689,187,638,96600,73067
4415,3196,1219,873,109600,73068
10044,4894,5150,776,146700,73069
16297,7494,8803,852,141300,73071
16827,10051,6776,855,205900,73072
213,180,33,850,135700,73073
404,279,125,592,88100,73074
3473,2137,1336,635,102100,73075
2866,2063,803,751,92100,73077
3099,2926,173,882,203500,73078
193,147,46,625,98600,73079
3641,2497,1144,726,152400,73080
1092,824,268,542,71200,73082
2811,1988,823,573,76400,73084
3250,2250,1000,670,108800,73086
4122,3641,481,778,175800,73089
367,298,69,671,138800,73090
366,274,92,696,66800,73092
966,815,151,721,176100,73093
748,553,195,583,112500,73095
5141,2592,2549,693,159000,73096
51,34,17,-,-,73097
1717,1187,530,597,94100,73098
22303,16801,5502,1043,158900,73099
1117,106,1011,1110,117600,73102
2543,899,1644,778,199700,73103
1186,266,920,1138,245000,73104
2745,1138,1607,897,101800,73105
4449,1776,2673,695,97000,73106
10611,5613,4998,795,95600,73107
4668,1595,3073,605,49100,73108
7017,3122,3895,648,71200,73109
14097,6620,7477,800,89300,73110
4732,2350,2382,707,69300,73111
14539,7433,7106,770,118200,73112
7609,2750,4859,838,85200,73114
8528,4996,3532,840,80700,73115
4416,3106,1310,931,216300,73116
2438,992,1446,523,74300,73117
6339,3548,2791,859,151400,73118
9700,4866,4834,764,62500,73119
17571,9256,8315,807,161500,73120
1321,991,330,924,171100,73121
5065,2969,2096,713,115000,73122
9122,4400,4722,699,111100,73127
1582,1195,387,1214,145300,73128
6153,3247,2906,712,49600,73129
8070,6164,1906,945,130100,73130
1306,973,333,1081,251200,73131
10790,6144,4646,793,153200,73132
2397,627,1770,970,254700,73134
7943,4336,3607,995,138100,73135
7519,3215,4304,756,115800,73139
1047,636,411,749,79600,73141
6178,3390,2788,943,218900,73142
540,0,540,1228,-,73145
1923,975,948,793,60200,73149
1649,1533,116,867,224800,73150
572,553,19,-,423000,73151
12187,7558,4629,861,106300,73159
22339,14431,7908,936,134900,73160
11766,8352,3414,929,174500,73162
2241,2159,82,911,202900,73165
755,596,159,966,139500,73169
14005,11395,2610,1234,187200,73170
786,762,24,-,292600,73173
1502,1341,161,1381,196600,73179
13601,8987,4614,741,121800,73401
28,28,0,-,35000,73425
419,385,34,-,114700,73430
430,310,120,656,110600,73432
1078,863,215,629,103600,73433
187,150,37,729,89200,73434
36,30,6,-,55700,73437
1404,1032,372,565,71900,73438
3186,2557,629,659,91000,73439
155,101,54,480,84100,73440
65,56,9,725,52500,73441
153,136,17,-,73300,73442
1448,1130,318,630,106500,73443
63,22,41,-,-,73444
2900,2057,843,655,83200,73446
441,355,86,727,73900,73447
1926,1448,478,673,90800,73448
1102,829,273,603,84100,73449
492,408,84,765,88800,73450
206,166,40,844,172300,73453
218,171,47,744,55600,73455
798,621,177,529,66600,73456
332,248,84,675,104000,73458
326,254,72,775,104300,73459
1953,1205,748,495,77400,73460
267,214,53,592,98300,73461
1134,939,195,629,78500,73463
365,312,53,575,66900,73481
78,67,11,725,36900,73487
271,206,65,589,75200,73491
7042,2915,4127,694,98300,73501
1559,4,1555,1246,-,73503
18690,10062,8628,781,129500,73505
8645,4696,3949,842,130500,73507
68,49,19,525,81300,73520
8157,4322,3835,708,104900,73521
901,692,209,652,124100,73526
1784,1427,357,684,152400,73527
206,160,46,689,72700,73528
2155,1677,478,654,79800,73529
183,155,28,500,52900,73530
173,131,42,888,84300,73531
195,129,66,513,102300,73532
10818,7332,3486,695,110600,73533
260,196,64,488,43100,73537
2088,1560,528,1135,180300,73538
102,97,5,-,69500,73539
178,140,38,717,88700,73540
972,763,209,729,122100,73541
1671,1288,383,611,50200,73542
576,410,166,626,102800,73543
108,83,25,450,55000,73544
480,328,152,600,57100,73546
656,451,205,387,59600,73547
193,187,6,-,102500,73548
75,60,15,-,83000,73549
1020,743,277,522,49000,73550
21,21,0,-,-,73551
524,426,98,700,117300,73552
33,33,0,-,184400,73553
1344,1012,332,576,65700,73554
76,62,14,-,43000,73555
62,50,12,483,66700,73556
181,154,27,-,166700,73557
222,165,57,444,36800,73559
247,183,64,543,69000,73560
253,198,55,596,84400,73562
251,194,57,270,75900,73564
384,287,97,450,58800,73565
758,493,265,529,69000,73566
263,176,87,477,74700,73567
410,334,76,638,33900,73568
222,156,66,442,44800,73569
489,382,107,519,61800,73570
49,31,18,-,-,73571
1377,1059,318,586,84600,73572
950,632,318,534,60800,73573
3573,2193,1380,744,104500,73601
350,299,51,599,119600,73620
84,61,23,-,75900,73622
762,398,364,686,79800,73624
275,236,39,911,93600,73625
385,303,82,923,82300,73626
163,111,52,675,78200,73627
550,401,149,525,95800,73628
1495,1078,417,586,78000,73632
107,64,43,-,235900,73638
229,185,44,577,83800,73639
232,207,25,500,49800,73641
68,54,14,-,121400,73642
4962,3294,1668,803,137500,73644
538,350,188,643,66700,73645
208,149,59,344,57900,73646
250,209,41,381,89900,73647
324,248,76,563,81300,73650
1674,1058,616,647,64000,73651
268,191,77,779,107300,73654
332,281,51,484,62300,73655
73,71,2,-,64400,73658
76,63,13,481,-,73659
162,125,37,-,72300,73660
168,144,24,800,92000,73661
2047,1316,731,450,88000,73662
420,316,104,675,99000,73663
456,332,124,519,61200,73664
80,48,32,-,90000,73666
258,179,79,620,83800,73667
704,539,165,547,90200,73669
119,79,40,920,59100,73673
8335,5229,3106,757,67200,73701
12377,7868,4509,876,139400,73703
0,0,0,-,-,73705
223,202,21,483,135400,73716
2557,1637,920,657,95500,73717
248,217,31,760,93700,73718
19,19,0,-,-,73719
68,57,11,-,92500,73720
196,149,47,725,154000,73722
449,382,67,572,67400,73724
224,178,46,654,52000,73726
97,86,11,-,167700,73727
763,546,217,679,70500,73728
251,215,36,683,85000,73729
265,202,63,563,75300,73730
46,45,1,-,58100,73731
120,112,8,-,122200,73733
323,244,79,831,79200,73734
255,217,38,675,108200,73735
194,158,36,-,78700,73736
1368,1008,360,665,81200,73737
486,356,130,550,61400,73738
157,153,4,-,79300,73739
299,215,84,752,84100,73741
1463,1148,315,665,122600,73742
60,45,15,660,81000,73743
92,74,18,-,76300,73744
7,7,0,-,-,73746
156,71,85,663,99400,73747
187,141,46,648,64100,73749
2796,2237,559,725,141300,73750
151,138,13,450,97500,73753
438,372,66,838,101700,73754
427,325,102,492,72000,73755
100,86,14,688,130800,73756
85,75,10,-,137500,73757
40,32,8,-,-,73758
686,509,177,614,79000,73759
147,133,14,775,110300,73760
175,148,27,-,78100,73761
744,635,109,920,168000,73762
798,637,161,556,80300,73763
45,29,16,-,112500,73764
470,317,153,750,86300,73766
579,482,97,659,111200,73768
214,164,50,500,44600,73771
1203,913,290,509,96600,73772
769,578,191,749,81700,73773
5558,3794,1764,769,127100,73801
405,353,52,538,90500,73832
625,484,141,600,69800,73834
88,70,18,829,95000,73835
154,133,21,650,88400,73838
275,194,81,840,86400,73840
195,154,41,1010,86900,73841
194,166,28,384,116700,73842
336,245,91,705,73400,73843
95,68,27,371,108000,73844
777,650,127,653,84600,73848
47,43,4,-,135400,73851
951,772,179,709,114200,73852
238,197,41,675,143100,73853
40,39,1,-,84400,73855
285,238,47,1575,132700,73857
620,410,210,633,80900,73858
553,371,182,632,101000,73859
622,425,197,605,73700,73860
41,32,9,-,83300,73901
215,166,49,911,111500,73931
868,611,257,645,103800,73932
686,510,176,453,59700,73933
101,64,37,663,60000,73937
296,257,39,694,76100,73938
504,248,256,610,90000,73939
4501,2791,1710,738,133500,73942
158,95,63,625,78300,73944
989,781,208,664,86500,73945
23,23,0,-,53200,73946
162,113,49,393,45000,73947
550,399,151,596,81500,73949
510,423,87,713,114500,73950
372,306,66,783,65000,73951
132,109,23,567,55600,74001
813,638,175,609,71200,74002
5751,3322,2429,657,76600,74003
10803,7858,2945,729,137900,74006
9581,7430,2151,897,198600,74008
3975,2822,1153,619,104100,74010
10148,8387,1761,1081,162600,74011
22435,15201,7234,985,160800,74012
13484,11751,1733,1129,168100,74014
3444,2403,1041,860,140800,74015
2264,1733,531,613,91600,74016
11150,7630,3520,823,129400,74017
6853,5609,1244,791,161200,74019
2821,2046,775,716,91500,74020
7116,5872,1244,934,155600,74021
719,625,94,713,97700,74022
4133,2759,1374,679,94900,74023
348,249,99,638,57200,74026
404,308,96,625,70900,74027
624,517,107,609,81200,74028
1986,1507,479,603,84100,74029
1551,1068,483,503,78100,74030
818,655,163,689,110200,74032
3935,3037,898,926,130300,74033
50,34,16,742,41400,74034
1330,947,383,530,69700,74035
2667,2202,465,738,127300,74036
6252,4846,1406,1147,187300,74037
786,679,107,596,88300,74038
1364,1124,240,705,89900,74039
964,757,207,816,141200,74041
166,112,54,660,58300,74042
2742,2257,485,756,112100,74044
133,107,26,831,62300,74045
37,27,10,413,87200,74046
2493,2055,438,770,123800,74047
2389,1736,653,633,80100,74048
148,87,61,623,43000,74050
719,656,63,750,106100,74051
439,306,133,669,55700,74052
1648,1376,272,779,146200,74053
289,254,35,494,45500,74054
16469,12191,4278,954,183400,74055
2205,1446,759,624,72700,74056
1505,1059,446,628,92700,74058
2069,1367,702,703,123800,74059
199,151,48,675,64600,74060
786,624,162,705,112700,74061
366,296,70,674,91600,74062
12223,9544,2679,782,120500,74063
11983,8551,3432,841,123100,74066
10,6,4,-,-,74068
5431,4071,1360,842,132400,74070
64,56,8,-,60000,74071
728,591,137,665,90200,74072
2159,1718,441,841,136000,74073
11638,5469,6169,867,189000,74074
10818,4069,6749,716,148400,74075
0,0,0,-,-,74078
1578,1092,486,645,96200,74079
1033,791,242,807,149200,74080
723,665,58,758,81300,74081
30,23,7,1042,63800,74082
397,314,83,536,103400,74083
222,174,48,555,55000,74084
956,750,206,639,73300,74085
252,4,248,1634,-,74103
5412,2417,2995,830,151000,74104
12369,6747,5622,733,201900,74105
7116,3152,3964,588,64200,74106
8118,4222,3896,731,86100,74107
2699,1688,1011,886,86600,74108
4969,2355,2614,731,51600,74110
9205,4922,4283,797,101500,74112
7274,5592,1682,1000,164000,74114
8119,4177,3942,825,60900,74115
1493,648,845,709,95000,74116
34,28,6,-,185900,74117
2401,576,1825,778,127100,74119
2347,885,1462,695,257300,74120
3667,2136,1531,752,48600,74126
6654,3766,2888,757,82000,74127
4505,2883,1622,816,82800,74128
7156,3449,3707,745,104900,74129
736,510,226,803,52400,74130
1143,927,216,819,150100,74131
3490,2248,1242,919,162700,74132
19294,10112,9182,888,181000,74133
6156,3461,2695,764,119300,74134
9758,4891,4867,729,164300,74135
13827,4855,8972,728,214100,74136
10818,7405,3413,930,285400,74137
7547,3894,3653,834,121500,74145
5629,1968,3661,650,89400,74146
4352,3188,1164,685,101000,74301
1154,806,348,731,118100,74330
3007,2338,669,707,121900,74331
650,530,120,950,109800,74332
388,311,77,682,89800,74333
1948,1549,399,719,104100,74337
1951,1483,468,651,84100,74338
873,582,291,576,57100,74339
113,87,26,750,76400,74340
1147,841,306,570,74300,74342
1208,910,298,627,88800,74343
6667,4982,1685,688,140700,74344
2687,1934,753,574,97900,74346
894,702,192,622,76600,74347
131,77,54,555,72500,74349
315,229,86,647,91300,74350
2455,1935,520,612,90200,74352
6930,4442,2488,697,89000,74354
87,61,26,608,60500,74358
186,146,40,567,68300,74359
8,5,3,-,-,74360
6447,4295,2152,695,120400,74361
1036,811,225,693,78200,74363
617,532,85,497,99300,74364
1690,1264,426,685,92000,74365
568,498,70,514,75000,74366
181,130,51,605,69400,74367
35,32,3,-,57800,74368
762,618,144,648,96700,74369
1367,1125,242,622,96000,74370
6481,3744,2737,632,89000,74401
12001,7765,4236,676,98300,74403
1738,1412,326,700,108000,74421
249,222,27,738,85000,74422
358,280,78,550,95000,74423
486,403,83,547,103700,74425
3959,3110,849,620,96000,74426
437,409,28,-,127700,74427
525,433,92,521,143600,74428
5381,4246,1135,793,150600,74429
180,143,37,690,92500,74430
316,246,70,669,61300,74431
4275,3361,914,528,88300,74432
3327,2644,683,644,142800,74434
1292,1038,254,575,82400,74435
1745,1364,381,735,109700,74436
3920,2857,1063,583,74500,74437
45,38,7,617,33600,74438
1919,1607,312,512,93900,74441
371,325,46,675,73800,74442
1220,894,326,708,114600,74445
203,140,63,670,85000,74446
6405,3970,2435,615,71600,74447
706,628,78,740,87900,74450
1398,1092,306,617,129700,74451
129,99,30,654,120800,74452
1248,1014,234,732,88400,74454
1315,1088,227,542,73300,74455
94,72,22,529,80000,74456
182,148,34,770,100000,74457
30,19,11,-,-,74458
51,48,3,-,105000,74459
76,58,18,517,50000,74460
3001,2197,804,580,86800,74462
95,53,42,631,85800,74463
10665,6089,4576,627,114300,74464
6073,4105,1968,721,100200,74467
110,98,12,875,87500,74468
800,506,294,614,89600,74469
658,544,114,535,75500,74470
569,455,114,534,84500,74471
237,200,37,810,86300,74472
0,0,0,-,-,74477
10885,7582,3303,706,110800,74501
82,57,25,550,66300,74521
109,93,16,1047,85000,74522
2408,1691,717,499,68600,74523
3762,2657,1105,565,99300,74525
74,54,20,442,50000,74528
78,70,8,-,55000,74530
344,282,62,700,85800,74531
316,222,94,675,88000,74533
71,62,9,538,127800,74534
45,34,11,-,115900,74535
659,457,202,530,80800,74536
1616,1097,519,618,96800,74538
88,75,13,400,123200,74540
167,128,39,-,93300,74543
295,215,80,561,51000,74546
1384,975,409,637,85800,74547
31,25,6,-,56400,74549
489,387,102,540,87900,74552
502,382,120,573,81900,74553
780,451,329,718,89800,74554
316,239,77,519,85800,74555
147,119,28,467,62500,74556
192,159,33,725,83100,74557
177,150,27,388,79400,74558
228,166,62,744,73800,74560
821,646,175,475,86900,74561
376,301,75,363,69500,74562
771,646,125,578,78600,74563
281,220,61,696,79200,74565
62,59,3,-,98300,74567
269,225,44,639,90600,74569
406,290,116,867,79500,74570
1362,938,424,468,74500,74571
261,203,58,617,65300,74572
442,365,77,563,86400,74574
52,42,10,-,-,74576
79,55,24,507,74200,74577
2403,1525,878,570,80900,74578
7387,4363,3024,665,68300,74601
5053,4147,906,650,134500,74604
267,145,122,599,77500,74630
3122,2277,845,700,56800,74631
235,202,33,575,83300,74632
146,138,8,520,58900,74633
118,95,23,-,92500,74636
748,614,134,466,39200,74637
114,89,25,688,86300,74640
305,274,31,650,92400,74641
178,158,20,397,52000,74643
205,141,64,604,56400,74644
83,83,0,-,-,74646
1409,1042,367,595,86900,74647
259,203,56,589,45000,74650
279,195,84,393,43200,74651
318,260,58,375,44400,74652
1470,974,496,595,72500,74653
9284,5000,4284,718,119300,74701
200,168,32,575,52500,74720
80,65,15,-,70700,74722
556,407,149,539,105800,74723
128,99,29,-,55500,74724
923,680,243,632,82400,74726
806,545,261,542,76300,74727
4297,2860,1437,583,85300,74728
1127,851,276,710,91600,74729
1682,1196,486,744,97100,74730
630,464,166,656,74800,74731
1107,835,272,644,85300,74733
458,356,102,542,87500,74734
598,478,120,622,83300,74735
396,321,75,564,91700,74736
255,207,48,532,55700,74738
936,763,173,550,68900,74740
400,311,89,729,92800,74741
3292,2034,1258,538,98400,74743
3993,2412,1581,592,83000,74745
66,57,9,563,68100,74747
244,226,18,755,73000,74748
137,109,28,621,66300,74750
30,30,0,-,-,74753
154,124,30,343,-,74754
37,37,0,-,-,74755
284,245,39,705,107900,74756
545,459,86,600,84900,74759
133,102,31,481,133300,74760
36,23,13,450,71300,74761
1498,1176,322,620,72300,74764
588,476,112,475,56300,74766
8382,4897,3485,647,89300,74801
7691,5216,2475,687,137400,74804
12029,7284,4745,660,125100,74820
484,406,78,728,99100,74824
800,636,164,617,93900,74825
418,326,92,639,71500,74826
155,118,37,579,85700,74827
197,146,51,513,63900,74829
85,65,20,625,34700,74830
318,250,68,497,97500,74831
316,245,71,556,93600,74832
297,242,55,530,85800,74833
2843,2255,588,596,124900,74834
60,28,32,-,105600,74836
91,73,18,625,47500,74837
246,182,64,525,59600,74839
651,510,141,736,97100,74840
40,36,4,-,88000,74842
132,111,21,713,124400,74843
128,81,47,717,77000,74844
183,146,37,-,67100,74845
2339,1730,609,557,70000,74848
1141,763,378,528,74600,74849
117,102,15,-,64000,74850
3175,2599,576,674,116300,74851
554,429,125,873,88400,74852
685,542,143,433,59800,74854
1863,1541,322,641,111800,74855
321,232,89,709,79400,74856
3181,2841,340,650,122400,74857
2225,1518,707,554,83900,74859
577,475,102,566,90600,74860
1953,1436,517,659,134900,74864
632,504,128,690,113800,74865
348,255,93,425,66800,74867
4846,3429,1417,627,80200,74868
299,257,42,934,90600,74869
898,749,149,563,108800,74871
1218,853,365,550,91500,74872
4292,3246,1046,736,93700,74873
453,404,49,736,84800,74875
550,468,82,711,83200,74878
762,595,167,538,66600,74880
1800,1499,301,678,85500,74881
835,572,263,538,59700,74883
2212,1509,703,549,61500,74884
776,481,295,567,71700,74901
1503,1146,357,715,96400,74902
771,653,118,725,80600,74930
453,394,59,725,79500,74931
922,676,246,689,92900,74932
68,50,18,608,28000,74935
388,287,101,695,85700,74936
1950,1368,582,561,58600,74937
259,197,62,544,76800,74939
923,730,193,646,94500,74940
1004,742,262,610,83900,74941
53,39,14,525,87500,74942
44,35,9,-,77900,74943
410,308,102,542,71200,74944
167,123,44,642,68800,74945
57,17,40,496,31500,74946
4331,3392,939,669,96900,74948
131,111,20,400,71400,74949
539,363,176,649,54100,74951
4404,3043,1361,622,124100,74953
1762,1032,730,722,95700,74954
5694,3740,1954,635,100700,74955
628,426,202,657,85600,74956
454,382,72,558,75600,74957
2738,1976,762,628,84200,74959
4698,3162,1536,538,81000,74960
1837,1432,405,653,78400,74962
200,190,10,-,70000,74963
1011,758,253,639,79100,74964
1773,1249,524,565,83100,74965
1437,1229,208,569,112000,74966
8287,1495,6792,1218,303500,75001
22029,17350,4679,1366,229800,75002
17780,9279,8501,1051,167000,75006
19109,14059,5050,1159,200600,75007
3532,2830,702,1335,270200,75009
11083,4889,6194,1184,247800,75010
12894,9747,3147,1388,375700,75013
15346,10815,4531,1285,344200,75019
8811,5654,3157,777,97000,75020
3242,2501,741,736,99100,75021
7587,7210,377,2208,378400,75022
18298,11614,6684,1361,212000,75023
17692,7694,9998,1255,356600,75024
19007,13441,5566,1328,308400,75025
15966,13302,2664,1671,271500,75028
10703,8846,1857,1243,272600,75032
33152,23494,9658,1232,358600,75034
21127,16843,4284,1698,290800,75035
12389,1913,10476,971,206900,75038
8849,1647,7202,1359,439800,75039
18499,13300,5199,1099,123700,75040
9708,5673,4035,921,106100,75041
11623,5843,5780,860,116300,75042
20860,11969,8891,1022,142100,75043
15167,10174,4993,1183,166500,75044
7522,6557,965,1227,197900,75048
14640,6312,8328,958,107100,75050
12709,6011,6698,876,94300,75051
29494,22150,7344,1197,149900,75052
3114,2757,357,2091,278700,75054
20777,13387,7390,1296,217100,75056
5035,1755,3280,1128,117100,75057
864,677,187,977,216300,75058
14295,8921,5374,886,115900,75060
17456,6683,10773,864,127500,75061
16248,6918,9330,935,134400,75062
15743,6352,9391,1141,322000,75063
4586,3519,1067,1182,172700,75065
24913,9557,15356,1082,170900,75067
17670,13751,3919,1498,209900,75068
13681,7089,6592,971,238700,75069
32577,23917,8660,1433,269600,75070
15980,11373,4607,1455,252400,75071
16430,9593,6837,1168,173000,75074
14081,9197,4884,1152,223400,75075
3043,2285,758,863,135600,75076
12966,10395,2571,1404,253500,75077
6111,5374,737,1256,409500,75078
18553,10148,8405,1215,225800,75080
14482,8192,6290,1227,185400,75081
8956,6565,2391,1367,289500,75082
11417,8894,2523,1278,241400,75087
8842,7578,1264,1430,179700,75088
10638,9490,1148,1562,182500,75089
8052,4955,3097,835,82900,75090
9901,5426,4475,826,143400,75092
19443,12348,7095,1261,408600,75093
6123,5171,952,2165,318700,75094
16866,13494,3372,1335,178600,75098
215,154,61,878,69400,75101
480,398,82,976,85000,75102
5163,4091,1072,907,120700,75103
15937,11146,4791,1277,147000,75104
89,84,5,-,106300,75105
1563,1322,241,1101,125800,75109
10128,6268,3860,758,90300,75110
1915,1534,381,1171,118100,75114
19109,12019,7090,1068,155300,75115
6507,3794,2713,956,119800,75116
1583,1176,407,724,119900,75117
9150,5840,3310,846,115500,75119
1617,1198,419,646,112500,75124
2083,1606,477,944,80400,75125
12527,11072,1455,1272,186200,75126
609,452,157,699,98800,75127
570,533,37,-,148600,75132
6999,4064,2935,951,112000,75134
2166,1792,374,929,143100,75135
6826,4827,1999,1185,137900,75137
2224,1562,662,691,102900,75140
1203,805,398,919,80700,75141
5959,4398,1561,865,107500,75142
5479,4172,1307,823,93600,75143
1307,889,418,730,84600,75144
6617,4220,2397,996,111500,75146
2294,1599,695,693,101000,75147
2140,1478,662,740,74300,75148
17834,10901,6933,992,103500,75149
21391,9789,11602,997,112800,75150
1497,1205,292,982,108400,75152
141,130,11,-,66600,75153
12436,9558,2878,1106,158600,75154
883,718,165,784,81800,75155
6255,4913,1342,792,98400,75156
94,73,21,838,68300,75157
1388,1229,159,1021,153600,75158
5470,4008,1462,878,95000,75159
8282,5065,3217,893,120400,75160
2127,1688,439,980,114500,75161
1072,787,285,1002,79900,75163
263,194,69,1096,106900,75164
14793,9081,5712,989,148300,75165
1258,1093,165,1642,217000,75166
3325,3039,286,1403,202100,75167
4738,3739,999,720,94400,75169
1117,619,498,816,59000,75172
1501,1307,194,1091,167900,75173
6251,3750,2501,919,83800,75180
7989,6713,1276,1646,155200,75181
1793,1725,68,2220,348000,75182
8113,6787,1326,1214,172600,75189
9080,933,8147,1611,448700,75201
1297,258,1039,1484,233500,75202
6248,1831,4417,762,78900,75203
16749,3432,13317,1376,317800,75204
9061,5736,3325,1379,1136900,75205
20424,5286,15138,1187,362100,75206
1433,0,1433,1522,-,75207
10166,5540,4626,898,193500,75208
6615,3868,2747,1234,581300,75209
2823,727,2096,688,63300,75210
21552,10698,10854,852,94500,75211
7441,3993,3448,621,83600,75212
15841,8795,7046,1070,430900,75214
6192,2195,3997,762,66600,75215
17828,9093,8735,785,61400,75216
23352,14262,9090,870,77100,75217
10421,6855,3566,1062,276500,75218
13990,4893,9097,1226,276100,75219
14324,4478,9846,788,218900,75220
4616,2524,2092,849,104600,75223
10972,5294,5678,809,93700,75224
8846,6653,2193,1880,996400,75225
1919,56,1863,1135,333300,75226
17067,9838,7229,873,90500,75227
25581,11685,13896,788,119300,75228
11150,7974,3176,946,345400,75229
13003,7890,5113,953,553900,75230
16390,3198,13192,815,299200,75231
10635,6217,4418,912,91000,75232
5051,2578,2473,870,122200,75233
11512,7090,4422,1167,154600,75234
7392,1940,5452,1073,124600,75235
6319,2177,4142,883,110900,75236
8310,1250,7060,776,113900,75237
12638,6244,6394,858,313800,75238
10118,2312,7806,921,210300,75240
10524,6223,4301,852,75900,75241
27344,6674,20670,837,186600,75243
6068,3030,3038,1315,356700,75244
1211,187,1024,690,163800,75246
224,0,224,817,-,75247
16070,8542,7528,1099,340600,75248
5015,3913,1102,1356,131100,75249
1610,0,1610,1297,-,75251
12549,4993,7556,924,328300,75252
6272,4112,2160,930,44400,75253
11628,2151,9477,1019,388400,75254
0,0,0,-,-,75270
27395,5587,21808,964,277900,75287
0,0,0,-,-,75390
6464,3449,3015,791,60500,75401
6218,4424,1794,858,132700,75402
5607,3831,1776,1033,152500,75407
4352,3210,1142,1603,174700,75409
1956,1566,390,761,113200,75410
469,368,101,688,80400,75411
271,257,14,-,72400,75412
87,61,26,950,63500,75413
1149,974,175,756,127300,75414
69,60,9,-,78100,75415
1040,810,230,770,88700,75416
1060,859,201,503,69200,75417
4719,3250,1469,742,91000,75418
334,283,51,708,140800,75420
272,203,69,831,110200,75421
1021,880,141,826,98100,75422
1049,888,161,859,121100,75423
1264,1062,202,1004,139100,75424
2109,1420,689,632,52400,75426
3771,1821,1950,836,82300,75428
824,570,254,783,77800,75431
1305,879,426,560,74100,75432
1065,864,201,753,99100,75433
519,346,173,359,55100,75435
770,555,215,484,81800,75436
475,445,30,-,110100,75437
352,307,45,705,106600,75438
357,229,128,812,116000,75439
2498,2003,495,634,130300,75440
65,65,0,-,-,75441
3409,2341,1068,1026,148500,75442
1186,919,267,725,93600,75446
352,271,81,625,128300,75447
227,220,7,-,49200,75448
582,418,164,755,58900,75449
53,53,0,-,106600,75450
496,401,95,611,101900,75451
1479,1088,391,669,105000,75452
1265,1011,254,803,87900,75453
2602,2186,416,1196,259300,75454
9410,6104,3306,683,101400,75455
2360,1665,695,818,127900,75457
1899,1443,456,735,124500,75459
9060,4568,4492,652,69400,75460
4457,3278,1179,728,146100,75462
392,357,35,-,108000,75468
141,119,22,463,76100,75469
188,177,11,-,49700,75470
496,383,113,-,82500,75471
1467,1037,430,737,85200,75472
1408,1190,218,823,93500,75473
5463,4136,1327,830,81900,75474
90,86,4,-,62600,75475
395,336,59,753,102900,75476
352,220,132,473,52700,75477
347,266,81,910,96300,75478
693,549,144,650,87100,75479
593,517,76,588,256100,75480
144,126,18,-,75000,75481
9197,5939,3258,754,97000,75482
859,696,163,774,86500,75486
583,447,136,568,67100,75487
281,239,42,807,97300,75488
413,267,146,810,100600,75489
886,760,126,1006,113700,75490
1992,1497,495,734,120300,75491
186,167,19,600,114300,75492
124,89,35,592,55000,75493
3620,2837,783,706,90900,75494
2778,2198,580,1015,164300,75495
1245,968,277,525,88800,75496
1418,1202,216,592,163000,75497
12599,7570,5029,670,96100,75501
9572,6101,3471,850,163500,75503
358,286,72,617,62500,75550
4252,3356,896,661,99400,75551
770,691,79,531,70900,75554
661,602,59,883,79500,75555
378,304,74,508,63300,75556
499,434,65,441,56300,75558
2056,1646,410,582,81400,75559
347,300,47,679,91700,75560
1941,1347,594,699,81300,75561
58,58,0,-,-,75562
1827,1301,526,524,84300,75563
91,59,32,829,77500,75565
307,272,35,950,118900,75566
1712,1303,409,865,90400,75567
1036,710,326,542,78100,75568
1211,635,576,922,104800,75569
3197,2238,959,550,88800,75570
1120,939,181,584,105400,75571
1600,1214,386,539,66600,75572
24,24,0,-,83300,75573
706,580,126,588,70300,75574
6325,3585,2740,737,128800,75601
7017,4141,2876,732,79200,75602
2260,1828,432,648,97400,75603
11219,6095,5124,832,135500,75604
12223,7508,4715,867,177800,75605
1158,1029,129,-,94400,75630
1130,894,236,765,91600,75631
5364,4034,1330,713,111500,75633
2380,1811,569,772,69100,75638
1164,912,252,784,76700,75639
1838,1464,374,1132,116200,75640
50,41,9,-,80600,75641
7,7,0,-,-,75642
861,702,159,545,83000,75643
4361,3104,1257,705,106400,75644
3359,2985,374,938,124000,75645
4478,3154,1324,892,115600,75647
3214,2440,774,879,148400,75650
710,680,30,-,103600,75651
4684,3253,1431,728,132500,75652
4619,3622,997,691,115200,75654
1616,1210,406,523,95100,75656
3371,2536,835,696,88900,75657
1036,788,248,615,88400,75661
9001,6190,2811,774,108400,75662
450,320,130,533,97200,75667
833,523,310,566,92100,75668
250,229,21,-,122100,75669
6013,3769,2244,662,69300,75670
6160,4806,1354,818,125100,75672
963,820,143,588,84600,75681
179,172,7,-,101100,75682
1529,1208,321,704,74900,75683
2498,1808,690,766,93000,75684
4870,3498,1372,699,85800,75686
1162,850,312,727,81900,75691
1643,1322,321,779,100800,75692
2351,1614,737,955,151700,75693
12304,6982,5322,860,125900,75701
7891,4103,3788,706,72500,75702
16735,9409,7326,888,200000,75703
3019,2308,711,789,91500,75704
822,663,159,861,87400,75705
2879,1874,1005,819,86300,75706
5260,3801,1459,1006,166900,75707
2316,1568,748,818,73900,75708
1984,1176,808,1021,113100,75709
1424,1163,261,648,133600,75750
5802,3639,2163,789,95800,75751
2810,2402,408,794,119300,75752
2437,1929,508,839,146500,75754
1973,1339,634,667,122300,75755
1632,1467,165,845,98100,75756
4298,3704,594,748,198600,75757
3440,2663,777,751,121900,75758
16,13,3,-,72500,75759
992,835,157,486,83100,75760
4747,3805,942,1138,168700,75762
2305,1827,478,669,117900,75763
86,71,15,613,53500,75764
2869,2417,452,824,132400,75765
9647,6773,2874,678,93400,75766
1240,1040,200,655,99200,75770
7392,5754,1638,923,153600,75771
4746,3615,1131,767,127000,75773
1251,1001,250,630,93800,75778
51,46,5,-,82900,75779
54,32,22,471,57500,75780
2915,2371,544,705,90000,75783
282,261,21,797,84400,75784
3211,2472,739,770,86600,75785
68,47,21,-,-,75788
2754,2262,492,807,152200,75789
1562,1154,408,598,111800,75790
4606,3533,1073,956,159500,75791
1103,711,392,828,85300,75792
5737,3471,2266,759,103300,75801
6203,4593,1610,766,88600,75803
1969,1510,459,558,85500,75831
10,0,10,-,-,75832
1264,987,277,653,110700,75833
4520,2748,1772,651,85700,75835
290,235,55,706,-,75838
2018,1678,340,640,71900,75839
2654,1988,666,713,92800,75840
2615,2029,586,658,73400,75844
1189,904,285,694,74000,75845
1080,769,311,616,70800,75846
799,604,195,529,68300,75847
52,38,14,-,55000,75848
39,33,6,-,-,75849
311,228,83,1106,167500,75850
838,705,133,841,116000,75851
395,285,110,855,121900,75852
373,310,63,485,65200,75853
1015,840,175,584,71200,75855
34,34,0,-,-,75856
14,14,0,-,-,75858
746,632,114,913,77200,75859
2050,1533,517,664,81900,75860
656,384,272,935,85100,75861
4240,3338,902,726,70300,75862
10843,7051,3792,787,101300,75901
12437,7325,5112,795,108300,75904
1514,1055,459,651,99200,75925
436,341,95,745,72800,75926
263,216,47,-,66600,75928
735,618,117,-,80800,75929
632,540,92,438,82000,75930
889,794,95,765,101800,75931
560,507,53,642,57700,75932
492,468,24,-,45900,75933
59,31,28,-,-,75934
4868,3256,1612,576,74200,75935
307,248,59,1639,76400,75936
349,298,51,600,92400,75937
1072,902,170,724,92000,75938
1819,1220,599,446,68000,75939
2664,1999,665,594,75300,75941
46,46,0,-,"10,000-",75942
528,413,115,603,70500,75943
569,514,55,750,83500,75944
1272,802,470,804,87800,75946
2279,2025,254,517,106200,75948
2810,2299,511,640,82100,75949
5124,3462,1662,731,92100,75951
1127,879,248,708,66900,75954
2901,2179,722,570,113300,75956
291,271,20,-,110800,75959
327,303,24,-,49800,75960
6087,2946,3141,795,98400,75961
0,0,0,-,-,75962
6617,3978,2639,681,81100,75964
7697,3767,3930,768,174500,75965
1741,1411,330,530,68200,75966
662,528,134,713,57000,75968
1292,1099,193,721,103300,75969
2259,1763,496,605,82200,75972
950,839,111,453,77400,75973
1119,809,310,506,67200,75974
1443,1033,410,465,83300,75975
287,160,127,344,55700,75976
266,188,78,-,60900,75977
55,49,6,-,128000,75978
3751,3037,714,715,75800,75979
994,730,264,507,72000,75980
9851,8155,1696,1368,165500,76001
9779,8351,1428,1771,163800,76002
11488,2954,8534,896,208100,76006
5545,4892,653,1245,287300,76008
6850,5400,1450,896,92900,76009
17633,5770,11863,819,86100,76010
9585,2008,7577,816,122900,76011
10146,6350,3796,948,174600,76012
13336,6849,6487,855,160200,76013
10982,5712,5270,1088,99300,76014
6351,3225,3126,1088,123900,76015
11315,9151,2164,1350,170900,76016
17070,11421,5649,1052,159400,76017
9386,6556,2830,1276,123900,76018
10027,7462,2565,845,135700,76020
15343,8563,6780,970,195700,76021
5518,2880,2638,1086,139500,76022
2147,1537,610,971,109200,76023
23666,18464,5202,1162,161600,76028
6051,4432,1619,833,95600,76031
9356,5665,3691,885,117200,76033
8854,8489,365,1618,456100,76034
579,550,29,1313,258000,76035
8757,6623,2134,1124,158400,76036
14322,6086,8236,1124,169400,76039
11398,5366,6032,874,164100,76040
90,66,24,-,101900,76041
2795,1961,834,849,175400,76043
1512,1195,317,911,169600,76044
9053,6081,2972,849,139200,76048
10881,8951,1930,948,189300,76049
1971,1717,254,820,162500,76050
19777,10953,8824,1208,273400,76051
6644,5917,727,1452,265300,76052
10903,6171,4732,968,134200,76053
4363,3830,533,1203,204700,76054
1005,762,243,687,79700,76055
6132,4914,1218,885,111400,76058
1624,651,973,844,97800,76059
2593,2008,585,925,173400,76060
39,39,0,-,-,76061
22828,17375,5453,1244,219400,76063
559,457,102,889,162300,76064
11505,9473,2032,1111,203000,76065
1292,1076,216,553,156700,76066
7062,4514,2548,753,83100,76067
261,261,0,-,176500,76070
1237,942,295,872,151400,76071
2021,1771,250,963,134600,76073
164,155,9,-,-,76077
3223,2713,510,1148,146200,76078
6214,5054,1160,906,135100,76082
2404,2008,396,815,102700,76084
3577,2897,680,793,166200,76085
7987,3947,4040,1003,121200,76086
9829,8710,1119,1068,212800,76087
4059,3392,667,964,196400,76088
9154,8510,644,1434,628100,76092
637,426,211,753,95900,76093
3537,965,2572,1316,217800,76102
4860,2960,1900,772,86200,76103
6234,2624,3610,826,59200,76104
6588,3390,3198,800,57300,76105
9902,5125,4777,865,75200,76106
13796,6748,7048,1047,261300,76107
14696,9711,4985,963,126200,76108
9622,5376,4246,1098,389900,76109
9934,5788,4146,840,102000,76110
6502,3943,2559,909,84100,76111
16242,7700,8542,801,100300,76112
8876,5008,3868,889,86100,76114
5817,3051,2766,813,74400,76115
21331,8495,12836,860,151700,76116
10087,5681,4406,839,93100,76117
5556,4143,1413,912,150300,76118
14180,7153,7027,830,66800,76119
7171,2855,4316,899,144300,76120
10333,7954,2379,1443,149800,76123
8198,6652,1546,1079,174500,76126
50,7,43,1570,-,76127
0,0,0,-,-,76129
11554,8405,3149,1336,155400,76131
12492,4144,8348,951,252100,76132
18281,11418,6863,1005,117600,76133
8407,4957,3450,989,97700,76134
8261,5636,2625,897,128400,76135
20178,12536,7642,1200,152400,76137
9535,6679,2856,1119,97900,76140
7950,6330,1620,1327,111900,76148
2754,0,2754,1039,-,76155
4373,2450,1923,817,64800,76164
3104,1847,1257,1270,202300,76177
18335,13841,4494,1344,160000,76179
14503,6881,7622,1024,150600,76180
11234,9118,2116,1172,194100,76182
9958,2008,7950,835,141100,76201
7298,2732,4566,978,199200,76205
5365,3494,1871,1089,196200,76207
8018,5067,2951,1098,219000,76208
9175,4419,4756,941,144000,76209
14436,11047,3389,1287,195400,76210
1100,907,193,827,151600,76225
8020,7228,792,1636,370500,76226
9740,7880,1860,1598,190100,76227
394,325,69,675,88100,76228
4030,2856,1174,815,124800,76230
1291,968,323,966,152000,76233
5657,4154,1503,967,161700,76234
166,133,33,675,88800,76238
526,399,127,847,138200,76239
10693,6936,3757,798,139400,76240
23025,18241,4784,1559,212100,76244
783,703,80,695,77900,76245
4097,3258,839,1221,165700,76247
12896,10392,2504,1295,324400,76248
2766,2154,612,1067,165900,76249
404,364,40,1063,183000,76250
276,210,66,907,124300,76251
988,784,204,834,172800,76252
115,84,31,475,-,76253
2276,1601,675,637,85800,76255
2417,1973,444,927,151800,76258
1630,1236,394,1019,164200,76259
119,106,13,-,73500,76261
11958,9187,2771,1158,319700,76262
20,13,7,-,-,76263
600,473,127,822,81400,76264
698,575,123,725,96600,76265
5352,3975,1377,1157,157800,76266
100,83,17,-,46100,76268
682,493,189,437,132300,76270
573,436,137,1007,141100,76271
1538,1184,354,619,128300,76272
3477,2435,1042,712,139900,76273
6603,3410,3193,639,49700,76301
5179,3015,2164,738,108900,76302
1812,1532,280,543,111400,76305
5881,3457,2424,772,75200,76306
8195,4506,3689,793,133100,76308
5145,3149,1996,749,96100,76309
7182,5156,2026,773,132300,76310
653,5,648,1214,-,76311
773,527,246,618,77200,76351
4818,3187,1631,858,96100,76354
230,200,30,725,61000,76357
1639,1246,393,656,44300,76360
132,116,16,433,30000,76363
62,47,15,-,65900,76364
1785,1437,348,663,81300,76365
814,626,188,623,94600,76366
3763,3252,511,864,86100,76367
123,101,22,334,-,76370
563,433,130,440,47200,76371
455,305,150,604,78300,76372
64,52,12,-,-,76373
1602,1092,510,580,59500,76374
311,298,13,563,56900,76377
184,138,46,640,121300,76379
1659,1288,371,472,66800,76380
4950,3210,1740,634,70400,76384
137,124,13,633,-,76388
459,372,87,730,127500,76389
10121,5882,4239,792,134600,76401
0,0,0,-,-,76402
3077,2406,671,576,69700,76424
4203,2807,1396,893,132600,76426
361,240,121,559,57500,76427
101,72,29,-,168100,76429
930,774,156,540,79600,76430
1062,912,150,927,110800,76431
544,505,39,681,107800,76432
549,451,98,865,249100,76433
187,156,31,675,33300,76435
78,78,0,-,262500,76436
2093,1590,503,608,71300,76437
2742,2167,575,523,95200,76442
912,681,231,661,69300,76443
1506,1202,304,515,80600,76444
176,166,10,-,71600,76445
2710,2027,683,599,91300,76446
1770,1368,402,540,77200,76448
968,756,212,678,112200,76449
5120,4249,871,679,91900,76450
23,11,12,-,-,76452
627,576,51,746,177600,76453
614,481,133,348,43400,76454
370,259,111,523,59800,76455
1456,1029,427,684,127700,76457
1956,1636,320,730,84700,76458
84,80,4,-,74400,76459
137,124,13,-,181100,76460
1128,1033,95,915,209000,76462
169,145,24,990,65000,76463
239,171,68,630,61000,76464
57,14,43,-,-,76466
29,29,0,-,60600,76469
1186,808,378,382,56000,76470
731,575,156,622,49300,76471
638,530,108,1019,117100,76472
103,95,8,-,117000,76474
355,277,78,625,87800,76475
1053,841,212,850,166500,76476
48,33,15,-,-,76481
476,334,142,367,65000,76483
353,260,93,710,100000,76484
458,391,67,678,74100,76486
907,759,148,990,144000,76487
44,40,4,-,-,76490
156,124,32,567,54000,76491
6192,3777,2415,692,110400,76501
14197,9449,4748,1023,154400,76502
8703,3408,5295,805,91900,76504
0,0,0,-,-,76508
707,533,174,611,90600,76511
12977,8823,4154,816,163400,76513
476,382,94,634,73000,76518
171,146,25,-,-,76519
3093,2106,987,619,77900,76520
13675,7986,5689,876,112500,76522
0,0,0,-,-,76523
1066,954,112,916,103300,76524
424,324,100,652,103600,76525
1280,883,397,749,145200,76527
6003,4240,1763,722,108200,76528
769,577,192,729,141900,76530
1912,1564,348,563,111700,76531
973,716,257,669,123000,76534
1652,1263,389,947,157800,76537
281,215,66,679,110700,76538
3031,2651,380,932,160500,76539
7495,2123,5372,690,69100,76541
17110,9605,7505,1036,147100,76542
11307,4314,6993,807,88500,76543
4221,32,4189,1181,-,76544
9904,6391,3513,898,174500,76548
16265,8300,7965,1035,129800,76549
4912,3441,1471,775,128500,76550
747,541,206,920,107300,76554
542,432,110,433,85300,76556
1759,1470,289,675,112100,76557
1873,1071,802,893,126900,76559
394,294,100,757,83200,76561
37,37,0,-,151400,76565
149,96,53,-,185700,76566
3613,2155,1458,669,96100,76567
792,624,168,929,87800,76569
919,693,226,642,65400,76570
2573,2210,363,749,273300,76571
9,4,5,-,-,76573
6320,4081,2239,857,133500,76574
1274,962,312,741,142100,76577
502,428,74,1045,140900,76578
1505,1134,371,924,117500,76579
0,0,0,-,-,76596
0,0,0,-,-,76597
0,0,0,-,-,76598
0,0,0,-,-,76599
361,317,44,717,123500,76621
420,313,107,767,86300,76622
49,43,6,-,70800,76623
726,551,175,766,103300,76624
472,337,135,844,89100,76626
554,494,60,735,85700,76627
16,14,2,-,-,76628
720,475,245,525,81600,76629
337,288,49,812,124000,76630
171,139,32,1034,58200,76631
507,400,107,1053,54900,76632
1870,1592,278,942,184800,76633
2824,2153,671,707,125900,76634
419,311,108,626,55300,76635
555,456,99,654,116000,76636
252,204,48,615,80000,76637
1142,933,209,1051,214500,76638
580,383,197,524,65000,76639
1152,788,364,793,77800,76640
639,521,118,599,74300,76641
2541,1939,602,645,91000,76642
5073,3721,1352,1090,151500,76643
3713,2294,1419,718,83700,76645
1023,760,263,685,90600,76648
290,262,28,775,92500,76649
71,56,15,-,65000,76650
1252,864,388,790,98200,76651
457,396,61,830,83800,76652
349,282,67,738,90000,76653
66,61,5,-,62100,76654
3005,2429,576,942,168500,76655
741,563,178,475,97900,76656
3448,2414,1034,835,198100,76657
181,147,34,638,82300,76660
2409,1513,896,461,52600,76661
1190,879,311,801,84100,76664
940,638,302,595,100000,76665
112,96,16,742,83000,76666
3657,2680,977,701,85200,76667
480,363,117,958,101800,76670
753,561,192,735,91300,76671
438,330,108,598,80000,76673
98,83,15,-,84200,76676
99,53,46,803,-,76678
528,433,95,615,86600,76679
122,122,0,-,66400,76680
273,191,82,932,-,76681
963,721,242,831,89900,76682
17,0,17,-,-,76685
89,63,26,780,76100,76686
714,518,196,668,109100,76687
1298,1064,234,796,122800,76689
343,241,102,759,75000,76690
2395,1740,655,752,106400,76691
3890,3023,867,661,101900,76692
547,309,238,683,83800,76693
656,114,542,943,306300,76701
3075,1118,1957,667,80000,76704
10101,5635,4466,729,88400,76705
13084,5173,7911,815,106400,76706
5195,2344,2851,766,64900,76707
9726,5831,3895,829,121900,76708
10422,5121,5301,742,122800,76710
3206,1707,1499,942,62500,76711
9873,6754,3119,928,185900,76712
0,0,0,-,-,76798
9029,6181,2848,705,92000,76801
1709,1287,422,729,112500,76802
54,46,8,-,196300,76820
1751,1310,441,585,78900,76821
1220,960,260,562,81500,76823
15,0,15,-,-,76824
2582,1907,675,729,80300,76825
167,139,28,-,108600,76827
85,78,7,-,66900,76828
18,18,0,-,-,76831
225,167,58,1081,159100,76832
2176,1540,636,696,63200,76834
9,9,0,-,-,76836
488,314,174,693,86700,76837
17,17,0,-,-,76841
111,96,15,-,-,76842
1374,1147,227,569,104300,76844
63,48,15,-,-,76845
40,40,0,-,-,76848
1628,1175,453,601,104000,76849
90,71,19,670,120300,76852
570,441,129,668,88500,76853
157,137,20,-,-,76854
1443,1037,406,797,153900,76856
765,645,120,656,78700,76857
122,107,15,-,27700,76858
873,560,313,604,56800,76859
641,490,151,698,101600,76861
78,47,31,-,193800,76862
271,234,37,538,142500,76864
44,44,0,-,142500,76865
194,172,22,525,163800,76866
34,24,10,-,166700,76869
94,74,20,506,96300,76870
312,216,96,613,65600,76871
363,306,57,700,150000,76872
25,19,6,-,-,76873
18,0,18,-,-,76874
224,187,37,919,115600,76875
1471,966,505,673,100200,76877
762,465,297,615,66300,76878
120,95,25,-,114800,76882
50,45,5,-,31900,76884
65,52,13,-,-,76885
58,58,0,-,-,76887
71,58,13,-,151600,76888
321,257,64,-,111200,76890
11405,7586,3819,907,103200,76901
11940,7048,4892,747,78500,76903
13816,8207,5609,846,184700,76904
4410,3008,1402,969,120500,76905
0,0,0,-,-,76908
49,30,19,-,81500,76930
1168,808,360,763,89300,76932
614,442,172,608,85800,76933
419,346,73,725,123800,76934
616,585,31,-,170800,76935
1102,847,255,483,72900,76936
29,29,0,-,-,76937
4,4,0,-,-,76939
75,61,14,-,-,76940
568,467,101,833,151700,76941
1379,1007,372,526,83100,76943
799,557,242,538,74200,76945
5,5,0,-,-,76949
1586,1077,509,633,95200,76950
462,393,69,919,66100,76951
25,3,22,-,-,76953
58,45,13,-,549100,76955
0,0,0,-,-,76957
62,52,10,-,177100,76958
3295,833,2462,1418,233000,77002
4470,2014,2456,975,272800,77003
13340,4595,8745,957,247300,77004
10114,7384,2730,1648,940800,77005
12493,4419,8074,1223,430600,77006
19082,9655,9427,1587,398200,77007
16116,9501,6615,1203,396300,77008
14176,7589,6587,877,250800,77009
589,78,511,3190,-,77010
5619,2561,3058,644,85700,77011
6084,2512,3572,715,77400,77012
6107,2183,3924,850,85500,77013
11606,4908,6698,906,132700,77014
17509,8975,8534,859,95800,77015
9771,6201,3570,803,60600,77016
9999,5364,4635,800,90300,77017
10889,7345,3544,848,342200,77018
10835,5695,5140,1586,510000,77019
8502,3787,4715,674,77700,77020
10770,4245,6525,864,89900,77021
9228,4140,5088,709,85900,77022
9592,4345,5247,760,112800,77023
15252,10241,5011,1467,898100,77024
12959,5519,7440,1186,405900,77025
8063,3368,4695,664,62100,77026
8915,3136,5779,1448,679000,77027
5526,2991,2535,805,56200,77028
5664,3326,2338,743,68500,77029
4994,2137,2857,1436,471100,77030
5992,2733,3259,822,135900,77031
4292,1568,2724,860,82500,77032
9139,5562,3577,883,62400,77033
12363,5434,6929,880,109400,77034
14144,5827,8317,810,196400,77035
26852,5191,21661,749,129600,77036
5441,3806,1635,928,94400,77037
8474,4430,4044,907,105300,77038
7483,4598,2885,846,89200,77039
17652,9634,8018,968,150200,77040
11649,8770,2879,1314,159700,77041
19165,4946,14219,990,239500,77042
8963,5210,3753,974,194700,77043
12594,9315,3279,1180,173400,77044
10330,7033,3297,899,80900,77045
719,222,497,1825,348200,77046
9626,6886,2740,1139,122900,77047
5622,3613,2009,704,71900,77048
10236,7039,3197,1014,126400,77049
1404,1099,305,831,81300,77050
6102,2527,3575,756,73800,77051
8740,5741,2999,1126,85200,77053
12485,2005,10480,1085,138800,77054
15034,6382,8652,894,383000,77055
10782,4672,6110,1557,631800,77056
19843,6792,13051,1025,287000,77057
8080,2387,5693,985,171800,77058
5889,5321,568,1547,277700,77059
13877,3214,10663,755,95700,77060
8690,2991,5699,734,116900,77061
9758,7644,2114,1129,178900,77062
18281,4738,13543,1009,207400,77063
16300,9520,6780,1184,143000,77064
15033,7216,7817,1082,154000,77065
10315,7212,3103,1094,125900,77066
10160,4093,6067,827,99900,77067
3821,2531,1290,1023,194000,77068
8212,4494,3718,1150,233900,77069
19713,10298,9415,1230,166900,77070
9912,5448,4464,835,130900,77071
17853,8508,9345,902,97500,77072
12824,7061,5763,1005,119100,77073
13130,4269,8861,821,114100,77074
12827,6859,5968,908,125900,77075
9756,4593,5163,842,88800,77076
26614,9446,17168,1171,265300,77077
4757,2817,1940,883,74500,77078
12496,7957,4539,1293,444100,77079
15241,6126,9115,880,171000,77080
18070,977,17093,782,256700,77081
22547,8129,14418,1097,147200,77082
22380,14901,7479,976,130300,77083
33790,21054,12736,1187,142400,77084
5146,3546,1600,1056,106300,77085
8078,4868,3210,924,97300,77086
11076,5433,5643,762,89000,77087
17381,10648,6733,854,100000,77088
16858,10925,5933,1073,137400,77089
15487,3421,12066,913,140900,77090
9658,3959,5699,752,110900,77091
14075,5142,8933,805,147100,77092
12275,6984,5291,776,75900,77093
3167,2600,567,1842,390000,77094
24232,18150,6082,1220,193100,77095
14382,6904,7478,921,320100,77096
8090,2534,5556,1524,462500,77098
16805,6367,10438,879,105700,77099
0,0,0,-,-,77201
10173,4949,5224,823,111100,77301
6417,5335,1082,834,147100,77302
6564,4824,1740,992,123700,77303
11655,6541,5114,1019,198000,77304
3602,2763,839,945,84700,77306
7294,6416,878,970,266700,77316
5848,4588,1260,1150,209600,77318
8936,5718,3218,792,109200,77320
15,15,0,-,-,77326
7704,5292,2412,715,87500,77327
4881,3728,1153,823,110500,77328
3002,2723,279,726,114200,77331
112,76,36,-,-,77334
1069,849,220,973,123200,77335
4430,3247,1183,1035,162600,77336
13714,7564,6150,948,128800,77338
15918,10387,5531,1226,171800,77339
10695,4249,6446,861,161400,77340
0,0,0,-,-,77342
9725,8321,1404,1307,272700,77345
20466,16961,3505,1300,182900,77346
70,67,3,-,41900,77350
12051,9242,2809,686,90500,77351
11848,9812,2036,1174,237900,77354
9269,7875,1394,1074,207700,77355
10996,8926,2070,1165,243800,77356
7341,5533,1808,808,105400,77357
1788,1349,439,926,139500,77358
201,133,68,-,132100,77359
2193,1773,420,808,75200,77360
1666,1442,224,1633,163000,77362
1232,1002,230,1024,90800,77363
741,676,65,823,102400,77364
10343,7618,2725,1019,177200,77365
62,24,38,934,-,77367
90,90,0,-,120500,77368
212,198,14,-,73200,77369
2445,1774,671,610,64800,77371
4070,3140,930,886,81000,77372
19731,14430,5301,1282,132700,77373
168,168,0,-,91300,77374
16125,11521,4604,1112,168300,77375
166,166,0,-,-,77376
11624,9622,2002,1271,241800,77377
4983,3661,1322,913,107100,77378
26321,20898,5423,1226,229000,77379
11649,4802,6847,1282,222700,77380
14205,10457,3748,1370,339300,77381
13259,9868,3391,1764,408100,77382
6560,3938,2622,1391,298100,77384
7956,6367,1589,1197,205300,77385
16675,12735,3940,1412,205900,77386
15774,12606,3168,1486,172300,77388
10482,8780,1702,1484,283100,77389
16773,9727,7046,1151,130800,77396
7011,5760,1251,1596,802300,77401
13392,11795,1597,1244,265700,77406
14198,11815,2383,1469,216900,77407
30,30,0,-,95000,77412
8652,5008,3644,771,105500,77414
21,21,0,-,-,77415
1123,771,352,930,107100,77417
3985,2926,1059,796,221200,77418
456,360,96,860,111300,77419
913,697,216,758,97800,77420
4728,3816,912,796,92000,77422
3799,2734,1065,886,166100,77423
845,682,163,1216,152100,77426
0,0,0,-,-,77428
27727,23330,4397,1265,215000,77429
740,671,69,950,126800,77430
35,16,19,-,-,77432
23046,19784,3262,1499,227800,77433
1637,1269,368,689,58500,77434
1607,1209,398,924,139100,77435
13,13,0,-,-,77436
6033,3950,2083,733,133900,77437
23,0,23,-,-,77440
3315,3147,168,-,411900,77441
367,276,91,521,114400,77442
50,50,0,-,-,77443
249,202,47,-,-,77444
4484,2562,1922,804,132100,77445
584,123,461,1107,140600,77446
4710,3828,882,1199,134900,77447
13,0,13,-,-,77448
33719,23412,10307,1386,142600,77449
24987,17815,7172,1277,242000,77450
31,28,3,-,65000,77451
112,38,74,746,-,77453
15,15,0,-,-,77454
829,677,152,710,128200,77455
484,430,54,-,75900,77456
239,216,23,309,131300,77457
120,104,16,-,-,77458
21160,18196,2964,1706,246700,77459
30,18,12,-,-,77460
3852,2941,911,834,139300,77461
98,55,43,1019,141900,77464
2769,2406,363,761,109100,77465
154,100,54,946,114700,77466
37,0,37,-,-,77467
19,19,0,-,-,77468
14853,10888,3965,1009,195800,77469
145,110,35,-,-,77470
12334,6996,5338,964,134900,77471
47,13,34,-,-,77473
4568,3305,1263,867,162800,77474
284,284,0,-,77500,77475
75,62,13,-,324100,77476
13169,5939,7230,1184,153900,77477
9345,7142,2203,1454,270200,77478
27308,22921,4387,1771,344400,77479
2876,2293,583,791,106800,77480
8,2,6,-,-,77481
1009,826,183,762,76100,77482
85,34,51,-,-,77483
3638,2815,823,859,176200,77484
1642,1191,451,758,136900,77485
2540,1928,612,914,121600,77486
5434,3482,1952,714,105200,77488
12059,9083,2976,1271,117000,77489
9004,7156,1848,1336,171200,77493
32612,26067,6545,1576,318600,77494
15344,11339,4005,1415,186500,77498
10950,6708,4242,871,92500,77502
8046,4081,3965,859,92900,77503
8620,3477,5143,856,134700,77504
8370,5717,2653,1047,172600,77505
11037,4465,6572,783,73300,77506
0,0,0,-,-,77507
5479,4282,1197,909,157700,77510
16050,11419,4631,872,125200,77511
1660,1340,320,776,127200,77514
10732,7275,3457,793,115000,77515
1738,1638,100,1014,162400,77517
3679,2371,1308,788,88500,77518
527,491,36,-,56700,77519
12354,7084,5270,852,80200,77520
18970,11819,7151,886,135500,77521
6885,5672,1213,1131,199000,77523
9239,5901,3338,882,91500,77530
6047,3183,2864,828,109400,77531
9970,7891,2079,964,135300,77532
336,223,113,671,60900,77533
879,726,153,893,141900,77534
9388,7464,1924,891,100900,77535
10853,8340,2513,1214,147000,77536
301,282,19,731,103200,77538
14940,10472,4468,931,152400,77539
6273,3665,2608,782,88800,77541
6968,5855,1113,1332,152400,77545
17615,13884,3731,1209,220000,77546
2694,1701,993,827,67400,77547
9866,4078,5788,843,135700,77550
8084,3144,4940,911,159200,77551
3696,2408,1288,984,277400,77554
270,260,10,-,190800,77560
42,35,7,-,126400,77561
3690,2780,910,936,106600,77562
3960,2850,1110,868,128800,77563
775,695,80,-,98100,77564
3417,1875,1542,1223,234000,77565
11410,7756,3654,1041,159300,77566
5591,3770,1821,838,96400,77568
13248,9814,3434,1032,133600,77571
29201,21925,7276,1276,224500,77573
5983,4383,1600,822,104000,77575
581,538,43,686,134400,77577
5869,5133,736,738,220400,77578
151,151,0,-,317300,77580
16452,12399,4053,1117,199200,77581
8165,6591,1574,870,161500,77583
29633,22034,7599,1391,223900,77584
290,259,31,-,24000,77585
8714,5695,3019,1045,212500,77586
4511,2702,1809,789,85200,77587
11205,6779,4426,847,98400,77590
5399,2935,2464,907,119300,77591
325,281,44,-,-,77597
10349,2172,8177,1015,138600,77598
3078,2385,693,792,142500,77611
3116,2629,487,802,99600,77612
471,361,110,728,112800,77613
214,151,63,-,61800,77614
332,302,30,498,80400,77615
256,250,6,-,81100,77616
48,48,0,-,263600,77617
5952,4165,1787,878,104900,77619
475,433,42,765,121200,77622
176,140,36,1045,79400,77623
309,240,69,993,108500,77624
3310,2810,500,772,84600,77625
8792,6256,2536,886,133100,77627
250,201,49,505,98000,77629
11704,7780,3924,783,98900,77630
8656,7195,1461,787,119300,77632
6428,3993,2435,812,63900,77640
13790,7320,6470,713,64000,77642
674,496,178,831,196000,77650
5090,3800,1290,800,155000,77651
140,127,13,-,94300,77655
6343,4863,1480,697,91100,77656
8001,6346,1655,815,153300,77657
1740,1460,280,819,150500,77659
395,347,48,-,63700,77660
244,184,60,-,86300,77661
9817,7722,2095,719,90600,77662
504,504,0,-,161200,77663
874,785,89,-,85600,77664
2287,1739,548,812,118900,77665
4980,2699,2281,683,56800,77701
1181,574,607,847,85400,77702
5315,2661,2654,691,62200,77703
10896,6892,4004,715,77500,77705
12807,7286,5521,844,167200,77706
6541,4729,1812,909,104400,77707
4545,2602,1943,858,101700,77708
5930,3679,2251,1059,139900,77713
6588,1126,5462,799,106000,77801
11074,5651,5423,933,160900,77802
9237,5362,3875,799,84900,77803
3315,2087,1228,838,157100,77807
4152,3762,390,1006,187800,77808
1053,905,148,445,180600,77830
1276,1133,143,713,126100,77831
9725,7350,2375,845,173200,77833
1210,1002,208,-,122900,77835
4395,3424,971,765,108900,77836
643,426,217,652,95400,77837
21053,2665,18388,890,167800,77840
21934,14532,7402,1146,224000,77845
510,429,81,711,103900,77853
37,37,0,-,-,77855
2024,1543,481,725,115900,77856
281,230,51,575,201700,77857
2579,1962,617,668,84900,77859
959,859,100,733,131100,77861
2888,2042,846,786,96900,77864
723,685,38,623,112000,77865
44,39,5,-,84100,77867
4800,3425,1375,679,108700,77868
1126,868,258,767,132500,77871
638,572,66,533,102000,77872
490,398,92,537,84100,77873
76,63,13,-,-,77876
131,77,54,866,-,77878
1991,1610,381,710,84600,77879
599,514,85,825,112800,77880
14823,7661,7162,843,89700,77901
10457,7436,3021,954,174300,77904
5334,4657,677,882,142700,77905
89,73,16,535,97500,77950
649,448,201,583,48800,77951
3810,2608,1202,835,112400,77954
3089,2067,1022,822,103200,77957
14,14,0,-,-,77960
100,100,0,-,111200,77961
1055,816,239,912,97400,77962
2185,1770,415,656,121300,77963
3270,2461,809,638,159600,77964
1144,1016,128,597,174000,77968
41,23,18,-,-,77969
196,94,102,577,-,77970
420,284,136,695,82800,77971
0,0,0,-,-,77973
142,121,21,1083,162500,77974
736,522,214,746,123600,77975
38,33,5,-,147900,77976
254,201,53,606,59200,77977
316,178,138,1029,76100,77978
6205,4320,1885,761,110800,77979
345,281,64,-,186600,77982
800,612,188,685,150500,77983
1567,1285,282,670,163600,77984
128,115,13,-,88500,77987
164,142,22,-,120100,77988
325,221,104,769,80800,77990
108,67,41,1267,68200,77991
56,37,19,-,1048900,77993
210,173,37,-,-,77994
3743,2829,914,638,96700,77995
0,0,0,-,-,78001
2056,1571,485,785,103700,78002
3538,2986,552,912,171800,78003
332,332,0,-,339300,78004
279,279,0,-,139400,78005
11169,8088,3081,1124,295700,78006
39,22,17,-,106300,78007
136,115,21,-,108900,78008
2778,2311,467,949,152100,78009
1260,1012,248,812,163100,78010
658,517,141,725,47100,78011
135,122,13,-,62300,78012
1900,1459,441,811,161500,78013
1847,1318,529,539,73900,78014
4605,4075,530,1567,415200,78015
3185,2515,670,586,94000,78016
1112,619,493,747,51100,78017
383,257,126,770,54300,78019
91,86,5,-,-,78021
1398,1091,307,823,89400,78022
8836,8085,751,1402,283900,78023
545,413,132,560,280400,78024
1721,1390,331,843,111200,78025
2023,1456,567,946,76800,78026
162,116,46,-,327700,78027
16545,11473,5072,805,166000,78028
0,0,0,-,-,78029
557,483,74,598,88500,78039
11524,5041,6483,641,74900,78040
13857,7572,6285,791,146200,78041
12199,6975,5224,767,94900,78043
104,62,42,-,-,78044
18358,14190,4168,1145,164900,78045
15866,11431,4435,800,84900,78046
189,86,103,548,78400,78050
2035,1653,382,688,109400,78052
635,477,158,800,165600,78055
756,717,39,-,348200,78056
267,246,21,-,-,78057
430,389,41,427,-,78058
2004,1851,153,666,133200,78059
12,12,0,-,-,78060
3003,2093,910,740,76900,78061
3849,3310,539,854,160100,78063
5466,3826,1640,861,144500,78064
3117,2356,761,695,86600,78065
133,103,30,-,-,78066
247,197,50,-,105000,78067
1656,1323,333,750,88800,78069
5585,4974,611,1183,294300,78070
1048,836,212,634,83200,78071
145,117,28,540,65900,78072
2383,1794,589,706,69600,78073
38,25,13,-,124000,78075
4067,2944,1123,508,60600,78076
2288,2147,141,1018,205500,78101
7216,4289,2927,866,81100,78102
35,26,9,-,-,78104
117,52,65,-,67500,78107
11132,8932,2200,1643,205200,78108
11853,8425,3428,1173,136200,78109
2190,1850,340,857,81200,78112
1074,816,258,1014,152800,78113
7438,5880,1558,857,149700,78114
142,125,17,-,219600,78116
192,159,33,738,212100,78117
1092,780,312,760,87100,78118
1861,1403,458,591,81700,78119
4249,3843,406,1105,230500,78121
137,114,23,-,-,78122
1114,819,295,825,135100,78123
2155,1788,367,866,156800,78124
38,31,7,-,-,78125
24974,16059,8915,1087,176800,78130
9376,8114,1262,1039,328400,78132
7702,6148,1554,1030,198900,78133
1172,783,389,629,66100,78140
204,173,31,688,79000,78141
48,34,14,-,105800,78142
90,90,0,-,-,78143
40,16,24,-,-,78144
35,27,8,-,113800,78145
165,123,42,-,59500,78146
659,452,207,728,131700,78147
7904,4516,3388,937,156000,78148
0,0,0,-,-,78150
495,340,155,531,102600,78151
699,616,83,938,186800,78152
13305,9383,3922,1190,180200,78154
17324,12234,5090,833,130800,78155
332,239,93,556,54300,78159
1654,1334,320,863,130600,78160
279,254,25,-,107900,78161
119,102,17,-,72000,78162
3637,3422,215,-,335400,78163
1365,1204,161,623,93300,78164
16324,7907,8417,764,87400,78201
3785,1923,1862,772,70300,78202
1927,928,999,771,64600,78203
4325,2432,1893,872,83500,78204
849,128,721,543,350800,78205
15490,7392,8098,629,57300,78207
1462,483,979,718,76300,78208
17804,10210,7594,1032,337500,78209
12754,6902,5852,766,84200,78210
9015,5623,3392,781,66000,78211
10784,5041,5743,775,137900,78212
16286,7703,8583,869,114000,78213
7555,4327,3228,719,70000,78214
1619,68,1551,1329,-,78215
17369,6220,11149,903,172300,78216
13986,5862,8124,895,128400,78217
12348,5752,6596,856,100600,78218
5718,2840,2878,877,80500,78219
5483,3075,2408,840,70100,78220
11591,7155,4436,793,79300,78221
7150,5194,1956,871,105800,78222
17603,10355,7248,786,87400,78223
5598,3400,2198,892,85300,78224
4289,2892,1397,769,66900,78225
2365,922,1443,668,67800,78226
14414,7358,7056,839,83500,78227
18808,11384,7424,806,88100,78228
14014,2272,11742,895,134700,78229
18555,9036,9519,958,210600,78230
3374,2435,939,1136,255300,78231
15784,9221,6563,1100,221100,78232
16942,10040,6902,1018,122500,78233
912,59,853,1679,-,78234
419,0,419,1299,-,78235
412,0,412,1699,-,78236
10856,6910,3946,777,58000,78237
9262,4044,5218,910,119600,78238
9086,6512,2574,1124,127300,78239
23773,8310,15463,972,156300,78240
8855,5035,3820,855,72300,78242
0,0,0,-,-,78243
9160,6377,2783,1192,112200,78244
20715,14235,6480,1156,136700,78245
17632,13441,4191,1173,162200,78247
5543,4298,1245,1191,298000,78248
19314,10924,8390,1169,175600,78249
18796,13937,4859,1105,134500,78250
19954,11184,8770,1074,157500,78251
2415,1865,550,1170,109600,78252
12417,10004,2413,1392,224400,78253
16376,13071,3305,1234,172700,78254
4358,3811,547,1458,300300,78255
3577,1535,2042,1274,389300,78256
2186,1505,681,1166,578100,78257
15977,10475,5502,1369,305200,78258
8832,6437,2395,1269,240700,78259
8539,7522,1017,1723,301500,78260
5506,4401,1105,1567,272800,78261
1666,1422,244,887,186700,78263
2888,2412,476,898,80300,78264
2367,2211,156,1855,374900,78266
345,288,57,790,69700,78330
9597,6404,3193,736,72600,78332
0,0,0,-,-,78335
4502,2632,1870,852,120000,78336
10,3,7,-,-,78338
171,96,75,827,-,78339
188,159,29,638,83400,78340
864,585,279,498,43200,78341
124,73,51,820,-,78342
1496,1090,406,698,80900,78343
116,88,28,-,98000,78344
248,243,5,-,40500,78349
120,99,21,1063,33100,78351
81,81,0,-,24200,78352
118,95,23,-,61300,78353
1992,1230,762,600,62500,78355
921,626,295,715,54900,78357
321,136,185,939,36400,78358
657,437,220,809,61600,78359
1610,1228,382,500,63000,78361
3555,2505,1050,979,122600,78362
10454,5386,5068,799,86900,78363
3271,2436,835,592,61900,78368
139,101,38,-,52100,78369
1549,1160,389,744,79000,78370
118,87,31,-,63200,78371
1773,1325,448,781,83800,78372
1993,1201,792,1204,250600,78373
6141,4009,2132,1202,158400,78374
1020,799,221,729,66700,78375
271,190,81,528,36600,78376
1398,945,453,595,79700,78377
503,421,82,854,78300,78379
7556,5235,2321,708,80400,78380
8139,6224,1915,785,166100,78382
1624,1476,148,618,123100,78383
1793,1020,773,724,43500,78384
124,40,84,473,20000,78385
3276,2291,985,715,70400,78387
526,424,102,-,65100,78389
1806,1179,627,739,70400,78390
76,69,7,-,57500,78391
751,606,145,952,80500,78393
1811,344,1467,668,60900,78401
155,64,91,1264,141700,78402
7170,3492,3678,899,94700,78404
5326,2940,2386,686,51300,78405
364,322,42,1250,54300,78406
1202,593,609,845,59600,78407
4129,1953,2176,711,69400,78408
972,534,438,683,81500,78409
9464,6286,3178,1015,139300,78410
10166,6327,3839,934,113600,78411
14707,6673,8034,974,120400,78412
15007,8390,6617,1104,167700,78413
13884,9116,4768,1174,191700,78414
13513,7855,5658,875,88600,78415
5093,3061,2032,836,69500,78416
1347,1033,314,692,82100,78417
12510,7307,5203,1042,171500,78418
204,4,200,1625,-,78419
20766,10486,10280,684,98300,78501
6585,4244,2341,807,93200,78503
17107,11806,5301,876,148400,78504
9371,7112,2259,547,52600,78516
18022,10953,7069,613,83800,78520
25228,14993,10235,683,69000,78521
12687,9472,3215,831,108100,78526
213,160,53,808,63500,78535
99,83,16,-,32800,78536
11856,8843,3013,568,56000,78537
3093,2306,787,557,52300,78538
10974,6392,4582,759,125700,78539
12922,6925,5997,741,82700,78541
16874,12716,4158,606,77700,78542
2333,1567,766,552,57400,78543
150,110,40,-,50700,78545
163,159,4,-,47500,78548
262,219,43,-,71700,78549
16665,8911,7754,690,80000,78550
11775,9281,2494,816,100000,78552
3486,2526,960,618,88700,78557
266,208,58,-,72200,78558
3826,2906,920,606,69100,78559
1328,867,461,686,83600,78560
175,141,34,566,36500,78561
798,605,193,500,45900,78562
73,56,17,-,137500,78563
38,0,38,-,-,78564
73,51,22,-,-,78565
4749,3540,1209,694,89300,78566
175,162,13,-,52300,78567
1185,1017,168,582,57100,78569
9049,6433,2616,553,59600,78570
24234,16759,7475,746,84500,78572
9660,6513,3147,675,88500,78573
15286,11617,3669,675,79800,78574
2838,2237,601,788,127200,78575
2590,1902,688,654,62000,78576
21433,13091,8342,735,74900,78577
4373,3043,1330,729,117600,78578
1112,913,199,561,56700,78579
3770,2755,1015,578,49500,78580
10623,8048,2575,528,66400,78582
2567,2202,365,456,59800,78583
5115,3580,1535,521,71400,78584
125,125,0,-,-,78585
15606,11776,3830,609,59300,78586
66,51,15,-,-,78588
10499,8074,2425,644,83300,78589
72,65,7,-,33400,78590
84,61,23,-,-,78591
282,230,52,590,34100,78592
1596,1130,466,588,54000,78593
491,430,61,-,43900,78594
1747,1421,326,565,60900,78595
18746,13297,5449,670,74900,78596
1586,1072,514,957,288000,78597
46,46,0,-,115600,78598
9098,6798,2300,871,165000,78602
1938,1618,320,869,151200,78605
2094,1659,435,793,242300,78606
62,55,7,-,-,78607
162,104,58,-,160200,78608
949,740,209,743,162900,78609
11243,8774,2469,1179,224600,78610
4598,3314,1284,832,159000,78611
3824,3010,814,1172,145500,78612
25202,17956,7246,1299,255200,78613
235,175,60,838,169300,78614
359,296,63,875,160900,78615
2372,1690,682,822,114600,78616
6520,5049,1471,1303,123900,78617
143,123,20,860,287500,78618
1439,1350,89,-,445600,78619
5445,4733,712,1113,352300,78620
7276,5559,1717,914,137300,78621
79,59,20,917,41500,78622
329,269,60,541,222500,78623
9050,6709,2341,879,278100,78624
10167,6667,3500,994,188400,78626
10823,7932,2891,1108,267200,78628
4300,2787,1513,644,112000,78629
1097,900,197,-,202900,78631
367,328,39,975,131400,78632
11332,10447,885,1608,285300,78633
8805,7000,1805,1232,171300,78634
66,25,41,-,-,78635
1541,1123,418,774,221400,78636
843,657,186,682,127400,78638
3272,2283,989,834,118500,78639
16074,11614,4460,1339,160500,78640
18662,15129,3533,1364,213100,78641
3431,2918,513,852,258600,78642
2257,1692,565,753,179000,78643
5848,3875,1973,860,132900,78644
4600,3725,875,1096,207300,78645
2919,1982,937,650,113900,78648
573,453,120,918,137500,78650
1913,1330,583,1231,239500,78652
6332,5210,1122,1273,160600,78653
7111,5326,1785,822,182400,78654
1115,834,281,841,163900,78655
806,477,329,846,104600,78656
2614,2147,467,1067,314300,78657
1000,822,178,676,144700,78659
28469,21486,6983,1312,198500,78660
152,118,34,747,95000,78661
869,784,85,913,163200,78662
348,283,65,-,-,78663
20346,11321,9025,1137,172900,78664
14246,10498,3748,1288,230000,78665
27735,10057,17678,962,148300,78666
4254,3728,526,1077,418500,78669
66,39,27,928,112500,78670
271,242,29,-,170000,78671
623,578,45,-,117700,78672
154,144,10,-,-,78675
5539,4569,970,1232,245200,78676
18,18,0,-,-,78677
17274,13562,3712,1223,256100,78681
4855,1702,3153,1847,476700,78701
8937,4183,4754,1020,297700,78702
9723,5051,4672,1319,767400,78703
23213,7970,15243,1235,464400,78704
8370,890,7480,1198,417800,78705
0,0,0,-,-,78712
9846,6016,3830,1250,319800,78717
500,372,128,859,129700,78719
4197,2427,1770,990,212400,78721
3111,1419,1692,1280,358900,78722
12518,5352,7166,964,268700,78723
6360,3847,2513,1091,122100,78724
2544,2033,511,1338,137800,78725
5554,2569,2985,1136,392800,78726
12937,6179,6758,1219,249700,78727
10029,2838,7191,1093,205500,78728
12622,5426,7196,1178,234200,78729
3678,2234,1444,1281,659400,78730
12556,7036,5520,1231,572700,78731
5689,4469,1220,1466,495800,78732
2920,2645,275,1511,533800,78733
7392,5929,1463,1715,377400,78734
7193,3835,3358,1362,463200,78735
3023,2472,551,1425,313700,78736
5305,4894,411,1979,394600,78737
5964,4340,1624,1435,496300,78738
6367,6044,323,2339,426700,78739
20758,3107,17651,1002,156800,78741
218,126,92,1048,86100,78742
14345,6509,7836,1104,121500,78744
25857,11931,13926,1218,229200,78745
10848,7765,3083,1456,812900,78746
6364,4630,1734,1387,203800,78747
18820,11402,7418,1326,238600,78748
15215,9417,5798,1335,296900,78749
11713,7391,4322,1255,359500,78750
7463,2229,5234,1200,395200,78751
7932,2165,5767,962,233900,78752
19947,7118,12829,1003,161000,78753
8009,3987,4022,1183,183200,78754
4246,2040,2206,1213,476700,78756
10746,6009,4737,1120,348600,78757
19397,5543,13854,1072,178100,78758
20240,9357,10883,1203,389900,78759
6970,4941,2029,632,76700,78801
163,125,38,-,-,78802
420,285,135,467,60700,78827
31,31,0,-,101600,78828
312,258,54,655,41200,78829
258,212,46,675,43800,78830
1200,928,272,513,64200,78832
496,340,156,767,76500,78833
2721,1877,844,758,71700,78834
64,64,0,-,39100,78836
76,70,6,-,-,78837
104,104,0,-,239700,78838
2706,1820,886,538,38200,78839
15070,9493,5577,687,94900,78840
14,0,14,-,-,78843
415,390,25,-,142300,78850
11,9,2,-,-,78851
15947,10779,5168,627,94800,78852
45,45,0,-,-,78860
3743,2750,993,780,127900,78861
335,236,99,534,75000,78870
18,18,0,-,-,78871
531,384,147,529,46200,78872
645,527,118,913,112300,78873
364,286,78,-,155600,78877
82,75,7,-,149200,78879
539,463,76,400,66600,78880
749,617,132,760,65600,78881
123,101,22,900,-,78883
382,338,44,477,173200,78884
42,38,4,-,-,78885
154,129,25,-,176000,78886
112,90,22,-,-,78931
226,162,64,723,120900,78932
504,442,62,-,164000,78933
2267,1769,498,647,138000,78934
430,418,12,-,286300,78935
105,82,23,-,94500,78938
924,844,80,750,175800,78940
1013,809,204,586,148200,78941
2902,2002,900,877,118500,78942
97,97,0,-,-,78943
239,210,29,588,167900,78944
3701,2904,797,870,176600,78945
414,335,79,836,185100,78946
1720,1470,250,831,201700,78947
268,251,17,-,212800,78948
236,200,36,527,150400,78949
816,721,95,717,172800,78950
0,0,0,-,-,78951
362,316,46,1302,129000,78953
567,525,42,740,291100,78954
2041,1564,477,773,136600,78956
3623,2745,878,914,151200,78957
693,560,133,463,76000,78959
2076,1740,336,862,112300,78962
369,363,6,-,118200,78963
90,67,23,-,97000,79001
77,47,30,-,103000,79003
606,439,167,679,125200,79005
5131,3844,1287,722,77000,79007
616,359,257,644,75500,79009
190,112,78,-,-,79010
111,75,36,-,68500,79011
461,406,55,-,263100,79012
944,550,394,549,55400,79013
1334,913,421,805,136700,79014
7616,4838,2778,790,182600,79015
0,0,0,-,-,79016
147,66,81,668,56700,79018
634,507,127,732,131700,79019
49,14,35,-,73300,79021
3495,2158,1337,726,100800,79022
176,127,49,850,80400,79024
20,10,10,-,-,79025
1582,915,667,611,81800,79027
4959,3146,1813,768,118400,79029
486,352,134,650,77900,79031
45,29,16,-,93900,79032
38,32,6,-,-,79033
210,170,40,694,92700,79034
1573,1104,469,676,78600,79035
1940,1780,160,714,72900,79036
377,327,50,580,113200,79039
608,392,216,732,95000,79040
1171,842,329,653,70300,79041
452,345,107,717,72400,79042
438,314,124,775,49800,79043
279,123,156,625,109500,79044
6143,3994,2149,764,87500,79045
251,179,72,880,79500,79046
16,0,16,-,-,79051
415,316,99,610,77500,79052
55,31,24,520,123800,79053
223,175,48,588,31800,79054
24,20,4,-,90000,79056
538,410,128,535,47100,79057
0,0,0,-,-,79058
276,211,65,893,123600,79059
136,84,52,528,70800,79061
74,54,20,-,45600,79062
236,211,25,522,152600,79063
887,574,313,599,60900,79064
7290,5463,1827,760,74700,79065
1135,935,200,711,123700,79068
3428,2447,981,733,103500,79070
8489,4836,3653,641,83800,79072
113,103,10,625,-,79078
1181,725,456,598,84600,79079
237,200,37,825,39100,79080
1359,1044,315,647,99200,79081
83,71,12,-,101600,79082
811,641,170,840,69300,79083
806,659,147,633,87500,79084
12,12,0,-,-,79085
821,604,217,695,84600,79086
250,170,80,720,83300,79087
1944,1322,622,657,71300,79088
52,52,0,-,78500,79091
357,313,44,904,92400,79092
37,37,0,-,-,79093
23,23,0,-,59600,79094
968,772,196,620,56800,79095
852,578,274,713,87700,79096
372,331,41,917,106200,79097
156,130,26,825,113200,79098
1062,120,942,708,77400,79101
3881,2016,1865,644,98600,79102
3836,2845,991,871,85300,79103
2324,1405,919,722,58800,79104
0,0,0,-,-,79105
11622,6059,5563,754,111300,79106
11342,6773,4569,734,64000,79107
4351,3385,966,807,109400,79108
18365,10934,7431,772,157200,79109
7017,4926,2091,899,109700,79110
503,11,492,963,-,79111
7576,5908,1668,1081,150100,79118
6065,4594,1471,976,254200,79119
2859,1960,899,836,186500,79121
3335,2736,599,1017,224400,79124
2296,1268,1028,749,81400,79201
108,52,56,569,104700,79220
373,279,94,538,42300,79225
1082,792,290,637,67400,79226
582,466,116,517,46900,79227
156,129,27,550,49300,79229
60,56,4,-,-,79230
27,0,27,-,-,79231
40,27,13,730,26300,79233
27,19,8,-,58800,79234
1373,1077,296,713,49600,79235
92,17,75,700,36900,79236
167,126,41,544,58800,79237
75,43,32,-,37100,79239
0,0,0,-,-,79240
901,591,310,686,75900,79241
24,14,10,-,103100,79243
280,203,77,527,58700,79244
974,607,367,530,49900,79245
27,24,3,-,27500,79247
639,407,232,288,42300,79248
533,403,130,652,62400,79250
15,15,0,-,63600,79251
1186,889,297,496,38000,79252
263,173,90,592,104700,79255
152,104,48,615,54800,79256
396,333,63,625,54400,79257
19,19,0,-,70700,79258
11,11,0,-,-,79259
158,116,42,606,55000,79261
1297,960,337,686,82100,79311
379,277,102,471,58600,79312
593,409,184,600,58400,79313
39,29,10,-,30300,79314
3704,2567,1137,732,68000,79316
743,534,209,628,55000,79322
2208,1739,469,708,84800,79323
17,17,0,-,269600,79324
859,653,206,684,116200,79325
66,66,0,-,850000,79326
1135,852,283,698,140300,79329
75,61,14,-,226500,79330
4207,2991,1216,570,67300,79331
6046,4034,2012,671,89200,79336
2311,1581,730,688,61100,79339
166,67,99,425,74200,79342
530,324,206,565,68200,79343
18,10,8,-,-,79344
312,243,69,575,71100,79345
795,610,185,516,33100,79346
2312,1645,667,808,69800,79347
109,79,30,695,71800,79350
491,340,151,594,65200,79351
11,2,9,-,-,79353
651,468,183,830,80900,79355
1618,1043,575,750,73700,79356
779,538,241,653,54800,79357
389,329,60,918,75400,79358
879,598,281,682,50000,79359
4447,3526,921,731,121700,79360
1931,1436,495,817,128900,79363
3144,2070,1074,688,75300,79364
508,453,55,833,210700,79366
240,177,63,1000,73500,79367
52,52,0,-,-,79369
564,420,144,476,53600,79370
533,430,103,594,61900,79371
422,303,119,723,73400,79372
1159,742,417,650,72200,79373
22,22,0,-,-,79376
78,61,17,760,68600,79377
113,74,39,353,-,79378
170,126,44,433,47100,79379
60,36,24,781,45000,79380
512,395,117,783,112200,79381
2465,1847,618,873,179900,79382
3203,358,2845,943,70400,79401
5431,3419,2012,762,54100,79403
3243,1987,1256,740,47400,79404
0,0,0,-,-,79406
8690,4103,4587,772,101400,79407
3803,1595,2208,1084,128700,79410
3225,1252,1973,890,64400,79411
5541,2793,2748,833,77500,79412
8442,4822,3620,1012,132200,79413
7745,3101,4644,854,91500,79414
6270,2467,3803,796,57100,79415
12882,6267,6615,1006,118600,79416
14189,10095,4094,976,138900,79423
18348,12692,5656,923,187800,79424
1206,930,276,757,71000,79501
423,317,106,496,52100,79502
90,80,10,-,-,79503
1217,1024,193,688,64500,79504
119,96,23,-,41700,79505
339,274,65,471,81400,79506
492,408,84,743,168800,79508
2689,2205,484,778,82200,79510
552,498,54,728,103500,79511
2235,1671,564,636,69000,79512
105,84,21,-,210000,79517
28,28,0,-,75700,79518
31,31,0,-,151800,79519
967,713,254,753,62500,79520
1244,968,276,485,58600,79521
1039,747,292,763,100300,79525
348,267,81,850,77600,79526
77,66,11,-,-,79527
241,173,68,475,60700,79528
527,435,92,524,44300,79529
185,172,13,700,51600,79530
312,252,60,543,47700,79532
146,98,48,389,31200,79533
30,24,6,-,-,79534
76,71,5,-,54500,79535
1830,1369,461,841,72100,79536
21,21,0,-,-,79537
106,99,7,-,-,79538
80,61,19,525,31500,79539
21,21,0,-,81700,79540
339,306,33,-,259600,79541
483,363,120,596,64700,79543
220,174,46,570,35000,79544
684,568,116,634,76600,79545
806,529,277,532,56900,79546
320,224,96,621,32100,79547
63,54,9,-,72300,79548
5383,3973,1410,735,91100,79549
1424,993,431,546,47600,79553
4783,3205,1578,634,64800,79556
68,55,13,-,76500,79560
272,194,78,618,63300,79561
1329,1238,91,891,162000,79562
378,266,112,731,58800,79563
101,87,14,-,46400,79565
125,111,14,-,241700,79566
1283,821,462,539,43400,79567
7804,3624,4180,774,88900,79601
8090,5779,2311,819,150600,79602
8668,5462,3206,714,71800,79603
11217,6165,5052,837,99900,79605
9623,5309,4314,930,169700,79606
628,0,628,1194,-,79607
0,0,0,-,-,79699
9587,6272,3315,935,114000,79701
7465,5097,2368,1225,143000,79703
14061,9713,4348,1221,226700,79705
7555,5898,1657,1111,151000,79706
14560,8864,5696,1264,276400,79707
132,92,40,525,107500,79713
5413,3981,1432,997,126000,79714
295,212,83,663,42900,79718
189,134,55,663,37100,79719
10505,7040,3465,841,85200,79720
115,100,15,-,29200,79730
1458,1126,332,702,84800,79731
68,44,24,429,71300,79733
953,780,173,688,113000,79734
3609,2517,1092,872,70100,79735
106,73,33,-,61300,79738
387,280,107,860,214300,79739
121,104,17,-,67600,79741
175,127,48,-,30100,79742
120,79,41,431,63100,79743
494,321,173,732,77000,79744
2232,1736,496,843,57300,79745
53,50,3,-,-,79748
103,77,26,431,187500,79749
864,638,226,549,58200,79752
28,16,12,930,-,79754
73,30,43,711,-,79755
3307,2303,1004,815,89900,79756
784,567,217,833,141400,79758
8,8,0,-,-,79759
11226,7183,4043,897,123100,79761
15613,8849,6764,1067,148300,79762
11485,7784,3701,862,99000,79763
7390,5509,1881,936,83300,79764
4917,3492,1425,1359,212500,79765
1780,1436,344,832,93300,79766
11,11,0,-,-,79770
3348,2397,951,798,56200,79772
90,42,48,-,60000,79777
360,286,74,557,80000,79778
63,48,15,-,-,79780
111,80,31,680,32500,79781
1307,991,316,819,113800,79782
99,87,12,-,201600,79783
31,23,8,-,-,79785
173,141,32,675,42200,79788
278,224,54,678,63300,79789
1775,1232,543,610,94100,79821
3215,1707,1508,634,131700,79830
10,4,6,-,-,79831
81,1,80,566,-,79834
3206,2097,1109,694,77100,79835
1736,1404,332,636,83000,79836
179,93,86,-,29400,79837
2020,1289,731,513,58300,79838
429,358,71,594,45400,79839
258,179,79,542,94200,79842
802,557,245,727,107600,79843
1755,986,769,438,44000,79845
17,0,17,-,-,79846
60,18,42,2013,18300,79847
325,254,71,744,66700,79848
3274,2339,935,637,67000,79849
213,120,93,576,44500,79851
368,264,104,367,76900,79852
720,576,144,472,52400,79853
59,26,33,512,44400,79854
715,490,225,535,57000,79855
3929,416,3513,380,53200,79901
8097,3358,4739,603,152900,79902
6042,3489,2553,563,88900,79903
10835,4724,6111,818,100400,79904
7682,4075,3607,453,80000,79905
1166,0,1166,1326,-,79906
16252,9708,6544,661,87800,79907
729,0,729,1565,-,79908
1524,1213,311,1453,222500,79911
28546,15413,13133,889,185500,79912
12338,7329,5009,595,86100,79915
5,0,5,-,-,79916
0,0,0,-,-,79920
2723,2318,405,805,274900,79922
19629,12121,7508,840,99000,79924
14706,7674,7032,799,137900,79925
11028,8210,2818,705,86100,79927
15175,12511,2664,960,116000,79928
10286,4844,5442,727,91900,79930
8927,6443,2484,849,157100,79932
8571,5910,2661,1151,134400,79934
6242,3507,2735,787,143000,79935
34781,23930,10851,949,124000,79936
21340,16054,5286,1010,139400,79938
9,9,0,-,-,79942
8194,4440,3754,1064,263500,80002
14129,9908,4221,1203,249500,80003
15033,10510,4523,1151,311300,80004
11069,9654,1415,1398,351800,80005
3649,3558,91,2316,557600,80007
13531,4392,9139,914,177900,80010
16119,8164,7955,1107,166900,80011
18691,8592,10099,1082,209700,80012
25105,18399,6706,1382,244500,80013
17932,10044,7888,1205,216700,80014
22231,17862,4369,1461,304100,80015
17545,13680,3865,1470,446200,80016
12776,6886,5890,1176,194400,80017
3737,3187,550,1637,314900,80018
940,634,306,1130,254300,80019
19448,13776,5672,1454,310700,80020
13957,7646,6311,1449,289500,80021
13952,9408,4544,1066,229500,80022
7559,6409,1150,1579,498700,80023
103,66,37,841,115000,80024
109,91,18,-,-,80025
11886,8753,3133,1287,353200,80026
12799,8492,4307,1618,489000,80027
6163,3396,2767,892,210600,80030
13273,9601,3672,1327,277400,80031
11801,6207,5594,979,298900,80033
486,0,486,1513,-,80045
155,125,30,925,271500,80101
2043,1767,276,1123,288400,80102
946,816,130,1125,251700,80103
10599,8126,2473,1392,326800,80104
504,426,78,645,197900,80105
1814,1701,113,1008,378500,80106
4433,4044,389,1175,390100,80107
8916,7249,1667,1484,541200,80108
6933,5897,1036,1726,390000,80109
9020,5138,3882,1118,235900,80110
12447,7676,4771,1509,579200,80111
13226,7902,5324,1467,380600,80112
10058,5798,4260,994,365300,80113
1436,1307,129,-,555300,80116
1108,979,129,1140,316100,80117
2412,2227,185,2032,536800,80118
13684,7956,5728,1079,328000,80120
7463,6215,1248,1218,388100,80121
12516,10531,1985,1519,355500,80122
19296,13882,5414,1361,332200,80123
8051,5070,2981,1569,474500,80124
3732,3556,176,1808,395900,80125
15456,13031,2425,1601,416100,80126
16349,14270,2079,1419,379400,80127
13896,11512,2384,1377,313500,80128
10798,8367,2431,1721,394100,80129
9957,7697,2260,1905,405600,80130
116,90,26,-,235400,80131
7317,6601,716,1540,424700,80132
980,676,304,1000,221400,80133
22323,18234,4089,1584,379400,80134
1540,1373,167,1310,541800,80135
1777,1579,198,1113,256800,80136
413,302,111,1080,418800,80137
11416,9380,2036,1443,405400,80138
8345,2559,5786,1687,458300,80202
14170,2844,11326,1007,286500,80203
12668,4423,8245,854,260100,80204
13886,6135,7751,1165,332500,80205
13079,6258,6821,1075,543700,80206
9976,6843,3133,1149,364100,80207
13544,6951,6593,1389,581200,80209
15287,9567,5720,1183,523100,80210
15937,8507,7430,1077,404500,80211
9049,5683,3366,1043,387300,80212
11631,4270,7361,956,281700,80214
8402,4949,3453,1077,381400,80215
3626,1453,2173,1144,165100,80216
11250,3707,7543,1079,378600,80218
20554,10736,9818,1010,196500,80219
16162,9614,6548,1045,419300,80220
13831,8728,5103,1101,215000,80221
10508,5316,5192,1104,315000,80222
7539,3813,3726,995,223500,80223
8376,4685,3691,1101,335300,80224
13344,7708,5636,1243,272900,80226
14975,9342,5633,1198,283700,80227
14026,9135,4891,1238,341400,80228
17881,10923,6958,1191,189400,80229
4130,2239,1891,1385,547200,80230
16941,5695,11246,1122,283800,80231
9126,6755,2371,1171,272900,80232
17240,10129,7111,1320,234400,80233
10563,6206,4357,1193,284300,80234
3516,1872,1644,1132,287100,80235
6428,3748,2680,1073,267100,80236
10209,4960,5249,1388,362100,80237
6281,4742,1539,1715,519000,80238
11637,6737,4900,1307,202500,80239
11532,8770,2762,1454,284500,80241
7373,1415,5958,1047,291600,80246
14069,5516,8553,1152,163300,80247
9073,6983,2090,1606,241400,80249
11736,6834,4902,1075,107300,80260
0,0,0,-,-,80264
0,0,0,-,-,80290
0,0,0,-,-,80293
0,0,0,-,-,80294
11469,7244,4225,1442,454500,80301
11822,4541,7281,1397,665200,80302
11331,5064,6267,1293,602400,80303
11082,7590,3492,1435,700800,80304
7094,4351,2743,1785,615000,80305
129,0,129,875,-,80310
16085,11019,5066,1267,434200,80401
7879,6614,1265,1444,457700,80403
0,0,0,-,-,80419
350,215,135,1189,284700,80420
3738,3034,704,1160,260700,80421
1931,1717,214,1067,307300,80422
27,23,4,-,-,80423
3015,2067,948,1402,530600,80424
111,111,0,-,471600,80425
47,43,4,-,505700,80426
477,175,302,1003,206400,80427
258,231,27,-,463500,80428
146,128,18,-,-,80432
3392,2915,477,1454,401900,80433
15,15,0,-,67500,80434
2147,1460,687,1306,528100,80435
247,235,12,-,272800,80436
229,178,51,700,155800,80438
9922,8463,1459,1529,473000,80439
982,665,317,1154,256000,80440
760,366,394,991,278200,80442
1666,1047,619,1419,590500,80443
643,421,222,852,258000,80444
1588,1098,490,1173,258600,80446
791,731,60,650,377800,80447
108,70,38,-,-,80448
440,435,5,-,194200,80449
328,193,135,1060,195300,80451
1516,1021,495,869,242200,80452
169,127,42,1164,310300,80453
481,396,85,-,390700,80454
254,156,98,1304,323700,80455
429,343,86,-,283500,80456
118,35,83,1310,236500,80457
919,611,308,848,205700,80459
3234,1834,1400,894,193000,80461
76,66,10,-,258300,80463
6166,5583,583,1390,346800,80465
1548,908,640,1026,392500,80466
978,700,278,1142,233800,80467
194,155,39,-,293400,80468
195,120,75,1115,165900,80469
1337,1250,87,993,326400,80470
0,0,0,-,-,80471
2,2,0,-,-,80473
33,0,33,-,-,80475
98,67,31,725,197300,80476
70,60,10,-,772700,80477
602,482,120,1080,250000,80478
5,5,0,-,-,80479
580,403,177,706,175900,80480
311,288,23,1672,532900,80481
530,299,231,893,444200,80482
242,163,79,1014,226700,80483
6731,4550,2181,1201,564000,80487
37,0,37,-,-,80488
206,186,20,-,372700,80497
2421,1527,894,1301,568700,80498
16453,8701,7752,1026,246900,80501
13034,9014,4020,1213,411500,80503
18273,15187,3086,1358,325200,80504
223,153,70,925,386200,80510
0,0,0,-,-,80511
847,792,55,1037,313300,80512
4521,3840,681,969,349800,80513
1907,1281,626,970,203900,80514
428,373,55,-,243700,80515
8626,7524,1102,1703,408000,80516
4767,3187,1580,897,369500,80517
524,370,154,1326,173800,80520
13143,4988,8155,1147,314400,80521
14275,9620,4655,1031,298900,80524
21260,13158,8102,1193,325200,80525
18114,10690,7424,1204,299200,80526
7138,5690,1448,1497,384400,80528
1594,1379,215,1185,221000,80530
43,43,0,-,-,80532
5745,4984,761,1613,289300,80534
1210,812,398,916,281600,80535
1037,882,155,1097,298500,80536
17798,11086,6712,1019,276500,80537
18832,13321,5511,1133,265700,80538
1762,1487,275,1354,457700,80540
1472,1429,43,1823,347300,80542
2325,2101,224,1423,212100,80543
68,68,0,-,-,80544
352,323,29,-,241800,80545
84,84,0,-,201400,80546
675,626,49,1188,448600,80547
3622,2996,626,1271,256300,80549
9550,7999,1551,1229,333800,80550
12194,7820,4374,1142,243400,80601
10619,9799,820,1747,371800,80602
4417,3802,615,1265,281900,80603
1215,850,365,892,241400,80610
286,228,58,771,248300,80611
179,164,15,-,280000,80612
2873,2202,671,909,267400,80615
6378,3705,2673,1035,167200,80620
4294,3093,1201,870,213400,80621
71,60,11,-,276500,80622
328,259,69,886,160200,80623
469,286,183,905,343300,80624
17453,8102,9351,795,153500,80631
21266,14908,6358,1068,229600,80634
3584,2760,824,1367,277300,80640
1265,1020,245,964,310600,80642
1287,1075,212,1058,306700,80643
1178,749,429,798,194900,80644
1592,1150,442,1015,201000,80645
439,379,60,1196,267200,80648
147,97,50,718,187500,80649
589,470,119,761,180800,80650
1419,1065,354,834,261200,80651
246,193,53,-,135300,80652
369,270,99,642,182500,80653
1035,759,276,845,220800,80654
5753,3630,2123,741,165000,80701
445,274,171,796,80000,80705
1146,813,333,679,108400,80720
106,63,43,-,92400,80721
128,58,70,773,170000,80722
2651,1644,1007,797,150800,80723
294,242,52,730,162300,80726
206,73,133,830,65000,80727
391,313,78,621,125500,80728
243,163,80,812,200900,80729
569,436,133,609,126100,80731
198,148,50,1000,115900,80733
1109,723,386,671,147100,80734
131,69,62,839,247500,80735
204,167,37,675,128500,80736
676,453,223,512,102400,80737
68,44,24,750,187500,80740
324,229,95,900,121400,80741
97,80,17,-,65000,80742
446,304,142,683,148600,80743
187,152,35,554,71200,80744
93,78,15,-,180900,80745
26,25,1,-,90500,80746
147,127,20,600,118200,80747
135,105,30,588,85000,80749
92,45,47,679,-,80750
6545,3813,2732,711,149200,80751
69,47,22,-,275000,80754
43,23,20,-,146900,80755
96,60,36,244,130000,80757
1387,784,603,706,140000,80758
2043,1382,661,636,160900,80759
62,53,9,-,118800,80801
111,83,28,-,108800,80802
126,90,36,483,71100,80804
188,152,36,725,128100,80805
1808,1229,579,823,133400,80807
2274,1658,616,811,202700,80808
630,544,86,1108,245300,80809
462,331,131,533,94600,80810
97,86,11,-,106600,80812
761,451,310,843,167500,80813
1439,1271,168,1131,249400,80814
361,281,80,563,147900,80815
2511,2135,376,1080,222800,80816
10173,6824,3349,1265,205100,80817
139,116,23,-,117700,80818
360,222,138,856,251200,80819
407,407,0,-,270800,80820
404,295,109,689,127500,80821
82,66,16,-,210000,80822
61,42,19,631,110700,80823
93,66,27,-,170800,80824
170,125,45,675,78000,80825
333,333,0,-,307000,80827
725,471,254,827,165200,80828
2702,1700,1002,891,325400,80829
102,81,21,-,-,80830
8027,6883,1144,1600,275700,80831
259,225,34,788,187000,80832
250,190,60,675,188200,80833
131,96,35,579,97100,80834
370,272,98,680,156800,80835
478,302,176,665,141700,80836
533,0,533,1519,-,80840
326,247,79,606,102800,80860
91,79,12,1025,158800,80861
25,23,2,-,-,80862
5148,4086,1062,1161,298500,80863
521,394,127,968,203600,80864
2945,11,2934,1469,-,80902
7078,2713,4365,765,216300,80903
10156,5615,4541,900,237200,80904
7425,3540,3885,860,198300,80905
14915,9255,5660,1120,322200,80906
12516,7208,5308,870,193500,80907
5601,5269,332,1946,440800,80908
16129,7551,8578,785,180900,80909
11649,4570,7079,856,141200,80910
11684,9403,2281,1225,178400,80911
20,0,20,-,-,80913
22,0,22,2156,-,80914
7836,5287,2549,960,170500,80915
13828,6692,7136,1029,150000,80916
12865,7323,5542,918,209400,80917
18626,11148,7478,1147,223900,80918
10964,8332,2632,1217,340400,80919
13562,10065,3497,1369,292300,80920
7530,5772,1758,1472,401400,80921
9443,6844,2599,1502,231200,80922
10202,7314,2888,1543,256100,80923
2486,1819,667,1888,422100,80924
2860,2205,655,1656,253600,80925
645,538,107,498,242500,80926
892,739,153,1972,345100,80927
456,386,70,1052,156300,80928
110,49,61,-,234400,80929
659,248,411,1445,194200,80930
32,32,0,-,-,80938
0,0,0,-,-,80939
1525,1053,472,1635,224700,80951
12010,6063,5947,746,111100,81001
5730,2409,3321,654,88800,81003
10755,5239,5516,758,94300,81004
12322,8654,3668,814,148500,81005
4431,3678,753,849,174000,81006
11266,9081,2185,968,188400,81007
4357,2837,1520,1029,165800,81008
622,488,134,894,171800,81019
406,279,127,640,161600,81020
8,3,5,-,-,81021
503,392,111,762,170600,81022
570,496,74,-,210700,81023
120,93,27,-,-,81024
372,271,101,-,97100,81025
86,65,21,-,41700,81027
96,60,36,358,-,81029
56,47,9,555,65000,81030
55,40,15,660,46700,81033
419,335,84,643,81800,81036
0,0,0,-,-,81038
722,472,250,598,104500,81039
220,212,8,-,100000,81040
247,152,95,567,74300,81041
26,17,9,-,-,81043
126,80,46,-,74600,81044
28,27,1,-,62500,81045
607,430,177,575,108500,81047
137,95,42,-,210700,81049
3792,2259,1533,743,97100,81050
3733,2383,1350,701,93900,81052
1371,840,531,671,70500,81054
752,544,208,964,222000,81055
186,117,69,725,96900,81057
403,282,121,539,78800,81058
71,57,14,-,-,81059
371,287,84,-,79200,81062
511,367,144,671,69700,81063
120,97,23,390,68800,81064
2378,1663,715,697,86300,81067
720,669,51,770,207500,81069
121,73,48,553,114400,81071
845,634,211,549,81700,81073
237,172,65,940,107400,81076
243,160,83,538,121500,81077
41,35,6,-,342000,81081
5135,3304,1831,696,142900,81082
72,35,37,-,-,81084
60,40,20,715,70000,81087
2017,1342,675,596,100300,81089
429,291,138,512,81200,81090
330,243,87,865,212500,81091
372,284,88,623,101700,81092
5744,3239,2505,656,153000,81101
928,682,246,470,98200,81120
141,118,23,850,233300,81121
3345,2671,674,1174,289800,81122
344,248,96,908,104000,81123
49,36,13,-,160400,81124
1206,716,490,577,85000,81125
135,123,12,-,90500,81126
61,36,25,-,600000,81128
63,48,15,-,67500,81129
398,336,62,638,274400,81130
609,482,127,826,199300,81131
1303,992,311,614,110900,81132
427,321,106,626,143000,81133
83,62,21,392,108300,81136
2229,1553,676,964,234100,81137
42,21,21,-,-,81138
849,657,192,581,136200,81140
457,380,77,555,116300,81141
323,255,68,690,75900,81143
2816,1723,1093,583,145300,81144
243,162,81,775,152600,81146
5254,3835,1419,909,272100,81147
126,109,17,838,68800,81148
384,255,129,583,154800,81149
512,416,96,500,114500,81151
595,387,208,284,115900,81152
549,445,104,-,221100,81154
153,114,39,-,325000,81155
4074,3130,944,782,328600,81201
109,62,47,-,350000,81210
3097,2373,724,838,286400,81211
10940,7983,2957,758,162600,81212
77,77,0,-,412500,81220
122,106,16,1313,97500,81221
239,132,107,838,224600,81222
725,641,84,623,144600,81223
1357,851,506,1226,485400,81224
550,348,202,1069,423300,81225
2428,1726,702,881,127100,81226
5,5,0,-,-,81227
4033,2179,1854,812,255800,81230
0,0,0,-,-,81231
7,7,0,-,-,81232
448,373,75,-,267600,81233
328,222,106,700,329100,81235
469,428,41,1190,379400,81236
38,38,0,-,318200,81237
25,25,0,-,-,81239
1534,1302,232,846,179600,81240
29,28,1,-,275000,81241
262,162,100,694,247700,81242
60,55,5,-,294600,81243
205,172,33,769,129600,81244
90,66,24,-,171200,81248
90,80,10,-,-,81251
1935,1556,379,660,247800,81252
217,217,0,-,243400,81253
12229,7887,4342,1085,415200,81301
3303,2211,1092,1142,344800,81303
77,77,0,-,124600,81320
6093,4062,2031,768,177600,81321
1804,1402,402,977,249400,81323
505,425,80,679,109600,81324
121,105,16,-,217500,81325
881,754,127,1059,275000,81326
205,182,23,-,165200,81327
1762,1301,461,900,265600,81328
45,0,45,-,-,81330
194,184,10,-,254100,81331
91,51,40,868,270500,81332
475,265,210,296,145800,81334
21,9,12,-,-,81335
9445,5865,3580,813,186700,81401
4347,3630,717,1048,279100,81403
702,519,183,824,209900,81410
32,28,4,-,145000,81411
2053,1604,449,772,220800,81413
529,505,24,711,317600,81415
5428,3539,1889,847,180400,81416
721,496,225,964,199300,81418
1629,1162,467,988,244200,81419
299,174,125,694,131900,81422
640,461,179,1104,279300,81423
508,360,148,736,168900,81424
2026,1356,670,903,179900,81425
60,48,12,975,428600,81426
459,321,138,1043,358700,81427
1364,1057,307,798,209600,81428
20,20,0,-,233300,81429
366,307,59,1098,593100,81430
194,172,22,-,195500,81431
1469,1009,460,1173,448900,81432
235,157,78,1090,267900,81433
88,47,41,-,-,81434
2146,1078,1068,1178,637000,81435
9987,4075,5912,786,170200,81501
6199,4364,1835,904,176100,81503
11360,8133,3227,1029,171300,81504
4024,2816,1208,1097,263200,81505
5315,3266,2049,1033,277400,81506
6215,5442,773,1183,302800,81507
5252,3294,1958,757,121700,81520
6247,4613,1634,1090,221900,81521
11,11,0,-,-,81522
527,527,0,-,376500,81523
740,577,163,-,283400,81524
493,271,222,1243,223700,81525
2225,1553,672,851,309900,81526
850,741,109,1120,297300,81527
5848,3558,2290,1194,388600,81601
143,116,27,828,113500,81610
4431,2735,1696,1365,623300,81611
0,0,0,-,-,81612
1188,644,544,706,-,81615
3605,1996,1609,1281,486900,81620
2540,1784,756,1601,556200,81621
5351,3833,1518,1374,570400,81623
467,364,103,918,250000,81624
4811,3341,1470,733,170400,81625
329,256,73,755,189500,81630
2578,2143,435,1498,470900,81631
3020,2143,877,1424,572400,81632
0,0,0,-,-,81633
2666,1585,1081,789,185900,81635
2559,2065,494,1338,346300,81637
69,54,15,-,352900,81638
916,617,299,940,225800,81639
73,45,28,555,111300,81640
1464,944,520,717,231300,81641
12,0,12,-,-,81642
276,213,63,981,279200,81643
438,233,205,1199,512000,81645
65,49,16,-,453400,81646
2536,1972,564,1396,303500,81647
918,701,217,768,168100,81648
102,78,24,1625,315800,81649
4599,3086,1513,975,228200,81650
1841,1350,491,1289,268600,81652
23,7,16,-,-,81653
494,429,65,2806,-,81654
12,0,12,-,-,81655
94,94,0,-,-,81656
2300,1483,817,1431,682700,81657
14896,9014,5882,892,178600,82001
21,0,21,-,-,82005
8005,5094,2911,968,141200,82007
13546,10956,2590,845,270600,82009
87,65,22,660,-,82050
22,6,16,-,-,82051
5,5,0,-,-,82052
539,411,128,931,216600,82053
300,231,69,-,256800,82054
117,117,0,-,217300,82055
24,24,0,-,-,82058
114,114,0,-,226100,82059
214,214,0,-,209300,82060
0,0,0,-,-,82061
99,25,74,-,-,82063
8488,4699,3789,783,222600,82070
7137,2928,4209,717,226300,82072
0,0,0,-,-,82073
23,23,0,-,-,82081
710,536,174,515,206600,82082
105,72,33,-,63300,82083
0,0,0,-,-,82084
99,0,99,435,-,82190
2761,2136,625,633,189900,82201
212,140,72,538,83300,82210
245,209,36,675,145300,82212
231,204,27,400,127800,82213
526,365,161,806,135700,82214
86,73,13,-,211500,82215
11,0,11,-,-,82217
7,7,0,-,-,82219
173,97,76,513,107400,82221
30,20,10,-,195800,82222
499,426,73,791,180000,82223
5,5,0,-,-,82224
823,569,254,616,145900,82225
83,79,4,-,-,82227
1,1,0,-,-,82229
4122,3079,1043,714,148900,82240
11,11,0,-,-,82242
45,24,21,-,-,82243
197,179,18,680,201200,82244
3469,2394,1075,888,154700,82301
250,170,80,727,197500,82321
49,40,9,-,-,82322
53,42,11,-,-,82323
112,62,50,-,182500,82324
457,368,89,739,218500,82325
332,234,98,788,71000,82327
211,164,47,564,103300,82329
1039,780,259,846,201400,82331
53,24,29,-,-,82332
191,134,57,544,137500,82334
37,37,0,-,-,82335
88,47,41,692,-,82336
3214,2438,776,628,163600,82401
743,588,155,680,155200,82410
189,128,61,398,246400,82411
201,168,33,775,121700,82412
6557,4755,1802,803,264500,82414
308,252,56,650,161800,82420
135,118,17,700,157300,82421
48,48,0,-,-,82422
72,60,12,458,-,82423
1036,758,278,716,143800,82426
59,52,7,-,229200,82428
45,37,8,963,104200,82430
1364,908,456,602,147400,82431
98,68,30,538,111500,82432
398,255,143,665,168200,82433
38,27,11,-,204200,82434
4589,3363,1226,728,204800,82435
78,78,0,-,198200,82440
160,92,68,-,-,82441
346,249,97,622,251500,82442
2184,1673,511,722,147800,82443
102,52,50,-,-,82450
7219,5023,2196,733,176200,82501
130,110,20,392,83300,82510
67,49,18,667,-,82512
849,622,227,690,218800,82513
478,279,199,523,114600,82514
170,131,39,850,155900,82515
180,131,49,746,171900,82516
5240,3739,1501,803,220200,82520
329,262,67,900,192200,82523
11842,7467,4375,749,193100,82601
10631,7720,2911,982,197100,82604
7406,4635,2771,914,237100,82609
94,62,32,-,528600,82620
14,14,0,-,-,82630
4001,3093,908,717,195500,82633
91,40,51,788,56700,82635
1988,1533,455,803,190100,82636
1641,1036,605,702,199400,82637
0,0,0,-,-,82638
320,214,106,771,-,82639
30,30,0,-,-,82640
49,31,18,-,-,82642
155,123,32,607,50200,82643
743,348,395,873,124200,82644
0,0,0,-,-,82646
0,0,0,-,-,82648
456,322,134,612,121400,82649
2384,1892,492,842,174100,82701
132,132,0,-,337000,82710
49,30,19,-,-,82711
213,137,76,-,234800,82712
65,38,27,-,-,82714
0,0,0,-,-,82715
6898,4772,2126,858,188500,82716
9109,6521,2588,1018,231800,82718
369,264,105,600,156800,82720
1105,903,202,789,218800,82721
171,118,53,-,250800,82723
176,176,0,-,228900,82725
526,507,19,-,203300,82727
1008,838,170,757,210400,82729
710,505,205,718,183400,82730
38,13,25,-,-,82731
841,586,255,1088,192500,82732
11019,7464,3555,823,233000,82801
78,46,32,825,359300,82831
351,319,32,-,364200,82832
47,47,0,-,-,82833
3384,2440,944,888,255500,82834
136,80,56,-,187500,82835
462,298,164,597,216300,82836
30,18,12,-,-,82837
114,75,39,-,306000,82838
505,401,104,1083,252800,82839
442,295,147,-,275800,82842
11,11,0,-,-,82844
15,15,0,-,-,82845
10739,7860,2879,925,201000,82901
107,107,0,-,447700,82922
100,87,13,-,-,82923
155,155,0,-,439900,82925
106,0,106,593,-,82929
5485,3773,1712,649,171800,82930
161,115,46,-,267100,82932
201,189,12,-,131300,82933
102,47,55,-,-,82934
4646,3564,1082,786,208400,82935
0,0,0,-,-,82936
1457,1182,275,669,201100,82937
83,83,0,-,-,82938
574,388,186,671,200500,82939
1690,1225,465,1097,244100,82941
40,40,0,-,"10,000-",82942
144,120,24,-,-,82943
39,39,0,-,718800,82944
111,85,26,919,87900,82945
6653,3599,3054,1305,682900,83001
22,22,0,-,-,83011
106,15,91,-,-,83012
204,91,113,-,-,83013
1399,1088,311,1203,1077600,83014
105,88,17,-,1538500,83025
1244,990,254,822,181000,83101
1561,1154,407,813,203600,83110
182,121,61,-,180100,83111
139,112,27,-,-,83112
776,566,210,937,201100,83113
355,305,50,867,215500,83114
369,279,90,-,319400,83115
322,261,61,725,146100,83116
465,310,155,821,-,83118
33,19,14,-,-,83119
325,281,44,-,185500,83120
0,0,0,-,-,83121
186,167,19,-,-,83122
178,108,70,725,155000,83123
54,48,6,-,67500,83124
182,182,0,-,268800,83126
1400,1114,286,884,269700,83127
503,405,98,1039,284600,83128
13727,9010,4717,650,144500,83201
7902,5890,2012,720,156800,83202
87,65,22,406,91900,83203
7127,4635,2492,603,139900,83204
162,0,162,659,-,83209
1127,782,345,606,135700,83210
2022,1359,663,703,132600,83211
54,47,7,-,156900,83212
549,427,122,548,85700,83213
236,175,61,531,141300,83214
22,19,3,-,63800,83215
303,241,62,456,130200,83217
117,99,18,725,122000,83218
55,44,11,-,150000,83220
9035,6602,2433,645,148000,83221
44,41,3,-,145800,83223
1000,837,163,629,167700,83226
155,57,98,-,-,83227
188,140,48,730,165100,83228
151,118,33,836,164300,83232
0,0,0,-,-,83233
623,495,128,627,98100,83234
22,22,0,-,-,83235
684,602,82,533,156200,83236
357,276,81,695,163500,83237
27,18,9,-,-,83238
197,178,19,608,129200,83239
801,668,133,535,127900,83241
18,7,11,-,-,83243
119,108,11,-,164300,83244
866,775,91,625,179100,83245
295,249,46,781,160900,83246
506,424,82,673,165100,83250
436,313,123,607,176300,83251
1563,1236,327,745,152400,83252
30,22,8,-,-,83253
1473,1083,390,573,130900,83254
490,422,68,750,128800,83255
239,206,33,658,144600,83261
431,385,46,950,141800,83262
3159,2539,620,643,168500,83263
180,137,43,727,125900,83271
112,104,8,-,200000,83272
2832,2197,635,791,153000,83274
1410,1210,200,610,130200,83276
99,99,0,-,136300,83277
122,88,34,420,-,83278
51,33,18,-,-,83281
59,55,4,-,303800,83283
58,44,14,-,278600,83285
372,321,51,822,171700,83286
100,91,9,-,225000,83287
20579,13265,7314,760,155000,83301
60,38,22,622,55500,83302
231,161,70,663,159700,83311
74,39,35,-,134700,83312
1415,1026,389,1038,318300,83313
434,288,146,569,145000,83314
3753,2742,1011,663,130000,83316
5847,4056,1791,638,132100,83318
269,214,55,663,157100,83320
207,142,65,750,88200,83321
6,6,0,-,-,83322
536,416,120,538,139200,83323
209,154,55,809,134000,83324
268,190,78,750,147900,83325
301,203,98,573,163100,83327
2070,1560,510,934,171900,83328
2400,1692,708,761,119000,83330
1152,816,336,698,183300,83332
3760,2382,1378,907,378700,83333
731,533,198,838,108900,83334
628,401,227,652,163900,83335
1835,1308,527,636,131500,83336
28,28,0,-,-,83337
6831,4381,2450,739,142600,83338
2183,1355,828,1034,598000,83340
2383,1995,388,733,180800,83341
437,364,73,389,121900,83342
380,206,174,639,180400,83344
600,412,188,633,160100,83346
1104,822,282,610,136500,83347
103,78,25,-,-,83348
381,263,118,631,144500,83349
4591,3145,1446,609,116800,83350
1034,721,313,808,121900,83352
501,456,45,1542,875000,83353
0,0,0,-,-,83354
1538,959,579,650,124200,83355
13698,9144,4554,764,153200,83401
9278,6161,3117,640,142400,83402
8465,6364,2101,914,170800,83404
5840,4475,1365,890,181500,83406
260,239,21,-,279100,83414
848,662,186,819,185600,83420
46,33,13,-,-,83421
1162,803,359,917,280400,83422
277,150,127,588,94200,83423
110,52,58,-,233300,83424
133,100,33,619,120000,83425
576,542,34,1120,174500,83427
200,168,32,910,194400,83428
399,385,14,-,310300,83429
254,199,55,813,155000,83431
4,4,0,-,-,83433
512,415,97,760,137800,83434
165,114,51,-,123400,83435
160,126,34,820,146400,83436
10143,4587,5556,671,190300,83440
6515,5378,1137,798,174000,83442
357,287,70,927,176000,83443
434,281,153,513,114900,83444
2430,1912,518,709,134200,83445
18,18,0,-,180000,83446
597,425,172,1051,196100,83448
87,73,14,850,262500,83449
301,237,64,763,114000,83450
320,246,74,839,130800,83451
538,477,61,637,367800,83452
141,122,19,618,141700,83454
1954,1410,544,938,284800,83455
0,0,0,-,-,83460
340,231,109,-,310600,83462
48,30,18,-,-,83463
132,74,58,380,120000,83464
55,39,16,-,273900,83465
163,121,42,-,223300,83466
2862,2026,836,649,159600,83467
60,53,7,-,256300,83468
21,21,0,-,-,83469
14476,10252,4224,691,173300,83501
105,68,37,548,-,83520
678,504,174,693,170800,83522
314,262,52,583,117400,83523
345,243,102,720,155100,83524
172,172,0,-,164700,83525
136,121,15,825,239400,83526
2238,1735,503,681,160600,83530
76,66,10,-,202900,83533
489,387,102,734,127700,83535
1798,1302,496,600,138400,83536
470,394,76,775,168900,83537
931,746,185,675,159300,83539
758,427,331,675,112200,83540
482,426,56,753,195200,83541
80,69,11,475,190600,83542
282,226,56,681,122000,83543
2379,1744,635,753,154000,83544
169,137,32,733,126400,83545
264,241,23,635,85000,83546
129,95,34,735,151800,83547
50,46,4,-,100000,83548
330,231,99,776,184400,83549
394,326,68,600,115200,83552
601,483,118,539,103900,83553
214,187,27,460,159400,83554
232,200,32,563,158900,83555
25,25,0,-,219400,83601
6,6,0,-,-,83602
252,126,126,-,203100,83604
14002,8970,5032,730,120200,83605
7976,5759,2217,803,170600,83607
423,372,51,529,162100,83610
853,764,89,721,232500,83611
879,640,239,554,131800,83612
453,304,149,903,222500,83615
10200,8572,1628,991,360000,83616
5914,4388,1526,736,141700,83617
2879,2349,530,733,154200,83619
823,647,176,667,239500,83622
534,323,211,643,104500,83623
424,208,216,504,116700,83624
501,383,118,740,119900,83626
228,177,51,-,176400,83627
1528,1078,450,671,98800,83628
683,589,94,672,153000,83629
348,245,103,679,126600,83631
126,115,11,808,206300,83632
213,148,65,449,120500,83633
6989,5282,1707,1149,166800,83634
0,0,0,-,-,83636
85,63,22,-,207300,83637
2244,1623,621,817,286300,83638
1233,873,360,534,133100,83639
1287,1005,282,818,184900,83641
16032,11239,4793,940,214100,83642
57,57,0,-,154500,83643
3703,3094,609,709,171700,83644
341,263,78,711,179200,83645
20171,16619,3552,1105,235300,83646
8091,5170,2921,742,145900,83647
920,0,920,940,-,83648
175,101,74,-,150500,83650
11264,6993,4271,862,120500,83651
667,567,100,637,218400,83654
1528,1190,338,635,138300,83655
210,158,52,1011,97500,83656
86,77,9,-,277100,83657
2150,1645,505,565,151500,83660
3815,2494,1321,716,112000,83661
9,7,2,-,143800,83666
3497,2814,683,1066,247900,83669
176,145,31,-,213900,83670
9,9,0,-,-,83671
3193,2253,940,662,139700,83672
1430,1025,405,638,212100,83676
13,13,0,-,-,83677
16568,11366,5202,817,160900,83686
11054,7110,3944,910,156600,83687
10718,5534,5184,733,341700,83702
6937,4599,2338,910,209800,83703
16086,9040,7046,897,164200,83704
11875,5878,5997,823,161500,83705
13815,7249,6566,843,217400,83706
19715,15605,4110,1090,209300,83709
3814,2500,1314,865,365200,83712
10182,7019,3163,1040,209400,83713
9248,6438,2810,844,207700,83714
6399,4980,1419,1166,263600,83716
2307,2048,259,1035,231700,83801
31,2,29,525,-,83802
526,344,182,908,302200,83803
604,468,136,682,209200,83804
3120,2437,683,612,181300,83805
87,59,28,633,66300,83806
65,58,7,-,-,83808
95,95,0,-,349200,83809
406,331,75,1565,217200,83810
606,394,212,741,116500,83811
31,30,1,-,86700,83812
360,309,51,-,295400,83813
11099,6077,5022,820,260400,83814
13525,8833,4692,958,189800,83815
97,72,25,-,-,83821
799,649,150,545,162000,83822
543,447,96,710,179300,83823
99,72,27,342,98000,83824
133,100,33,-,200000,83825
0,0,0,-,-,83826
74,60,14,-,101500,83827
267,190,77,-,166900,83830
590,465,125,832,184800,83832
613,514,99,850,448800,83833
117,99,18,-,-,83834
8050,6774,1276,967,250400,83835
411,346,65,725,260300,83836
1308,724,584,661,111200,83837
589,467,122,709,179500,83839
83,68,15,950,156300,83840
165,76,89,826,151600,83841
85,56,29,-,146400,83842
11193,4930,6263,671,220600,83843
0,0,0,-,-,83844
750,536,214,881,164600,83845
348,265,83,594,76600,83846
620,344,276,611,213900,83847
140,102,38,-,239100,83848
889,710,179,619,120800,83849
978,797,181,719,141600,83850
649,462,187,755,131400,83851
364,97,267,743,85000,83852
15367,11277,4090,927,182300,83854
867,581,286,699,144700,83855
2544,2040,504,770,171300,83856
358,266,92,959,227800,83857
5227,4285,942,931,219600,83858
2528,2020,508,792,269200,83860
2543,1947,596,655,156000,83861
7662,5023,2639,782,239700,83864
34,34,0,-,-,83866
243,220,23,-,116500,83867
380,194,186,631,61500,83868
1824,1482,342,746,191700,83869
120,78,42,575,120000,83870
817,687,130,667,204400,83871
259,218,41,-,299000,83872
704,419,285,661,109500,83873
0,0,0,-,-,83874
660,491,169,678,222800,83876
271,233,38,850,172900,84001
110,81,29,985,228800,84002
12285,9870,2415,1117,311300,84003
2653,2230,423,1737,496900,84004
6401,5477,924,1435,239000,84005
266,226,40,-,166700,84006
205,182,23,-,189500,84007
15167,10720,4447,951,273100,84010
276,256,20,917,228200,84013
5506,4619,887,1079,269600,84014
19422,14287,5135,968,186300,84015
1468,1193,275,894,289800,84017
40,40,0,-,372700,84018
13278,10523,2755,1364,408800,84020
1367,981,386,854,158800,84021
205,6,199,636,-,84022
50,39,11,-,278100,84023
30,22,8,-,-,84024
6465,5206,1259,1048,344300,84025
354,289,65,800,130800,84026
234,196,38,1579,170000,84027
198,143,55,589,235000,84028
3028,2488,540,807,211900,84029
64,46,18,-,-,84031
6498,4495,2003,1254,335500,84032
372,308,64,838,239000,84033
56,36,20,-,-,84034
127,127,0,-,173100,84035
2195,1566,629,1063,304000,84036
10264,9184,1080,931,305600,84037
94,85,9,-,278100,84038
273,253,20,-,173100,84039
7312,6191,1121,1301,267400,84040
15926,10679,5247,902,197500,84041
2741,2282,459,1052,362300,84042
15366,12419,2947,1382,285800,84043
8105,6113,1992,1047,160500,84044
5834,4826,1008,1393,297000,84045
118,118,0,-,161700,84046
13087,5485,7602,1011,214900,84047
1875,1389,486,1708,404300,84049
3196,2696,500,1156,308900,84050
143,124,19,950,214700,84051
441,302,139,792,137500,84052
314,283,31,786,196400,84053
6179,4521,1658,1033,259300,84054
421,290,131,868,285000,84055
1007,19,988,1167,-,84056
11800,6729,5071,997,212600,84057
10259,5220,5039,951,235700,84058
3437,2092,1345,1238,953200,84060
217,163,54,-,391700,84061
12862,9065,3797,1094,277300,84062
80,80,0,-,151900,84063
219,170,49,704,132400,84064
10998,9901,1097,1242,326900,84065
3902,2871,1031,854,178600,84066
12475,10219,2256,988,164500,84067
184,147,37,950,187500,84069
9728,5880,3848,1048,228600,84070
335,261,74,838,208200,84071
133,109,24,796,169300,84072
70,64,6,-,157500,84073
15264,12397,2867,929,194700,84074
7463,7019,444,1615,269600,84075
95,78,17,-,137500,84076
8944,6626,2318,949,205900,84078
106,91,15,1021,168000,84080
12637,10370,2267,1283,257600,84081
230,216,14,-,298900,84082
462,105,357,523,41600,84083
11806,8754,3052,1145,223800,84084
139,120,19,-,158900,84085
90,63,27,-,122300,84086
4705,4198,507,1328,246600,84087
11163,7961,3202,1121,249000,84088
9015,8127,888,1573,396600,84092
7359,6526,833,1771,358700,84093
9057,7107,1950,1325,255500,84094
19556,15427,4129,1385,363500,84095
11247,9083,2164,1211,322600,84096
6306,4664,1642,894,264600,84097
7020,5452,1568,1488,674500,84098
2755,679,2076,907,232300,84101
8873,2186,6687,855,264400,84102
10375,5010,5365,845,397400,84103
7529,3654,3875,930,157900,84104
9426,6089,3337,947,331400,84105
14215,8370,5845,1058,269000,84106
13741,6674,7067,977,225800,84107
7664,5654,2010,998,464500,84108
8715,6816,1899,1096,368200,84109
6273,1393,4880,728,211000,84111
194,5,189,817,-,84112
43,0,43,-,-,84113
10762,4310,6452,776,186200,84115
10905,6019,4886,930,162000,84116
10253,6772,3481,1002,338800,84117
19642,15976,3666,1117,190400,84118
16845,9501,7344,978,160900,84119
13321,9517,3804,1018,180600,84120
15542,11707,3835,1181,336300,84121
14360,8409,5951,975,211300,84123
7927,5870,2057,1010,371400,84124
6930,5819,1111,1348,196700,84128
137,28,109,1764,272200,84144
0,0,0,-,-,84180
292,282,10,1300,174600,84301
8378,6076,2302,712,174000,84302
0,0,0,-,-,84304
244,227,17,836,163400,84305
132,78,54,-,242900,84306
482,407,75,1082,182000,84307
84,65,19,1075,182000,84308
181,155,26,686,190100,84309
1451,1340,111,-,381800,84310
231,164,67,628,214000,84311
1236,1031,205,763,170100,84312
35,13,22,-,-,84313
302,270,32,490,197200,84314
2455,2292,163,1304,290100,84315
101,85,16,-,139600,84316
752,669,83,885,363900,84317
1242,1131,111,967,252200,84318
2224,1792,432,785,165200,84319
772,636,136,692,175000,84320
14458,7103,7355,661,180700,84321
269,250,19,775,221900,84324
604,558,46,656,280100,84325
520,446,74,630,212600,84326
268,252,16,638,195000,84327
523,474,49,763,272000,84328
24,24,0,-,150000,84329
152,145,7,800,157200,84330
116,97,19,679,146300,84331
2355,1916,439,925,253000,84332
875,708,167,689,190200,84333
123,29,94,-,-,84334
3632,3157,475,875,206200,84335
71,56,15,-,131300,84336
3713,2763,950,709,174000,84337
141,119,22,638,169500,84338
1412,1220,192,631,227700,84339
1154,1019,135,713,258000,84340
7475,3424,4051,846,221700,84341
13440,7010,6430,741,176800,84401
12961,8880,4081,783,195200,84403
19683,13854,5829,838,155600,84404
11081,8168,2913,826,191000,84405
9006,7774,1232,1004,236600,84414
4789,3389,1400,668,148700,84501
1287,1028,259,607,162000,84511
257,195,62,-,86800,84512
524,427,97,588,122300,84513
0,0,0,-,-,84515
72,67,5,-,171900,84516
303,243,60,1052,231700,84518
482,346,136,577,55600,84520
258,209,49,683,138200,84521
131,123,8,-,89700,84522
609,487,122,576,150500,84523
349,266,83,476,119700,84525
1655,1280,375,669,128700,84526
816,646,170,718,140600,84528
143,143,0,-,82700,84529
109,45,64,1214,-,84530
196,180,16,-,57100,84531
4016,2813,1203,769,233100,84532
74,42,32,-,109200,84533
605,510,95,569,75700,84534
888,701,187,769,169200,84535
397,339,58,427,33500,84536
502,380,122,752,130500,84537
124,108,16,763,49000,84539
21,21,0,-,-,84540
648,446,202,634,112500,84542
10722,4799,5923,794,181700,84601
11909,6334,5575,826,303500,84604
10406,2424,7982,775,200700,84606
348,317,31,950,150900,84620
59,59,0,-,-,84621
507,406,101,1208,185200,84622
133,88,45,-,248900,84623
1923,1452,471,698,149600,84624
61,61,0,-,161300,84626
2012,1041,971,693,190800,84627
226,199,27,869,102000,84628
862,743,119,985,199100,84629
131,127,4,-,162000,84630
1000,764,236,625,140700,84631
357,300,57,693,149300,84632
400,348,52,488,188800,84633
360,307,53,635,159200,84634
221,211,10,975,113200,84635
174,134,40,550,157100,84636
258,214,44,800,159900,84637
106,93,13,670,165100,84638
294,223,71,718,157100,84639
42,40,2,-,105600,84640
1108,786,322,729,161700,84642
178,141,37,925,195300,84643
712,620,92,657,266400,84645
553,461,92,721,124500,84646
1483,1179,304,750,162500,84647
1980,1586,394,758,170300,84648
342,283,59,619,157100,84649
6866,5535,1331,918,223500,84651
250,227,23,-,152700,84652
2343,2024,319,1175,311200,84653
976,782,194,694,113900,84654
3057,2581,476,947,216200,84655
155,137,18,746,181500,84656
231,164,67,643,139200,84657
10746,8168,2578,1029,229300,84660
455,382,73,878,179000,84662
9181,6411,2770,959,225300,84663
2398,2264,134,1404,365300,84664
121,112,9,-,188200,84665
107,103,4,-,166400,84667
2900,1902,998,751,158400,84701
43,36,7,-,233300,84710
256,218,38,879,169700,84711
75,60,15,-,139300,84712
1298,861,437,626,158400,84713
160,110,50,-,73000,84714
145,136,9,-,202000,84715
123,76,47,834,229300,84716
72,61,11,1078,120300,84718
27,15,12,-,-,84719
7026,4217,2809,687,201000,84720
6651,4322,2329,720,179300,84721
358,313,45,837,172800,84722
263,228,35,675,140900,84723
412,355,57,578,117300,84724
503,424,79,976,172900,84725
333,280,53,722,151200,84726
14,0,14,-,-,84728
97,87,10,-,172000,84729
99,97,2,-,216900,84730
57,57,0,-,147300,84731
22,22,0,-,216700,84732
78,47,31,-,321700,84733
103,57,46,518,133900,84734
92,84,8,-,187500,84735
73,70,3,-,112500,84736
5596,4071,1525,1029,196500,84737
3048,2406,642,1139,247000,84738
196,144,52,725,145000,84739
34,33,1,-,156300,84740
2049,1673,376,944,198100,84741
110,94,16,625,590000,84742
4,4,0,-,-,84743
106,96,10,475,160200,84744
1237,1000,237,1037,151300,84745
355,324,31,758,233900,84746
360,240,120,583,153700,84747
105,87,18,-,225000,84749
163,147,16,942,127300,84750
590,452,138,698,116000,84751
368,273,95,926,154200,84752
12,12,0,-,-,84753
1357,1170,187,808,184200,84754
26,26,0,-,-,84755
148,73,75,-,187500,84756
423,289,134,1276,333100,84757
204,151,53,902,140200,84758
685,545,140,825,182300,84759
195,156,39,697,168300,84760
1146,956,190,908,166800,84761
63,63,0,-,234700,84762
129,107,22,775,456300,84763
72,28,44,440,-,84764
1832,1554,278,1609,285700,84765
58,49,9,-,161300,84766
226,145,81,638,587800,84767
14238,8215,6023,896,226300,84770
89,63,26,-,229800,84772
90,68,22,-,264300,84773
520,457,63,1071,263700,84774
187,170,17,556,210600,84775
201,162,39,779,183300,84776
189,146,43,713,209400,84779
8167,5972,2195,1141,238500,84780
74,54,20,-,272700,84781
219,203,16,-,272300,84782
306,293,13,-,414200,84783
309,37,272,-,158800,84784
14589,10670,3919,1056,261700,84790
3840,1410,2430,843,329700,85003
2521,635,1886,891,257800,85004
9131,3481,5650,746,169100,85006
5033,1784,3249,785,237800,85007
21634,5422,16212,835,143200,85008
12036,5433,6603,755,76200,85009
3436,1815,1621,974,369600,85012
9758,4392,5366,917,242200,85013
12663,4633,8030,905,219400,85014
14805,5268,9537,750,152000,85015
16185,7372,8813,895,269900,85016
11648,4439,7209,730,94400,85017
16763,9064,7699,877,431100,85018
7192,3469,3723,879,116500,85019
15034,8033,7001,850,226700,85020
15763,6103,9660,781,231300,85021
21138,11616,9522,960,217400,85022
12459,7019,5440,911,199000,85023
9995,6855,3140,1290,223700,85024
15180,8564,6616,1049,158900,85027
8057,6394,1663,1300,343500,85028
16677,8348,8329,848,153000,85029
7745,3824,3921,888,117100,85031
27585,15447,12138,925,204800,85032
15646,7375,8271,954,111500,85033
1613,390,1223,619,115300,85034
14540,5116,9424,948,116300,85035
14194,7782,6412,1126,133900,85037
9566,3884,5682,834,106800,85040
16855,10247,6608,1051,139200,85041
13895,8251,5644,982,163100,85042
9645,5336,4309,1141,151000,85043
16970,9913,7057,1151,266300,85044
2541,2178,363,1843,393900,85045
13094,9004,4090,1246,352600,85048
11351,8091,3260,1549,303900,85050
14595,7725,6870,818,139900,85051
11222,6305,4917,934,166500,85053
3662,1554,2108,1393,377900,85054
6368,5630,738,1879,327100,85083
8108,4967,3141,1213,353400,85085
14448,11378,3070,1588,317100,85086
3004,2627,377,1411,272500,85087
6095,5461,634,1162,264900,85118
9993,7642,2351,789,132400,85119
13317,9760,3557,799,68700,85120
581,162,419,892,-,85121
18612,11682,6930,873,119100,85122
4285,2684,1601,848,99400,85123
4854,2833,2021,752,94900,85128
3305,2095,1210,650,81200,85131
7569,5609,1960,925,130200,85132
195,119,76,525,32100,85135
914,663,251,880,88700,85137
11183,8429,2754,1314,174100,85138
5704,4069,1635,1122,151000,85139
13194,10172,3022,1188,185200,85140
151,110,41,817,55000,85141
18360,15197,3163,1270,274000,85142
11662,8114,3548,1229,180400,85143
872,695,177,1117,140000,85145
1254,444,810,-,83900,85147
483,243,240,1034,237500,85172
1102,731,371,758,83400,85173
615,549,66,575,83800,85192
1305,896,409,679,85000,85193
2876,2363,513,1031,184900,85194
19512,6589,12923,854,151500,85201
15632,6888,8744,885,189200,85202
12346,6808,5538,885,208000,85203
21678,11877,9801,931,154500,85204
17239,11965,5274,895,162500,85205
15219,9749,5470,1117,171100,85206
17587,13754,3833,1083,244400,85207
14670,11017,3653,1109,125900,85208
15977,11857,4120,1206,192200,85209
14114,5666,8448,859,162800,85210
9035,7179,1856,1338,268800,85212
12315,8969,3346,1029,232100,85213
7209,5937,1272,1282,224900,85215
16790,9091,7699,1197,220300,85224
24924,13757,11167,1056,207500,85225
14038,8365,5673,1222,265900,85226
12707,8558,4149,1193,264200,85233
15919,11181,4738,1190,276500,85234
15233,12015,3218,1324,298400,85248
13262,11402,1860,1726,346900,85249
8596,6097,2499,1256,305100,85250
19572,9554,10018,1082,293100,85251
7385,6200,1185,1433,1191200,85253
17869,12683,5186,1412,407200,85254
16558,12914,3644,1658,634800,85255
1653,1247,406,606,57100,85256
13581,7729,5852,1122,228900,85257
12297,8790,3507,1316,450900,85258
9465,7269,2196,1155,610600,85259
17357,10300,7057,1307,412100,85260
4866,4375,491,2566,728400,85262
1289,1221,68,-,486000,85263
386,312,74,757,158300,85264
5250,4941,309,2297,702300,85266
11770,9296,2474,1187,388900,85268
22976,4764,18212,994,180500,85281
21481,9234,12247,1033,202400,85282
19203,8747,10456,1093,225700,85283
6821,5651,1170,1710,394000,85284
13335,8859,4476,1402,325000,85286
13654,8651,5003,1382,283600,85295
13526,10433,3093,1478,258900,85296
9615,7003,2612,1535,297500,85297
9195,8165,1030,1914,357200,85298
21648,7523,14125,757,88100,85301
14301,7664,6637,888,158000,85302
9113,5421,3692,1004,161000,85303
9429,6652,2777,1047,175500,85304
4315,2310,2005,1113,222500,85305
8664,5075,3589,1064,187100,85306
3126,1312,1814,1027,165400,85307
24288,16594,7694,1166,248000,85308
0,0,0,-,-,85309
6630,5588,1042,1489,283400,85310
307,212,95,575,155400,85320
1816,1192,624,773,77200,85321
280,187,93,521,147200,85322
12264,6199,6065,1064,153700,85323
1285,1051,234,724,101400,85324
544,525,19,-,86800,85325
15492,10115,5377,1135,164700,85326
166,94,72,1047,98800,85328
11252,9721,1531,1467,417400,85331
662,584,78,1081,152900,85332
237,167,70,595,65000,85333
428,279,149,-,56800,85334
10279,6181,4098,1125,136300,85335
176,108,68,710,91100,85336
830,389,441,597,83900,85337
14641,10385,4256,1289,216900,85338
12226,8464,3762,1409,203800,85339
10289,7702,2587,1352,280000,85340
0,0,0,-,-,85341
632,521,111,628,162800,85342
81,39,42,654,132600,85343
3755,2498,1257,719,100000,85344
19785,12446,7339,1042,146400,85345
2378,1903,475,516,71800,85346
273,134,139,506,58500,85347
1238,1043,195,519,51600,85348
8149,5767,2382,673,112300,85349
6023,4274,1749,639,120500,85350
17536,14822,2714,1024,122700,85351
171,129,42,490,55000,85352
10208,6315,3893,1129,168500,85353
2224,1650,574,798,135100,85354
3336,2821,515,1560,291500,85355
1982,1624,358,759,80700,85356
185,140,45,519,71300,85357
99,42,57,275,57800,85360
2020,1732,288,1294,172800,85361
372,302,70,883,124500,85362
2302,1113,1189,967,132600,85363
26278,14511,11767,795,118300,85364
18362,13354,5008,1027,119000,85365
10061,8323,1738,1056,127000,85367
104,51,53,356,-,85371
8812,7486,1326,1184,181200,85373
21233,15244,5989,1126,191700,85374
16577,14683,1894,1285,196900,85375
1607,1263,344,1078,662200,85377
13845,9752,4093,1317,219300,85379
8781,5828,2953,1220,229500,85381
15801,10814,4987,1250,235100,85382
14684,13048,1636,1670,353800,85383
4818,4181,637,1103,272600,85387
8445,6386,2059,1330,219000,85388
4171,3204,967,635,239500,85390
12497,7157,5340,1135,201100,85392
9756,7658,2098,1296,325600,85395
5879,4857,1022,1397,237600,85396
5133,3538,1595,823,100900,85501
417,301,116,384,28500,85530
129,91,38,-,211000,85531
1093,700,393,552,89100,85533
1047,854,193,693,83700,85534
0,0,0,-,-,85535
183,167,16,-,-,85536
1906,1382,524,681,79700,85539
1194,0,1194,409,-,85540
9667,7159,2508,838,209600,85541
643,342,301,435,43400,85542
1226,966,260,912,117200,85543
1185,1083,102,783,279100,85544
303,253,50,-,102000,85545
6028,4089,1939,815,127100,85546
1270,684,586,416,38400,85550
121,116,5,-,102800,85551
2273,1425,848,787,150100,85552
885,751,134,414,143000,85553
268,218,50,735,206100,85554
348,284,64,-,-,85601
4141,2949,1192,738,98200,85602
3324,2336,988,703,125900,85603
237,149,88,469,61900,85605
558,499,59,475,113900,85606
4700,3192,1508,575,86200,85607
0,0,0,-,-,85608
133,124,9,-,-,85609
429,354,75,600,99300,85610
445,420,25,-,286500,85611
878,7,871,1241,-,85613
12797,10158,2639,1033,163500,85614
4009,3455,554,1105,199300,85615
2363,1605,758,647,123800,85616
619,471,148,583,135800,85617
586,435,151,589,61500,85618
55,19,36,-,-,85619
229,156,73,705,100600,85620
7134,3773,3361,546,116200,85621
3652,3295,357,1120,226200,85622
2035,1654,381,801,213700,85623
607,440,167,718,231800,85624
998,887,111,704,99100,85625
412,320,92,583,73600,85626
470,365,105,1066,147200,85627
8425,6935,1490,1381,170100,85629
1007,913,94,479,162500,85630
1364,988,376,821,68500,85631
361,292,69,633,170700,85632
16,7,9,406,-,85633
1699,1077,622,558,63500,85634
14266,7691,6575,866,162600,85635
579,524,55,-,362200,85637
1002,756,246,596,128200,85638
133,69,64,-,-,85640
8607,7613,994,1433,224100,85641
3115,2099,1016,619,96700,85643
731,616,115,754,112000,85645
828,690,138,1829,303200,85646
6013,4743,1270,858,124800,85648
6450,5687,763,1211,206800,85650
5586,4519,1067,958,138900,85653
13,13,0,-,-,85654
4381,3693,688,1384,302300,85658
2785,769,2016,827,241100,85701
14692,8395,6297,915,248400,85704
23439,10341,13098,680,74200,85705
17125,9966,7159,749,84100,85706
0,0,0,-,-,85707
1272,22,1250,1208,-,85708
25345,13108,12237,808,152600,85710
16868,7776,9092,726,143400,85711
15965,5921,10044,768,135800,85712
16780,10192,6588,778,85800,85713
5243,2757,2486,629,86000,85714
7715,5293,2422,1062,214400,85715
15342,6205,9137,763,169500,85716
12438,8671,3767,903,456600,85718
17668,4680,12988,836,194400,85719
0,0,0,-,-,85723
0,0,0,-,-,85724
0,0,0,-,-,85726
15559,10439,5120,914,129200,85730
4192,3511,681,799,112700,85735
1827,1526,301,633,93400,85736
9138,6676,2462,1212,283400,85737
8721,7963,758,975,285400,85739
13881,7880,6001,1024,161900,85741
10022,7622,2400,1247,186900,85742
10932,8914,2018,1225,203600,85743
15965,9434,6531,875,205400,85745
14500,9864,4636,880,113100,85746
8420,6413,2007,1373,199400,85747
7419,5392,2027,1155,215800,85748
7766,6405,1361,1145,360600,85749
11243,7921,3322,992,369300,85750
6926,6116,810,1482,296900,85755
10814,7941,2873,1031,104700,85756
5855,4538,1317,1005,140300,85757
6790,4551,2239,848,148100,85901
474,280,194,510,53900,85911
138,138,0,-,73000,85912
175,143,32,738,255000,85920
32,32,0,-,300000,85922
148,101,47,-,186800,85923
1047,1000,47,-,109200,85924
1551,1181,370,681,164400,85925
95,52,43,410,68000,85926
74,53,21,-,412500,85927
465,335,130,531,176800,85928
3020,2055,965,773,167300,85929
279,138,141,600,88000,85930
88,88,0,-,282600,85931
185,143,42,-,-,85932
1227,917,310,732,190600,85933
146,146,0,-,198800,85934
1961,1543,418,649,231400,85935
1211,973,238,507,96300,85936
2509,2041,468,713,130000,85937
730,558,172,623,110100,85938
1651,1154,497,810,136100,85939
431,413,18,-,166800,85940
2588,1569,1019,468,59400,85941
67,67,0,-,-,85942
17443,8409,9034,1181,319000,86001
4,4,0,-,-,86003
13407,8219,5188,1134,279400,86004
64,0,64,625,-,86011
153,106,47,-,-,86015
24,24,0,-,52900,86016
454,389,65,982,248200,86017
466,389,77,1292,263700,86018
590,501,89,-,55300,86020
794,189,605,825,180200,86021
740,472,268,625,99500,86022
675,53,622,399,-,86023
299,277,22,775,279000,86024
1688,1089,599,671,84600,86025
0,0,0,-,-,86028
87,87,0,-,"10,000-",86029
410,357,53,538,102100,86030
533,416,117,617,80000,86031
456,331,125,678,132500,86032
2051,1159,892,543,48500,86033
615,380,235,480,84700,86034
569,439,130,559,70100,86035
184,129,55,-,150300,86036
0,0,0,-,-,86038
373,315,58,825,96400,86039
3160,2159,1001,901,104200,86040
537,342,195,1009,59500,86042
565,485,80,530,86100,86043
1025,861,164,569,60300,86044
3210,2098,1112,660,56100,86045
2499,1840,659,961,169300,86046
4104,2442,1662,590,84400,86047
0,0,0,-,-,86052
595,462,133,540,53300,86053
515,372,143,529,54000,86054
9791,6295,3496,984,242900,86301
8345,5836,2509,827,302200,86303
7925,6229,1696,894,369600,86305
0,0,0,-,-,86313
14718,8588,6130,910,177100,86314
2950,2638,312,1744,278400,86315
893,739,154,715,72500,86320
700,137,563,474,33300,86321
4326,3077,1249,802,170200,86322
6526,5144,1382,860,184000,86323
2238,1433,805,956,199500,86324
2391,2047,344,1337,267100,86325
10325,6557,3768,897,160100,86326
4386,3823,563,1172,192600,86327
432,388,44,-,217900,86329
302,233,69,836,199300,86331
769,626,143,606,123600,86332
2460,2035,425,782,102300,86333
1879,1306,573,937,154000,86334
2206,1396,810,898,142600,86335
6039,4439,1600,1175,436500,86336
567,402,165,584,97500,86337
237,181,56,688,343300,86338
44,41,3,-,164600,86343
3358,2331,1027,1156,426300,86351
9576,6849,2727,830,132500,86401
7117,4062,3055,781,183700,86403
7680,5508,2172,893,201000,86404
10268,7785,2483,897,239300,86406
11054,7826,3228,756,83300,86409
109,101,8,-,154800,86411
4996,4269,727,666,78600,86413
6023,4308,1715,917,146300,86426
3554,1839,1715,749,205500,86429
209,203,6,-,47300,86431
1508,1116,392,639,85500,86432
48,0,48,-,-,86433
436,222,214,429,81500,86434
2,2,0,-,-,86435
753,631,122,761,77400,86436
35,23,12,-,55300,86437
466,389,77,614,-,86438
3081,2049,1032,640,136000,86440
1204,926,278,515,76400,86441
14021,8311,5710,752,99600,86442
0,0,0,-,-,86443
510,416,94,741,66300,86444
146,146,0,-,100000,86445
355,328,27,450,56700,86502
2907,1957,950,442,33700,86503
1721,1139,582,559,44400,86504
1990,1644,346,467,52100,86505
338,286,52,431,48200,86506
536,497,39,588,52000,86507
212,203,9,-,55800,86508
1352,1125,227,509,96600,86510
977,910,67,415,71400,86511
643,457,186,552,79800,86512
771,624,147,565,62600,86514
1245,699,546,440,57500,86515
495,431,64,586,59500,86520
306,294,12,-,52000,86535
592,405,187,395,49800,86538
270,235,35,470,71100,86540
275,232,43,650,48800,86544
349,315,34,450,54700,86545
275,264,11,-,52800,86547
429,256,173,318,47100,86556
855,785,70,498,158100,87001
8121,5963,2158,738,128800,87002
3936,3049,887,720,153000,87004
264,240,24,-,84300,87005
274,259,15,-,173500,87006
287,280,7,-,87400,87007
1082,969,113,1408,249900,87008
541,448,93,875,240500,87010
34,34,0,-,-,87011
100,74,26,-,188600,87012
1427,1127,300,581,47600,87013
232,216,16,-,119800,87014
4768,4337,431,883,192400,87015
1168,946,222,581,122600,87016
143,129,14,-,170400,87017
155,125,30,331,24000,87018
4211,2492,1719,619,103100,87020
1115,787,328,651,100900,87021
345,283,62,400,67500,87022
175,175,0,-,103100,87023
561,521,40,486,113100,87024
554,530,24,666,280500,87025
1181,944,237,525,77300,87026
106,70,36,-,114200,87027
49,49,0,-,-,87028
132,129,3,-,-,87029
15091,12318,2773,825,129300,87031
59,21,38,-,-,87032
510,471,39,550,77500,87034
2559,1983,576,866,112600,87035
704,594,110,729,92500,87036
211,189,22,189,54700,87037
173,101,72,310,51700,87038
166,166,0,-,-,87040
283,220,63,678,118900,87041
1422,1267,155,762,198400,87042
2392,2113,279,1141,341200,87043
130,130,0,-,-,87044
470,413,57,-,43700,87045
36,30,6,-,238500,87046
1772,1604,168,1380,275500,87047
3844,3493,351,845,430900,87048
380,338,42,668,33600,87049
334,313,21,-,117800,87051
575,482,93,494,89600,87052
329,275,54,793,88300,87053
460,407,53,-,264200,87056
3879,3569,310,1169,243600,87059
203,203,0,-,-,87061
409,344,65,725,67200,87062
87,50,37,547,56700,87063
79,62,17,-,215600,87064
1829,1695,134,791,166500,87068
34,0,34,-,-,87070
196,172,24,538,99200,87072
272,240,32,1116,155900,87083
8925,3160,5765,681,129900,87102
5588,3289,2299,758,218300,87104
19865,14177,5688,731,136500,87105
11217,4466,6751,702,242500,87106
12993,8304,4689,700,211400,87107
17012,5503,11509,646,156000,87108
17425,9102,8323,825,210500,87109
16945,11070,5875,815,182900,87110
24198,15462,8736,1009,260000,87111
18170,10888,7282,801,178700,87112
5758,4434,1324,1077,242600,87113
24996,16923,8073,1078,209800,87114
1220,11,1209,1309,-,87116
0,0,0,-,-,87117
23390,17236,6154,1070,191100,87120
23500,16917,6583,1007,127200,87121
6881,6123,758,1333,462600,87122
17199,11106,6093,794,174900,87123
20282,15708,4574,996,170500,87124
13801,11073,2728,1290,185900,87144
7299,4437,2862,719,118600,87301
1028,917,111,580,37300,87305
256,230,26,-,55300,87310
1009,816,193,672,28300,87311
185,157,28,-,21300,87312
1562,921,641,574,59300,87313
74,45,29,-,-,87315
386,207,179,717,36800,87316
452,369,83,-,36800,87317
544,502,42,-,51200,87319
172,154,18,433,49000,87320
704,578,126,375,87100,87321
27,27,0,-,-,87322
1195,926,269,671,52300,87323
892,723,169,559,50200,87325
464,417,47,433,49700,87326
1906,1535,371,555,69700,87327
691,338,353,423,51900,87328
74,40,34,-,-,87347
233,130,103,575,37800,87357
313,275,38,420,42000,87364
783,718,65,425,49200,87375
15609,10310,5299,802,159100,87401
3645,3000,645,1039,221600,87402
6321,4878,1443,794,154200,87410
339,306,33,-,105500,87412
5289,3936,1353,771,139700,87413
655,595,60,486,158700,87415
1384,1144,240,786,73200,87416
1800,1199,601,781,130300,87417
360,286,74,592,183800,87418
140,140,0,-,-,87419
3269,2137,1132,478,73200,87420
607,476,131,1065,129900,87421
569,448,121,563,46700,87455
453,404,49,1016,52000,87461
180,144,36,-,62500,87499
8311,5150,3161,1124,397800,87501
14147,8701,5446,1002,323200,87505
5639,4631,1008,889,396000,87506
17490,11807,5683,956,213800,87507
7866,6542,1324,1286,353600,87508
364,307,57,-,126300,87510
745,534,211,535,135300,87511
29,29,0,-,-,87512
337,226,111,1057,313700,87513
348,348,0,-,246200,87514
141,141,0,-,121600,87515
35,35,0,-,163400,87516
186,130,56,-,116000,87517
24,10,14,-,-,87518
185,111,74,-,-,87519
509,383,126,728,164100,87520
341,295,46,806,-,87521
977,751,226,485,157200,87522
152,135,17,-,343000,87523
45,45,0,-,-,87524
28,17,11,-,608300,87525
299,289,10,-,112100,87527
856,560,296,493,104400,87528
1683,1255,428,901,263500,87529
224,224,0,-,159300,87530
158,100,58,-,"10,000-",87531
6615,4450,2165,691,182100,87532
59,43,16,667,19700,87533
499,388,111,1208,158000,87535
957,732,225,498,162000,87537
382,273,109,-,165600,87538
21,21,0,-,-,87539
438,364,74,-,366700,87540
50,50,0,-,-,87543
7525,5543,1982,1004,285300,87544
362,316,46,-,145500,87548
257,199,58,-,169900,87549
153,144,9,-,291400,87551
1445,1156,289,538,175700,87552
475,368,107,586,127100,87553
0,0,0,-,-,87554
1075,882,193,610,127700,87556
2324,1808,516,832,262100,87557
207,105,102,813,320300,87558
617,331,286,-,83300,87560
188,188,0,-,162500,87562
146,146,0,-,367500,87564
225,172,53,-,-,87565
831,747,84,589,198500,87566
585,346,239,633,154000,87567
199,182,17,-,137500,87569
4543,3105,1438,645,240600,87571
38,38,0,-,-,87573
92,86,6,-,-,87574
383,315,68,-,326200,87575
173,173,0,-,113300,87577
158,158,0,-,284800,87578
230,180,50,775,150700,87579
255,150,105,-,-,87580
0,0,0,-,-,87581
230,197,33,-,181500,87582
71,51,20,-,65100,87583
7083,4692,2391,603,126600,87701
718,515,203,598,327700,87710
216,169,47,-,52200,87711
75,23,52,-,-,87712
92,82,10,-,-,87713
470,327,143,642,96900,87714
225,164,61,-,-,87715
184,140,44,821,187500,87718
210,210,0,-,116700,87722
81,56,25,-,-,87723
16,0,16,-,-,87724
154,106,48,445,80000,87728
40,37,3,-,214100,87729
11,6,5,-,-,87730
107,91,16,-,231900,87731
419,314,105,813,101900,87732
53,42,11,-,90000,87733
96,88,8,-,-,87734
50,30,20,-,-,87735
64,64,0,-,177100,87736
3435,2218,1217,588,87100,87740
212,187,25,-,163900,87742
121,86,35,525,66100,87743
292,254,38,-,193200,87745
42,26,16,-,53500,87746
552,409,143,350,108100,87747
22,0,22,-,-,87749
0,0,0,-,-,87750
171,111,60,453,52200,87752
23,4,19,-,-,87753
2663,1707,956,573,121900,87801
26,26,0,-,-,87820
307,302,5,-,162900,87821
306,284,22,-,179200,87823
95,95,0,-,296300,87824
669,605,64,956,64600,87825
59,59,0,-,290400,87827
183,183,0,-,60700,87828
236,236,0,-,166300,87829
518,445,73,811,142300,87830
60,54,6,-,91200,87831
205,194,11,-,-,87832
3125,2057,1068,482,75700,87901
252,210,42,575,77500,87930
368,304,64,-,138100,87931
31,31,0,-,-,87933
863,768,95,678,138700,87935
196,162,34,-,58600,87936
1007,585,422,455,64900,87937
41,41,0,-,-,87939
235,185,50,-,-,87940
299,183,116,-,-,87941
449,356,93,850,136900,87942
100,100,0,-,-,87943
14227,6109,8118,658,106800,88001
296,15,281,1140,-,88002
0,0,0,-,-,88003
0,0,0,-,-,88004
10920,7122,3798,718,157100,88005
8266,6034,2232,708,162400,88007
2501,1517,984,779,184100,88008
3,0,3,-,-,88009
12804,6917,5887,908,250500,88011
9761,7463,2298,1000,140800,88012
277,234,43,1094,76700,88020
5675,4062,1613,573,88900,88021
457,400,57,561,110800,88022
1033,713,320,630,84900,88023
85,70,15,-,35400,88024
165,117,48,-,-,88025
666,490,176,547,70000,88026
123,104,19,-,-,88027
98,88,10,-,177000,88028
408,303,105,515,71000,88029
8664,5293,3371,553,85900,88030
151,100,51,-,91200,88032
0,0,0,-,-,88033
36,36,0,-,-,88034
154,122,32,-,153100,88038
186,176,10,-,121100,88039
43,31,12,-,85400,88040
540,453,87,538,99600,88041
141,141,0,-,272500,88042
637,532,105,836,81000,88043
1388,1019,369,620,107900,88044
1362,945,417,497,79700,88045
384,253,131,630,223100,88046
878,652,226,807,156300,88047
922,807,115,810,88300,88048
195,167,28,-,263100,88049
54,54,0,-,141700,88051
114,69,45,-,112500,88052
80,9,71,605,-,88053
12,12,0,-,-,88055
110,94,16,-,113300,88056
7451,5208,2243,689,162700,88061
3645,2413,1232,543,95700,88063
267,162,105,951,129900,88065
457,317,140,662,67400,88072
4307,3372,935,663,71500,88081
17318,9812,7506,843,133800,88101
0,0,0,-,-,88103
54,40,14,817,180600,88112
22,11,11,-,92500,88113
3,3,0,-,-,88114
45,34,11,-,-,88115
139,113,26,685,103500,88116
110,64,46,427,155400,88118
631,427,204,671,68300,88119
88,69,19,575,104200,88120
44,32,12,463,73300,88121
497,397,100,755,84800,88124
21,9,12,-,-,88125
12,12,0,-,52000,88126
6651,4042,2609,763,114200,88130
96,59,37,1125,153100,88132
20,4,16,-,-,88134
561,373,188,690,90300,88135
15,12,3,-,-,88136
10137,7264,2873,779,146000,88201
10661,6710,3951,703,88100,88203
6915,4857,2058,772,162900,88210
13365,9502,3863,877,134000,88220
1577,1166,411,758,96000,88230
1064,852,212,795,95000,88231
655,535,120,521,85200,88232
12673,8012,4661,861,121200,88240
2381,1984,397,1019,175500,88242
105,29,76,-,-,88250
793,538,255,729,71500,88252
296,189,107,-,77700,88253
31,31,0,-,-,88254
11,11,0,-,-,88255
731,505,226,840,115900,88256
4613,3249,1364,731,109200,88260
4,4,0,-,-,88262
62,40,22,-,216700,88263
9,0,9,-,-,88264
52,27,25,-,128100,88265
437,330,107,623,68600,88267
57,30,27,-,-,88268
512,433,79,696,87100,88301
14701,8986,5715,774,117700,88310
528,449,79,529,60600,88311
1173,1013,160,873,308800,88312
22,0,22,-,-,88314
927,738,189,770,172800,88316
649,542,107,850,162100,88317
142,111,31,-,217700,88318
60,50,10,-,35800,88321
0,0,0,-,-,88323
86,76,10,-,185700,88324
266,231,35,-,202000,88325
1015,9,1006,1157,-,88330
142,78,64,-,120500,88336
968,817,151,-,113600,88337
105,105,0,-,162000,88338
241,198,43,-,158300,88339
957,563,394,329,59700,88340
229,227,2,-,268600,88341
45,39,6,-,-,88342
14,8,6,-,-,88343
13,13,0,-,-,88344
3273,2605,668,871,167500,88345
1091,655,436,506,151200,88346
59,27,32,-,-,88347
112,61,51,-,-,88348
12,12,0,-,-,88349
263,263,0,-,83900,88350
92,76,16,-,-,88351
2002,1659,343,681,88700,88352
103,68,35,-,43500,88353
14,0,14,-,-,88354
0,0,0,-,-,88355
2336,1478,858,522,67400,88401
23,10,13,-,-,88410
30,22,8,-,-,88411
11,9,2,-,-,88414
1090,713,377,510,81700,88415
0,0,0,-,-,88416
0,0,0,-,-,88417
71,51,20,-,-,88418
81,60,21,632,176600,88419
32,32,0,-,-,88421
54,54,0,-,213500,88422
41,35,6,-,"2,000,000+",88424
432,377,55,670,89300,88426
60,48,12,-,125000,88427
46,38,8,-,-,88430
10,10,0,-,-,88431
124,110,14,-,74500,88434
988,655,333,419,88600,88435
72,24,48,-,157400,88436
391,309,82,634,123200,89001
12021,8760,3261,1271,238600,89002
356,182,174,568,56700,89003
144,133,11,-,369400,89004
6403,4306,2097,985,241600,89005
320,239,81,1195,183200,89007
554,341,213,596,133900,89008
208,112,96,516,119700,89010
9080,5605,3475,1109,211100,89011
13337,8390,4947,1266,280600,89012
198,135,63,481,66200,89013
15658,6999,8659,1025,222700,89014
14961,8844,6117,981,183300,89015
46,46,0,-,-,89017
373,287,86,725,93400,89018
788,495,293,535,92500,89019
415,192,223,614,87300,89020
1018,811,207,1028,223600,89021
9,9,0,-,-,89022
373,262,111,624,151400,89025
0,0,0,-,-,89026
7729,5409,2320,816,204400,89027
4020,1749,2271,691,147600,89029
13374,4876,8498,820,94200,89030
20092,13373,6719,1338,180100,89031
13594,7548,6046,1131,164400,89032
96,96,0,-,110000,89039
1285,968,317,798,134700,89040
527,318,209,656,113500,89042
412,322,90,-,175800,89043
8294,6813,1481,1662,321400,89044
779,629,150,942,84600,89045
212,140,72,825,78900,89046
46,22,24,554,43800,89047
8789,6097,2692,822,138500,89048
1332,531,801,588,68400,89049
21160,13945,7215,1402,357500,89052
28,28,0,-,136400,89054
3874,2868,1006,744,118200,89060
2332,1852,480,1028,169300,89061
19453,11534,7919,1262,250900,89074
10344,5740,4604,1272,199000,89081
8794,5550,3244,1275,252700,89084
1307,1045,262,2144,277200,89085
1862,633,1229,1114,251600,89086
14219,2634,11585,692,95300,89101
14517,3439,11078,794,172800,89102
21483,7272,14211,901,125300,89103
14193,6433,7760,789,126800,89104
8629,2669,5960,827,123600,89106
12261,6217,6044,896,135300,89107
25876,11307,14569,975,142700,89108
3972,1149,2823,915,345600,89109
20897,11668,9229,944,149500,89110
10576,5554,5022,1157,255600,89113
17723,5834,11889,883,107300,89115
22687,10361,12326,1112,282400,89117
8226,3214,5012,1040,215000,89118
20964,4029,16935,821,159700,89119
9319,4993,4326,977,187000,89120
24164,11341,12823,886,141600,89121
17964,9832,8132,974,133900,89122
23261,12984,10277,1210,230900,89123
361,319,42,932,399200,89124
14181,7016,7165,1064,205500,89128
19727,12757,6970,1223,233600,89129
12555,8843,3712,1266,223200,89130
15670,11836,3834,1396,286800,89131
11358,8982,2376,1484,266300,89134
11000,7314,3686,1646,374200,89135
5322,3511,1811,1751,397600,89138
12126,6833,5293,1407,246700,89139
10056,6768,3288,1582,283100,89141
10869,6016,4853,1076,154400,89142
4257,3105,1152,1437,229500,89143
7224,4627,2597,1385,288000,89144
9614,5689,3925,1166,181200,89145
6653,2834,3819,957,247900,89146
19600,9865,9735,1180,209400,89147
16954,7914,9040,1334,256400,89148
13824,8593,5231,1222,268500,89149
9189,5342,3847,915,139300,89156
84,84,0,-,354800,89161
5793,3436,2357,1255,245100,89166
8705,1447,7258,780,129900,89169
12150,8524,3626,1379,255900,89178
1961,1627,334,1449,253800,89179
13574,6411,7163,1214,217800,89183
0,0,0,-,-,89191
2495,1861,634,673,147800,89301
260,231,29,-,168500,89310
44,29,15,-,-,89311
130,56,74,315,60000,89314
515,333,182,376,85500,89316
115,115,0,-,141800,89317
561,432,129,770,83400,89318
108,94,14,-,-,89319
8,8,0,-,-,89402
5711,4106,1605,983,191500,89403
46,32,14,-,-,89404
17,0,17,-,-,89405
9715,6242,3473,792,169400,89406
7263,4847,2416,1042,164600,89408
112,112,0,-,36200,89409
4692,3029,1663,1005,302100,89410
332,299,33,696,712500,89411
125,125,0,-,-,89412
299,234,65,-,1465500,89413
142,107,35,883,100500,89414
1393,932,461,555,99100,89415
132,59,73,-,64100,89418
1517,1039,478,640,102800,89419
8,0,8,-,-,89420
180,150,30,554,70300,89421
45,45,0,-,62100,89422
4483,3585,898,1313,352600,89423
106,72,34,288,85000,89424
182,157,25,-,-,89425
138,113,25,-,-,89426
390,226,164,324,45700,89427
91,77,14,-,227900,89428
2776,2239,537,885,97400,89429
202,155,47,-,341700,89430
14379,6024,8355,833,169600,89431
6822,4686,2136,952,131500,89433
10505,6637,3868,1104,222000,89434
15104,11109,3995,1460,292800,89436
36,36,0,-,"10,000-",89438
667,482,185,1216,296800,89439
365,206,159,764,262200,89440
4292,3603,689,1490,323900,89441
435,331,104,630,107900,89442
1242,1043,199,973,195100,89444
5923,4537,1386,829,163900,89445
0,0,0,-,-,89446
3304,2174,1130,657,104700,89447
696,501,195,1247,650500,89448
1522,799,723,1110,422400,89449
45,37,8,-,-,89450
3700,2687,1013,1380,773000,89451
5499,3591,1908,1036,275300,89460
2369,500,1869,633,285500,89501
18300,6369,11931,779,172800,89502
11430,5174,6256,828,229300,89503
13386,9109,4277,1084,192500,89506
4353,3745,608,1328,223400,89508
16556,8617,7939,888,359400,89509
592,542,50,500,312200,89510
10751,7822,2929,1080,513200,89511
9743,3246,6497,771,142100,89512
3673,2899,774,1399,463400,89519
11247,7921,3326,1517,329300,89521
14223,7816,6407,1144,325800,89523
9918,5402,4516,796,209700,89701
0,0,0,-,-,89702
4416,3023,1393,889,330000,89703
1765,1597,168,1140,334900,89704
2090,1503,587,1175,225500,89705
8439,4216,4223,934,150500,89706
8751,5990,2761,958,205200,89801
4961,4300,661,1401,218400,89815
1968,1580,388,632,143400,89820
249,194,55,938,80000,89821
745,588,157,995,102700,89822
59,49,10,-,591900,89823
525,179,346,537,-,89825
0,0,0,-,-,89826
155,155,0,-,227700,89828
82,39,43,-,-,89830
16,16,0,-,-,89831
499,263,236,481,91300,89832
56,20,36,262,-,89833
50,17,33,-,-,89834
752,441,311,713,169800,89835
1332,637,695,738,155200,89883
13807,4887,8920,1051,305500,90001
12694,4549,8145,1074,272400,90002
16581,4703,11878,1133,300700,90003
22140,3673,18467,1177,918500,90004
16399,1332,15067,1060,713400,90005
19486,1619,17867,1030,530500,90006
11695,1411,10284,1111,523500,90007
14937,4854,10083,1097,566000,90008
1986,427,1559,1692,816300,90010
23884,6110,17774,1074,328500,90011
11971,1283,10688,1327,465100,90012
7047,618,6429,810,531900,90013
5000,182,4818,1550,417200,90014
8510,1109,7401,1064,617400,90015
16954,6319,10635,1163,458100,90016
10433,443,9990,951,589300,90017
16395,4952,11443,1050,454900,90018
24426,6835,17591,1245,774600,90019
16364,1539,14825,1221,623200,90020
1966,163,1803,473,915000,90021
17640,5778,11862,1022,349600,90022
11583,3292,8291,1034,355200,90023
16812,5049,11763,2068,1098000,90024
21959,5715,16244,1808,756200,90025
25510,5777,19733,1213,715100,90026
21907,4161,17746,1324,959600,90027
16301,928,15373,1273,649200,90028
14188,1375,12813,1104,608000,90029
11720,3830,7890,1072,432800,90031
13429,6507,6922,1120,419900,90032
13165,2230,10935,980,356900,90033
25725,4907,20818,1566,780200,90034
12704,4058,8646,1815,961200,90035
18230,2993,15237,2055,1153400,90036
17007,4176,12831,1031,326400,90037
11190,1052,10138,1161,674300,90038
11523,4929,6594,1535,717800,90039
3565,1525,2040,1056,356600,90040
9547,5119,4428,1338,647700,90041
20527,9216,11311,1216,500300,90042
16789,8858,7931,1070,438200,90043
27804,8380,19424,1031,326600,90044
15576,8169,7407,1842,840800,90045
29180,6536,22644,1517,1047200,90046
16952,9204,7748,1157,351500,90047
12184,3691,8493,1997,1078000,90048
16514,8466,8048,2108,1914900,90049
3480,2429,1051,1601,864600,90056
16914,688,16226,957,378300,90057
795,100,695,590,321700,90058
10590,4723,5867,946,286700,90059
7307,2909,4398,1147,298200,90061
9719,4138,5581,1118,357600,90062
13591,5132,8459,1073,350400,90063
10999,6019,4980,1871,1052100,90064
15167,7116,8051,1187,604600,90065
24951,9516,15435,1612,911400,90066
1342,1099,243,2442,1066900,90067
11703,5622,6081,1654,1121600,90068
12379,4755,7624,1724,777600,90069
0,0,0,-,-,90071
0,0,0,-,-,90073
3370,2802,568,2371,1744400,90077
0,0,0,-,-,90079
7,0,7,-,-,90089
0,0,0,-,-,90090
3874,1653,2221,2751,889100,90094
0,0,0,-,-,90095
24088,5563,18525,1140,348600,90201
7983,5543,2440,2383,"2,000,000+",90210
3755,1139,2616,1819,1242300,90211
5921,1836,4085,2013,1641000,90212
13270,8006,5264,1154,266700,90220
12122,6080,6042,1135,301500,90221
7820,3774,4046,1151,289700,90222
13088,7130,5958,1621,658500,90230
6458,2448,4010,1657,896700,90232
7224,4857,2367,1469,530800,90240
13371,5614,7757,1246,496300,90241
12101,6145,5956,1336,447000,90242
6638,2958,3680,1681,875600,90245
15870,6448,9422,1168,397000,90247
3642,2584,1058,1219,424900,90248
8639,5083,3556,1144,420000,90249
32242,9714,22528,1140,466200,90250
9158,4259,4899,2035,1220500,90254
18387,5899,12488,992,357800,90255
10635,4123,6512,1365,450200,90260
15327,6505,8822,1123,345000,90262
0,0,0,-,-,90263
7248,5407,1841,2579,1692300,90265
13529,9319,4210,2393,1694900,90266
6609,1563,5046,1000,350800,90270
9094,7260,1834,2364,"2,000,000+",90272
9175,8035,1140,2606,1455300,90274
15838,12611,3227,2391,1051900,90275
15797,7111,8686,1916,956400,90277
15559,8860,6699,1802,767100,90278
23557,10254,13303,1072,351000,90280
2368,1842,526,1970,931800,90290
13676,4519,9157,1861,1324200,90291
12354,3360,8994,2638,860200,90292
6655,3258,3397,1963,688400,90293
12096,3124,8972,1139,354400,90301
10872,3035,7837,1208,379900,90302
7231,2856,4375,1188,390800,90303
6443,1921,4522,1075,373200,90304
5775,3880,1895,1362,422100,90305
4716,250,4466,1757,949100,90401
4967,3311,1656,1884,"2,000,000+",90402
13458,2994,10464,1765,1018300,90403
9938,2178,7760,1474,790000,90404
14161,4808,9353,1650,1197900,90405
14267,6297,7970,1281,577100,90501
5955,3979,1976,1425,405000,90502
16994,8674,8320,1658,704600,90503
11456,6851,4605,1401,581400,90504
14362,8005,6357,1647,809200,90505
0,0,0,-,-,90506
11216,6780,4436,1349,475200,90601
7826,3151,4675,1189,490300,90602
6682,5309,1373,1733,531300,90603
12113,7934,4179,1370,449500,90604
10719,7365,3354,1371,423300,90605
8924,5941,2983,1386,398400,90606
12747,8766,3981,1701,478500,90620
10123,3957,6166,1413,496800,90621
4933,3379,1554,1651,613200,90623
15937,10724,5213,1753,575600,90630
21416,13051,8365,1417,522800,90631
14544,11253,3291,1617,479000,90638
19863,8815,11048,1211,441800,90640
27238,17155,10083,1450,375400,90650
17011,11378,5633,1259,380200,90660
4793,3186,1607,1330,408400,90670
8627,4274,4353,1407,349800,90680
4529,2297,2232,1471,438800,90701
15667,12280,3387,2188,637300,90703
1437,322,1115,1399,656300,90704
23359,9352,14007,1263,398000,90706
9193,4938,4255,1119,444000,90710
10403,7549,2854,1715,475200,90712
9290,7539,1751,1890,506800,90713
6041,3433,2608,1524,411500,90715
3836,1565,2271,1266,311400,90716
8470,3840,4630,1286,558800,90717
7821,5122,2699,1746,857100,90720
14339,5584,8755,1256,304400,90723
22373,6895,15478,1214,508200,90731
8610,5978,2632,1867,558700,90732
12422,9352,3070,1765,335900,90740
387,143,244,2065,1520800,90742
125,75,50,2273,-,90743
14509,5557,8952,1064,353800,90744
15103,10338,4765,1389,380400,90745
8112,7019,1093,1664,430400,90746
0,0,0,-,-,90747
4391,2049,2342,1365,444300,90755
20711,4478,16233,1153,356400,90802
16838,7245,9593,1516,790900,90803
14846,3171,11675,1193,435700,90804
26783,11240,15543,1149,345200,90805
12479,4450,8029,1103,408900,90806
12570,6448,6122,1288,559100,90807
13924,10709,3215,1635,601200,90808
9294,5092,4202,1190,360800,90810
16983,2115,14868,1008,339400,90813
8927,3202,5725,1292,647700,90814
14349,9655,4694,1738,588900,90815
0,0,0,-,-,90822
0,0,0,-,-,90831
12654,9484,3170,1617,649700,91001
10590,7284,3306,1678,901300,91006
11627,6401,5226,1421,959600,91007
429,276,153,2732,1615400,91008
7931,5020,2911,1486,412000,91010
6590,5846,744,2185,1282200,91011
14399,6992,7407,1366,583900,91016
3338,1076,2262,1492,517600,91020
4441,2683,1758,1487,889300,91024
10231,4661,5570,1555,928500,91030
7335,5221,2114,1245,492100,91040
9822,5195,4627,1261,486500,91042
121,0,121,1056,-,91046
10510,1807,8703,1536,479100,91101
8529,4179,4350,1275,637200,91103
13149,6717,6432,1331,649400,91104
5343,3015,2328,2113,1018900,91105
10663,4004,6659,1567,674600,91106
12472,7590,4882,1503,752100,91107
4684,3954,730,"3,500+",1514800,91108
8238,2555,5683,1401,657200,91201
8727,3377,5350,1620,679500,91202
5188,1071,4117,1445,468100,91203
6196,728,5468,1295,469300,91204
14158,2139,12019,1295,486400,91205
13173,4484,8689,1476,704400,91206
3963,2239,1724,1572,951100,91207
5898,3822,2076,1780,814800,91208
310,51,259,2985,630700,91210
10425,7817,2608,1715,693300,91214
9156,6990,2166,2260,764100,91301
9503,6812,2691,2296,1142400,91302
9716,2385,7331,1354,398300,91303
16984,8559,8425,1363,536200,91304
14589,8158,6431,1272,443000,91306
8826,7420,1406,2602,615300,91307
14024,9135,4889,1762,533600,91311
12442,6198,6244,1565,633600,91316
15120,11576,3544,2187,645100,91320
11172,6192,4980,1463,411800,91321
10016,5089,4927,1567,551000,91324
11654,5387,6267,1419,597200,91325
12594,9083,3511,1802,678100,91326
0,0,0,-,-,91330
23127,14090,9037,1340,359800,91331
24004,11796,12208,1286,422300,91335
8432,4751,3681,1281,366600,91340
24908,16512,8396,1470,401700,91342
17732,9259,8473,1239,458500,91343
16940,12619,4321,1674,554800,91344
5300,3796,1504,1536,397300,91345
11452,9506,1946,1825,463700,91350
9928,7018,2910,1590,376300,91351
12411,6541,5870,1284,424500,91352
10122,7795,2327,2227,536100,91354
12051,7056,4995,1860,488100,91355
11613,6484,5129,1485,826400,91356
15133,10150,4983,1801,620100,91360
8675,6616,2059,2146,871700,91361
13641,9723,3918,1825,751500,91362
10434,7271,3163,1937,750800,91364
17659,9121,8538,1961,629800,91367
0,0,0,-,-,91371
5313,3717,1596,2258,714600,91377
6784,4637,2147,1851,644900,91381
6982,5773,1209,1339,456000,91384
13275,8159,5116,1796,450800,91387
6214,5569,645,1902,540900,91390
14951,5167,9784,1247,613100,91401
19301,6433,12868,1169,346800,91402
11315,5090,6225,1672,887100,91403
17519,4344,13175,1164,418100,91405
18228,7358,10870,1247,462600,91406
9662,2711,6951,1269,566900,91411
15469,6127,9342,1718,835800,91423
5519,4409,1110,2137,1143200,91436
8013,2526,5487,1543,677300,91501
5215,440,4775,1377,416500,91502
9317,4816,4501,1475,662700,91504
12869,5962,6907,1708,630000,91505
7411,4009,3402,1485,638500,91506
16798,3321,13477,1348,560800,91601
9648,3330,6318,1578,687000,91602
14437,6613,7824,1780,1004700,91604
15822,5712,10110,1222,424300,91605
15352,4527,10825,1205,476300,91606
13760,4254,9506,1394,699900,91607
0,0,0,-,-,91608
12909,10223,2686,1557,452700,91701
15144,8671,6473,1333,366200,91702
18013,10209,7804,1357,358000,91706
393,220,173,2380,429500,91708
24091,18518,5573,1939,567200,91709
20958,13508,7450,1493,404300,91710
11899,7880,4019,1476,604300,91711
10217,7243,2974,1387,390700,91722
6297,2669,3628,1310,428700,91723
7994,5767,2227,1541,478100,91724
23306,10313,12993,1604,357000,91730
8079,3051,5028,1081,404700,91731
15939,6860,9079,1207,401000,91732
11200,4688,6512,1175,389000,91733
8151,5705,2446,1748,559000,91737
11620,8123,3497,1794,547600,91739
8331,5722,2609,1429,437200,91740
9015,6536,2479,1664,625100,91741
18493,12294,6199,1288,362000,91744
16204,12503,3701,1733,545400,91745
6647,4901,1746,1309,380700,91746
13579,8718,4861,1490,583900,91748
11799,8807,2992,1423,543500,91750
8184,5082,3102,1351,395400,91752
10932,6091,4841,1233,573500,91754
8796,4500,4296,1318,558400,91755
215,152,63,1500,431400,91759
16863,10970,5893,1441,334300,91761
17288,8453,8835,1215,321000,91762
10281,5660,4621,1239,304700,91763
15774,7308,8466,1408,302900,91764
15096,11663,3433,1916,617900,91765
17788,9545,8243,1288,351400,91766
13961,7136,6825,1250,342000,91767
8082,4188,3894,1139,330000,91768
17063,8997,8066,1239,480100,91770
11743,8414,3329,1605,514100,91773
8117,5352,2765,1416,723500,91775
11532,4470,7062,1312,573300,91776
10917,6895,4022,1376,656000,91780
9106,7840,1266,2264,584400,91784
19205,8238,10967,1264,390500,91786
13288,10920,2368,2123,676900,91789
12327,8499,3828,1440,444300,91790
10171,6859,3312,1480,531900,91791
8747,4830,3917,1617,428500,91792
19624,7247,12377,1297,541200,91801
9523,4493,5030,1254,569100,91803
6420,4778,1642,1397,525700,91901
6078,4415,1663,1777,607100,91902
610,369,241,706,279900,91905
1094,754,340,968,221300,91906
25375,12013,13362,1298,424700,91910
24288,12260,12028,1359,361600,91911
14369,10034,4335,1947,451700,91913
4598,3833,765,2425,611700,91914
8205,5941,2264,2250,475000,91915
672,631,41,878,349800,91916
232,215,17,-,277100,91917
74,74,0,-,75700,91931
8847,2812,6035,1269,433400,91932
206,146,60,-,132400,91934
2807,2377,430,1858,592300,91935
11873,7419,4454,1378,572200,91941
16531,6395,10136,1395,428800,91942
8495,4549,3946,1212,367700,91945
14,14,0,-,-,91948
16546,5511,11035,1075,345300,91950
820,637,183,1200,376500,91962
321,267,54,1173,174100,91963
18726,10713,8013,1280,375400,91977
3197,2092,1105,1660,404900,91978
83,63,20,-,-,91980
1805,1196,609,1558,589100,92003
1225,891,334,756,169800,92004
4484,2534,1950,1951,920600,92007
11374,5220,6154,1744,699600,92008
16485,12206,4279,1978,779300,92009
5783,4242,1541,2225,578400,92010
9432,6275,3157,2123,759100,92011
6104,4096,2008,2137,1412200,92014
14888,9887,5001,1552,473400,92019
19052,7431,11621,1176,478500,92020
22200,11244,10956,1266,363500,92021
19815,12975,6840,1802,853000,92024
15181,6328,8853,1247,468800,92025
16378,9741,6637,1375,428300,92026
16194,9435,6759,1317,382900,92027
16532,11076,5456,1167,495700,92028
6990,5309,1681,1665,542400,92029
1105,805,300,1125,319400,92036
17108,9934,7174,1916,1276500,92037
14919,9665,5254,1248,411300,92040
15829,6001,9828,1358,498900,92054
106,0,106,-,-,92055
19872,12494,7378,1692,431000,92056
19281,12329,6952,1774,417900,92057
14155,3962,10193,1770,331200,92058
422,332,90,1013,313600,92059
70,58,12,-,279200,92060
628,392,236,1270,380000,92061
15811,11771,4040,1485,621300,92064
12090,9117,2973,1336,454100,92065
188,126,62,1074,369600,92066
2994,2657,337,1884,"2,000,000+",92067
14446,8225,6221,1373,449900,92069
372,281,91,546,397100,92070
19404,13431,5973,1598,397000,92071
5488,3108,2380,1975,1118800,92075
17306,11481,5825,1661,478700,92078
10510,5553,4957,1690,467100,92081
6126,4839,1287,1212,489500,92082
11182,5249,5933,1366,361400,92083
15175,8656,6519,1348,464900,92084
751,589,162,782,134600,92086
644,547,97,2538,895100,92091
22356,5373,16983,1497,556900,92101
14454,3950,10504,1147,359600,92102
17971,6197,11774,1388,693200,92103
20968,6349,14619,1231,550100,92104
21539,6422,15117,1079,329100,92105
7347,4190,3157,1849,931500,92106
13157,5078,8079,1473,787900,92107
10835,2797,8038,1954,326500,92108
22747,6218,16529,1565,799700,92109
11041,4733,6308,1545,536800,92110
16957,8314,8643,1424,460000,92111
13041,3464,9577,1040,299400,92113
17789,11779,6010,1324,352300,92114
21307,7055,14252,1238,437100,92115
16681,5448,11233,1217,556900,92116
20793,12300,8493,1488,542000,92117
8486,4179,4307,2366,1423600,92118
9394,6499,2895,1684,501500,92119
11406,7897,3509,1633,563700,92120
1794,1011,783,1950,751300,92121
19812,6315,13497,1912,648200,92122
11571,5613,5958,1921,471900,92123
10917,5129,5788,2188,574100,92124
24510,14011,10499,1857,464100,92126
14937,10050,4887,1923,719100,92127
20524,13147,7377,1932,571500,92128
17744,11904,5840,1842,646400,92129
19126,12758,6368,2351,943400,92130
11572,9204,2368,2222,700600,92131
0,0,0,-,-,92132
0,0,0,-,-,92134
0,0,0,-,-,92135
10415,6244,4171,1474,346900,92139
12,0,12,-,-,92140
625,430,195,1328,1259200,92145
0,0,0,-,-,92147
21626,12727,8899,1467,345400,92154
0,0,0,-,-,92155
7903,2362,5541,1060,335600,92173
21253,13104,8149,997,210100,92201
11219,7946,3273,1390,323200,92203
2611,2210,401,857,675100,92210
12726,9401,3325,1389,350600,92211
11640,7480,4160,996,200900,92220
0,0,0,-,-,92222
16189,12131,4058,1183,269800,92223
6009,3317,2692,712,134000,92225
7412,3976,3436,822,159700,92227
984,486,498,1104,125400,92230
9237,4861,4376,862,182900,92231
1005,508,497,696,119600,92233
17872,10747,7125,1160,232400,92234
12953,8517,4436,894,183800,92236
49,44,5,-,78000,92239
11812,5770,6042,944,153300,92240
3488,2691,797,718,80900,92241
626,517,109,547,70800,92242
13189,6827,6362,772,171600,92243
1828,1155,673,766,172700,92249
2409,1430,979,700,162200,92250
5211,3780,1431,1156,208400,92251
3822,2150,1672,839,118200,92252
14911,10774,4137,1429,376100,92253
2816,1632,1184,669,115300,92254
1461,1193,268,918,133800,92256
705,499,206,419,39000,92257
229,182,47,-,71500,92258
79,74,5,-,78600,92259
15577,9115,6462,1151,316900,92260
13100,7351,5749,988,360900,92262
10846,6747,4099,1036,304600,92264
93,64,29,-,-,92266
5,0,5,-,-,92267
285,238,47,760,173400,92268
9402,7367,2035,1251,483100,92270
452,223,229,773,146900,92273
5008,3184,1824,675,69200,92274
708,527,181,948,113100,92275
2662,1887,775,1220,149300,92276
9114,3137,5977,911,121600,92277
191,0,191,1190,-,92278
17,0,17,-,-,92280
665,313,352,730,109500,92281
486,317,169,1346,136600,92282
646,334,312,576,77600,92283
10670,6962,3708,978,156700,92284
1105,847,258,891,91900,92285
8151,4036,4115,1048,150000,92301
14,0,14,-,-,92304
228,135,93,1550,278000,92305
12599,8576,4023,988,226900,92307
14062,9018,5044,1038,201700,92308
215,45,170,746,-,92309
2414,0,2414,1243,-,92310
11506,5604,5902,747,108600,92311
4279,2602,1677,1305,276500,92313
4464,2883,1581,1070,241200,92314
2165,1203,962,943,381600,92315
7505,5360,2145,1149,234400,92316
3310,2790,520,978,194300,92320
442,333,109,1108,281400,92321
294,190,104,1078,183000,92322
17718,9252,8466,1087,213600,92324
3618,2324,1294,900,217300,92325
257,136,121,586,109200,92327
172,59,113,-,-,92328
8,8,0,-,-,92332
185,144,41,1573,457600,92333
24750,12590,12160,1086,255900,92335
23408,17609,5799,1772,364100,92336
9613,6764,2849,1546,304000,92337
0,0,0,-,-,92338
504,402,102,1300,235900,92339
130,107,23,-,199500,92341
2484,1883,601,1398,216300,92342
6103,4848,1255,1456,277900,92344
23273,14457,8816,1073,192100,92345
16944,11342,5602,1017,286600,92346
235,208,27,-,-,92347
2380,1780,600,1392,384500,92352
7503,3021,4482,1172,340000,92354
2293,1637,656,739,129300,92356
422,288,134,1083,232800,92358
2997,1838,1159,935,269600,92359
2259,1273,986,585,85800,92363
0,0,0,-,-,92364
995,777,218,901,114200,92365
278,151,127,967,121900,92368
5361,3964,1397,1107,193400,92371
2110,1690,420,1077,197100,92372
13011,6515,6496,1249,427400,92373
13048,7875,5173,1170,301300,92374
21515,12663,8852,1122,233700,92376
5389,4674,715,2034,323800,92377
66,66,0,-,262500,92378
1867,1237,630,1141,218100,92382
11,5,6,-,-,92384
123,100,23,-,285300,92385
952,507,445,950,176900,92386
89,62,27,559,66300,92389
963,563,400,1009,267400,92391
15718,9117,6601,1296,191300,92392
8044,4927,3117,1241,191000,92394
13145,6370,6775,1087,174900,92395
1743,1144,599,1173,291100,92397
627,234,393,699,-,92398
18308,13280,5028,1033,279100,92399
708,74,634,770,120500,92401
17465,7589,9876,989,221200,92404
8756,3981,4775,958,183500,92405
16465,9460,7005,1191,272700,92407
3789,1297,2492,976,219200,92408
12391,4898,7493,890,113500,92410
6390,3316,3074,1031,158100,92411
6680,3011,3669,1059,262700,92501
25088,15528,9560,1268,315400,92503
16411,9535,6876,1207,294400,92504
13334,6868,6466,1349,309700,92505
14869,11147,3722,1359,388900,92506
16824,5553,11271,1202,290900,92507
10239,8361,1878,1913,421300,92508
19506,13134,6372,1170,290800,92509
520,38,482,1801,276300,92518
15161,8415,6746,1191,261000,92530
6291,4632,1659,1766,338800,92532
1061,769,292,1025,259800,92536
1582,1017,565,795,166300,92539
12990,6303,6687,925,104600,92543
15435,10359,5076,1065,184100,92544
15105,10109,4996,1205,189700,92545
2300,1386,914,993,89500,92548
1266,844,422,1063,275200,92549
8054,5131,2923,1324,232800,92551
18304,8880,9424,1239,223100,92553
10699,7724,2975,1659,315600,92555
13892,9134,4758,1401,276100,92557
787,691,96,950,362900,92561
19712,13211,6501,1542,385900,92562
17466,12369,5097,1731,368700,92563
2623,1874,749,1188,257000,92567
13705,8436,5269,1098,251100,92570
12348,8116,4232,1465,238600,92571
4042,3037,1005,1466,220100,92582
9213,5661,3552,985,160300,92583
14671,11727,2944,1780,331900,92584
5889,4483,1406,1476,293100,92585
9317,6041,3276,1106,183800,92586
5668,4392,1276,1665,350700,92587
1494,626,868,899,1001600,92590
12965,7344,5621,1635,395100,92591
24105,17536,6569,1879,418400,92592
9240,6517,2723,1552,311000,92595
7556,5688,1868,1801,362100,92596
8862,4635,4227,1991,747900,92602
7816,5132,2684,2309,1143900,92603
9860,6076,3784,2104,675700,92604
8205,3514,4691,2193,722700,92606
4180,3200,980,1858,639800,92610
12594,3863,8731,2155,667400,92612
9247,4319,4928,2143,676900,92614
4128,1013,3115,1353,443100,92617
14045,5485,8560,2224,725700,92618
18112,10725,7387,2032,835600,92620
2704,1716,988,1842,755600,92624
5808,4134,1674,2329,"2,000,000+",92625
18889,8125,10764,1847,674800,92626
21860,7823,14037,1614,670100,92627
11652,7097,4555,1940,849500,92629
21211,14218,6993,1837,573500,92630
11251,8561,2690,1656,246600,92637
21402,16197,5205,1923,664500,92646
21062,9598,11464,1700,638600,92647
19576,9971,9605,1729,848900,92648
14282,8815,5467,1756,696800,92649
11035,7016,4019,2216,1639400,92651
9732,6959,2773,1965,663300,92653
2526,915,1611,1374,453800,92655
19297,11601,7696,2058,577900,92656
3912,3144,768,2570,"2,000,000+",92657
15153,8091,7062,2265,1569900,92660
1616,771,845,1854,1625000,92661
1425,765,660,2091,"2,000,000+",92662
10018,4693,5325,1867,1163100,92663
14197,7529,6668,1704,829100,92672
10355,8595,1760,2479,863400,92673
12390,9207,3183,1892,636000,92675
849,688,161,1945,545500,92676
25338,17687,7651,2013,737400,92677
221,131,90,-,498800,92678
10762,9238,1524,2179,826900,92679
27700,14638,13062,1425,546200,92683
16090,10871,5219,1827,583900,92688
16665,12662,4003,2057,625400,92691
17983,13909,4074,2095,664500,92692
8030,6000,2030,2246,792800,92694
12693,3329,9364,1164,402400,92701
13705,6579,7126,1432,376700,92703
20072,10666,9406,1595,411300,92704
14940,10271,4669,1550,812200,92705
9124,4827,4297,1271,543700,92706
13787,6805,6982,1568,408700,92707
18856,12898,5958,1815,653800,92708
19705,8888,10817,1576,535500,92780
8422,5198,3224,2215,731000,92782
18038,5918,12120,1423,418400,92801
11475,4168,7307,1375,448200,92802
24301,9764,14537,1409,451400,92804
18789,7587,11202,1381,442600,92805
12415,4894,7521,1716,486900,92806
12272,9663,2609,2072,630500,92807
7440,5555,1885,2181,671700,92808
13879,8157,5722,1682,597300,92821
1243,1106,137,3233,734500,92823
12458,4738,7720,1445,598300,92831
8118,3177,4941,1422,478500,92832
16184,9225,6959,1541,562400,92833
8429,6179,2250,1687,709800,92835
14818,8097,6721,1455,454700,92840
9527,4941,4586,1383,484000,92841
11703,5400,6303,1332,438300,92843
6572,2855,3717,1431,429900,92844
5642,4607,1035,1756,573300,92845
7019,5715,1304,1850,479000,92860
1984,1877,107,"3,500+",1081200,92861
6278,3764,2514,1716,554200,92865
5422,1992,3430,1557,626100,92866
12937,8433,4504,1649,661700,92867
7898,2668,5230,1670,407400,92868
11442,8266,3176,1691,626900,92869
16876,10963,5913,1661,586700,92870
14460,8247,6213,1482,351100,92879
17667,12970,4697,2084,475100,92880
9765,7536,2229,1571,464400,92881
21807,14288,7519,1385,399500,92882
10298,8671,1627,2321,419800,92883
16319,13344,2975,1893,748700,92886
6628,5626,1002,2014,842500,92887
12567,5135,7432,1358,491600,93001
19106,11016,8090,1604,496100,93003
10718,6792,3926,1648,478100,93004
15427,9658,5769,1735,568500,93010
13209,9898,3311,2022,580400,93012
6330,3420,2910,1763,690500,93013
4997,3311,1686,1242,361200,93015
11747,8705,3042,1831,596000,93021
2517,1941,576,1445,483700,93022
7766,5100,2666,1552,623900,93023
14865,7423,7442,1337,413800,93030
16948,9366,7582,1389,337300,93033
9982,5782,4200,1887,485100,93035
12838,6428,6410,1465,415100,93036
570,387,183,1094,308700,93040
7127,3045,4082,1650,355700,93041
0,0,0,-,-,93042
29,6,23,-,-,93043
9796,5251,4545,1163,357200,93060
19024,13291,5733,1743,491500,93063
0,0,0,-,-,93064
24008,17689,6319,1914,529500,93065
1097,684,413,1392,833300,93066
342,189,153,1170,759900,93067
12801,2926,9875,1442,785100,93101
7324,3314,4010,1854,958300,93103
10949,6099,4850,1809,969100,93105
4166,3138,1028,2400,"2,000,000+",93108
4714,3060,1654,2124,1031800,93109
6319,4082,2237,1740,801400,93110
6414,4319,2095,2068,842200,93111
15516,5865,9651,1615,734200,93117
336,144,192,740,89200,93201
1075,611,464,932,123100,93202
5159,2299,2860,824,133300,93203
2197,985,1212,744,129900,93204
718,504,214,801,93800,93205
569,247,322,807,150800,93206
128,120,8,-,164600,93207
48,0,48,-,-,93208
4712,2518,2194,840,161200,93210
4335,1958,2377,795,124300,93212
11854,6871,4983,831,168600,93215
267,172,95,765,104600,93218
2429,1088,1341,664,127900,93219
121,0,121,-,-,93220
4928,3256,1672,844,211500,93221
614,483,131,1459,189300,93222
2652,1722,930,741,133900,93223
151,97,54,850,95000,93224
1909,1068,841,850,170100,93225
104,87,17,892,196300,93226
21516,12080,9436,922,196000,93230
1809,509,1300,663,120700,93234
1100,548,552,748,106300,93235
700,393,307,974,226400,93238
399,229,170,856,87300,93239
2934,1814,1120,796,118700,93240
4141,1674,2467,764,110000,93241
1035,526,509,930,148600,93242
656,483,173,746,-,93243
164,127,37,808,238400,93244
12051,5670,6381,1050,206400,93245
5092,2605,2487,738,148800,93247
532,180,352,664,113300,93249
3525,2010,1515,873,155300,93250
79,51,28,450,45400,93251
558,340,218,781,77600,93252
211,122,89,937,90000,93254
389,292,97,-,74400,93255
1429,512,917,781,111500,93256
21601,11708,9893,852,164600,93257
550,275,275,778,92900,93258
76,35,41,1432,131300,93260
725,302,423,641,107000,93261
0,0,0,-,-,93262
5251,2765,2486,801,165000,93263
1707,1378,329,1070,260500,93265
322,147,175,787,149300,93266
1898,912,986,736,145100,93267
5699,3062,2637,809,134700,93268
1445,867,578,798,187000,93270
1043,874,169,1039,291300,93271
1037,386,651,879,129400,93272
21601,11743,9858,957,180300,93274
55,33,22,775,-,93276
18163,10112,8051,944,196200,93277
5853,3149,2704,705,156600,93280
958,737,221,597,100400,93283
1068,952,116,597,135500,93285
2891,1797,1094,694,154700,93286
34,34,0,-,260000,93287
16366,10158,6208,905,247400,93291
13470,8012,5458,1019,190300,93292
4793,1346,3447,777,171800,93301
15223,6442,8781,893,135400,93304
10714,3647,7067,795,128600,93305
21743,13715,8028,967,178800,93306
21942,10978,10964,933,140100,93307
19401,8921,10480,958,189500,93308
21853,9787,12066,955,184000,93309
14223,9829,4394,1414,289000,93311
19124,14547,4577,1584,278200,93312
13267,9723,3544,1526,224600,93313
8566,7401,1165,1287,338600,93314
12292,5651,6641,1298,627900,93401
6375,4293,2082,1427,461500,93402
8410,2956,5454,1566,640200,93405
0,0,0,-,-,93410
11817,8225,3592,1290,587500,93420
12610,8055,4555,1298,448600,93422
488,348,140,1458,656500,93424
508,390,118,1093,446300,93426
2137,1446,691,1476,464100,93427
2910,2113,797,1331,627800,93428
47,47,0,-,169000,93429
1515,987,528,1229,710300,93430
423,362,61,2287,611900,93432
5321,2240,3081,1241,446800,93433
1944,975,969,1150,221400,93434
17749,8980,8769,1137,294400,93436
950,0,950,1786,-,93437
486,244,242,1238,451900,93440
402,276,126,1868,882500,93441
5109,2932,2177,1392,540600,93442
7057,5188,1869,1546,497200,93444
2589,1264,1325,1102,345700,93445
17200,11220,5980,1181,424900,93446
4081,2429,1652,1555,660000,93449
219,48,171,821,259400,93450
1325,881,444,1336,356000,93451
233,37,196,949,-,93452
1368,1001,367,1148,442000,93453
11725,6088,5637,1264,307800,93454
15224,11402,3822,1644,369700,93455
13234,5898,7336,1193,263600,93458
1993,1549,444,1569,891600,93460
546,291,255,1382,275600,93461
3227,1992,1235,1476,777300,93463
3175,2435,740,1600,558700,93465
1948,849,1099,663,100700,93501
4101,2078,2023,917,101800,93505
2688,2397,291,1639,495900,93510
124,94,30,-,-,93512
710,496,214,947,197200,93513
6219,4107,2112,936,284000,93514
970,587,383,608,61300,93516
246,205,41,-,148800,93517
425,313,112,1000,182100,93518
28,28,0,-,-,93519
24,24,0,-,-,93522
1072,226,846,1424,53700,93523
0,0,0,-,-,93524
316,209,107,769,169000,93526
751,551,200,944,164300,93527
63,36,27,-,-,93528
139,97,42,-,237500,93529
10,10,0,-,-,93530
160,145,15,-,298800,93531
1056,791,265,1090,245000,93532
14187,4628,9559,1013,171200,93534
21171,12145,9026,1137,155400,93535
21380,14688,6692,1284,274900,93536
181,105,76,1227,246100,93541
3686,2504,1182,1265,201900,93543
469,400,69,-,229000,93544
749,414,335,655,256000,93545
3222,1491,1731,1148,398100,93546
125,82,43,-,188200,93549
21445,11062,10383,1024,183900,93550
16249,12460,3789,1640,320900,93551
10147,7542,2605,1500,212600,93552
787,561,226,724,227400,93553
103,96,7,-,-,93554
13138,8370,4768,874,170700,93555
74,58,16,-,-,93558
6894,4132,2762,945,164400,93560
11438,8598,2840,946,239600,93561
726,393,333,561,48700,93562
129,90,39,998,267900,93563
1860,1285,575,1101,151300,93591
44,27,17,-,68300,93592
663,546,117,1290,324600,93601
1579,1308,271,720,261300,93602
56,29,27,-,-,93603
374,357,17,-,653400,93604
53,14,39,745,-,93605
202,147,55,771,157900,93606
268,108,160,843,125000,93608
1581,815,766,831,173600,93609
4957,2476,2481,923,190700,93610
15694,11310,4384,1515,290500,93611
13420,4875,8545,956,172200,93612
4479,3874,605,1224,243700,93614
1452,646,806,772,104300,93615
720,366,354,606,244300,93616
8091,4139,3952,873,172100,93618
11580,9875,1705,1848,387700,93619
2891,1739,1152,874,159100,93620
109,63,46,-,-,93621
2789,1214,1575,689,151000,93622
47,47,0,-,341300,93623
247,6,241,529,-,93624
2250,1143,1107,835,233000,93625
705,573,132,1516,303700,93626
43,0,43,-,-,93627
68,51,17,-,-,93628
5386,2766,2620,847,208900,93630
5183,3256,1927,845,254400,93631
0,0,0,-,-,93633
3,2,1,-,-,93634
11743,6327,5416,1100,230200,93635
4004,3581,423,1483,290900,93636
12244,6373,5871,1002,199900,93637
12217,6306,5911,951,169200,93638
2836,1026,1810,760,144200,93640
91,72,19,-,260900,93641
1214,972,242,591,243300,93643
3415,2483,932,942,278600,93644
78,78,0,-,341900,93645
2746,1079,1667,737,118500,93646
2863,1519,1344,826,135600,93647
4090,1769,2321,775,134700,93648
1377,659,718,869,65300,93650
696,606,90,847,381300,93651
99,51,48,828,120800,93652
534,478,56,1094,248600,93653
8982,5730,3252,926,199700,93654
1740,985,755,861,166900,93656
10410,6456,3954,912,209000,93657
1104,408,696,615,120200,93660
8473,4818,3655,897,179500,93662
224,172,52,930,452600,93664
251,221,30,-,92100,93665
253,54,199,654,67900,93666
981,696,285,1072,257500,93667
349,213,136,1035,260900,93668
88,63,25,-,-,93669
201,109,92,772,106900,93673
1237,1098,139,1048,187500,93675
3185,418,2767,687,98500,93701
11910,4191,7719,772,110800,93702
9906,3486,6420,873,122100,93703
11104,6186,4918,949,226300,93704
11915,4847,7068,890,149900,93705
10913,4601,6312,791,140400,93706
11216,4584,6632,927,210600,93710
15807,9709,6098,1111,325900,93711
17916,10597,7319,1386,291500,93720
1938,207,1731,730,123400,93721
24504,13837,10667,1144,209500,93722
3655,3017,638,1284,287000,93723
6820,3546,3274,929,154100,93725
14067,5300,8767,867,155800,93726
23725,13382,10343,876,222100,93727
5680,2517,3163,819,126800,93728
4166,3201,965,1831,408000,93730
9640,4075,5565,1172,422300,93901
13016,5024,7992,1135,297800,93905
16957,8770,8187,1386,334600,93906
6974,4856,2118,1383,417600,93907
4422,3613,809,2277,719300,93908
444,106,338,733,1706500,93920
1586,927,659,2040,1317200,93921
5566,4332,1234,1882,1066100,93923
2539,1928,611,1721,908600,93924
409,185,224,873,280100,93925
2245,971,1274,1112,324500,93926
4055,1938,2117,1203,263700,93927
16,0,16,-,-,93928
4287,2210,2077,1001,252300,93930
249,145,104,1006,260800,93932
8813,3398,5415,1304,436400,93933
13170,5418,7752,1654,703200,93940
0,0,0,-,-,93943
6864,3260,3604,1606,763200,93950
1824,1537,287,2990,1175500,93953
86,38,48,973,210000,93954
10428,4160,6268,1596,414300,93955
4298,2576,1722,1155,300100,93960
184,106,78,-,448500,93962
10349,6219,4130,1911,1170700,94002
1871,1386,485,1934,777400,94005
16053,9522,6531,1973,"2,000,000+",94010
13835,8102,5733,1670,616500,94014
19852,11085,8767,2019,678900,94015
7359,5253,2106,1946,876200,94019
593,426,167,1682,757800,94020
65,23,42,1104,-,94021
7239,5870,1369,2823,"2,000,000+",94022
7816,6967,849,2822,"2,000,000+",94024
14726,9048,5678,2104,1692400,94025
2399,2222,177,"3,500+","2,000,000+",94027
2641,2228,413,2485,"2,000,000+",94028
8234,5262,2972,2101,1130500,94030
1077,917,160,1762,870700,94037
1158,958,200,1577,837400,94038
14297,5975,8322,2056,1375600,94040
6410,2083,4327,2139,1106900,94041
12923,6048,6875,2148,905400,94043
14080,9602,4478,2110,740700,94044
466,274,192,1356,911000,94060
14084,7181,6903,1923,999300,94061
10180,7429,2751,1932,1520600,94062
9823,3553,6270,1719,658200,94063
5160,3618,1542,3031,1127100,94065
14989,8395,6594,1999,754300,94066
11626,8364,3262,2040,1248700,94070
90,39,51,-,1132800,94074
20833,12757,8076,1754,698000,94080
8330,2937,5393,2073,730400,94085
19327,6450,12877,2106,956400,94086
20253,11584,8669,2154,1243400,94087
7953,5036,2917,2513,243800,94089
17540,1437,16103,950,739900,94102
14046,2093,11953,1058,815100,94103
248,23,225,660,1578100,94104
4404,2045,2359,3095,793400,94105
14123,5666,8457,2318,947900,94107
8063,784,7279,1176,1098300,94108
33173,5314,27859,1622,931200,94109
27784,9797,17987,1652,956200,94110
2021,464,1557,2244,1011800,94111
23557,15048,8509,1630,712100,94112
17000,7788,9212,2058,1232400,94114
17562,4458,13104,1852,1120500,94115
16144,10872,5272,1851,934200,94116
18262,5332,12930,2007,1187000,94117
17731,6149,11582,1838,1307600,94118
17815,7693,10122,1763,1035100,94121
23158,11421,11737,1881,938000,94122
13951,3552,10399,2206,1648000,94123
10650,5482,5168,969,624200,94124
7548,6022,1526,2658,1177200,94127
0,0,0,-,-,94128
1284,34,1250,3250,"2,000,000+",94129
586,0,586,2010,-,94130
13243,7415,5828,1969,1071500,94131
10172,4566,5606,1965,848900,94132
12982,2385,10597,1348,1174000,94133
12204,7158,5046,1488,672800,94134
3497,814,2683,2706,886600,94158
7098,3497,3601,2368,"2,000,000+",94301
14054,7317,6737,1823,1214700,94303
1843,312,1531,2875,1647200,94304
3318,944,2374,1594,1625000,94305
10783,6026,4757,2191,1751800,94306
12703,6076,6627,1789,697600,94401
9535,6457,3078,2111,1246100,94402
16110,8967,7143,2266,979500,94403
14448,8388,6060,2758,999200,94404
25471,10352,15119,1575,725300,94501
5116,4039,1077,2145,736900,94502
5505,4321,1184,1762,418800,94503
5358,4227,1131,2311,535000,94505
8221,7439,782,2371,1118800,94506
5455,5089,366,2881,1519700,94507
1041,537,504,1608,692900,94508
21417,11959,9458,1352,305100,94509
11201,7964,3237,1577,515800,94510
1034,933,101,1153,-,94511
32,32,0,-,-,94512
19579,14714,4865,2020,483700,94513
479,308,171,1567,461300,94514
3110,1905,1205,1177,645900,94515
62,37,25,733,520800,94516
4706,4351,355,2208,660200,94517
10351,6914,3437,1611,523900,94518
6827,4700,2127,1572,437000,94519
13344,4681,8663,1343,324600,94520
16094,11531,4563,1667,509300,94521
13855,8408,5447,1840,634500,94523
1453,694,759,1252,430000,94525
12212,10282,1930,2351,963500,94526
270,249,21,-,1612000,94528
10047,6035,4012,1677,680400,94530
12386,8603,3783,2086,364300,94531
23414,11762,11652,1224,281800,94533
12750,9548,3202,1999,440800,94534
1110,10,1100,1925,-,94535
24357,14185,10172,1904,724600,94536
21690,10392,11298,2040,645200,94538
16274,13450,2824,2252,1123900,94539
21379,9160,12219,1435,464900,94541
4233,2840,1393,1802,666200,94542
22648,10853,11795,1551,422100,94544
9285,6386,2899,1690,464600,94545
16708,10536,6172,1543,595900,94546
8193,6738,1455,1779,457300,94547
153,109,44,1280,890600,94548
10987,8276,2711,1930,1172100,94549
18166,12990,5176,1739,714800,94550
15165,10967,4198,1836,608600,94551
5137,4619,518,2659,813900,94552
19036,12711,6325,1564,473900,94553
11316,7882,3434,2250,739400,94555
5747,4742,1005,1917,1038500,94556
23988,15988,8000,1650,578500,94558
10374,4906,5468,1429,551300,94559
13395,9271,4124,1914,607200,94560
12010,9007,3003,1461,355000,94561
6929,6121,808,2231,1219600,94563
6751,4726,2025,1660,431400,94564
27966,15602,12364,1462,310400,94565
16138,11635,4503,1943,927800,94566
241,175,66,1446,302100,94567
17746,11391,6355,2346,726100,94568
118,37,81,1555,-,94569
4468,3431,1037,1348,293300,94571
3293,2025,1268,1292,381800,94572
5,0,5,-,-,94573
3658,2382,1276,1434,937100,94574
0,0,0,-,-,94575
36,17,19,-,-,94576
17545,9565,7980,1426,491900,94577
14512,5519,8993,1320,451700,94578
7218,5103,2115,1475,468700,94579
9101,5988,3113,1645,465700,94580
13143,9159,3984,2120,948500,94582
12015,8455,3560,2176,793000,94583
9344,5644,3700,1633,292600,94585
351,262,89,1577,1040700,94586
21106,13859,7247,1883,620200,94587
12259,8275,3984,2278,828900,94588
9547,5916,3631,1451,242800,94589
14410,5537,8873,1106,254100,94590
18540,11992,6548,1531,349500,94591
305,238,67,2479,422700,94592
9597,8110,1487,1546,507000,94595
9634,3977,5657,1734,886900,94596
10402,4679,5723,1887,695300,94597
10305,8004,2301,2071,849000,94598
1394,919,475,2039,511900,94599
15153,4621,10532,1145,364500,94601
11814,6664,5150,1286,673100,94602
9626,4441,5185,1320,307500,94603
15644,8728,6916,1333,476800,94605
14955,2812,12143,1146,440500,94606
11441,3171,8270,1001,451900,94607
14120,5175,8945,1621,486600,94608
9731,2825,6906,1368,674700,94609
15337,5700,9637,1446,839100,94610
17244,10317,6927,1425,941900,94611
8575,745,7830,1046,535000,94612
4,0,4,-,-,94613
7054,4457,2597,1758,1030000,94618
8977,5823,3154,1409,614500,94619
9472,2943,6529,1153,246800,94621
7588,3477,4111,1461,679800,94702
8790,3696,5094,1633,740900,94703
7993,790,7203,1423,680300,94704
5782,3257,2525,1590,1078100,94705
7913,3849,4064,1733,761000,94706
4896,4083,813,1609,1001400,94707
4855,4173,682,2631,959400,94708
5219,1442,3777,1603,892400,94709
2941,1072,1869,1472,706800,94710
17,17,0,-,-,94720
9046,3789,5257,1229,298400,94801
9347,6717,2630,1459,450600,94803
14218,6372,7846,1234,343900,94804
5330,3331,1999,1528,396800,94805
19805,9206,10599,1355,325500,94806
0,0,0,-,-,94850
15495,7429,8066,1632,909100,94901
12382,8600,3782,2137,750600,94903
5375,3356,2019,1863,1457500,94904
5394,3775,1619,2437,"2,000,000+",94920
250,94,156,806,-,94922
452,288,164,1182,732100,94923
556,381,175,1820,1062500,94924
3876,2653,1223,2350,1144800,94925
16022,8282,7740,1538,376200,94928
71,55,16,-,935000,94929
3797,2565,1232,1804,821600,94930
3235,1924,1311,1413,476900,94931
279,197,82,2294,630700,94933
410,163,247,1350,845100,94937
400,282,118,1682,812500,94938
3293,1668,1625,2073,1376100,94939
129,91,38,2068,1263900,94940
13182,9012,4170,1967,1188700,94941
7376,4832,2544,1863,729700,94945
319,265,54,1925,1413500,94946
10152,7565,2587,1837,692500,94947
7067,4556,2511,2037,695400,94949
55,30,25,-,1125000,94950
1810,1324,486,1340,755300,94951
13506,8167,5339,1543,674500,94952
13694,9586,4108,1785,521000,94954
652,283,369,1228,1021900,94956
432,368,64,2000,"2,000,000+",94957
6412,5092,1320,1792,1039800,94960
196,144,52,1750,1017900,94963
103,9,94,875,-,94964
5824,2839,2985,1916,1039700,94965
356,213,143,1903,1669300,94970
168,81,87,1315,543400,94971
11,11,0,-,-,94972
774,603,171,1418,735700,94973
574,418,156,1679,541400,95002
10140,7384,2756,1904,764200,95003
1249,963,286,1353,567200,95004
2708,2145,563,1570,605900,95005
3915,2881,1034,1636,507700,95006
303,258,45,-,622600,95007
18095,8948,9147,1891,884700,95008
4132,2023,2109,1719,590200,95010
2417,1045,1372,1029,300600,95012
32,9,23,-,-,95013
21489,13000,8489,2778,1377300,95014
270,164,106,1048,777000,95017
2882,2396,486,1498,526500,95018
2024,768,1256,1076,400800,95019
18593,11189,7404,1601,618800,95020
15088,9822,5266,1378,451500,95023
5098,3747,1351,2203,"2,000,000+",95030
9916,6925,2991,2129,1319200,95032
3708,3026,682,1676,962700,95033
21978,14165,7813,2098,705200,95035
16615,12232,4383,1700,766900,95037
335,236,99,913,204100,95039
111,39,72,865,657300,95041
258,147,111,1392,669900,95043
1462,712,750,1274,570400,95045
1726,1213,513,1517,836900,95046
14154,4961,9193,1757,792300,95050
20538,10116,10422,2176,845000,95051
27,27,0,-,660700,95053
8412,3464,4948,2521,837500,95054
18699,9261,9438,1575,795800,95060
15071,7894,7177,1564,671800,95062
462,173,289,1733,333700,95064
3294,2320,974,2128,766100,95065
5718,4144,1574,1957,760300,95066
11043,9326,1717,2426,1912900,95070
4086,2946,1140,1499,703600,95073
141,90,51,1625,589300,95075
23323,12437,10886,1358,469600,95076
6233,2486,3747,1771,533200,95110
15934,9253,6681,1475,459600,95111
20128,5883,14245,1452,562600,95112
987,169,818,2502,689500,95113
14364,5340,9024,1409,465800,95116
10609,3910,6699,1740,799500,95117
11285,7614,3671,1818,794200,95118
3210,2461,749,2015,707900,95119
12683,11413,1270,2867,1141500,95120
9794,7112,2682,1967,612200,95121
12786,6396,6390,1644,500900,95122
22219,13919,8300,2130,657400,95123
17011,12768,4243,1990,896100,95124
21032,13902,7130,1722,900200,95125
14819,5029,9790,1720,702000,95126
16572,10563,6009,1781,595300,95127
13863,5579,8284,1679,750500,95128
13959,8254,5705,1982,1157300,95129
5003,3115,1888,1697,983900,95130
9377,6125,3252,2288,667100,95131
12094,8902,3192,2191,709900,95132
8450,4730,3720,1569,606900,95133
10159,2059,8100,2699,162400,95134
7482,6418,1064,2436,911800,95135
15560,9049,6511,2031,661200,95136
6119,5205,914,2358,858800,95138
2273,1793,480,2395,654500,95139
50,26,24,-,-,95140
12175,9894,2281,2363,716100,95148
2866,134,2732,588,165900,95202
5232,1887,3345,855,169600,95203
11088,5571,5517,951,174300,95204
10547,4437,6110,894,125800,95205
17105,8677,8428,1133,170100,95206
17905,7021,10884,926,220400,95207
12893,8402,4491,1381,259300,95209
11811,5253,6558,1052,167400,95210
0,0,0,-,-,95211
6986,5251,1735,1525,306700,95212
6969,3922,3047,982,172200,95215
10847,6073,4774,1180,350600,95219
2518,1897,621,1276,435300,95220
2360,1632,728,997,304300,95222
1395,1068,327,1267,287600,95223
122,92,30,-,-,95224
122,75,47,-,-,95225
15,0,15,-,-,95226
274,194,80,894,-,95227
1805,1615,190,1782,265600,95228
165,83,82,1560,618800,95230
809,304,505,906,236700,95231
66,66,0,-,348900,95232
200,137,63,-,229100,95233
24,0,24,-,-,95234
1540,1064,476,734,373700,95236
1138,824,314,1227,259500,95237
15969,7963,8006,955,248500,95240
9979,6639,3340,1300,322100,95242
789,645,144,1045,279900,95245
551,429,122,1011,370400,95246
1957,1570,387,1290,312300,95247
79,79,0,-,205000,95248
1744,1145,599,898,192300,95249
0,0,0,-,-,95250
251,198,53,-,288000,95251
4992,4065,927,1545,266100,95252
413,413,0,-,342500,95254
753,553,200,805,174800,95255
212,155,57,1356,252000,95257
1516,1160,356,1050,341100,95258
11450,6521,4929,935,218300,95301
276,96,180,1038,400000,95303
3749,2589,1160,1300,499700,95304
22,0,22,-,-,95305
409,338,71,1072,345100,95306
12376,7498,4878,1039,218700,95307
945,615,330,791,234400,95310
854,741,113,729,229400,95311
84,70,14,-,219600,95312
468,202,266,829,284600,95313
0,0,0,-,-,95314
3669,2358,1311,1129,163900,95315
2127,1516,611,1038,317200,95316
258,89,169,725,195300,95317
165,35,130,1028,420500,95318
579,186,393,719,160900,95319
4376,2901,1475,1226,304400,95320
1479,1083,396,821,282100,95321
3146,1918,1228,871,186100,95322
367,216,151,696,272200,95323
2688,1780,908,1128,248300,95324
10,0,10,-,-,95325
3131,1939,1192,1267,295600,95326
2423,1951,472,888,215400,95327
1171,749,422,1024,182200,95328
1032,756,276,1125,232400,95329
5446,3840,1606,1615,293100,95330
833,567,266,905,166400,95333
4373,2492,1881,954,201500,95334
116,23,93,1138,-,95335
14981,8572,6409,1227,292200,95336
11072,7062,4010,1328,355300,95337
4718,3355,1363,913,269900,95338
11923,5970,5953,922,227000,95340
8233,3461,4772,816,157700,95341
360,220,140,594,245800,95345
772,570,202,1091,275700,95346
10918,4359,6559,970,189300,95348
19773,9933,9840,999,209300,95350
13208,5614,7594,1011,155100,95351
8860,4183,4677,957,205700,95354
21086,12593,8493,1130,265100,95355
11355,7006,4349,1146,292900,95356
3743,2648,1095,1232,262100,95357
8876,5200,3676,1128,202900,95358
3634,2209,1425,990,172800,95360
11955,7564,4391,1003,320200,95361
7266,4442,2824,1307,271100,95363
0,0,0,-,-,95364
1336,726,610,712,118600,95365
5960,4172,1788,1236,397600,95366
7280,5004,2276,1132,250700,95367
4186,3045,1141,1218,241500,95368
373,176,197,688,186800,95369
11908,7978,3930,963,280100,95370
829,651,178,1187,262100,95372
544,283,261,996,326700,95374
0,0,0,-,-,95375
15735,8650,7085,1426,335300,95376
9082,6472,2610,2089,427200,95377
1463,879,584,766,239700,95379
14162,6397,7765,914,232300,95380
13110,7879,5231,1188,301900,95382
1856,1327,529,987,302300,95383
179,67,112,-,-,95385
2969,2004,965,1033,205900,95386
145,43,102,584,785000,95387
3888,1946,1942,826,157800,95388
245,53,192,-,515600,95389
4321,3093,1228,2501,502600,95391
13482,7103,6379,1385,395700,95401
17156,9061,8095,1487,442600,95403
16479,9374,7105,1311,610000,95404
8400,4948,3452,1590,509200,95405
12785,6263,6522,1341,351500,95407
12043,7933,4110,1679,527600,95409
382,268,114,1560,434400,95410
135,105,30,-,517500,95412
459,238,221,1039,362500,95415
144,92,52,-,-,95417
275,206,69,-,433300,95420
730,499,231,1053,455900,95421
6360,3182,3178,831,96900,95422
1705,1198,507,933,166700,95423
3982,2721,1261,1242,412000,95425
624,471,153,980,250400,95426
120,60,60,1156,-,95427
909,639,270,833,238000,95428
46,46,0,-,-,95429
6,0,6,-,-,95430
0,0,0,-,-,95431
246,147,99,1689,450000,95432
74,74,0,-,-,95435
2716,1990,726,1258,410200,95436
5768,3287,2481,1043,366200,95437
240,146,94,-,744400,95439
648,325,323,1235,814700,95441
1517,828,689,1505,700000,95442
168,59,109,697,-,95443
266,198,68,971,405300,95444
953,693,260,1429,528800,95445
2346,1431,915,1122,406700,95446
7007,4300,2707,1461,717900,95448
554,279,275,1070,444600,95449
162,70,92,979,422200,95450
4790,3632,1158,1306,206000,95451
598,550,48,-,717000,95452
4570,2910,1660,924,205900,95453
1072,674,398,432,355100,95454
381,255,126,1152,326300,95456
1282,1062,220,846,163500,95457
1204,716,488,757,104600,95458
225,173,52,1284,365900,95459
1241,852,389,1056,457900,95460
1020,676,344,975,252300,95461
611,432,179,916,399200,95462
50,34,16,-,-,95463
1095,690,405,876,157800,95464
982,717,265,1623,606400,95465
381,165,216,767,838400,95466
2149,1756,393,1481,257000,95467
659,384,275,851,429500,95468
707,362,345,1345,459800,95469
2145,1618,527,1218,354200,95470
304,104,200,1336,-,95471
12810,8300,4510,1444,697100,95472
15249,9872,5377,1429,610500,95476
11520,6176,5344,1047,308500,95482
1113,831,282,885,224000,95485
48,15,33,-,-,95486
96,84,12,-,618800,95488
5382,3166,2216,1057,246000,95490
9823,7167,2656,1714,512900,95492
125,94,31,-,335900,95493
65,29,36,-,1286800,95494
618,511,107,1661,734400,95497
10095,4223,5872,851,253000,95501
9758,6479,3279,1007,268100,95503
96,59,37,-,327800,95511
74,74,0,-,-,95514
7238,4763,2475,936,294700,95519
8313,3526,4787,934,336500,95521
778,614,164,973,454000,95524
682,422,260,1058,287200,95525
144,103,41,807,256600,95526
263,206,57,808,263600,95527
454,360,94,1286,327900,95528
8119,4961,3158,842,184900,95531
1150,613,537,1035,371800,95536
101,48,53,-,-,95537
5197,3000,2197,931,259600,95540
886,520,366,864,505300,95542
353,310,43,641,206100,95543
34,34,0,-,-,95545
1137,751,386,551,164700,95546
418,320,98,1022,357100,95547
437,242,195,726,138000,95548
340,260,80,840,430900,95549
50,8,42,880,-,95550
622,383,239,731,232000,95551
309,190,119,788,280600,95552
525,257,268,1200,460100,95553
132,102,30,-,527800,95554
165,91,74,718,228300,95555
267,158,109,431,-,95556
217,177,40,1016,335700,95558
74,23,51,-,-,95559
673,332,341,984,330600,95560
1446,846,600,801,197000,95562
334,165,169,822,358500,95563
148,41,107,1058,258300,95564
344,80,264,1068,235700,95565
774,483,291,675,237500,95567
64,49,15,763,266300,95568
129,85,44,1263,335700,95569
1014,788,226,989,410100,95570
125,102,23,-,326100,95571
680,458,222,878,283800,95573
277,172,105,670,319200,95585
41,41,0,-,-,95587
504,440,64,1421,400900,95589
46,37,9,-,531300,95595
63,25,38,860,-,95601
7081,5130,1951,1210,422700,95602
11747,7634,4113,1124,372900,95603
60,48,12,-,666700,95604
4826,1767,3059,850,225700,95605
92,48,44,878,-,95606
206,151,55,-,648600,95607
25135,13423,11712,1001,354700,95608
17864,8570,9294,1086,276300,95610
398,277,121,1158,473900,95612
1594,1410,184,1548,343700,95614
309,97,212,900,334000,95615
17126,6256,10870,1327,603200,95616
9638,5393,4245,1535,617800,95618
1877,1435,442,1351,241900,95619
6537,4398,2139,1252,339600,95620
16220,10269,5951,1169,221800,95621
1441,1213,228,1167,357600,95623
19514,14746,4768,1453,350200,95624
80,9,71,1096,-,95625
1976,1487,489,1435,290600,95626
1109,780,329,1298,220600,95627
16241,10890,5351,1219,377500,95628
359,218,141,900,336700,95629
26810,18713,8097,1493,456900,95630
2609,1972,637,1207,317600,95631
9714,7044,2670,1247,290500,95632
1256,1172,84,-,333300,95633
1164,861,303,1155,262300,95634
421,386,35,-,285400,95635
381,381,0,-,212100,95636
111,83,28,-,337100,95637
751,698,53,1151,461000,95638
84,60,24,-,354200,95639
2730,2106,624,1077,257700,95640
816,521,295,931,212200,95641
2933,2026,907,1074,280300,95642
646,307,339,864,171200,95645
26,6,20,-,-,95646
19104,15126,3978,1662,394800,95648
4870,4034,836,1503,484400,95650
280,231,49,-,621500,95651
191,0,191,873,-,95652
182,127,55,1243,180400,95653
1347,1077,270,-,308000,95655
2706,2204,502,1520,469200,95658
359,210,149,960,358000,95659
10765,5275,5490,1074,162900,95660
12036,7158,4878,1377,409700,95661
11916,8751,3165,1296,330900,95662
880,796,84,1602,573900,95663
453,403,50,-,476900,95664
2031,1629,402,1120,274100,95665
2365,2068,297,1135,244300,95666
14210,10931,3279,1046,342100,95667
306,210,96,2013,449000,95668
897,749,148,1309,340800,95669
20211,10852,9359,1070,274500,95670
1735,1539,196,2020,447700,95672
4887,3638,1249,1228,223500,95673
284,182,102,1054,374500,95674
180,139,41,-,158400,95675
9040,5875,3165,1377,372300,95677
15959,8673,7286,1379,327000,95678
24,24,0,-,-,95679
35,9,26,-,-,95680
395,317,78,-,292100,95681
10970,8038,2932,1114,431900,95682
2540,2353,187,1612,442000,95683
1277,1042,235,1423,291300,95684
1994,1390,604,991,372800,95685
331,149,182,818,208300,95686
22060,13063,8997,1511,340300,95687
13032,8506,4526,1335,423700,95688
587,543,44,-,314000,95689
825,419,406,806,449500,95690
13207,7933,5274,1126,322000,95691
1701,1063,638,1115,247600,95692
2427,1920,507,970,519000,95693
3503,2168,1335,1006,359400,95694
14545,7806,6739,1027,334200,95695
143,89,54,930,169100,95697
88,51,37,-,360700,95698
68,68,0,-,342000,95699
322,251,71,1260,367000,95701
465,374,91,1115,344200,95703
1805,1529,276,1367,347800,95709
3859,2773,1086,1330,325500,95713
166,124,42,950,250000,95714
38,33,5,-,202500,95715
76,40,36,1080,309100,95717
24,23,1,-,203100,95720
14,14,0,-,-,95721
1953,1812,141,1240,454900,95722
0,0,0,-,-,95724
3405,2673,732,1162,271700,95726
116,40,76,-,-,95728
2,2,0,-,-,95735
72,0,72,514,-,95736
3236,2726,510,1960,368800,95742
8198,7120,1078,1844,680600,95746
21859,16853,5006,1598,416600,95747
13297,9764,3533,1720,392900,95757
20980,14512,6468,1528,312100,95758
13770,12059,1711,1904,584400,95762
12636,8500,4136,1553,449600,95765
7277,4684,2593,1155,314100,95776
3243,618,2625,817,481000,95811
6234,512,5722,836,378000,95814
9285,2783,6502,936,177100,95815
9985,2782,7203,991,504400,95816
5902,2407,3495,956,287300,95817
9746,5095,4651,903,492400,95818
7806,5326,2480,1368,471300,95819
12589,6635,5954,1104,206500,95820
14631,6062,8569,862,293200,95821
15982,8577,7405,1115,266400,95822
23238,10123,13115,996,194000,95823
9172,3467,5705,935,152900,95824
15465,3873,11592,939,251500,95825
14963,7896,7067,1095,254700,95826
7322,4190,3132,1160,216300,95827
17770,10335,7435,1185,201100,95828
8043,6183,1860,1587,340500,95829
314,283,31,1368,519500,95830
18502,10535,7967,1208,375200,95831
3028,1460,1568,1224,205100,95832
14470,6265,8205,1234,228000,95833
9919,4008,5911,1217,286000,95834
13185,8004,5181,1608,348200,95835
96,80,16,-,625000,95837
10974,5493,5481,1097,169900,95838
8111,2898,5213,983,214900,95841
11079,5534,5545,1085,197500,95842
14255,9446,4809,1379,275700,95843
9326,7067,2259,1336,531300,95864
11678,5907,5771,885,190900,95901
355,0,355,1621,-,95903
25,25,0,-,-,95910
1417,963,454,935,259600,95912
343,309,34,1292,182600,95914
0,0,0,-,-,95915
488,382,106,750,173000,95916
1081,718,363,978,189700,95917
1091,956,135,1630,356100,95918
564,431,133,942,202000,95919
107,62,45,710,-,95920
263,191,72,827,197300,95922
8,8,0,-,-,95923
170,107,63,-,-,95925
15182,6619,8563,970,286300,95926
14226,6716,7510,970,317800,95928
60,42,18,-,-,95930
2755,1662,1093,843,234400,95932
179,146,33,703,218600,95934
275,147,128,-,331300,95935
75,28,47,-,158300,95936
515,395,120,1050,137900,95937
1500,949,551,1215,404500,95938
240,103,137,524,141000,95939
271,240,31,-,216000,95941
425,405,20,-,322400,95942
341,171,170,979,379700,95943
25,9,16,-,-,95944
11122,6339,4783,1057,336200,95945
3850,3320,530,1484,364800,95946
786,569,217,840,170500,95947
3723,2138,1585,797,185900,95948
8060,7128,932,1574,354700,95949
141,48,93,760,195000,95950
820,494,326,706,166800,95951
3156,2086,1070,919,185900,95953
5191,4061,1130,1074,159900,95954
482,315,167,847,211600,95955
161,161,0,-,226500,95956
327,181,146,822,239900,95957
7190,5811,1379,1145,410000,95959
274,190,84,1191,247500,95960
8686,5503,3183,930,198900,95961
578,395,183,792,213600,95962
5273,3308,1965,797,232600,95963
6968,4102,2866,804,161200,95965
11130,7621,3509,943,184000,95966
440,328,112,1013,121800,95968
11422,8137,3285,1042,209100,95969
233,150,83,909,254200,95970
2384,1547,837,900,234600,95971
13998,8349,5649,1039,308800,95973
16,0,16,-,-,95974
501,432,69,1638,331500,95975
818,597,221,1399,278500,95977
44,9,35,-,-,95978
270,170,100,766,268200,95979
11,11,0,-,-,95981
1190,840,350,1186,212100,95982
198,198,0,-,183000,95983
41,41,0,-,-,95984
51,46,5,-,-,95986
1821,1249,572,1043,180100,95987
3281,1695,1586,762,204100,95988
14253,6634,7619,917,197700,95991
12046,7866,4180,1150,274000,95993
13847,8025,5822,927,264200,96001
12540,6945,5595,967,232100,96002
18129,10419,7710,1072,243900,96003
140,124,16,-,139100,96006
8960,5976,2984,839,204400,96007
492,451,41,819,238800,96008
178,162,16,-,252900,96009
71,57,14,563,222900,96010
70,43,27,750,129200,96011
1795,991,804,762,141900,96013
98,74,24,-,161300,96014
139,93,46,-,-,96015
253,206,47,725,175900,96016
70,44,26,840,333300,96017
3789,2349,1440,1034,162800,96019
1078,700,378,813,177700,96020
5879,4110,1769,801,166300,96021
6198,4879,1319,866,239400,96022
480,304,176,648,107500,96023
414,332,82,1081,241400,96024
946,604,342,914,162200,96025
1021,785,236,835,227900,96027
496,417,79,634,279700,96028
73,54,19,780,323100,96029
47,41,6,-,145800,96031
1000,671,329,763,275500,96032
243,179,64,850,107500,96033
114,52,62,1000,187500,96034
1197,806,391,718,157200,96035
108,99,9,-,157100,96037
281,152,129,872,155000,96038
455,264,191,590,132100,96039
130,104,26,-,210000,96040
1154,800,354,696,281300,96041
439,339,100,797,158700,96044
29,29,0,-,-,96046
324,250,74,850,237500,96047
277,232,45,757,295700,96048
22,22,0,-,-,96049
196,139,57,448,174000,96050
541,456,85,590,244800,96051
594,423,171,822,225600,96052
135,121,14,-,260900,96054
1509,1049,460,772,176300,96055
741,601,140,622,212000,96056
623,470,153,808,195900,96057
249,175,74,663,141400,96058
259,176,83,658,386400,96059
11,11,0,-,597200,96061
410,321,89,1016,370300,96062
114,36,78,875,187500,96063
1882,1354,528,784,162300,96064
161,118,43,675,294400,96065
3287,2097,1190,1015,255500,96067
26,13,13,-,-,96068
359,299,60,883,235300,96069
21,21,0,-,139100,96071
1517,1413,104,1679,371700,96073
52,34,18,864,131300,96074
91,77,14,638,107800,96075
81,70,11,-,246900,96076
10770,6561,4209,821,191800,96080
156,123,33,817,205800,96084
37,37,0,-,135400,96085
134,108,26,863,167700,96086
341,292,49,-,227000,96087
2016,1754,262,1124,215000,96088
164,127,37,827,156900,96090
326,277,49,800,367000,96091
96,81,15,-,149400,96092
1616,981,635,720,292500,96093
2778,1789,989,934,193800,96094
290,235,55,738,287100,96096
4373,2672,1701,759,155800,96097
2314,1613,701,799,116900,96101
765,606,159,936,284500,96103
228,183,45,589,218500,96104
77,77,0,-,-,96105
86,70,16,-,500000,96106
446,328,118,814,215200,96107
10,10,0,-,-,96108
385,288,97,736,151800,96109
71,42,29,556,-,96110
32,32,0,-,197200,96111
102,67,35,242,291700,96112
423,169,254,850,-,96113
1346,1101,245,874,226100,96114
79,69,10,-,165800,96115
78,78,0,-,-,96116
138,90,48,1115,232500,96117
651,493,158,1006,116900,96118
29,6,23,-,-,96119
271,230,41,950,329800,96120
142,123,19,-,191300,96121
1579,1059,520,678,212800,96122
13,7,6,-,96300,96123
187,179,8,-,132200,96124
98,94,4,-,351900,96125
58,47,11,-,-,96126
319,283,36,-,221100,96128
64,64,0,-,-,96129
5125,3044,2081,1004,182200,96130
45,24,21,-,-,96132
32,0,32,-,-,96133
708,392,316,597,83900,96134
79,79,0,-,-,96135
32,32,0,-,245800,96136
1691,1260,431,925,171800,96137
406,293,113,972,596600,96140
183,165,18,-,600500,96141
248,194,54,1208,472600,96142
1329,667,662,1160,394300,96143
1129,801,328,1191,627100,96145
469,329,140,1030,877500,96146
248,150,98,1036,703100,96148
11738,6393,5345,963,395300,96150
0,0,0,-,-,96155
7124,4944,2180,1491,533800,96161
13080,8246,4834,1665,632600,96701
594,484,110,842,437400,96703
2578,1832,746,1295,439400,96704
761,537,224,1160,414200,96705
18988,13064,5924,2141,530500,96706
12889,8569,4320,2157,537200,96707
3504,2271,1233,1567,749400,96708
134,110,24,-,680200,96710
2621,1370,1251,1653,1111500,96712
424,269,155,1180,403500,96713
312,172,140,1357,930600,96714
913,645,268,1297,404400,96716
1344,662,682,1629,595100,96717
519,311,208,1170,373800,96719
16825,10451,6374,992,305900,96720
805,614,191,1942,741900,96722
1041,630,411,1334,570100,96725
206,98,108,616,400000,96726
1515,1113,402,978,360000,96727
204,171,33,1150,255000,96728
378,304,74,1033,171500,96729
507,299,208,1375,652300,96730
757,534,223,1173,550600,96731
7440,4457,2983,1212,541400,96732
15959,9654,6305,2603,905200,96734
1638,1275,363,1176,142400,96737
2540,1859,681,1429,410100,96738
13096,8048,5048,1300,488200,96740
2123,1412,711,1468,650700,96741
53,2,51,867,-,96742
4297,2772,1525,1431,450000,96743
16365,12139,4226,1953,707800,96744
6717,4123,2594,1425,527500,96746
215,0,215,744,-,96747
1470,1013,457,739,301500,96748
5865,4485,1380,1127,256500,96749
1139,593,546,880,468500,96750
27,27,0,-,-,96751
1099,729,370,1014,371500,96752
10802,5739,5063,1500,599900,96753
996,694,302,1568,709600,96754
1013,689,324,1098,341600,96755
2034,1107,927,1200,649200,96756
236,144,92,1225,270000,96757
75,0,75,-,-,96759
1079,824,255,856,231500,96760
7622,3837,3785,1430,643400,96761
962,406,556,1500,660700,96762
1246,642,604,863,401600,96763
269,233,36,850,440300,96764
184,127,57,1469,585500,96765
5014,3217,1797,1176,474300,96766
6331,4059,2272,1258,616100,96768
119,0,119,474,-,96769
264,85,179,747,-,96770
3002,2308,694,1054,176900,96771
746,573,173,1000,235500,96772
28,28,0,-,388900,96773
66,66,0,-,224200,96774
473,327,146,962,269600,96776
492,353,139,773,216400,96777
5552,3847,1705,1105,193800,96778
897,595,302,2088,662200,96779
206,110,96,657,-,96780
466,318,148,1125,195800,96781
11437,7659,3778,1823,609300,96782
667,486,181,361,250000,96783
1398,1032,366,1002,188800,96785
12587,3524,9063,2239,524400,96786
17767,12924,4843,1920,594500,96789
3583,2543,1040,1369,746200,96790
2332,1457,875,1561,640000,96791
11643,6882,4761,1277,363900,96792
10132,6213,3919,1168,466800,96793
2425,1667,758,1150,534400,96795
650,325,325,1198,386600,96796
18889,12064,6825,1644,561500,96797
9986,4676,5310,1326,596400,96813
10158,4104,6054,1365,525900,96814
13458,5792,7666,1543,492200,96815
17397,10723,6674,1662,853600,96816
19429,7553,11876,1131,651900,96817
18171,6324,11847,2601,492400,96818
12137,5544,6593,1466,672800,96819
6418,5477,941,2344,1033200,96821
18478,9232,9246,1362,660700,96822
10469,8638,1831,2757,816600,96825
14723,4059,10664,1221,396000,96826
0,0,0,-,-,96850
0,0,0,-,-,96853
0,0,0,-,-,96857
0,0,0,-,-,96859
0,0,0,-,-,96860
0,0,0,-,-,96863
79,21,58,639,319200,97001
2196,1908,288,1055,311200,97002
1601,1406,195,988,385100,97004
10944,3774,7170,1030,275300,97005
25822,13275,12547,1278,281700,97006
25218,17657,7561,1224,315000,97007
11778,6759,5019,1085,313800,97008
3059,2632,427,970,357900,97009
230,152,78,2209,223300,97011
8531,5839,2692,971,291000,97013
606,358,248,692,189400,97014
8431,5101,3330,1123,304700,97015
2624,2124,500,828,179700,97016
1085,975,110,1093,315700,97017
889,675,214,988,243900,97018
1299,1144,155,1070,342900,97019
363,315,48,1281,166600,97020
458,274,184,878,204300,97021
1219,1061,158,843,339400,97022
3788,3004,784,943,322400,97023
4238,2486,1752,1076,239400,97024
1231,917,314,1169,203800,97026
4945,3056,1889,1144,244900,97027
42,42,0,-,360000,97028
123,84,39,946,97500,97029
14344,6496,7848,1016,225700,97030
7227,4524,2703,1050,344700,97031
1699,1263,436,903,195900,97032
53,29,24,-,165100,97033
7770,6057,1713,1578,660000,97034
11067,7003,4064,1330,462700,97035
437,270,167,708,159900,97037
5783,4266,1517,1007,252000,97038
237,143,94,753,164400,97039
522,334,188,692,327500,97040
743,590,153,839,365400,97041
1038,860,178,1185,371400,97042
20069,15293,4776,1084,322900,97045
2496,1878,618,729,220900,97048
648,522,126,1136,233300,97049
96,56,40,717,110900,97050
5891,3850,2041,862,205400,97051
1236,1045,191,1072,333900,97053
689,604,85,781,235100,97054
6771,5196,1575,1131,274600,97055
4631,3232,1399,951,252700,97056
3,3,0,-,-,97057
7940,5066,2874,744,191200,97058
7657,4859,2798,1060,250700,97060
11362,6478,4884,1156,375800,97062
474,375,99,1013,171600,97063
1235,1004,231,792,171300,97064
270,185,85,725,146300,97065
1054,740,314,836,260500,97067
11144,8910,2234,1394,452400,97068
9568,4453,5115,1206,386700,97070
9078,5821,3257,927,175200,97071
15183,10369,4814,1115,279300,97080
10996,7090,3906,1193,414200,97086
4531,4082,449,1519,382800,97089
1330,956,374,1010,265400,97101
95,95,0,-,523600,97102
7526,4899,2627,856,244500,97103
1593,1375,218,1333,401400,97106
684,542,142,995,199300,97107
190,170,20,-,261100,97108
225,214,11,-,389200,97109
505,207,298,760,447700,97110
1215,945,270,1504,306000,97111
849,636,213,733,246200,97112
4288,3365,923,1010,223600,97113
1497,1039,458,1050,245200,97114
1465,1296,169,1350,295600,97115
8954,5595,3359,897,266300,97116
265,246,19,-,365100,97117
347,241,106,953,196900,97118
1557,1297,260,1122,356600,97119
556,305,251,891,265700,97121
168,149,19,-,185100,97122
15662,10665,4997,1126,275100,97123
20655,10314,10341,1312,321900,97124
41,41,0,-,427800,97125
1239,1059,180,968,196500,97127
13969,8717,5252,897,233200,97128
175,144,31,893,447200,97130
1179,952,227,1016,237800,97131
10461,6838,3623,1087,286700,97132
1457,1244,213,1048,369700,97133
107,107,0,-,-,97134
379,343,36,-,230900,97135
788,533,255,958,191600,97136
418,280,138,745,368100,97137
4367,2200,2167,890,276400,97138
8732,6700,2032,1361,389700,97140
5023,2986,2037,806,226900,97141
35,35,0,-,296900,97144
183,127,56,1012,494400,97145
2391,1601,790,1032,235300,97146
174,76,98,633,257900,97147
1287,1100,187,1069,324500,97148
397,348,49,-,422900,97149
9009,2845,6164,1256,592500,97201
18135,9010,9125,1077,460200,97202
12091,6702,5389,1013,284500,97203
390,43,347,644,467200,97204
4881,860,4021,917,514800,97205
20100,12628,7472,1174,284100,97206
0,0,0,-,-,97208
11376,2910,8466,1111,432700,97209
6253,2549,3704,1208,707700,97210
13081,8609,4472,1255,381700,97211
10890,6975,3915,1273,595700,97212
13783,8495,5288,1051,385900,97213
12190,4344,7846,1124,470400,97214
7802,4982,2820,1164,444500,97215
6530,3047,3483,1091,240600,97216
14520,9062,5458,1179,340200,97217
5543,3276,2267,961,302200,97218
16561,11646,4915,1212,415800,97219
11488,6464,5024,1046,240400,97220
5170,3925,1245,963,537800,97221
15262,8140,7122,1068,260900,97222
19203,11512,7691,1092,359000,97223
14437,9945,4492,1120,347600,97224
11306,6126,5180,1246,457200,97225
2259,701,1558,1220,459700,97227
23913,16912,7001,1266,473600,97229
14967,8527,6440,968,256500,97230
1652,1436,216,1410,563900,97231
6641,2116,4525,1182,564600,97232
13496,6184,7312,952,193400,97233
12996,7094,5902,1040,226500,97236
8322,4123,4199,1280,508100,97239
12280,6661,5619,1007,212400,97266
12927,9013,3914,1138,289100,97267
18333,7798,10535,792,150600,97301
16153,9343,6810,866,235100,97302
14627,8998,5629,921,215800,97303
11305,7402,3903,971,246100,97304
14038,7414,6624,828,172900,97305
11710,7383,4327,992,246700,97306
7693,4987,2706,1021,223500,97317
10513,7707,2806,917,243900,97321
13421,7278,6143,883,177800,97322
511,381,130,853,196800,97324
2577,2013,564,887,201800,97325
384,314,70,778,246400,97326
1212,895,317,884,215500,97327
65,65,0,-,231900,97329
17474,8806,8668,946,302600,97330
0,0,0,-,-,97331
9210,4267,4943,1021,298600,97333
8003,5693,2310,772,214200,97338
1238,817,421,892,260300,97341
72,26,46,680,141700,97342
112,79,33,-,323200,97343
426,348,78,989,144900,97344
159,109,50,1094,-,97345
327,243,84,672,169100,97346
825,541,284,596,190500,97347
598,361,237,733,169400,97348
113,64,49,719,122900,97350
3710,2072,1638,921,167500,97351
2067,1487,580,973,246000,97352
11092,7265,3827,879,176000,97355
127,127,0,-,368300,97357
1124,1008,116,954,195900,97358
1041,639,402,901,171200,97360
4176,2212,1964,787,222200,97361
1434,887,547,828,213400,97362
231,124,107,1125,338500,97364
4913,2621,2292,852,223900,97365
696,510,186,932,205100,97366
4203,2176,2027,838,237700,97367
1456,1103,353,850,162700,97368
84,71,13,-,251500,97369
3294,2566,728,799,259100,97370
165,126,39,-,339100,97371
0,0,0,-,-,97373
1960,1546,414,882,291800,97374
489,435,54,1150,196100,97375
553,450,103,1115,253500,97376
310,218,92,1123,287900,97377
2393,1596,797,777,183100,97378
1062,762,300,751,153800,97380
5461,3995,1466,903,280400,97381
3243,1733,1510,807,223700,97383
0,0,0,-,-,97384
1328,877,451,985,258000,97385
5502,3823,1679,840,150500,97386
457,396,61,959,386000,97388
642,453,189,1065,223200,97389
333,213,120,1052,282000,97390
2055,1441,614,788,216100,97391
2200,1710,490,1068,239400,97392
2200,1587,613,809,239100,97394
1204,864,340,855,173300,97396
19559,6091,13468,940,282000,97401
21038,10304,10734,894,184800,97402
3759,1855,1904,935,343000,97403
13249,9061,4188,1050,225000,97404
19415,12745,6670,1031,296100,97405
7,7,0,-,-,97406
5331,3521,1810,1168,291800,97408
397,261,136,803,291700,97410
3450,2282,1168,693,230900,97411
177,142,35,1087,268500,97412
399,283,116,849,239800,97413
155,27,128,-,-,97414
6415,4204,2211,878,237100,97415
428,307,121,617,198700,97416
1052,583,469,677,121900,97417
554,442,112,1123,271700,97419
11174,6945,4229,765,174100,97420
2854,1888,966,742,165300,97423
7347,5059,2288,870,191700,97424
3864,2876,988,893,219800,97426
345,240,105,756,186700,97429
153,101,52,1063,216200,97430
794,677,117,847,282300,97431
328,249,79,732,219700,97434
901,707,194,641,153700,97435
364,275,89,759,245300,97436
1096,932,164,938,255400,97437
376,308,68,685,250000,97438
6973,4860,2113,826,213800,97439
161,102,59,-,140600,97441
844,504,340,841,163400,97442
828,497,331,598,273200,97443
2493,1768,725,799,207800,97444
1680,1224,456,1063,182500,97446
313,196,117,-,-,97447
4905,3497,1408,878,243900,97448
1092,892,200,769,166700,97449
206,165,41,-,222100,97450
110,99,11,-,328300,97451
667,589,78,939,206800,97452
464,302,162,625,238200,97453
524,477,47,981,253500,97454
956,879,77,735,331200,97455
1118,860,258,692,242600,97456
4062,3001,1061,843,160500,97457
1920,1417,503,658,149400,97458
5457,3554,1903,765,187900,97459
206,155,51,-,305400,97461
1647,1128,519,712,225000,97462
1716,1152,564,807,119400,97463
1166,770,396,825,172500,97465
383,268,115,468,108300,97466
2264,1563,701,589,145000,97467
1004,731,273,755,154100,97469
8453,5249,3204,742,165900,97470
12299,8567,3732,835,209800,97471
135,132,3,-,186700,97473
95,95,0,-,-,97476
15759,7606,8153,831,180300,97477
14246,9605,4641,938,215500,97478
3877,2650,1227,849,157000,97479
152,88,64,632,182500,97480
326,266,60,585,220700,97481
104,87,17,833,164200,97484
299,263,36,-,318500,97486
3284,2460,824,983,199100,97487
488,420,68,775,335400,97488
393,320,73,-,362400,97489
101,81,20,-,298800,97490
266,199,67,940,137500,97492
165,129,36,700,285900,97493
14,14,0,-,-,97494
740,613,127,940,307700,97495
2998,1860,1138,720,157900,97496
669,507,162,613,226400,97497
812,500,312,954,305300,97498
792,553,239,709,159800,97499
17463,9503,7960,871,176100,97501
10908,7584,3324,946,215600,97502
3812,3087,725,1067,164000,97503
18658,10558,8100,923,267600,97504
11633,6850,4783,1046,399200,97520
242,193,49,855,165200,97522
2922,2022,900,720,207100,97523
5675,3947,1728,1180,263900,97524
1865,1599,266,856,219800,97525
14627,9179,5448,823,242000,97526
14607,9940,4667,950,232300,97527
3036,2147,889,978,322200,97530
290,174,116,-,-,97531
977,765,212,779,307300,97532
287,139,148,514,184800,97534
2437,1682,755,733,168500,97535
499,373,126,771,176000,97536
3201,2038,1163,827,241600,97537
748,595,153,656,204500,97538
1604,1220,384,1140,152500,97539
3774,2370,1404,947,222900,97540
590,413,177,789,263800,97541
286,216,70,921,279100,97543
999,762,237,534,319600,97544
9482,4835,4647,748,162300,97601
11708,8060,3648,713,155300,97603
7,0,7,-,-,97604
103,38,65,327,118800,97620
35,11,24,-,-,97621
234,201,33,-,116800,97622
1001,837,164,690,147100,97623
1515,1279,236,782,160700,97624
95,82,13,-,-,97625
11,11,0,-,-,97626
304,290,14,-,165800,97627
2191,1300,891,672,135800,97630
504,350,154,695,121300,97632
524,388,136,622,179300,97633
83,79,4,-,129800,97634
126,126,0,-,147000,97635
217,105,112,447,88300,97636
41,28,13,520,125000,97637
175,134,41,673,157300,97638
302,259,43,-,118900,97639
51,35,16,467,203600,97640
645,358,287,-,83600,97641
26879,15809,11070,1083,356400,97701
18170,12896,5274,1180,323300,97702
2511,1681,830,1199,262900,97707
60,37,23,-,258300,97710
27,24,3,-,333300,97711
18,0,18,-,-,97712
1882,1339,543,577,91600,97720
136,99,37,-,-,97721
35,14,21,675,-,97722
119,101,18,900,435000,97730
170,57,113,575,"10,000-",97731
49,26,23,579,-,97732
178,100,78,-,153300,97733
1016,780,236,852,177300,97734
41,41,0,-,179500,97735
37,16,21,875,250000,97736
357,200,157,877,161500,97737
713,509,204,599,117000,97738
4854,3848,1006,898,170900,97739
3946,2346,1600,823,160000,97741
159,123,36,588,193800,97750
39,39,0,-,-,97751
28,0,28,-,-,97752
952,768,184,1629,445600,97753
8231,5438,2793,799,170800,97754
14003,8561,5442,945,247200,97756
48,27,21,-,363300,97758
2884,2303,581,1022,386600,97759
2753,2452,301,1050,217300,97760
1101,705,396,453,117400,97761
7693,4523,3170,689,162900,97801
356,276,80,920,263900,97810
343,213,130,825,124700,97812
470,330,140,773,133100,97813
5321,3654,1667,665,137700,97814
9,9,0,-,310000,97817
1412,945,467,715,135100,97818
12,6,6,-,-,97819
438,354,84,534,162500,97820
455,295,160,803,100700,97823
680,536,144,835,260000,97824
131,98,33,600,140000,97825
369,251,118,713,113700,97826
1048,747,301,696,151200,97827
1417,943,474,701,198000,97828
351,241,110,590,116500,97830
406,250,156,732,190800,97833
451,298,153,624,175000,97834
119,85,34,782,155700,97835
788,497,291,768,120300,97836
38,25,13,-,94500,97837
9137,5793,3344,713,156200,97838
104,90,14,1111,113900,97839
51,16,35,-,-,97840
211,159,52,1096,233800,97841
84,47,37,-,453600,97842
252,191,61,780,161300,97843
1363,1051,312,746,128300,97844
1167,777,390,734,136500,97845
893,652,241,621,284600,97846
101,64,37,500,253600,97848
6787,3878,2909,734,167200,97850
140,102,38,625,238900,97856
205,140,65,844,275000,97857
38,38,0,-,-,97859
4238,2807,1431,662,141500,97862
96,63,33,584,258300,97864
576,455,121,511,216300,97865
310,208,102,765,166700,97867
780,524,256,820,116200,97868
388,279,109,792,136300,97869
263,222,41,583,170500,97870
107,99,8,713,68400,97873
170,140,30,606,175000,97874
1047,678,369,893,116700,97875
328,287,41,775,290500,97876
184,164,20,820,141100,97877
129,84,45,819,125000,97880
2139,1209,930,623,117200,97882
901,656,245,696,136600,97883
84,58,26,785,153100,97884
527,341,186,665,163500,97885
485,393,92,736,109700,97886
297,175,122,656,126300,97901
57,34,23,-,-,97903
96,63,33,-,247200,97904
70,35,35,-,209400,97905
117,73,44,475,202300,97906
202,152,50,613,80400,97907
24,13,11,-,-,97908
23,23,0,-,-,97909
215,144,71,547,154400,97910
34,16,18,-,162500,97911
1776,1061,715,648,115700,97913
5997,3397,2600,674,129400,97914
1614,970,644,636,146700,97918
99,55,44,-,187800,97920
11097,8470,2627,1466,285700,98001
13111,6390,6721,1052,184200,98002
18279,8833,9446,1102,240700,98003
16006,7324,8682,1949,952200,98004
7761,4269,3492,1663,677300,98005
13356,10602,2754,1884,737200,98006
10974,3899,7075,1610,480100,98007
9075,6740,2335,1544,587800,98008
1961,1725,236,993,379900,98010
13183,8654,4529,1516,421600,98011
22394,15442,6952,1548,408900,98012
2762,2259,503,1153,457800,98014
4175,3660,515,1345,437100,98019
8650,6431,2219,1384,502300,98020
10684,8568,2116,1682,428300,98021
8520,5828,2692,1033,330800,98022
17803,11998,5805,1285,300300,98023
2153,1823,330,1207,613200,98024
14287,10539,3748,1277,391500,98026
11304,8039,3265,1514,560800,98027
8644,6189,2455,1315,474500,98028
10786,7289,3497,2013,504000,98029
11967,5906,6061,1210,280700,98030
12554,8151,4403,1220,292400,98031
13752,5717,8035,1136,245300,98032
16133,10370,5763,1754,678000,98033
17481,10830,6651,1564,446500,98034
14437,9423,5014,1204,357500,98036
10514,6059,4455,1223,354400,98037
12190,10387,1803,1664,364100,98038
1175,1044,131,"3,500+",1692700,98039
9867,6950,2917,1908,1034600,98040
16408,13455,2953,1594,328200,98042
8216,4604,3612,1334,311300,98043
5254,4015,1239,1419,417000,98045
2367,1218,1149,1161,235300,98047
179,179,0,-,-,98050
1382,1137,245,1455,408100,98051
26051,13772,12279,1731,596900,98052
8184,6844,1340,1859,654000,98053
9256,4638,4618,1462,305800,98055
13964,7571,6393,1353,400400,98056
5937,1458,4479,1187,319300,98057
15758,11420,4338,1429,342800,98058
13423,10450,2973,1556,432000,98059
4951,4175,776,1801,501800,98065
114,105,9,-,384900,98068
4407,3533,874,993,461400,98070
8839,6504,2335,1604,579700,98072
9067,8068,999,2113,661200,98074
7740,6697,1043,2143,772600,98075
4795,4501,294,1865,679500,98077
13607,6929,6678,1457,327500,98087
15985,11137,4848,1295,321400,98092
8390,1575,6815,1492,523700,98101
15058,4379,10679,1455,512100,98102
24189,11463,12726,1459,602900,98103
8004,853,7151,1030,428800,98104
16007,5633,10374,1301,721200,98105
10781,5299,5482,1139,343300,98106
12906,4961,7945,1467,591000,98107
8639,4714,3925,1097,367400,98108
15090,4425,10665,1605,573300,98109
9679,7399,2280,1313,624200,98110
11264,6176,5088,1448,890500,98112
21844,13647,8197,1561,613300,98115
12161,7216,4945,1389,602100,98116
14448,10429,4019,1539,596900,98117
16693,9647,7046,1150,396700,98118
12148,5050,7098,1444,689100,98119
11339,2327,9012,1639,479600,98121
17930,5991,11939,1382,514800,98122
18649,8806,9843,1237,437500,98125
10062,5735,4327,1239,439800,98126
21642,10270,11372,1192,380700,98133
207,63,144,1477,287500,98134
7461,5019,2442,1314,580500,98136
13021,6146,6875,1123,497300,98144
9908,5937,3971,1135,350300,98146
4463,1696,2767,1147,296300,98148
0,0,0,-,-,98154
13377,9149,4228,1327,411700,98155
0,0,0,-,-,98158
85,63,22,-,660700,98164
8472,5467,3005,1063,423500,98166
11236,5988,5248,1099,269000,98168
0,0,0,-,-,98174
8312,6441,1871,1339,601800,98177
9500,5821,3679,1292,335700,98178
9517,4057,5460,1069,259600,98188
0,0,0,-,-,98195
13549,7301,6248,1209,286700,98198
9518,6150,3368,1468,700800,98199
12735,5028,7707,929,249500,98201
13372,7956,5416,1195,301300,98203
16484,5372,11112,1150,208500,98204
4787,3978,809,1451,303800,98205
0,0,0,-,-,98207
20261,13581,6680,1361,328000,98208
220,127,93,-,-,98220
9379,6535,2844,1110,373600,98221
34,34,0,-,659100,98222
15718,11840,3878,1217,302700,98223
137,103,34,725,170700,98224
20589,8306,12283,950,336700,98225
16588,10462,6126,1028,322600,98226
12676,8431,4245,995,315800,98229
7095,5351,1744,994,271200,98230
1805,1454,351,1275,346100,98232
6124,3784,2340,1014,235800,98233
60,47,13,-,185200,98235
2671,2023,648,1057,406400,98236
1681,1180,501,980,168800,98237
5,5,0,-,-,98238
3296,2654,642,898,337500,98239
1098,917,181,968,283600,98240
870,559,311,848,167900,98241
248,197,51,1056,543300,98243
1167,871,296,683,289300,98244
1850,1307,543,882,439200,98245
3368,2440,928,897,267100,98247
8853,6431,2422,917,287700,98248
1977,1394,583,1044,332100,98249
3592,2594,998,1046,437200,98250
1780,1495,285,1011,192400,98251
3740,2840,900,1206,228500,98252
804,742,62,-,381100,98253
61,50,11,1219,109100,98255
172,111,61,921,181700,98256
1761,1308,453,1079,285600,98257
11236,8529,2707,1460,319800,98258
2663,1974,689,1056,432100,98260
1258,971,287,976,453900,98261
452,330,122,1077,417600,98262
36,20,16,1050,181800,98263
7351,5159,2192,1060,298000,98264
1488,804,684,980,127400,98266
211,173,38,-,163300,98267
17652,11937,5715,1221,275000,98270
10497,7693,2804,1276,261500,98271
9479,7120,2359,1181,314200,98272
10886,6629,4257,885,241200,98273
6690,5057,1633,1166,280100,98274
8165,5550,2615,1492,476900,98275
170,137,33,1338,246900,98276
15859,8588,7271,1114,257400,98277
0,0,0,-,-,98278
315,248,67,875,557700,98279
240,218,22,908,511100,98280
681,533,148,820,242000,98281
6757,5805,952,1345,330500,98282
140,104,36,869,160000,98283
9219,6338,2881,1020,234900,98284
88,69,19,860,625000,98286
93,65,28,883,302800,98288
12285,9539,2746,1067,379900,98290
8354,6712,1642,1127,323200,98292
2735,1909,826,1250,223300,98294
906,602,304,855,228200,98295
9940,8428,1512,1767,466700,98296
28,23,5,-,-,98297
670,564,106,1509,257600,98303
313,214,99,721,142400,98304
151,139,12,-,113400,98305
8906,4674,4232,925,215100,98310
10164,7380,2784,1205,234600,98311
12835,7763,5072,1018,221500,98312
13,0,13,-,-,98314
1269,0,1269,1421,-,98315
540,451,89,921,219700,98320
5381,4368,1013,1125,260600,98321
263,220,43,1250,212200,98323
624,488,136,639,191000,98325
275,166,109,635,-,98326
3405,1614,1791,1743,308000,98327
3810,3062,748,882,262300,98328
3857,3254,603,1288,267200,98329
67,67,0,-,-,98330
2542,1619,923,605,149500,98331
6445,5421,1024,1477,403100,98332
1426,1309,117,1172,517600,98333
9749,7073,2676,1308,406000,98335
397,331,66,631,130900,98336
3225,1172,2053,824,176200,98337
9380,8208,1172,1332,237100,98338
1414,870,544,820,214100,98339
1349,1160,189,866,285500,98340
589,449,140,1265,382200,98342
198,80,118,1063,211800,98345
3886,2861,1025,1149,313900,98346
1811,1452,359,810,205200,98349
130,66,64,500,87500,98350
387,320,67,915,385300,98351
17,0,17,-,-,98353
2904,1746,1158,1220,251400,98354
379,379,0,-,112100,98355
939,655,284,827,151800,98356
496,335,161,466,85000,98357
453,379,74,1078,436900,98358
1720,1480,240,1178,298500,98359
4503,3747,756,1457,251900,98360
406,290,116,802,98800,98361
10220,6716,3504,809,218400,98362
5614,3945,1669,935,212400,98363
49,0,49,-,-,98364
2361,1947,414,1337,366600,98365
12581,7880,4701,1070,238300,98366
10568,8532,2036,1273,268000,98367
7175,4988,2187,936,311600,98368
11972,9197,2775,1225,336400,98370
8258,5670,2588,1061,275600,98371
9527,5565,3962,1156,280900,98372
8632,4838,3794,1183,271200,98373
13686,9377,4309,1342,269600,98374
9799,7254,2545,1472,243500,98375
862,727,135,842,248000,98376
817,569,248,561,140300,98377
1790,1468,322,1109,287500,98380
167,106,61,781,236400,98381
13159,9749,3410,971,261900,98382
8375,4630,3745,1229,310100,98383
118,104,14,1357,200000,98385
15611,11532,4079,1179,209200,98387
2527,1544,983,1067,326900,98388
4469,2461,2008,1067,258400,98390
16756,14218,2538,1415,293200,98391
1299,952,347,1040,226700,98392
496,455,41,1308,258000,98394
260,194,66,1527,228000,98396
3601,462,3139,1006,368500,98402
4192,1541,2651,915,385700,98403
11128,6388,4740,932,166400,98404
9614,4263,5351,887,201500,98405
9713,6120,3593,1008,296300,98406
9274,5408,3866,1212,311100,98407
7252,4232,3020,1050,179100,98408
9860,3622,6238,1071,167400,98409
0,0,0,-,-,98416
3864,2122,1742,1007,178300,98418
0,0,0,-,-,98421
7597,5835,1762,1416,338700,98422
4017,1650,2367,1125,258600,98424
0,0,0,-,-,98430
4219,34,4185,1608,-,98433
5,0,5,-,-,98438
1971,247,1724,1090,18400,98439
2185,1790,395,1162,262600,98443
12761,4676,8085,940,181100,98444
10992,7173,3819,1195,206400,98445
3749,2677,1072,978,254800,98446
0,0,0,-,-,98447
3103,1504,1599,934,319500,98465
11392,5998,5394,1082,300900,98466
6368,3172,3196,974,330300,98467
11441,6712,4729,1035,245200,98498
12393,4554,7839,895,212000,98499
17145,9747,7398,1069,285900,98501
13762,7617,6145,1064,326200,98502
15243,8039,7204,1142,226700,98503
7945,4741,3204,987,275700,98506
11903,8141,3762,1105,255800,98512
12639,8932,3707,1401,240100,98513
9149,6601,2548,1275,292800,98516
8127,4676,3451,746,144600,98520
1517,1172,345,988,278500,98524
90,56,34,667,100000,98526
155,149,6,-,-,98527
3486,2709,777,994,238800,98528
231,156,75,856,111500,98530
9913,5685,4228,836,156700,98531
8981,6441,2540,866,219800,98532
206,197,9,-,194700,98533
285,199,86,914,142500,98535
57,57,0,-,167100,98536
838,632,206,1058,169400,98537
117,84,33,1000,275000,98538
3811,2718,1093,656,177100,98541
214,163,51,847,258800,98542
9,9,0,-,-,98544
1164,1029,135,953,273400,98546
666,504,162,637,161200,98547
1051,1001,50,1108,187900,98548
4798,3033,1765,706,120500,98550
235,199,36,536,113100,98552
234,208,26,-,264700,98555
1311,938,373,1045,162500,98557
108,60,48,-,-,98558
24,0,24,-,-,98559
89,89,0,-,229500,98560
0,0,0,-,-,98562
2898,2225,673,934,196400,98563
1037,845,192,664,187500,98564
220,171,49,745,181800,98565
1108,806,302,750,182100,98568
2981,2138,843,869,197200,98569
1643,1277,366,832,202900,98570
132,132,0,-,-,98571
285,233,52,586,133500,98572
80,63,17,906,134700,98575
2017,1621,396,979,217300,98576
2428,1905,523,690,143800,98577
4757,3911,846,1276,218100,98579
4162,3337,825,1049,251300,98580
208,188,20,-,112500,98581
125,116,9,-,204800,98582
49,34,15,-,116100,98583
13508,9774,3734,901,185600,98584
351,247,104,980,179200,98585
689,433,256,538,116700,98586
267,192,75,375,94200,98587
751,676,75,-,242400,98588
2796,2147,649,1102,236800,98589
208,165,43,334,153000,98590
1376,1100,276,711,189200,98591
566,566,0,-,278500,98592
444,353,91,850,129500,98593
1256,704,552,720,160400,98595
2587,1839,748,934,174200,98596
8079,5802,2277,1226,209700,98597
1066,725,341,1225,255300,98601
51,43,8,-,-,98602
456,422,34,-,246900,98603
11970,9578,2392,1017,296700,98604
404,237,167,826,210200,98605
3137,2882,255,906,377400,98606
10744,8199,2545,1274,377500,98607
1230,794,436,944,192900,98610
3892,3176,716,778,195300,98611
1213,948,265,772,216100,98612
127,91,36,958,178700,98613
66,66,0,-,-,98614
73,73,0,-,256800,98616
500,385,115,1091,173700,98617
192,127,65,748,242600,98619
2969,1864,1105,732,148300,98620
190,176,14,-,178800,98621
716,440,276,917,212500,98624
2502,2027,475,738,229800,98625
9315,6199,3116,790,179900,98626
143,69,74,731,122900,98628
2730,2352,378,1438,317100,98629
1734,1229,505,698,174500,98631
20148,11833,8315,795,174200,98632
753,528,225,791,227100,98635
516,439,77,956,192800,98638
476,256,220,757,230700,98639
1964,1667,297,802,172300,98640
9,9,0,-,-,98641
6700,5540,1160,1344,357700,98642
187,175,12,-,194300,98643
111,67,44,863,124500,98644
464,399,65,-,159300,98645
149,112,37,-,-,98647
1288,798,490,665,258600,98648
388,326,62,-,218100,98649
342,275,67,963,387300,98650
367,271,96,1012,360200,98651
5417,2487,2930,849,234100,98660
18099,7585,10514,932,227000,98661
12258,7998,4260,1152,227000,98662
5902,3487,2415,959,234800,98663
8836,4951,3885,1085,238900,98664
9809,6002,3807,1003,246700,98665
22,20,2,-,207100,98670
8469,6592,1877,1049,294400,98671
2558,1850,708,903,319100,98672
201,112,89,758,98800,98673
4384,3249,1135,834,253500,98674
1949,1645,304,868,273800,98675
18990,13393,5597,1203,232600,98682
13704,7654,6050,1235,285200,98683
10240,5721,4519,1175,242100,98684
10297,8234,2063,1307,315200,98685
7356,5361,1995,1297,314700,98686
15362,9442,5920,859,237000,98801
10861,7877,2984,876,246300,98802
22,22,0,-,137500,98811
1557,885,672,610,161100,98812
885,522,363,689,100900,98813
248,217,31,-,249300,98814
2658,1713,945,735,251000,98815
2557,1718,839,763,306300,98816
53,36,17,-,-,98817
146,94,52,573,181700,98819
182,134,48,-,367000,98821
747,607,140,1009,254300,98822
3880,2594,1286,701,157600,98823
98,46,52,600,119400,98824
2963,2238,725,1017,331100,98826
79,63,16,-,-,98827
826,707,119,890,270400,98828
258,141,117,422,404800,98829
266,192,74,531,112800,98830
1202,765,437,582,272700,98831
87,72,15,-,195500,98832
59,40,19,-,428600,98833
83,69,14,-,281300,98834
254,176,78,-,246900,98836
14792,8992,5800,838,170900,98837
1913,1258,655,622,133700,98840
3690,2409,1281,673,155800,98841
656,314,342,773,290900,98843
2117,1419,698,620,165600,98844
113,81,32,550,266000,98845
479,296,183,674,221200,98846
582,477,105,543,274500,98847
3481,2250,1231,733,157600,98848
501,356,145,762,99700,98849
659,472,187,1122,152500,98850
1799,1303,496,702,146200,98851
5,2,3,-,-,98852
9,9,0,-,-,98853
2472,1830,642,665,159800,98855
1265,875,390,813,279200,98856
1190,837,353,683,118700,98857
856,579,277,679,155900,98858
120,73,47,-,-,98859
149,113,36,794,83900,98860
992,767,225,722,349000,98862
10124,5449,4675,706,156300,98901
16584,8730,7854,761,140800,98902
5191,3816,1375,905,144600,98903
14472,10019,4453,997,216600,98908
150,0,150,950,-,98921
2866,2035,831,890,278000,98922
362,179,183,638,101300,98923
284,211,73,732,315500,98925
12817,6809,6008,886,261600,98926
0,0,0,-,-,98929
4938,3075,1863,754,146100,98930
1344,812,532,945,119600,98932
357,234,123,818,130500,98933
426,236,190,893,154300,98934
962,711,251,791,106300,98935
1842,1399,443,1091,180300,98936
1520,1123,397,854,172300,98937
810,607,203,1223,173100,98938
44,35,9,-,-,98939
169,153,16,-,199600,98940
288,193,95,913,194600,98941
6420,4613,1807,952,215400,98942
395,275,120,1208,173800,98943
6041,3693,2348,713,149300,98944
229,150,79,1034,300000,98946
862,644,218,675,192000,98947
3532,2142,1390,668,122400,98948
73,18,55,-,-,98950
3677,2091,1586,721,122400,98951
560,324,236,554,102500,98952
2171,1762,409,942,185000,98953
1410,687,723,880,155100,99001
1843,1660,183,845,274100,99003
7465,4205,3260,833,198100,99004
2972,2671,301,1631,295500,99005
4583,3988,595,668,220500,99006
239,190,49,-,180200,99008
1320,994,326,743,215400,99009
733,5,728,1217,-,99011
321,244,77,875,157100,99012
615,456,159,379,182100,99013
5247,4223,1024,1054,222300,99016
64,42,22,858,60000,99017
117,55,62,671,129200,99018
4401,2968,1433,1043,292700,99019
0,0,0,-,-,99020
3433,3052,381,1025,225300,99021
3350,2584,766,669,206500,99022
209,172,37,-,322500,99023
1980,1626,354,694,256000,99025
3624,3103,521,947,240600,99026
2258,1961,297,953,194100,99027
459,367,92,770,177500,99029
428,370,58,855,158500,99030
506,359,147,607,230100,99031
293,243,50,939,104800,99032
383,267,116,617,115200,99033
0,0,0,-,-,99034
567,464,103,856,290700,99036
5576,3771,1805,859,226800,99037
33,28,5,-,103600,99039
292,212,80,479,75700,99040
549,458,91,1066,173100,99101
249,185,64,637,112500,99102
205,164,41,850,162500,99103
21,12,9,-,81700,99105
2192,1477,715,613,173700,99109
522,311,211,665,188400,99110
1858,1109,749,596,165900,99111
328,285,43,832,227500,99113
5123,3768,1355,651,176200,99114
473,340,133,642,155900,99115
729,538,191,763,150600,99116
190,144,46,593,123600,99117
287,206,81,775,213600,99118
493,441,52,1061,182300,99119
41,39,2,-,-,99121
1564,1280,284,712,165600,99122
442,334,108,754,176600,99123
143,103,40,1008,99200,99124
239,172,67,569,90700,99125
371,293,78,734,212800,99126
95,81,14,800,124100,99128
299,223,76,622,120500,99129
354,263,91,683,157400,99130
86,80,6,500,216700,99131
719,436,283,608,110500,99133
234,156,78,740,116300,99134
124,85,39,705,153100,99135
12,12,0,-,-,99136
180,135,45,608,121800,99137
442,288,154,505,132100,99138
589,458,131,701,190200,99139
159,103,56,355,112500,99140
2173,1580,593,656,171900,99141
301,232,69,563,100000,99143
8,4,4,-,-,99144
19,19,0,-,243800,99146
85,82,3,-,265000,99147
872,750,122,717,202900,99148
102,93,9,-,82800,99149
151,124,27,1039,217900,99150
65,51,14,-,105400,99151
82,58,24,630,153600,99152
207,128,79,398,172100,99153
11,11,0,-,-,99154
428,244,184,497,84400,99155
3524,2715,809,836,191400,99156
298,192,106,660,116000,99157
238,161,77,797,134900,99158
686,533,153,758,114700,99159
94,78,16,680,-,99160
653,526,127,557,174300,99161
11628,3628,8000,758,239500,99163
0,0,0,-,-,99164
1382,916,466,664,160500,99166
262,243,19,850,173900,99167
1046,703,343,688,132900,99169
433,320,113,397,135000,99170
480,304,176,640,136200,99171
596,507,89,688,188800,99173
21,14,7,713,111100,99174
85,59,26,771,231300,99176
202,168,34,600,231700,99179
468,374,94,705,165600,99180
736,604,132,588,155600,99181
548,415,133,642,154600,99185
6545,1913,4632,608,152100,99201
7055,2930,4125,756,145700,99202
9155,6774,2381,1056,248300,99203
3531,1093,2438,635,174900,99204
17810,11455,6355,935,142500,99205
14872,9232,5640,829,191000,99206
12083,5781,6302,854,109400,99207
20925,13610,7315,801,221500,99208
8432,5770,2662,913,156200,99212
10911,5315,5596,873,180600,99216
6790,4396,2394,834,166900,99217
6003,3243,2760,826,224800,99218
13024,8087,4937,889,249900,99223
8304,5532,2772,890,246500,99224
23066,16217,6849,868,182000,99301
3608,2936,672,760,168400,99320
76,42,34,-,-,99321
70,56,14,545,212500,99322
1366,1152,214,926,172700,99323
3967,2363,1604,843,184800,99324
1343,819,524,709,129400,99326
1593,1111,482,748,163700,99328
87,69,18,1025,123900,99329
360,272,88,424,112200,99330
22,19,3,-,-,99333
111,77,34,571,111300,99335
18408,8877,9531,861,159200,99336
10883,9385,1498,1002,187700,99337
5371,4936,435,971,291500,99338
277,185,92,931,129900,99341
749,373,376,621,162900,99343
4894,3009,1885,699,155700,99344
52,28,24,625,225000,99345
204,183,21,-,173600,99346
1025,715,310,599,140100,99347
428,166,262,697,142900,99348
2074,946,1128,696,184400,99349
5009,3277,1732,707,169800,99350
12153,8098,4055,994,245100,99352
5260,4353,907,1164,225500,99353
9264,5703,3561,905,200100,99354
72,38,34,713,155000,99356
941,434,507,609,138200,99357
89,72,17,442,107100,99359
483,376,107,895,301000,99360
758,570,188,716,173600,99361
15277,9769,5508,849,205300,99362
64,23,41,-,-,99363
191,156,35,833,82000,99371
80,80,0,-,-,99401
693,510,183,753,224600,99402
8488,5955,2533,732,175000,99403
7522,2379,5143,1047,332700,99501
8741,5575,3166,1224,322300,99502
5852,1804,4048,1039,236600,99503
14473,9368,5105,1310,256400,99504
1119,0,1119,2246,-,99505
2250,14,2236,2011,-,99506
13960,9565,4395,1366,292400,99507
12495,6354,6141,1120,261000,99508
0,0,0,-,-,99510
0,0,0,-,-,99513
7939,5837,2102,1440,315600,99515
7148,6599,549,1439,458900,99516
6960,3844,3116,1292,304100,99517
4071,2587,1484,1390,253200,99518
0,0,0,-,-,99519
160,107,53,-,254400,99540
33,21,12,1125,24200,99546
18,15,3,-,117500,99547
24,22,2,-,112500,99548
21,15,6,725,81700,99549
93,82,11,638,137500,99550
148,115,33,513,102700,99551
82,66,16,-,87500,99552
67,42,25,421,98800,99553
164,130,34,715,100000,99554
63,52,11,-,194400,99555
1091,942,149,880,171300,99556
202,134,68,1011,204400,99557
39,23,16,1125,55000,99558
2216,1110,1106,1410,245800,99559
77,70,7,-,110000,99561
253,200,53,742,82200,99563
15,10,5,625,-,99564
26,23,3,-,225000,99565
41,32,9,775,"10,000-",99566
3186,2462,724,1076,333200,99567
143,137,6,-,190100,99568
17,12,5,-,70000,99569
47,19,28,1125,157500,99571
229,187,42,-,368700,99572
164,128,36,633,155400,99573
1046,750,296,951,319000,99574
33,22,11,-,206300,99575
815,464,351,1171,248100,99576
9219,6825,2394,1934,335700,99577
119,81,38,458,39600,99578
18,15,3,-,106300,99579
28,21,7,-,112500,99580
180,132,48,817,105900,99581
33,8,25,-,137500,99583
83,58,25,425,109400,99585
67,41,26,-,265600,99586
854,395,459,1207,440900,99587
159,123,36,1194,218300,99588
57,43,14,-,68800,99589
54,29,25,338,62500,99590
25,15,10,-,77500,99591
65,48,17,763,57500,99602
3918,2668,1250,980,271700,99603
233,163,70,492,75500,99604
29,23,6,-,-,99605
95,64,31,650,112500,99606
68,58,10,-,161400,99607
114,89,25,650,79000,99609
809,694,115,979,206800,99610
6157,4032,2125,973,227400,99611
240,149,91,932,119000,99612
150,78,72,1194,197700,99613
154,122,32,563,85000,99614
4248,2451,1797,1306,276000,99615
156,109,47,633,73100,99620
151,127,24,513,85000,99621
68,54,14,-,183300,99622
23,17,6,488,86300,99624
34,23,11,-,92500,99625
77,64,13,-,195000,99626
157,94,63,1031,80000,99627
149,105,44,660,97500,99628
76,63,13,675,80600,99630
102,88,14,-,233300,99631
155,109,46,625,76500,99632
202,126,76,878,195800,99633
117,77,40,431,51500,99634
112,75,37,500,167500,99636
124,88,36,788,77100,99637
14,8,6,725,26700,99638
436,327,109,906,174800,99639
54,32,22,758,153600,99640
113,80,33,575,52000,99641
91,72,19,1042,78200,99643
83,57,26,925,153800,99644
8549,6620,1929,1035,247200,99645
8,8,0,-,137500,99647
29,22,7,575,82500,99648
28,24,4,-,95000,99649
136,95,41,488,85000,99650
7,5,2,-,-,99651
1221,951,270,978,184900,99652
38,7,31,967,"2,000,000+",99653
17927,13575,4352,1138,238800,99654
163,142,21,631,85000,99655
11,11,0,-,112500,99656
69,50,19,425,107500,99657
179,144,35,700,114500,99658
103,61,42,900,65000,99659
150,87,63,908,87700,99660
425,264,161,1049,138800,99661
114,81,33,-,81000,99662
197,145,52,588,202900,99663
1540,958,582,903,210800,99664
29,17,12,-,63000,99665
30,25,5,-,-,99666
49,49,0,-,-,99667
24,15,9,-,134400,99668
5781,4237,1544,1136,235500,99669
24,14,10,-,116700,99670
123,85,38,475,128800,99671
1254,1009,245,1033,273000,99672
552,434,118,792,170300,99674
598,421,177,1006,172900,99676
24,16,8,-,-,99677
221,142,79,610,103600,99678
87,55,32,675,72500,99679
122,83,39,438,59400,99680
70,49,21,525,-,99681
93,61,32,900,26300,99682
219,171,48,1288,128500,99683
207,139,68,960,126300,99684
904,221,683,1426,347800,99685
1163,947,216,1241,200700,99686
927,755,172,978,192700,99688
255,154,101,1030,185000,99689
42,38,4,-,75000,99690
41,27,14,538,28500,99691
74,0,74,675,-,99692
151,52,99,861,56000,99693
551,413,138,917,177800,99694
0,0,0,-,-,99695
6992,3036,3956,1165,184900,99701
935,6,929,2111,-,99702
1921,11,1910,2116,-,99703
0,0,0,-,-,99704
8226,5777,2449,1472,222500,99705
2,2,0,-,-,99706
12441,7987,4454,1071,250400,99709
5326,4285,1041,1030,257800,99712
446,367,79,1314,195700,99714
61,34,27,538,-,99720
78,52,26,850,100000,99721
61,48,13,-,95000,99722
1385,641,744,1061,181200,99723
28,22,6,-,85000,99724
9,6,3,-,57500,99726
125,76,49,850,90000,99727
93,78,15,883,157800,99729
40,31,9,-,59000,99730
6,0,6,-,-,99732
39,16,23,625,320000,99733
0,0,0,-,-,99734
43,26,17,1208,62000,99736
1443,1026,417,1153,220700,99737
61,41,20,533,97900,99738
88,57,31,813,87500,99739
203,141,62,763,92500,99740
171,139,32,1450,117600,99741
157,132,25,575,85700,99742
413,316,97,844,251300,99743
62,52,10,938,125000,99744
29,15,14,-,55000,99745
114,89,25,613,-,99746
57,41,16,850,106900,99747
68,50,18,692,72000,99748
94,73,21,800,106900,99749
121,82,39,900,72500,99750
32,18,14,725,118800,99751
905,419,486,1446,207000,99752
74,46,28,594,105600,99753
29,17,12,200,58300,99754
100,77,23,-,320800,99755
41,33,8,-,87900,99756
13,13,0,-,85000,99757
75,45,30,-,41300,99758
67,26,41,825,76700,99759
225,167,58,850,113600,99760
96,76,20,688,109400,99761
1429,729,700,1577,209100,99762
122,69,53,694,141100,99763
77,55,22,1604,89000,99764
94,73,21,500,67500,99765
168,118,50,781,88300,99766
11,9,2,-,83800,99767
68,56,12,333,118800,99768
209,178,31,900,88600,99769
171,128,43,692,83300,99770
75,60,15,563,86700,99771
158,105,53,773,73400,99772
55,39,16,750,93800,99773
6,2,4,-,-,99774
112,0,112,-,-,99775
43,32,11,538,104200,99776
100,65,35,481,52500,99777
54,36,18,513,106300,99778
556,395,161,892,142200,99780
57,44,13,513,-,99781
134,85,49,900,100800,99782
56,33,23,600,51300,99783
71,35,36,810,-,99784
93,59,34,925,75000,99785
78,49,29,650,79000,99786
38,32,6,-,57100,99788
105,60,45,850,86700,99789
4,4,0,-,-,99790
47,37,10,1063,116100,99791
11311,7561,3750,1187,343600,99801
136,70,66,733,125000,99820
962,472,490,1141,334000,99824
46,46,0,-,325000,99825
185,165,20,779,267500,99826
1119,793,326,1012,238300,99827
304,191,113,1005,172300,99829
191,132,59,938,140600,99830
36,31,5,-,174000,99832
1255,856,399,885,205000,99833
3545,2008,1537,1104,350900,99835
20,17,3,-,88300,99836
423,220,203,1069,293800,99840
63,63,0,-,247100,99841
5270,3261,2009,1139,265700,99901
9,9,0,-,-,99903
89,73,16,-,199000,99918
325,262,63,843,191700,99919
739,518,221,1015,225700,99921
98,81,17,350,90700,99922
0,0,0,-,-,99923
327,230,97,620,160900,99925
485,336,149,656,122600,99926
41,41,0,-,-,99927
1075,713,362,793,195900,99929
