housing_units_occ,homeowner_units_occ,renters_units_occ,med_rent,med_household_price,zip
5397,3553,1844,377,78800,601
12858,9782,3076,414,88500,602
19295,11254,8041,409,121600,603
1968,1440,528,350,96500,606
8934,6452,2482,478,89900,610
514,310,204,381,119500,611
23319,14466,8853,424,96000,612
3342,2366,976,438,90500,616
7820,5707,2113,573,107600,617
2789,2052,737,492,105800,622
13933,10137,3796,495,104300,623
7194,5033,2161,458,80900,624
11367,8659,2708,524,92000,627
396,248,148,283,87800,631
296,202,94,-,63300,636
7005,5550,1455,457,94300,637
6032,4487,1545,351,86200,638
8724,5299,3425,427,91000,641
11863,9393,2470,574,131500,646
1927,1431,496,328,81500,647
5157,3611,1546,598,92600,650
1250,952,298,671,104300,652
3591,2447,1144,280,78600,653
6513,4712,1801,386,76700,656
13214,9540,3674,509,104200,659
6220,4440,1780,439,103400,660
13974,8353,5621,475,114600,662
5120,3104,2016,404,96600,664
7849,5367,2482,474,90200,667
9745,6441,3304,453,87600,669
2639,2016,623,265,85000,670
14437,10708,3729,515,104400,674
13032,8126,4906,445,93100,676
5763,3854,1909,523,130300,677
8985,6081,2904,464,96600,678
17636,9967,7669,426,88900,680
11916,6124,5792,403,113500,682
10721,7343,3378,437,86200,683
14152,9817,4335,424,94500,685
9654,6780,2874,505,104600,687
4066,2547,1519,478,88900,688
2187,1563,624,-,128800,690
11537,7873,3664,572,120800,692
20194,15510,4684,530,109000,693
28,28,0,-,-,694
11647,8745,2902,429,91000,698
9057,5853,3204,407,118900,703
2543,1975,568,530,80200,704
8683,6814,1869,469,112700,705
3845,2798,1047,479,88000,707
6147,4685,1462,446,86000,714
801,670,131,236,65100,715
11125,7395,3730,426,114700,716
6398,3117,3281,297,105100,717
8105,5862,2243,479,89700,718
8456,5508,2948,506,90700,719
6495,4476,2019,436,85700,720
5882,4213,1669,391,88200,723
29994,19457,10537,507,120900,725
19267,13624,5643,742,132600,727
13021,10394,2627,431,99400,728
16529,12249,4280,555,105400,729
12806,8279,4527,454,93300,730
3933,3011,922,438,81000,731
4129,3020,1109,510,93000,735
17400,10856,6544,521,121200,736
11564,8039,3525,573,103000,738
11792,7559,4233,497,120100,739
643,330,313,513,81800,740
1394,1146,248,551,85400,741
15803,11608,4195,554,115700,745
7538,5794,1744,468,82500,751
13248,9749,3499,541,101800,754
7203,5660,1543,533,94800,757
2374,1670,704,470,123700,765
7873,5798,2075,448,93100,766
12011,8356,3655,479,86200,767
12975,9877,3098,469,93300,769
11857,9203,2654,487,115300,771
6580,4093,2487,403,88000,772
6803,4743,2060,472,110000,773
489,312,177,438,164100,775
13352,9654,3698,519,103400,777
14448,10954,3494,638,143300,778
4443,3923,520,807,97300,780
5130,2464,2666,482,109400,782
10531,7692,2839,563,99600,783
13947,9654,4293,385,85200,784
81,81,0,-,-,786
16356,11814,4542,458,105900,791
8731,5677,3054,428,109400,794
14486,10817,3669,517,92600,795
3133,1351,1782,577,345800,901
91,91,0,-,382700,906
8334,5150,3184,849,250300,907
2239,969,1270,566,137500,909
3656,1811,1845,695,308700,911
2691,1526,1165,597,133200,912
3040,532,2508,240,369000,913
10602,4458,6144,421,88400,915
8100,3996,4104,511,112700,917
7633,3601,4032,604,167100,918
6911,3796,3115,725,136000,920
13552,6643,6909,559,125600,921
10278,4594,5684,435,108800,923
19048,10031,9017,451,126400,924
2964,727,2237,492,142600,925
35788,26242,9546,621,167300,926
5936,3241,2695,553,188300,927
27,0,27,-,-,934
25663,19452,6211,670,125100,949
0,0,0,-,-,950
149,64,85,-,94300,951
2842,1861,981,469,96200,952
21990,17748,4242,694,131600,953
23846,16725,7121,587,118800,956
14799,10691,4108,623,124100,957
17329,11228,6101,587,133300,959
0,0,0,-,-,960
11292,7563,3729,691,147700,961
7567,4235,3332,509,101600,962
1888,1139,749,476,84700,965
5976,4361,1615,951,243000,966
1775,1304,471,879,188800,968
14577,11021,3556,898,213400,969
9104,6132,2972,602,133200,971
22179,15742,6437,574,143800,976
8548,5584,2964,950,162800,979
5804,3767,2037,592,132900,982
12664,8462,4202,596,134600,983
12105,8506,3599,570,130400,985
20202,15017,5185,731,133600,987
6791,4936,1855,1208,236300,1001
9985,4763,5222,1342,388300,1002
15,0,15,-,-,1003
1761,1711,50,-,281000,1005
5917,4964,953,1110,288300,1007
506,474,32,820,251700,1008
333,295,38,-,207800,1009
1503,1336,167,825,299400,1010
498,393,105,974,213800,1011
227,180,47,1083,247900,1012
9375,4753,4622,931,197800,1013
13400,8221,5179,1036,203400,1020
1082,762,320,1504,135300,1022
454,369,85,938,240400,1026
8451,5456,2995,1047,285800,1027
6017,5094,923,962,290500,1028
228,199,29,-,282000,1029
4994,3987,1007,1091,262700,1030
608,361,247,998,190700,1031
198,180,18,1188,245700,1032
2530,2206,324,861,281200,1033
830,779,51,1575,288100,1034
2254,1724,530,1246,361400,1035
2016,1906,110,2045,289100,1036
257,225,32,-,249600,1037
1111,821,290,1200,350400,1038
709,580,129,1215,330700,1039
15062,5962,9100,908,209900,1040
1072,878,194,1103,233200,1050
712,561,151,1090,282000,1053
708,623,85,1453,364600,1054
8567,6339,2228,1078,247300,1056
3485,2884,601,852,259400,1057
7060,3311,3749,1353,364100,1060
4162,3121,1041,1038,326100,1062
5,0,5,-,-,1063
34,34,0,-,-,1066
625,575,50,1227,320300,1068
3732,2755,977,920,210700,1069
258,225,33,895,244200,1070
518,465,53,885,243200,1071
609,541,68,1444,283300,1072
2318,2085,233,800,336600,1073
157,41,116,1083,-,1074
7328,5680,1648,1025,275600,1075
3648,3052,596,1149,303000,1077
237,161,76,-,248400,1079
895,571,324,1129,195800,1080
708,634,74,1111,232400,1081
4689,3203,1486,916,215500,1082
934,594,340,711,268900,1083
44,35,9,-,198200,1084
15608,10339,5269,983,257900,1085
345,188,157,1153,316700,1088
12734,7187,5547,949,251600,1089
532,274,258,746,245300,1092
70,62,8,-,361300,1093
31,31,0,-,344700,1094
5417,4865,552,906,319900,1095
1058,897,161,1318,299100,1096
26,15,11,-,-,1097
510,474,36,810,277600,1098
1434,134,1300,930,146900,1103
9208,4333,4875,985,160000,1104
5206,458,4748,788,178800,1105
6015,5411,604,1759,361900,1106
4234,1289,2945,769,162400,1107
10213,4237,5976,1034,171100,1108
9506,3970,5536,953,151600,1109
5785,4610,1175,1056,184300,1118
5230,3705,1525,1026,169900,1119
1136,1055,81,1700,204400,1128
2523,1961,562,1108,185500,1129
0,0,0,-,-,1144
3664,1771,1893,1134,158000,1151
19952,12672,7280,968,185800,1201
3948,2273,1675,837,167500,1220
289,267,22,1111,265600,1222
1223,1132,91,1448,281600,1223
80,67,13,-,243000,1224
1509,1329,180,1250,210500,1225
2907,2153,754,903,262900,1226
88,60,28,1281,804300,1229
3793,2842,951,1036,389400,1230
1104,893,211,851,182300,1235
704,543,161,1294,299300,1236
1019,948,71,1155,242700,1237
2292,1765,527,1041,289300,1238
2158,1337,821,1047,349000,1240
93,93,0,-,193800,1242
80,80,0,-,308000,1243
68,55,13,-,608300,1244
355,339,16,-,458300,1245
6527,4061,2466,823,157400,1247
434,366,68,-,282300,1253
440,430,10,-,447600,1254
309,304,5,1313,278000,1255
330,315,15,692,196100,1256
1013,778,235,941,385900,1257
77,73,4,-,397600,1258
292,257,35,-,352700,1259
81,81,0,-,191300,1260
688,439,249,854,507100,1262
100,74,26,1313,522700,1264
421,357,64,1643,363000,1266
2541,1952,589,994,356700,1267
372,372,0,-,300000,1270
8190,4607,3583,934,209300,1301
704,586,118,846,328400,1330
5450,3984,1466,900,193400,1331
1007,835,172,888,260300,1337
63,60,3,-,225000,1338
627,552,75,963,248100,1339
797,669,128,1006,233200,1340
730,614,116,1412,344500,1341
343,258,85,-,274400,1342
60,48,12,-,215000,1343
681,535,146,855,207800,1344
180,171,9,-,237100,1346
96,42,54,-,-,1347
327,244,83,1101,238000,1349
52,40,12,1000,100000,1350
1046,805,241,1172,271800,1351
602,472,130,855,269600,1354
413,360,53,1083,295200,1355
1213,1019,194,966,267000,1360
3021,2096,925,837,173900,1364
458,414,44,1182,310500,1366
178,161,17,1275,235300,1367
551,485,66,908,274700,1368
1694,1189,505,938,292800,1370
2355,1827,528,986,345300,1373
1666,727,939,1435,340000,1375
2312,1276,1036,948,211400,1376
319,297,22,1313,267000,1378
381,311,70,1403,223800,1379
14,14,0,-,150000,1380
16383,9189,7194,1008,232200,1420
2141,2014,127,1907,292300,1430
1297,1208,89,1024,288400,1431
3560,2416,1144,1171,335200,1432
315,315,0,-,347400,1434
1262,977,285,1030,275500,1436
124,102,22,-,181100,1438
8904,5088,3816,915,199600,1440
3820,3353,467,1267,517600,1450
1668,1582,86,1125,623100,1451
1586,1444,142,1052,295900,1452
17896,11363,6533,1064,275300,1453
3504,3043,461,1332,526600,1460
4447,3598,849,1505,344400,1462
4370,3583,787,1093,381200,1463
2345,1831,514,899,324000,1464
1622,1452,170,1304,280900,1468
2831,2317,514,1107,318500,1469
3122,2774,348,1541,317200,1473
680,626,54,1909,325400,1474
3726,2734,992,752,238500,1475
6534,5642,892,1007,295700,1501
1311,1095,216,792,477100,1503
3874,2953,921,1075,304800,1504
1834,1487,347,1513,470500,1505
1395,1215,180,955,248200,1506
4776,3885,891,1081,340600,1507
6455,3523,2932,1186,290600,1510
835,649,186,887,284200,1515
3179,2646,533,1274,354400,1516
1280,927,353,1300,327900,1518
2652,1924,728,1728,418400,1519
6021,5185,836,1421,363600,1520
1106,999,107,1172,258600,1521
1159,998,161,955,338000,1522
2801,2271,530,1524,374600,1523
2180,1856,324,937,303700,1524
31,0,31,-,-,1525
5165,3786,1379,1284,316600,1527
1275,1088,187,1199,341900,1529
430,359,71,772,338100,1531
5662,4696,966,1992,475400,1532
2367,1917,450,975,372100,1534
1883,1307,576,860,261800,1535
2914,2208,706,1055,386600,1536
781,532,249,1133,294400,1537
3988,3338,650,1021,283200,1540
1298,1229,69,872,419600,1541
992,878,114,1397,293400,1542
3052,2605,447,1005,350500,1543
13808,10358,3450,1676,447400,1545
7094,3270,3824,959,222900,1550
1902,1209,693,1164,378100,1560
17,17,0,-,-,1561
5186,3331,1855,919,309500,1562
3248,2866,382,1325,372400,1564
2610,2303,307,1379,317400,1566
2651,2365,286,916,506700,1568
5327,4396,931,1334,365400,1569
7414,4431,2983,994,275700,1570
4199,2800,1399,1050,285200,1571
7980,4852,3128,1790,508800,1581
2784,2280,504,1124,323600,1583
1968,1582,386,955,257300,1585
4005,2450,1555,1074,330200,1588
3332,2915,417,1178,391300,1590
10527,6481,4046,1250,280700,1602
7496,3635,3861,1108,229800,1603
16869,7403,9466,1295,246600,1604
11626,3335,8291,1107,258000,1605
9198,5995,3203,1308,259800,1606
3916,1426,2490,1109,246900,1607
1945,147,1798,1269,154400,1608
8439,3547,4892,1134,325000,1609
8866,1524,7342,1089,200600,1610
783,609,174,913,275000,1611
1588,1445,143,1125,365300,1612
13189,10311,2878,1666,480700,1701
14810,5150,9660,1494,431600,1702
228,156,72,-,318000,1718
2180,1637,543,1458,576200,1719
8678,6213,2465,1648,624000,1720
7587,5792,1795,2018,435900,1721
5540,3914,1626,2094,718800,1730
478,0,478,3031,-,1731
1853,1743,110,-,612800,1740
1800,1675,125,1389,863700,1741
6357,4745,1612,2271,922900,1742
215,147,68,1736,441300,1745
5354,4828,526,1235,483700,1746
2116,1673,443,1340,376300,1747
6556,5722,834,2082,624400,1748
8035,5795,2240,1364,384100,1749
17147,9877,7270,1527,382900,1752
4269,3369,900,1322,390600,1754
2076,1895,181,1350,523400,1756
11487,8127,3360,1458,348400,1757
15153,10195,4958,1778,621100,1760
1515,1418,97,1638,817700,1770
3364,3099,265,1125,652700,1772
2123,1599,524,1793,1028800,1773
2646,2262,384,1435,555200,1775
6208,5750,458,1232,797100,1776
4838,4408,430,1067,763900,1778
16292,9528,6764,1843,528200,1801
10093,7547,2546,2165,610000,1803
13235,10774,2461,1771,664500,1810
11664,9240,2424,1783,444300,1821
9915,8276,1639,1828,467700,1824
12350,9943,2407,1467,358200,1826
1136,1068,68,1625,539900,1827
10759,5659,5100,1277,348100,1830
9915,5585,4330,1368,350200,1832
3185,2470,715,1942,476800,1833
2532,2320,212,1432,409300,1834
5434,3971,1463,1354,341000,1835
3068,47,3021,987,-,1840
17019,5286,11733,1319,313500,1841
10204,3474,6730,1390,308800,1843
18792,13760,5032,1328,371300,1844
10971,7795,3176,1887,547300,1845
5864,2792,3072,1306,310300,1850
11376,4821,6555,1404,337300,1851
14628,6889,7739,1294,307300,1852
10417,3786,6631,1189,287100,1854
2589,2066,523,1130,432800,1860
3956,3138,818,1628,426500,1862
3713,3043,670,1402,372400,1863
5848,4763,1085,2022,601300,1864
9297,7968,1329,1619,630000,1867
11903,10068,1835,2130,447800,1876
4053,3450,603,1596,442000,1879
10905,7892,3013,1643,585400,1880
8515,7538,977,2134,590800,1886
7756,6627,1129,2186,542600,1887
8149,6703,1446,2063,1001300,1890
1194,137,1057,905,277900,1901
18673,7352,11321,1365,358900,1902
7044,5601,1443,1396,423200,1904
9339,4341,4998,1370,363200,1905
10581,8211,2370,1140,468300,1906
6169,4473,1696,2046,560500,1907
1678,1395,283,1763,601900,1908
7326,4918,2408,1245,379900,1913
16363,9750,6613,1442,480600,1915
2905,2799,106,914,705300,1921
1196,1121,75,-,608500,1922
10964,7807,3157,1681,490200,1923
1335,1075,260,1534,647100,1929
13168,8261,4907,1256,460400,1930
0,0,0,-,-,1937
5573,4176,1397,1271,545600,1938
4663,4001,662,1752,731400,1940
2080,1575,505,1725,881500,1944
8075,6552,1523,1567,766100,1945
3122,2862,260,1449,625800,1949
7537,5806,1731,1366,643300,1950
1337,1153,184,-,625000,1951
3885,3150,735,1565,380900,1952
22681,14831,7850,1620,441300,1960
354,336,18,-,658600,1965
3319,2269,1050,1632,573400,1966
2326,1862,464,1321,536800,1969
19699,10183,9516,1489,396700,1970
2575,2110,465,1356,590200,1982
2202,1939,263,1115,652900,1983
1291,1128,163,-,682600,1984
1591,1476,115,2250,603400,1985
6250,4915,1335,1628,344600,2019
9305,7152,2153,1931,560200,2021
3146,2519,627,1250,875000,2025
10458,7422,3036,1795,511000,2026
1916,1786,130,2575,1042100,2030
1522,1268,254,1702,558100,2032
7289,5148,2141,1577,476000,2035
12118,9693,2425,1519,450800,2038
9252,7621,1631,2149,877400,2043
4380,3505,875,1672,454600,2045
89,72,17,-,666700,2047
8707,6515,2192,1387,456300,2048
10142,8229,1913,1334,489300,2050
4373,3767,606,1504,727200,2052
4812,4192,620,1300,453900,2053
3078,2606,472,1770,460400,2054
2967,2836,131,1439,563800,2056
3567,3235,332,1923,652300,2061
13002,6923,6079,1730,482200,2062
7412,6496,916,1192,633500,2066
6395,5712,683,1802,608400,2067
383,359,24,-,499700,2071
11277,8458,2819,1722,392300,2072
7251,5846,1405,1544,543800,2081
5424,4658,766,1944,804000,2090
4480,3850,630,1243,484900,2093
1905,893,1012,2368,"2,000,000+",2108
1958,781,1177,3212,792500,2109
1282,809,473,3034,1142200,2110
3515,973,2542,1619,887900,2111
4025,629,3396,2144,655500,2113
7358,1697,5661,2650,864000,2114
9455,1160,8295,1784,931300,2115
11707,4211,7496,2183,1401900,2116
13847,3826,10021,1418,946500,2118
11953,3011,8942,1059,563200,2119
4701,449,4252,1363,602900,2120
10718,2492,8226,1129,541900,2121
9004,3787,5217,1692,551100,2122
19395,8006,11389,1555,492900,2124
12986,4616,8370,1540,578400,2125
8785,3360,5425,1553,440800,2126
16799,7467,9332,1875,719100,2127
16925,4276,12649,1740,577600,2128
9278,4508,4770,1860,799600,2129
17609,7977,9632,1975,665100,2130
12450,6688,5762,1679,517400,2131
10941,7737,3204,1778,606600,2132
0,0,0,-,-,2133
8082,1228,6854,1949,504800,2134
20040,4468,15572,1993,587800,2135
13929,7425,6504,1477,444500,2136
14377,5299,9078,2424,938100,2138
15263,5235,10028,2314,902900,2139
9437,3144,6293,2185,889600,2140
6826,2009,4817,2411,740100,2141
2077,293,1784,3392,1362500,2142
11623,3703,7920,2092,763700,2143
11363,3994,7369,2270,795500,2144
11349,3976,7373,2090,687600,2145
25582,10602,14980,1773,491100,2148
17091,6356,10735,1701,477400,2149
13337,3765,9572,1641,383800,2150
21663,10998,10665,1624,431200,2151
8242,4670,3572,1656,516700,2152
24771,13502,11269,2122,588100,2155
403,0,403,2811,-,2163
27629,10890,16739,1762,454100,2169
8001,4173,3828,1608,524100,2170
8869,4440,4429,1850,499100,2171
11926,7913,4013,1796,639400,2176
9758,6620,3138,1661,549600,2180
14384,10818,3566,1602,524900,2184
8797,7199,1598,1276,710000,2186
7085,4302,2783,1705,420900,2188
6194,4114,2080,1533,376500,2189
7677,5428,2249,1642,449200,2190
3444,2846,598,1515,402400,2191
833,59,774,3269,"2,000,000+",2199
0,0,0,-,-,2203
0,0,0,-,-,2205
3016,784,2232,3257,969800,2210
7931,703,7228,2157,494900,2215
22928,11337,11591,1337,316600,2301
12164,8602,3562,1217,296900,2302
1653,1360,293,1419,396900,2322
8657,6559,2098,1760,403600,2324
30,4,26,-,-,2325
4648,4122,526,1573,321200,2330
6092,5449,643,1743,678700,2332
4952,4011,941,1292,395300,2333
2930,2738,192,1255,360200,2338
4744,4295,449,1228,575500,2339
3850,3502,348,1732,410500,2341
4695,3775,920,1015,346900,2343
9727,7591,2136,1428,359700,2346
4162,3499,663,1663,428600,2347
70,70,0,-,256800,2350
6083,4796,1287,1365,421000,2351
4511,3316,1195,1546,485200,2356
0,0,0,-,-,2357
6861,5942,919,1607,441800,2359
24985,20203,4782,1588,391400,2360
5321,4524,797,1060,429400,2364
0,0,0,-,-,2366
989,919,70,1396,403200,2367
12167,8129,4038,1768,372500,2368
6654,5161,1493,1216,346800,2370
4482,3595,887,1856,395100,2375
2726,2317,409,1745,397900,2379
5684,4008,1676,1469,368600,2382
5374,4851,523,2130,988100,2420
6927,5335,1592,2691,973400,2421
9225,5089,4136,2477,1026100,2445
14278,5623,8655,2389,994500,2446
7586,4550,3036,2160,609500,2451
5215,2778,2437,2067,646100,2452
12115,5073,7042,1853,570700,2453
18,18,0,-,-,2457
4871,3088,1783,1893,892000,2458
6268,5328,940,2276,1153600,2459
3776,2362,1414,2079,931600,2460
2532,2030,502,2418,941900,2461
532,341,191,1510,1008200,2462
1370,891,479,2464,725700,2464
4436,3146,1290,2101,924300,2465
2990,1614,1376,1940,924900,2466
6746,4455,2291,2483,1085100,2467
1873,1789,84,-,1342400,2468
16067,7940,8127,1996,641500,2472
11649,6717,4932,1873,718600,2474
7659,4796,2863,1668,754500,2476
10372,6592,3780,2211,941700,2478
4743,4154,589,2213,1368100,2481
3907,3023,884,2510,1094500,2482
7160,6470,690,2003,961400,2492
3731,3252,479,1741,1323200,2493
4100,3037,1063,1801,895300,2494
5688,4548,1140,1264,382900,2532
379,347,32,-,639700,2534
742,644,98,1578,1325800,2535
8373,7228,1145,1517,390300,2536
2488,2346,142,1443,452300,2537
1748,1157,591,1238,283000,2538
1401,1030,371,1408,849100,2539
4171,2868,1303,1071,625400,2540
244,0,244,1679,-,2542
485,400,85,1207,722200,2543
30,30,0,-,-,2553
3973,2814,1159,1822,1069100,2554
1018,875,143,1157,596700,2556
685,406,279,1736,713200,2557
993,710,283,1439,323500,2558
1593,1222,371,1150,441600,2559
280,194,86,1414,446100,2561
1236,1037,199,1472,427500,2562
3983,3456,527,1589,417100,2563
33,33,0,-,"2,000,000+",2564
3044,2107,937,1340,810000,2568
4824,3468,1356,959,356100,2571
907,787,120,2052,860000,2575
1767,1493,274,1314,246700,2576
25,25,0,-,-,2584
6794,3522,3272,1435,316800,2601
744,659,85,1768,580200,2630
4519,3790,729,1360,476800,2631
4744,3799,945,1918,406800,2632
2269,1961,308,1043,755900,2633
1376,1313,63,1542,475100,2635
129,129,0,-,631500,2637
1447,1163,284,1347,548400,2638
1712,1044,668,1242,354300,2639
91,91,0,-,1111400,2641
2525,2357,168,1639,517100,2642
0,0,0,-,-,2643
1447,1289,158,1602,393900,2644
4474,3801,673,1247,478400,2645
896,780,116,1466,630200,2646
67,48,19,-,573500,2647
3064,2875,189,1774,449900,2648
6603,5524,1079,1365,389400,2649
340,300,40,-,932300,2650
618,470,148,-,702500,2652
2989,2405,584,974,640000,2653
1527,1356,171,1635,585900,2655
1968,1488,480,1133,666700,2657
555,490,65,1115,659900,2659
2896,2237,659,1329,399500,2660
178,168,10,-,580000,2663
3989,2886,1103,1621,379300,2664
295,295,0,-,536400,2666
1558,1294,264,1274,575700,2667
1004,955,49,-,526500,2668
829,634,195,1245,487100,2670
463,426,37,-,524700,2671
88,88,0,-,830800,2672
3839,3098,741,1583,342400,2673
3087,2849,238,1519,438000,2675
1673,1565,108,1395,396700,2702
17898,12062,5836,1261,332300,2703
18,13,5,-,-,2713
1383,1266,117,-,414900,2715
1696,1499,197,1923,391900,2717
2444,2185,259,899,333800,2718
6872,5077,1795,953,321400,2719
13787,5530,8257,993,285100,2720
11010,4047,6963,882,291100,2721
7511,2292,5219,888,254600,2723
8389,2809,5580,903,286500,2724
934,811,123,-,331700,2725
6314,5267,1047,1242,314700,2726
1993,1628,365,1326,520100,2738
2926,2237,689,1546,491000,2739
19301,7360,11941,930,250300,2740
4060,3524,536,952,309700,2743
5157,1708,3449,962,261500,2744
10154,5959,4195,946,266700,2745
6697,1126,5571,920,255800,2746
7237,5623,1614,1209,367400,2747
4779,3621,1158,1101,389000,2748
11550,7981,3569,1151,366400,2760
4144,3032,1112,1659,398200,2762
723,538,185,1605,461600,2763
1560,1357,203,1582,383000,2764
6489,5476,1013,1671,383300,2766
5550,4336,1214,1613,399500,2767
4377,3896,481,1184,429100,2769
2032,1806,226,1347,445200,2770
5969,5109,860,1478,381900,2771
6752,5915,837,1183,333600,2777
2294,2244,50,-,377700,2779
20625,12414,8211,1068,307800,2780
6667,5504,1163,1164,388700,2790
244,211,33,-,830900,2791
238,58,180,848,-,2802
898,738,160,1294,256600,2804
6176,5500,676,1434,461100,2806
459,338,121,1139,983900,2807
901,512,389,1075,249500,2808
8065,5537,2528,1170,363200,2809
438,417,21,-,362900,2812
3459,2885,574,1292,363900,2813
2902,2507,395,955,318700,2814
72,56,16,-,219400,2815
13371,10437,2934,1051,252100,2816
2316,1939,377,2004,374000,2817
8307,6066,2241,1375,433200,2818
2018,1722,296,954,348100,2822
13,13,0,-,-,2823
85,85,0,-,229900,2824
1843,1629,214,893,338900,2825
282,282,0,-,232400,2826
844,809,35,2069,291300,2827
3183,2678,505,1363,335000,2828
35,0,35,-,-,2829
2409,1855,554,869,328500,2830
1473,1286,187,1550,348000,2831
1816,1464,352,1066,344200,2832
352,254,98,375,267700,2833
2361,2002,359,1642,701900,2835
53,53,0,-,277100,2836
1592,1262,330,1717,607800,2837
1310,515,795,1187,293400,2838
589,385,204,1367,252100,2839
10171,4712,5459,1399,529900,2840
6,0,6,-,-,2841
7270,4103,3167,1475,420900,2842
9563,7366,2197,1073,375400,2852
3155,2849,306,1266,339400,2857
214,182,32,-,261200,2858
2436,1892,544,891,293400,2859
18949,7296,11653,969,228800,2860
10737,6870,3867,1110,228100,2861
7074,1809,5265,955,187300,2863
13620,10650,2970,1023,327600,2864
6756,5096,1660,1247,367700,2865
7196,5820,1376,1608,404700,2871
82,69,13,-,419800,2872
58,58,0,-,-,2873
2395,2096,299,1673,508200,2874
138,127,11,-,353600,2875
520,91,429,1568,-,2876
6651,5179,1472,1119,288700,2878
9148,6959,2189,1165,399700,2879
793,478,315,1319,416300,2881
5492,3723,1769,1298,495000,2882
5032,2921,2111,1032,318700,2885
12976,8352,4624,1262,267100,2886
8365,6547,1818,1148,244000,2888
11354,8783,2571,1173,242200,2889
9936,7147,2789,1176,345800,2891
2091,1836,255,1596,386100,2892
14030,7677,6353,1045,238000,2893
255,237,18,-,295100,2894
16921,6372,10549,974,208700,2895
4455,3546,909,897,340800,2896
575,550,25,-,294400,2898
5047,950,4097,1200,331500,2903
12951,6581,6370,1068,241500,2904
9862,4721,5141,1028,243300,2905
12185,6040,6145,1435,476100,2906
10591,3208,7383,971,218400,2907
14380,7091,7289,1152,230000,2908
14857,5663,9194,999,219000,2909
8624,5938,2686,1196,236300,2910
6637,3895,2742,1217,263600,2911
13,0,13,-,-,2912
9311,4863,4448,1052,233900,2914
7168,4633,2535,1076,236300,2915
3791,2691,1100,1029,279500,2916
4672,3680,992,852,321800,2917
36,0,36,-,-,2918
11405,8366,3039,1045,254800,2919
14326,9039,5287,1157,274700,2920
4659,3835,824,1343,400000,2921
4476,4070,406,1159,390200,3031
1989,1829,160,1739,416700,3032
1728,1664,64,1682,359900,3033
1603,1512,91,1188,299400,3034
1719,1672,47,906,380800,3036
1646,1482,164,1346,325300,3037
13056,8696,4360,1266,290900,3038
2681,2333,348,1339,338500,3042
571,535,36,1500,300300,3043
1638,1542,96,1571,305700,3044
5172,4365,807,1324,284900,3045
1024,965,59,1104,360700,3046
677,561,116,-,258900,3047
1418,1155,263,1090,227200,3048
3223,3003,220,1612,494600,3049
9542,7957,1585,1357,330200,3051
2967,2578,389,1668,347600,3052
9269,7947,1322,1505,367300,3053
9971,8758,1213,1609,331100,3054
6419,3907,2512,1383,278200,3055
893,805,88,1542,360600,3057
12194,4258,7936,1302,257800,3060
11733,8068,3665,1624,320500,3062
6823,4165,2658,1518,302100,3063
6369,3835,2534,1282,310200,3064
2045,1753,292,1005,334800,3070
1844,1581,263,842,253600,3071
4884,4341,543,1241,387600,3076
4093,3146,947,1380,263200,3077
12138,9286,2852,1332,355400,3079
620,564,56,1711,283900,3082
490,429,61,1393,312300,3084
1739,1367,372,1353,281800,3086
5283,4956,327,2780,516400,3087
1895,99,1796,1519,279000,3101
14100,5114,8986,1283,236200,3102
15018,6804,8214,1090,238200,3103
14725,8329,6396,1222,286100,3104
5185,3974,1211,1390,274800,3106
3833,2907,926,1379,258800,3109
8076,6906,1170,1863,474100,3110
99,83,16,1036,359100,3215
818,701,117,1112,253700,3216
992,529,463,1014,176800,3217
569,408,161,1301,199500,3218
3039,2585,454,856,201400,3220
878,782,96,1125,240700,3221
2286,1861,425,1046,210600,3222
1174,960,214,858,190000,3223
900,834,66,-,295400,3224
1299,1199,100,1186,232000,3225
384,340,44,883,340700,3226
692,637,55,1850,299400,3227
2227,1998,229,1159,311900,3229
616,578,38,1010,163100,3230
77,71,6,-,332100,3231
100,90,10,-,368100,3233
1746,1516,230,1061,251400,3234
3813,2528,1285,951,206200,3235
773,706,67,-,270300,3237
43,42,1,-,162100,3238
461,425,36,1099,186000,3240
377,343,34,1115,295700,3241
2098,1440,658,1000,239800,3242
355,327,28,850,184200,3243
2967,2758,209,-,196100,3244
815,644,171,1630,297100,3245
6826,4126,2700,1097,213600,3246
3086,2777,309,923,305400,3249
563,413,150,995,240900,3251
3109,2458,651,1205,341900,3253
2007,1808,199,1410,367200,3254
746,668,78,433,352800,3255
941,818,123,1127,276500,3256
1537,1354,183,1359,388100,3257
984,905,79,1657,286700,3258
151,151,0,-,347300,3259
377,356,21,-,282500,3260
1746,1578,168,1047,284100,3261
475,373,102,1012,246100,3262
1823,1179,644,879,200600,3263
2179,1232,947,1035,209600,3264
799,683,116,783,199300,3266
599,571,28,1250,232200,3268
1080,824,256,1051,295500,3269
115,115,0,-,269200,3273
4458,3384,1074,1077,229500,3275
3501,2423,1078,953,184600,3276
1203,800,403,1119,258200,3278
307,259,48,1034,142100,3279
479,431,48,1237,213100,3280
3371,3192,179,1341,268400,3281
412,356,56,1229,220000,3282
252,220,32,1075,243300,3284
1060,853,207,1125,253800,3285
655,519,136,1195,286900,3287
1959,1878,81,1288,330200,3290
29,29,0,-,-,3291
54,54,0,-,194800,3293
13351,7261,6090,1152,261500,3301
6466,4449,2017,1170,222800,3303
2802,2494,308,1227,344300,3304
2336,2063,273,1036,248300,3307
9964,5465,4499,1086,193200,3431
1103,868,235,1093,243100,3440
86,49,37,-,170800,3441
647,407,240,1052,195700,3442
180,180,0,-,245000,3443
621,509,112,1159,319600,3444
273,231,42,1083,186100,3445
2823,1936,887,1286,206500,3446
1010,929,81,1118,227500,3447
302,275,27,1330,193800,3448
802,656,146,1229,341900,3449
427,398,29,1318,273600,3450
1550,1309,241,945,149900,3451
2048,1527,521,982,186800,3452
988,648,340,1061,222100,3455
315,270,45,1039,230300,3456
299,267,32,1125,313200,3457
3011,1860,1151,892,279900,3458
1859,1564,295,962,259100,3461
625,504,121,1036,279100,3462
346,330,16,-,245700,3464
737,540,197,1052,160000,3465
599,528,71,-,191100,3466
822,742,80,1098,287300,3467
1888,1343,545,971,180600,3470
2873,1564,1309,771,192200,3561
3759,2374,1385,688,79100,3570
1013,757,256,827,174300,3574
3,3,0,-,-,3575
1397,1072,325,726,167200,3576
182,166,16,-,241300,3579
527,447,80,931,378300,3580
1583,1159,424,677,142100,3581
913,712,201,721,101100,3582
473,410,63,777,267600,3583
1395,1094,301,822,142600,3584
1014,790,224,923,168200,3585
252,230,22,632,428300,3586
655,551,104,937,180400,3588
418,342,76,636,139000,3590
544,444,100,745,196900,3592
173,128,45,1170,246400,3593
386,314,72,944,193500,3595
233,156,77,586,72100,3597
1494,1039,455,996,154800,3598
125,117,8,-,175900,3601
983,730,253,842,193800,3602
2036,1520,516,1091,115000,3603
0,0,0,-,-,3604
283,265,18,1094,171000,3605
99,86,13,1146,217600,3607
1201,769,432,1048,271400,3608
248,157,91,1188,157200,3609
433,370,63,967,180200,3740
1567,1290,277,1071,208600,3741
5346,3022,2324,995,137600,3743
735,713,22,1313,239600,3745
2056,1622,434,1340,254500,3748
259,240,19,-,487500,3750
203,175,28,-,261700,3751
301,262,39,1089,192500,3752
1235,1135,100,1575,331300,3753
2668,1783,885,1703,590900,3755
158,143,15,-,228200,3765
4184,2360,1824,1560,275100,3766
609,540,69,1500,521000,3768
147,142,5,-,455600,3770
323,295,28,793,195700,3771
3031,2001,1030,1109,166200,3773
691,509,182,1304,154300,3774
538,434,104,1151,263600,3777
269,214,55,1057,221800,3779
198,198,0,-,-,3780
778,697,81,1659,321400,3781
983,719,264,1377,322400,3782
1802,815,987,1337,271400,3784
831,485,346,1006,149400,3785
10851,5743,5108,1504,497300,3801
1325,1169,156,-,244100,3809
809,794,15,-,378900,3810
2821,2591,230,1578,376300,3811
448,295,153,1025,223200,3812
1573,1273,300,1245,173700,3813
933,688,245,921,180500,3814
567,492,75,1152,282400,3816
295,180,115,830,271600,3817
1664,1177,487,887,197700,3818
1649,1456,193,1760,312100,3819
14724,7622,7102,1276,310200,3820
711,589,122,1333,383000,3823
2904,1728,1176,1203,404200,3824
3333,3080,253,1635,294600,3825
1122,756,366,882,358100,3826
1169,1084,85,1089,436700,3827
634,634,0,-,271700,3830
155,122,33,775,331400,3832
8953,6573,2380,1373,369200,3833
2785,2049,736,990,222600,3835
579,563,16,-,290300,3836
720,650,70,1372,275800,3837
579,431,148,-,437600,3838
1577,1077,500,1105,223600,3839
1566,1299,267,1805,502500,3840
2623,2232,391,1166,379800,3841
7139,5293,1846,1372,401300,3842
861,766,95,1646,500000,3844
705,577,128,1493,228200,3845
488,391,97,1691,465700,3846
249,205,44,-,340100,3847
2687,2161,526,1184,335900,3848
459,399,60,1125,280200,3849
69,69,0,-,311400,3850
1512,1321,191,900,221100,3851
140,140,0,-,189400,3852
363,320,43,1337,409500,3853
395,364,31,2663,1192900,3854
1005,901,104,1254,256900,3855
637,608,29,1781,471100,3856
4322,2352,1970,1375,337200,3857
1769,1572,197,1109,347200,3858
1818,1152,666,899,295000,3860
1865,1615,250,1073,330800,3861
1924,1726,198,1586,498900,3862
730,702,28,-,206500,3864
3242,2646,596,1355,329800,3865
9366,5827,3539,1112,206200,3867
2528,1891,637,1025,208000,3868
1025,814,211,1087,281800,3869
2206,1877,329,1228,700500,3870
201,192,9,-,1511100,3871
1674,1580,94,850,248900,3872
2211,1892,319,1890,337900,3873
3837,2677,1160,1327,301000,3874
406,343,63,791,295200,3875
5185,3094,2091,1189,226100,3878
513,427,86,1125,210100,3882
164,105,59,-,275700,3883
1379,1292,87,1271,321500,3884
3046,2795,251,1770,491500,3885
457,340,117,956,191000,3886
699,645,54,869,202200,3887
19,10,9,-,-,3890
3005,2172,833,886,326200,3894
17,17,0,-,415000,3897
3398,2841,557,985,260800,3901
941,764,177,2007,419400,3902
2680,2288,392,1141,383700,3903
4084,2508,1576,1235,334000,3904
878,792,86,1880,466500,3905
1954,1639,315,984,298800,3906
595,511,84,1708,632100,3907
2772,2148,624,1108,304900,3908
4539,3630,909,1421,452800,3909
14,14,0,-,-,3910
77,77,0,-,-,3911
1129,1096,33,950,257100,4001
2979,2617,362,779,243000,4002
107,85,22,-,-,4003
9987,5151,4836,1065,278900,4005
27,27,0,-,801500,4006
1196,1082,114,1073,257200,4008
2245,1882,363,850,208500,4009
613,512,101,1313,214900,4010
8716,6234,2482,1150,272700,4011
1700,1514,186,754,214800,4015
302,207,95,1684,454100,4017
39,39,0,-,416700,4019
704,587,117,1037,173500,4020
2339,1942,397,1398,381600,4021
431,389,42,1066,224500,4022
193,159,34,1125,183900,4024
2277,1974,303,1285,231200,4027
836,696,140,1046,193300,4029
735,633,102,1193,273700,4030
3427,2754,673,1457,360400,4032
1458,1169,289,590,205800,4037
6092,5005,1087,1195,314100,4038
3434,2677,757,1187,272700,4039
1390,1255,135,775,188600,4040
617,503,114,1108,178500,4041
1882,1744,138,919,246000,4042
4858,3696,1162,1136,358800,4043
3201,2625,576,1131,373100,4046
711,607,104,681,199100,4047
1171,1021,150,1029,190900,4048
1496,1379,117,1145,197900,4049
117,95,22,2194,369400,4050
530,473,57,1125,218500,4051
2006,1740,266,1362,209200,4055
39,39,0,-,171600,4056
116,116,0,-,-,4057
976,958,18,-,172800,4061
7064,6167,897,1181,281500,4062
389,232,157,396,407600,4063
4751,3365,1386,967,239200,4064
357,182,175,1082,578300,4066
556,476,80,870,166900,4068
570,468,102,1202,336100,4069
2173,1970,203,1262,273700,4071
8631,5880,2751,1186,289800,4072
6997,4448,2549,979,205200,4073
8811,7039,1772,1651,399800,4074
1144,1057,87,1150,242200,4076
1967,1625,342,1129,482300,4079
2037,1513,524,992,191500,4083
2656,2424,232,881,258900,4084
992,897,95,1359,228600,4085
4135,3194,941,1021,248100,4086
924,841,83,1241,195800,4087
532,459,73,944,180400,4088
4904,4136,768,990,333300,4090
320,288,32,-,209900,4091
8838,5849,2989,1094,253900,4092
3325,2402,923,1353,247200,4093
708,676,32,1069,238200,4095
3463,2594,869,1544,416400,4096
1497,1227,270,1249,381200,4097
9684,2032,7652,1257,450900,4101
7820,4050,3770,1233,343500,4102
13183,8025,5158,1332,315300,4103
4825,4167,658,1631,505800,4105
11774,7566,4208,1460,292400,4106
3893,3403,490,1625,514900,4107
434,379,55,1063,374300,4108
77,77,0,-,458700,4109
611,522,89,1378,682800,4110
10249,5948,4301,814,190000,4210
280,256,24,767,141700,4216
1540,1278,262,519,217400,4217
559,482,77,940,167300,4219
1238,1150,88,1039,157800,4220
335,272,63,425,151000,4221
1699,1586,113,990,237200,4222
1072,855,217,668,98900,4224
33,30,3,-,137500,4226
17,17,0,-,-,4227
94,80,14,1563,156800,4231
0,0,0,-,-,4234
1661,1485,176,879,213200,4236
105,98,7,-,261800,4237
443,391,52,1042,191500,4238
1928,1702,226,682,135400,4239
15588,7770,7818,804,157500,4240
1782,1382,400,832,179200,4250
1928,1465,463,799,182200,4252
761,723,38,806,170000,4253
1412,797,615,735,91300,4254
302,220,82,986,203000,4255
1152,857,295,1098,170600,4256
1136,847,289,713,80300,4257
1063,979,84,970,226600,4258
1412,1100,312,865,201100,4259
2093,1713,380,1085,253300,4260
158,144,14,850,-,4261
777,706,71,775,184100,4263
332,261,71,1103,167000,4265
15,15,0,-,-,4267
1915,1287,628,726,168000,4268
2320,1966,354,1099,168300,4270
0,0,0,-,-,4271
2348,2060,288,979,233000,4274
268,253,15,875,105000,4275
2416,1712,704,557,88900,4276
2989,2697,292,787,159200,4280
2063,1296,767,833,156700,4281
2361,1850,511,673,197800,4282
465,368,97,796,298100,4284
189,171,18,571,173000,4285
0,0,0,-,-,4286
1356,1266,90,-,231200,4287
689,550,139,803,156700,4289
669,601,68,669,117400,4290
373,333,40,-,143100,4292
1422,1050,372,484,138600,4294
12227,7515,4712,762,158400,4330
0,0,0,-,-,4341
717,624,93,1073,173500,4342
1381,923,458,685,163700,4344
4760,3615,1145,840,157700,4345
792,561,231,923,127500,4346
1289,644,645,892,219700,4347
1169,1001,168,872,191100,4348
581,496,85,1016,223400,4349
1482,1372,110,1020,213900,4350
974,790,184,922,232200,4351
665,588,77,808,170800,4352
895,836,59,923,163800,4353
618,589,29,-,202600,4354
959,821,138,963,223300,4355
1484,1045,439,921,200800,4357
1845,1655,190,937,198400,4358
127,58,69,693,171400,4359
229,215,14,535,170600,4360
1051,870,181,894,178600,4363
2533,1933,600,837,234400,4364
18773,10384,8389,890,181600,4401
328,276,52,769,135100,4406
100,86,14,863,173200,4408
430,391,39,642,156700,4410
620,512,108,933,156300,4411
4074,2342,1732,898,172800,4412
75,75,0,-,102700,4413
667,602,65,493,102700,4414
116,81,35,766,58900,4415
2327,1871,456,628,174900,4416
203,196,7,-,85300,4417
633,533,100,533,94800,4418
1204,987,217,1070,191900,4419
256,186,70,871,388600,4421
400,377,23,567,139300,4422
378,309,69,501,105600,4424
1969,1297,672,770,119100,4426
1088,913,175,595,118900,4427
1267,1056,211,969,166200,4428
2102,1806,296,960,226500,4429
721,527,194,572,63200,4430
21,13,8,-,-,4431
418,393,25,900,116300,4434
438,416,22,1071,128000,4435
525,444,81,677,158300,4438
757,593,164,619,198500,4441
37,37,0,-,172000,4442
916,689,227,454,150900,4443
3541,2934,607,895,237500,4444
561,455,106,707,93800,4448
490,442,48,858,120200,4449
553,451,102,922,121400,4450
119,109,10,-,56100,4451
287,205,82,712,96100,4453
13,13,0,-,78300,4454
260,224,36,913,121300,4455
1164,970,194,1045,174200,4456
2700,1970,730,602,113500,4457
323,272,51,363,61900,4459
598,510,88,660,68000,4460
1197,1022,175,954,134900,4461
2349,1882,467,533,79300,4462
1153,863,290,907,72100,4463
213,176,37,547,119600,4464
3881,2565,1316,839,144900,4468
0,0,0,-,-,4469
240,231,9,-,130500,4471
862,746,116,1231,177900,4472
3465,1749,1716,967,188500,4473
1551,1369,182,1048,190900,4474
221,184,37,475,74400,4475
524,479,45,944,225700,4476
186,146,40,-,259400,4478
585,462,123,722,104500,4479
230,220,10,875,170300,4481
66,57,9,-,160800,4485
376,346,30,825,73600,4487
463,378,85,738,161200,4488
111,77,34,1553,149700,4489
105,104,1,-,88000,4490
86,79,7,-,74400,4491
34,33,1,-,87500,4492
764,686,78,623,122900,4493
187,162,25,605,83200,4495
1587,1342,245,545,183700,4496
173,151,22,-,57300,4497
5008,3284,1724,893,237200,4530
278,254,24,1094,239100,4535
660,593,67,893,249800,4537
836,611,225,617,284000,4538
654,615,39,-,255300,4539
29,29,0,-,446400,4541
917,542,375,871,266400,4543
467,294,173,-,350000,4544
499,440,59,1144,250000,4547
458,375,83,850,354800,4548
279,266,13,-,293200,4551
778,602,176,900,298200,4553
326,289,37,-,451400,4554
697,633,64,833,224400,4555
557,484,73,1139,296300,4556
102,102,0,-,369000,4558
1040,867,173,872,239300,4562
645,552,93,996,283300,4563
207,200,7,-,300000,4564
257,144,113,1123,392900,4568
0,0,0,-,-,4570
309,275,34,-,199100,4571
2639,2019,620,282,185000,4572
178,160,18,675,358300,4573
691,629,62,1524,148300,4574
106,106,0,-,296900,4575
278,269,9,-,412500,4576
1994,1517,477,839,220800,4578
1202,1071,131,1221,201700,4579
6244,4602,1642,864,188700,4605
518,464,54,725,131200,4606
566,493,73,725,210600,4607
2208,1516,692,924,342700,4609
190,149,41,695,256000,4611
222,209,13,-,294600,4612
42,42,0,-,-,4613
1228,801,427,860,309800,4614
349,318,31,1134,231300,4616
348,312,36,1250,348900,4617
1664,1185,479,615,100300,4619
397,288,109,350,112000,4622
366,299,67,835,134000,4623
103,94,9,-,-,4624
32,26,6,-,350000,4625
240,209,31,541,131600,4626
807,702,105,810,254400,4627
241,199,42,358,130600,4628
529,449,80,829,120600,4630
599,464,135,433,111600,4631
846,704,142,913,169000,4634
6,4,2,-,200000,4635
1059,893,166,934,209900,4640
78,69,9,-,379200,4642
320,257,63,1078,130800,4643
22,16,6,-,-,4645
41,36,5,-,313300,4646
263,205,58,925,76400,4648
541,356,185,388,131700,4649
133,120,13,-,241700,4650
727,599,128,345,150200,4652
318,196,122,1155,269200,4653
1282,882,400,397,123400,4654
396,272,124,995,159800,4655
144,129,15,-,225000,4657
536,432,104,797,121900,4658
502,455,47,947,421700,4660
238,159,79,1063,547700,4662
482,387,95,950,183700,4664
517,439,78,935,99300,4666
536,400,136,525,122600,4667
760,561,199,330,100300,4668
56,39,17,-,260300,4669
217,188,29,1125,209400,4671
68,68,0,-,187500,4673
111,99,12,-,254700,4674
80,65,15,-,437500,4675
575,455,120,875,224200,4676
131,98,33,1339,247400,4677
708,444,264,618,317200,4679
514,448,66,618,151800,4680
477,350,127,743,190000,4681
0,0,0,-,-,4683
858,675,183,791,239200,4684
195,175,20,-,261400,4685
66,45,21,728,81300,4686
188,156,32,1523,186400,4691
230,187,43,835,164300,4693
944,756,188,599,91000,4694
4032,2893,1139,541,112600,4730
731,490,241,-,93900,4732
156,118,38,-,118800,4733
339,315,24,767,115600,4734
203,179,24,438,83200,4735
4139,2980,1159,626,100100,4736
0,0,0,-,-,4737
331,276,55,567,111900,4739
594,483,111,603,112000,4740
1303,1014,289,765,117100,4742
1939,1494,445,679,108700,4743
376,330,46,717,98400,4745
201,169,32,443,58800,4746
562,475,87,650,114000,4747
777,463,314,672,80300,4750
1510,968,542,513,116200,4756
1089,895,194,527,153000,4757
532,364,168,438,98000,4758
317,268,49,589,105000,4760
172,131,41,775,202500,4761
200,161,39,363,122400,4762
304,243,61,606,85000,4763
13,11,2,-,108900,4764
461,355,106,552,103800,4765
157,131,26,700,99000,4766
178,158,20,663,161500,4768
4157,2352,1805,746,119600,4769
396,339,57,421,143500,4772
295,262,33,-,94700,4773
312,257,55,425,75300,4774
325,303,22,-,97600,4776
152,127,25,817,85300,4777
171,164,7,-,201000,4779
335,299,36,840,104400,4780
213,192,21,-,150000,4781
199,175,24,775,155900,4783
857,533,324,600,84700,4785
743,560,183,413,87000,4786
179,166,13,683,84600,4787
3367,2084,1283,834,173600,4841
2373,1745,628,994,346500,4843
665,600,65,973,239800,4847
329,312,17,917,241100,4848
1672,1471,201,1014,273400,4849
34,34,0,-,288900,4851
43,34,9,833,500000,4852
198,148,50,1057,380000,4853
696,535,161,1214,277500,4854
159,159,0,-,354400,4855
1364,1103,261,938,280900,4856
558,493,65,1125,263500,4858
371,315,56,1111,568500,4859
825,736,89,1423,230300,4860
1308,951,357,808,208000,4861
1718,1452,266,853,194300,4862
479,399,80,981,321300,4863
1557,1496,61,973,165200,4864
10942,6550,4392,814,147000,4901
862,672,190,855,135100,4910
806,629,177,758,88000,4911
282,245,37,471,67300,4912
4174,2896,1278,940,187800,4915
1308,1225,83,732,228200,4917
0,0,0,-,-,4918
840,611,229,715,83200,4920
664,544,120,779,133300,4921
412,356,56,648,131100,4922
232,221,11,613,140600,4923
920,739,181,820,136000,4924
11,11,0,-,468800,4925
10,10,0,-,-,4926
1462,1251,211,904,151000,4927
868,752,116,726,132500,4928
322,218,104,863,116200,4929
1954,1498,456,803,127000,4930
514,434,80,957,148800,4932
112,85,27,-,206500,4936
2891,2215,676,737,122100,4937
3771,2286,1485,799,162400,4938
394,338,56,833,103400,4939
0,0,0,-,-,4940
732,607,125,733,167800,4941
528,422,106,921,140400,4942
756,599,157,722,109700,4943
32,32,0,-,-,4944
580,479,101,604,138000,4945
790,705,85,917,220100,4947
335,312,23,442,202900,4949
1995,1518,477,883,112300,4950
475,402,73,883,145300,4951
796,670,126,928,165800,4952
1425,1092,333,748,161000,4953
571,536,35,825,146900,4955
275,239,36,663,112700,4956
1642,1304,338,815,158500,4957
832,768,64,675,129700,4958
397,363,34,-,104300,4961
3086,2730,356,873,173200,4963
84,80,4,-,330000,4964
817,660,157,1021,114000,4965
703,600,103,382,118500,4966
1503,995,508,614,117500,4967
462,395,67,850,147900,4969
733,558,175,654,228900,4970
767,677,90,855,146000,4971
546,471,75,730,218100,4973
1386,889,497,758,156000,4974
33,33,0,-,-,4975
4301,3013,1288,790,139600,4976
427,384,43,647,198900,4978
354,319,35,677,154100,4979
1223,1055,168,930,179200,4981
227,130,97,604,180200,4982
602,547,55,-,120800,4983
269,231,38,761,150500,4984
52,46,6,-,275000,4985
642,524,118,1011,122900,4986
404,366,38,1125,149700,4987
708,532,176,708,170500,4988
1963,1589,374,846,179700,4989
112,112,0,-,-,4992
4128,3010,1118,1016,236300,5001
0,0,0,-,-,5009
111,111,0,-,161700,5030
10,10,0,-,-,5031
1062,858,204,1295,199600,5032
1272,894,378,1029,188200,5033
98,42,56,-,227300,5034
321,292,29,1229,193800,5035
485,422,63,986,276100,5036
375,340,35,955,263300,5037
593,473,120,877,185100,5038
472,439,33,1141,193400,5039
281,250,31,1089,195500,5040
67,9,58,-,241700,5041
277,234,43,641,198800,5042
537,454,83,1194,262700,5043
776,647,129,1365,216700,5045
512,447,65,758,174200,5046
1176,978,198,945,251300,5048
55,23,32,-,222500,5050
521,394,127,1098,210000,5051
75,41,34,-,174400,5052
110,92,18,-,280400,5053
1220,909,311,956,457600,5055
145,112,33,1089,324300,5056
72,52,20,-,226500,5058
278,219,59,1444,289300,5059
2035,1541,494,940,207200,5060
580,475,105,1261,230000,5061
190,175,15,872,289700,5062
441,310,131,1116,212300,5065
71,65,6,-,462500,5067
1309,989,320,1157,192800,5068
271,255,16,-,194600,5069
181,141,40,1125,339400,5070
71,71,0,-,529800,5071
260,241,19,-,346600,5072
0,0,0,-,-,5073
480,436,44,1463,224400,5075
200,172,28,975,161900,5076
486,399,87,1023,247800,5077
384,348,36,892,160500,5079
254,176,78,894,157100,5081
83,59,24,821,46500,5083
28,28,0,-,659100,5084
223,193,30,853,160100,5086
465,408,57,-,235500,5088
2014,1404,610,946,185800,5089
1594,1257,337,1299,415100,5091
1799,1118,681,964,168300,5101
80,48,32,-,269200,5141
260,213,47,1180,185800,5142
1891,1510,381,934,221100,5143
224,204,20,923,275000,5146
577,486,91,1135,263500,5148
964,648,316,947,263000,5149
257,242,15,-,136200,5150
609,589,20,863,231900,5151
172,155,17,1063,348200,5152
271,213,58,925,271700,5153
243,86,157,906,197500,5154
330,224,106,928,267600,5155
3924,2807,1117,900,145500,5156
429,390,39,894,168200,5158
288,253,35,-,435700,5161
5984,3794,2190,947,177600,5201
1327,1126,201,1116,211300,5250
626,559,67,863,380800,5251
171,157,14,-,178800,5252
257,194,63,695,321600,5253
149,144,5,-,479200,5254
1815,1234,581,801,299300,5255
946,698,248,1050,231700,5257
167,167,0,-,186300,5260
820,725,95,821,161100,5261
755,674,81,845,230300,5262
7388,4521,2867,929,222600,5301
272,249,23,-,279000,5340
247,152,95,584,285600,5341
232,205,27,896,178200,5342
430,376,54,1086,233700,5343
0,0,0,-,-,5344
790,658,132,1351,221600,5345
1998,1616,382,996,242600,5346
314,261,53,343,214500,5350
149,140,9,-,268300,5351
351,331,20,883,244400,5352
569,452,117,1136,231600,5353
876,621,255,854,205300,5354
307,294,13,1078,240300,5355
323,258,65,960,269600,5356
141,122,19,1000,174100,5358
232,180,52,1069,251500,5359
119,97,22,-,291000,5360
371,321,50,642,214000,5361
130,110,20,1038,277300,5362
930,646,284,918,229700,5363
13031,3610,9421,1394,369900,5401
8651,5217,3434,1596,328500,5403
3628,1271,2357,1361,265500,5404
0,0,0,-,-,5405
4219,2998,1221,1191,301700,5408
0,0,0,-,-,5439
764,610,154,974,224500,5440
238,231,7,-,191600,5441
179,172,7,-,168200,5442
2691,2154,537,1106,267200,5443
590,480,110,1178,273800,5444
1717,1551,166,1303,535300,5445
6733,4757,1976,1235,288500,5446
39,30,9,-,113500,5447
344,330,14,-,211600,5448
1864,1528,336,881,223600,5450
9365,6266,3099,1352,324900,5452
2100,1662,438,1137,278100,5454
458,380,78,963,280900,5455
402,352,50,-,318200,5456
567,464,103,739,209000,5457
873,736,137,1112,325000,5458
609,508,101,-,207700,5459
2079,1653,426,1307,359400,5461
718,637,81,864,281000,5462
213,197,16,950,199600,5463
1131,818,313,1100,261800,5464
2236,2055,181,966,353000,5465
4814,4160,654,1344,274100,5468
407,320,87,-,188100,5471
811,675,136,1071,300800,5472
580,449,131,1419,348900,5473
528,510,18,1438,309000,5474
1219,804,415,1015,145800,5476
1943,1490,453,1031,344100,5477
6395,4328,2067,1156,244000,5478
0,0,0,-,-,5481
3180,2360,820,1325,417900,5482
545,497,48,1181,189200,5483
0,0,0,-,-,5485
581,483,98,1298,396000,5486
596,543,53,1131,222700,5487
2960,2433,527,1098,215000,5488
1408,1189,219,2013,340100,5489
2456,1812,644,1060,258100,5491
384,304,80,838,215700,5492
568,526,42,1288,320700,5494
4368,3505,863,1682,362500,5495
5734,3715,2019,1111,275200,5602
75,63,12,-,353300,5640
7371,4875,2496,904,190200,5641
462,398,64,909,191400,5647
211,171,40,1150,287900,5648
192,136,56,-,156600,5649
421,361,60,1583,270700,5650
551,507,44,611,272100,5651
326,252,74,1382,150700,5652
245,196,49,725,189700,5653
607,330,277,1060,157100,5654
1241,1095,146,947,185500,5655
1284,774,510,873,154500,5656
609,564,45,1528,184900,5658
733,657,76,1042,318600,5660
2699,1910,789,941,227100,5661
2211,1569,642,839,209300,5663
0,0,0,-,-,5664
18,14,4,-,555600,5666
962,748,214,1082,233700,5667
319,271,48,750,169500,5669
39,9,30,-,-,5670
2497,1808,689,1161,529100,5672
1129,857,272,1115,376100,5673
702,635,67,1051,380400,5674
418,401,17,-,164500,5675
2026,1374,652,1051,280500,5676
865,725,140,1229,362000,5677
34,34,0,-,106300,5678
1195,1042,153,1399,189800,5679
888,714,174,883,198900,5680
59,53,6,-,169200,5681
517,431,86,986,235300,5682
9378,5637,3741,822,165900,5701
153,135,18,-,247200,5730
0,0,0,-,-,5731
496,357,139,-,246100,5732
2505,2043,462,838,190800,5733
526,392,134,986,275000,5734
1349,1088,261,1078,169100,5735
239,152,87,889,164400,5736
242,209,33,833,208300,5737
468,427,41,1208,266200,5738
521,428,93,883,234000,5739
230,186,44,775,242200,5742
1549,1220,329,834,155500,5743
183,131,52,-,167200,5744
0,0,0,-,-,5746
139,112,27,950,170500,5747
234,135,99,842,160700,5748
311,261,50,1324,316100,5751
3610,2435,1175,1029,313000,5753
318,284,34,1182,197900,5757
243,221,22,1063,196700,5758
719,550,169,886,184500,5759
355,325,30,950,236900,5760
420,356,64,888,262500,5761
193,158,35,896,220000,5762
1225,1044,181,883,191400,5763
1060,832,228,749,171800,5764
668,564,104,955,168900,5765
243,207,36,1617,265800,5766
684,601,83,708,180100,5767
14,11,3,-,341700,5768
479,388,91,1149,292000,5769
442,355,87,986,248200,5770
368,327,41,933,226300,5772
887,702,185,853,210900,5773
388,308,80,944,170000,5774
237,181,56,880,201000,5775
146,117,29,786,214500,5776
1400,1137,263,888,163900,5777
327,219,108,1042,257800,5778
3868,2508,1360,830,165900,5819
156,143,13,-,178100,5820
363,328,35,914,202800,5821
810,653,157,775,150100,5822
512,445,67,910,141600,5824
31,24,7,-,120800,5825
311,272,39,1086,207900,5826
159,136,23,633,290900,5827
847,667,180,604,253700,5828
745,543,202,1002,181900,5829
635,486,149,840,158000,5830
403,387,16,-,256500,5832
18,14,4,-,220000,5833
543,503,40,696,164400,5836
160,142,18,1400,116700,5837
242,215,27,766,199000,5839
19,15,4,-,103100,5840
180,157,23,770,306900,5841
223,182,41,928,163800,5842
1005,830,175,635,121600,5843
528,477,51,911,202100,5845
625,397,228,736,114500,5846
326,270,56,859,122800,5847
56,37,19,-,-,5850
2495,1857,638,901,184100,5851
323,301,22,875,174800,5853
3279,2360,919,808,166800,5855
572,482,90,1125,196500,5857
138,126,12,-,94300,5858
877,749,128,1034,180600,5859
1140,890,250,821,149100,5860
160,131,29,-,196800,5862
301,249,52,878,132700,5866
271,227,44,957,204000,5867
35,35,0,-,-,5868
556,446,110,800,188000,5871
411,364,47,925,155300,5872
344,259,85,1125,191100,5873
215,181,34,864,188200,5874
199,196,3,-,192700,5875
9,9,0,-,-,5901
57,54,3,-,131000,5902
351,318,33,850,123900,5903
95,55,40,1039,80300,5904
414,376,38,967,215400,5905
527,464,63,888,141300,5906
56,50,6,-,121200,5907
7570,6338,1232,1497,380000,6001
8802,6051,2751,1596,220900,6002
24557,15706,8851,1154,207400,6010
3318,3072,246,1583,345700,6013
2730,2014,716,1540,274700,6016
1055,607,448,1031,201800,6018
4173,3363,810,1334,345700,6019
19,19,0,-,-,6020
598,554,44,1350,270300,6021
23,23,0,-,-,6022
693,620,73,-,305000,6023
189,180,9,-,218800,6024
1879,1483,396,1081,289200,6026
601,556,45,1393,284500,6027
6714,4703,2011,1537,288900,6029
630,525,105,1228,430100,6031
7790,5571,2219,1671,347300,6032
11930,9514,2416,1518,345100,6033
3158,2842,316,1321,288800,6035
7412,6161,1251,1301,289900,6037
729,516,213,1171,443800,6039
14830,7976,6854,1158,200800,6040
10122,5672,4450,1573,182600,6042
1868,1660,208,1099,277300,6043
12204,3698,8506,985,164400,6051
3329,1875,1454,1107,201200,6052
12782,6135,6647,1109,161600,6053
2510,2152,358,956,295600,6057
700,552,148,1042,331100,6058
17,17,0,-,-,6059
772,772,0,-,359600,6060
110,64,46,-,153100,6061
8004,5409,2595,1045,214700,6062
1220,1092,128,1353,282400,6063
237,237,0,-,275800,6065
13695,6814,6881,1211,218700,6066
8894,6087,2807,1579,275600,6067
674,497,177,1932,721000,6068
1171,787,384,1481,363000,6069
5813,4556,1257,1707,348500,6070
3400,2980,420,1177,332700,6071
0,0,0,-,-,6072
2148,1892,256,1610,436500,6073
9926,8452,1474,1595,291400,6074
5053,3934,1119,1039,210600,6076
3853,3326,527,1255,346300,6078
21,21,0,-,-,6079
0,0,0,-,-,6080
600,363,237,1219,221600,6081
16588,12771,3817,1304,198000,6082
5411,4785,626,1424,301100,6084
2898,2339,559,1127,330700,6085
2186,1624,562,1280,166300,6088
1285,802,483,1770,325700,6089
334,298,36,-,426000,6090
93,68,25,-,300000,6091
1412,1366,46,1741,415100,6092
1356,1323,33,1125,318300,6093
11278,9466,1812,1423,229600,6095
5357,4359,998,1155,207500,6096
4708,2826,1882,1031,197000,6098
1424,82,1342,1660,328600,6103
9685,1664,8021,960,332200,6105
14176,3773,10403,1055,165800,6106
7912,6556,1356,1653,385700,6107
9137,4128,5009,1097,173800,6108
11411,9135,2276,1071,266100,6109
5375,3447,1928,1345,227000,6110
12575,9799,2776,1352,237700,6111
7533,2927,4606,1078,166800,6112
9649,3076,6573,1103,192300,6114
5759,4579,1180,1852,369600,6117
10510,7374,3136,1144,171000,6118
6482,3178,3304,1377,311900,6119
4761,720,4041,1006,146800,6120
6752,2355,4397,944,151400,6226
1384,1302,82,1142,292600,6231
1178,1025,153,897,313500,6232
2833,2186,647,1073,227700,6234
878,764,114,965,210500,6235
2216,1878,338,782,276800,6237
4780,4263,517,1093,256300,6238
4483,2860,1623,1051,211000,6239
2684,2003,681,1165,217800,6241
517,408,109,850,265300,6242
57,57,0,-,450000,6243
966,855,111,1196,251300,6247
2219,1900,319,1532,313400,6248
2847,2569,278,1297,278500,6249
2168,1529,639,1557,236900,6250
705,583,122,739,249400,6254
1887,1328,559,884,238800,6255
919,826,93,-,147800,6256
0,0,0,-,-,6258
1762,1390,372,1053,312000,6259
3756,2291,1465,1029,197400,6260
414,350,64,-,173500,6262
83,15,68,971,-,6263
70,29,41,-,338900,6264
115,69,46,-,174500,6266
3977,1632,2345,1345,279700,6268
147,66,81,-,-,6269
1480,1363,117,1434,220800,6277
1824,1438,386,1050,268400,6278
2542,1558,984,1137,248300,6279
1374,752,622,1339,189300,6280
2939,2464,475,1061,301400,6281
487,440,47,-,265900,6282
11138,4272,6866,1091,189200,6320
1251,853,398,1227,220700,6330
2144,1782,362,751,253600,6331
448,271,177,1078,184600,6332
2723,2062,661,1550,365800,6333
902,741,161,1171,237600,6334
2197,1894,303,1864,243600,6335
19,19,0,-,340600,6336
31,30,1,-,-,6338
3497,2967,530,1221,242300,6339
12660,5297,7363,1332,211500,6340
58,58,0,-,175000,6350
6557,5099,1458,1090,233200,6351
140,115,25,-,-,6353
2211,1560,651,1070,224700,6354
5192,4284,908,1491,356100,6355
4847,3459,1388,1389,309400,6357
2106,1927,179,967,319100,6359
15611,8491,7120,1061,182300,6360
1806,1613,193,1406,279000,6365
2757,2486,271,1104,265600,6370
4016,3373,643,1446,420400,6371
60,51,9,-,-,6373
3172,2552,620,1043,197600,6374
1457,1306,151,1123,244400,6375
20,20,0,-,-,6376
1001,788,213,1469,213000,6377
2665,1977,688,1369,456100,6378
3850,2644,1206,1093,328700,6379
1264,428,836,981,146100,6380
3702,2897,805,1149,211500,6382
1086,824,262,965,264900,6384
6748,5234,1514,1390,269200,6385
163,54,109,935,182700,6387
48,48,0,-,-,6389
22,12,10,-,-,6390
8032,4617,3415,1175,224000,6401
2631,2267,364,1522,252100,6403
12686,8541,4145,1411,323900,6405
363,286,77,847,261900,6409
9900,8725,1175,1317,349700,6410
1548,1116,432,1345,352800,6412
5400,4619,781,1320,290400,6413
30,30,0,-,266700,6414
6333,5062,1271,1301,270400,6415
5742,4475,1267,1219,249300,6416
2061,1360,701,1197,290300,6417
5613,3828,1785,1202,212900,6418
2276,2191,85,1088,345500,6419
1695,1448,247,1438,323000,6420
3019,2808,211,1760,328000,6422
2223,2030,193,1344,328100,6423
4731,4142,589,1362,268800,6424
1621,1220,401,1215,587600,6426
8665,7309,1356,1568,409200,6437
986,813,173,-,331600,6438
15,15,0,-,-,6439
1995,1868,127,881,338900,6441
980,761,219,890,392500,6442
6719,6040,679,1617,438700,6443
72,72,0,-,213900,6444
2142,1936,206,1327,324800,6447
15112,9489,5623,1120,172100,6450
10079,5203,4876,1081,184700,6451
1187,1100,87,-,304500,6455
122,122,0,-,350000,6456
20084,10761,9323,1196,240700,6457
5,0,5,-,-,6459
15863,11261,4602,1670,324000,6460
5447,4929,518,1909,338200,6461
208,88,120,-,269900,6467
6274,5771,503,1408,385900,6468
1298,833,465,1121,269800,6469
5587,4912,675,1645,417500,6470
2977,2482,495,1504,295000,6471
2203,2000,203,1327,322600,6472
9642,7951,1691,1381,305500,6473
4584,3804,780,1537,395500,6475
5169,4625,544,1774,406100,6477
4781,4420,361,1122,380400,6478
4136,3613,523,1101,278100,6479
3564,2875,689,1177,247300,6480
608,396,212,"3,500+",268100,6481
4068,3806,262,1818,384500,6482
6432,4707,1725,1202,272500,6483
16204,12862,3342,1373,358900,6484
8029,6928,1101,1624,327800,6488
12722,10658,2064,1233,302100,6489
18289,13352,4937,1168,276400,6492
3494,2655,839,1238,373600,6498
2233,125,2108,1796,311300,6510
20507,3928,16579,1353,239000,6511
11316,7695,3621,1230,227100,6512
15064,5977,9087,1077,187000,6513
10170,6447,3723,1438,208500,6514
6524,2762,3762,1241,243600,6515
20341,10251,10090,1200,210900,6516
5922,3600,2322,1270,259700,6517
6304,3910,2394,1738,261600,6518
5252,1462,3790,1255,184700,6519
1768,1637,131,1505,405000,6524
3057,2687,370,1572,462300,6525
10183,3337,6846,1204,202900,6604
9233,2795,6438,1192,220000,6605
17125,9963,7162,1328,202500,6606
2685,924,1761,1257,180200,6607
4750,1186,3564,1264,166700,6608
8938,4386,4552,1121,170600,6610
12282,10809,1473,2063,417600,6611
2719,2276,443,2391,642400,6612
12842,11238,1604,1579,278300,6614
7345,4776,2569,1328,257500,6615
1791,91,1700,531,252600,6702
10726,4769,5957,1069,140400,6704
11200,4990,6210,1071,132400,6705
5423,2478,2945,999,121600,6706
12642,7050,5592,1139,153900,6708
3362,1252,2110,1001,166700,6710
3238,2974,264,1340,291800,6712
6173,5330,843,1451,259000,6716
532,329,203,645,273900,6750
1340,1031,309,892,330800,6751
728,637,91,2119,530300,6752
28,25,3,-,341700,6753
675,579,96,2156,378600,6754
337,307,30,-,322100,6755
1117,995,122,1805,344800,6756
929,660,269,-,355700,6757
21,21,0,-,345000,6758
2380,1959,421,1214,349200,6759
2906,2609,297,-,364400,6762
825,731,94,965,311800,6763
12212,8279,3933,1165,198000,6770
10297,8125,2172,1342,325300,6776
664,588,76,1545,399500,6777
493,467,26,968,261400,6778
3405,2432,973,1268,216800,6779
807,704,103,1335,235500,6782
939,730,209,1725,603900,6783
1566,1394,172,2109,468200,6784
314,299,15,-,629600,6785
3927,2894,1033,1036,209400,6786
3076,2404,672,958,218100,6787
14344,9725,4619,1010,157700,6790
2070,1936,134,1400,304800,6791
532,367,165,1715,885000,6793
387,250,137,1191,368500,6794
5330,4514,816,1119,274700,6795
431,390,41,1528,468200,6796
4501,3511,990,1360,390700,6798
7207,5646,1561,1350,359200,6801
6392,5515,877,1746,389100,6804
2713,1879,834,2053,1117400,6807
20216,9278,10938,1568,285000,6810
11910,9361,2549,1550,343800,6811
4503,4213,290,2025,367400,6812
6978,6004,974,3066,1475400,6820
11950,9999,1951,2157,705200,6824
7416,5968,1448,1757,471300,6825
9447,5165,4282,2020,1540500,6830
5247,3916,1331,2430,1305700,6831
6937,5639,1298,2477,1269400,6840
8013,4660,3353,1971,447200,6850
11440,7257,4183,1757,454700,6851
1468,1170,298,1987,1108100,6853
11076,5348,5728,1632,394900,6854
3548,1846,1702,1739,459900,6855
2673,2071,602,2271,1372000,6870
9159,7845,1314,1796,678900,6877
2634,2235,399,2338,1616400,6878
9522,8381,1141,1999,1125000,6880
3525,3418,107,"3,500+",839900,6883
1680,1479,201,2481,892800,6890
3307,2818,489,1375,564500,6896
6198,5562,636,2039,768400,6897
5053,679,4374,2012,426100,6901
26869,10760,16109,1936,461700,6902
5218,4767,451,"3,500+",756900,6903
8365,5438,2927,2167,558600,6905
3619,1849,1770,2002,480500,6906
3359,2231,1128,1697,467000,6907
5055,2779,2276,1515,288100,7001
27036,10642,16394,1394,359800,7002
19959,10223,9736,1517,359500,7003
2946,2507,439,2234,557100,7004
5606,3899,1707,1503,481300,7005
9816,7585,2231,1817,561900,7006
8231,4678,3553,1632,284000,7008
4791,3908,883,1315,514900,7009
10296,4890,5406,1586,470500,7010
13357,5918,7439,1467,342600,7011
5215,2818,2397,1498,377200,7012
11341,8046,3295,1537,389100,7013
1716,1236,480,1686,347800,7014
9029,7160,1869,1796,538900,7016
14597,4125,10472,1179,245600,7017
11407,2456,8951,1302,240100,7018
6788,2854,3934,2566,653000,7020
714,688,26,"3,500+",890200,7021
6127,2048,4079,1360,429600,7022
2670,2390,280,1869,498400,7023
18189,10550,7639,1982,356200,7024
11762,5291,6471,1399,372900,7026
1814,985,829,1638,409800,7027
2539,2387,152,1814,668400,7028
8771,2139,6632,1712,354700,7029
27932,9802,18130,2479,777600,7030
6660,3238,3422,1498,388100,7031
14294,6670,7624,1416,359800,7032
2755,1978,777,1758,384700,7033
4064,2396,1668,1339,341500,7034
4079,3116,963,1636,353500,7035
16300,9552,6748,1369,306000,7036
10452,9080,1372,2513,645800,7039
8264,6654,1610,1884,566300,7040
2668,1862,806,1801,846000,7041
10454,5557,4897,1827,553600,7042
4148,3536,612,2246,783200,7043
5714,4709,1005,1785,483400,7044
3629,3507,122,1947,613400,7045
1413,1318,95,-,818900,7046
23315,9579,13736,1475,385900,7047
12420,2720,9700,1242,268800,7050
16977,12201,4776,1655,417700,7052
11845,5930,5915,1491,479500,7054
20217,4308,15909,1246,347900,7055
4917,1846,3071,1338,396300,7057
2123,1475,648,2123,672000,7058
5500,4886,614,2030,782700,7059
15777,6203,9574,1332,288000,7060
4540,2677,1863,1401,287200,7062
4366,2607,1759,1474,282000,7063
1286,1126,160,1306,349600,7064
12158,6788,5370,1405,293300,7065
5902,4657,1245,1467,488500,7066
6249,5548,701,1750,381600,7067
2429,1922,507,2598,551900,7068
2327,2018,309,2269,704000,7069
6720,4120,2600,1589,497200,7070
9083,5223,3860,1488,424000,7071
2411,1477,934,1609,428800,7072
4356,1503,2853,1577,402800,7073
970,676,294,1096,373500,7074
3735,2367,1368,1775,454700,7075
8903,7384,1519,1722,568200,7076
1187,759,428,1398,321700,7077
4464,4006,458,"3,500+",1394000,7078
5680,3814,1866,1944,666900,7079
8144,6977,1167,1766,362200,7080
6534,4279,2255,1855,463900,7081
1980,1944,36,1650,522400,7082
19667,14863,4804,1770,352700,7083
7565,2449,5116,1938,739300,7086
25292,4807,20485,1334,382200,7087
1108,612,496,1540,285500,7088
10531,8437,2094,2008,809600,7090
2546,2142,404,2926,651100,7092
24973,6561,18412,1432,343800,7093
8000,4473,3527,2036,490700,7094
7748,4111,3637,1891,305400,7095
5835,487,5348,1026,329100,7102
12484,2804,9680,1107,217700,7103
19433,4996,14437,1174,306300,7104
18883,3631,15252,1367,374100,7105
12625,4127,8498,1088,246100,7106
14693,3893,10800,1130,275800,7107
11094,1815,9279,983,198200,7108
13536,7576,5960,1424,319600,7109
11711,7927,3784,1487,405100,7110
22208,6226,15982,1155,229500,7111
10549,2950,7599,1212,258000,7112
4268,767,3501,557,336100,7114
9394,2193,7201,1301,303800,7201
14261,3420,10841,1288,310400,7202
7915,4509,3406,1248,249700,7203
5204,3062,2142,1344,319400,7204
7191,5026,2165,1424,300200,7205
8504,2321,6183,1336,269000,7206
12195,3271,8924,1229,348900,7208
25272,6825,18447,2640,744600,7302
18673,5436,13237,1320,377600,7304
25335,10634,14701,1340,348800,7305
21825,5107,16718,1373,393700,7306
17009,5479,11530,1466,484900,7307
6624,712,5912,3042,730300,7310
916,0,916,3432,-,7311
2213,1695,518,2470,726900,7401
2896,1927,969,1803,326900,7403
6729,5229,1500,1413,461600,7405
7121,3881,3240,1769,376700,7407
11892,9409,2483,1864,447500,7410
2530,1687,843,1099,205600,7416
3847,3408,439,2861,1016000,7417
995,973,22,-,281300,7418
3949,3046,903,1557,253500,7419
1877,1372,505,1748,284200,7420
2819,2553,266,2135,305600,7421
2178,2021,157,1621,234200,7422
1444,1365,79,2773,815200,7423
10669,7277,3392,1484,385400,7424
9430,7448,1982,2053,509300,7430
2796,1810,986,1695,493300,7432
1035,844,191,2121,407700,7435
4223,3750,473,1745,475400,7436
4482,4009,473,1257,361200,7438
828,727,101,1571,235600,7439
1531,1347,184,-,450600,7440
4224,3199,1025,1479,338500,7442
4736,3917,819,2987,439300,7444
5300,4564,736,1751,606600,7446
8659,7108,1551,2200,789500,7450
3630,3358,272,1818,695300,7452
4200,4000,200,2077,370900,7456
1839,1282,557,2572,343000,7457
4000,3537,463,"3,500+",1081100,7458
1192,1079,113,2203,300500,7460
6728,5645,1083,1389,286500,7461
2871,2245,626,1473,211100,7462
3354,3030,324,1810,483200,7463
2374,1941,433,2106,343800,7465
19147,15022,4125,1902,498500,7470
5975,5312,663,1495,299300,7480
5749,5173,576,2127,803500,7481
12269,1901,10368,1210,258800,7501
4794,2523,2271,1353,279500,7502
6086,1884,4202,1350,271600,7503
3984,1357,2627,1373,320700,7504
1332,81,1251,951,263800,7505
7463,4923,2540,1580,419800,7506
8045,5058,2987,1531,365400,7508
3803,2922,881,1471,389300,7512
3182,982,2200,1450,286900,7513
6582,2004,4578,1273,235000,7514
7013,1324,5689,1254,194800,7522
4459,987,3472,1277,304600,7524
19995,7296,12699,1576,302200,7601
3102,2150,952,1506,349600,7603
4226,2884,1342,1589,448300,7604
3470,2273,1197,1639,546000,7605
869,404,465,1654,398700,7606
3755,2610,1145,1763,417200,7607
26,0,26,1639,-,7608
485,457,28,2188,"2,000,000+",7620
9146,6325,2821,1465,386900,7621
2791,2294,497,2308,697800,7624
3036,2526,510,2194,676400,7626
1656,1401,255,"3,500+",786500,7627
6626,4833,1793,1478,393600,7628
2537,2211,326,1966,556100,7630
11320,6070,5250,1573,410200,7631
1905,1573,332,"3,500+",1159200,7632
1737,1697,40,3188,612000,7640
1059,1006,53,"3,500+",696600,7641
3457,3114,343,1385,582200,7642
4353,1920,2433,1459,361800,7643
9235,3848,5387,1442,393500,7644
2920,2570,350,1894,657800,7645
6167,3992,2175,1471,442000,7646
1693,1419,274,1635,482500,7647
1921,1608,313,1935,615300,7648
2702,2428,274,1792,661900,7649
7142,2666,4476,1697,604500,7650
8354,6803,1551,2470,623900,7652
3246,2766,480,1716,609500,7656
4032,1909,2123,1718,457300,7657
4971,2594,2377,1444,388600,7660
4352,3342,1010,1715,549500,7661
2248,1790,458,1746,409100,7662
5245,3473,1772,1767,390900,7663
13122,10255,2867,1559,429300,7666
4981,3658,1323,2985,858900,7670
9689,7402,2287,1856,602800,7675
3410,3291,119,2036,564900,7676
2021,1826,195,-,845900,7677
11023,7265,3758,1739,441300,7701
1361,1182,179,3403,642300,7702
0,0,0,-,-,7703
2038,1922,116,2143,796500,7704
595,486,109,1484,756800,7711
17010,8365,8645,1338,451300,7712
3638,2485,1153,1460,478900,7716
868,578,290,1439,913700,7717
2393,2214,179,1633,406700,7718
9064,6590,2474,1512,516000,7719
1956,954,1002,1540,732400,7720
1439,800,639,1726,286900,7721
3510,3207,303,2148,765700,7722
259,140,119,1197,1066700,7723
9575,6625,2950,1421,394100,7724
16214,13976,2238,1620,485400,7726
2366,1984,382,1266,494300,7727
20651,15530,5121,1706,408600,7728
6300,5756,544,875,374000,7730
12958,11673,1285,1760,362400,7731
2559,1759,800,1503,341100,7732
6084,5491,593,2761,722200,7733
4952,2984,1968,1518,238000,7734
7954,6094,1860,1228,291200,7735
1508,1368,140,1336,349000,7737
2321,2114,207,809,591100,7738
2224,2101,123,"3,500+",709100,7739
12817,5366,7451,1485,394600,7740
5944,5709,235,2741,562200,7746
12839,9998,2841,1773,382800,7747
10067,8515,1552,1319,462400,7748
1479,1146,333,2055,847300,7750
7018,6437,581,2310,569600,7751
15843,10676,5167,1587,320200,7753
2037,1707,330,2142,478700,7755
1773,911,862,1270,771800,7756
2384,2158,226,2639,568500,7757
1589,1250,339,1189,357200,7758
3365,2872,493,1950,1067800,7760
4133,2730,1403,1595,682200,7762
2858,2112,746,1594,483300,7764
8299,3916,4383,1599,299200,7801
1387,1217,170,1821,317400,7803
0,0,0,-,-,7820
3438,3047,391,1497,339700,7821
352,352,0,-,400000,7822
3640,2388,1252,861,252600,7823
3459,3105,354,1283,348100,7825
2181,1866,315,1682,296600,7826
1613,1483,130,1163,249200,7827
5699,3172,2527,1302,365700,7828
2777,2676,101,1210,556000,7830
0,0,0,-,-,7831
1209,1087,122,1155,297000,7832
48,48,0,-,215800,7833
6880,5785,1095,1814,457100,7834
4458,2995,1463,1767,423700,7836
1274,1116,158,1722,335600,7838
12148,8483,3665,1318,315100,7840
10,10,0,-,-,7842
4391,3750,641,1398,251900,7843
54,12,42,978,-,7844
6,6,0,-,-,7846
791,622,169,1736,304600,7847
1662,1451,211,1309,363500,7848
3422,3007,415,1505,365300,7849
2494,1945,549,1625,326800,7850
153,135,18,-,275000,7851
1480,1235,245,1594,396600,7852
4306,4086,220,1958,483200,7853
1709,1137,572,2244,354200,7856
1793,972,821,1256,284500,7857
10152,8050,2102,1217,281000,7860
1510,1314,196,1291,230100,7863
895,739,156,1937,343100,7865
8274,6889,1385,1502,366600,7866
9118,6955,2163,1633,561700,7869
21,21,0,-,-,7870
7538,6756,782,1646,387600,7871
3091,2730,361,1742,266000,7874
3179,2966,213,2112,418300,7876
246,219,27,-,339700,7878
102,79,23,-,325700,7880
5,5,0,-,-,7881
5836,4009,1827,1169,257400,7882
4237,2770,1467,1769,310400,7885
8555,5810,2745,1979,839700,7901
10227,8482,1745,2141,666400,7920
3921,3123,798,2098,391900,7921
4089,3937,152,2283,640000,7922
2668,2342,326,1698,664300,7924
19,11,8,-,-,7926
1812,1073,739,2790,491700,7927
6614,5498,1116,2054,876400,7928
2955,2705,250,1585,665100,7930
1185,1027,158,2406,946800,7931
4351,3065,1286,2632,622800,7932
952,871,81,"3,500+",556200,7933
498,438,60,2068,703500,7934
135,119,16,-,753300,7935
3797,3560,237,2765,621600,7936
26,13,13,-,-,7939
5710,3663,2047,2003,748000,7940
3377,3081,296,1750,774800,7945
1038,994,44,-,642000,7946
7938,6087,1851,2302,497100,7950
18312,11319,6993,1994,615600,7960
0,0,0,-,-,7961
75,75,0,-,-,7970
4588,3797,791,1875,633400,7974
129,62,67,-,"2,000,000+",7976
212,108,104,1808,659100,7977
57,57,0,-,-,7979
913,647,266,1659,592400,7980
3809,3359,450,2311,540200,7981
284,229,55,1183,286300,8001
9052,6018,3034,1592,251700,8002
11143,9768,1375,1743,350700,8003
3838,3308,530,1445,212200,8004
10093,9019,1074,1608,276100,8005
214,199,15,-,743400,8006
2390,1360,1030,1102,184700,8007
3355,3100,255,1487,865300,8008
5391,4355,1036,1278,241400,8009
4202,2886,1316,1338,190500,8010
0,0,0,-,-,8011
15076,10170,4906,1331,222700,8012
124,124,0,-,171000,8014
7243,5967,1276,1174,171700,8015
12594,9369,3225,1150,254500,8016
375,328,47,2107,332300,8019
968,908,60,-,304800,8020
21033,10402,10631,1083,154000,8021
3815,3613,202,1660,333600,8022
119,48,71,1290,147700,8023
758,684,74,-,236500,8026
1978,1708,270,1201,189800,8027
7080,4537,2543,1386,222500,8028
2253,1575,678,612,171800,8029
5129,3402,1727,1299,135500,8030
4696,2935,1761,1046,174600,8031
96,96,0,-,145900,8032
6308,4662,1646,1209,471900,8033
7689,6130,1559,1463,260400,8034
3194,2461,733,1146,296400,8035
2474,2286,188,1000,365300,8036
8907,6668,2239,1225,245000,8037
163,82,81,1362,152900,8038
6,6,0,-,-,8039
402,393,9,-,439800,8041
31,18,13,-,310000,8042
11683,7563,4120,1511,341700,8043
1198,841,357,1021,171600,8045
10701,8463,2238,1652,182700,8046
4793,3610,1183,1495,342100,8048
2058,1488,570,1154,175500,8049
10646,9434,1212,1637,293000,8050
4298,3362,936,1421,204100,8051
8767,3983,4784,1328,195300,8052
18653,13591,5062,1679,311100,8053
18545,14262,4283,1718,281200,8054
10332,9175,1157,1441,371500,8055
1729,1680,49,-,361000,8056
7490,6365,1125,1231,491700,8057
2249,1429,820,1236,179600,8059
9312,6729,2583,1387,241300,8060
1265,1227,38,-,310000,8061
5701,5290,411,1267,383800,8062
1125,1005,120,1263,158800,8063
37,37,0,-,-,8064
3078,2268,810,1473,175400,8065
3761,2445,1316,978,135900,8066
569,481,88,1450,258500,8067
2832,1754,1078,1091,220300,8068
4995,2753,2242,1067,146600,8069
5127,3911,1216,1052,155300,8070
3742,2730,1012,1298,196800,8071
133,106,27,-,185700,8072
0,0,0,-,-,8073
32,32,0,-,-,8074
11748,7931,3817,1331,234000,8075
7200,6248,952,1751,290000,8077
3053,2097,956,1133,163800,8078
4112,2367,1745,952,163000,8079
14080,12540,1540,1488,272200,8080
17337,13875,3462,1312,211500,8081
3691,2929,762,1138,208100,8083
2598,1995,603,1027,184700,8084
7080,5762,1318,1696,290200,8085
3468,2361,1107,1544,212700,8086
10601,8928,1673,1565,258500,8087
9189,8744,445,2043,288600,8088
1363,1256,107,1091,193600,8089
3061,2773,288,798,208200,8090
2105,1493,612,1222,200800,8091
1141,946,195,1172,350300,8092
4218,2460,1758,1161,161000,8093
14952,12658,2294,1174,213900,8094
0,0,0,-,-,8095
13643,10064,3579,1213,201200,8096
1200,1064,136,1112,200000,8097
3493,2681,812,1086,275800,8098
3095,634,2461,998,84000,8102
4355,1737,2618,1040,83600,8103
8537,3064,5473,911,73200,8104
8411,3740,4671,1106,90100,8105
3835,2504,1331,982,235300,8106
5710,2935,2775,1164,205800,8107
8385,5397,2988,1408,290600,8108
8635,6288,2347,1082,183400,8109
6098,4428,1670,1158,150800,8110
4075,2684,1391,1486,198100,8201
789,767,22,1205,1290100,8202
3769,2749,1020,1337,374600,8203
7614,5948,1666,1090,304800,8204
11031,8767,2264,1430,201400,8205
7039,5743,1296,1326,267500,8210
79,79,0,-,889400,8212
5594,3852,1742,1114,228300,8215
0,0,0,-,-,8217
2621,2274,347,1799,287800,8221
1868,1641,227,1596,290000,8223
62,62,0,-,255000,8224
3084,2757,327,1413,224600,8225
5353,3764,1589,1332,594700,8226
2099,2035,64,-,331600,8230
6359,3007,3352,998,138200,8232
15773,13295,2478,1340,228300,8234
5,5,0,-,-,8240
450,428,22,1525,318500,8241
1782,1226,556,1220,277100,8242
1083,1006,77,1589,794800,8243
4635,2343,2292,1178,229400,8244
0,0,0,-,-,8245
26,26,0,-,-,8246
553,502,51,1300,1542300,8247
76,76,0,-,937500,8248
4658,3810,848,1453,203900,8251
6145,3968,2177,1081,363800,8260
3101,2480,621,1091,263600,8270
13716,8251,5465,1180,167100,8302
567,416,151,982,150500,8310
544,472,72,1134,153800,8311
2921,2205,716,1150,211000,8312
180,167,13,-,163500,8314
85,53,32,-,130900,8316
571,441,130,-,254200,8317
4482,3743,739,1156,225500,8318
451,445,6,-,261100,8319
0,0,0,-,-,8320
70,50,20,-,210000,8321
3418,3023,395,1370,217200,8322
223,188,35,1023,219600,8323
100,57,43,-,184900,8324
443,315,128,1669,168900,8326
192,151,41,-,130100,8327
634,547,87,-,188800,8328
103,89,14,-,279300,8329
11503,8627,2876,1466,202900,8330
14571,9960,4611,1035,167200,8332
386,305,81,985,238200,8340
846,350,496,940,168600,8341
1572,1452,120,1686,293600,8343
1930,1821,109,1461,173600,8344
292,268,24,1328,158800,8345
194,194,0,-,201200,8346
22,15,7,-,-,8348
837,543,294,1347,120000,8349
150,150,0,-,212900,8350
115,63,52,1683,153300,8352
120,84,36,983,165300,8353
15543,9741,5802,1119,163100,8360
6520,5193,1327,1250,226100,8361
16176,4520,11656,963,151000,8401
2651,2288,363,1337,508200,8402
482,395,87,1912,782800,8403
4243,2744,1499,1420,265000,8406
2476,2247,229,1371,460200,8501
3717,3102,615,2196,637100,8502
6831,4888,1943,1368,297700,8505
1738,1592,146,2225,601300,8510
339,207,132,983,282500,8511
4406,2754,1652,1445,508300,8512
1976,1774,202,1220,431800,8514
2272,2136,136,1942,461400,8515
2214,1387,827,1080,248100,8518
10362,7339,3023,1444,305100,8520
1828,1517,311,1781,471100,8525
20567,17689,2878,1573,381900,8527
187,187,0,-,232900,8528
3291,2353,938,1547,455800,8530
2431,1925,506,1286,361500,8533
4574,3834,740,1813,478100,8534
1669,1518,151,2241,590900,8535
8168,3636,4532,1714,564800,8536
17695,11568,6127,1931,661500,8540
1007,386,621,2058,452900,8542
0,0,0,-,-,8544
7310,5677,1633,2291,645800,8550
1975,1796,179,2167,500400,8551
280,241,39,1500,510200,8553
1646,1341,305,1416,167800,8554
339,279,60,2138,316500,8555
2610,2191,419,1496,692300,8558
2253,1941,312,1853,525200,8559
1483,1366,117,2239,385000,8560
144,77,67,-,336500,8561
1476,1119,357,1020,210300,8562
505,31,474,715,-,8608
4364,1339,3025,1118,75000,8609
11675,7774,3901,1329,206300,8610
10269,3925,6344,1186,105100,8611
13691,5607,8084,1069,171100,8618
9103,6416,2687,1469,267000,8619
4152,3409,743,1173,285100,8620
4092,2515,1577,1377,289200,8628
4208,2874,1334,1205,107700,8629
8723,5055,3668,1302,181400,8638
866,2,864,2122,-,8640
1432,0,1432,2188,-,8641
11480,7921,3559,1773,343200,8648
7857,6547,1310,1420,305400,8690
6635,5452,1183,1792,417000,8691
30408,15475,14933,1534,356000,8701
215,166,49,-,556500,8720
7862,6655,1207,1512,293500,8721
3916,3564,352,1710,243900,8722
12649,9783,2866,1492,317900,8723
15927,13143,2784,1677,302700,8724
1805,1701,104,2389,666600,8730
8504,7209,1295,1887,296200,8731
664,598,66,1742,429500,8732
1037,647,390,1488,194200,8733
2532,2383,149,-,319600,8734
2156,1844,312,1509,692200,8735
5297,4701,596,1412,690000,8736
634,578,56,1833,1226900,8738
757,566,191,1773,268300,8740
1051,972,79,1224,352200,8741
10376,8169,2207,1709,441300,8742
1475,1315,160,-,874000,8750
1928,1168,760,1186,450900,8751
1335,1095,240,1428,653400,8752
24947,19889,5058,1526,311100,8753
10299,8387,1912,1423,298300,8755
17702,15032,2670,1505,195800,8757
3303,2973,330,1539,357800,8758
19912,17267,2645,1148,135400,8759
2530,2125,405,1900,451300,8801
1461,1361,100,2052,377900,8802
1138,895,243,-,365600,8804
5128,2564,2564,1567,320000,8805
13740,11324,2416,1776,488900,8807
2231,1729,502,1543,371100,8809
2761,2460,301,1869,408900,8810
4544,3509,1035,1541,341500,8812
16472,13519,2953,1743,413200,8816
16234,9024,7210,1765,344400,8817
13310,10020,3290,1775,520800,8820
165,165,0,-,433700,8821
11462,8966,2496,1479,441900,8822
3476,2410,1066,1962,264100,8823
4503,3949,554,2013,506500,8824
1917,1537,380,1420,410500,8825
2181,1878,303,1362,352400,8826
1561,1404,157,748,378800,8827
991,723,268,1719,254900,8828
1427,1102,325,1425,267600,8829
6410,4554,1856,1880,328400,8830
22751,20309,2442,1603,391500,8831
976,218,758,1563,317100,8832
3516,3031,485,1693,488300,8833
4380,3287,1093,1487,266800,8835
1336,1295,41,1694,661600,8836
6874,3445,3429,1575,343300,8837
6083,4723,1360,1840,435000,8840
15293,12845,2448,1960,458100,8844
5459,4063,1396,1574,333200,8846
2993,2767,226,1453,341000,8848
3043,2505,538,1741,353200,8850
7141,4855,2286,1752,425400,8852
1913,1615,298,1603,582100,8853
16954,11153,5801,1764,353600,8854
15753,10419,5334,1340,376100,8857
0,0,0,-,-,8858
8837,5303,3534,1419,342200,8859
19135,6497,12638,1442,281600,8861
4349,3082,1267,1724,327800,8863
12885,8604,4281,1104,199400,8865
1892,1770,122,1185,500000,8867
3119,1744,1375,1717,369400,8869
7501,4443,3058,1337,324200,8872
20794,14225,6569,1767,358300,8873
8926,5925,3001,1515,397300,8876
9004,5298,3706,1473,317100,8879
1778,992,786,1623,275900,8880
5658,3753,1905,1416,322200,8882
3143,2585,558,973,317100,8884
2519,2119,400,1734,353700,8886
584,376,208,1477,218000,8887
4242,3768,474,1564,448800,8889
7,0,7,-,-,8890
15464,3059,12405,1597,265700,8901
15488,8805,6683,1799,352700,8902
6502,2666,3836,1611,377100,8904
14273,3780,10493,2269,467800,10001
34737,5850,28887,1047,719500,10002
25181,9245,15936,2478,972900,10003
2113,864,1249,"3,500+",1722600,10004
4782,795,3987,"3,500+",1237900,10005
1991,348,1643,3398,931900,10006
3246,1018,2228,"3,500+","2,000,000+",10007
29407,2765,26642,1740,626300,10009
16207,4884,11323,2513,1028800,10010
29222,11017,18205,2301,1042400,10011
11964,2359,9605,2406,"2,000,000+",10012
12334,3557,8777,1951,"2,000,000+",10013
17685,5242,12443,2587,1266100,10014
30115,8458,21657,2793,883100,10016
9471,3010,6461,2606,801800,10017
4535,633,3902,3291,667700,10018
26403,6016,20387,2128,907400,10019
0,0,0,-,-,10020
21312,9695,11617,2437,1593100,10021
18294,8989,9305,2519,1051500,10022
35480,13520,21960,2399,1337600,10023
29475,11266,18209,2543,1641100,10024
41418,13365,28053,1690,1043600,10025
15034,3077,11957,1415,988900,10026
23638,3249,20389,1353,798600,10027
24790,8538,16252,2570,1405100,10028
33024,2358,30666,1038,612400,10029
13111,1915,11196,1106,719300,10030
21473,2819,18654,1620,562100,10031
21959,2104,19855,1375,501900,10032
20079,2728,17351,1541,626200,10033
15763,1464,14299,1469,425200,10034
14350,1389,12961,971,634500,10035
18598,1655,16943,2196,1173700,10036
9922,617,9305,1350,-,10037
10494,2999,7495,2637,797800,10038
11550,1817,9733,1064,528100,10039
16502,2136,14366,1499,416100,10040
4914,1128,3786,2810,951500,10044
16112,5056,11056,2560,1284300,10065
2651,891,1760,2790,1740000,10069
12227,5488,6739,2233,1005300,10075
0,0,0,-,-,10103
0,0,0,-,-,10110
0,0,0,-,-,10111
0,0,0,-,-,10112
0,0,0,-,-,10115
0,0,0,-,-,10119
29351,9293,20058,2335,1175400,10128
0,0,0,-,-,10152
0,0,0,-,-,10153
0,0,0,-,-,10154
1208,0,1208,3068,-,10162
0,0,0,-,-,10165
0,0,0,-,-,10167
0,0,0,-,-,10168
0,0,0,-,-,10169
0,0,0,-,-,10170
0,0,0,-,-,10171
0,0,0,-,-,10172
0,0,0,-,-,10173
0,0,0,-,-,10174
0,0,0,-,-,10177
0,0,0,-,-,10199
0,0,0,-,-,10271
0,0,0,-,-,10278
56,0,56,-,-,10279
4208,1303,2905,"3,500+",885000,10280
2581,246,2335,"3,500+","2,000,000+",10282
14308,6543,7765,1494,563300,10301
5597,3190,2407,1576,452500,10302
8387,5193,3194,1164,382500,10303
15160,7344,7816,1234,561200,10304
15969,10532,5437,1421,544000,10305
19820,14164,5656,1439,586400,10306
5146,4032,1114,1388,763300,10307
10488,8217,2271,1660,591100,10308
12114,9919,2195,1663,625800,10309
9070,5590,3480,1433,559700,10310
0,0,0,-,-,10311
21708,17870,3838,1590,603000,10312
31761,23841,7920,1503,586200,10314
20434,2872,17562,1136,186500,10451
27940,759,27181,1241,375600,10452
27864,1385,26479,1269,518200,10453
14259,657,13602,908,633500,10454
15673,1426,14247,1092,328500,10455
31718,1788,29930,1116,390100,10456
25682,1560,24122,1254,370000,10457
29090,993,28097,1375,432500,10458
17453,2126,15327,1173,478300,10459
21480,2308,19172,1191,491800,10460
19084,6433,12651,1532,528000,10461
29843,6637,23206,1522,400200,10462
30201,9946,20255,1474,319000,10463
1958,1313,645,1641,535000,10464
16211,9147,7064,1567,538700,10465
25014,9941,15073,1383,495900,10466
38175,5282,32893,1403,337600,10467
27795,2210,25585,1392,240900,10468
23517,11709,11808,1567,518300,10469
6412,2317,4095,1521,505600,10470
9015,4845,4170,1619,360900,10471
21876,3371,18505,1312,550300,10472
22362,6590,15772,1010,468500,10473
3649,328,3321,1148,423800,10474
18608,7673,10935,1095,32100,10475
495,456,39,-,728400,10501
1882,1542,340,"3,500+",694700,10502
50,50,0,-,576400,10503
2753,2504,249,2625,1035600,10504
411,237,174,1344,674200,10505
2033,1933,100,3270,932000,10506
1984,1080,904,1821,587800,10507
7126,5648,1478,1679,368200,10509
3776,3069,707,1980,743200,10510
742,615,127,1630,390900,10511
9213,7605,1608,1359,344900,10512
4327,3987,340,2650,906000,10514
2283,1714,569,1608,536300,10516
162,97,65,1475,460300,10517
376,348,28,-,555300,10518
59,21,38,-,-,10519
5110,3425,1685,1617,592200,10520
3812,2281,1531,2014,646300,10522
3235,1638,1597,2650,446300,10523
1478,1324,154,1615,452200,10524
662,583,79,1873,575300,10526
185,166,19,-,632000,10527
4622,2485,2137,2275,799600,10528
6395,5344,1051,1874,423800,10530
1782,1549,233,3011,612200,10532
2362,1847,515,1968,830600,10533
136,83,53,-,356900,10535
3542,3117,425,2750,723200,10536
875,681,194,1391,250500,10537
5995,4849,1146,1873,1021600,10538
0,0,0,-,-,10540
8869,7668,1201,1527,393200,10541
0,0,0,-,-,10542
7155,4472,2683,1891,649800,10543
0,0,0,-,-,10545
411,362,49,3288,812900,10546
2682,1704,978,1746,408300,10547
1219,1011,208,1474,368200,10548
5930,4269,1661,1661,581400,10549
15504,3713,11791,1316,372100,10550
9841,5743,4098,1646,370000,10552
3632,1942,1690,1579,398600,10553
1761,1476,285,2009,592100,10560
12342,7366,4976,1825,419600,10562
10404,5782,4622,1700,308300,10566
6623,6040,583,2141,437700,10567
4072,3482,590,1818,762800,10570
13197,7092,6105,1868,579800,10573
1740,1627,113,"3,500+",884300,10576
731,685,46,"3,500+",1214600,10577
498,498,0,-,565100,10578
2976,2763,213,2060,412600,10579
6246,4571,1675,2605,1580100,10580
14143,12036,2107,2132,985300,10583
1248,731,517,1568,394200,10588
3502,3057,445,3091,455700,10589
2542,2308,234,2375,584900,10590
9397,4708,4689,1705,613400,10591
1632,1422,210,1970,646100,10594
2360,1628,732,1675,632300,10595
399,191,208,1650,410000,10596
242,242,0,-,942100,10597
10362,9225,1137,2006,478100,10598
5353,2121,3232,1793,359800,10601
7307,4484,2823,1750,457000,10603
3893,2209,1684,1997,703000,10604
7834,5714,2120,1855,656300,10605
5712,2390,3322,2154,582900,10606
2207,1680,527,1496,564900,10607
25954,7342,18612,1535,358900,10701
7995,4177,3818,1352,380600,10703
12533,7641,4892,1678,445300,10704
15161,5282,9879,1509,424700,10705
3265,2603,662,1975,731700,10706
3996,2301,1695,1708,593300,10707
9564,7099,2465,1875,488300,10708
3735,2850,885,1887,696800,10709
10077,6925,3152,1535,459600,10710
15122,6662,8460,1626,482600,10801
4235,3479,756,1886,805200,10803
5173,4916,257,2006,781000,10804
8075,3483,4592,1700,389900,10805
9093,6561,2532,1661,418500,10901
0,0,0,-,-,10910
6,0,6,-,-,10911
1484,1425,59,1824,532600,10913
106,106,0,-,274700,10914
32,32,0,-,-,10915
1376,1294,82,787,374600,10916
455,400,55,-,370100,10917
4389,3519,870,1486,338200,10918
462,442,20,-,335700,10919
2868,2474,394,1676,454500,10920
1368,1055,313,1774,312800,10921
407,210,197,1372,286400,10922
2714,1945,769,1699,369900,10923
4442,3389,1053,1356,347200,10924
1597,1202,395,1205,282100,10925
1478,865,613,1743,245200,10926
3714,1774,1940,1569,289100,10927
1984,1094,890,1496,253900,10928
3418,3101,317,1746,355400,10930
324,186,138,1808,349400,10931
14,14,0,-,-,10932
87,52,35,-,292300,10933
18576,11694,6882,1461,226600,10940
5324,3435,1889,1446,260400,10941
14828,9589,5239,1433,369200,10950
10556,4466,6090,1487,678100,10952
0,0,0,-,-,10953
9266,6719,2547,1982,414900,10954
9646,8795,851,1642,539400,10956
990,865,125,1708,293600,10958
5853,2908,2945,2062,578100,10960
1684,1433,251,1245,545600,10962
1229,884,345,850,258100,10963
533,493,40,-,626700,10964
5506,4173,1333,1708,464400,10965
1231,775,456,1995,565900,10968
381,373,8,-,344000,10969
3948,2849,1099,1421,402700,10970
774,646,128,1778,300000,10973
1252,1062,190,1863,370300,10974
44,34,10,-,150000,10975
602,354,248,845,495400,10976
16454,7683,8771,1504,490600,10977
0,0,0,-,-,10979
4701,4029,672,1573,385500,10980
1890,1721,169,1889,485700,10983
891,831,60,-,435200,10984
82,82,0,-,255400,10985
539,489,50,2188,523200,10986
1471,1226,245,1378,553600,10987
237,146,91,1223,250000,10988
3437,3049,388,2190,417400,10989
7958,6248,1710,1192,369100,10990
3070,2521,549,1192,293100,10992
1562,973,589,1426,259100,10993
2416,2401,15,-,517600,10994
860,0,860,3157,-,10996
1158,965,193,1253,381300,10998
8688,7292,1396,1928,610600,11001
12279,9932,2347,2042,452600,11003
5302,3673,1629,1743,555100,11004
1452,1356,96,2147,654400,11005
8247,7007,1240,1822,574900,11010
1795,1527,268,2141,1043000,11020
8071,5504,2567,1923,694100,11021
3018,2499,519,1334,984600,11023
2093,1708,385,1990,1572800,11024
5788,5333,455,2319,1575100,11030
13387,11611,1776,2207,678000,11040
0,0,0,-,-,11042
11584,7935,3649,2326,871200,11050
2464,1135,1329,1623,459400,11096
15764,2447,13317,2221,968400,11101
12265,1794,10471,1995,768900,11102
15515,2518,12997,1868,915200,11103
11864,2661,9203,1764,499600,11104
15352,4235,11117,1997,934500,11105
18225,3403,14822,1768,606400,11106
3109,757,2352,"3,500+",488300,11109
31084,10956,20128,2838,994100,11201
29002,11643,17359,1397,542800,11203
25207,9420,15787,1569,966100,11204
16926,5018,11908,1835,809100,11205
31256,3374,27882,1293,807200,11206
33996,9137,24859,1386,548100,11207
33551,9066,24485,1436,549400,11208
30150,11558,18592,1682,823100,11209
21720,9730,11990,1552,722700,11210
26082,4057,22025,2143,1005200,11211
31594,4332,27262,1016,459500,11212
26098,4329,21769,1404,916800,11213
31716,11119,20597,1573,831100,11214
29395,12229,17166,2446,1437900,11215
26106,6359,19747,1825,1196800,11216
18052,5153,12899,2390,1432200,11217
26140,10552,15588,1733,828600,11218
24000,6406,17594,1470,959400,11219
27487,7715,19772,1514,852900,11220
33851,7255,26596,1717,1000200,11221
18636,3376,15260,2274,1180900,11222
27484,10299,17185,1474,927200,11223
19218,6033,13185,874,474500,11224
24609,4705,19904,1595,1064300,11225
37128,4889,32239,1530,686400,11226
15485,8476,7009,1616,990400,11228
31057,15334,15723,1482,702700,11229
31670,9683,21987,1572,789400,11230
16738,5316,11422,2158,1535000,11231
9207,2271,6936,1806,809300,11232
32147,7821,24326,1349,951400,11233
32645,22047,10598,1616,641600,11234
34712,13216,21496,1457,616000,11235
33728,16410,17318,1516,600500,11236
17515,1877,15638,1843,906000,11237
26009,7634,18375,2113,1022000,11238
7845,647,7198,832,477600,11239
15811,2812,12999,2455,1178900,11249
20400,7909,12491,1602,524700,11354
29217,8737,20480,1525,640800,11355
8104,4013,4091,1895,731800,11356
15456,11491,3965,1947,819700,11357
13190,7787,5403,1849,858400,11358
0,0,0,-,-,11359
8822,6435,2387,2116,607200,11360
10842,6709,4133,2134,789000,11361
7279,5593,1686,2172,512400,11362
2908,2154,754,2187,843000,11363
13797,9673,4124,2008,666900,11364
16167,7677,8490,1626,797600,11365
4619,3284,1335,1741,832300,11366
14568,6834,7734,1442,540300,11367
29550,5917,23633,1758,650900,11368
9551,5731,3820,1797,627700,11369
7823,4107,3716,1843,764000,11370
0,0,0,-,-,11371
25164,8670,16494,1617,383800,11372
31438,9194,22244,1727,603100,11373
19938,8065,11873,1832,441400,11374
33099,17435,15664,1885,494600,11375
32419,10026,22393,1609,578400,11377
12885,6931,5954,1753,710700,11378
13887,8137,5750,1781,773200,11379
37050,11308,25742,1697,715100,11385
6509,5559,950,1498,485800,11411
11500,8812,2688,1508,509400,11412
12983,9656,3327,1825,529100,11413
11516,8696,2820,1748,544400,11414
8546,3410,5136,1717,310200,11415
7372,3494,3878,1687,621300,11416
9347,5664,3683,1742,614700,11417
11609,5609,6000,1631,625400,11418
12856,7918,4938,1748,600300,11419
13555,9498,4057,1833,591800,11420
11676,6032,5644,1819,598400,11421
10191,6973,3218,2009,514400,11422
10007,5846,4161,1501,605800,11423
0,0,0,-,-,11424
6256,4518,1738,1870,595800,11426
7970,5076,2894,1570,594800,11427
6298,4721,1577,1618,593500,11428
7974,5762,2212,1410,518000,11429
0,0,0,-,-,11430
19783,7626,12157,1667,675700,11432
10822,4998,5824,1320,491300,11433
22264,10899,11365,1225,469000,11434
19075,6969,12106,1660,446900,11435
5852,4030,1822,1781,488900,11436
0,0,0,-,-,11439
0,0,0,-,-,11451
8361,5474,2887,1975,564600,11501
2277,2225,52,-,704800,11507
730,669,61,2639,832800,11509
10901,9703,1198,1759,452200,11510
1682,1220,462,2018,587400,11514
2725,1850,875,1877,682800,11516
4050,3049,1001,1897,503100,11518
14611,9997,4614,1716,389000,11520
9521,8516,1005,3431,835500,11530
10877,6262,4615,1904,535800,11542
4325,3838,487,1794,879800,11545
202,162,40,-,726200,11547
340,238,102,3266,674600,11548
0,0,0,-,-,11549
17544,8201,9343,1584,362100,11550
7304,6605,699,2130,487200,11552
6850,5138,1712,1770,389500,11553
11808,10395,1413,2618,505400,11554
0,0,0,-,-,11556
2701,2372,329,2673,659800,11557
2917,1963,954,1903,505900,11558
2389,1929,460,1938,974600,11559
2384,2012,372,2142,818800,11560
15771,9895,5876,2234,587600,11561
7765,5917,1848,1889,520100,11563
3209,3052,157,1818,529400,11565
11534,11051,483,2383,588900,11566
1022,940,82,-,"2,000,000+",11568
577,462,115,"3,500+",827300,11569
10740,7897,2843,1693,673900,11570
10306,9281,1025,1744,540500,11572
4334,3111,1223,2195,354400,11575
4526,4051,475,2004,1079600,11576
4136,3739,397,1625,864100,11577
1834,1549,285,2121,743400,11579
13353,11411,1942,1705,473700,11580
7021,5768,1253,1848,539200,11581
14677,11637,3040,2194,515400,11590
3474,2876,598,1839,677900,11596
3933,3420,513,2290,849000,11598
21572,5613,15959,1348,559100,11691
8035,2766,5269,1267,487600,11692
5257,2424,2833,1040,404500,11693
8392,4500,3892,1557,724200,11694
1403,1359,44,950,610900,11697
9162,6045,3117,1804,388400,11701
5494,4565,929,2204,493000,11702
5518,4631,887,1872,387100,11703
12972,9668,3304,1984,390100,11704
3027,2540,487,1724,497400,11705
18882,14200,4682,1713,370000,11706
2732,2352,380,1924,591400,11709
11362,10173,1189,2097,552800,11710
3256,2195,1061,2436,369900,11713
7926,7117,809,2244,505400,11714
1595,1338,257,1841,464200,11715
3545,2817,728,2167,424600,11716
14754,11914,2840,1387,351000,11717
1023,971,52,1950,576000,11718
1149,904,245,1333,480000,11719
8948,7459,1489,2116,377100,11720
2315,2222,93,3121,678000,11721
9436,7008,2428,1838,319600,11722
946,919,27,-,1306900,11724
9220,8539,681,2035,554000,11725
6034,4637,1397,1725,347500,11726
10906,7330,3576,2206,325900,11727
8562,7282,1280,1674,408800,11729
4854,3987,867,2291,456700,11730
10667,9699,968,2036,534100,11731
1547,976,571,2566,664100,11732
5911,5103,808,2368,548900,11733
11175,8968,2207,1842,451300,11735
5346,4431,915,2523,381800,11738
572,559,13,-,656900,11739
3353,2698,655,1502,564700,11740
9023,7073,1950,2087,415700,11741
4514,3754,760,2049,381600,11742
15300,13572,1728,1976,652800,11743
21544,18327,3217,1978,531800,11746
7425,6323,1102,2663,678200,11747
1151,1105,46,-,351800,11749
5212,4529,683,1953,398300,11751
3029,2503,526,2280,381100,11752
4155,3582,573,2434,855600,11753
6691,5630,1061,1716,471300,11754
4052,3361,691,1905,460500,11755
14088,13226,862,2229,441800,11756
14401,12256,2145,1812,384800,11757
19159,17573,1586,2157,527900,11758
7737,7599,138,2508,545000,11762
9540,8426,1114,2008,352700,11763
4240,3545,695,1205,453700,11764
244,220,24,2417,"2,000,000+",11765
3888,3768,120,-,482500,11766
4729,4215,514,2071,492100,11767
7882,7136,746,2128,676000,11768
3210,2605,605,2066,460700,11769
52,45,7,-,581500,11770
3699,2752,947,1771,823400,11771
16989,12068,4921,1743,360100,11772
7830,6112,1718,1998,389600,11776
3456,2661,795,2054,589500,11777
4449,4061,388,1616,337500,11778
12882,9611,3271,1772,378200,11779
5602,5029,573,1853,587000,11780
5422,4073,1349,1958,491900,11782
7094,6756,338,2401,524500,11783
8209,7080,1129,1900,353300,11784
1977,1840,137,2375,451600,11786
11920,10555,1365,1865,549400,11787
5443,4538,905,2347,531500,11788
2655,2300,355,2284,324400,11789
4391,3923,468,2451,492300,11790
8170,7600,570,-,731000,11791
3156,3024,132,2791,464300,11792
10407,9952,455,2006,517700,11793
0,0,0,-,-,11794
8107,7791,316,2007,467800,11795
1351,1087,264,2037,443200,11796
3030,2671,359,3038,844100,11797
4871,3473,1398,1771,350100,11798
12915,11296,1619,2345,501400,11801
10344,9467,877,2175,629300,11803
1464,1348,116,-,636900,11804
11065,7609,3456,1726,360000,11901
366,335,31,-,1690700,11930
0,0,0,-,-,11931
431,371,60,-,1553600,11932
3038,2674,364,2035,355500,11933
2721,2390,331,2255,451000,11934
1224,1120,104,2106,627800,11935
8328,6742,1586,2331,871600,11937
629,525,104,2089,731600,11939
1850,1404,446,1982,473100,11940
820,748,72,-,521200,11941
2183,1931,252,1958,653000,11942
2207,1519,688,1824,622700,11944
6312,4577,1735,1998,582500,11946
0,0,0,-,-,11947
255,255,0,-,598200,11948
4799,3924,875,1887,443800,11949
4759,3839,920,2024,282700,11950
4718,3760,958,1826,244400,11951
2201,2104,97,1428,585800,11952
5708,3966,1742,1795,306900,11953
1571,1310,261,2143,995400,11954
1470,675,795,1779,358100,11955
148,124,24,1313,867300,11956
521,477,44,1917,859300,11957
310,236,74,-,772200,11958
235,215,20,-,1529600,11959
445,431,14,-,921700,11960
5676,4811,865,1707,307800,11961
127,121,6,-,"2,000,000+",11962
3318,2670,648,2289,950300,11963
1366,1298,68,-,871700,11964
417,341,76,-,906900,11965
8195,7362,833,2137,301500,11967
5193,4310,883,2005,1102600,11968
282,228,54,-,695200,11970
2745,2302,443,1819,631000,11971
272,170,102,-,398100,11972
0,0,0,-,-,11973
189,180,9,-,"2,000,000+",11975
938,854,84,2681,1664500,11976
1049,966,83,1865,868900,11977
1442,1120,322,1940,758000,11978
2060,1535,525,2249,337200,11980
127,111,16,-,219000,12007
181,174,7,-,207900,12008
3154,2504,650,1086,274400,12009
11049,7034,4015,824,136000,12010
1282,1086,196,986,215200,12015
218,212,6,-,124500,12017
3014,2507,507,1189,258300,12018
6275,4996,1279,1163,318700,12019
14242,10476,3766,1394,254500,12020
340,276,64,950,162100,12022
805,664,141,922,216200,12023
38,36,2,-,222500,12024
2165,1774,391,838,180400,12025
1675,1351,324,1580,287200,12027
323,261,62,850,160800,12028
496,423,73,1219,289900,12029
83,59,24,663,178800,12031
282,270,12,-,155700,12032
3457,2636,821,1122,233600,12033
191,169,22,-,150600,12035
90,83,7,-,115900,12036
1808,1347,461,949,263800,12037
11,11,0,-,89200,12040
188,168,20,-,190900,12041
115,93,22,-,190800,12042
2709,1754,955,863,147400,12043
233,128,105,1315,139800,12045
271,232,39,-,211900,12046
9863,4847,5016,1085,196200,12047
1513,901,612,862,205600,12051
768,724,44,1157,194100,12052
1476,1266,210,691,229400,12053
6816,5101,1715,1340,282400,12054
765,642,123,1202,259600,12056
813,713,100,943,191600,12057
427,353,74,766,167900,12058
621,578,43,1036,272200,12059
783,690,93,1433,286300,12060
4098,3150,948,1437,272400,12061
638,508,130,1066,199200,12062
310,310,0,-,229700,12063
177,132,45,918,89600,12064
17855,12660,5195,1238,290800,12065
710,623,87,1057,172800,12066
589,515,74,891,299000,12067
973,857,116,711,144700,12068
119,119,0,-,126600,12069
755,533,222,723,109300,12070
99,74,25,694,151100,12071
970,798,172,903,133800,12072
1179,1044,135,1302,220900,12074
1010,823,187,1163,261500,12075
572,521,51,881,175400,12076
2675,2064,611,1306,295600,12077
9418,5701,3717,771,102000,12078
2,2,0,-,-,12082
1328,1079,249,941,191900,12083
2085,533,1552,1381,268600,12084
130,0,130,889,-,12085
704,604,100,768,168500,12086
413,377,36,-,220200,12087
2309,1498,811,801,161300,12090
601,390,211,943,113500,12092
654,565,89,758,136700,12093
902,870,32,-,183000,12094
5131,3406,1725,799,129800,12095
1017,855,162,1022,254600,12106
119,80,39,860,225000,12108
7749,5182,2567,1327,264700,12110
34,34,0,-,-,12115
618,537,81,942,129400,12116
1267,1085,182,888,171800,12117
7343,5017,2326,940,275800,12118
290,240,50,897,260000,12120
724,699,25,-,186200,12121
1896,1415,481,787,140600,12122
1998,1629,369,880,201400,12123
97,97,0,-,261600,12124
512,354,158,945,212700,12125
161,107,54,-,202800,12130
69,54,15,936,116700,12131
98,72,26,-,270500,12132
1702,1297,405,814,171000,12134
304,287,17,-,322000,12136
759,588,171,-,219400,12137
1296,1173,123,980,154600,12138
89,86,3,-,208300,12139
595,510,85,693,217700,12140
2179,1600,579,942,192500,12143
9380,5351,4029,1139,209900,12144
219,203,16,1188,226800,12147
1928,1529,399,1054,349700,12148
955,696,259,753,126100,12149
273,269,4,-,186900,12150
370,316,54,1531,260100,12151
314,297,17,-,317200,12153
1311,1141,170,783,213000,12154
681,558,123,746,126000,12155
342,265,77,686,204900,12156
1761,1529,232,863,177600,12157
2706,1922,784,1240,247200,12158
3714,2770,944,1363,361800,12159
333,291,42,944,118600,12160
8,0,8,-,-,12161
123,97,26,825,160800,12164
89,74,15,-,336800,12165
541,511,30,927,146600,12166
1050,728,322,714,165600,12167
771,632,139,1028,178100,12168
187,171,16,-,-,12169
2018,1593,425,1280,230300,12170
77,2,75,933,-,12172
727,533,194,1082,170800,12173
208,196,12,-,95000,12174
281,246,35,1010,123100,12175
186,178,8,-,178600,12176
233,206,27,-,87800,12177
21958,9927,12031,1068,188500,12180
6634,3332,3302,931,158400,12182
1282,356,926,886,134300,12183
2804,2128,676,939,251900,12184
741,564,177,1009,209500,12185
2546,2198,348,1122,266600,12186
225,161,64,726,158900,12187
4977,3647,1330,1029,234700,12188
8694,3397,5297,961,176300,12189
170,144,26,675,164500,12190
651,588,63,1005,170200,12192
787,721,66,855,194400,12193
56,45,11,-,166100,12194
108,71,37,-,-,12195
1302,1187,115,948,242400,12196
745,644,101,749,153400,12197
2767,2223,544,930,209200,12198
4203,974,3229,916,142200,12202
13755,6898,6857,1194,221600,12203
3819,1093,2726,1139,189700,12204
11324,8088,3236,1232,230800,12205
6443,1457,4986,1081,118400,12206
1225,72,1153,594,182100,12207
9876,4750,5126,1121,213900,12208
4247,2864,1383,1047,163100,12209
5475,1381,4094,1056,130500,12210
4431,4082,349,-,317700,12211
0,0,0,-,-,12222
0,0,0,-,-,12226
10951,8185,2766,1104,194400,12302
11346,8264,3082,984,190300,12303
8200,4849,3351,1005,133600,12304
3393,488,2905,898,116900,12305
10556,7636,2920,1008,170600,12306
2774,764,2010,930,90200,12307
5693,2612,3081,959,133900,12308
12167,9921,2246,1284,256900,12309
14536,7944,6592,1152,213000,12401
1419,1089,330,961,290500,12404
218,182,36,-,148600,12405
298,198,100,-,172100,12406
40,28,12,725,206300,12407
442,346,96,1375,396900,12409
215,180,35,-,174600,12410
157,141,16,-,223700,12411
253,220,33,-,205400,12412
1147,749,398,1233,172500,12413
4363,3082,1281,995,185100,12414
137,137,0,-,270800,12416
408,404,4,-,91400,12417
108,72,36,1609,182400,12418
272,181,91,1304,262200,12419
88,88,0,-,-,12420
140,140,0,-,290000,12421
138,134,4,-,200000,12422
412,325,87,938,167200,12423
144,117,27,1067,217500,12424
143,143,0,-,256700,12427
2594,1399,1195,1041,162400,12428
19,19,0,-,-,12429
607,544,63,821,198600,12430
611,559,52,738,164600,12431
310,52,258,1383,-,12432
229,218,11,-,290200,12433
384,289,95,825,113200,12434
85,85,0,-,206000,12435
160,81,79,-,-,12436
8,8,0,-,-,12438
155,151,4,-,178100,12439
627,521,106,1321,328900,12440
62,35,27,-,163000,12441
390,241,149,940,198400,12442
1570,1445,125,1261,245300,12443
147,135,12,-,401300,12444
2023,1515,508,1032,232500,12446
99,61,38,-,451100,12448
1198,672,526,1146,191900,12449
99,69,30,-,189400,12450
449,327,122,1115,164100,12451
13,8,5,-,-,12452
100,86,14,-,-,12453
155,144,11,-,232500,12454
796,596,200,758,190700,12455
238,205,33,-,130100,12456
595,427,168,1033,-,12457
856,743,113,1146,137500,12458
63,63,0,-,144800,12459
108,99,9,-,145100,12460
610,507,103,-,351200,12461
613,496,117,806,185200,12463
545,409,136,1185,265200,12464
151,134,17,521,349100,12465
896,730,166,1157,219300,12466
573,507,66,414,190900,12468
329,329,0,-,178900,12469
193,182,11,-,169300,12470
288,264,24,-,189800,12471
608,345,263,984,250300,12472
236,213,23,-,189500,12473
400,328,72,738,170800,12474
176,98,78,1550,268200,12475
7790,5537,2253,1093,252600,12477
169,164,5,-,234400,12480
555,514,41,824,214600,12481
128,112,16,-,138900,12482
22,22,0,-,168800,12483
1486,1300,186,1115,343800,12484
370,216,154,830,300000,12485
605,485,120,1664,234900,12486
1499,1154,345,1255,254300,12487
96,42,54,-,-,12489
0,0,0,-,-,12490
715,641,74,1938,262100,12491
92,92,0,-,-,12492
57,57,0,-,-,12493
342,342,0,-,272600,12494
92,67,25,-,292700,12495
496,440,56,-,241900,12496
2405,1768,637,1235,385800,12498
875,435,440,1158,274800,12501
454,393,61,1200,293800,12502
225,203,22,-,367600,12503
9,0,9,-,-,12504
92,37,55,1672,426900,12507
7588,4644,2944,1396,323700,12508
76,76,0,-,326900,12512
117,74,43,-,-,12513
1327,1297,30,1143,355300,12514
545,383,162,1081,317100,12515
780,668,112,1110,215500,12516
164,74,90,933,351400,12517
2318,1541,777,1603,305400,12518
1203,835,368,1277,350800,12520
700,656,44,1500,283100,12521
1862,1131,731,933,234200,12522
846,683,163,978,314100,12523
6233,4131,2102,1465,323100,12524
752,564,188,1229,310700,12525
1444,1196,248,1058,329500,12526
6,6,0,-,-,12527
5425,3677,1748,1522,259800,12528
865,663,202,905,293600,12529
54,54,0,-,-,12530
872,771,101,-,364700,12531
8556,7837,719,1569,364300,12533
7568,4391,3177,1038,209900,12534
5347,3864,1483,1074,246600,12538
3009,2614,395,1725,378500,12540
2407,1776,631,1139,267500,12542
1286,705,581,1310,200200,12543
59,59,0,-,-,12544
2009,1219,790,1182,366000,12545
1215,927,288,1132,271000,12546
1229,897,332,1682,291000,12547
446,356,90,1261,267700,12548
3469,2720,749,1446,306400,12549
19586,11247,8339,1262,247500,12550
9718,6919,2799,1340,283700,12553
6429,4045,2384,1380,319700,12561
2196,1835,361,1530,321700,12563
2855,2153,702,1197,346100,12564
548,276,272,882,163600,12565
4224,3339,885,1397,290900,12566
1021,794,227,1292,268600,12567
4002,2662,1340,1552,296000,12569
2291,1958,333,1590,349300,12570
3616,2865,751,1205,336000,12571
3904,2696,1208,1411,388500,12572
195,169,26,-,365800,12574
623,558,65,-,372900,12575
514,441,73,1794,359100,12577
871,705,166,1438,317000,12578
1655,1470,185,914,288200,12580
844,639,205,1207,318000,12581
1454,1339,115,1688,387600,12582
734,501,233,1419,331900,12583
378,295,83,1063,509200,12585
4476,3102,1374,1343,263900,12586
5431,4302,1129,1057,275000,12589
14041,9892,4149,1518,309200,12590
533,377,156,689,242500,12592
1581,1190,391,998,271100,12594
16972,6714,10258,1196,221100,12601
16534,12235,4299,1428,274900,12603
0,0,0,-,-,12604
4713,2305,2408,943,146000,12701
503,450,53,1163,265300,12719
34,16,18,-,-,12720
2241,1630,611,1170,259600,12721
25,25,0,-,-,12722
767,613,154,918,170600,12723
28,28,0,-,315400,12724
74,70,4,-,311100,12725
601,514,87,958,272000,12726
530,426,104,1242,228100,12729
446,426,20,950,218000,12732
139,35,104,1656,-,12733
393,238,155,-,139700,12734
70,61,9,-,119100,12736
634,586,48,1155,231600,12737
105,50,55,1021,260000,12738
727,568,159,1313,257900,12740
91,65,26,1079,-,12741
61,45,16,-,-,12742
136,99,37,1346,262500,12743
15,15,0,-,-,12745
301,262,39,1403,209800,12746
782,589,193,866,222300,12747
835,615,220,850,207700,12748
148,87,61,890,122900,12749
12,9,3,-,-,12750
443,218,225,959,116400,12751
170,103,67,839,262500,12752
2661,1135,1526,873,148800,12754
1893,1545,348,860,140000,12758
586,408,178,850,65600,12759
217,179,38,-,100700,12760
158,73,85,-,-,12762
291,228,63,1427,185700,12763
799,649,150,809,179100,12764
397,367,30,-,274400,12765
267,250,17,-,325800,12766
54,49,5,-,170100,12767
212,193,19,-,245500,12768
145,145,0,-,410900,12769
83,76,7,-,266000,12770
5597,3580,2017,1033,188200,12771
862,683,179,1403,251300,12775
723,665,58,1433,202900,12776
340,331,9,-,249500,12777
149,111,38,-,206000,12778
639,277,362,769,221000,12779
909,660,249,1089,185400,12780
49,49,0,-,-,12781
550,430,120,1164,167200,12783
1,0,1,-,-,12784
407,386,21,-,205000,12785
271,242,29,-,155900,12786
38,28,10,-,-,12787
714,478,236,823,218200,12788
785,452,333,797,117400,12789
1766,1428,338,1151,173800,12790
245,238,7,-,166300,12791
69,64,5,-,210000,12792
6718,3489,3229,934,161400,12801
3689,2171,1518,987,189500,12803
11851,8657,3194,1082,250600,12804
109,107,2,-,299000,12808
1493,1307,186,1022,188300,12809
259,239,20,963,158200,12810
63,63,0,-,148200,12811
50,50,0,-,319400,12812
685,591,94,958,242700,12814
517,402,115,932,214300,12815
2072,1645,427,918,170300,12816
939,751,188,780,236600,12817
121,95,26,1038,150700,12819
32,32,0,-,1014700,12820
65,65,0,-,213400,12821
2349,1856,493,915,159000,12822
138,138,0,-,163300,12823
423,386,37,-,277800,12824
1349,1120,229,888,172200,12827
3740,3197,543,1034,174600,12828
6804,5170,1634,1202,279800,12831
2717,2006,711,725,123800,12832
2102,1753,349,983,252400,12833
2398,1914,484,1061,203100,12834
1273,1048,225,838,187400,12835
297,269,28,883,266200,12836
406,337,69,1030,139200,12837
302,256,46,865,174200,12838
5884,3205,2679,878,143000,12839
90,81,9,-,854700,12841
262,237,25,542,164100,12842
276,265,11,-,158200,12843
103,92,11,-,711500,12844
2072,1610,462,992,313900,12845
1570,1253,317,990,172300,12846
164,153,11,913,195500,12847
128,128,0,-,-,12849
1010,815,195,1266,246800,12850
172,156,16,-,98100,12851
176,156,20,1313,157400,12852
600,472,128,900,168400,12853
19,19,0,-,-,12854
112,100,12,963,132900,12855
152,75,77,-,237500,12856
316,258,58,920,182700,12857
58,58,0,-,466700,12858
758,645,113,1266,302700,12859
166,166,0,-,190800,12860
208,191,17,944,169200,12861
105,51,54,-,318000,12862
404,346,58,789,287900,12863
2,0,2,-,-,12864
1362,1064,298,982,152400,12865
17464,10855,6609,1402,349200,12866
758,601,157,775,197800,12870
1586,1221,365,961,197700,12871
49,49,0,-,-,12872
349,220,129,786,222700,12873
75,56,19,-,371400,12874
282,263,19,763,166300,12878
2103,1387,716,786,137500,12883
261,163,98,871,141300,12884
1958,1399,559,890,147000,12885
77,77,0,-,329300,12886
1779,1257,522,865,121400,12887
13906,7672,6234,865,148100,12901
785,408,377,1279,143600,12903
621,464,157,855,89300,12910
0,0,0,-,-,12911
672,580,92,944,131800,12912
485,398,87,785,173400,12913
350,242,108,671,94700,12914
38,27,11,-,94400,12915
915,583,332,732,103900,12916
469,359,110,727,106900,12917
1170,1041,129,877,161100,12918
1200,829,371,874,148400,12919
974,819,155,859,105300,12920
916,745,171,863,157000,12921
25,22,3,-,218800,12922
218,183,35,381,77700,12923
17,7,10,-,-,12924
991,769,222,763,96000,12926
157,149,8,-,118300,12927
853,674,179,889,133900,12928
336,233,103,824,104900,12929
299,245,54,1031,87900,12930
528,454,74,792,147400,12932
20,20,0,-,-,12933
418,284,134,690,83500,12934
697,559,138,636,117400,12935
271,232,39,1313,171300,12936
614,474,140,821,86200,12937
77,55,22,-,117500,12939
632,568,64,1083,168200,12941
318,300,18,-,312100,12942
149,100,49,-,219600,12943
1695,1263,432,1007,119900,12944
140,130,10,-,256900,12945
2000,1298,702,897,375900,12946
275,236,39,1065,120100,12950
90,86,4,-,46900,12952
4710,3179,1531,752,106600,12953
147,130,17,782,131300,12955
552,432,120,-,79700,12956
637,337,300,663,123100,12957
787,713,74,-,153200,12958
771,657,114,825,116800,12959
489,428,61,-,110100,12960
105,105,0,-,-,12961
1956,1578,378,959,163800,12962
19,19,0,-,260700,12964
179,160,19,-,66500,12965
1099,910,189,741,89500,12966
491,398,93,796,78200,12967
142,129,13,-,96500,12969
128,93,35,1425,222500,12970
2866,2425,441,1048,160200,12972
37,37,0,-,93800,12973
973,739,234,633,114600,12974
157,107,50,931,161900,12975
109,87,22,-,275000,12976
0,0,0,-,-,12977
79,79,0,-,-,12978
1138,602,536,613,139200,12979
473,404,69,683,83800,12980
905,804,101,823,105900,12981
3320,2068,1252,767,170400,12983
408,329,79,1060,150700,12985
2311,1682,629,639,113600,12986
106,97,9,-,166800,12987
393,369,24,1125,171100,12989
1657,1301,356,853,149000,12992
674,477,197,830,162500,12993
863,711,152,758,203200,12996
549,459,90,1034,237100,12997
69,69,0,-,-,12998
32,32,0,-,123500,13020
16501,10037,6464,789,141800,13021
0,0,0,-,-,13024
551,417,134,1253,168100,13026
14542,10437,4105,1054,174700,13027
304,286,18,-,118800,13028
2965,2278,687,845,195600,13029
1483,1316,167,767,153800,13030
6754,5175,1579,1055,168300,13031
4833,3781,1052,857,140200,13032
1341,1136,205,853,130700,13033
739,627,112,646,162800,13034
2919,2519,400,1020,216200,13035
3842,3022,820,849,147400,13036
3539,2800,739,710,168300,13037
6640,5532,1108,1061,184300,13039
1094,858,236,719,118400,13040
4533,4088,445,1217,164600,13041
793,699,94,1250,113600,13042
1210,1071,139,850,111500,13044
10710,6356,4354,808,135500,13045
30,30,0,-,-,13051
691,581,110,682,119600,13052
1807,1310,497,921,188600,13053
399,337,62,757,165400,13054
6381,4488,1893,875,133100,13057
1168,996,172,813,114100,13060
308,282,26,-,205600,13061
107,107,0,-,202200,13062
810,734,76,769,178200,13063
119,119,0,-,86300,13065
5361,4248,1113,1112,243000,13066
1996,1360,636,937,182400,13068
9946,6640,3306,812,86400,13069
315,261,54,1025,115000,13071
328,272,56,736,85000,13072
2689,2076,613,985,158600,13073
1696,1364,332,822,108400,13074
851,796,55,-,129200,13076
2947,2354,593,932,140100,13077
3800,3198,602,1133,231000,13078
1403,1162,241,731,131300,13080
523,464,59,1163,206800,13081
1526,1430,96,486,147100,13082
823,605,218,740,124300,13083
1453,1237,216,976,175300,13084
69,66,3,-,158900,13087
10334,6093,4241,988,137800,13088
11883,8276,3607,1102,161600,13090
935,839,96,1105,144700,13092
923,619,304,754,99000,13101
35,35,0,-,-,13102
82,57,25,1388,"10,000-",13103
6444,5244,1200,944,255300,13104
2675,2025,650,864,187700,13108
892,833,59,734,208300,13110
557,460,97,921,107800,13111
572,495,77,921,150300,13112
14,14,0,-,128100,13113
2938,2257,681,747,129900,13114
96,57,39,980,90600,13115
1422,1068,354,981,139900,13116
125,78,47,608,68100,13117
2098,1674,424,765,140300,13118
0,0,0,-,-,13119
712,657,55,773,103500,13120
0,0,0,-,-,13121
518,420,98,913,274000,13122
0,0,0,-,-,13123
62,60,2,-,130600,13124
13249,8965,4284,891,118700,13126
1302,1082,220,585,102900,13131
1609,1517,92,725,166100,13132
27,27,0,-,81300,13134
2348,1590,758,839,130200,13135
134,108,26,569,88300,13136
52,52,0,-,-,13138
1653,1287,366,822,97600,13140
290,269,21,877,127200,13141
2464,1941,523,784,136100,13142
923,797,126,813,108700,13143
507,424,83,673,80000,13144
696,523,173,704,113000,13145
777,602,175,744,88800,13146
362,280,82,1000,123400,13147
4822,3241,1581,803,105600,13148
3396,2820,576,1081,350100,13152
120,89,31,-,213800,13153
10,10,0,-,-,13154
248,201,47,742,77800,13155
880,791,89,644,149400,13156
257,188,69,1022,77100,13157
500,366,134,693,140600,13158
2139,1807,332,956,196600,13159
841,624,217,908,146500,13160
205,124,81,-,-,13162
106,106,0,-,154300,13163
851,820,31,-,209000,13164
4275,3073,1202,853,96400,13165
2363,1815,548,948,130600,13166
1260,1030,230,1260,149100,13167
3087,224,2863,694,73700,13202
7788,2482,5306,825,126500,13203
8392,2440,5952,896,79800,13204
7178,3403,3775,803,80700,13205
7848,3988,3860,836,99200,13206
5290,3320,1970,934,89500,13207
8832,4058,4774,861,87600,13208
5895,4177,1718,883,127600,13209
7432,1865,5567,943,154700,13210
2398,1746,652,1018,96300,13211
8865,6871,1994,944,128800,13212
3010,2155,855,856,177200,13214
5390,4451,939,1018,225800,13215
6236,5189,1047,981,145400,13219
3510,2309,1201,919,162100,13224
14,0,14,-,-,13244
0,0,0,-,-,13290
63,63,0,-,276000,13301
558,476,82,947,90900,13302
563,501,62,672,131400,13303
746,572,174,1105,171100,13304
83,46,37,-,116700,13305
1631,1393,238,1017,104300,13308
2525,1867,658,655,156100,13309
268,213,55,-,106500,13310
157,139,18,-,279200,13312
212,137,75,638,63900,13313
24,24,0,-,71700,13314
526,434,92,819,170800,13315
2746,2313,433,722,125200,13316
1381,1041,340,792,99700,13317
427,405,22,696,144900,13318
325,199,126,776,86800,13319
745,633,112,784,181100,13320
356,243,113,942,86800,13321
455,372,83,897,183700,13322
4433,3062,1371,963,187900,13323
836,735,101,684,115200,13324
422,385,37,719,111600,13325
2064,1538,526,1112,274800,13326
780,620,160,596,122200,13327
631,564,67,-,166900,13328
1587,1106,481,709,95400,13329
40,40,0,-,357100,13331
865,748,117,905,104200,13332
42,20,22,-,150000,13333
394,258,136,690,112500,13334
455,386,69,-,123300,13335
335,235,100,1075,282100,13337
634,583,51,1021,118400,13338
2051,1650,401,758,84300,13339
3084,2572,512,778,118000,13340
88,83,5,-,120600,13342
642,547,95,689,129500,13343
64,52,12,-,133300,13345
1953,1449,504,933,190900,13346
583,488,95,815,153300,13348
4253,2561,1692,733,110900,13350
1,1,0,-,-,13352
14,14,0,-,130000,13353
1205,1086,119,805,167100,13354
353,304,49,776,158300,13355
4269,2892,1377,655,82700,13357
40,37,3,-,237500,13360
245,196,49,733,151400,13361
866,817,49,1046,166400,13363
107,92,15,-,115400,13364
3073,2338,735,671,104200,13365
3534,2716,818,828,143600,13367
469,420,49,643,93700,13368
552,441,111,-,91900,13402
1719,1390,329,1034,187600,13403
50,34,16,-,75000,13404
149,128,21,-,108800,13406
1983,1580,403,700,103700,13407
736,602,134,737,138300,13408
796,721,75,833,101000,13409
262,160,102,589,50000,13410
1154,918,236,652,105900,13411
6626,4918,1708,1045,180800,13413
30,30,0,-,132700,13415
884,735,149,669,128200,13416
1625,741,884,734,124800,13417
60,30,30,-,76700,13418
498,393,105,-,258600,13420
5386,3481,1905,780,122400,13421
875,693,182,879,159100,13424
831,649,182,736,107800,13425
598,424,174,442,122300,13428
642,550,92,836,164200,13431
584,487,97,625,89100,13433
106,96,10,-,113300,13435
31,29,2,-,241700,13436
117,110,7,-,87500,13437
1253,1046,207,749,154300,13438
1400,1097,303,717,153300,13439
16630,10824,5806,793,120300,13440
88,0,88,850,-,13441
102,81,21,-,133900,13450
1805,1402,403,725,89700,13452
362,343,19,-,58200,13454
17,13,4,-,-,13455
1487,1245,242,696,195400,13456
23,7,16,-,77500,13457
797,574,223,892,145900,13459
1619,1277,342,673,104400,13460
1299,935,364,905,171200,13461
561,479,82,942,65000,13464
121,58,63,647,101900,13468
469,451,18,-,155000,13469
250,215,35,750,136700,13470
1022,886,136,836,94300,13471
78,78,0,-,350000,13472
426,413,13,888,116000,13473
17,14,3,-,108300,13475
1301,835,466,725,149600,13476
515,396,119,632,96000,13477
1310,1191,119,812,147800,13478
1274,913,361,730,125600,13480
27,27,0,-,156300,13482
157,108,49,729,143800,13483
0,0,0,-,-,13484
499,428,71,783,102400,13485
325,292,33,647,110400,13486
55,45,10,-,91100,13488
178,172,6,-,150000,13489
388,388,0,-,165300,13490
1289,1067,222,698,122200,13491
4760,3540,1220,870,162500,13492
806,690,116,812,87700,13493
94,89,5,-,89700,13494
820,516,304,846,118200,13495
14700,7695,7005,747,109200,13501
13199,8025,5174,827,121000,13502
16326,8189,8137,920,149300,13601
0,0,0,-,-,13602
4212,88,4124,1432,-,13603
1950,1491,459,791,155000,13605
1116,924,192,1039,159800,13606
833,523,310,728,142800,13607
653,504,149,738,114900,13608
155,136,19,-,146400,13611
1180,744,436,812,171400,13612
1043,734,309,730,102300,13613
105,64,41,811,63600,13614
294,225,69,942,159800,13615
966,337,629,1128,119000,13616
4130,2373,1757,851,123500,13617
650,584,66,833,148000,13618
4262,2405,1857,934,128000,13619
781,666,115,819,135900,13620
206,131,75,-,97500,13621
731,632,99,1069,197400,13622
28,28,0,-,-,13623
1952,1356,596,883,168600,13624
663,589,74,812,140900,13625
885,714,171,743,151800,13626
85,52,33,792,96200,13628
468,403,65,527,68300,13630
70,70,0,-,-,13632
94,91,3,-,83600,13633
1489,1210,279,685,168700,13634
393,315,78,583,80700,13635
54,43,11,910,168800,13636
1792,539,1253,1201,188900,13637
143,59,84,-,-,13638
40,37,3,-,46800,13639
127,127,0,-,367000,13640
26,26,0,-,77000,13641
3694,2581,1113,770,95700,13642
21,11,10,-,-,13643
0,0,0,-,-,13645
818,669,149,803,111500,13646
71,23,48,1105,-,13647
839,684,155,883,88500,13648
4,4,0,-,-,13649
620,507,113,697,175700,13650
89,89,0,-,265300,13651
649,573,76,530,79900,13652
900,735,165,763,111100,13654
1450,984,466,922,221000,13655
1048,882,166,423,138300,13656
927,831,96,855,123100,13658
153,144,9,-,108300,13659
638,531,107,740,106900,13660
668,613,55,861,122200,13661
7219,4977,2242,702,94700,13662
152,119,33,1027,133800,13664
336,264,72,850,89400,13665
86,57,29,1641,33400,13666
1224,895,329,723,86200,13667
1381,1138,243,866,96200,13668
5510,4051,1459,681,88500,13669
175,163,12,-,62600,13670
202,117,85,786,82400,13672
825,474,351,684,143800,13673
36,36,0,-,-,13674
13,13,0,-,-,13675
5280,3354,1926,782,134900,13676
97,0,97,510,-,13678
482,443,39,-,176700,13679
433,370,63,617,86400,13680
419,367,52,975,75000,13681
311,268,43,881,157400,13682
0,0,0,-,-,13683
451,401,50,715,84200,13684
1046,578,468,1228,254200,13685
231,223,8,-,138200,13687
312,244,68,570,68100,13690
1155,824,331,943,138300,13691
86,86,0,-,285900,13692
149,149,0,-,154200,13693
579,432,147,755,170800,13694
53,50,3,-,160000,13695
110,37,73,-,-,13696
787,661,126,-,95300,13697
0,0,0,-,-,13699
1207,934,273,663,109000,13730
525,449,76,932,261700,13731
3058,2691,367,904,146800,13732
2166,1861,305,634,106700,13733
888,849,39,-,110700,13734
820,700,120,1079,122900,13736
18,18,0,-,-,13738
325,262,63,745,150000,13739
234,214,20,730,277300,13740
1567,1140,427,769,129200,13743
457,414,43,820,97900,13744
866,769,97,926,123000,13746
22,22,0,-,-,13747
1544,1125,419,766,113500,13748
350,305,45,778,140800,13750
49,34,15,-,243800,13751
315,216,99,925,241700,13752
1808,1258,550,896,174200,13753
1134,894,240,642,117100,13754
385,312,73,639,111100,13755
241,231,10,-,149200,13756
542,457,85,829,159600,13757
19362,13004,6358,788,130000,13760
113,92,21,-,135900,13774
724,607,117,649,159800,13775
218,177,41,850,130100,13776
146,139,7,-,232800,13777
2303,1672,631,667,147600,13778
311,311,0,-,120100,13780
272,211,61,802,212500,13782
1080,766,314,775,131300,13783
98,83,15,1266,"10,000-",13784
194,187,7,-,114100,13786
1399,1109,290,616,126500,13787
382,291,91,713,160800,13788
8124,4736,3388,849,99400,13790
1537,1166,371,854,98200,13795
465,317,148,859,151500,13796
832,643,189,659,87800,13797
619,531,88,686,110200,13801
504,375,129,-,48100,13802
1516,1267,249,785,111200,13803
79,48,31,1067,130900,13804
88,79,9,-,172100,13806
471,339,132,725,136600,13807
520,432,88,623,121400,13808
719,632,87,708,144600,13809
566,480,86,917,188000,13810
1558,1288,270,844,115200,13811
908,747,161,907,115500,13812
255,255,0,-,161700,13813
10,10,0,-,-,13814
5728,3655,2073,741,109900,13815
7376,4687,2689,910,156400,13820
1174,832,342,809,162900,13825
94,90,4,-,-,13826
5084,3577,1507,831,111800,13827
2050,1688,362,684,89900,13830
159,147,12,-,100700,13832
1462,1152,310,1027,105200,13833
116,60,56,-,150000,13834
508,410,98,869,92500,13835
1603,1004,599,641,83700,13838
502,428,74,721,96800,13839
234,183,51,864,91900,13841
196,181,15,906,223600,13842
787,709,78,755,135800,13843
223,183,40,856,86700,13844
226,203,23,591,168200,13846
10,10,0,-,-,13847
1987,1642,345,713,98200,13849
9311,7400,1911,960,157100,13850
2696,1833,863,695,126000,13856
44,32,12,-,137500,13859
48,48,0,-,257100,13860
291,155,136,-,158100,13861
1585,1169,416,725,112500,13862
209,190,19,1250,86700,13863
607,401,206,824,183800,13864
2521,2209,312,639,138900,13865
8480,4420,4060,723,125600,13901
0,0,0,-,-,13902
8127,5161,2966,792,125200,13903
3637,2437,1200,646,94400,13904
11321,5549,5772,854,116800,13905
4121,3040,1081,779,173800,14001
3920,3403,517,764,200600,14004
737,601,136,694,149300,14005
3996,3324,672,859,127300,14006
609,467,142,475,167900,14008
2558,1957,601,770,125200,14009
2172,1742,430,720,137500,14011
1061,921,140,555,138800,14012
647,542,105,725,123400,14013
10145,6204,3941,829,122700,14020
578,507,71,740,105700,14024
1682,1504,178,791,215300,14025
295,202,93,-,167400,14026
38,9,29,-,-,14027
642,576,66,883,134800,14028
33,27,6,-,133900,14029
702,581,121,770,165100,14030
3967,3234,733,819,268100,14031
3733,3454,279,1632,407600,14032
684,568,116,1034,276100,14033
771,675,96,817,112300,14034
32,32,0,-,-,14035
2217,1779,438,802,148000,14036
390,358,32,-,169500,14037
38,27,11,-,98300,14039
718,678,40,-,181800,14040
64,49,15,747,82500,14041
1860,1401,459,706,87800,14042
11177,7798,3379,946,146400,14043
2481,2021,460,885,154200,14047
6831,4093,2738,738,80900,14048
7892,6468,1424,1609,308100,14051
7274,6164,1110,840,266500,14052
510,375,135,733,135200,14054
683,566,117,584,122700,14055
103,103,0,-,-,14056
3165,2680,485,921,191000,14057
750,654,96,846,134600,14058
3761,3004,757,1271,276100,14059
190,152,38,-,83100,14060
26,21,5,-,176100,14061
1330,1094,236,820,93100,14062
5003,3505,1498,805,149800,14063
597,554,43,-,103200,14065
463,397,66,701,94100,14066
1806,1538,268,1068,142700,14067
2842,2051,791,1182,295900,14068
261,237,24,-,174600,14069
2313,1651,662,658,88900,14070
8800,6995,1805,1134,232300,14072
19501,13995,5506,970,197600,14075
1733,1446,287,740,207500,14080
1228,1001,227,847,98500,14081
221,207,14,-,229200,14082
5,5,0,-,-,14083
2818,2766,52,1303,218000,14085
14655,12188,2467,838,215400,14086
561,499,62,1475,165300,14091
4776,3590,1186,898,216500,14092
21279,15388,5891,716,146800,14094
1154,892,262,933,108100,14098
710,639,71,748,92700,14101
548,474,74,-,264500,14102
4542,3194,1348,832,100900,14103
1770,1461,309,640,116600,14105
2157,1821,336,762,117000,14108
0,0,0,-,-,14109
1248,989,259,709,154200,14111
37,19,18,-,-,14112
309,246,63,988,130200,14113
18918,13805,5113,796,159000,14120
1384,997,387,765,114100,14125
214,163,51,-,149600,14126
12446,9059,3387,1083,266800,14127
440,370,70,645,98600,14129
39,33,6,-,74100,14130
1931,1762,169,885,158600,14131
2587,2143,444,855,167800,14132
37,37,0,-,106300,14134
46,41,5,-,-,14135
2180,1773,407,882,111700,14136
738,553,185,762,94500,14138
727,678,49,734,212200,14139
3306,2371,935,659,163200,14141
426,365,61,965,140100,14143
502,453,49,676,171800,14145
19293,13800,5493,931,145600,14150
103,103,0,-,135200,14166
661,579,82,694,145000,14167
35,35,0,-,-,14168
71,71,0,-,"10,000-",14169
925,801,124,758,250900,14170
777,716,61,661,140400,14171
1287,1097,190,688,144500,14172
72,72,0,-,103000,14173
2447,2003,444,953,201100,14174
5770,1272,4498,815,243900,14201
2164,545,1619,633,474200,14202
1433,19,1414,991,277500,14203
4381,1336,3045,706,116600,14204
9432,5849,3583,771,83900,14206
9902,3413,6489,787,78700,14207
4349,2388,1961,837,79900,14208
4261,1227,3034,853,316000,14209
7047,3429,3618,794,96800,14210
9465,3976,5489,832,65500,14211
4972,2466,2506,751,72200,14212
9543,3528,6015,866,134200,14213
8418,3914,4504,935,185000,14214
16804,7687,9117,853,77400,14215
11788,5833,5955,994,222700,14216
10800,7259,3541,860,152100,14217
8775,4943,3832,741,106600,14218
5258,3723,1535,802,145800,14219
10485,6993,3492,827,135000,14220
23521,17666,5855,1342,242300,14221
6779,2719,4060,1007,344100,14222
10072,8053,2019,878,154000,14223
17973,13959,4014,945,170100,14224
16038,11238,4800,836,116800,14225
12635,9420,3215,982,176300,14226
9861,6518,3343,957,148300,14227
9964,5569,4395,1112,202000,14228
0,0,0,-,-,14260
0,0,0,-,-,14261
5773,2442,3331,632,62900,14301
126,0,126,531,-,14302
2867,1290,1577,763,65000,14303
12496,9686,2810,769,119400,14304
7150,4455,2695,699,85200,14305
4977,3360,1617,798,89100,14411
25,0,25,-,-,14413
2954,2179,775,895,166900,14414
66,38,28,-,87100,14415
1534,1360,174,691,131800,14416
446,403,43,1257,160000,14418
6922,4279,2643,898,153200,14420
734,613,121,843,123800,14422
2054,1617,437,798,147900,14423
12522,8256,4266,1010,202100,14424
5031,3433,1598,1167,168700,14425
785,630,155,728,88600,14427
2894,2423,471,1059,169700,14428
2027,1724,303,614,133900,14432
1620,1265,355,581,78900,14433
1059,968,91,921,161900,14435
3979,3264,715,809,102500,14437
93,79,14,745,99300,14441
3373,2012,1361,989,115600,14445
18271,14200,4071,1102,229800,14450
0,0,0,-,-,14453
3283,1699,1584,916,179700,14454
7709,4891,2818,862,138400,14456
270,243,27,1097,155800,14462
134,134,0,-,137500,14463
2742,2379,363,863,123100,14464
626,591,35,617,142200,14466
4426,2974,1452,996,169200,14467
6717,5833,884,1031,167500,14468
2574,2154,420,813,159500,14469
3146,2588,558,715,114900,14470
1256,920,336,1025,165900,14471
3436,2661,775,893,271500,14472
145,140,5,-,340300,14475
941,873,68,832,126300,14476
666,566,100,812,143000,14477
293,237,56,-,252900,14478
84,84,0,-,-,14479
285,205,80,843,-,14480
712,615,97,778,124400,14481
3640,2720,920,814,132300,14482
1573,1229,344,761,159500,14485
132,112,20,-,134700,14486
2263,1907,356,877,171600,14487
2642,1984,658,871,86800,14489
4270,3469,801,843,175600,14502
654,505,149,1019,92300,14504
2038,1661,377,613,137000,14505
370,356,14,-,245600,14506
366,337,29,741,137500,14507
2136,1520,616,819,88100,14510
136,109,27,-,116100,14511
1891,1588,303,764,163700,14512
5728,3814,1914,845,106600,14513
2550,1732,818,1307,170300,14514
109,109,0,-,79000,14515
824,706,118,1063,88800,14516
1103,796,307,677,106100,14517
5306,4301,1005,897,177900,14519
1123,867,256,765,121200,14521
4127,3055,1072,756,130500,14522
1015,880,135,800,121700,14525
8064,6683,1381,1066,221400,14526
4830,3437,1393,702,156900,14527
12,12,0,-,-,14529
2498,1756,742,725,104100,14530
1654,1434,220,797,150100,14532
793,643,150,807,162500,14533
12347,11157,1190,1620,273300,14534
286,199,87,617,86500,14536
27,16,11,-,-,14537
41,35,6,-,170300,14539
799,602,197,1054,146800,14541
0,0,0,-,-,14542
1309,1216,93,833,197800,14543
728,550,178,1145,156600,14544
44,44,0,-,82500,14545
2099,1364,735,1105,143100,14546
1759,1435,324,950,120400,14548
154,137,17,-,106500,14549
577,445,132,587,94100,14550
2455,1993,462,734,104200,14551
657,567,90,678,179600,14555
0,0,0,-,-,14556
55,55,0,-,82600,14557
7268,5899,1369,1130,177200,14559
950,780,170,938,155800,14560
1035,926,109,988,154800,14561
6569,5279,1290,1330,288000,14564
2555,2436,119,771,153100,14568
2877,1910,967,621,128200,14569
474,427,47,1349,130300,14571
1792,1475,317,715,94000,14572
22955,16760,6195,1208,210100,14580
97,76,21,-,-,14585
4582,3485,1097,1312,201000,14586
0,0,0,-,-,14588
3176,2496,680,735,145600,14589
2233,1805,428,701,84800,14590
654,533,121,718,120400,14591
97,53,44,-,144000,14592
1719,46,1673,990,-,14604
4065,956,3109,747,61600,14605
11059,7065,3994,896,121100,14606
10829,1993,8836,970,265500,14607
5626,1310,4316,827,140400,14608
17889,10517,7372,1003,109800,14609
7155,3892,3263,972,195600,14610
7237,2170,5067,939,64300,14611
15073,10551,4522,948,152300,14612
6010,2184,3826,822,80800,14613
54,0,54,-,-,14614
7598,3973,3625,917,94100,14615
11388,7848,3540,1040,112100,14616
9708,8221,1487,985,144800,14617
8302,6358,1944,1213,237500,14618
5545,3345,2200,1026,87300,14619
12001,3683,8318,1037,161300,14620
13001,4467,8534,862,65700,14621
5899,4769,1130,943,125500,14622
8545,4664,3881,1122,137800,14623
15274,12050,3224,1134,141200,14624
4580,4031,549,1179,193100,14625
12790,8861,3929,1022,151100,14626
0,0,0,-,-,14627
0,0,0,-,-,14642
16742,9616,7126,660,77700,14701
2535,1962,573,699,131300,14706
34,22,12,-,85000,14707
52,52,0,-,45300,14708
506,411,95,755,75100,14709
1386,1227,159,563,111600,14710
653,544,109,648,72800,14711
1298,1080,218,730,179400,14712
196,177,19,975,122100,14714
1031,766,265,761,63600,14715
747,541,206,612,87400,14716
281,252,29,650,125000,14717
746,653,93,688,100200,14718
1355,1080,275,615,88000,14719
350,190,160,844,54500,14720
68,61,7,-,116300,14721
58,58,0,-,-,14722
477,408,69,781,86100,14723
826,688,138,634,126300,14724
587,531,56,750,84800,14726
2090,1719,371,756,88500,14727
462,396,66,-,118900,14728
381,309,72,753,133500,14729
572,462,110,758,232800,14731
15,15,0,-,-,14732
1456,1046,410,618,86500,14733
941,772,169,641,93600,14735
65,61,4,-,101400,14736
1726,1469,257,694,85800,14737
1382,1108,274,837,111600,14738
1042,917,125,736,57100,14739
417,353,64,1265,95000,14740
746,665,81,590,113400,14741
84,76,8,-,86200,14742
833,648,185,600,80900,14743
395,271,124,636,119000,14744
820,667,153,538,82400,14747
233,170,63,558,68900,14748
1947,1330,617,1005,126300,14750
130,99,31,-,142900,14752
490,404,86,685,67000,14753
222,187,35,733,71900,14754
1122,875,247,610,93700,14755
0,0,0,-,-,14756
1341,1035,306,660,153900,14757
7871,4491,3380,683,87200,14760
786,676,110,692,113000,14767
333,238,95,838,107100,14769
1060,808,252,654,94700,14770
1604,1236,368,616,101600,14772
50,43,7,-,65500,14774
975,786,189,612,88600,14775
174,144,30,725,60000,14777
0,0,0,-,-,14778
2918,1702,1216,685,71300,14779
738,594,144,763,87300,14781
958,803,155,643,85800,14782
72,58,14,-,86700,14783
299,252,47,654,119000,14784
15,0,15,-,-,14785
2341,1661,680,597,87500,14787
35,9,26,-,-,14788
1820,1425,395,637,92800,14801
380,219,161,650,124700,14802
497,417,80,660,114000,14803
559,499,60,828,90700,14804
394,338,56,875,124700,14805
769,589,180,690,78500,14806
1159,968,191,829,96000,14807
229,205,24,-,80700,14808
959,708,251,782,85800,14809
5196,3507,1689,654,95900,14810
1246,1020,226,889,104800,14812
848,666,182,656,85700,14813
811,566,245,1320,174800,14814
331,274,57,746,123800,14815
228,207,21,-,89500,14816
1160,704,456,1518,168900,14817
843,773,70,1089,171000,14818
268,222,46,1167,80000,14819
241,204,37,860,100600,14820
1238,1072,166,897,117700,14821
362,327,35,875,78700,14822
1478,1126,352,611,91600,14823
262,198,64,1019,95700,14824
327,279,48,720,111400,14825
761,627,134,765,84400,14826
62,62,0,-,86200,14827
8616,5807,2809,914,133200,14830
415,396,19,686,74500,14836
1976,1589,387,705,115900,14837
795,745,50,985,118700,14838
247,214,33,731,106400,14839
1212,1054,158,717,170300,14840
278,202,76,1267,230800,14841
221,174,47,763,206300,14842
5405,3259,2146,683,85100,14843
8936,6485,2451,1087,152400,14845
303,269,34,625,96400,14846
931,738,193,645,159500,14847
28182,12205,15977,1259,277100,14850
0,0,0,-,-,14853
38,38,0,-,-,14854
278,228,50,586,89400,14855
0,0,0,-,-,14856
458,399,59,625,121100,14858
397,329,68,1006,110700,14859
553,364,189,591,122800,14860
498,418,80,1022,96800,14861
488,469,19,958,92500,14864
1131,822,309,599,105600,14865
2507,1905,602,1005,151300,14867
523,350,173,728,135900,14869
3970,3025,945,982,143400,14870
1771,1474,297,967,144300,14871
187,158,29,705,166700,14872
821,742,79,1260,109800,14873
56,56,0,-,93300,14874
224,174,50,544,118800,14877
229,219,10,-,169200,14878
892,795,97,807,94700,14879
760,681,79,732,86100,14880
118,57,61,850,205800,14881
1561,1298,263,1173,238400,14882
1878,1473,405,1036,156700,14883
118,97,21,758,143100,14884
258,208,50,938,120400,14885
2824,2266,558,1098,208000,14886
549,444,105,888,104800,14889
2008,1275,733,706,126500,14891
3231,2192,1039,789,112300,14892
9,9,0,-,-,14893
411,353,58,950,93900,14894
3998,3054,944,661,75700,14895
262,214,48,564,61500,14897
559,472,87,649,98400,14898
5440,2866,2574,748,79100,14901
3121,1957,1164,849,114800,14903
6132,3713,2419,885,75100,14904
3655,2461,1194,963,153400,14905
14182,10735,3447,797,154200,15001
5160,3298,1862,785,97200,15003
142,142,0,-,101000,15004
3887,3384,503,572,174700,15005
129,113,16,-,69000,15006
165,130,35,-,181300,15007
6645,5067,1578,706,207200,15009
11743,8263,3480,739,159700,15010
6797,5081,1716,770,172600,15012
1463,1055,408,728,75100,15014
505,499,6,-,385800,15015
7372,5471,1901,994,193100,15017
465,397,68,756,69700,15018
679,555,124,715,140800,15019
203,195,8,-,267700,15020
2695,2123,572,731,141900,15021
4257,3211,1046,671,93900,15022
3474,2795,679,963,163500,15024
7017,5193,1824,1003,189700,15025
1553,1169,384,965,221500,15026
1157,780,377,669,139500,15027
76,74,2,-,82900,15028
484,286,198,830,77000,15030
230,111,119,843,88900,15031
2248,1011,1237,755,61800,15033
850,420,430,590,77100,15034
1031,698,333,658,70300,15035
4279,3756,523,833,136600,15037
121,87,34,-,79400,15038
3397,2887,510,1309,191100,15042
839,724,115,786,170100,15043
10641,9870,771,1240,306000,15044
1897,1262,635,766,68500,15045
1103,948,155,869,153500,15046
128,128,0,-,112500,15047
498,410,88,729,109800,15049
897,836,61,1214,177400,15050
238,128,110,1093,107300,15051
1262,1019,243,829,151100,15052
41,38,3,-,-,15053
236,178,58,-,109200,15054
631,580,51,1057,195200,15055
521,318,203,831,98000,15056
6301,5573,728,872,270200,15057
1668,892,776,609,79400,15059
366,325,41,533,94500,15060
5225,3481,1744,820,156100,15061
3297,2514,783,561,75700,15062
4598,3706,892,794,121600,15063
134,62,72,1119,-,15064
5041,3758,1283,663,120200,15065
5669,3636,2033,734,111000,15066
1076,866,210,662,88000,15067
16352,11640,4712,747,139600,15068
5017,3642,1375,1231,217700,15071
39,0,39,-,-,15072
3600,2359,1241,731,107100,15074
22,11,11,-,-,15075
411,203,208,762,104400,15076
93,74,19,883,130400,15077
200,137,63,-,85800,15078
165,107,58,707,123900,15081
77,37,40,-,180800,15082
452,412,40,1038,126900,15083
4430,3062,1368,726,92400,15084
3309,2739,570,753,156100,15085
257,187,70,-,219800,15086
33,23,10,-,59400,15087
159,116,43,696,73300,15088
2964,2173,791,656,143700,15089
9652,7622,2030,1518,365500,15090
10766,7982,2784,1064,252800,15101
13470,10977,2493,1075,215100,15102
3744,1712,2032,576,47900,15104
9375,6534,2841,815,155100,15106
16998,12641,4357,973,215800,15108
2138,997,1141,687,51000,15110
1470,623,847,713,72000,15112
5797,5052,745,942,203700,15116
8449,5138,3311,763,97000,15120
8237,6388,1849,700,102800,15122
0,0,0,-,-,15123
3093,2428,665,742,200600,15126
4287,3411,876,1195,185000,15129
3952,2805,1147,880,123000,15131
9155,4413,4742,722,54500,15132
2812,2138,674,832,79600,15133
2095,1632,463,790,140100,15135
9988,6322,3666,869,151000,15136
4651,2990,1661,793,90400,15137
3274,1889,1385,957,260500,15139
1482,591,891,718,64500,15140
786,474,312,1676,589600,15142
8610,6711,1899,1385,369300,15143
1852,1263,589,782,121400,15144
2973,1371,1602,805,75000,15145
12360,8817,3543,1078,161500,15146
7964,5363,2601,836,111000,15147
1113,438,675,852,52900,15148
6640,3657,2983,1211,201400,15201
9959,5092,4867,849,161300,15202
5644,2148,3496,1305,225100,15203
3564,2331,1233,919,86300,15204
10827,6189,4638,999,144500,15205
14753,6138,8615,1084,248700,15206
4729,3007,1722,905,102600,15207
4126,2138,1988,865,152200,15208
5510,4185,1325,930,180400,15209
11188,5953,5235,906,72800,15210
5638,2719,2919,1095,146700,15211
14176,6991,7185,923,118700,15212
9597,2473,7124,1020,197500,15213
6129,4009,2120,942,131100,15214
5532,4085,1447,932,245800,15215
10385,6433,3952,967,149100,15216
11662,6061,5601,1210,352500,15217
6715,3859,2856,936,158500,15218
5377,1357,4020,786,129000,15219
8826,4759,4067,1091,173000,15220
15214,6522,8692,854,116600,15221
3018,497,2521,1721,426200,15222
3364,2132,1232,928,121200,15223
5574,2085,3489,1045,192600,15224
523,283,240,830,94600,15225
6253,4336,1917,1009,135800,15226
12833,9232,3601,762,138300,15227
7437,5307,2130,1021,306300,15228
6241,4646,1595,998,178900,15229
6198,1743,4455,1259,410100,15232
1447,634,813,741,240400,15233
6077,4354,1723,957,151100,15234
15290,10905,4385,944,105800,15235
13446,10277,3169,984,178000,15236
18231,14254,3977,1115,250600,15237
5396,4238,1158,966,381100,15238
8304,7036,1268,1030,165900,15239
8127,7056,1071,1571,323900,15241
5788,5078,710,1006,228000,15243
0,0,0,-,-,15260
0,0,0,-,-,15275
0,0,0,-,-,15282
0,0,0,-,-,15290
20943,14478,6465,826,167000,15301
101,87,14,967,111300,15310
492,475,17,-,224200,15311
1534,1241,293,836,168300,15312
156,132,24,881,122800,15313
1360,980,380,556,142600,15314
233,188,45,939,60600,15315
87,63,24,-,-,15316
17080,13554,3526,1088,271800,15317
2258,1791,467,647,120900,15320
695,536,159,1590,235700,15321
706,600,106,725,84600,15322
1574,1295,279,606,168000,15323
298,197,101,885,97900,15324
130,71,59,-,43000,15325
543,442,101,884,83300,15327
575,484,91,833,182800,15329
2197,1975,222,992,281200,15330
303,209,94,938,75900,15331
3981,3515,466,827,155300,15332
707,509,198,496,207900,15333
81,81,0,-,171900,15334
211,169,42,679,175500,15337
632,526,106,745,102100,15338
524,471,53,1030,259200,15340
280,187,93,847,139000,15341
2267,1922,345,937,198600,15342
596,534,62,-,125300,15344
586,470,116,874,116400,15345
226,200,26,-,79100,15346
85,20,65,-,-,15347
32,28,4,-,-,15348
656,496,160,763,174200,15349
228,120,108,629,63500,15350
475,303,172,-,-,15351
364,314,50,679,140400,15352
44,42,2,-,186500,15353
598,503,95,799,117000,15357
398,249,149,850,100400,15358
77,49,28,813,109300,15359
639,561,78,950,193600,15360
91,66,25,-,-,15361
299,250,49,-,117600,15362
313,179,134,733,152200,15363
294,245,49,832,154400,15364
67,59,8,-,117200,15365
244,96,148,-,261400,15366
3212,2982,230,-,442100,15367
156,117,39,759,45800,15368
4841,3428,1413,658,157300,15370
564,449,115,883,159300,15376
253,199,54,1016,217300,15377
18,9,9,-,-,15378
30,24,6,-,95600,15379
296,221,75,708,87500,15380
13424,9226,4198,705,114500,15401
381,308,73,-,86400,15410
278,234,44,856,189700,15411
104,79,25,858,72800,15412
169,113,56,-,28400,15413
186,173,13,-,262000,15416
3246,2230,1016,659,82500,15417
1395,479,916,626,111500,15419
86,49,37,-,63000,15420
50,50,0,-,275000,15421
121,31,90,788,-,15422
768,606,162,903,144400,15423
884,696,188,653,115600,15424
8121,5750,2371,624,114400,15425
398,291,107,792,106900,15427
773,678,95,753,95000,15428
221,176,45,-,46700,15429
111,108,3,-,60800,15430
1791,1472,319,686,89700,15431
189,139,50,850,80800,15432
365,328,37,-,109100,15433
127,87,40,542,103100,15434
47,47,0,-,55400,15435
1086,728,358,753,87800,15436
774,496,278,1030,182600,15437
918,788,130,662,111100,15438
60,60,0,-,158300,15440
966,696,270,762,83400,15442
65,12,53,-,-,15443
171,139,32,-,102700,15444
1304,1127,177,897,130300,15445
59,59,0,-,80900,15446
47,47,0,-,-,15447
71,57,14,-,64000,15448
183,174,9,-,-,15449
79,79,0,-,156400,15450
345,299,46,-,88900,15451
50,0,50,-,-,15454
216,203,13,-,170800,15455
970,798,172,727,103000,15456
997,718,279,1335,115500,15458
573,443,130,699,164800,15459
58,56,2,-,65000,15460
1555,1145,410,724,99100,15461
88,88,0,-,"10,000-",15462
125,88,37,-,38700,15463
672,515,157,844,151300,15464
183,154,29,-,105600,15465
168,144,24,1042,83800,15466
59,55,4,-,38500,15467
1074,864,210,948,69700,15468
975,761,214,691,108600,15469
260,209,51,675,215300,15470
86,15,71,787,-,15472
1593,1316,277,722,175200,15473
673,443,230,882,85000,15474
457,228,229,760,62900,15475
34,34,0,-,197200,15476
411,349,62,696,100900,15477
2352,1935,417,725,123400,15478
909,778,131,880,164000,15479
778,608,170,750,108800,15480
158,113,45,838,-,15482
162,125,37,671,87500,15483
255,255,0,-,-,15484
895,774,121,734,137500,15486
50,50,0,-,-,15488
172,161,11,-,74100,15489
121,103,18,-,95600,15490
58,58,0,-,71200,15492
6241,4364,1877,654,133100,15501
82,72,10,-,277500,15502
0,0,0,-,-,15510
138,123,15,-,87700,15520
706,621,85,858,157000,15521
4734,3718,1016,711,169200,15522
2024,1648,376,639,129100,15530
1526,1146,380,570,113400,15531
64,50,14,822,75000,15532
514,375,139,741,167300,15533
382,315,67,642,139100,15534
794,675,119,658,158100,15535
153,130,23,783,250000,15536
3447,2455,992,682,151100,15537
274,243,31,613,140300,15538
136,118,18,-,118600,15539
141,124,17,-,143800,15540
1432,1336,96,692,130300,15541
446,367,79,782,97200,15542
49,49,0,-,107000,15544
1079,886,193,625,100200,15545
211,211,0,-,55500,15546
252,190,62,738,180300,15547
700,540,160,759,131700,15550
240,198,42,633,119300,15551
2177,1657,520,596,101100,15552
1042,827,215,-,144200,15554
43,40,3,-,72000,15555
1360,1115,245,630,110600,15557
712,547,165,734,118000,15558
815,670,145,725,171600,15559
64,54,10,775,80000,15560
56,42,14,-,117200,15561
88,76,12,1100,142900,15562
1199,1083,116,608,106900,15563
51,32,19,583,90000,15564
2,2,0,-,-,15565
24325,18116,6209,768,171300,15601
1820,1592,228,733,169300,15610
150,126,24,650,81400,15611
176,136,40,-,129400,15612
5240,4418,822,769,158100,15613
114,107,7,-,126400,15615
212,192,20,-,312700,15616
123,104,19,729,107100,15617
1016,845,171,685,103800,15618
162,136,26,-,-,15619
276,212,64,829,93200,15620
553,521,32,-,194300,15622
313,265,48,913,152400,15623
218,181,37,-,-,15624
27,27,0,-,-,15625
2443,1679,764,679,196000,15626
2751,2267,484,695,121300,15627
197,134,63,-,88600,15628
294,192,102,817,59000,15629
383,203,180,731,72300,15631
3814,3078,736,1039,228800,15632
218,121,97,943,187500,15633
220,125,95,686,82500,15634
93,48,45,-,-,15635
1561,1369,192,-,304000,15636
611,531,80,939,216500,15637
45,14,31,-,-,15638
907,589,318,1271,167400,15639
143,119,24,-,92800,15640
228,153,75,688,107000,15641
19025,16225,2800,793,193700,15642
8551,6530,2021,782,128100,15644
77,77,0,-,117800,15646
9,0,9,-,-,15647
11308,8038,3270,772,154500,15650
128,115,13,625,139600,15655
3978,3144,834,682,123000,15656
3752,3085,667,792,194100,15658
140,115,25,-,94200,15660
283,265,18,-,138400,15661
363,363,0,-,93900,15662
242,210,32,694,160700,15663
497,432,65,-,129500,15665
6793,5307,1486,702,134700,15666
5425,5033,392,1287,273100,15668
1248,1117,131,815,149800,15670
256,205,51,-,100900,15671
1386,949,437,938,198600,15672
614,518,96,544,110100,15673
156,147,9,-,155300,15674
406,310,96,828,85300,15675
257,145,112,1524,150700,15676
198,164,34,-,152300,15677
257,175,82,873,93500,15678
1384,1188,196,747,131300,15679
149,132,17,-,-,15680
1883,1521,362,877,117100,15681
113,107,6,-,119500,15682
3504,2548,956,599,139200,15683
147,123,24,-,91400,15684
432,421,11,-,176200,15686
524,501,23,475,174700,15687
386,313,73,1325,86500,15688
50,50,0,-,128600,15689
4034,2451,1583,717,94100,15690
161,161,0,-,224700,15691
444,311,133,688,134100,15692
130,117,13,-,139900,15693
133,133,0,-,142600,15695
109,91,18,850,87800,15696
1309,842,467,766,125900,15697
274,251,23,-,108600,15698
12702,7381,5321,747,153200,15701
0,0,0,-,-,15705
111,73,38,723,78500,15710
136,105,31,853,72900,15711
48,39,9,-,-,15712
96,96,0,-,-,15713
1990,1529,461,538,75200,15714
220,166,54,744,92800,15715
176,103,73,618,-,15716
4078,3061,1017,687,138200,15717
105,90,15,825,-,15720
78,64,14,-,50000,15721
903,823,80,584,109600,15722
12,12,0,-,-,15723
856,743,113,806,96600,15724
560,425,135,614,131600,15725
87,66,21,942,68500,15727
1350,940,410,622,109200,15728
517,403,114,445,92600,15729
60,51,9,-,136600,15730
146,121,25,-,63400,15731
615,532,83,648,132400,15732
61,57,4,-,-,15733
163,150,13,-,71300,15734
168,127,41,814,92700,15736
53,43,10,-,56300,15737
74,66,8,825,45000,15738
162,111,51,838,67800,15739
23,17,6,-,102100,15741
343,277,66,635,93500,15742
11,7,4,-,-,15744
110,104,6,-,36900,15745
54,42,12,-,91300,15746
664,596,68,681,162300,15747
2835,2185,650,751,117500,15748
112,92,20,-,68900,15750
16,8,8,-,83300,15752
176,148,28,663,77500,15753
159,121,38,-,79500,15754
71,55,16,1050,84200,15756
569,487,82,592,80300,15757
1062,800,262,679,137300,15759
44,27,17,-,43800,15760
54,22,32,-,45000,15761
337,306,31,608,156700,15762
12,5,7,-,-,15763
42,38,4,-,143800,15764
648,531,117,635,165900,15765
5716,4157,1559,780,117600,15767
86,77,9,-,118800,15770
370,326,44,-,141300,15771
568,429,139,892,103000,15772
161,155,6,-,65700,15773
1195,1023,172,813,147100,15774
236,211,25,-,88700,15775
26,24,2,-,85000,15776
35,35,0,-,85000,15777
64,63,1,-,61000,15778
91,83,8,-,172200,15779
49,46,3,-,73600,15780
46,45,1,-,95000,15781
35,24,11,592,103100,15783
32,29,3,-,87200,15784
8220,5878,2342,786,130700,15801
49,43,6,-,85800,15821
534,466,68,647,115400,15823
2087,1617,470,782,110100,15824
3811,2825,986,655,127600,15825
120,120,0,-,65800,15827
108,93,15,-,101000,15828
465,396,69,739,120300,15829
31,31,0,-,-,15831
129,107,22,379,92500,15832
1933,1347,586,667,78800,15834
741,592,149,848,90400,15840
91,77,14,-,47300,15841
1332,1005,327,480,62700,15845
1419,1244,175,925,125000,15846
21,10,11,513,51700,15847
335,306,29,880,111500,15848
530,447,83,861,85100,15849
2661,2044,617,620,97600,15851
2687,2028,659,655,89400,15853
385,348,37,745,142700,15856
5793,4487,1306,687,127000,15857
513,437,76,667,114200,15860
60,54,6,-,108300,15861
69,67,2,-,55800,15863
700,548,152,809,98000,15864
532,328,204,650,77400,15865
58,51,7,800,71300,15866
725,628,97,669,143500,15868
525,484,41,547,75000,15870
1919,741,1178,471,19100,15901
4930,3166,1764,643,54700,15902
6619,4694,1925,823,145000,15904
8752,6694,2058,763,103100,15905
4660,3052,1608,509,49100,15906
2081,1833,248,648,91900,15909
257,228,29,875,105500,15920
153,115,38,-,51600,15921
28,28,0,-,-,15922
612,508,104,563,89400,15923
378,337,41,775,76200,15924
56,45,11,738,69400,15925
1044,895,149,716,83700,15926
355,280,75,-,69500,15927
860,744,116,1363,208000,15928
38,23,15,-,115600,15929
165,165,0,-,-,15930
3805,2922,883,751,161700,15931
0,0,0,-,-,15934
1129,1000,129,647,96500,15935
685,625,60,613,87200,15936
305,257,48,-,-,15937
983,897,86,571,101100,15938
590,526,64,918,191700,15940
706,662,44,780,152500,15942
1733,1229,504,647,78800,15943
1114,957,157,585,133300,15944
47,47,0,-,55000,15945
2725,2318,407,543,98300,15946
179,130,49,-,85800,15948
225,190,35,920,55000,15949
299,283,16,-,-,15951
492,385,107,631,149800,15952
20,20,0,-,-,15953
1133,948,185,595,81500,15954
878,826,52,722,109800,15955
1186,1017,169,638,64800,15956
132,132,0,-,125000,15957
821,711,110,754,116500,15958
88,81,7,-,76300,15960
376,294,82,728,77600,15961
116,94,22,925,97500,15962
4485,3624,861,647,111600,15963
18074,12314,5760,750,163800,16001
6348,5476,872,705,213800,16002
443,388,55,800,165600,16020
135,90,45,750,107900,16022
1700,1200,500,1140,218400,16023
105,95,10,1071,130800,16024
1922,1618,304,638,169800,16025
153,99,54,1301,205000,16027
861,612,249,588,119400,16028
370,280,90,823,117600,16029
104,75,29,665,74400,16030
3065,2430,635,918,260700,16033
742,646,96,914,175400,16034
52,38,14,-,-,16035
128,87,41,780,114100,16036
1828,1544,284,1094,274300,16037
1291,1052,239,788,144500,16038
330,269,61,658,148900,16040
783,670,113,693,120500,16041
422,275,147,1054,110200,16045
6645,5313,1332,1505,402200,16046
64,51,13,1069,88500,16048
1215,951,264,669,117000,16049
468,376,92,834,104800,16050
1268,1176,92,593,181300,16051
915,844,71,800,173300,16052
1599,1406,193,-,232300,16053
170,140,30,681,86800,16054
3329,3071,258,1130,247500,16055
1948,1494,454,751,245000,16056
4533,2594,1939,788,188900,16057
3750,3325,425,1674,311800,16059
1013,910,103,923,170800,16061
3623,2337,1286,1030,245800,16063
13045,10245,2800,1401,327700,16066
13390,9389,4001,628,95700,16101
2192,1553,639,809,97800,16102
6763,5244,1519,1007,147100,16105
167,158,9,-,101900,16110
404,353,51,942,123500,16111
601,535,66,726,119000,16112
153,126,27,975,165400,16113
229,214,15,1071,124600,16114
1389,1120,269,714,151900,16115
1087,931,156,614,115700,16116
7221,5613,1608,731,122100,16117
948,764,184,598,141900,16120
2024,1120,904,594,61100,16121
968,892,76,1045,171200,16123
648,535,113,540,124400,16124
7025,4850,2175,694,115900,16125
5260,3795,1465,726,163600,16127
832,686,146,563,116600,16130
377,292,85,671,148300,16131
187,163,24,-,102400,16132
572,530,42,1020,159600,16133
1626,1388,238,716,111700,16134
328,234,94,717,78300,16136
4425,3657,768,593,151000,16137
155,125,30,-,83000,16140
666,546,120,730,95300,16141
1899,1447,452,734,184900,16142
873,764,109,688,160200,16143
1155,970,185,687,139300,16145
6006,3019,2987,626,63600,16146
7805,5506,2299,788,151700,16148
3166,2266,900,721,117900,16150
33,27,6,-,71300,16151
922,732,190,679,130700,16153
886,712,174,831,159800,16154
50,0,50,866,-,16155
1167,1027,140,830,169900,16156
1292,1009,283,614,116300,16157
2154,1784,370,721,129600,16159
455,274,181,717,72700,16160
301,197,104,483,46400,16161
4,4,0,-,-,16172
6861,5085,1776,707,131900,16201
289,262,27,606,124000,16210
26,26,0,-,69000,16211
127,107,20,700,66800,16212
56,41,15,675,62500,16213
3194,1579,1615,710,155900,16214
53,44,9,-,-,16217
417,389,28,593,151300,16218
43,43,0,-,128900,16220
1019,884,135,572,122600,16222
46,40,6,-,98500,16223
385,327,58,758,117600,16224
3494,2630,864,721,96800,16226
143,121,22,840,77200,16228
2233,1751,482,739,177200,16229
191,147,44,693,79800,16230
1655,1205,450,653,121100,16232
436,371,65,848,146800,16233
521,469,52,827,170300,16235
125,113,12,-,95300,16236
158,127,31,631,145800,16238
520,433,87,709,90600,16239
619,485,134,648,144900,16240
1752,1284,468,636,114300,16242
151,130,21,-,75000,16244
124,82,42,542,56800,16245
64,45,19,1067,81900,16246
1234,930,304,618,92400,16248
795,631,164,883,139300,16249
147,96,51,890,49300,16250
64,30,34,593,75000,16253
1348,1098,250,827,128600,16254
695,533,162,638,125800,16255
437,405,32,790,122300,16256
758,474,284,654,138500,16258
864,713,151,574,114600,16259
164,150,14,-,135700,16260
1260,1048,212,886,147400,16262
117,117,0,-,97200,16263
6196,4354,1842,703,72400,16301
190,176,14,-,115000,16311
0,0,0,-,-,16312
782,633,149,597,86000,16313
2084,1771,313,710,135000,16314
2105,1793,312,757,140200,16316
565,458,107,1024,110800,16317
472,447,25,579,124600,16319
15,8,7,-,85000,16321
45,45,0,-,65400,16322
6382,4466,1916,649,104200,16323
97,77,20,-,134700,16326
971,854,117,666,122700,16327
93,65,28,675,79200,16328
173,156,17,-,80500,16329
32,28,4,-,210000,16331
17,13,4,-,137500,16332
110,102,8,-,57500,16333
199,158,41,487,190400,16334
11185,6823,4362,758,123000,16335
689,616,73,730,102200,16340
755,687,68,600,89500,16341
928,824,104,657,102200,16342
233,217,16,-,104400,16343
179,85,94,810,46900,16344
1469,1359,110,584,153200,16345
1494,989,505,698,122700,16346
644,524,120,529,99800,16347
871,736,135,653,134000,16350
733,567,166,519,84200,16351
74,63,11,-,69200,16352
1163,977,186,500,103700,16353
4406,3012,1394,570,85700,16354
525,411,114,592,137100,16360
17,12,5,-,-,16361
395,349,46,631,143300,16362
467,393,74,847,146900,16364
7676,5378,2298,682,100000,16365
88,80,8,-,151000,16370
1250,932,318,638,86900,16371
235,163,72,530,82600,16372
1223,1017,206,616,117500,16373
731,636,95,730,112200,16374
1597,1275,322,626,131700,16401
276,251,25,713,106900,16402
2264,1835,429,642,135100,16403
1186,973,213,803,127500,16404
227,206,21,783,100000,16405
1302,1066,236,807,123800,16406
4638,3373,1265,761,99300,16407
666,627,39,731,153800,16410
529,446,83,977,119900,16411
4141,2835,1306,828,189800,16412
3409,3120,289,1028,222400,16415
73,73,0,-,-,16416
3619,2592,1027,584,151900,16417
198,182,16,1083,81900,16420
954,582,372,666,177800,16421
85,85,0,-,115100,16422
1608,1369,239,739,126500,16423
1889,1596,293,672,105300,16424
1495,1234,261,686,174000,16426
77,54,23,542,82000,16427
4940,3646,1294,678,158700,16428
71,58,13,-,148800,16430
1873,1572,301,622,146300,16433
894,766,128,792,123600,16434
662,532,130,770,115600,16435
276,230,46,-,159200,16436
3041,2302,739,620,122000,16438
339,286,53,546,150000,16440
3707,3157,550,703,176200,16441
1103,933,170,881,160200,16442
427,393,34,-,131300,16443
0,0,0,-,-,16444
0,0,0,-,-,16475
1069,22,1047,363,-,16501
6770,2431,4339,769,75300,16502
5447,2000,3447,751,47300,16503
6542,4407,2135,863,91000,16504
7654,5780,1874,764,163600,16505
10020,7248,2772,995,189800,16506
3609,1136,2473,778,61600,16507
6812,4415,2397,749,99900,16508
11927,8192,3735,947,169400,16509
9892,7919,1973,783,133400,16510
4480,2939,1541,758,142600,16511
0,0,0,-,-,16546
0,0,0,-,-,16550
0,0,0,-,-,16563
13139,9143,3996,694,115800,16601
11685,7531,4154,754,106300,16602
965,842,123,911,140900,16611
650,621,29,575,123800,16613
69,50,19,-,74600,16616
1125,815,310,744,121000,16617
117,114,3,-,86100,16619
131,102,29,1188,97500,16620
259,216,43,695,125000,16621
45,41,4,-,123200,16622
205,184,21,845,141700,16623
86,75,11,588,126800,16624
1480,1110,370,775,129700,16625
855,756,99,625,77200,16627
2005,1454,551,642,118900,16630
18,18,0,-,179200,16631
106,92,14,-,77000,16633
124,110,14,1042,97100,16634
5197,4039,1158,941,156300,16635
331,308,23,1080,188800,16636
1093,890,203,932,114000,16637
22,20,2,-,150000,16638
563,532,31,548,108800,16639
355,335,20,925,106300,16640
1017,825,192,717,91700,16641
83,82,1,-,-,16645
908,793,115,604,90000,16646
301,250,51,636,259000,16647
6123,4678,1445,876,185400,16648
638,534,104,650,127300,16650
1397,1124,273,567,85200,16651
5449,3903,1546,726,158300,16652
9,7,2,-,-,16654
535,436,99,640,127000,16655
468,410,58,742,80700,16656
548,497,51,600,167100,16657
79,49,30,584,110200,16659
377,340,37,716,87100,16661
2148,1604,544,819,168400,16662
690,615,75,725,153300,16664
160,123,37,723,176700,16665
1301,1195,106,985,87400,16666
557,419,138,903,119800,16667
1415,1149,266,441,90700,16668
831,703,128,675,172800,16669
33,33,0,-,119300,16670
170,134,36,720,91000,16671
88,76,12,-,75000,16672
2064,1697,367,940,137000,16673
179,137,42,681,99000,16674
38,36,2,-,48000,16675
140,110,30,-,117800,16677
1010,814,196,562,110100,16678
258,218,40,535,67100,16679
130,114,16,-,79500,16680
56,52,4,-,62800,16682
130,116,14,-,157100,16683
26,26,0,-,-,16684
108,108,0,-,191000,16685
5474,3926,1548,719,145100,16686
161,152,9,-,163400,16689
140,132,8,-,178300,16691
346,283,63,725,118300,16692
1501,1234,267,623,128400,16693
121,111,10,-,90300,16694
341,296,45,789,144100,16695
0,0,0,-,-,16699
6682,4848,1834,700,83900,16701
477,409,68,713,81200,16720
41,37,4,-,-,16724
15,6,9,-,-,16725
223,170,53,719,100000,16726
55,23,32,-,75000,16727
289,233,56,680,95900,16729
52,46,6,-,45900,16730
1056,836,220,592,88900,16731
63,54,9,-,76300,16732
47,32,15,646,60000,16733
103,80,23,909,55000,16734
2531,1899,632,654,75800,16735
498,444,54,858,93300,16738
372,299,73,498,63600,16740
1482,1108,374,731,94400,16743
83,66,17,-,78900,16744
280,274,6,-,93900,16745
435,390,45,759,83500,16746
1022,776,246,630,86800,16748
1534,1198,336,763,95200,16749
274,260,14,875,65900,16750
16854,7597,9257,1102,314600,16801
84,0,84,1178,-,16802
10215,4708,5507,1166,344200,16803
434,394,40,544,165600,16820
92,92,0,-,-,16821
743,611,132,822,147700,16822
11127,7956,3171,882,216400,16823
124,110,14,-,84400,16825
187,172,15,-,163700,16826
1797,1485,312,1083,370500,16827
1972,1714,258,998,240600,16828
258,214,44,675,154000,16829
5567,3696,1871,682,102800,16830
116,105,11,921,167000,16832
2181,1755,426,649,112400,16833
237,221,16,-,191100,16834
90,80,10,617,150000,16835
470,415,55,617,94700,16836
45,45,0,-,82800,16837
749,575,174,786,103800,16838
153,131,22,-,99500,16839
129,119,10,-,69000,16840
2450,2076,374,911,172600,16841
243,201,42,677,74700,16843
939,850,89,942,179500,16844
303,286,17,563,109200,16845
95,72,23,-,120200,16847
98,74,24,593,150900,16848
68,68,0,-,159500,16849
567,402,165,-,260000,16851
115,92,23,554,126900,16852
143,88,55,781,-,16853
307,241,66,769,174700,16854
38,27,11,-,-,16855
34,34,0,-,-,16856
1561,1267,294,755,146500,16858
200,186,14,639,123800,16859
231,231,0,-,76800,16860
146,143,3,-,206100,16861
234,194,40,767,104600,16863
54,46,8,-,30800,16864
579,491,88,1120,230800,16865
3588,2423,1165,582,117700,16866
520,520,0,-,284400,16868
2701,2347,354,821,342100,16870
30,24,6,-,74700,16871
396,312,84,744,174000,16872
501,433,68,729,121900,16874
1480,1271,209,784,257700,16875
102,83,19,731,58100,16876
735,616,119,1108,267400,16877
732,643,89,924,116100,16878
156,125,31,612,72300,16879
1009,854,155,850,83400,16881
182,159,23,950,145100,16882
4413,3377,1036,724,196100,16901
34,32,2,-,70000,16910
87,79,8,725,131300,16911
856,605,251,857,119800,16912
911,811,100,817,206100,16914
2303,1707,596,719,138000,16915
474,369,105,717,157400,16917
727,509,218,688,110500,16920
258,236,22,670,162100,16921
759,535,224,762,117800,16922
525,467,58,818,119700,16923
1223,1067,156,695,155600,16925
386,305,81,940,149600,16926
198,173,25,838,105100,16927
546,409,137,680,115100,16928
933,720,213,786,134200,16929
451,370,81,865,179800,16930
306,220,86,-,203400,16932
2609,1637,972,726,170800,16933
471,374,97,858,169400,16935
893,689,204,760,144600,16936
47,47,0,-,212500,16937
340,316,24,725,169400,16938
120,101,19,963,88600,16939
24,13,11,-,87500,16940
32,30,2,-,88000,16941
300,245,55,730,113400,16942
181,140,41,725,177300,16943
1054,848,206,833,138800,16946
1654,1193,461,645,143900,16947
587,463,124,525,127300,16948
1293,1029,264,644,106100,16950
174,132,42,382,156500,17002
4231,3306,925,924,211400,17003
1616,1160,456,649,175400,17004
129,110,19,875,107800,17005
312,238,74,900,139100,17006
2107,1720,387,807,264400,17007
791,577,214,691,105100,17009
99,17,82,-,-,17010
13698,9200,4498,1166,222000,17011
14156,8786,5370,905,183000,17013
64,56,8,-,178600,17014
9405,7823,1582,1035,239500,17015
371,128,243,2552,140500,17016
643,545,98,625,149700,17017
1810,1545,265,873,198400,17018
7323,6080,1243,1004,237300,17019
3484,2770,714,789,182000,17020
452,348,104,700,170700,17021
12089,8049,4040,1200,233900,17022
1266,948,318,649,159000,17023
722,629,93,833,243100,17024
7199,5194,2005,966,201700,17025
1298,1185,113,958,210500,17026
216,214,2,-,181300,17027
1386,1235,151,965,207200,17028
94,84,10,-,47400,17029
293,128,165,670,167000,17030
3094,2635,459,725,171800,17032
6314,3475,2839,1110,275200,17033
1239,626,613,879,103300,17034
341,293,48,631,167900,17035
9024,6481,2543,1262,273200,17036
296,210,86,911,176900,17037
3343,2499,844,749,202100,17038
43,43,0,-,-,17039
884,696,188,825,198800,17040
68,68,0,-,-,17041
15485,10609,4876,934,174400,17042
2904,1652,1252,881,172400,17043
8849,5632,3217,711,102800,17044
1337,1069,268,682,184900,17045
11973,7422,4551,877,147900,17046
915,693,222,646,232600,17047
1458,1119,339,783,112500,17048
1042,779,263,714,145900,17049
16241,12565,3676,1236,287700,17050
1931,1590,341,759,151600,17051
551,470,81,819,125000,17052
2193,1782,411,918,183300,17053
77,63,14,-,112800,17054
17310,12348,4962,1189,219100,17055
13,8,5,-,-,17056
9726,6781,2945,1014,149100,17057
578,325,253,548,157800,17058
3016,2203,813,696,165800,17059
360,288,72,638,131300,17060
2852,2125,727,718,157800,17061
1481,1305,176,780,182300,17062
1327,1087,240,731,110300,17063
326,317,9,-,261400,17064
1552,1263,289,817,174200,17065
1998,1362,636,747,89000,17066
6007,4687,1320,974,182900,17067
1581,1306,275,845,180700,17068
129,85,44,760,179800,17069
7393,5681,1712,842,194100,17070
50,41,9,675,95000,17071
2003,1723,280,1024,210600,17073
2913,2205,708,720,170900,17074
62,45,17,850,63800,17075
37,37,0,-,-,17076
31,0,31,-,-,17077
9087,6193,2894,1056,227300,17078
109,95,14,717,95000,17080
172,153,19,-,121300,17081
1051,780,271,689,166900,17082
1775,1498,277,771,154900,17084
782,558,224,645,148100,17086
864,730,134,916,191800,17087
263,199,64,-,180900,17088
2326,2004,322,656,207700,17090
399,348,51,-,144500,17093
920,687,233,656,141300,17094
329,286,43,903,74900,17097
987,708,279,715,92400,17098
568,424,144,801,76900,17099
1681,90,1591,856,159400,17101
4381,1438,2943,907,148200,17102
4787,1746,3041,874,85500,17103
7446,2748,4698,840,77900,17104
10797,5995,4802,1088,162200,17109
10897,6918,3979,1188,165600,17110
14471,9715,4756,1150,185000,17111
15384,12802,2582,1198,245900,17112
4086,2639,1447,1018,115400,17113
0,0,0,-,-,17120
12214,5857,6357,930,169100,17201
11864,9746,2118,1006,222500,17202
83,64,19,-,195000,17210
187,165,22,-,115900,17211
211,196,15,867,190400,17212
245,210,35,700,165200,17213
505,264,241,722,222400,17214
66,60,6,-,216700,17215
42,37,5,-,160900,17217
246,228,18,-,-,17219
162,130,32,867,217900,17220
201,167,34,772,161200,17221
4493,3583,910,964,190100,17222
130,82,48,608,176700,17223
857,756,101,743,256000,17224
7927,6335,1592,1056,223000,17225
411,319,92,738,178100,17228
548,469,79,625,158600,17229
25,17,8,-,-,17232
2294,1662,632,708,150400,17233
252,120,132,1363,178600,17235
3022,2425,597,866,187400,17236
633,474,159,1108,156900,17237
740,547,193,746,187500,17238
65,49,16,725,196900,17239
1335,1106,229,1112,217500,17240
4342,3358,984,883,177800,17241
514,366,148,668,151300,17243
794,647,147,1083,166600,17244
193,193,0,-,-,17246
202,40,162,1420,-,17247
118,108,10,-,103100,17249
71,35,36,-,-,17250
23,19,4,-,172900,17251
1400,1036,364,951,168500,17252
126,113,13,713,96300,17253
203,203,0,-,216800,17254
450,381,69,777,136300,17255
11189,7464,3725,921,177000,17257
403,321,82,533,156000,17260
0,0,0,-,-,17261
336,255,81,698,198600,17262
235,161,74,-,162500,17263
928,782,146,639,149100,17264
162,126,36,820,143800,17265
167,119,48,750,168800,17266
1080,867,213,669,209100,17267
11613,8103,3510,967,190300,17268
192,113,79,480,182200,17271
1455,1287,168,1072,191200,17301
1071,800,271,-,222500,17302
138,96,42,817,156500,17303
1024,755,269,1065,217400,17304
187,162,25,986,160000,17306
2277,1802,475,904,191000,17307
724,595,129,1255,198000,17309
81,66,15,1080,135400,17311
4345,2544,1801,995,173400,17313
2059,1708,351,844,213000,17314
11016,9572,1444,953,171500,17315
3118,2691,427,949,237300,17316
174,150,24,775,146100,17317
148,93,55,1125,129400,17318
4172,3687,485,909,175100,17319
3122,2746,376,1122,242600,17320
875,775,100,1090,241700,17321
2364,2208,156,1156,207600,17322
45,18,27,990,112500,17323
1610,1326,284,741,183700,17324
10826,7931,2895,882,233800,17325
3145,2403,742,874,248000,17327
999,961,38,1063,270400,17329
21623,16440,5183,1002,190700,17331
2627,2181,446,1015,226000,17339
4304,3417,887,1086,232700,17340
178,122,56,-,275000,17342
95,95,0,-,344800,17343
1485,858,627,983,171600,17344
3470,2601,869,1046,169900,17345
2557,2282,275,1235,183600,17347
2935,2704,231,1333,290900,17349
5256,3812,1444,1068,190100,17350
549,472,77,1200,255000,17352
1121,895,226,1075,202700,17353
156,77,79,863,234400,17355
9080,6554,2526,932,193400,17356
2259,1974,285,845,232600,17360
2463,1858,605,960,250000,17361
5407,4490,917,1152,218900,17362
3319,2855,464,794,252500,17363
1482,1171,311,963,168900,17364
1094,975,119,692,240500,17365
2344,1939,405,1146,158200,17366
2471,2031,440,868,164700,17368
2365,2096,269,1058,186500,17370
138,128,10,1292,168800,17371
1502,1190,312,969,221100,17372
7286,2166,5120,846,60300,17401
13607,9651,3956,1145,212100,17402
14963,9482,5481,991,161400,17403
14699,10543,4156,1048,143000,17404
9271,7391,1880,1170,172500,17406
877,722,155,1606,228000,17407
9665,7010,2655,1282,189000,17408
1895,1109,786,1079,191500,17501
1058,936,122,918,178000,17502
39,39,0,-,163900,17504
427,266,161,1230,336500,17505
125,72,53,-,-,17506
58,12,46,-,-,17507
282,260,22,-,244900,17508
1359,975,384,989,252500,17509
7572,4807,2765,943,166600,17512
1965,1747,218,1147,264600,17516
5464,4447,1017,1013,218700,17517
495,339,156,975,258600,17518
2384,1659,725,1102,293500,17519
2041,1652,389,1231,205300,17520
13425,8519,4906,992,221200,17522
1968,1551,417,980,272000,17527
1296,900,396,1235,334200,17529
1227,1064,163,934,285100,17532
49,21,28,-,-,17534
737,500,237,1082,354000,17535
1078,946,132,763,289100,17536
3116,2654,462,897,227100,17538
3688,2382,1306,1182,253400,17540
17898,13255,4643,1161,259700,17543
8802,7227,1575,1040,216200,17545
3265,2435,830,973,187800,17547
197,110,87,-,170700,17550
3953,2117,1836,1356,215100,17551
8468,6027,2441,1138,225400,17552
2993,2168,825,1004,221900,17554
2027,1612,415,1060,300300,17555
5405,3957,1448,1123,239100,17557
1905,1490,415,908,215400,17560
1293,879,414,1125,290500,17562
1098,803,295,1029,251000,17563
819,784,35,1138,247400,17565
4284,3042,1242,1162,241200,17566
39,0,39,-,-,17568
2428,2217,211,1116,244100,17569
101,101,0,-,121400,17570
1274,899,375,825,291300,17572
0,0,0,-,-,17576
2380,1966,414,780,218400,17578
2152,1706,446,1103,253000,17579
42,26,16,-,-,17581
681,634,47,875,244300,17582
4287,2608,1679,1691,262300,17584
22670,17053,5617,1292,253300,17601
18345,10584,7761,1105,199500,17602
26716,16374,10342,1089,190100,17603
148,13,135,1430,-,17606
17634,9634,8000,835,141500,17701
4258,3115,1143,863,165500,17702
136,124,12,675,154700,17720
716,556,160,761,125400,17721
33,24,9,-,175000,17723
1857,1233,624,682,141000,17724
16,16,0,-,-,17727
2001,1698,303,732,194000,17728
52,43,9,758,110400,17729
51,11,40,-,-,17730
89,81,8,950,376300,17731
2736,2051,685,789,172500,17737
19,18,1,-,162500,17739
4575,3727,848,761,156200,17740
24,14,10,-,132100,17742
1129,923,206,780,172200,17744
7037,4153,2884,772,154400,17745
1010,793,217,850,180700,17747
63,61,2,-,103800,17748
126,72,54,761,160000,17749
29,0,29,-,-,17750
2727,2271,456,825,167000,17751
1739,1347,392,854,151000,17752
4976,3811,1165,863,211700,17754
4333,3498,835,866,183000,17756
423,399,24,867,163300,17758
241,234,7,-,91400,17760
242,220,22,1056,156200,17762
138,102,36,950,97100,17763
1077,735,342,615,66000,17764
406,353,53,941,171300,17765
142,129,13,613,176800,17768
20,20,0,-,360000,17769
1234,1102,132,738,170200,17771
963,845,118,661,191000,17772
429,343,86,883,195200,17774
96,95,1,-,156800,17776
2652,2021,631,727,160500,17777
47,37,10,475,152500,17778
18,18,0,-,-,17779
6588,4249,2339,670,121600,17801
644,530,114,750,176600,17810
612,440,172,673,150000,17812
728,567,161,789,162000,17813
1843,1556,287,873,180000,17814
11058,6914,4144,887,173600,17815
2140,1691,449,747,168200,17820
7674,5262,2412,828,200800,17821
5,5,0,-,-,17822
464,390,74,850,177500,17823
1553,1400,153,435,220000,17824
316,269,47,807,139900,17827
92,80,12,850,122900,17829
800,676,124,663,156700,17830
303,236,67,931,82100,17832
1488,1204,284,724,77600,17834
21,21,0,-,-,17835
66,47,19,685,213900,17836
6299,4223,2076,766,219100,17837
174,152,22,-,38700,17840
1663,1403,260,833,136400,17841
3259,2572,687,734,165500,17842
3801,2668,1133,852,194500,17844
642,513,129,748,163800,17845
1474,1156,318,679,178700,17846
4853,3081,1772,758,156900,17847
267,169,98,670,-,17850
3343,2345,998,679,58800,17851
1075,860,215,759,185600,17853
284,227,57,1028,172500,17855
1244,1047,197,796,175100,17856
3273,2503,770,789,154800,17857
31,31,0,-,197900,17858
1084,951,133,788,194600,17859
1031,965,66,-,200600,17860
83,78,5,-,144200,17861
135,59,76,765,107400,17862
674,557,117,764,203000,17864
23,13,10,-,131300,17865
3386,2646,740,697,71200,17866
63,59,4,-,154800,17867
429,387,42,788,213300,17868
5295,3739,1556,814,197300,17870
3964,2458,1506,634,67800,17872
718,468,250,846,167700,17876
551,495,56,625,170000,17878
36,0,36,867,-,17880
600,475,125,691,87600,17881
64,19,45,850,362500,17884
105,95,10,-,169500,17885
382,184,198,-,141500,17886
222,222,0,-,-,17887
195,179,16,-,79800,17888
963,831,132,1031,254700,17889
9608,6662,2946,729,104600,17901
132,127,5,-,114600,17920
2419,1916,503,649,109000,17921
1878,1774,104,897,206100,17922
193,120,73,529,63100,17923
128,112,16,1018,89200,17925
526,373,153,813,117000,17929
137,92,45,658,76000,17930
1951,1565,386,711,91800,17931
107,69,38,-,-,17933
94,90,4,-,26000,17934
710,553,157,705,37700,17935
377,290,87,645,93500,17936
1075,843,232,774,156400,17938
274,229,45,688,174700,17941
13,13,0,-,-,17943
83,76,7,-,97500,17944
156,126,30,-,-,17945
127,100,27,-,56600,17946
1686,988,698,848,31500,17948
97,63,34,-,35500,17949
141,141,0,-,134000,17951
100,94,6,-,61100,17952
156,121,35,593,75400,17953
2003,1154,849,647,62800,17954
140,136,4,-,151300,17957
570,448,122,604,60000,17959
1839,1532,307,836,191700,17960
2866,2229,637,785,175500,17961
3683,3015,668,768,162300,17963
278,229,49,-,157300,17964
829,671,158,665,83700,17965
906,782,124,641,150800,17967
76,60,16,850,180800,17968
1365,1092,273,765,65400,17970
4760,3489,1271,641,134000,17972
110,80,30,-,154200,17974
2438,1909,529,720,42800,17976
220,143,77,770,169400,17978
24,24,0,-,-,17979
1173,934,239,852,110200,17980
987,783,204,735,73400,17981
200,180,20,-,85000,17982
559,417,142,806,130900,17983
557,474,83,955,155900,17985
1983,1716,267,1233,227100,18011
0,0,0,-,-,18012
6797,5078,1719,1017,202400,18013
4446,3786,660,1052,221600,18014
11686,5697,5989,1060,175800,18015
16169,11017,5152,1316,250600,18017
13394,6971,6423,1117,174100,18018
7906,6877,1029,1453,279400,18020
243,129,114,790,152100,18030
4078,3021,1057,1577,294500,18031
3933,2875,1058,1021,174300,18032
3066,2802,264,1761,360200,18034
14,14,0,-,-,18035
5689,4976,713,1018,324600,18036
3083,2497,586,1102,209800,18037
1391,1323,68,1345,191300,18038
6428,5804,624,1496,287600,18040
2146,1577,569,1041,259800,18041
15971,8861,7110,1160,161500,18042
11617,9398,2219,1500,247500,18045
55,55,0,-,-,18046
7215,5291,1924,1136,233900,18049
1239,1096,143,963,358000,18051
11892,7615,4277,1248,198600,18052
948,754,194,1125,238000,18053
1701,1368,333,1160,358700,18054
4616,3545,1071,1219,232800,18055
416,303,113,1350,28600,18056
3593,3017,576,1261,173500,18058
366,333,33,-,323200,18059
10126,7984,2142,1632,292200,18062
126,85,41,-,185300,18063
10018,7792,2226,1048,295000,18064
163,158,5,-,168300,18065
2199,1903,296,953,259600,18066
7881,5922,1959,1100,210200,18067
2988,2551,437,1315,317700,18069
154,154,0,-,243200,18070
4563,2990,1573,843,165700,18071
2679,1954,725,1320,197500,18072
4080,3622,458,1179,278600,18073
2155,2098,57,1516,297700,18074
1264,848,416,1271,206200,18076
911,676,235,1205,336000,18077
2801,2335,466,1067,312200,18078
192,182,10,-,101600,18079
4444,3569,875,778,209500,18080
41,41,0,-,-,18081
248,202,46,1164,216100,18083
336,245,91,921,185900,18085
241,200,41,-,250500,18086
253,84,169,1184,150000,18087
3231,2802,429,1098,197400,18088
2203,1511,692,1022,237100,18091
1265,1115,150,1193,335700,18092
1931,166,1765,1004,110800,18101
17425,5305,12120,1037,110000,18102
18745,11639,7106,1173,188900,18103
17389,12207,5182,1348,253400,18104
2790,2245,545,1505,283000,18106
6966,3358,3608,1103,139400,18109
0,0,0,-,-,18195
11586,5959,5627,894,101300,18201
5071,3514,1557,803,140600,18202
2983,2524,459,1159,170700,18210
416,341,75,839,251100,18211
9,9,0,-,-,18212
766,733,33,757,152600,18214
448,320,128,1022,94400,18216
884,684,200,822,47800,18218
510,383,127,823,171300,18219
134,128,6,725,46600,18220
149,108,41,-,106700,18221
3570,3302,268,898,186800,18222
26,26,0,-,-,18223
2711,1953,758,762,90100,18224
0,0,0,-,-,18225
3653,3134,519,832,177700,18229
55,55,0,-,85400,18230
210,146,64,744,94700,18231
1722,836,886,812,42300,18232
335,180,155,-,-,18234
7827,5829,1998,838,180300,18235
1408,996,412,914,81500,18237
66,42,24,-,-,18239
1451,1045,406,732,103700,18240
238,175,63,1071,97100,18241
151,130,21,-,109200,18242
132,101,31,905,135600,18244
169,152,17,-,108200,18245
96,51,45,-,93900,18246
183,147,36,735,106000,18248
1434,1262,172,934,219100,18249
1222,923,299,1036,81900,18250
4623,3254,1369,732,126800,18252
347,236,111,980,86200,18254
1589,1269,320,729,134000,18255
79,59,20,-,54700,18256
9701,6792,2909,1210,194200,18301
6036,5172,864,1558,158200,18302
617,489,128,1449,178000,18321
909,749,160,1022,229000,18322
58,21,37,-,-,18323
3668,3114,554,1592,147700,18324
1022,802,220,1238,235800,18325
1420,1116,304,732,190000,18326
295,163,132,1079,227400,18327
3041,2690,351,1021,163700,18328
3102,2692,410,1397,183900,18330
176,130,46,-,167500,18331
942,826,116,1158,192300,18332
0,0,0,-,-,18333
1715,1390,325,1031,156000,18334
437,396,41,-,202300,18335
1578,1033,545,968,190200,18336
5837,4850,987,1199,230000,18337
36,36,0,-,-,18340
217,155,62,-,177500,18342
1668,1390,278,1223,245400,18343
1271,890,381,845,140400,18344
1070,990,80,1287,156500,18346
1538,1316,222,-,137200,18347
59,43,16,-,-,18349
393,393,0,-,178500,18350
175,88,87,1537,175000,18351
4608,3966,642,1326,218000,18353
518,451,67,1368,198100,18354
478,247,231,1720,251500,18355
32,32,0,-,-,18356
52,52,0,-,-,18357
10799,7638,3161,1167,221500,18360
421,277,144,760,161300,18370
269,229,40,-,174200,18371
928,689,239,1576,190700,18372
2798,2125,673,840,176200,18403
926,816,110,485,173300,18405
6141,4098,2043,746,120100,18407
8762,6954,1808,968,243400,18411
30,30,0,-,-,18413
2211,1873,338,1027,225700,18414
743,681,62,952,300300,18415
379,324,55,635,247200,18417
1770,1365,405,771,181800,18419
73,56,17,-,136700,18420
1927,1483,444,724,145800,18421
2041,1821,220,864,156700,18424
426,368,58,995,146900,18425
1527,1290,237,1040,209500,18426
5178,4265,913,1147,208700,18428
29,29,0,-,-,18430
5262,3681,1581,871,188100,18431
2940,2406,534,821,171000,18433
1693,1150,543,823,138600,18434
440,406,34,-,244900,18435
4717,4134,583,1039,183100,18436
77,59,18,-,198400,18437
562,548,14,-,281000,18438
166,153,13,875,192300,18439
20,20,0,-,-,18440
172,119,53,728,350000,18441
141,116,25,-,288600,18443
5364,4428,936,885,227600,18444
924,777,147,921,220300,18445
1379,1131,248,769,165500,18446
4369,3155,1214,871,157300,18447
238,212,26,-,275000,18451
2301,1694,607,924,161100,18452
463,396,67,1045,237200,18453
51,45,6,-,319600,18454
53,41,12,-,-,18455
113,94,19,880,261500,18456
32,32,0,-,230800,18457
1455,1368,87,1043,236600,18458
82,64,18,1292,158300,18460
131,116,15,938,153800,18461
214,191,23,950,165100,18462
86,68,18,-,260000,18463
592,541,51,1397,235300,18464
492,400,92,836,200000,18465
5753,4206,1547,1489,134200,18466
165,159,6,-,331900,18469
793,702,91,850,175500,18470
207,203,4,-,317500,18471
1520,1122,398,821,203800,18472
179,142,37,-,111300,18473
577,24,553,781,-,18503
8507,5134,3373,840,112200,18504
8360,4533,3827,817,111500,18505
2132,1464,668,869,186400,18507
4771,2225,2546,870,99000,18508
5275,2460,2815,850,145500,18509
4822,1903,2919,869,147800,18510
5678,3787,1891,790,155700,18512
2139,1475,664,889,150500,18517
3688,2443,1245,797,144400,18518
2280,1443,837,818,143500,18519
140,134,6,1375,295200,18602
8364,6099,2265,688,133700,18603
1322,1175,147,1059,181200,18610
6148,4858,1290,1071,213500,18612
888,688,200,675,167600,18614
747,637,110,900,181300,18615
304,242,62,525,178700,18616
696,414,282,691,73300,18617
1569,1297,272,1328,184600,18618
59,47,12,1688,132800,18619
1950,1782,168,943,159000,18621
55,55,0,-,135800,18622
944,718,226,846,147300,18623
256,249,7,-,255000,18624
57,45,12,-,242500,18625
180,170,10,750,230400,18626
0,0,0,-,-,18627
97,91,6,-,92500,18628
775,598,177,958,184800,18629
1101,833,268,779,211200,18630
435,337,98,1261,156500,18631
188,137,51,695,102700,18632
5515,3509,2006,717,86700,18634
1487,1229,258,824,165800,18635
626,510,116,914,121300,18636
6839,4037,2802,795,121300,18640
2955,1999,956,824,119000,18641
1763,1340,423,826,123800,18642
5696,4092,1604,843,142200,18643
3425,2450,975,780,156000,18644
3818,2229,1589,758,82600,18651
2318,1947,371,864,171800,18655
879,812,67,855,175000,18656
4480,3352,1128,853,177200,18657
1360,1234,126,785,162400,18660
2039,1744,295,1025,147800,18661
1051,132,919,821,159400,18701
17152,9609,7543,858,93300,18702
13420,7883,5537,805,127300,18704
6442,4163,2279,803,101100,18705
6792,4434,2358,703,96100,18706
6010,5457,553,732,220900,18707
3719,3190,529,937,186900,18708
1471,878,593,636,93500,18709
3140,2359,781,820,199900,18801
2784,1758,1026,720,153300,18810
617,538,79,971,211500,18812
80,71,9,-,111300,18814
23,18,5,-,141700,18816
39,39,0,-,204200,18817
529,404,125,683,185000,18818
34,34,0,-,-,18820
465,324,141,881,153000,18821
1317,1004,313,714,133400,18822
75,56,19,-,140900,18823
476,420,56,775,176600,18824
73,68,5,-,215400,18825
605,548,57,962,221700,18826
108,103,5,-,212500,18828
284,235,49,850,176600,18829
243,191,52,865,176800,18830
422,322,100,709,161500,18831
724,596,128,830,120600,18832
835,671,164,831,166100,18833
1228,913,315,905,187700,18834
1013,839,174,912,162000,18837
4322,2780,1542,747,143800,18840
56,47,9,-,164100,18842
92,84,8,-,99000,18843
639,557,82,872,220800,18844
171,144,27,1063,195000,18845
264,242,22,1045,216700,18846
2026,1534,492,784,122100,18847
3648,2524,1124,781,157100,18848
828,668,160,879,158100,18850
255,213,42,1071,147500,18851
1684,1334,350,751,181500,18853
621,496,125,854,180100,18854
10681,7635,3046,1544,462900,18901
7892,7310,582,1697,536100,18902
107,80,27,-,"2,000,000+",18912
74,74,0,-,1144200,18913
7757,6571,1186,1695,402700,18914
464,372,92,1771,414100,18915
969,560,409,1167,286800,18917
148,82,66,1456,-,18920
114,114,0,-,354900,18921
496,416,80,1805,401900,18923
2171,2024,147,2690,517900,18925
144,36,108,-,-,18927
3352,3181,171,1392,531000,18929
931,807,124,1493,426300,18930
124,108,16,-,348400,18932
57,49,8,-,895800,18933
113,113,0,-,270400,18935
79,79,0,-,222900,18936
6380,5578,802,1698,606000,18938
11527,9772,1755,1759,512400,18940
1054,939,115,1095,452600,18942
9845,7930,1915,1211,334900,18944
141,128,13,-,650000,18946
2398,2244,154,1388,472000,18947
30,30,0,-,-,18950
13960,11382,2578,1212,280300,18951
3598,3533,65,1600,460700,18954
530,397,133,905,243100,18955
4729,3712,1017,1325,307200,18960
117,93,24,681,301400,18962
5200,3762,1438,1158,290300,18964
14215,12193,2022,1477,376600,18966
6250,5046,1204,1214,302600,18969
313,218,95,952,238700,18970
1341,1201,140,1438,399000,18972
17264,12793,4471,1512,341000,18974
8178,6646,1532,1459,421400,18976
1758,1593,165,1328,630300,18977
71,52,19,-,750000,18980
6407,5189,1218,1137,282500,19001
11486,8976,2510,1328,443500,19002
5985,3982,2003,1422,348500,19003
3971,3104,867,1635,545200,19004
8472,6417,2055,1307,433400,19006
8963,5291,3672,989,210100,19007
7006,6023,983,1397,384200,19008
355,257,98,1383,551300,19009
7728,5005,2723,1750,670500,19010
2219,1889,330,990,249500,19012
12551,4490,8061,924,72200,19013
7771,6714,1057,1341,252700,19014
6773,5084,1689,1105,188400,19015
74,74,0,-,500000,19017
9603,6218,3385,1150,167300,19018
22290,12878,9412,1301,290300,19020
3777,2710,1067,1135,218900,19021
1499,611,888,1049,106300,19022
7809,4185,3624,1130,96900,19023
2346,1948,398,2345,466800,19025
12387,8260,4127,1126,195800,19026
8075,5010,3065,1224,288700,19027
1569,977,592,1132,146000,19029
4709,3532,1177,1156,276500,19030
1858,1449,409,1406,427200,19031
2489,1724,765,1381,117800,19032
2772,2111,661,1353,222900,19033
2418,1823,595,1300,522300,19034
1455,1172,283,1726,1125700,19035
5016,3843,1173,1128,151000,19036
11544,9791,1753,1214,320000,19038
8045,5804,2241,1369,311700,19040
2569,1669,900,1976,797700,19041
1031,772,259,951,219700,19043
6618,3689,2929,1324,301600,19044
7640,5239,2401,1351,363200,19046
12462,9156,3306,1544,374100,19047
12082,7079,5003,1054,154700,19050
284,268,16,-,311000,19052
10521,8879,1642,1232,310800,19053
6521,5217,1304,1293,256100,19054
4755,3962,793,1294,218300,19055
5909,4196,1713,1238,295500,19056
6008,4754,1254,1224,238100,19057
3657,3590,67,-,437800,19060
7731,4921,2810,1075,203700,19061
15221,10314,4907,1459,418800,19063
8563,7932,631,1379,329200,19064
1689,1575,114,1846,677700,19066
20503,16527,3976,1288,391500,19067
2885,2110,775,1111,237200,19070
4357,3182,1175,1621,659200,19072
8302,6391,1911,1696,464700,19073
2251,1626,625,1099,184800,19074
2860,2507,353,1169,347100,19075
2581,1564,1017,1076,195600,19076
4593,3392,1201,1103,199300,19078
3477,2165,1312,1181,121400,19079
3767,3077,690,1187,294700,19081
15894,7667,8227,1055,121400,19082
13330,11838,1492,1194,349400,19083
1870,1797,73,"3,500+",857700,19085
4721,4212,509,1397,350300,19086
12157,8763,3394,1769,598000,19087
7602,5223,2379,1346,277600,19090
1821,1202,619,971,187800,19094
3316,1998,1318,1561,365700,19095
5805,4345,1460,1934,572900,19096
3425,885,2540,2179,452400,19102
16337,4960,11377,1836,514700,19103
18053,3629,14424,1092,202200,19104
8155,3911,4244,1930,537100,19106
8459,1541,6918,1429,412300,19107
57,48,9,-,-,19108
0,0,0,-,-,19109
25828,14305,11523,1126,198200,19111
0,0,0,-,-,19112
0,0,0,-,-,19113
13553,9062,4491,1225,223700,19114
14642,8986,5656,1100,269200,19115
13402,7663,5739,1087,270500,19116
4875,2356,2519,1635,544100,19118
12564,8076,4488,1103,288200,19119
24592,15519,9073,1049,113000,19120
14597,4645,9952,1005,168700,19121
7814,3265,4549,955,262700,19122
8978,2802,6176,1487,446400,19123
24377,15085,9292,945,111900,19124
11422,6867,4555,1559,295500,19125
6704,4033,2671,1020,162300,19126
2830,1175,1655,1656,275100,19127
18018,10225,7793,1420,267200,19128
5149,2524,2625,1435,260500,19129
15446,5901,9545,1647,424600,19130
18164,8612,9552,1159,132800,19131
14384,7185,7199,907,61700,19132
9461,3888,5573,807,64800,19133
21942,12118,9824,1046,94700,19134
13379,7983,5396,1088,140600,19135
13124,7936,5188,966,164700,19136
3236,2605,631,1117,168800,19137
12492,7818,4674,1000,134300,19138
18957,7677,11280,953,93500,19139
20384,10275,10109,967,75700,19140
14413,7331,7082,920,112200,19141
10908,5098,5810,1099,86200,19142
26259,12820,13439,1072,113000,19143
19792,7181,12611,980,163000,19144
18976,11237,7739,1194,227900,19145
18101,9586,8515,1419,398500,19146
18970,10837,8133,1385,445000,19147
20449,13302,7147,1255,240500,19148
19381,11217,8164,1285,149100,19149
10003,7852,2151,1160,183300,19150
12766,8159,4607,998,147800,19151
13456,7969,5487,1078,221800,19152
5682,2921,2761,1273,155900,19153
12760,9867,2893,1304,222200,19154
2913,2381,532,1632,442500,19301
934,723,211,1193,240500,19310
3414,2773,641,1300,431400,19311
4318,3673,645,1506,711600,19312
13,13,0,-,-,19316
4012,3346,666,1836,502800,19317
76,76,0,-,595600,19319
19960,14605,5355,1260,252200,19320
2005,1780,225,1044,341700,19330
3055,1917,1138,1654,694400,19333
19489,15607,3882,1319,383200,19335
8182,4536,3646,1801,417500,19341
7833,5632,2201,2045,462000,19342
2832,2410,422,1595,438900,19343
4576,3339,1237,1188,277100,19344
0,0,0,-,-,19345
8939,6252,2687,1217,419800,19348
3853,3505,348,1368,421600,19350
3028,2823,205,1152,382900,19352
10707,7999,2708,1773,556100,19355
129,32,97,1108,205600,19358
2068,1675,393,948,233100,19362
5783,4045,1738,1168,286700,19363
2729,2042,687,1179,232700,19365
22,22,0,-,-,19367
52,7,45,-,-,19369
865,507,358,1848,268500,19372
683,683,0,-,637100,19373
244,214,30,1016,266400,19374
64,54,10,-,-,19375
20741,14926,5815,1626,441900,19380
20216,14188,6028,1558,447100,19382
126,0,126,1093,-,19383
4652,3631,1021,1011,318500,19390
16862,7629,9233,1185,186300,19401
18542,13447,5095,1459,296300,19403
2022,984,1038,1339,230400,19405
12322,6809,5513,1671,331800,19406
7698,6239,1459,1856,479700,19422
5718,5275,443,2314,512100,19425
12968,11496,1472,1650,390700,19426
9270,5012,4258,1709,365200,19428
45,37,8,-,198100,19435
369,113,256,"3,500+",-,19436
379,379,0,-,820500,19437
9236,7328,1908,1640,369900,19438
7524,5137,2387,1216,325900,19440
0,0,0,-,-,19442
4764,3513,1251,1897,424800,19444
23608,15705,7903,1452,349300,19446
722,431,291,1577,233400,19453
11178,8791,2387,1451,352700,19454
71,71,0,-,351600,19456
49,49,0,-,203300,19457
17208,12131,5077,1365,350900,19460
6347,5129,1218,1664,377700,19462
18586,11970,6616,1096,181600,19464
7244,5754,1490,1159,316700,19465
10572,7952,2620,1524,295400,19468
39,23,16,-,-,19472
6424,5571,853,1269,359300,19473
215,190,25,-,243500,19474
4814,3345,1469,884,281400,19475
26,26,0,-,-,19477
115,115,0,-,-,19490
409,89,320,-,375000,19492
438,330,108,907,185200,19501
452,327,125,1034,186600,19503
1921,1715,206,971,282400,19504
1522,1234,288,1118,237200,19505
2478,2126,352,982,251900,19506
1191,962,229,889,221000,19507
6084,5011,1073,922,201700,19508
3320,2962,358,1184,222200,19510
54,54,0,-,201800,19511
6876,5063,1813,1050,202000,19512
92,33,59,781,162500,19516
5810,4938,872,1395,267100,19518
2484,2089,395,968,317900,19520
5560,4714,846,943,219100,19522
0,0,0,-,-,19523
5598,5135,463,1126,321500,19525
4728,3563,1165,977,166500,19526
1183,1044,139,1131,260200,19529
4748,3160,1588,950,217700,19530
2410,2106,304,855,225700,19533
761,647,114,850,230100,19534
19,0,19,-,-,19535
248,175,73,926,135300,19536
33,25,8,-,241700,19538
1581,1386,195,1366,216700,19539
4246,3488,758,919,249400,19540
1610,1451,159,1109,247100,19541
2023,1755,268,1015,287200,19543
60,60,0,-,162500,19544
212,161,51,-,115100,19545
1904,1629,275,1113,258800,19547
125,89,36,1135,97500,19549
158,125,33,-,143800,19550
1757,1466,291,895,199800,19551
156,77,79,876,192500,19554
1393,1032,361,932,176200,19555
115,97,18,825,124700,19559
3806,3107,699,1201,147800,19560
1283,624,659,902,167900,19562
59,32,27,-,-,19564
3388,2718,670,1110,191300,19565
2089,1578,511,1016,192000,19567
12390,4782,7608,804,81900,19601
6805,2169,4636,783,61600,19602
9581,4387,5194,913,90600,19604
7702,6364,1338,1154,176900,19605
13771,10790,2981,1112,189800,19606
9592,6204,3388,1132,168100,19607
8662,6847,1815,1375,256100,19608
4114,3479,635,1280,178100,19609
6783,4765,2018,1413,271100,19610
4270,2044,2226,958,131100,19611
16192,12276,3916,1536,289800,19701
20724,12384,8340,1367,276000,19702
6622,3324,3298,1139,224200,19703
679,473,206,1217,198500,19706
6261,5303,958,2046,449400,19707
16880,14655,2225,1424,355800,19709
17,17,0,-,-,19710
19358,12523,6835,1298,304400,19711
11809,7369,4440,1188,223400,19713
0,0,0,-,-,19716
0,0,0,-,-,19717
22685,15417,7268,1208,203800,19720
168,145,23,1250,301500,19730
114,106,8,-,-,19731
132,132,0,-,627900,19732
76,57,19,-,218500,19733
4271,3963,308,1353,350900,19734
0,0,0,-,-,19735
13,13,0,-,-,19736
7463,2011,5452,959,148400,19801
10740,4900,5840,1087,159100,19802
8523,7596,927,1367,376800,19803
7443,5489,1954,1157,204200,19804
16059,8730,7329,1109,181900,19805
5932,2998,2934,1158,324700,19806
3379,2365,1014,1401,739500,19807
15263,11769,3494,1218,268400,19808
6198,4369,1829,1269,260700,19809
10266,8244,2022,1238,354700,19810
14103,7996,6107,1210,209300,19901
0,0,0,-,-,19902
14513,8990,5523,1133,233800,19904
1405,1380,25,1319,660700,19930
162,158,4,-,212800,19931
3712,2884,828,845,205400,19933
4745,3997,748,1233,258000,19934
115,56,59,939,113500,19936
3001,2416,585,1430,264300,19938
3078,2853,225,1027,297100,19939
2144,1657,487,852,210600,19940
1014,770,244,1098,182000,19941
5032,4241,791,1070,237200,19943
298,279,19,529,875000,19944
3324,2909,415,1226,317000,19945
2010,1694,316,1150,199300,19946
6629,4466,2163,1110,233900,19947
3016,2185,831,1178,232100,19950
814,778,36,1588,308900,19951
3854,2678,1176,1028,227300,19952
1731,1367,364,1056,222000,19953
599,433,166,1197,234100,19954
97,83,14,-,216200,19955
5625,3802,1823,799,186900,19956
13249,10950,2299,1459,393100,19958
2489,2104,385,1079,215300,19960
4142,3747,395,1135,288100,19962
8432,5482,2950,1042,244300,19963
541,531,10,-,275300,19964
13797,11543,2254,1178,224400,19966
924,856,68,2131,365400,19967
5547,4829,718,1255,336900,19968
3666,3343,323,1339,386700,19970
7240,6298,942,1389,435100,19971
9659,7294,2365,918,211500,19973
4395,3763,632,1123,356000,19975
8546,6869,1677,1310,247200,19977
269,218,51,1276,205400,19979
100,90,10,-,-,19980
22974,7875,15099,2269,753100,20001
31832,12230,19602,1856,694600,20002
15993,6770,9223,2395,838900,20003
1270,508,762,2551,595500,20004
8802,2469,6333,1961,580200,20005
637,49,588,1762,-,20006
11668,6465,5203,1921,1064400,20007
16989,6229,10760,2038,840900,20008
28382,9334,19048,2005,671700,20009
14255,5649,8606,1654,743300,20010
26989,13980,13009,1436,619100,20011
6784,4072,2712,1419,697400,20012
6072,4695,1377,1767,1051900,20015
14092,9206,4886,2018,1053100,20016
8108,4953,3155,1606,588700,20017
8858,4998,3860,1065,571500,20018
26184,10270,15914,1097,361400,20019
23071,7678,15393,1158,362100,20020
8939,3246,5693,1749,452200,20024
17796,4028,13768,1175,335600,20032
3664,1606,2058,2083,378100,20036
6696,2410,4286,2135,674300,20037
0,0,0,-,-,20045
0,0,0,-,-,20052
0,0,0,-,-,20057
0,0,0,-,-,20059
0,0,0,-,-,20064
9366,8282,1084,2520,634200,20105
1631,1438,193,1469,388200,20106
14582,6322,8260,1753,321800,20109
15263,10980,4283,1677,366500,20110
11025,7108,3917,1776,380700,20111
8894,8509,385,2234,489800,20112
2713,1817,896,1478,496000,20115
1407,954,453,1328,805700,20117
1208,961,247,1578,521000,20119
14167,10636,3531,1900,503700,20120
9458,6615,2843,1959,408300,20121
5052,4594,458,1927,701400,20124
213,188,25,-,1097700,20129
107,66,41,1519,364300,20130
5710,5124,586,1800,589100,20132
1417,1143,274,1339,436000,20135
8977,8220,757,2563,469800,20136
718,686,32,-,536000,20137
2555,2282,273,1114,520300,20141
231,214,17,-,730200,20143
610,546,64,996,503000,20144
23624,16440,7184,2090,555200,20147
18902,15306,3596,2329,658100,20148
6681,5278,1403,1885,542500,20151
10964,9172,1792,2510,585100,20152
12052,10307,1745,2364,505900,20155
1484,1226,258,-,613300,20158
12583,9515,3068,2007,420200,20164
11926,9384,2542,2196,548500,20165
4672,2501,2171,2040,459100,20166
8820,8165,655,2535,576600,20169
13764,9778,3986,1936,526100,20170
17812,10331,7481,2025,650900,20171
11500,8703,2797,1815,578300,20175
16563,12445,4118,1826,570200,20176
2573,2288,285,1710,542700,20180
2978,2633,345,1434,566500,20181
209,102,107,-,367900,20184
5889,3926,1963,1448,405100,20186
6241,5451,790,1795,476300,20187
10301,4943,5358,2040,495100,20190
11898,8419,3479,1834,521500,20191
5638,4004,1634,2087,650900,20194
915,837,78,-,838800,20197
760,525,235,1481,472500,20198
0,0,0,-,-,20204
0,0,0,-,-,20220
0,0,0,-,-,20230
0,0,0,-,-,20240
0,0,0,-,-,20245
0,0,0,-,-,20250
0,0,0,-,-,20260
0,0,0,-,-,20317
0,0,0,-,-,20319
49,0,49,-,-,20373
0,0,0,-,-,20388
0,0,0,-,-,20390
0,0,0,-,-,20408
0,0,0,-,-,20415
0,0,0,-,-,20418
0,0,0,-,-,20422
0,0,0,-,-,20427
0,0,0,-,-,20431
0,0,0,-,-,20510
0,0,0,-,-,20515
0,0,0,-,-,20520
0,0,0,-,-,20530
0,0,0,-,-,20535
0,0,0,-,-,20540
0,0,0,-,-,20542
0,0,0,-,-,20551
0,0,0,-,-,20560
0,0,0,-,-,20565
0,0,0,-,-,20566
0,0,0,-,-,20591
9544,7369,2175,1806,321200,20601
10426,6821,3605,1674,284200,20602
10944,8494,2450,1773,360600,20603
52,52,0,-,465000,20606
3932,3791,141,1484,423500,20607
264,242,22,1683,339000,20608
508,471,37,1425,331300,20609
429,395,34,-,348400,20611
69,69,0,-,-,20612
5058,4755,303,1853,411600,20613
223,223,0,-,395900,20615
2468,2149,319,2174,286200,20616
198,171,27,-,441500,20617
389,339,50,1353,272900,20618
5160,3149,2011,1663,308700,20619
520,433,87,1220,245400,20620
396,381,15,-,444800,20621
1609,1467,142,1347,370300,20622
830,796,34,-,351900,20623
306,291,15,-,418200,20624
444,380,64,-,206800,20625
109,109,0,-,-,20626
257,207,50,1277,425700,20628
332,290,42,-,408800,20629
167,101,66,-,465300,20630
131,109,22,-,423600,20632
2915,1832,1083,1532,284200,20634
3349,2991,358,1196,408200,20636
2035,1872,163,2548,450100,20637
4705,4319,386,1139,449500,20639
4042,3012,1030,1537,268500,20640
268,256,12,-,398000,20645
7001,5862,1139,1556,368900,20646
5158,3836,1322,1509,402600,20650
10367,5754,4613,1432,276200,20653
50,41,9,-,-,20656
7253,6206,1047,1512,266900,20657
394,317,77,1350,253300,20658
7984,6970,1014,1438,323500,20659
0,0,0,-,-,20660
0,0,0,-,-,20661
923,824,99,1238,341300,20662
1254,902,352,1716,338500,20664
180,170,10,-,235100,20667
298,0,298,1836,-,20670
297,212,85,1575,294600,20674
694,665,29,-,323900,20675
1175,1022,153,1750,379800,20676
786,699,87,1133,477900,20677
4506,3543,963,915,357900,20678
225,204,21,-,319300,20680
339,256,83,892,320000,20684
2460,2290,170,1643,351600,20685
0,0,0,-,-,20686
208,142,66,-,370000,20687
716,408,308,3034,465600,20688
629,591,38,-,351300,20689
329,254,75,1445,455000,20690
216,216,0,-,365800,20692
350,326,24,-,394600,20693
4073,3251,822,1901,368100,20695
260,0,260,2271,-,20701
8958,5816,3142,1655,362300,20705
13111,9165,3946,1673,341600,20706
13525,7600,5925,1705,335900,20707
10279,3649,6630,1652,354700,20708
3497,678,2819,1468,296100,20710
2272,2141,131,1139,355500,20711
4592,1160,3432,1362,426800,20712
1660,1176,484,1733,291000,20714
8996,8353,643,2279,355200,20715
8805,6384,2421,1876,335400,20716
8147,7490,657,2596,451400,20720
10364,9132,1232,2564,444200,20721
2135,1444,691,1552,318000,20722
11878,8689,3189,1799,425600,20723
6962,4301,2661,2027,334100,20724
4069,3221,848,1663,376300,20732
1085,939,146,1794,339200,20733
13117,12045,1072,1821,337000,20735
3363,3155,208,1424,455000,20736
6492,3386,3106,1405,308300,20737
11182,4698,6484,1553,351600,20740
0,0,0,-,-,20742
15013,9953,5060,1411,252700,20743
19724,16000,3724,1638,355900,20744
11674,4870,6804,1404,279400,20745
12447,4465,7982,1581,255000,20746
16493,8114,8379,1434,271900,20747
16075,8788,7287,1398,294000,20748
928,861,67,1540,414400,20751
2277,2048,229,2204,484800,20754
2943,100,2843,2230,416700,20755
240,225,15,-,484700,20758
1903,1837,66,"3,500+",693100,20759
841,0,841,2467,-,20762
1093,516,577,1509,366700,20763
1444,1266,178,2196,321800,20764
188,134,54,1397,541700,20765
2173,2051,122,2401,446500,20769
12019,5482,6537,1714,236800,20770
0,0,0,-,-,20771
18915,16548,2367,1834,358700,20772
20011,15221,4790,1932,354500,20774
1121,1051,70,1382,496000,20776
1156,1133,23,-,753600,20777
809,750,59,1899,632800,20778
514,497,17,-,479500,20779
4291,2470,1821,1551,380900,20781
12286,5497,6789,1575,364600,20782
13533,5645,7888,1535,337500,20783
10120,5884,4236,1624,288500,20784
15401,7901,7500,1599,292900,20785
3963,2647,1316,1731,338800,20794
99,90,9,2250,880000,20812
13429,7127,6302,2063,845400,20814
13233,8552,4681,2237,1066300,20815
6373,5154,1219,2439,990100,20816
13619,11275,2344,2664,938800,20817
755,712,43,2797,1046100,20818
8485,7409,1076,2044,509400,20832
2615,2442,173,2200,651700,20833
2229,2006,223,1864,540100,20837
90,90,0,-,592600,20838
62,32,30,-,-,20839
2920,2804,116,2600,604900,20841
661,523,138,1412,633900,20842
20766,11165,9601,2024,603600,20850
5168,3116,2052,1819,423100,20851
21414,8969,12445,2019,538300,20852
9794,8185,1609,1965,478200,20853
17030,15289,1741,2754,950400,20854
6140,4877,1263,2146,552700,20855
746,556,190,1718,-,20860
1135,1120,15,-,758200,20861
155,155,0,-,800300,20862
5006,4037,969,1946,378400,20866
156,140,16,-,653800,20868
8185,7072,1113,2168,528800,20871
4510,3988,522,1544,396300,20872
22011,14507,7504,1777,341200,20874
8598,5500,3098,1952,392200,20876
12496,5388,7108,1727,395200,20877
24477,16607,7870,1905,582600,20878
8836,6243,2593,1768,367000,20879
319,306,13,-,493500,20880
4657,4577,80,1750,582300,20882
12305,8297,4008,1718,323000,20886
0,0,0,-,-,20889
0,0,0,-,-,20892
0,0,0,-,-,20894
7082,5801,1281,1804,664700,20895
336,324,12,-,872300,20896
217,0,217,938,-,20899
13012,9184,3828,1642,479000,20901
17776,11316,6460,1880,425700,20902
7211,2931,4280,1709,407100,20903
20706,10792,9914,1780,432800,20904
5564,4768,796,1792,538200,20905
25547,16790,8757,1755,363700,20906
21332,7416,13916,1813,601100,20910
9738,4025,5713,1268,583500,20912
10275,6805,3470,1173,228100,21001
758,13,745,1816,-,21005
12367,10018,2349,1460,283200,21009
103,0,103,1875,-,21010
8136,6926,1210,1884,458800,21012
1855,1715,140,954,468000,21013
14270,10981,3289,1316,341700,21014
10916,9773,1143,1502,366900,21015
2384,1580,804,1654,195200,21017
30,24,6,-,-,21023
965,827,138,1632,396800,21028
3964,3647,317,2932,768900,21029
10843,4991,5852,1392,384400,21030
18,0,18,-,-,21031
2902,2532,370,1734,496100,21032
1203,1076,127,996,279200,21034
2897,2788,109,-,678600,21035
744,710,34,-,707800,21036
7981,6732,1249,1909,429500,21037
9162,6417,2745,1254,183000,21040
14748,12551,2197,1872,604600,21042
17098,11831,5267,1744,520300,21043
18237,11315,6922,1830,440600,21044
15307,10837,4470,1500,372600,21045
6189,3548,2641,1893,386200,21046
4643,4498,145,2159,431400,21047
3715,3427,288,1209,376500,21048
6399,5772,627,1498,384500,21050
63,63,0,-,362500,21051
249,179,70,-,279900,21052
1123,1026,97,2067,379400,21053
4946,4029,917,2054,502500,21054
127,127,0,-,1858900,21056
1614,1389,225,895,521300,21057
15007,11269,3738,1418,294700,21060
22311,12466,9845,1470,271600,21061
158,127,31,-,354900,21071
6005,5187,818,971,300000,21074
12322,8118,4204,1847,368300,21075
7932,5329,2603,2080,392900,21076
43,43,0,-,332800,21077
8004,5977,2027,1121,302200,21078
272,260,12,-,465000,21082
2675,2418,257,1222,392700,21084
6451,5120,1331,1324,282600,21085
2197,1962,235,-,421000,21087
3703,3129,574,1656,331900,21090
15769,12510,3259,1424,395800,21093
4342,4007,335,1146,335700,21102
2030,1919,111,-,581900,21104
0,0,0,-,-,21105
6092,5260,832,1766,463100,21108
1854,1784,70,-,521700,21111
14974,8988,5986,1981,341000,21113
9334,7284,2050,1865,399800,21114
23142,12902,10240,1648,314400,21117
2427,2308,119,1704,487800,21120
22734,19524,3210,1778,358200,21122
5437,4585,852,1488,362200,21128
21,0,21,-,-,21130
2696,2607,89,2100,569500,21131
1007,998,9,-,429700,21132
11674,7905,3769,1358,254500,21133
13746,10550,3196,1265,328900,21136
1474,1421,53,1914,491500,21140
12781,10550,2231,1704,390600,21144
9990,9028,962,1444,568700,21146
2651,1961,690,1659,422000,21152
318,299,19,-,852100,21153
2429,2262,167,1253,351600,21154
978,791,187,1458,438400,21155
126,126,0,-,351900,21156
14410,10826,3584,1073,344200,21157
8355,6489,1866,1633,332900,21158
984,764,220,-,343800,21160
2125,1936,189,1282,370100,21161
1423,1247,176,-,408900,21162
2535,2052,483,1241,511200,21163
10068,1181,8887,1167,254800,21201
10095,2240,7855,1261,257100,21202
8363,4258,4105,1712,449300,21204
5265,1827,3438,1012,50300,21205
20047,10975,9072,1069,172600,21206
19360,11850,7510,1197,211500,21207
15289,10342,4947,1438,262100,21208
11511,6915,4596,1430,356400,21209
5337,3327,2010,1379,460000,21210
8333,4553,3780,1420,239500,21211
12679,8786,3893,1293,305200,21212
11288,6447,4841,1213,105000,21213
8381,6454,1927,1118,203700,21214
21287,11341,9946,1001,154400,21215
11196,5419,5777,1048,111900,21216
14392,4873,9519,965,155800,21217
18180,8845,9335,1140,180700,21218
3449,2914,535,1317,316000,21219
15970,10510,5460,1393,227900,21220
16827,10151,6676,1121,214900,21221
22322,13846,8476,1208,161500,21222
8292,2804,5488,988,75300,21223
19254,11624,7630,1613,229700,21224
12648,6549,6099,1014,165900,21225
2369,1561,808,1330,241900,21226
13731,8893,4838,1151,224200,21227
19582,14047,5535,1454,317900,21228
17811,9647,8164,1122,148300,21229
15308,7935,7373,1587,293000,21230
7975,2631,5344,1462,297000,21231
0,0,0,-,-,21233
27842,17681,10161,1381,232800,21234
15504,10680,4824,1387,253500,21236
11946,7899,4047,1281,236900,21237
11617,6341,5276,1189,158000,21239
0,0,0,-,-,21240
13934,6515,7419,1426,232200,21244
0,0,0,-,-,21250
0,0,0,-,-,21251
0,0,0,-,-,21252
0,0,0,-,-,21285
9270,5825,3445,1322,338900,21286
0,0,0,-,-,21287
17347,11121,6226,1785,479300,21401
363,0,363,2322,-,21402
14138,9626,4512,1679,480600,21403
179,179,0,-,1079200,21405
7466,6674,792,1985,449500,21409
16681,11282,5399,729,136000,21502
865,683,182,691,290300,21520
640,512,128,739,111000,21521
99,53,46,-,123400,21523
289,211,78,1051,89300,21524
261,216,45,960,159200,21529
806,681,125,1176,171500,21530
954,753,201,523,154200,21531
4867,3115,1752,709,143800,21532
1470,1126,344,598,164300,21536
310,270,40,644,-,21538
992,660,332,610,96500,21539
25,17,8,775,24700,21540
800,575,225,684,247600,21541
62,18,44,661,60000,21542
202,187,15,-,154800,21543
770,636,134,739,106900,21545
5908,4634,1274,655,189200,21550
636,491,145,810,154900,21555
764,560,204,-,117500,21557
8,8,0,-,-,21560
1061,959,102,570,281300,21561
1195,925,270,485,91800,21562
10094,6799,3295,1146,304200,21601
200,143,57,960,294000,21607
170,131,39,896,212500,21610
283,276,7,-,506800,21612
7439,4145,3294,868,215200,21613
3560,2951,609,1291,376200,21617
2362,1795,567,1765,376600,21619
5369,3509,1860,1046,271400,21620
234,156,78,-,164600,21622
939,841,98,1195,299100,21623
116,72,44,-,-,21624
796,668,128,1434,334600,21625
34,34,0,-,153800,21626
15,15,0,-,-,21627
189,158,31,-,157600,21628
3413,2629,784,1117,244700,21629
1033,841,192,1212,218500,21631
2493,1539,954,820,172600,21632
190,190,0,-,313100,21634
874,697,177,-,299500,21635
348,250,98,1107,190600,21636
1955,1549,406,1706,450200,21638
1723,1178,545,1056,187800,21639
539,508,31,1409,233200,21640
56,32,24,871,187500,21641
2009,1748,261,883,154300,21643
7,7,0,-,-,21644
478,330,148,-,407900,21645
183,166,17,-,469000,21647
44,40,4,-,-,21648
570,449,121,1648,209900,21649
92,84,8,-,74900,21650
1056,809,247,1106,243600,21651
103,98,5,-,479100,21652
50,50,0,-,300000,21653
616,503,113,1750,700900,21654
1854,1456,398,1115,234500,21655
435,379,56,-,316200,21657
1456,1296,160,1401,435600,21658
393,356,37,720,150000,21659
1502,1039,463,923,253100,21660
1222,824,398,1069,215400,21661
275,227,48,1688,475000,21662
1630,1310,320,985,492300,21663
221,143,78,1063,142100,21664
58,58,0,-,433300,21665
5315,4234,1081,1665,404900,21666
89,89,0,-,201700,21667
599,448,151,1132,314100,21668
73,73,0,-,670500,21669
368,323,45,-,303800,21671
82,82,0,-,76100,21672
1197,952,245,1238,299500,21673
35,35,0,-,-,21675
238,229,9,-,565500,21676
201,160,41,1399,400000,21677
817,758,59,1341,250900,21678
151,142,9,-,231600,21679
17029,11161,5868,1418,335800,21701
17018,10962,6056,1553,301800,21702
14415,9651,4764,1609,295400,21703
5381,4342,1039,2117,513500,21704
0,0,0,-,-,21705
1740,1394,346,1780,465800,21710
497,490,7,-,229200,21711
3799,3164,635,1419,285300,21713
109,109,0,-,360800,21714
11,11,0,-,-,21715
2535,1974,561,976,258600,21716
89,52,37,-,-,21717
61,43,18,1063,396200,21718
358,323,35,-,220700,21719
2202,1854,348,1033,243600,21722
251,235,16,-,690700,21723
1882,1477,405,913,272900,21727
361,361,0,-,319100,21733
506,303,203,681,181300,21734
705,705,0,-,824800,21737
1316,1275,41,-,715100,21738
24763,13203,11560,885,191600,21740
13341,9079,4262,1148,238100,21742
0,0,0,-,-,21746
1567,1093,474,875,170600,21750
2218,2117,101,1418,497500,21754
2017,1809,208,991,404800,21755
1192,1136,56,950,299100,21756
1000,811,189,1139,331900,21757
1691,1512,179,1559,309600,21758
79,79,0,-,-,21762
290,234,56,691,222600,21766
416,208,208,773,174300,21767
4211,3688,523,1428,387100,21769
2220,2163,57,2065,498100,21770
10602,9762,840,1516,434200,21771
1875,1733,142,1399,376500,21773
4929,4645,284,2301,414800,21774
2366,2018,348,1298,374300,21776
734,724,10,-,346900,21777
322,294,28,-,288500,21778
583,384,199,1189,440000,21779
769,622,147,1134,340600,21780
0,0,0,-,-,21781
1699,1465,234,1158,243100,21782
3491,2807,684,1053,289000,21783
13094,11317,1777,1494,404300,21784
4141,3260,881,919,281200,21787
4699,3917,782,1061,295900,21788
5,0,5,-,-,21790
1924,1562,362,1139,326600,21791
3994,3322,672,1578,339800,21793
717,713,4,-,758400,21794
3638,2379,1259,1049,233700,21795
2859,2577,282,1185,587300,21797
875,673,202,863,391700,21798
11285,6114,5171,941,234000,21801
15264,7146,8118,1177,174700,21804
150,150,0,-,183300,21810
10235,8238,1997,1215,281300,21811
1095,956,139,1058,392700,21813
55,55,0,-,203100,21814
1794,1124,670,622,129200,21817
369,354,15,1042,162100,21821
953,709,244,749,181100,21822
86,72,14,-,112700,21824
1923,1136,787,1208,160600,21826
163,163,0,-,207800,21829
1711,1471,240,920,199800,21830
150,150,0,-,-,21835
1188,972,216,999,172900,21837
766,699,67,1353,143300,21838
165,105,60,-,161500,21840
427,289,138,1309,288000,21841
5498,4084,1414,1124,338200,21842
1423,1131,292,1057,216500,21849
1364,1167,197,1054,182800,21850
3027,1814,1213,778,150100,21851
3649,2056,1593,867,142900,21853
349,256,93,1219,199300,21856
283,236,47,990,146600,21861
0,0,0,-,-,21862
1836,1387,449,934,189900,21863
253,226,27,-,156700,21864
172,161,11,-,256400,21865
56,56,0,-,-,21866
0,0,0,-,-,21867
362,319,43,1292,153100,21869
704,618,86,863,169000,21871
212,199,13,-,574800,21872
744,548,196,1306,161800,21874
2939,2074,865,1237,176000,21875
0,0,0,-,-,21890
6633,4953,1680,1208,282300,21901
73,0,73,-,-,21902
2196,1530,666,923,265100,21903
2442,2163,279,1106,260900,21904
4074,3228,846,1085,259700,21911
553,529,24,-,450000,21912
382,232,150,766,210400,21913
353,239,114,1393,265000,21914
1225,1046,179,821,303300,21915
617,565,52,-,279000,21917
1611,1469,142,-,283300,21918
1398,1325,73,1310,329000,21919
278,239,39,-,332300,21920
16825,11754,5071,1279,243500,21921
12,12,0,-,-,21930
19077,13245,5832,1772,588100,22003
15023,12486,2537,2234,539000,22015
6453,5299,1154,2286,409200,22025
5644,4026,1618,1637,356900,22026
665,596,69,-,957000,22027
21246,12112,9134,2026,630300,22030
14272,7145,7127,2110,597900,22031
9911,8423,1488,2074,611600,22032
15389,9663,5726,1978,533900,22033
0,0,0,-,-,22035
5718,5507,211,"3,500+",853300,22039
11098,5513,5585,1752,382100,22041
12180,7812,4368,1934,581100,22042
9467,5976,3491,2004,719700,22043
5275,2497,2778,1643,592000,22044
6886,4659,2227,2064,798400,22046
2542,211,2331,2806,599800,22060
5587,5307,280,2958,1084600,22066
11933,8947,2986,2244,502900,22079
10656,9043,1613,3088,1098800,22101
12387,6000,6387,2203,857800,22102
6553,5707,846,1988,801100,22124
462,321,141,1844,396800,22125
1316,62,1254,1887,210900,22134
9540,6017,3523,2263,500000,22150
5548,4618,930,2412,522600,22151
9817,8001,1816,2392,510600,22152
10817,9806,1011,2299,545400,22153
3624,2228,1396,1330,415500,22172
9295,6636,2659,2127,773800,22180
5736,4880,856,2372,782100,22181
9729,7235,2494,2443,917600,22182
24324,14866,9458,1828,355500,22191
20229,15042,5187,1896,378400,22192
24613,19946,4667,1667,355100,22193
19946,6256,13690,2307,696500,22201
15178,3190,11988,2263,711700,22202
12946,4307,8639,2156,716200,22203
22847,9496,13351,1756,524600,22204
6835,5465,1370,1706,899900,22205
10794,4667,6127,2040,463800,22206
12014,9632,2382,2097,994100,22207
7584,2407,5177,1990,720100,22209
47,0,47,"3,500+",-,22211
1719,1113,606,3022,866900,22213
0,0,0,-,-,22214
6242,3499,2743,2150,857500,22301
8661,5102,3559,1869,480500,22302
7950,3741,4209,1818,445500,22303
23148,9217,13931,1792,406400,22304
7444,2684,4760,1754,654700,22305
11305,5624,5681,1652,476000,22306
4533,3454,1079,1792,577900,22307
4675,4309,366,3273,698800,22308
12560,8505,4055,1539,443800,22309
10751,8198,2553,2125,509100,22310
8354,1690,6664,1706,542100,22311
10482,5427,5055,1862,486600,22312
18846,8979,9867,2136,710100,22314
11514,8584,2930,2194,506100,22315
11154,4345,6809,1355,383300,22401
11665,9425,2240,1511,342700,22405
9151,6766,2385,1505,383700,22406
20866,15766,5100,1569,304900,22407
11548,8738,2810,1579,300600,22408
1387,853,534,805,218200,22427
87,58,29,-,-,22432
78,78,0,-,322000,22433
888,801,87,1272,155000,22435
313,290,23,-,185500,22436
278,211,67,-,279000,22437
107,82,25,-,-,22438
4296,3292,1004,1050,211000,22443
181,0,181,1779,-,22448
745,472,273,835,270900,22454
674,586,88,1603,181100,22460
1050,821,229,921,304400,22469
0,0,0,-,-,22472
2224,2076,148,610,220000,22473
105,105,0,-,121500,22476
420,248,172,953,301300,22480
1591,1097,494,885,247400,22482
9264,7076,2188,1326,327500,22485
200,145,55,-,-,22488
1751,1521,230,920,172000,22503
112,93,19,-,216300,22504
5723,5537,186,1471,305700,22508
50,39,11,-,85000,22509
543,523,20,-,295500,22511
898,745,153,850,206800,22514
1919,1442,477,719,203700,22520
12,12,0,-,-,22529
974,852,122,1283,267000,22534
188,138,50,1096,222100,22535
92,92,0,-,169400,22538
926,821,105,-,350500,22539
808,752,56,-,268000,22542
6021,5059,962,1506,224600,22546
38,38,0,-,-,22548
7022,6113,909,1144,308600,22551
5462,4266,1196,1675,344300,22553
18963,14785,4178,1764,382700,22554
9750,7734,2016,1590,370000,22556
2690,1674,1016,920,211300,22560
1055,841,214,1251,232200,22567
2388,1395,993,845,190900,22572
751,675,76,838,239500,22576
1250,1029,221,1011,427500,22578
2108,1716,392,973,241400,22580
11474,5304,6170,1129,268500,22601
10993,8623,2370,1230,286100,22602
6360,4418,1942,1285,280600,22603
706,663,43,1088,283600,22610
3345,2399,946,1197,415600,22611
969,856,113,1375,411300,22620
267,203,64,1143,195300,22623
1001,842,159,1010,309300,22624
1307,1165,142,1140,244200,22625
281,224,57,1198,918300,22627
12843,9359,3484,1028,265000,22630
935,641,294,844,252200,22637
249,202,47,1208,569400,22639
176,81,95,1572,675000,22640
101,89,12,-,227000,22641
1692,1405,287,1596,253900,22642
117,117,0,-,-,22643
1023,882,141,866,234100,22644
1672,1258,414,857,305000,22645
13,13,0,-,-,22646
346,338,8,-,220800,22650
575,518,57,860,295700,22652
395,372,23,-,273000,22654
7835,5664,2171,1212,283800,22655
1644,1425,219,1673,283300,22656
4220,3159,1061,982,222700,22657
640,521,119,881,180100,22660
403,313,90,772,243800,22663
3677,2118,1559,1005,236900,22664
12505,8467,4038,1255,309600,22701
433,335,98,-,240300,22709
15,0,15,-,-,22711
2893,2233,660,1201,310900,22712
607,443,164,-,364300,22713
320,235,85,-,354300,22714
586,553,33,-,298200,22715
449,432,17,-,636000,22716
293,232,61,-,276300,22718
79,70,9,-,180400,22719
296,279,17,-,515100,22720
199,199,0,-,199100,22722
71,71,0,-,-,22723
764,659,105,-,414300,22724
16,16,0,-,-,22725
352,251,101,972,340700,22726
2205,1709,496,1019,281100,22727
1178,954,224,862,409200,22728
80,55,25,-,301800,22729
27,14,13,-,-,22730
78,78,0,-,-,22731
86,86,0,-,307700,22732
511,387,124,-,295000,22733
1286,809,477,1161,298100,22734
792,704,88,-,297700,22735
241,232,9,-,247400,22736
1080,1005,75,1367,322500,22737
472,402,70,-,313300,22738
358,244,114,911,350700,22740
77,77,0,-,275000,22741
529,432,97,1685,331300,22742
96,87,9,-,187900,22743
102,102,0,-,443300,22746
481,334,147,786,394400,22747
80,50,30,-,-,22749
13938,6479,7459,1050,285600,22801
11031,5819,5212,900,211400,22802
1,0,1,-,-,22807
279,271,8,-,270100,22810
222,143,79,-,193000,22811
3200,2191,1009,958,266500,22812
3392,2452,940,824,194300,22815
100,85,15,-,100800,22820
2190,1758,432,873,226000,22821
2551,1997,554,935,222700,22824
4376,3441,935,769,191000,22827
741,651,90,845,163900,22830
304,244,60,860,162700,22831
390,368,22,-,315900,22832
452,375,77,1107,272900,22834
4986,3415,1571,814,195700,22835
1867,1597,270,1435,295000,22840
1240,933,307,960,276400,22841
2102,1608,494,931,174200,22842
987,807,180,699,209400,22843
2171,1315,856,696,229500,22844
58,58,0,-,-,22845
643,551,92,1196,347900,22846
265,181,84,907,214500,22847
1833,1401,432,954,152000,22849
472,402,70,1076,210000,22850
2098,1405,693,742,167000,22851
1792,1299,493,919,174200,22853
15900,8911,6989,1397,383200,22901
11099,5705,5394,1323,336000,22902
15466,6079,9387,1345,433500,22903
26,0,26,881,-,22904
0,0,0,-,-,22908
7377,5154,2223,1589,342000,22911
1727,1376,351,1134,319100,22920
892,813,79,-,145800,22922
2581,1697,884,1396,315100,22923
93,65,28,970,509600,22931
2979,2499,480,1242,425500,22932
285,285,0,-,214800,22935
2185,1963,222,1259,434100,22936
832,741,91,1069,225700,22937
383,299,84,-,249400,22938
2411,1746,665,1348,271000,22939
371,341,30,-,447300,22940
3905,2918,987,968,256500,22942
222,157,65,-,477300,22943
55,55,0,-,238300,22946
2101,1758,343,1083,580500,22947
62,62,0,-,-,22948
576,275,301,-,212500,22949
609,560,49,-,184300,22952
0,0,0,-,-,22957
965,871,94,1377,403000,22958
680,571,109,778,404400,22959
3821,2368,1453,930,243600,22960
6334,5816,518,1503,241400,22963
138,77,61,-,332700,22964
873,614,259,837,263000,22967
3678,3044,634,1066,269500,22968
636,503,133,1299,177600,22969
736,564,172,590,260600,22971
189,127,62,-,490000,22972
2570,2046,524,921,210500,22973
1282,1099,183,989,257300,22974
116,98,18,-,168800,22976
13645,9237,4408,871,207900,22980
29,0,29,-,-,22989
4172,3388,784,1096,197600,23002
466,378,88,725,109400,23004
6540,4730,1810,1114,309900,23005
2763,2488,275,1181,213500,23009
390,283,107,-,339500,23011
1639,1566,73,-,317300,23015
12,12,0,-,-,23021
461,350,111,-,180600,23022
115,108,7,-,240200,23023
3897,3396,501,1126,286600,23024
382,329,53,-,-,23025
500,432,68,1181,226000,23027
1896,1568,328,736,174500,23030
97,86,11,-,203700,23032
605,580,25,-,311400,23035
763,648,115,1585,294700,23038
499,499,0,-,387200,23039
1776,1268,508,738,150600,23040
737,597,140,793,276300,23043
33,33,0,-,-,23045
684,609,75,-,388100,23047
246,246,0,-,278700,23050
413,190,223,-,132100,23055
56,27,29,-,-,23056
14897,11494,3403,1638,474900,23059
13655,10888,2767,1359,320000,23060
8502,7174,1328,1058,242100,23061
953,620,333,942,240100,23062
1637,1305,332,1014,266600,23063
590,538,52,-,212900,23065
348,229,119,-,411500,23066
109,109,0,-,267600,23068
1115,1021,94,1125,258400,23069
345,326,19,-,434100,23070
774,698,76,950,268200,23071
4879,3672,1207,1032,247500,23072
3680,2062,1618,1115,153700,23075
181,167,14,-,-,23076
151,125,26,-,164400,23079
0,0,0,-,-,23081
850,771,79,699,221000,23083
600,469,131,-,261700,23084
176,176,0,-,215500,23085
1323,1148,175,939,206700,23086
2227,1779,448,1242,288800,23089
195,106,89,-,223000,23091
370,346,24,-,236400,23092
5197,3825,1372,974,214700,23093
1246,1120,126,1370,360700,23102
2570,2386,184,853,489600,23103
473,460,13,-,216200,23106
31,26,5,-,-,23108
937,718,219,887,283800,23109
409,351,58,1356,229900,23110
14693,11603,3090,1287,261000,23111
20264,16025,4239,1423,296400,23112
9761,8235,1526,1415,485000,23113
7999,6397,1602,1522,335500,23114
11283,10007,1276,1474,334900,23116
3843,3370,473,1060,249500,23117
39,39,0,-,-,23119
4460,4295,165,2087,433600,23120
656,382,274,638,112900,23123
1804,1764,40,-,308200,23124
214,202,12,-,251900,23126
161,107,54,-,-,23128
182,155,27,-,502800,23129
62,62,0,-,169400,23130
397,346,51,1545,264500,23138
9802,8879,923,1195,297500,23139
2698,2408,290,899,279100,23140
2583,2343,240,1103,299400,23141
1203,1124,79,1704,373600,23146
0,0,0,-,-,23147
599,523,76,1154,204800,23148
1041,755,286,1001,237000,23149
5218,3755,1463,1121,201900,23150
516,460,56,-,302000,23153
572,496,76,862,147300,23156
0,0,0,-,-,23160
38,0,38,-,-,23161
46,46,0,-,-,23163
3028,2670,358,1060,300000,23168
426,401,25,782,217000,23169
0,0,0,-,-,23173
812,580,232,848,269600,23175
160,160,0,-,239700,23176
316,204,112,895,168500,23177
236,184,52,-,289300,23180
2134,1730,404,885,229600,23181
18682,13317,5365,1241,350300,23185
17190,12671,4519,1316,346700,23188
2404,2096,308,990,306000,23192
3003,223,2780,1218,220400,23219
14099,4792,9307,1187,340900,23220
7419,3812,3607,1327,455300,23221
10789,5680,5109,1093,176900,23222
23486,10509,12977,1069,173500,23223
15987,5734,10253,1089,145200,23224
18722,9187,9535,1110,241500,23225
7328,5752,1576,1619,412400,23226
11870,6466,5404,1094,267100,23227
14990,7873,7117,1212,217500,23228
13451,9409,4042,1161,374300,23229
3794,1457,2337,1341,269700,23230
15307,10507,4800,1090,213600,23231
12401,7859,4542,1454,364000,23233
16124,8826,7298,1164,180700,23234
13977,9839,4138,1463,260400,23235
10247,8967,1280,1403,246600,23236
9091,5992,3099,1294,192700,23237
11388,7019,4369,1353,326900,23238
0,0,0,-,-,23250
7,0,7,-,-,23284
8260,2985,5275,1312,232700,23294
0,0,0,-,-,23298
753,410,343,854,223600,23301
0,0,0,-,-,23302
163,107,56,-,195200,23303
0,0,0,-,-,23304
442,235,207,933,187000,23306
236,132,104,825,113400,23307
831,533,298,922,106600,23308
2323,1385,938,753,233300,23310
3629,2566,1063,1594,344200,23314
617,514,103,966,274000,23315
32,23,9,-,192000,23316
24387,15254,9133,1387,276100,23320
13815,10615,3200,1274,278100,23321
21294,18678,2616,1696,374000,23322
14236,11486,2750,1447,275800,23323
8492,4349,4143,990,188400,23324
7297,4696,2601,1291,224000,23325
1908,1412,496,1070,312400,23336
284,142,142,-,199300,23337
274,158,116,-,-,23347
1485,867,618,631,145100,23350
100,100,0,-,340700,23354
541,464,77,1125,175900,23356
186,118,68,-,156700,23357
54,54,0,-,-,23358
344,320,24,681,-,23359
58,58,0,-,-,23389
215,215,0,-,122200,23395
12,5,7,-,-,23398
114,60,54,1330,-,23401
445,430,15,-,307300,23405
193,133,60,-,77600,23407
10,10,0,-,-,23408
60,54,6,-,172500,23409
712,435,277,1065,153000,23410
347,192,155,522,89800,23413
57,0,57,-,-,23414
757,478,279,899,127600,23415
42,16,26,-,-,23416
1850,1296,554,871,189800,23417
381,242,139,869,212500,23418
1106,582,524,773,109600,23420
1699,1007,692,774,179700,23421
107,83,24,-,-,23422
116,50,66,978,200000,23423
27,20,7,-,-,23426
116,105,11,808,83600,23427
7088,5806,1282,1011,308400,23430
533,502,31,-,371400,23432
501,473,28,882,429100,23433
18960,12550,6410,1127,246600,23434
12175,8411,3764,1609,306100,23435
355,349,6,-,385300,23436
1938,1592,346,884,254400,23437
679,596,83,1625,252100,23438
216,204,12,-,121900,23440
0,0,0,-,-,23441
447,352,95,850,143800,23442
20835,11007,9828,1430,477700,23451
22182,13408,8774,1354,270800,23452
12647,8957,3690,1396,252300,23453
23165,15096,8069,1414,323400,23454
20801,12588,8213,1417,326000,23455
19965,17691,2274,1820,368300,23456
1635,1441,194,767,416800,23457
0,0,0,-,-,23459
0,0,0,-,-,23460
0,0,0,-,-,23461
27278,14686,12592,1464,224800,23462
28538,20124,8414,1479,276100,23464
156,144,12,963,219300,23480
28,16,12,-,-,23486
2330,1834,496,915,221700,23487
217,134,83,-,143400,23488
8280,4330,3950,1158,207400,23502
13999,6129,7870,1087,220900,23503
8379,2744,5635,817,204500,23504
12286,4003,8283,1095,277500,23505
3313,1380,1933,1310,435800,23507
6691,3069,3622,1210,330500,23508
5241,3114,2127,1137,194800,23509
4633,896,3737,1399,327900,23510
326,0,326,1885,-,23511
12009,6429,5580,1118,177500,23513
2414,538,1876,1196,341100,23517
12542,6898,5644,1125,234200,23518
2764,909,1855,881,185500,23523
0,0,0,-,-,23551
11663,6119,5544,1042,200100,23601
17737,9080,8657,1196,221800,23602
1439,865,574,1263,250800,23603
773,12,761,1657,-,23604
6393,2755,3638,1068,144100,23605
11873,5457,6416,1144,252600,23606
9521,2766,6755,966,114200,23607
16889,8897,7992,1154,203800,23608
242,0,242,1788,-,23651
5868,4056,1812,1091,159900,23661
4617,3782,835,1475,358700,23662
5424,2820,2604,1109,153400,23663
4550,3102,1448,1184,222600,23664
1610,67,1543,1756,-,23665
23074,11868,11206,1216,195700,23666
0,0,0,-,-,23667
0,0,0,-,-,23668
16342,9556,6786,1014,209500,23669
0,0,0,-,-,23681
1535,1176,359,1028,329800,23690
15,0,15,1750,-,23691
7303,5989,1314,1648,334100,23692
8791,6284,2507,1525,381500,23693
1321,1152,169,1694,387600,23696
9518,6178,3340,1147,170400,23701
4832,2174,2658,1077,155200,23702
9836,6694,3142,1222,231400,23703
8037,2907,5130,1055,150500,23704
6325,3510,2815,1006,170000,23707
5,0,5,-,-,23708
0,0,0,-,-,23709
1470,3,1467,1727,-,23801
16379,8185,8194,1005,159000,23803
8282,4533,3749,1099,170300,23805
722,565,157,1042,112100,23821
2583,1754,829,698,180400,23824
441,269,172,802,124700,23827
261,247,14,-,169600,23828
500,445,55,776,209000,23829
533,503,30,-,251900,23830
13744,10138,3606,1343,257400,23831
13025,11345,1680,1553,258800,23832
835,726,109,905,249500,23833
10925,7543,3382,1116,189900,23834
5272,3657,1615,1413,258200,23836
1773,1298,475,816,173300,23837
5777,5542,235,-,355100,23838
314,237,77,1188,187000,23839
755,650,105,1342,190300,23840
1328,1112,216,1114,207800,23841
2664,2407,257,920,230400,23842
258,221,37,-,115600,23843
201,142,59,967,-,23844
166,116,50,-,-,23845
340,266,74,925,213500,23846
5094,3010,2084,890,111000,23847
510,497,13,-,179900,23850
5350,3139,2211,848,186300,23851
404,272,132,650,111100,23856
140,70,70,-,-,23857
10877,5906,4971,974,147700,23860
744,535,209,881,211200,23866
857,617,240,835,132800,23867
1948,1266,682,694,111100,23868
0,0,0,-,-,23870
943,730,213,895,120200,23872
402,333,69,1054,166300,23874
4711,3313,1398,1157,220700,23875
86,77,9,-,98500,23876
646,581,65,-,201200,23878
253,115,138,935,87700,23879
867,587,280,917,228800,23881
688,573,115,743,124000,23882
790,606,184,1011,231400,23883
0,0,0,-,-,23884
1033,929,104,1021,210800,23885
269,219,50,-,204500,23887
867,596,271,940,152700,23888
229,183,46,936,88800,23889
1645,1179,466,884,153500,23890
0,0,0,-,-,23891
182,172,10,-,133200,23893
143,108,35,-,212000,23894
325,210,115,-,73800,23897
1078,810,268,639,247800,23898
204,179,25,950,131300,23899
5634,3457,2177,765,182500,23901
0,0,0,-,-,23909
402,276,126,598,134500,23915
1068,865,203,467,152700,23917
865,735,130,680,280500,23919
1285,1142,143,986,129000,23920
813,594,219,787,152800,23921
808,587,221,800,134600,23922
1009,744,265,634,154600,23923
2520,1939,581,673,110100,23924
1983,1536,447,641,207100,23927
2193,1632,561,821,144700,23930
243,175,68,-,162500,23934
2015,1545,470,744,153700,23936
805,552,253,668,75400,23937
102,102,0,-,76800,23938
521,399,122,626,128300,23942
0,0,0,-,-,23943
1315,870,445,839,104100,23944
1486,857,629,594,154200,23947
1303,826,477,742,164600,23950
65,65,0,-,140200,23952
925,537,388,630,105200,23954
9,9,0,-,-,23955
996,782,214,907,167400,23958
489,387,102,735,137800,23959
764,572,192,595,134000,23960
180,163,17,-,107500,23962
101,93,8,-,-,23963
484,347,137,692,78300,23964
831,623,208,852,156100,23966
391,259,132,538,119900,23967
351,211,140,713,101600,23968
3447,1943,1504,808,139200,23970
1511,1017,494,746,115800,23974
64,7,57,-,-,23976
475,46,429,979,750000,24011
12427,7147,5280,855,140100,24012
2662,1289,1373,886,86700,24013
7615,4926,2689,831,176100,24014
6866,3944,2922,813,202800,24015
4556,981,3575,808,114300,24016
9477,4945,4532,858,112200,24017
15958,11416,4542,1073,265700,24018
11808,9265,2543,1085,190700,24019
28,0,28,-,-,24020
0,0,0,-,-,24022
1095,851,244,776,110700,24053
2143,1746,397,705,101100,24054
4948,3668,1280,527,91700,24055
92,78,14,-,-,24058
477,477,0,-,229300,24059
18160,8053,10107,1150,335300,24060
0,0,0,-,-,24061
1814,1770,44,-,219000,24064
2698,2212,486,771,200900,24065
2045,1746,299,792,166000,24066
842,684,158,587,163300,24067
691,590,101,905,89100,24069
580,572,8,-,222200,24070
450,439,11,-,160300,24072
12661,8173,4488,986,202900,24073
478,382,96,-,128000,24076
452,228,224,-,256400,24077
2852,1526,1326,646,106800,24078
772,551,221,776,161400,24079
217,170,47,-,77100,24082
1370,1196,174,1315,368300,24083
4402,3092,1310,747,168300,24084
1087,1013,74,-,127800,24085
80,48,32,-,162500,24086
1610,1115,495,908,138300,24087
1635,1242,393,590,106100,24088
1291,986,305,663,78100,24089
1974,1689,285,942,256900,24090
3387,2853,534,743,209800,24091
1263,1072,191,-,165900,24092
39,34,5,-,128100,24093
1741,1557,184,963,183400,24095
2382,2052,330,854,214700,24101
630,572,58,476,140900,24102
1301,1254,47,-,286500,24104
211,211,0,-,165300,24105
12697,8571,4126,663,95800,24112
815,637,178,602,156500,24120
4711,4151,560,1013,294700,24121
595,575,20,-,144300,24122
1834,1460,374,581,99900,24124
1576,1190,386,630,149300,24127
842,732,110,757,197100,24128
102,102,0,-,-,24129
45,8,37,-,-,24131
209,125,84,-,133100,24132
924,704,220,657,106400,24133
2230,1672,558,732,144100,24134
1267,995,272,694,131100,24136
1356,1188,168,865,154200,24137
568,486,82,931,184700,24138
392,306,86,-,151900,24139
8747,5112,3635,837,197900,24141
0,0,0,-,-,24142
421,212,209,-,121400,24147
3143,2458,685,669,119600,24148
1446,1244,202,-,158000,24149
310,243,67,769,134400,24150
7580,5398,2182,763,157400,24151
14924,10749,4175,999,210700,24153
128,82,46,880,112500,24161
886,485,401,916,131000,24162
573,422,151,628,117300,24165
65,31,34,-,-,24167
97,52,45,-,-,24168
3710,2881,829,587,117900,24171
1155,1006,149,439,134300,24174
2980,2561,419,842,250600,24175
547,510,37,1319,493800,24176
8052,5823,2229,808,175700,24179
1629,1439,190,607,189200,24184
326,307,19,-,223400,24185
6806,4125,2681,734,131200,24201
5212,4371,841,776,162300,24202
7299,4932,2367,725,158700,24210
4204,3562,642,833,231900,24211
1019,654,365,579,54700,24216
122,100,22,-,72100,24217
4018,2779,1239,657,122900,24219
301,301,0,-,85700,24220
275,272,3,-,142500,24221
2194,1697,497,673,102400,24224
911,598,313,-,83900,24225
613,456,157,589,69600,24226
2424,1830,594,635,89400,24228
2914,2033,881,646,85900,24230
1228,847,381,605,124000,24236
388,358,30,-,97700,24237
24,24,0,-,-,24239
637,556,81,820,87500,24243
1947,1461,486,292,90900,24244
341,210,131,469,68100,24245
103,19,84,-,-,24246
1072,939,133,623,78700,24248
467,402,65,-,96000,24250
3324,2616,708,557,106100,24251
1336,961,375,517,72000,24256
559,497,62,-,116300,24258
2082,1479,603,539,83200,24260
2356,1492,864,544,91000,24263
354,307,47,-,80800,24265
3551,2702,849,598,110800,24266
139,115,24,-,-,24269
160,160,0,-,164700,24270
1140,972,168,619,134700,24271
291,259,32,326,76000,24272
2354,1493,861,491,81700,24273
1883,1063,820,598,79900,24277
1656,1430,226,597,83200,24279
272,220,52,-,165800,24280
795,566,229,-,112600,24281
228,195,33,-,-,24282
843,576,267,411,92900,24283
775,492,283,683,128600,24290
173,146,27,-,80000,24292
3710,2713,997,683,102800,24293
5903,3600,2303,747,135400,24301
692,494,198,545,70500,24311
701,429,272,750,93400,24312
282,257,25,-,75100,24313
588,525,63,-,95000,24314
1235,982,253,720,146200,24315
13,13,0,-,-,24316
1530,1217,313,412,71800,24317
199,188,11,-,74300,24318
2547,1769,778,659,133700,24319
23,23,0,-,-,24322
417,371,46,-,112900,24323
976,833,143,839,182900,24324
579,482,97,583,113600,24325
427,357,70,-,135300,24326
0,0,0,-,-,24327
947,917,30,-,148500,24328
1180,1037,143,593,102200,24330
7281,5652,1629,666,115300,24333
2201,1647,554,729,153400,24340
3420,2525,895,585,114800,24343
752,564,188,649,154200,24347
1649,1180,469,595,116700,24348
602,526,76,385,87800,24350
255,123,132,-,108600,24351
429,334,95,321,129900,24352
6112,3876,2236,638,114800,24354
2352,2040,312,664,165200,24360
1832,1340,492,744,136300,24361
553,502,51,181,106800,24363
187,175,12,-,57900,24366
1945,1667,278,642,123400,24368
2504,1892,612,538,79100,24370
299,254,45,921,88000,24374
725,530,195,488,69100,24375
159,151,8,-,139500,24377
417,391,26,-,157400,24378
1179,1101,78,587,170500,24380
1247,837,410,531,107800,24381
6532,4449,2083,607,144400,24382
16220,10164,6056,886,199500,24401
3,3,0,-,-,24411
106,106,0,-,-,24412
114,110,4,-,162500,24413
13,13,0,-,-,24415
3612,2285,1327,888,127400,24416
1485,1285,200,1124,238500,24421
2377,1653,724,572,107100,24422
5839,4786,1053,695,101500,24426
694,389,305,683,170700,24430
1039,943,96,-,141400,24431
170,159,11,-,131800,24432
30,24,6,-,207100,24433
783,766,17,-,173600,24435
581,533,48,-,236500,24437
532,380,152,664,157100,24439
1046,883,163,1533,194900,24440
2557,2028,529,1035,205100,24441
36,27,9,-,94300,24442
1071,795,276,648,154400,24445
177,171,6,-,71700,24448
5689,3627,2062,968,265500,24450
138,68,70,-,115600,24457
152,145,7,-,169600,24458
257,214,43,-,517300,24459
506,390,116,-,182300,24460
107,17,90,-,-,24464
585,468,117,649,169700,24465
975,828,147,576,310800,24467
0,0,0,-,-,24469
698,590,108,660,208700,24471
873,631,242,880,230000,24472
300,247,53,-,275900,24473
170,164,6,-,82300,24474
99,84,15,-,139700,24476
4541,3404,1137,1075,215400,24477
746,660,86,-,298400,24479
1846,1399,447,937,171800,24482
365,326,39,830,234000,24483
242,222,20,-,156300,24484
180,180,0,-,168800,24485
1144,855,289,1020,261200,24486
171,150,21,-,312700,24487
10063,4749,5314,835,120800,24501
16688,8672,8016,1025,173800,24502
7922,5800,2122,872,249900,24503
3977,2213,1764,920,152600,24504
0,0,0,-,-,24515
2004,1438,566,716,116400,24517
990,872,118,664,107900,24520
3920,2945,975,766,187200,24521
3698,2826,872,745,151200,24522
8358,6346,2012,823,186800,24523
624,534,90,807,185700,24526
1128,927,201,889,129600,24527
1471,1096,375,753,113300,24528
623,535,88,485,187100,24529
462,360,102,715,156400,24530
3297,2639,658,716,122200,24531
649,510,139,770,98000,24534
77,77,0,-,-,24536
1971,1624,347,688,143900,24538
170,107,63,691,138500,24539
13311,7839,5472,759,112800,24540
12350,6936,5414,739,113800,24541
1589,1248,341,754,118900,24549
2825,2142,683,738,154100,24550
10155,8178,1977,937,291000,24551
867,574,293,949,132000,24553
1430,1157,273,833,114000,24554
984,762,222,743,148900,24555
1138,1074,64,-,269600,24556
3477,2535,942,657,111700,24557
2547,1937,610,711,120600,24558
226,200,26,-,195000,24562
2240,1506,734,740,116900,24563
402,346,56,-,88900,24565
531,449,82,1380,89000,24566
295,245,50,-,140700,24569
0,0,0,-,-,24570
851,727,124,727,117000,24571
6488,4819,1669,709,153900,24572
1602,1375,227,845,184100,24574
1909,1542,367,708,100700,24577
345,285,60,-,179400,24578
436,289,147,-,116900,24579
309,261,48,769,105800,24580
0,0,0,-,-,24581
1911,1485,426,997,131000,24586
3873,2658,1215,653,152700,24588
892,710,182,769,101300,24589
2997,2329,668,1051,203400,24590
5246,3409,1837,684,142600,24592
951,789,162,855,181700,24593
661,534,127,870,139100,24594
64,30,34,-,-,24595
342,298,44,939,126200,24597
517,425,92,698,121400,24598
280,220,60,-,-,24599
0,0,0,-,-,24601
281,194,87,581,81000,24602
282,282,0,-,-,24603
104,104,0,-,-,24604
3585,2775,810,497,123100,24605
59,59,0,-,72500,24606
116,96,20,-,33800,24607
2484,1877,607,673,110500,24609
98,44,54,731,118800,24612
234,222,12,-,65400,24613
2760,2243,517,711,93500,24614
730,618,112,-,60800,24620
284,228,56,-,63600,24622
2481,1593,888,726,106100,24630
628,389,239,684,69500,24631
166,154,12,-,102700,24634
187,132,55,375,60600,24635
1302,1076,226,-,125300,24637
1302,1021,281,623,84500,24639
2317,1505,812,713,93700,24641
394,377,17,-,64300,24646
782,688,94,-,74500,24649
2105,1664,441,589,114600,24651
987,882,105,750,75800,24656
135,55,80,947,75000,24657
7826,5146,2680,742,88100,24701
672,517,155,732,118200,24712
119,119,0,-,-,24714
117,112,5,-,-,24715
144,102,42,-,17200,24716
27,27,0,-,-,24719
53,41,12,-,-,24724
171,109,62,-,-,24726
45,45,0,-,-,24729
40,40,0,-,-,24731
98,98,0,-,218200,24733
279,238,41,675,28400,24736
442,290,152,417,41400,24737
0,0,0,-,-,24738
5700,4224,1476,752,122300,24739
6838,4213,2625,747,112500,24740
1382,940,442,820,75900,24747
1274,960,314,783,53000,24801
217,186,31,477,61500,24808
234,168,66,-,-,24811
0,0,0,-,-,24813
158,141,17,-,-,24815
0,0,0,-,-,24816
543,474,69,717,39700,24817
366,323,43,-,71200,24818
492,404,88,-,97000,24822
203,171,32,-,41000,24823
8,8,0,-,-,24826
496,452,44,-,153300,24827
248,233,15,-,24300,24828
51,32,19,-,35900,24830
96,85,11,-,58100,24831
298,298,0,-,-,24834
232,197,35,-,49100,24836
356,331,25,-,74100,24839
31,31,0,-,-,24843
394,347,47,-,50900,24844
116,96,20,-,104700,24845
104,56,48,-,73800,24846
51,51,0,-,-,24847
47,37,10,-,-,24848
142,142,0,-,108300,24849
0,0,0,-,-,24850
183,155,28,-,59200,24851
150,93,57,-,72400,24853
263,176,87,975,-,24854
53,17,36,-,-,24855
347,284,63,725,32500,24857
48,16,32,-,-,24860
48,16,32,-,-,24861
219,201,18,-,-,24862
258,241,17,-,14500,24866
58,58,0,-,-,24867
464,427,37,850,28000,24868
161,150,11,-,-,24869
564,477,87,792,59700,24870
177,138,39,-,50200,24871
292,193,99,-,32300,24872
197,188,9,-,60000,24873
915,546,369,476,113900,24874
113,72,41,-,57100,24878
181,151,30,-,-,24879
102,82,20,-,-,24880
110,110,0,-,51600,24881
386,386,0,-,-,24882
12,6,6,-,-,24884
0,0,0,-,-,24887
32,32,0,-,85600,24888
448,316,132,650,46000,24892
119,79,40,-,49000,24894
29,29,0,-,28500,24895
83,83,0,-,-,24898
4225,2540,1685,697,234800,24901
1665,1368,297,566,122100,24910
192,169,23,-,57600,24915
261,243,18,-,198500,24916
534,365,169,590,106900,24918
83,75,8,-,83000,24920
278,260,18,-,125900,24924
276,204,72,-,188500,24925
133,103,30,-,-,24927
473,398,75,-,116300,24931
156,117,39,-,237100,24934
170,148,22,-,67100,24935
609,476,133,-,159900,24938
382,304,78,858,108400,24941
39,39,0,-,206300,24943
153,138,15,-,114500,24944
124,124,0,-,130600,24945
362,302,60,-,143600,24946
630,589,41,-,130800,24951
1142,971,171,613,129100,24954
213,174,39,-,302200,24957
34,34,0,-,-,24962
1279,997,282,619,142400,24963
512,489,23,-,110100,24966
1897,1407,490,782,96000,24970
101,101,0,-,59100,24974
407,360,47,-,170900,24976
193,162,31,-,-,24977
249,123,126,-,-,24981
814,702,112,475,133900,24983
50,27,23,-,-,24984
115,97,18,-,-,24985
2165,1515,650,756,122800,24986
282,282,0,-,112700,24991
28,28,0,-,-,24993
0,0,0,-,-,25002
901,667,234,-,103600,25003
78,78,0,-,130800,25005
168,168,0,-,-,25007
86,56,30,-,82500,25008
389,304,85,710,78600,25009
251,178,73,493,85000,25011
1502,1143,359,763,89500,25015
150,138,12,-,71300,25019
182,134,48,493,82600,25021
53,36,17,-,168800,25022
205,136,69,559,73700,25024
5,5,0,-,-,25025
161,161,0,-,70200,25028
96,96,0,-,-,25030
427,311,116,761,84200,25031
681,576,105,489,93300,25033
229,141,88,589,-,25035
67,67,0,-,-,25036
244,204,40,807,73600,25039
219,184,35,-,109400,25040
504,322,182,572,102500,25043
74,56,18,-,-,25044
1480,1050,430,749,83600,25045
56,56,0,-,-,25047
64,61,3,-,32700,25048
123,107,16,-,73900,25049
73,73,0,-,-,25051
1496,1079,417,810,85200,25053
48,30,18,-,-,25054
66,66,0,-,63600,25057
95,87,8,-,55600,25059
91,55,36,-,-,25060
200,163,37,-,74100,25061
108,108,0,-,73400,25062
659,546,113,-,82800,25063
4358,2710,1648,835,102700,25064
340,269,71,738,81900,25067
665,539,126,797,165700,25070
4406,3460,946,782,137000,25071
335,177,158,-,-,25075
71,59,12,-,17000,25076
541,510,31,-,154200,25081
686,649,37,-,234100,25082
150,137,13,-,152500,25083
290,163,127,647,77000,25085
302,241,61,777,96300,25086
93,93,0,-,31400,25088
99,65,34,385,73600,25090
56,28,28,-,37500,25093
116,114,2,-,41800,25102
53,40,13,-,55400,25103
312,232,80,726,-,25106
183,166,17,-,53300,25107
146,126,20,-,-,25108
258,258,0,-,144000,25109
240,219,21,-,-,25110
163,136,27,-,68400,25111
0,0,0,-,-,25112
185,174,11,-,154400,25113
92,57,35,-,-,25114
57,57,0,-,59700,25115
206,154,52,-,54300,25118
143,110,33,-,44300,25119
367,316,51,-,-,25121
1128,993,135,595,114500,25123
608,583,25,-,121500,25124
343,295,48,-,80800,25125
194,184,10,-,-,25126
1204,942,262,710,100900,25130
137,74,63,-,-,25132
284,239,45,381,93200,25133
104,104,0,-,34100,25134
670,257,413,593,91700,25136
66,66,0,-,-,25139
392,287,105,-,42500,25140
70,70,0,-,156600,25141
98,98,0,-,47100,25142
3744,2666,1078,696,101600,25143
145,145,0,-,-,25148
56,56,0,-,-,25149
186,176,10,-,57100,25152
252,198,54,-,95000,25154
12,12,0,-,-,25156
1571,1337,234,955,127400,25159
170,128,42,-,27900,25160
154,137,17,-,46900,25161
131,95,36,727,119400,25162
395,332,63,-,106400,25164
284,251,33,-,98100,25165
1372,1194,178,919,118100,25168
144,120,24,-,-,25169
99,54,45,-,68400,25173
96,96,0,-,70300,25174
9604,6773,2831,790,112200,25177
109,109,0,-,89800,25180
461,445,16,-,64000,25181
35,35,0,-,-,25183
0,0,0,-,-,25185
404,262,142,559,100700,25186
350,328,22,-,163800,25187
184,135,49,623,61300,25193
32,32,0,-,-,25201
455,384,71,1057,114100,25202
24,24,0,-,-,25203
27,19,8,-,-,25204
49,40,9,-,-,25205
60,37,23,-,-,25206
274,167,107,576,57600,25208
278,239,39,-,67800,25209
21,21,0,-,-,25211
2445,2124,321,1034,227100,25213
238,217,21,-,-,25214
0,0,0,-,-,25231
351,296,55,658,119000,25234
411,303,108,519,111100,25235
580,502,78,1058,163000,25239
603,557,46,-,170100,25241
252,199,53,-,103700,25243
198,172,26,-,137500,25244
350,350,0,-,129700,25245
196,162,34,681,64100,25247
1456,1223,233,624,159300,25248
214,192,22,442,208800,25251
460,394,66,-,151400,25252
803,687,116,517,111700,25253
258,237,21,-,157200,25259
614,498,116,746,81100,25260
27,27,0,-,-,25261
444,413,31,-,115600,25262
194,123,71,-,169000,25264
665,575,90,428,103800,25265
230,169,61,-,180200,25266
241,224,17,-,47100,25267
239,189,50,-,118500,25268
312,234,78,476,-,25270
3528,2168,1360,691,131200,25271
664,616,48,-,133600,25275
3087,2119,968,547,96400,25276
215,152,63,-,-,25285
570,477,93,430,96300,25286
271,213,58,-,86300,25287
1365,258,1107,612,148900,25301
6343,3591,2752,794,118100,25302
3178,2164,1014,874,144500,25303
3508,2272,1236,910,186100,25304
0,0,0,-,-,25305
2812,1831,981,1141,84500,25306
5527,3995,1532,720,121400,25309
4836,2857,1979,744,94500,25311
3979,3329,650,809,105800,25312
5051,3909,1142,840,139900,25313
6539,5493,1046,965,200700,25314
1438,1041,397,792,74400,25315
1968,1442,526,767,96500,25320
2210,1370,840,879,72500,25387
6095,3066,3029,955,159900,25401
5565,4538,1027,1157,249700,25403
8821,5353,3468,1065,188900,25404
5446,4530,916,1340,200800,25405
4892,4053,839,752,193900,25411
2951,2281,670,1143,193000,25413
7437,5637,1800,873,292800,25414
4748,3830,918,1055,196300,25419
2018,1556,462,1079,209100,25420
34,34,0,-,-,25421
660,610,50,-,121000,25422
5247,4489,758,1256,265800,25425
6110,5309,801,960,205400,25427
5288,4450,838,1263,187300,25428
2791,2268,523,1184,254500,25430
155,141,14,-,155900,25431
38,28,10,-,187500,25432
923,752,171,683,120700,25434
110,89,21,-,-,25437
2558,1761,797,974,188500,25438
841,741,100,984,288100,25442
2625,2062,563,1103,341700,25443
91,91,0,-,272500,25444
331,319,12,-,345200,25446
543,473,70,-,103800,25501
240,240,0,-,-,25502
274,185,89,-,74300,25503
5105,3934,1171,784,148100,25504
139,127,12,-,-,25505
1904,1357,547,636,77600,25506
402,360,42,746,111600,25507
3639,2844,795,674,113700,25508
2026,1654,372,849,150400,25510
229,177,52,-,111100,25511
408,360,48,-,110000,25512
1480,1112,368,829,64600,25514
639,531,108,708,76700,25515
642,437,205,745,47000,25517
744,724,20,-,74000,25520
347,334,13,-,84000,25521
1006,675,331,620,81100,25523
1016,900,116,743,71800,25524
8802,6829,1973,794,201000,25526
336,254,82,633,59000,25529
2655,1805,850,660,103400,25530
98,53,45,-,69100,25534
866,815,51,-,200800,25535
607,455,152,636,133900,25537
156,144,12,-,33200,25540
4503,3319,1184,784,150800,25541
31,31,0,-,-,25544
1550,1455,95,1006,167600,25545
168,168,0,-,119700,25547
3775,3096,679,556,120100,25550
716,531,185,713,166500,25555
691,556,135,536,72000,25557
696,557,139,-,94600,25559
2979,2410,569,1224,216800,25560
393,393,0,-,212200,25564
291,217,74,-,78000,25565
295,223,72,-,86500,25567
1654,1263,391,682,112300,25570
752,664,88,678,81500,25571
165,131,34,-,182200,25573
1964,1268,696,870,86900,25601
398,263,135,867,92000,25606
345,200,145,543,61600,25607
309,252,57,-,112100,25608
406,377,29,-,-,25611
197,130,67,-,-,25612
63,59,4,-,105500,25617
724,575,149,648,59300,25621
212,212,0,-,83200,25624
350,290,60,691,70400,25625
200,126,74,843,-,25628
124,104,20,-,80800,25630
192,148,44,-,14100,25632
566,441,125,608,95700,25634
465,320,145,663,152100,25635
530,341,189,617,55500,25637
227,216,11,-,70800,25638
174,134,40,-,88000,25639
191,142,49,-,-,25644
284,248,36,-,86800,25646
114,64,50,-,-,25647
523,375,148,-,116900,25649
15,15,0,-,-,25650
244,192,52,-,76500,25651
469,349,120,779,72600,25652
54,54,0,-,85300,25653
37,11,26,-,-,25654
2150,1193,957,519,82000,25661
71,71,0,-,-,25666
195,141,54,1040,84300,25667
359,297,62,-,-,25669
1378,1173,205,658,92700,25670
528,372,156,494,61800,25671
171,145,26,-,52900,25672
734,484,250,584,103400,25674
397,324,73,-,84400,25676
577,398,179,318,90200,25678
179,137,42,-,142100,25685
111,47,64,-,58300,25688
198,178,20,-,91700,25690
542,443,99,-,78400,25692
512,426,86,578,87800,25696
24,24,0,-,-,25699
9710,5476,4234,745,128800,25701
3222,1768,1454,677,70300,25702
2148,482,1666,805,64500,25703
6154,4098,2056,778,99700,25704
8939,6026,2913,834,136200,25705
6,0,6,-,-,25755
12688,8756,3932,765,113100,25801
28,28,0,-,-,25810
15,15,0,-,-,25811
563,426,137,673,65300,25812
2652,2198,454,1053,120400,25813
140,140,0,-,155100,25817
196,38,158,764,-,25818
187,166,21,-,-,25820
245,138,107,-,-,25823
1057,1006,51,-,113400,25825
122,122,0,-,51500,25826
776,681,95,534,176700,25827
626,527,99,664,83500,25831
1757,1529,228,1002,173700,25832
434,434,0,-,-,25836
140,140,0,-,161700,25837
305,167,138,-,65300,25839
2989,2431,558,827,110900,25840
152,127,25,-,114000,25841
397,287,110,-,412800,25843
524,333,191,680,65700,25844
131,113,18,-,-,25845
41,41,0,-,-,25846
35,35,0,-,75400,25848
262,108,154,-,-,25849
0,0,0,-,-,25851
42,25,17,-,-,25853
431,337,94,885,147400,25854
46,46,0,-,-,25855
15,15,0,-,-,25857
85,85,0,-,-,25862
0,0,0,-,-,25864
548,485,63,592,90700,25865
121,79,42,-,32300,25866
178,169,9,-,105900,25868
52,52,0,-,76200,25870
429,264,165,796,79200,25871
434,401,33,-,128300,25873
266,250,16,-,91300,25875
26,26,0,-,-,25876
539,398,141,587,104900,25878
40,24,16,-,-,25879
2093,1436,657,660,100600,25880
745,652,93,656,74700,25882
4312,3263,1049,666,102400,25901
102,102,0,-,-,25902
281,221,60,-,81100,25904
21,21,0,-,-,25907
20,20,0,-,-,25908
248,133,115,-,87900,25909
96,96,0,-,-,25911
121,121,0,-,-,25913
84,70,14,-,"10,000-",25915
61,61,0,-,-,25916
627,506,121,-,106300,25917
1896,1693,203,829,152200,25918
82,82,0,-,"10,000-",25920
1242,755,487,754,73800,25921
68,68,0,-,-,25922
196,196,0,-,54800,25928
113,96,17,-,93300,25932
4,0,4,-,-,25936
545,475,70,-,178600,25938
53,53,0,-,89300,25942
0,0,0,-,-,25943
2443,1730,713,730,98300,25951
251,195,56,871,68600,25958
1369,1015,354,563,84600,25962
35,35,0,-,95000,25966
564,507,57,527,131600,25969
598,584,14,-,145100,25971
101,73,28,-,-,25972
997,853,144,566,118000,25976
0,0,0,-,-,25977
174,165,9,-,168200,25978
285,229,56,-,89300,25979
254,208,46,-,36800,25981
665,471,194,561,62200,25984
154,66,88,892,68800,25985
113,113,0,-,187500,25986
62,62,0,-,181100,25989
17383,12157,5226,725,137900,26003
249,197,52,742,51600,26030
727,504,223,662,76800,26031
207,175,32,688,82800,26032
695,631,64,629,106100,26033
2206,1702,504,744,99300,26034
726,687,39,-,91600,26035
117,100,17,-,227500,26036
2712,1975,737,543,92300,26037
1281,1174,107,822,195900,26038
182,148,34,-,80800,26039
628,443,185,492,77600,26040
5989,4542,1447,643,108300,26041
2390,1735,655,604,103200,26047
691,339,352,662,65000,26050
463,421,42,-,86000,26055
109,109,0,-,-,26056
28,28,0,-,-,26058
1115,843,272,880,118800,26059
652,576,76,720,164300,26060
9382,6371,3011,643,98800,26062
3669,2867,802,606,101200,26070
180,140,40,883,116000,26074
275,243,32,690,59100,26075
11914,7777,4137,754,88100,26101
7488,5350,2138,661,141200,26104
5168,3817,1351,762,147400,26105
457,423,34,-,176900,26133
271,195,76,531,102300,26134
134,128,6,-,83600,26136
248,208,40,-,84200,26137
91,52,39,-,-,26138
117,114,3,-,58000,26141
914,823,91,941,85900,26142
1574,1283,291,477,93300,26143
344,342,2,-,152900,26146
701,527,174,558,97300,26147
88,88,0,-,82700,26148
735,579,156,669,100300,26149
2353,1839,514,847,171700,26150
281,214,67,-,73400,26151
16,9,7,-,-,26152
2809,2270,539,773,122000,26155
946,745,201,783,79500,26159
396,380,16,-,108800,26160
221,221,0,-,150100,26161
0,0,0,-,-,26162
2997,2231,766,835,126800,26164
395,359,36,-,110200,26167
303,226,77,-,215000,26169
2185,1845,340,601,117400,26170
1198,1019,179,498,94700,26175
86,73,13,-,-,26178
791,616,175,862,97800,26180
2473,2061,412,916,169600,26181
862,756,106,-,139800,26184
2590,2364,226,842,162600,26187
7777,5727,2050,691,136600,26201
174,174,0,-,84400,26202
190,156,34,-,"10,000-",26203
1289,1008,281,563,80600,26205
928,681,247,580,73000,26206
308,259,49,-,72700,26208
79,55,24,1063,-,26209
0,0,0,-,-,26210
44,44,0,-,-,26215
36,12,24,-,-,26217
1065,935,130,828,108000,26218
71,47,24,-,116000,26222
107,107,0,-,105700,26224
0,0,0,-,-,26228
59,49,10,-,-,26230
565,553,12,-,-,26234
8,8,0,-,-,26236
205,184,21,-,59000,26237
468,455,13,-,107300,26238
5252,3508,1744,636,126500,26241
1694,1332,362,658,96000,26250
1268,920,348,810,136900,26253
56,50,6,-,-,26254
298,275,23,-,75800,26257
51,51,0,-,-,26259
588,483,105,515,176300,26260
1183,959,224,593,63100,26261
99,86,13,-,91700,26263
241,218,23,618,131900,26264
0,0,0,-,-,26266
195,101,94,-,-,26267
18,18,0,-,-,26268
436,385,51,-,151400,26269
217,164,53,579,88700,26270
186,156,30,596,140000,26271
277,232,45,608,105400,26273
222,174,48,658,71400,26275
260,260,0,-,98000,26276
299,246,53,-,69500,26278
560,399,161,757,87700,26280
61,61,0,-,67300,26282
618,534,84,-,134700,26283
106,92,14,-,85800,26285
1122,846,276,639,111400,26287
1337,964,373,607,83000,26288
42,42,0,-,1104200,26289
45,45,0,-,312500,26291
255,184,71,740,104000,26292
193,134,59,-,255900,26293
244,244,0,-,106700,26294
36,36,0,-,-,26296
34,34,0,-,-,26298
11588,7710,3878,717,97000,26301
253,248,5,-,81700,26320
100,72,28,-,-,26321
231,122,109,666,58800,26323
86,75,11,705,-,26325
42,42,0,-,107500,26327
6108,4539,1569,1061,215500,26330
579,506,73,766,67200,26335
368,329,39,650,76600,26337
235,171,64,-,81200,26338
42,33,9,-,-,26339
179,148,31,-,99600,26342
186,147,39,-,-,26343
205,167,38,531,124600,26346
759,663,96,794,160700,26347
159,123,36,-,63600,26348
58,28,30,-,87400,26349
1026,610,416,680,92800,26351
3965,3247,718,529,99600,26354
11,11,0,-,-,26361
1080,820,260,628,103000,26362
24,24,0,-,-,26366
259,147,112,936,113500,26369
326,280,46,1156,343200,26372
673,626,47,720,145600,26374
168,127,41,-,143800,26376
297,268,29,-,113500,26377
1676,1520,156,632,166600,26378
194,181,13,-,106900,26384
1297,1183,114,893,127900,26385
1041,838,203,595,103400,26386
120,120,0,-,-,26404
392,363,29,-,131300,26405
888,837,51,-,179700,26408
324,289,35,850,84700,26410
233,176,57,-,158200,26411
159,159,0,-,120800,26412
946,844,102,-,85700,26415
2915,1994,921,579,112400,26416
223,162,61,561,89300,26419
65,43,22,-,-,26421
173,146,27,-,76500,26422
13,0,13,-,-,26424
403,334,69,615,81900,26425
2388,2109,279,733,110000,26426
115,68,47,-,117900,26430
2268,1744,524,742,118700,26431
32,32,0,-,112500,26435
82,82,0,-,74100,26436
170,149,21,282,83700,26437
63,63,0,-,39100,26438
472,375,97,870,120500,26440
101,101,0,-,57500,26443
1383,1160,223,631,77700,26444
502,284,218,679,123800,26447
463,445,18,-,87000,26448
194,173,21,725,121800,26451
3772,2535,1237,692,99100,26452
1130,990,140,365,120400,26456
105,79,26,-,-,26463
8846,5063,3783,830,183100,26501
15859,5211,10648,875,232100,26505
0,0,0,-,-,26506
15203,11438,3765,902,252800,26508
708,484,224,706,89200,26519
281,281,0,-,124100,26520
60,48,12,657,-,26521
72,59,13,-,-,26524
2017,1818,199,722,165000,26525
420,243,177,829,85400,26534
2409,1755,654,599,138700,26537
1571,1437,134,509,189800,26541
821,703,118,622,135800,26542
108,34,74,-,-,26543
20,20,0,-,-,26544
12,12,0,-,-,26546
1107,827,280,724,157000,26547
17687,12430,5257,826,139700,26554
628,564,64,813,136300,26559
40,40,0,-,-,26560
226,196,30,-,83000,26562
110,57,53,-,93900,26563
239,209,30,-,72400,26568
1217,1045,172,660,141300,26570
634,547,87,837,97900,26571
111,72,39,1098,-,26572
164,133,31,640,74800,26574
319,281,38,411,80700,26575
394,394,0,-,106700,26576
372,322,50,-,-,26581
1597,1347,250,483,89800,26582
197,157,40,-,164600,26585
37,37,0,-,-,26586
121,79,42,-,77200,26587
1286,1048,238,699,151000,26588
298,298,0,-,-,26590
610,533,77,645,103800,26591
1211,917,294,568,102400,26601
276,213,63,544,93200,26610
48,41,7,-,-,26611
15,0,15,-,-,26615
40,40,0,-,102500,26617
156,156,0,-,-,26619
263,240,23,650,92900,26621
412,392,20,-,-,26623
1108,877,231,617,93100,26624
100,51,49,-,-,26627
118,118,0,-,84300,26629
88,88,0,-,170800,26631
173,161,12,-,-,26636
65,54,11,-,-,26638
3631,2658,973,593,116400,26651
121,121,0,-,153300,26656
175,152,23,-,-,26660
220,220,0,-,-,26662
29,20,9,-,110300,26667
198,198,0,-,83700,26671
128,128,0,-,86800,26676
510,510,0,-,101600,26678
564,502,62,1214,153000,26679
156,135,21,-,-,26680
561,476,85,-,92400,26681
134,74,60,-,104300,26684
260,218,42,-,49300,26690
144,141,3,-,-,26691
1761,1558,203,817,182100,26704
252,166,86,573,-,26705
93,72,21,660,66000,26707
824,731,93,676,164700,26710
943,773,170,1016,185500,26711
167,137,30,-,190100,26714
318,231,87,-,120400,26716
357,333,24,654,74300,26717
960,795,165,548,138900,26719
46,46,0,-,-,26720
119,100,19,-,-,26722
5039,3678,1361,678,141000,26726
137,137,0,-,259800,26731
330,294,36,-,129100,26739
645,595,50,-,233600,26743
296,152,144,453,53300,26750
2233,1876,357,895,178900,26753
170,162,8,-,135500,26755
2442,1792,650,656,134800,26757
325,307,18,-,67200,26761
439,322,117,-,153000,26763
1781,1433,348,579,102900,26764
200,151,49,952,157200,26767
456,368,88,619,232500,26801
390,293,97,585,136600,26802
169,140,29,421,95000,26804
845,701,144,665,141300,26807
232,201,31,-,225000,26808
227,219,8,-,159200,26810
681,559,122,586,121200,26812
168,168,0,-,96700,26814
259,233,26,430,163000,26815
196,196,0,-,-,26817
428,247,181,614,109600,26818
58,27,31,-,-,26823
888,824,64,-,127300,26833
2629,1867,762,893,127900,26836
20,20,0,-,-,26838
280,247,33,-,183800,26845
2249,1645,604,582,137600,26847
825,702,123,835,161600,26851
358,299,59,680,155600,26852
257,218,39,858,138600,26855
143,119,24,-,-,26865
262,250,12,-,182500,26866
98,79,19,-,118800,26884
84,66,18,491,32900,26886
6176,5632,544,782,252100,27006
819,687,132,638,151600,27007
1191,1135,56,1098,169300,27009
2273,1705,568,649,131400,27011
11171,9163,2008,892,248900,27012
2307,1808,499,682,136300,27013
301,195,106,875,95700,27014
761,614,147,925,120000,27016
3328,2505,823,651,119200,27017
3018,2511,507,695,183400,27018
1668,1332,336,676,163100,27019
2373,1741,632,668,146100,27020
7243,5361,1882,817,157100,27021
473,356,117,677,116800,27022
4766,4046,720,955,250500,27023
1085,935,150,767,154700,27024
4357,3548,809,626,116100,27025
1872,1154,718,534,95100,27027
9757,7541,2216,767,159500,27028
14784,10223,4561,641,125400,27030
4653,4310,343,1159,198800,27040
3294,2408,886,670,163800,27041
96,96,0,-,155600,27042
2532,2167,365,710,182600,27043
4102,3279,823,873,150600,27045
1148,915,233,503,154100,27046
459,406,53,-,156300,27047
3227,2686,541,718,127700,27048
1609,1457,152,743,147700,27050
3021,2090,931,935,152300,27051
4110,2971,1139,728,147600,27052
1365,1178,187,674,144100,27053
876,775,101,-,167400,27054
5223,4037,1186,657,152400,27055
9266,3049,6217,828,161100,27101
16075,8484,7591,950,172400,27103
13310,8150,5160,963,268500,27104
14900,7479,7421,768,104400,27105
19076,10512,8564,889,211100,27106
18438,12782,5656,784,150900,27107
0,0,0,-,-,27109
0,0,0,-,-,27110
16190,10141,6049,908,142700,27127
39,27,12,-,129200,27201
26,26,0,-,-,27202
9025,3964,5061,723,113400,27203
13886,11033,2853,731,146600,27205
1338,1071,267,575,147000,27207
612,537,75,-,130500,27208
1386,842,544,596,115200,27209
459,337,122,716,200400,27212
52,43,9,-,66700,27213
5042,3510,1532,944,211700,27214
19186,11679,7507,917,185700,27215
14131,8928,5203,792,117900,27217
918,747,171,595,103200,27229
992,780,212,1014,177100,27231
1193,1016,177,781,182900,27233
1894,1594,300,1090,211700,27235
3362,2662,700,748,135200,27239
611,353,258,617,101600,27242
2042,1788,254,779,197000,27243
4942,3670,1272,928,217900,27244
64,26,38,-,-,27247
1197,911,286,950,117200,27248
5173,4183,990,875,165500,27249
644,466,178,811,165700,27252
13127,9055,4072,806,165800,27253
67,67,0,-,-,27256
2713,2263,450,726,148600,27258
35,22,13,-,-,27259
9407,3637,5770,769,87700,27260
9010,5404,3606,922,172200,27262
8580,5956,2624,825,132800,27263
20559,14141,6418,982,194500,27265
0,0,0,-,-,27268
11338,8788,2550,1038,294400,27278
1303,1098,205,871,228300,27281
6089,4642,1447,1224,221000,27282
1212,1029,183,998,172300,27283
22910,16261,6649,903,192600,27284
9866,5955,3911,726,101800,27288
628,549,79,827,156900,27291
16550,10789,5761,729,150000,27292
15647,11450,4197,732,151000,27295
4094,2826,1268,782,150600,27298
1706,1339,367,913,134500,27299
3811,3313,498,1008,164200,27301
12915,9092,3823,979,209300,27302
779,572,207,1285,118500,27305
2304,1827,477,699,120900,27306
2824,2721,103,1277,407600,27310
1261,847,414,599,89200,27311
9505,7680,1825,843,346300,27312
2582,2219,363,791,170600,27313
304,264,40,-,112700,27314
751,649,102,869,117600,27315
2738,1884,854,742,117100,27316
6686,5157,1529,761,123300,27317
16033,11406,4627,687,133000,27320
2538,1890,648,580,89600,27325
1311,946,365,602,115600,27326
15002,9357,5645,858,156800,27330
12181,8372,3809,959,166300,27332
15,7,8,-,-,27340
1764,1506,258,805,137500,27341
22,18,4,-,160000,27342
549,501,48,961,-,27343
6718,4383,2335,832,162700,27344
2492,2044,448,744,158800,27349
2424,2092,332,773,134700,27350
68,68,0,-,-,27351
886,551,335,686,157200,27355
875,623,252,620,136800,27356
3551,2966,585,870,184100,27357
5328,4663,665,1043,336000,27358
18108,12131,5977,739,139500,27360
5392,4742,650,847,136700,27370
2873,1998,875,557,127900,27371
115,29,86,-,-,27374
3480,3094,386,753,262600,27376
3738,2868,870,1006,219600,27377
1887,1229,658,526,133000,27379
7590,2585,5005,776,112200,27401
7815,4138,3677,954,179500,27403
19497,8865,10632,856,117200,27405
24710,13623,11087,924,140600,27406
21662,10257,11405,944,159700,27407
7575,5321,2254,984,251700,27408
8076,2882,5194,953,143400,27409
24349,15461,8888,1111,239400,27410
0,0,0,-,-,27411
0,0,0,-,-,27412
11726,8560,3166,1045,254200,27455
8076,6380,1696,901,187800,27501
15795,12691,3104,1480,370600,27502
1385,1202,183,-,303100,27503
5867,4305,1562,783,156400,27504
2915,2173,742,885,141800,27505
0,0,0,-,-,27506
689,473,216,885,144300,27507
864,669,195,650,202700,27508
1547,978,569,1003,159400,27509
6571,1954,4617,1166,350700,27510
13201,8911,4290,1199,305600,27511
19076,12040,7036,1285,371400,27513
9883,4972,4911,1261,510400,27514
16400,11247,5153,1303,392000,27516
11222,7675,3547,1381,450700,27517
8245,5327,2918,1364,456100,27518
21393,15055,6338,1589,473000,27519
16241,12265,3976,1101,210800,27520
2581,1760,821,912,142600,27521
4768,4034,734,1101,186300,27522
5509,3857,1652,1490,421500,27523
5027,3259,1768,901,150600,27524
5512,4240,1272,882,173700,27525
19654,15305,4349,1361,274700,27526
10959,9185,1774,1270,269600,27527
19786,14094,5692,1196,238300,27529
15530,9284,6246,742,141500,27530
42,0,42,-,-,27531
0,0,0,-,-,27533
13130,7200,5930,976,154800,27534
5923,2416,3507,728,93900,27536
8662,6180,2482,738,117400,27537
8801,7258,1543,1434,374800,27539
13875,11452,2423,1473,369300,27540
1475,1355,120,1035,246900,27541
3883,2535,1348,745,131700,27542
1725,1131,594,816,119800,27544
11911,8777,3134,1196,217100,27545
6880,4651,2229,921,166500,27546
9258,6535,2723,867,152300,27549
837,708,129,923,159200,27551
640,436,204,709,128100,27553
216,92,124,856,137500,27555
87,69,18,-,-,27556
2595,1729,866,715,122500,27557
1183,971,212,867,255900,27559
14806,6866,7940,1478,349900,27560
1287,1144,143,-,524300,27562
2119,1324,795,589,87500,27563
9308,6104,3204,835,152400,27565
560,392,168,809,144700,27568
3342,2279,1063,790,150700,27569
30,30,0,-,-,27570
2751,2386,365,890,347600,27571
2876,2657,219,707,213100,27572
4627,2444,2183,705,110400,27573
5945,5141,804,739,133700,27574
7017,4781,2236,796,133600,27576
9333,6241,3092,748,174000,27577
1244,1111,133,916,177500,27581
101,65,36,1229,114100,27582
2767,2460,307,718,185600,27583
100,42,58,-,-,27584
27840,21848,5992,1243,346000,27587
2628,1804,824,620,79800,27589
8378,6263,2115,1048,212500,27591
6017,5181,836,835,253300,27592
0,0,0,-,-,27593
55,55,0,-,-,27594
6978,5734,1244,1015,236600,27596
9981,7895,2086,853,197900,27597
0,0,0,-,-,27599
4371,1154,3217,1227,390100,27601
21127,12576,8551,1230,263600,27603
18100,10188,7912,1168,214800,27604
3624,1176,2448,1388,376500,27605
18835,6917,11918,1149,329700,27606
8861,4120,4741,1234,474100,27607
5113,3900,1213,1255,714300,27608
16399,8597,7802,1179,351200,27609
26086,16006,10080,1136,188600,27610
18460,9908,8552,1290,381300,27612
17505,12587,4918,1228,380900,27613
12785,9233,3552,1363,402400,27614
18865,13404,5461,1288,352300,27615
20907,12328,8579,1266,232700,27616
9500,4121,5379,1435,319100,27617
0,0,0,-,-,27695
0,0,0,-,-,27697
10712,3239,7473,1036,333500,27701
23944,15383,8561,1146,252900,27703
15865,8988,6877,1080,179800,27704
21130,9523,11607,1163,304300,27705
21279,10148,11131,1137,278000,27707
0,0,0,-,-,27708
0,0,0,-,-,27709
9103,8145,958,1346,261900,27712
23585,14154,9431,1210,278100,27713
6893,3408,3485,735,88700,27801
8534,5371,3163,890,139400,27803
12195,6821,5374,877,141200,27804
1354,1111,243,701,77100,27805
933,794,139,724,75200,27806
2194,1504,690,774,138600,27807
934,832,102,983,290000,27808
1781,1384,397,670,131900,27809
1693,1223,470,1015,194300,27810
1146,729,417,757,76900,27812
301,180,121,715,89400,27813
613,582,31,-,127000,27814
0,0,0,-,-,27815
1298,927,371,821,111800,27816
3023,2300,723,723,140800,27817
559,448,111,688,59600,27818
128,50,78,1077,55600,27819
859,677,182,658,107200,27820
64,64,0,-,55700,27821
3259,2662,597,747,118500,27822
2651,1719,932,736,59000,27823
537,380,157,-,-,27824
33,5,28,775,73800,27825
232,193,39,-,99100,27826
81,81,0,-,-,27827
3697,2475,1222,738,128000,27828
758,548,210,623,58300,27829
1730,972,758,671,127000,27830
1423,997,426,793,58300,27831
919,673,246,773,74700,27832
24304,9362,14942,833,126000,27834
2379,1882,497,675,134600,27837
1420,1033,387,779,80100,27839
125,101,24,933,54100,27840
15,0,15,-,-,27841
790,723,67,1069,333100,27842
324,217,107,728,78800,27843
1269,874,395,620,81800,27844
838,527,311,663,88800,27845
1162,867,295,684,84200,27846
355,220,135,1036,55000,27847
506,380,126,828,82500,27849
3040,2524,516,594,153200,27850
1857,1303,554,566,109000,27851
1148,1002,146,732,104700,27852
185,160,25,-,69100,27853
2136,1342,794,842,81800,27855
6104,4368,1736,801,151100,27856
545,377,168,880,88600,27857
22504,9792,12712,893,183100,27858
493,382,111,708,87600,27860
44,34,10,-,63300,27861
319,269,50,1035,186800,27862
4512,3620,892,919,140700,27863
1834,1149,685,729,92400,27864
805,760,45,1125,153200,27865
229,188,41,-,110300,27866
716,567,149,732,76900,27869
10227,5917,4310,735,106900,27870
1766,1156,610,687,81000,27871
147,97,50,-,-,27872
135,98,37,599,104200,27873
1861,1238,623,526,71000,27874
105,73,32,-,82600,27875
527,354,173,737,51500,27876
5,5,0,-,-,27877
497,197,300,815,88200,27878
125,108,17,831,93300,27879
1591,1274,317,779,162300,27880
8,8,0,-,23300,27881
3081,2111,970,723,132900,27882
1304,852,452,746,86200,27883
412,330,82,744,43800,27884
518,271,247,1339,57200,27885
7799,5125,2674,658,102300,27886
749,553,196,625,92800,27888
10532,6863,3669,767,140500,27889
883,391,492,659,73400,27890
1754,1365,389,906,95400,27891
5494,3642,1852,790,99800,27892
15756,6834,8922,789,109600,27893
8042,5929,2113,918,169400,27896
565,279,286,729,82700,27897
15079,9525,5554,967,179700,27909
4526,2983,1543,802,90600,27910
299,256,43,-,251300,27915
400,339,61,-,219900,27916
236,131,105,-,328800,27917
392,287,105,429,123800,27919
603,466,137,2023,282100,27920
1852,1362,490,1121,219400,27921
285,213,72,671,107700,27922
274,243,31,-,237200,27923
1171,925,246,764,90200,27924
1281,912,369,549,97000,27925
621,445,176,893,192200,27926
609,527,82,1290,472500,27927
813,646,167,757,145000,27928
1055,966,89,1114,333900,27929
5583,3438,2145,836,150500,27932
643,484,159,872,142700,27935
381,298,83,876,319400,27936
1239,973,266,1151,137900,27937
651,586,65,1074,107100,27938
1168,909,259,1048,233100,27939
243,223,20,-,283900,27941
259,179,80,-,84400,27942
243,148,95,1568,465200,27943
5059,3838,1221,965,189400,27944
630,553,77,-,150300,27946
445,423,22,-,199900,27947
5365,3954,1411,1198,281900,27948
3288,2863,425,1491,450600,27949
817,730,87,1092,190500,27950
385,333,52,1232,164400,27953
2742,2006,736,1143,287900,27954
47,47,0,-,276600,27956
555,368,187,-,115900,27957
4106,3733,373,1116,287300,27958
1521,1185,336,988,334900,27959
352,279,73,1260,387500,27960
3018,1819,1199,643,83400,27962
283,228,55,-,196000,27964
221,100,121,1520,213200,27965
361,238,123,1253,226900,27966
268,256,12,678,81100,27967
99,86,13,-,337900,27968
69,33,36,-,265600,27969
1320,973,347,912,80400,27970
76,42,34,-,326300,27972
520,371,149,-,243400,27973
320,303,17,-,149000,27974
1519,1356,163,680,236700,27976
98,50,48,-,259400,27978
333,276,57,535,170200,27979
827,725,102,-,163900,27980
719,521,198,942,246000,27981
13,13,0,-,-,27982
2987,2141,846,618,79700,27983
95,66,29,950,110000,27985
442,280,162,800,103200,27986
10512,6888,3624,767,146800,28001
483,461,22,1021,215400,28006
337,229,108,818,78100,28007
410,273,137,788,98100,28009
9973,6974,2999,1011,247700,28012
5100,3333,1767,781,132900,28016
0,0,0,-,-,28017
1855,1533,322,804,120000,28018
0,0,0,-,-,28019
754,560,194,696,86800,28020
5501,4015,1486,748,150900,28021
6097,4718,1379,792,148800,28023
0,0,0,-,-,28024
19802,13967,5835,987,196200,28025
26077,18655,7422,1168,263600,28027
12479,8922,3557,1347,365500,28031
1407,1001,406,899,195100,28032
1239,1032,207,688,118300,28033
7011,5163,1848,739,164800,28034
7435,6123,1312,1366,419600,28036
9315,7767,1548,958,360100,28037
11,11,0,-,-,28039
2876,2400,476,655,106700,28040
0,0,0,-,-,28041
110,59,51,637,91300,28042
7944,4902,3042,666,127100,28043
13267,7223,6044,891,128900,28052
16468,7508,8960,986,159800,28054
13321,10449,2872,908,214000,28056
1193,967,226,638,143900,28071
271,217,54,-,164400,28072
2301,1596,705,750,114500,28073
0,0,0,-,-,28074
6247,5700,547,1868,324200,28075
54,54,0,-,-,28076
187,82,105,627,85000,28077
24667,18126,6541,1488,336400,28078
13265,11200,2065,1542,259500,28079
2805,2229,576,1021,165200,28080
10269,6802,3467,888,169300,28081
9129,5253,3876,930,142600,28083
9923,7267,2656,758,146500,28086
943,728,215,-,156400,28088
19,19,0,-,-,28089
2631,2068,563,607,113600,28090
758,569,189,749,112500,28091
16008,11207,4801,810,162900,28092
2801,2347,454,789,195800,28097
1546,1098,448,1020,124500,28098
437,402,35,879,284100,28101
27,27,0,-,73500,28102
3994,3314,680,848,174000,28103
11445,10641,804,1454,362300,28104
16483,11451,5032,1394,294400,28105
2795,2437,358,921,251200,28107
40,40,0,-,-,28108
155,151,4,-,161800,28109
17949,13460,4489,1116,221500,28110
9940,7175,2765,905,194600,28112
2821,2134,687,742,107600,28114
15567,11274,4293,990,250200,28115
17736,12226,5510,1330,456200,28117
933,586,347,884,87100,28119
9291,6732,2559,932,190600,28120
2087,1747,340,933,206800,28124
991,811,180,928,205300,28125
2644,2210,434,779,192800,28127
2694,2020,674,740,134500,28128
2311,1957,354,704,206400,28129
929,695,234,830,121100,28133
4781,2973,1808,1330,234000,28134
1213,914,299,806,122800,28135
24,0,24,-,-,28136
1074,929,145,930,174800,28137
3819,2767,1052,880,144100,28138
7851,6061,1790,789,154000,28139
10254,5549,4705,848,163700,28144
12498,10045,2453,715,167100,28146
9032,5934,3098,859,170100,28147
10975,7383,3592,709,140200,28150
9381,5988,3393,733,139200,28152
1086,583,503,915,113200,28159
1887,867,1020,631,82200,28160
1913,1561,352,781,200400,28163
5875,4855,1020,904,196100,28164
3800,3091,709,1176,212500,28166
955,860,95,-,181800,28167
3991,3348,643,829,144900,28168
70,49,21,675,83800,28169
4279,2739,1540,746,91400,28170
18899,16850,2049,1380,436300,28173
2666,1914,752,901,165100,28174
8231,2289,5942,1594,350800,28202
9821,2984,6837,1614,584500,28203
5070,1197,3873,1402,454600,28204
21826,9238,12588,1146,299600,28205
5690,1883,3807,953,156100,28206
4134,3387,747,1280,1160500,28207
15641,6163,9478,1034,140700,28208
11339,5991,5348,1380,449100,28209
20838,11394,9444,1244,375800,28210
13019,7261,5758,1369,518200,28211
16443,6136,10307,1092,167000,28212
17674,8701,8973,1116,190600,28213
14430,11032,3398,1262,172900,28214
21754,13713,8041,1143,183700,28215
22067,11252,10815,1249,178100,28216
11513,3727,7786,1250,158700,28217
0,0,0,-,-,28223
15871,11153,4718,1256,431300,28226
21672,14893,6779,1195,229700,28227
0,0,0,-,-,28244
19395,6476,12919,1233,226800,28262
29853,19221,10632,1361,220500,28269
12623,9333,3290,1491,416200,28270
16199,8602,7597,1371,222600,28273
0,0,0,-,-,28274
27899,17780,10119,1611,394800,28277
11695,8726,2969,1528,333600,28278
0,0,0,-,-,28280
0,0,0,-,-,28282
7082,2517,4565,788,90500,28301
13628,5992,7636,944,139500,28303
14405,7722,6683,1065,122700,28304
2908,1627,1281,910,183700,28305
15767,9534,6233,977,171400,28306
4253,34,4219,1298,153600,28307
0,0,0,-,-,28308
0,0,0,-,-,28310
14139,6774,7365,951,153000,28311
7670,5346,2324,840,166800,28312
22089,9855,12234,1046,138800,28314
5072,3685,1387,762,193500,28315
1547,1296,251,771,105500,28318
3348,2454,894,638,99600,28320
1539,1111,428,903,169700,28323
183,103,80,545,79300,28325
7987,4811,3176,1318,190400,28326
7079,5783,1296,1175,232100,28327
9072,6051,3021,706,109600,28328
139,106,33,-,154100,28330
16,8,8,-,-,28331
243,201,42,675,108700,28332
3674,2470,1204,748,78100,28333
8669,5963,2706,741,133200,28334
3524,2300,1224,616,118100,28337
1566,1228,338,562,99000,28338
2620,1881,739,899,109100,28339
3561,2160,1401,612,69700,28340
1181,787,394,607,96400,28341
26,22,4,-,175000,28342
602,381,221,658,53900,28343
1379,1113,266,739,97100,28344
4387,2691,1696,577,82400,28345
431,319,112,814,85900,28347
13126,9394,3732,970,156500,28348
1350,932,418,736,104300,28349
107,107,0,-,168600,28350
1727,1185,542,632,67100,28351
8453,4721,3732,709,100100,28352
0,0,0,-,-,28355
2085,1626,459,585,162000,28356
1025,784,241,782,80900,28357
12576,7085,5491,718,94000,28358
0,0,0,-,-,28359
4696,3270,1426,632,88600,28360
20,18,2,-,90000,28362
389,209,180,662,96600,28363
4860,3588,1272,645,71200,28364
5868,4030,1838,756,93300,28365
1942,1448,494,770,92700,28366
50,14,36,754,-,28367
42,31,11,-,-,28368
845,601,244,680,64600,28369
2044,1410,634,903,98500,28371
3909,2486,1423,642,97900,28372
1043,800,243,845,184100,28373
8517,7235,1282,1495,350000,28374
64,44,20,769,86700,28375
14450,9910,4540,980,164100,28376
4133,2762,1371,593,75500,28377
40,19,21,-,-,28378
9524,6193,3331,711,98900,28379
2652,2126,526,691,101300,28382
2658,2079,579,679,65900,28383
3376,2342,1034,697,74500,28384
803,705,98,-,95900,28385
1954,1523,431,626,63000,28386
7120,4256,2864,956,284700,28387
8774,4194,4580,976,151200,28390
2256,1744,512,765,158200,28391
778,536,242,814,98600,28392
751,635,116,734,56600,28393
1906,1419,487,1581,186100,28394
822,665,157,952,163900,28395
890,615,275,611,105600,28396
2620,1452,1168,732,78600,28398
642,417,225,782,-,28399
10529,3959,6570,964,177100,28401
18092,6424,11668,1077,260000,28403
14638,8461,6177,1165,256100,28405
13476,11097,2379,1297,310800,28409
15156,11588,3568,1406,293600,28411
17972,10500,7472,1150,263900,28412
1197,794,403,958,174300,28420
599,462,137,636,113100,28421
3082,2555,527,1227,249500,28422
889,781,108,825,109200,28423
28,14,14,633,-,28424
3821,2829,992,746,162700,28425
3092,2129,963,1194,399000,28428
3366,2772,594,909,167600,28429
807,536,271,622,84000,28430
2716,1933,783,626,79600,28431
534,442,92,912,82400,28432
1617,1084,533,786,133200,28433
300,257,43,330,63800,28434
792,672,120,488,103400,28435
520,364,156,933,137000,28436
518,455,63,529,101800,28438
365,251,114,813,103400,28439
1102,770,332,769,78000,28441
567,485,82,619,88200,28442
8930,7252,1678,1218,272600,28443
872,693,179,977,142500,28444
3815,2774,1041,1215,251000,28445
451,396,55,-,136800,28447
346,161,185,477,45000,28448
899,645,254,1249,464200,28449
817,632,185,927,228500,28450
16081,13029,3052,1270,235000,28451
142,103,39,-,94500,28452
1409,1042,367,570,66000,28453
1019,916,103,1106,139000,28454
893,657,236,674,89100,28455
1462,1252,210,712,120700,28456
3996,3280,716,818,188200,28457
2114,1448,666,672,91000,28458
4755,3701,1054,1364,224500,28460
9886,8442,1444,1188,308700,28461
5084,4051,1033,738,153200,28462
2490,1783,707,637,102300,28463
877,505,372,854,126500,28464
3572,3125,447,1097,317200,28465
3588,2621,967,609,137100,28466
5913,5308,605,1203,223100,28467
2407,2017,390,1147,277300,28468
3642,3066,576,932,334400,28469
4317,3156,1161,900,176100,28470
6712,4334,2378,684,99200,28472
2023,1726,297,670,135000,28478
2312,1935,377,1011,182800,28479
1260,900,360,1698,863800,28480
7623,3441,4182,694,73600,28501
8625,5378,3247,765,107400,28504
763,517,246,805,65100,28508
0,0,0,-,-,28509
682,523,159,1028,197900,28510
264,206,58,-,112000,28511
1666,1360,306,1018,405600,28512
3952,2701,1251,617,131500,28513
1152,793,359,534,97200,28515
5263,3427,1836,794,207900,28516
2884,2322,562,702,110600,28518
161,116,45,1008,119700,28519
163,131,32,-,160100,28520
648,511,137,884,132700,28521
1022,678,344,593,139500,28523
92,92,0,-,181500,28524
1227,929,298,677,76200,28525
1194,767,427,939,93300,28526
554,426,128,678,182000,28527
233,196,37,-,118500,28528
760,598,162,673,115300,28529
3114,1917,1197,663,92600,28530
516,432,84,1056,213300,28531
7544,3773,3771,1120,156400,28532
0,0,0,-,-,28533
20,20,0,-,-,28537
855,470,385,754,70900,28538
6910,4616,2294,1054,162900,28539
18704,10109,8595,917,162800,28540
74,0,74,1606,-,28542
1891,49,1842,1250,-,28543
2364,584,1780,987,98900,28544
18171,9884,8287,1005,167900,28546
1810,0,1810,1340,-,28547
5259,3487,1772,693,100400,28551
87,87,0,-,81800,28552
180,147,33,-,301700,28553
47,47,0,-,75300,28554
2095,1482,613,880,118300,28555
388,286,102,-,288200,28556
7223,4561,2662,982,269900,28557
11276,7282,3994,903,156300,28560
16453,11754,4699,948,202600,28562
8481,6413,2068,911,182300,28570
1219,1048,171,938,310900,28571
2690,1856,834,646,88600,28572
721,523,198,658,155900,28573
6765,4751,2014,1103,159000,28574
75,69,6,-,314700,28575
83,53,30,-,-,28577
1754,1222,532,793,72700,28578
330,197,133,838,259900,28579
3832,2555,1277,747,95200,28580
52,45,7,-,167200,28581
697,532,165,1349,240400,28582
5864,4420,1444,1208,250100,28584
1470,1126,344,618,91500,28585
2925,2153,772,684,97000,28586
107,101,6,-,95000,28587
17,17,0,-,-,28589
10234,7656,2578,908,186100,28590
1764,1478,286,1294,405000,28594
21040,13857,7183,808,186900,28601
11579,7742,3837,714,139900,28602
3044,2368,676,883,254800,28604
1840,1269,571,937,355000,28605
661,536,125,625,78800,28606
11820,5986,5834,960,271800,28607
2425,2047,378,881,176400,28609
4231,3181,1050,790,119400,28610
164,164,0,-,69300,28611
4759,3822,937,769,115900,28612
9098,6482,2616,741,150100,28613
832,652,180,627,134200,28615
21,21,0,-,182500,28616
825,557,268,721,158400,28617
965,697,268,918,203400,28618
184,107,77,549,104600,28619
4017,2816,1201,651,131000,28621
1179,971,208,519,136100,28622
642,586,56,669,150000,28623
591,517,74,617,95600,28624
14956,11209,3747,855,162500,28625
1279,1151,128,882,198300,28626
616,463,153,617,135000,28627
18,15,3,-,-,28628
0,0,0,-,-,28629
8033,6106,1927,782,157100,28630
331,205,126,-,160700,28631
1764,1484,280,797,104100,28634
1342,1243,99,786,114500,28635
1655,1255,400,846,125500,28636
675,471,204,644,150600,28637
4470,3409,1061,635,141400,28638
2075,1406,669,623,181700,28640
23,0,23,-,-,28641
2327,1578,749,458,103300,28642
1626,1396,230,938,129200,28643
616,452,164,732,147200,28644
18366,13219,5147,655,120200,28645
175,133,42,-,405400,28646
409,267,142,540,105400,28649
4499,3696,803,768,151800,28650
2409,2033,376,595,136000,28651
61,22,39,-,-,28652
21,21,0,-,-,28653
1344,1144,200,860,150600,28654
21382,15608,5774,720,135100,28655
3614,2933,681,675,165900,28657
10524,7548,2976,793,144500,28658
8849,6042,2807,656,129200,28659
879,739,140,-,144300,28660
30,0,30,-,-,28662
298,271,27,-,-,28663
74,74,0,-,265700,28664
1098,889,209,585,122900,28665
55,30,25,-,-,28666
88,35,53,716,88600,28667
97,97,0,-,348100,28668
1263,1038,225,717,117500,28669
972,787,185,609,130800,28670
121,87,34,1065,161600,28671
64,64,0,-,-,28672
2839,2448,391,1416,338000,28673
2849,2157,692,675,172000,28675
1295,1154,141,607,160400,28676
13841,9091,4750,732,151600,28677
2171,1865,306,796,169100,28678
891,810,81,1080,235200,28679
9420,7778,1642,692,146300,28681
540,412,128,1125,442900,28682
570,455,115,728,115500,28683
859,788,71,767,242700,28684
746,575,171,663,103400,28685
763,573,190,595,132400,28689
3928,3123,805,712,121700,28690
2102,1581,521,1063,228300,28692
655,564,91,835,145100,28693
3148,2513,635,654,170700,28694
5771,3811,1960,657,173500,28697
1072,920,152,639,187200,28698
1494,1198,296,1258,229400,28701
249,224,25,-,219200,28702
7799,4808,2991,1182,285900,28704
2921,2348,573,781,169900,28705
227,180,47,-,142400,28707
110,103,7,-,140300,28708
1075,755,320,1087,197900,28709
0,0,0,-,-,28710
5540,3755,1785,1104,280400,28711
8588,6208,2380,793,274000,28712
3390,2666,724,658,185500,28713
6775,5142,1633,669,172700,28714
10234,7528,2706,1035,237400,28715
7432,5715,1717,788,174300,28716
637,533,104,647,320400,28717
192,146,46,-,187100,28718
2796,2004,792,565,119900,28719
72,47,25,1358,-,28720
4365,3024,1341,816,178700,28721
2759,1897,862,904,205600,28722
3208,1357,1851,770,285200,28723
44,17,27,939,-,28725
1311,736,575,899,160700,28726
1471,1245,226,1563,268400,28729
3140,2671,469,804,260600,28730
3525,2812,713,904,284600,28731
7084,5951,1133,1130,267600,28732
45,26,19,-,-,28733
13268,9790,3478,762,158300,28734
121,121,0,-,249400,28735
444,383,61,1147,346000,28736
9309,7410,1899,888,275900,28739
755,635,120,670,155000,28740
2163,1505,658,753,493400,28741
1258,1074,184,844,220900,28742
970,721,249,498,179600,28743
147,139,8,-,302600,28745
1195,1007,188,1057,353400,28746
863,704,159,642,187000,28747
4242,3002,1240,783,189800,28748
48,48,0,-,-,28749
1791,1519,272,935,224400,28751
12345,8838,3507,700,126800,28752
3904,3123,781,637,178300,28753
3461,2536,925,741,239100,28754
0,0,0,-,-,28755
1520,1197,323,666,187800,28756
2,2,0,-,-,28757
0,0,0,-,-,28758
3065,2562,503,1088,308800,28759
2938,2344,594,722,155200,28761
2871,2133,738,673,140300,28762
1081,725,356,793,202200,28763
448,349,99,959,207700,28766
2950,2565,385,741,239000,28768
0,0,0,-,-,28770
2917,2348,569,579,111200,28771
538,386,152,832,185000,28772
1227,1062,165,906,242600,28773
683,531,152,1545,481900,28774
215,144,71,-,457100,28775
3588,2758,830,588,170100,28777
3626,2724,902,927,186400,28778
7784,5151,2633,725,204300,28779
541,433,108,752,219000,28781
3061,2374,687,1107,266700,28782
500,294,206,682,210200,28783
3219,2564,655,863,248100,28785
9426,6662,2764,884,197700,28786
8680,6666,2014,1039,285300,28787
57,39,18,1125,267900,28788
2723,1793,930,788,176900,28789
1361,1193,168,1194,388100,28790
6588,5108,1480,954,270400,28791
14968,9360,5608,952,203900,28792
6544,2461,4083,966,370800,28801
14256,7533,6723,1246,321100,28803
9496,6526,2970,1256,418100,28804
8885,5517,3368,1040,276800,28805
17058,9726,7332,1042,239200,28806
2372,1880,492,777,133400,28901
395,342,53,-,-,28902
4489,3405,1084,748,215300,28904
1220,983,237,656,166800,28905
8701,7175,1526,768,172100,28906
346,290,56,-,167000,28909
633,488,145,749,115300,29001
2272,1720,552,496,84300,29003
3643,2579,1064,748,136900,29006
851,709,142,-,86600,29009
4389,3006,1383,758,90300,29010
638,576,62,431,144500,29014
512,439,73,645,93500,29015
10373,8448,1925,1085,274200,29016
1221,1005,216,715,95500,29018
8956,6783,2173,739,159800,29020
840,788,52,838,134000,29030
645,468,177,886,78900,29031
1799,1456,343,773,85500,29032
6092,3392,2700,1056,133900,29033
9446,8766,680,1502,318300,29036
301,292,9,-,151600,29037
1054,833,221,691,100300,29038
1554,1252,302,1071,53300,29039
3474,2488,986,928,140100,29040
1139,711,428,700,81500,29042
2128,1654,474,664,112000,29044
10440,8444,1996,1136,183000,29045
18,18,0,-,-,29046
1498,1266,232,633,113000,29047
1914,1519,395,775,85400,29048
153,139,14,-,108200,29051
566,541,25,-,71700,29052
7738,5486,2252,899,88600,29053
3599,3219,380,834,187000,29054
1542,1356,186,789,76600,29055
925,729,196,585,70500,29056
1791,1289,502,656,120100,29058
1966,1486,480,695,91900,29059
4721,3483,1238,1189,122800,29061
10,10,0,-,-,29062
13848,11115,2733,1359,184600,29063
267,235,32,-,88800,29065
3792,2755,1037,789,95800,29067
1862,1366,496,693,85900,29069
5894,4814,1080,836,155500,29070
24004,19746,4258,1121,244100,29072
18349,15083,3266,914,153700,29073
114,105,9,-,308600,29074
1225,1163,62,722,208000,29075
5958,5184,774,719,145200,29078
12,12,0,-,-,29079
970,834,136,619,87800,29080
511,420,91,613,76200,29081
199,193,6,-,105600,29082
1093,878,215,754,69400,29101
6248,4480,1768,646,133300,29102
464,397,67,586,79000,29104
388,327,61,833,81900,29105
1072,851,221,725,50200,29107
7831,5255,2576,894,100700,29108
507,455,52,697,137500,29111
1514,1237,277,771,62100,29112
610,503,107,770,67200,29113
601,508,93,815,81200,29114
10334,5013,5321,709,86900,29115
0,0,0,-,-,29117
5932,3915,2017,799,143000,29118
36,20,16,-,-,29122
2741,2169,572,745,109800,29123
1123,870,253,598,85900,29125
925,834,91,1042,155300,29126
3628,2924,704,781,191200,29127
1502,1190,312,823,84800,29128
1638,1313,325,758,120800,29129
2884,2393,491,796,200900,29130
294,241,53,825,95300,29133
3347,2511,836,884,110900,29135
893,729,164,496,75800,29137
3905,2826,1079,635,73200,29138
1927,1543,384,807,104700,29142
313,268,45,-,41400,29145
456,360,96,812,85000,29146
2390,1764,626,572,101000,29148
15584,8863,6721,821,116700,29150
728,12,716,1193,-,29152
6220,4606,1614,876,99800,29153
11030,7904,3126,945,149600,29154
2974,2282,692,816,88200,29160
4289,3079,1210,775,100500,29161
922,697,225,606,117500,29162
445,336,109,586,65600,29163
2040,1419,621,690,129200,29164
238,200,38,661,113500,29166
1446,953,493,835,77300,29168
10460,5646,4814,916,161300,29169
8769,6819,1950,885,155200,29170
3777,2924,853,895,133800,29172
167,137,30,-,100300,29175
0,0,0,-,-,29177
1480,1208,272,688,63100,29178
5021,3450,1571,741,95000,29180
8863,2406,6457,1057,203800,29201
16179,7430,8749,924,98900,29203
7144,4384,2760,887,147300,29204
10771,5600,5171,930,266600,29205
8346,5374,2972,1185,273600,29206
4,4,0,-,-,29207
0,0,0,-,-,29208
14599,8691,5908,1098,154200,29209
17139,6354,10785,935,144500,29210
12325,8494,3831,1143,174700,29212
21702,11903,9799,1072,159100,29223
0,0,0,-,-,29225
18305,12616,5689,1502,176700,29229
13581,7770,5811,959,159800,29301
7216,5248,1968,905,187500,29302
9093,4375,4718,827,122600,29303
6882,3028,3854,786,121800,29306
8010,5439,2571,882,163600,29307
11094,8756,2338,920,170300,29316
222,177,45,-,67700,29320
1095,890,205,594,61800,29321
3703,3145,558,775,175300,29322
5540,4513,1027,763,140100,29323
37,37,0,-,-,29324
5025,3347,1678,763,122200,29325
75,66,9,-,33300,29329
3380,2617,763,819,108600,29330
51,51,0,-,-,29331
1112,947,165,841,80200,29332
102,48,54,-,"2,000,000+",29333
5710,4174,1536,1098,219000,29334
1917,1550,367,-,94400,29335
25,25,0,-,-,29338
7748,5619,2129,684,86800,29340
7677,5012,2665,810,138800,29341
99,81,18,1275,83200,29346
12877,11183,1694,852,170300,29349
556,431,125,532,56400,29351
1488,1195,293,497,99200,29353
301,266,35,434,85000,29355
3737,2966,771,560,208100,29356
8139,5478,2661,768,121500,29360
299,242,57,780,27000,29364
4673,4158,515,1200,182200,29365
82,49,33,-,-,29368
6151,5461,690,1080,182800,29369
289,204,85,-,122600,29370
1698,1397,301,721,86800,29372
114,77,37,1513,29300,29373
1352,1117,235,805,154200,29374
34,12,22,861,-,29375
3031,2612,419,927,179100,29376
220,24,196,624,-,29377
60,0,60,839,-,29378
7462,4668,2794,721,82900,29379
1493,1316,177,669,132900,29384
2759,1985,774,852,164100,29385
6070,4924,1146,739,178300,29388
3910,2267,1643,1531,1080300,29401
9451,3491,5960,1484,486600,29403
571,0,571,1595,-,29404
11156,5110,6046,1021,172800,29405
12490,5209,7281,1071,182900,29406
16630,9269,7361,1206,339400,29407
35,5,30,-,-,29409
7399,4950,2449,1223,267200,29410
16397,11691,4706,1570,360700,29412
18920,11732,7188,1405,292300,29414
10586,5847,4739,1145,170400,29418
8684,5323,3361,1291,212600,29420
48,0,48,-,-,29424
0,0,0,-,-,29425
683,549,134,991,227500,29426
1590,1506,84,2083,375500,29429
2374,1886,488,912,177100,29431
1075,637,438,463,106500,29432
316,269,47,-,-,29434
1680,1515,165,794,139900,29435
1830,1452,378,749,106000,29436
910,791,119,545,136300,29437
1167,1013,154,1157,380700,29438
571,414,157,-,628500,29439
10113,8153,1960,906,131600,29440
21360,14899,6461,1267,197600,29445
423,364,59,-,52700,29446
1020,774,246,1038,152900,29448
3002,2536,466,723,242600,29449
1117,961,156,714,119900,29450
1930,1694,236,2731,889300,29451
99,99,0,-,82000,29452
538,295,243,938,298100,29453
10610,8843,1767,1292,392700,29455
12282,7996,4286,1293,191200,29456
934,767,167,1772,174800,29458
15326,12123,3203,993,214900,29461
23241,14936,8305,1801,526600,29464
15098,12875,2223,1736,474600,29466
840,485,355,440,101700,29468
353,353,0,-,285200,29469
1718,1358,360,932,238200,29470
562,325,237,843,116800,29471
3235,2777,458,970,168900,29472
854,610,244,745,100000,29474
889,766,123,-,72000,29475
3022,2300,722,883,82500,29477
2659,1802,857,732,85000,29479
601,506,95,698,60400,29481
832,688,144,2313,"2,000,000+",29482
20566,15778,4788,1092,231200,29483
21364,14890,6474,1265,248800,29485
14569,11325,3244,1301,243200,29486
1080,920,160,1147,346400,29487
8311,5678,2633,670,97300,29488
8054,5158,2896,1552,601800,29492
66,59,7,-,82500,29493
18606,11486,7120,844,176600,29501
9776,6725,3051,992,150900,29505
6826,3676,3150,719,95300,29506
3535,2721,814,679,90600,29510
1973,1638,335,815,191800,29511
6005,3576,2429,628,69500,29512
222,170,52,790,53800,29516
408,291,117,846,-,29518
111,50,61,-,-,29519
5198,3563,1635,775,91400,29520
706,468,238,460,56900,29525
15983,11929,4054,897,170000,29526
9365,6931,2434,837,156800,29527
884,647,237,642,-,29530
7903,4908,2995,744,94400,29532
5829,2991,2838,629,84900,29536
1948,1641,307,745,59800,29540
3241,2626,615,919,146300,29541
117,87,30,-,140500,29543
2274,1797,477,854,167600,29544
648,392,256,658,64400,29545
1054,796,258,701,102000,29546
903,595,308,686,80500,29547
11627,8324,3303,750,123800,29550
3429,2504,925,826,79500,29554
2016,1555,461,618,101700,29555
4793,3253,1540,648,77500,29556
5065,2899,2166,634,86900,29560
738,430,308,525,89000,29563
458,354,104,700,70800,29564
2500,1615,885,663,70200,29565
8584,6880,1704,1006,203200,29566
150,102,48,711,48300,29567
6104,5040,1064,1157,186800,29568
6257,4116,2141,721,125900,29569
1363,720,643,661,51800,29570
4896,2592,2304,594,87700,29571
4923,3741,1182,1009,286000,29572
3738,2381,1357,498,73300,29574
8032,6079,1953,1183,228700,29575
15047,12939,2108,1290,237400,29576
14413,8340,6073,982,208900,29577
17557,12063,5494,1211,237600,29579
554,416,138,1043,80800,29580
1607,1219,388,562,107600,29581
8925,7011,1914,1101,292900,29582
1881,1375,506,558,84600,29583
1069,915,154,778,60100,29584
7455,6229,1226,1220,341500,29585
18199,14050,4149,1076,194800,29588
44,0,44,-,-,29589
908,704,204,754,60700,29590
1803,1356,447,660,62100,29591
274,215,59,758,43400,29592
810,510,300,730,55200,29593
105,39,66,-,77500,29594
931,765,166,-,60000,29596
6590,2089,4501,1133,450000,29601
15446,10299,5147,899,173400,29605
18947,8662,10285,1126,241800,29607
12920,8000,4920,918,231300,29609
12487,6813,5674,865,123400,29611
0,0,0,-,-,29613
4,0,4,-,-,29614
18036,9534,8502,1056,274100,29615
11056,7140,3916,859,154500,29617
4841,3782,1059,760,123000,29620
16931,12514,4417,875,190200,29621
6003,2873,3130,649,68100,29624
12254,8177,4077,850,154600,29625
5339,4177,1162,854,125800,29626
6200,4864,1336,758,117300,29627
1086,669,417,422,75300,29628
7073,3108,3965,831,166400,29630
6127,2634,3493,976,290400,29631
27,0,27,705,-,29634
426,395,31,-,160800,29635
1451,1097,354,757,109900,29638
414,294,120,821,179200,29639
12248,8849,3399,845,150900,29640
13417,11320,2097,818,207300,29642
1116,1008,108,839,268500,29643
7976,5901,2075,893,167400,29644
4244,3348,896,825,125800,29645
10864,6459,4405,743,110900,29646
10822,6606,4216,818,167100,29649
14300,10655,3645,1207,264000,29650
19182,15336,3846,872,200700,29651
1653,1361,292,887,102000,29653
3613,2817,796,835,93900,29654
2950,2461,489,620,91300,29655
6001,4903,1098,837,135600,29657
122,122,0,-,-,29658
54,38,16,-,591700,29659
2376,2081,295,731,152000,29661
5988,4210,1778,1137,176600,29662
813,645,168,876,174800,29664
82,82,0,-,134800,29665
2403,1940,463,767,125800,29666
79,66,13,700,128600,29667
4697,3816,881,748,152500,29669
4242,3062,1180,825,171300,29670
7074,5560,1514,804,158800,29671
5207,4135,1072,878,330700,29672
11179,8209,2970,876,170100,29673
2521,2394,127,-,358300,29676
9694,6320,3374,855,163000,29678
12164,9568,2596,1211,219100,29680
23157,20156,3001,1327,259100,29681
1549,1451,98,688,148500,29682
151,133,18,-,72600,29683
1999,1627,372,760,127600,29684
910,868,42,-,315600,29685
378,251,127,732,174200,29686
16295,12521,3774,1019,192600,29687
1686,1341,345,737,241900,29689
9101,7367,1734,786,200700,29690
4697,3394,1303,673,140200,29691
1884,1390,494,685,79000,29692
5749,4217,1532,765,134300,29693
1991,1665,326,-,164500,29696
5624,4024,1600,835,141800,29697
3397,2444,953,641,104800,29702
1395,1202,193,764,172800,29704
7671,5748,1923,694,102800,29706
12818,11837,981,1344,335200,29707
15199,11600,3599,1372,371900,29708
2402,1845,557,680,80800,29709
14369,11199,3170,1109,243600,29710
851,766,85,-,161800,29712
1181,972,209,916,146400,29714
13913,11350,2563,1273,297400,29715
556,379,177,945,113800,29717
1292,957,335,562,101000,29718
19335,14215,5120,788,160000,29720
20,0,20,-,-,29724
674,472,202,738,192400,29726
854,613,241,511,67300,29727
3679,2125,1554,751,93000,29728
839,702,137,926,83700,29729
23440,13091,10349,1067,172200,29730
22870,16388,6482,1106,219200,29732
0,0,0,-,-,29733
784,705,79,935,86100,29741
1010,856,154,955,131300,29742
735,569,166,720,225800,29743
12609,10035,2574,765,170800,29745
11062,6527,4535,959,133400,29801
16000,13340,2660,1004,209200,29803
2163,1955,208,833,173800,29805
968,708,260,718,96500,29809
1690,1154,536,628,49700,29810
4178,3121,1057,632,88900,29812
387,185,202,714,71600,29816
1541,1061,480,779,71600,29817
626,511,115,541,63700,29819
429,397,32,875,122500,29821
2770,1966,804,678,111700,29824
113,104,9,-,-,29826
1167,760,407,713,56500,29827
258,129,129,588,64500,29828
4124,3067,1057,1013,171200,29829
1926,1567,359,590,118400,29831
2031,1246,785,614,101600,29832
250,105,145,862,26300,29834
2651,2215,436,691,148600,29835
121,111,10,-,47900,29836
189,176,13,-,112900,29838
153,153,0,-,71600,29840
13774,9462,4312,867,155300,29841
2959,2229,730,721,96100,29842
454,384,70,746,91100,29843
64,43,21,900,124000,29844
549,384,165,827,68800,29845
1688,1266,422,811,117200,29847
290,258,32,468,97300,29848
114,46,68,-,47500,29849
3084,2337,747,935,95700,29851
2676,1647,1029,701,95200,29853
1024,963,61,677,106600,29856
6158,5456,702,918,208400,29860
0,0,0,-,-,29899
5794,3589,2205,1047,252900,29902
0,0,0,-,-,29904
0,0,0,-,-,29905
8860,4309,4551,1132,176200,29906
5483,4542,941,1376,321500,29907
10556,9959,597,1950,331300,29909
17184,13052,4132,1616,326400,29910
487,329,158,1019,89500,29911
0,0,0,-,-,29912
329,328,1,-,295400,29915
711,571,140,-,87600,29916
1622,1336,286,555,81500,29918
4197,3627,570,1114,278400,29920
144,117,27,-,71200,29921
297,291,6,-,48200,29922
79,64,15,833,55000,29923
1872,1410,462,686,122100,29924
10787,8182,2605,1342,469700,29926
3775,2667,1108,1173,189400,29927
7554,6494,1060,1602,623100,29928
412,369,43,975,75400,29929
60,42,18,920,82300,29932
194,167,27,-,190400,29934
1691,484,1207,1209,173300,29935
4649,3113,1536,1046,132400,29936
96,95,1,-,78500,29939
1672,1435,237,-,95600,29940
68,62,6,-,-,29941
194,194,0,-,144400,29943
1490,1075,415,697,68500,29944
2157,1651,506,699,79400,29945
2810,1588,1222,933,432400,30002
23933,18287,5646,1478,444200,30004
13498,9709,3789,1712,464100,30005
11648,7014,4634,1195,200700,30008
7563,4815,2748,1764,456300,30009
5836,4529,1307,1376,191000,30011
11562,6303,5259,1067,151000,30012
9389,5704,3685,1203,201500,30013
14933,9467,5466,1025,191700,30014
19625,15424,4201,1308,159300,30016
7502,6359,1143,1650,293400,30017
27,19,8,675,266100,30018
14742,12450,2292,1794,290700,30019
6563,1293,5270,1052,173000,30021
23465,16891,6574,1709,463500,30022
27369,22141,5228,1731,387300,30024
3691,3154,537,1007,248900,30025
10423,9287,1136,1657,321000,30028
12617,7809,4808,1395,524700,30030
16657,8176,8481,1108,169700,30032
13112,8707,4405,1344,355500,30033
16929,11314,5615,1089,163500,30034
7588,3852,3736,1239,137900,30035
14393,7926,6467,1262,159600,30038
15744,13135,2609,1501,206600,30039
25461,20987,4474,1584,364900,30040
24705,21128,3577,1533,399300,30041
28151,19782,8369,1455,260000,30043
30289,19281,11008,1436,219000,30044
13514,11360,2154,1843,240600,30045
13865,7076,6789,1193,206900,30046
21533,16041,5492,1406,244100,30047
24082,19446,4636,1358,239600,30052
4296,3575,721,1187,180200,30054
1392,1249,143,1096,227800,30055
786,662,124,920,189900,30056
21719,12550,9169,1237,153000,30058
13536,6133,7403,1157,220000,30060
23232,18752,4480,1470,370800,30062
18038,15108,2930,1324,338100,30064
21998,16938,5060,1500,299700,30066
19107,7669,11438,1337,356400,30067
12667,10912,1755,1359,447800,30068
48,43,5,-,79500,30070
8438,4417,4021,1266,241800,30071
325,192,133,1080,207100,30072
21172,17295,3877,1611,455400,30075
17237,11302,5935,1393,358100,30076
12934,10427,2507,1471,234400,30078
1357,588,769,937,213200,30079
24527,11831,12696,1342,334500,30080
10757,7547,3210,1477,309500,30082
20719,10324,10395,1154,154000,30083
15188,9925,5263,1325,265300,30084
13249,11044,2205,1460,234000,30087
10683,5946,4737,1212,146900,30088
0,0,0,-,-,30090
15135,7171,7964,1331,387000,30092
18995,5415,13580,1286,166600,30093
11759,9111,2648,1318,189600,30094
27057,12100,14957,1464,255700,30096
16839,12031,4808,1563,453800,30097
20710,16255,4455,1445,292900,30101
15034,11260,3774,1229,220800,30102
4881,3909,972,1117,158900,30103
1609,1137,472,818,133400,30104
839,672,167,490,191400,30105
8796,4617,4179,1168,177500,30106
5916,5199,717,968,288300,30107
2938,2123,815,656,117500,30108
5391,3825,1566,755,174000,30110
0,0,0,-,-,30111
1884,1565,319,768,142000,30113
20205,13519,6686,1381,305100,30114
16552,13633,2919,1365,325800,30115
9181,6805,2376,943,148300,30116
13142,6883,6259,913,177900,30117
0,0,0,-,-,30118
14309,10048,4261,976,206500,30120
9529,5827,3702,1017,202500,30121
10325,4642,5683,1223,162900,30122
1248,866,382,933,177700,30124
8527,5353,3174,742,131100,30125
15905,11552,4353,1300,268800,30126
23774,19257,4517,1547,242500,30127
15927,12484,3443,1169,245400,30132
14666,9480,5186,1051,171000,30134
22315,17352,4963,1305,191400,30135
757,559,198,969,154700,30137
1704,1280,424,899,133500,30139
7960,5960,2000,1243,185000,30141
9728,7940,1788,934,257100,30143
21225,12967,8258,1457,226500,30144
3136,2812,324,842,171500,30145
1759,1239,520,882,97600,30147
308,296,12,-,253300,30148
32,0,32,-,-,30149
15772,12794,2978,1462,310800,30152
6613,3969,2644,873,145500,30153
16642,13392,3250,1340,179100,30157
12946,8045,4901,819,150500,30161
15168,8776,6392,816,155000,30165
8993,4372,4621,1140,164300,30168
1111,940,171,875,153600,30170
922,768,154,1231,269800,30171
2584,1748,836,920,109400,30173
2200,1742,458,930,178600,30175
3018,1904,1114,765,116400,30176
530,475,55,528,183800,30177
1362,1145,217,763,218400,30178
6450,5598,852,962,156700,30179
13692,9909,3783,1225,184700,30180
1355,1036,319,757,162600,30182
2228,1850,378,1235,289900,30183
2408,2051,357,924,204400,30184
1446,1245,201,714,99400,30185
2828,2457,371,883,204700,30187
24491,18945,5546,1522,290700,30188
15093,11607,3486,1452,282300,30189
5235,3854,1381,705,154500,30204
1199,1110,89,791,388500,30205
1162,1049,113,983,197300,30206
14918,8854,6064,1524,201900,30213
11609,9331,2278,1340,252800,30214
12780,10996,1784,1502,288100,30215
865,606,259,823,156700,30216
3450,2434,1016,705,119700,30217
495,442,53,1103,120600,30218
1888,1403,485,1052,164600,30220
1905,1263,642,558,93100,30222
14408,8991,5417,898,143400,30223
10521,6958,3563,976,164100,30224
15728,11636,4092,1267,185600,30228
20,20,0,-,186800,30229
3492,2108,1384,848,137600,30230
8417,5974,2443,877,168300,30233
778,696,82,1115,108900,30234
17234,9223,8011,1085,160900,30236
13754,8074,5680,1214,137400,30238
11208,6825,4383,828,168200,30240
8680,4295,4385,969,126800,30241
9861,8279,1582,1216,179300,30248
0,0,0,-,-,30250
725,512,213,837,132000,30251
15580,13474,2106,1446,253600,30252
19653,12150,7503,1272,206700,30253
811,695,116,635,145800,30256
1477,1108,369,854,161300,30257
967,791,176,1093,172800,30258
1383,1227,156,1155,291500,30259
8301,3779,4522,1142,120300,30260
21821,14413,7408,1139,199400,30263
13612,10220,3392,1453,253400,30265
4151,2914,1237,1006,191500,30268
14655,10814,3841,1678,367100,30269
0,0,0,-,-,30272
6162,4721,1441,1163,136100,30273
12472,5632,6840,1073,115700,30274
77,17,60,-,-,30275
6235,5624,611,1138,292500,30276
8078,7406,672,1216,278800,30277
26750,15633,11117,1193,174600,30281
2,0,2,-,-,30284
189,164,25,-,-,30285
9023,5643,3380,681,113900,30286
3432,2581,851,959,162100,30288
0,0,0,-,-,30289
3199,2836,363,932,313500,30290
10331,4103,6228,1076,139300,30291
2064,1644,420,765,184200,30292
824,709,115,855,88700,30293
14862,11603,3259,1332,177500,30294
1602,1253,349,817,219500,30295
9971,6533,3438,1283,134900,30296
10349,3610,6739,946,81200,30297
1019,314,705,1395,188900,30303
14045,7598,6447,1647,633500,30305
11766,6916,4850,1634,666500,30306
9329,5589,3740,1669,594300,30307
14082,4522,9560,1579,351500,30308
16758,7746,9012,1747,364600,30309
11867,5759,6108,1031,223200,30310
14940,6490,8450,922,175000,30311
13207,4961,8246,1297,391000,30312
3293,1316,1977,1268,250800,30313
7726,2705,5021,937,148200,30314
13126,4776,8350,837,199900,30315
14768,9135,5633,1322,312900,30316
5997,4203,1794,1281,430300,30317
24206,9358,14848,1372,297500,30318
20064,11560,8504,1622,581800,30319
0,0,0,-,-,30322
16631,6052,10579,1524,422600,30324
4929,1884,3045,1856,446100,30326
9778,7655,2123,1752,855400,30327
17215,9752,7463,1677,451900,30328
11045,2859,8186,1493,375900,30329
24808,12346,12462,1130,200900,30331
0,0,0,-,-,30332
0,0,0,-,-,30334
193,56,137,1179,213300,30336
5315,1534,3781,967,243200,30337
15672,9898,5774,1590,482200,30338
17759,5717,12042,1556,368500,30339
10573,4942,5631,1256,257300,30340
13852,6663,7189,1444,367200,30341
14491,7166,7325,1556,653400,30342
14947,6056,8891,1164,175300,30344
10491,5402,5089,1493,425800,30345
3149,217,2932,1692,424000,30346
30974,17792,13182,1108,165500,30349
18407,7783,10624,1377,463900,30350
6273,2455,3818,1079,162500,30354
5369,3147,2222,1358,326200,30360
2042,948,1094,1806,305200,30363
5054,2694,2360,651,75800,30401
607,466,141,706,100800,30410
767,581,186,435,61300,30411
51,48,3,-,115800,30412
590,489,101,818,116300,30413
10,6,4,-,-,30414
2448,1816,632,873,153000,30415
3973,2528,1445,641,112600,30417
713,419,294,677,126400,30420
1139,923,216,566,75100,30421
25,20,5,-,96700,30423
493,446,47,-,94300,30425
371,340,31,814,55600,30426
3955,2750,1205,594,116400,30427
729,501,228,296,60900,30428
53,3,50,911,-,30429
1880,1154,726,578,75600,30434
4276,2783,1493,605,80600,30436
3845,2248,1597,632,89100,30439
674,494,180,713,85300,30441
3329,2565,764,639,78100,30442
984,645,339,599,84900,30445
507,418,89,793,116100,30446
5,5,0,-,75000,30448
23,9,14,-,-,30449
800,556,244,926,83500,30450
15,15,0,-,-,30451
532,389,143,871,113400,30452
2231,1392,839,598,75800,30453
133,94,39,-,-,30454
283,225,58,675,99500,30455
914,765,149,672,72400,30456
1820,1145,675,593,76100,30457
16409,6327,10082,852,154400,30458
0,0,0,-,-,30460
6712,4515,2197,927,181100,30461
30,16,14,-,-,30464
3927,2898,1029,579,88600,30467
371,253,118,762,-,30470
1490,1008,482,580,62900,30471
1078,850,228,640,78700,30473
6022,3724,2298,687,118300,30474
1048,682,366,491,64500,30477
10544,4412,6132,981,190500,30501
8643,4650,3993,1092,232700,30504
16202,13417,2785,1179,276700,30506
8339,6186,2153,992,176600,30507
2484,1707,777,660,129600,30510
1092,851,241,717,175900,30511
9519,7636,1883,681,218400,30512
5431,3739,1692,644,224800,30513
915,643,272,759,143200,30516
5533,4796,737,1229,283300,30517
17781,13310,4471,1310,271100,30518
16943,13157,3786,1687,283100,30519
1595,1175,420,854,106800,30520
1683,1235,448,723,145000,30521
353,296,57,560,230400,30522
4800,4028,772,691,205900,30523
3092,2242,850,818,181200,30525
1499,1285,214,978,230300,30527
8431,6402,2029,904,194700,30528
4135,2485,1650,959,187400,30529
2800,1930,870,865,161900,30530
3806,2682,1124,854,144800,30531
9396,6907,2489,949,216600,30533
10741,8596,2145,1188,250300,30534
2937,2207,730,851,163100,30535
3598,2706,892,867,223800,30536
608,493,115,1333,216500,30537
1268,1058,210,688,122200,30538
109,80,29,-,151900,30539
8127,5960,2167,730,218300,30540
709,601,108,1262,231700,30541
12642,9968,2674,1289,260100,30542
1698,1346,352,1107,174300,30543
375,270,105,657,248800,30545
3623,2806,817,814,248400,30546
1012,714,298,729,211900,30547
7949,7023,926,1023,335600,30548
9347,7779,1568,730,242400,30549
633,570,63,825,197600,30552
3362,2498,864,669,153400,30553
2960,2217,743,922,173800,30554
1313,1089,224,674,128400,30555
1867,1469,398,815,105200,30557
1759,1450,309,832,139300,30558
1871,1634,237,782,236200,30559
1901,1661,240,1308,215700,30560
244,149,95,744,113700,30562
1955,1731,224,728,149300,30563
1706,1393,313,830,256900,30564
1485,1157,328,1000,135900,30565
2968,1972,996,1152,174700,30566
1224,1024,200,950,228600,30567
748,592,156,758,181600,30568
1512,1325,187,1003,216000,30571
467,400,67,-,263800,30572
83,63,20,-,56100,30573
581,435,146,547,233100,30575
1052,841,211,-,215000,30576
8211,5886,2325,740,129800,30577
31,31,0,-,-,30581
1869,1537,332,647,229100,30582
0,0,0,-,-,30597
7,0,7,-,-,30598
10110,3691,6419,959,112500,30601
0,0,0,-,-,30602
17251,6185,11066,905,194300,30605
20625,9024,11601,969,262900,30606
4379,2756,1623,876,178500,30607
0,0,0,-,-,30609
645,530,115,954,168100,30619
4359,3770,589,1342,191900,30620
2014,1750,264,951,326000,30621
4202,3390,812,1438,307200,30622
29,24,5,1188,-,30623
1234,905,329,725,76400,30624
951,860,91,848,226100,30625
871,686,185,-,151400,30627
2105,1894,211,736,160100,30628
1806,1191,615,726,124900,30629
932,625,307,691,119900,30630
614,455,159,644,65200,30631
2709,2110,599,692,150200,30633
726,576,150,1051,108600,30634
6321,4415,1906,721,93700,30635
0,0,0,-,-,30639
712,653,59,919,238800,30641
5660,4538,1122,769,325400,30642
6325,4556,1769,735,176300,30643
2891,1943,948,869,164400,30646
1005,853,152,726,117800,30648
5042,3636,1406,929,240300,30650
9205,5706,3499,942,208300,30655
5983,4641,1342,1079,244100,30656
308,213,95,625,97500,30660
3083,2085,998,714,122000,30662
1006,730,276,907,229300,30663
13,13,0,-,-,30664
94,67,27,-,-,30665
3314,2700,614,1015,206700,30666
382,339,43,-,151400,30667
854,561,293,802,84700,30668
1065,729,336,799,82800,30669
2955,1972,983,802,79700,30673
6944,5863,1081,1285,304900,30677
454,389,65,806,107400,30678
16081,12279,3802,1062,179000,30680
2809,2095,714,689,166300,30683
14424,9000,5424,737,161300,30701
11792,8733,3059,721,138300,30705
6389,5185,1204,818,150700,30707
135,123,12,-,74900,30708
2447,1947,500,841,170900,30710
1421,1202,219,563,97200,30711
8962,5095,3867,826,186700,30720
18395,11528,6867,756,130300,30721
13,0,13,-,-,30724
1422,1269,153,828,162300,30725
0,0,0,-,-,30726
7515,5025,2490,716,109300,30728
667,549,118,758,70800,30730
963,682,281,750,127800,30731
888,741,147,713,130900,30733
1207,1036,171,1009,175800,30734
2227,1707,520,950,120200,30735
15792,13045,2747,842,184400,30736
1452,1282,170,883,146900,30738
2253,1852,401,899,174300,30739
3057,2647,410,822,175400,30740
11613,7979,3634,874,107100,30741
3324,1376,1948,739,128100,30742
390,342,48,-,188300,30746
5898,3929,1969,580,78600,30747
1165,959,206,886,307300,30750
42,42,0,-,31700,30751
3522,2368,1154,755,121900,30752
2365,1715,650,666,71400,30753
3662,2641,1021,735,139000,30755
16,12,4,-,-,30756
938,638,300,642,123300,30757
2010,1664,346,959,227200,30802
321,281,40,575,87900,30803
772,667,105,785,85400,30805
82,74,8,-,-,30807
1512,1190,322,814,111100,30808
15401,13368,2033,1538,277700,30809
691,460,231,703,102200,30810
0,0,0,-,-,30812
13260,10185,3075,1277,206400,30813
3439,2716,723,653,156700,30814
13900,9811,4089,1049,124700,30815
813,593,220,656,86500,30816
2860,2068,792,719,143900,30817
207,145,62,-,130500,30818
439,325,114,-,69700,30820
375,261,114,566,67000,30821
0,0,0,-,-,30822
495,299,196,627,83000,30823
6620,4505,2115,760,126700,30824
1331,892,439,551,78800,30828
5021,3371,1650,778,115800,30830
1345,764,581,683,122400,30833
7004,1866,5138,724,72200,30901
10403,4669,5734,849,145100,30904
820,19,801,1426,-,30905
20718,11512,9206,925,90200,30906
17312,12090,5222,1082,175700,30907
17467,8435,9032,974,184400,30909
0,0,0,-,-,30912
825,548,277,540,72700,31001
1081,779,302,555,103700,31002
48,48,0,-,151100,31003
0,0,0,-,-,31004
6972,5227,1745,1144,211300,31005
1779,907,872,740,85600,31006
291,229,62,475,72200,31007
7897,6065,1832,981,152100,31008
487,374,113,467,83000,31009
239,182,57,538,107100,31011
365,268,97,390,84700,31012
4303,3135,1168,697,99400,31014
7238,3912,3326,694,102600,31015
698,568,130,491,167100,31016
598,483,115,-,74100,31017
525,397,128,783,55000,31018
956,714,242,734,144000,31019
629,563,66,822,74100,31020
9944,5823,4121,668,142100,31021
661,508,153,713,132500,31022
4980,3158,1822,654,108200,31023
8850,6859,1991,849,168400,31024
376,376,0,-,175000,31025
3715,2438,1277,763,68500,31027
2065,1585,480,1033,146300,31028
5978,4551,1427,800,168900,31029
5955,3575,2380,701,110500,31030
2232,1750,482,685,80500,31031
5353,4282,1071,802,153600,31032
826,690,136,883,176500,31033
33,0,33,-,-,31034
382,308,74,800,111500,31035
3245,2215,1030,694,119000,31036
657,482,175,778,82500,31037
398,315,83,-,113800,31038
0,0,0,-,-,31039
285,167,118,662,49500,31041
521,452,69,802,76300,31042
966,824,142,500,74500,31044
27,11,16,-,-,31045
1323,1280,43,-,169700,31046
5722,5054,668,1262,197500,31047
604,461,143,584,77100,31049
446,340,106,-,332000,31050
33,19,14,533,-,31051
3033,2818,215,802,172400,31052
461,372,89,709,97400,31054
1256,842,414,527,73100,31055
728,412,316,406,89300,31057
630,423,207,290,86900,31058
680,539,141,589,72700,31060
15344,9383,5961,747,133800,31061
0,0,0,-,-,31062
1618,955,663,676,84300,31063
3489,2650,839,935,153900,31064
526,484,42,922,137200,31065
445,365,80,533,197200,31066
80,66,14,-,160200,31067
1163,715,448,570,48200,31068
9096,6329,2767,859,159400,31069
368,295,73,483,77500,31070
424,349,75,558,57100,31071
396,354,42,589,75000,31072
926,778,148,822,66200,31075
1040,842,198,674,88500,31076
376,306,70,500,71300,31077
1208,753,455,631,97700,31078
1039,769,270,549,63800,31079
22,22,0,-,-,31081
3950,2550,1400,726,105500,31082
96,61,35,518,64100,31083
0,0,0,-,-,31084
414,378,36,943,81800,31085
3030,2343,687,625,82400,31087
20733,12852,7881,1047,150500,31088
1606,918,688,752,83200,31089
410,261,149,822,73600,31090
1207,915,292,606,76600,31091
2001,1344,657,650,85700,31092
11100,6088,5012,869,102300,31093
321,296,25,-,123000,31094
2429,1802,627,548,75000,31096
478,413,65,663,146900,31097
1077,15,1062,1307,154200,31098
3500,670,2830,721,146300,31201
11866,5710,6156,760,91500,31204
9020,3634,5386,813,65600,31206
0,0,0,-,-,31207
13962,7580,6382,1047,204300,31210
6132,3417,2715,772,115700,31211
0,0,0,-,-,31213
6202,5145,1057,965,145500,31216
6168,4214,1954,736,73900,31217
5907,4027,1880,1141,160400,31220
1610,662,948,698,111800,31301
3027,2222,805,789,152200,31302
1088,855,233,808,152900,31303
2235,1776,459,681,137400,31305
448,391,57,-,250100,31307
3007,2377,630,1057,126100,31308
261,213,48,781,78400,31309
7262,6213,1049,1154,181000,31312
15166,7136,8030,1030,138600,31313
0,0,0,-,-,31314
2277,0,2277,1348,-,31315
4043,2739,1304,827,154900,31316
132,113,19,-,126000,31318
3281,2440,841,1065,155100,31320
2747,2140,607,860,135700,31321
10718,6206,4512,1319,229700,31322
691,584,107,877,86700,31323
10847,7858,2989,1597,279800,31324
8731,6163,2568,1069,194700,31326
18,18,0,-,-,31327
1615,1459,156,1159,537700,31328
3162,2217,945,1080,161700,31329
2409,1991,418,718,166500,31331
136,0,136,688,-,31333
8275,2827,5448,1138,388400,31401
12832,5854,6978,1069,145500,31404
14304,7696,6608,1204,226900,31405
13920,8518,5402,1158,203300,31406
8149,5156,2993,1383,177600,31407
3608,1286,2322,996,132100,31408
0,0,0,-,-,31409
9709,7310,2399,1422,285400,31410
4392,4052,340,1905,567500,31411
4153,1587,2566,865,97100,31415
22141,12030,10111,1139,174000,31419
0,0,0,-,-,31421
5803,3044,2759,647,85000,31501
7368,5223,2145,722,96500,31503
3192,2301,891,631,85100,31510
842,621,221,510,131400,31512
5722,4084,1638,618,83400,31513
5776,4462,1314,761,101700,31516
238,186,52,479,141700,31518
1476,1035,441,559,127500,31519
8493,3710,4783,826,103500,31520
7763,6471,1292,1422,389100,31522
5326,4540,786,1068,207600,31523
0,0,0,-,-,31524
11091,6953,4138,1041,158000,31525
668,545,123,-,439500,31527
257,211,46,-,57200,31532
6217,3365,2852,658,113400,31533
4254,3141,1113,684,108800,31535
3270,2379,891,447,97300,31537
5072,3483,1589,572,89300,31539
892,714,178,816,92500,31542
1651,1368,283,624,93900,31543
217,206,11,875,61000,31544
5928,3359,2569,730,124500,31545
2746,1801,945,744,126400,31546
0,0,0,-,-,31547
8390,5304,3086,941,177900,31548
665,442,223,511,63300,31549
251,239,12,-,88100,31550
354,303,51,737,151300,31551
283,255,28,-,62300,31552
1781,1280,501,694,80600,31553
1801,1270,531,691,78400,31554
1037,710,327,952,85800,31555
29,24,5,-,-,31556
1246,887,359,686,76200,31557
8364,4657,3707,1146,208700,31558
1082,772,310,643,102500,31560
60,60,0,-,-,31561
706,548,158,540,86400,31562
526,427,99,695,97700,31563
0,0,0,-,-,31564
1023,849,174,894,178000,31565
1376,1077,299,734,83500,31566
500,344,156,662,155000,31567
241,209,32,-,208700,31568
1996,1633,363,805,145700,31569
0,0,0,-,-,31599
12023,5416,6607,730,89400,31601
13046,5699,7347,879,157600,31602
8677,5386,3291,1049,169300,31605
1266,993,273,874,121100,31606
4016,2621,1395,786,121800,31620
678,486,192,619,92000,31622
43,30,13,-,65000,31623
475,367,108,562,55200,31624
475,230,245,611,220700,31625
1313,932,381,814,137800,31626
81,51,30,717,87500,31627
305,250,55,-,-,31629
225,189,36,724,66300,31630
241,187,54,573,71600,31631
4904,3992,912,1110,182300,31632
1826,1228,598,552,74900,31634
2493,1510,983,749,134400,31635
3833,2423,1410,788,161400,31636
1154,890,264,628,87800,31637
415,288,127,641,81300,31638
3845,2567,1278,643,110100,31639
592,493,99,950,122600,31641
1578,1190,388,558,62300,31642
3485,2327,1158,675,98300,31643
1636,1070,566,792,115800,31645
1010,557,453,850,85500,31647
341,255,86,-,64300,31648
370,254,116,890,120500,31649
1283,806,477,468,70600,31650
0,0,0,-,-,31698
0,0,0,-,-,31699
7439,2670,4769,732,88900,31701
0,0,0,-,-,31704
10421,4737,5684,735,79900,31705
10995,4909,6086,848,109800,31707
6222,3154,3068,783,126000,31709
247,148,99,567,81900,31711
484,407,77,727,43200,31712
2385,1490,895,588,85300,31714
1131,967,164,711,80800,31716
2737,1787,950,638,81100,31719
138,116,22,750,59200,31720
7979,5462,2517,1042,176700,31721
253,195,58,592,59800,31722
0,0,0,-,-,31727
3261,1787,1474,692,89000,31730
458,401,57,738,157800,31733
254,190,64,1338,192200,31735
936,674,262,735,140400,31738
53,41,12,-,170800,31743
1235,786,449,635,97300,31744
57,43,14,408,-,31747
929,656,273,710,78100,31749
7308,4359,2949,706,89500,31750
23,5,18,-,-,31753
627,616,11,-,99400,31756
4061,3076,985,1045,172800,31757
9724,7176,2548,1021,175300,31763
677,620,57,872,178900,31764
936,701,235,525,95200,31765
8136,4679,3457,652,103800,31768
2253,1484,769,634,64900,31771
213,204,9,-,157100,31772
1895,1387,508,825,163500,31773
2393,1610,783,668,79300,31774
1007,873,134,629,71300,31775
1066,835,231,691,77300,31778
2979,1898,1081,673,93600,31779
676,498,178,838,-,31780
677,443,234,885,84200,31781
541,486,55,562,100300,31783
370,237,133,675,86400,31784
638,504,134,760,134200,31787
3396,2285,1111,804,113000,31788
608,426,182,956,89100,31789
692,547,145,652,67600,31790
4352,2901,1451,763,98100,31791
9318,5058,4260,947,162200,31792
3240,2600,640,638,160200,31793
10638,5647,4991,703,120200,31794
594,494,100,814,81100,31795
495,375,120,946,157500,31796
390,308,82,-,64900,31798
1138,1041,97,649,114700,31801
1877,1250,627,549,89100,31803
2066,1934,132,905,249700,31804
1009,595,414,713,109400,31805
1538,1075,463,810,130400,31806
738,655,83,691,213900,31807
2803,2657,146,1219,236100,31808
99,89,10,-,56200,31810
2004,1724,280,1067,233000,31811
239,188,51,494,95000,31812
0,0,0,-,-,31814
834,621,213,-,37100,31815
2066,1205,861,833,110700,31816
4453,3988,465,1526,280900,31820
29,29,0,-,-,31821
2316,1834,482,794,165900,31822
321,282,39,-,155400,31823
468,375,93,403,55400,31824
1073,744,329,705,90900,31825
803,489,314,817,148800,31826
926,678,248,727,80800,31827
521,487,34,-,291800,31829
961,663,298,884,117700,31830
1358,1209,149,668,196600,31831
73,73,0,-,-,31832
2525,1900,625,661,124700,31833
408,333,75,526,94600,31836
3107,875,2232,733,147800,31901
7543,2198,5345,779,58300,31903
14016,6747,7269,917,168400,31904
3641,22,3619,1512,-,31905
8768,4003,4765,794,123300,31906
22637,12464,10173,959,115400,31907
15723,7780,7943,1129,161000,31909
11090,9586,1504,1684,292800,32003
2354,1873,481,820,96000,32008
1383,1200,183,864,149600,32009
5480,4613,867,873,185700,32011
5,5,0,-,-,32013
7220,6067,1153,1022,159000,32024
8127,4797,3330,858,148400,32025
0,0,0,-,-,32026
1915,1646,269,1069,252000,32033
16526,13872,2654,1008,365900,32034
3824,3239,585,792,146000,32038
2663,2338,325,968,147800,32040
11018,8718,2300,1133,217900,32043
813,554,259,1073,66400,32044
3602,2742,860,766,189400,32046
2245,1558,687,685,95600,32052
1289,1001,288,740,74300,32053
3567,2535,1032,699,133400,32054
6190,4014,2176,788,122800,32055
1494,1141,353,867,136100,32058
1109,806,303,728,74600,32059
7754,6152,1602,631,123700,32060
85,72,13,-,184400,32061
668,521,147,-,149600,32062
4523,3269,1254,901,183200,32063
2865,1326,1539,797,120800,32064
13336,10305,3031,1373,221500,32065
1978,1519,459,675,112800,32066
19950,15333,4617,1237,185300,32068
1173,994,179,-,116700,32071
43,43,0,-,251100,32072
15600,9857,5743,1200,196500,32073
172,17,155,1564,-,32079
9618,7613,2005,1400,400300,32080
7113,6295,818,2491,442500,32081
11696,9529,2167,1606,574800,32082
616,397,219,893,112600,32083
13125,8972,4153,1129,228400,32084
12531,9386,3145,1309,260400,32086
1209,809,400,730,133500,32087
5457,3316,2141,805,109800,32091
14569,12889,1680,1864,335100,32092
925,724,201,808,109200,32094
5218,4524,694,1193,377300,32095
1142,902,240,558,93300,32096
7650,5962,1688,1423,223500,32097
1120,980,140,1172,159600,32102
3272,2323,949,936,135600,32110
2767,1909,858,674,113800,32112
1927,1494,433,811,101500,32113
14270,4592,9678,1004,136500,32114
12399,6042,6357,1157,132300,32117
9639,5986,3653,1095,269900,32118
10403,6414,3989,1172,159700,32119
2312,1890,422,1417,271500,32124
12799,9477,3322,1147,230200,32127
8901,7299,1602,1470,303200,32128
10166,7180,2986,1244,189100,32129
1661,1410,251,1179,206200,32130
1665,1323,342,864,173700,32131
3741,3119,622,896,182300,32132
294,264,30,-,592900,32133
3198,2887,311,653,95900,32134
3905,3239,666,1168,334700,32136
18346,15523,2823,1491,270600,32137
338,317,21,-,78600,32139
570,495,75,902,73100,32140
8592,7567,1025,1151,187900,32141
1989,1536,453,933,162300,32145
796,666,130,-,82700,32147
4359,3401,958,679,63100,32148
163,93,70,884,139300,32157
15676,12663,3013,1106,214700,32159
29994,28334,1660,1541,281600,32162
13131,12696,435,1685,367100,32163
18982,13620,5362,1451,231600,32164
13517,10643,2874,1267,252300,32168
5889,4954,935,1531,375000,32169
22934,18094,4840,1131,238700,32174
6885,5407,1478,1257,272000,32176
10055,6246,3809,762,127000,32177
3665,2951,714,923,103000,32179
1409,1065,344,860,177400,32180
1159,780,379,797,88100,32181
21,21,0,-,-,32182
615,520,95,950,128300,32187
2449,1663,786,672,79000,32189
513,397,116,686,208900,32190
0,0,0,-,-,32192
560,464,96,832,207500,32193
1114,1049,65,-,141500,32195
2149,224,1925,850,153600,32202
0,0,0,-,-,32203
4314,1086,3228,972,222400,32204
14447,7522,6925,1015,203700,32205
6840,3191,3649,822,102600,32206
15890,7857,8033,954,189500,32207
13365,7114,6251,1036,99500,32208
14517,6680,7837,853,68300,32209
26474,14017,12457,1049,157100,32210
13301,6844,6457,971,153100,32211
237,2,235,1741,-,32212
0,0,0,-,-,32214
17224,7763,9461,1076,192200,32216
8807,4860,3947,999,240400,32217
23743,15356,8387,1174,196900,32218
5019,4121,898,917,156500,32219
4604,3850,754,1092,166800,32220
10397,7764,2633,1374,182400,32221
5450,4043,1407,1407,221400,32222
10311,8600,1711,1324,292000,32223
15366,8797,6569,1391,347000,32224
21065,14131,6934,1430,251800,32225
6389,5910,479,1792,262900,32226
544,0,544,1759,-,32227
0,0,0,-,-,32228
9901,5902,3999,1251,337800,32233
2750,2272,478,799,171400,32234
23759,13088,10671,1206,163800,32244
22370,12366,10004,1352,225800,32246
12403,8386,4017,1615,398500,32250
5100,2521,2579,924,65400,32254
22519,8446,14073,1319,279500,32256
16968,10527,6441,1199,235400,32257
14831,9898,4933,1669,261700,32258
19000,16458,2542,2013,372100,32259
2957,2092,865,1365,462200,32266
12859,6196,6663,1074,188000,32277
14163,4184,9979,1037,166000,32301
21986,10783,11203,1132,166300,32303
18175,2600,15575,996,129700,32304
7603,4687,2916,870,117800,32305
0,0,0,-,-,32306
0,0,0,-,-,32307
10827,5669,5158,1138,240400,32308
13011,10276,2735,1135,288500,32309
5775,2913,2862,859,89800,32310
8555,5459,3096,1284,239000,32311
12229,10430,1799,1335,327900,32312
0,0,0,-,-,32313
5353,4966,387,1250,286900,32317
1801,1297,504,872,188400,32320
1662,1294,368,805,99200,32321
951,771,180,871,173700,32322
53,42,11,-,-,32323
1843,1221,622,573,63400,32324
9942,8311,1631,968,184000,32327
1508,1222,286,971,251900,32328
212,97,115,725,96100,32330
1725,1461,264,738,69500,32331
520,231,289,651,75300,32332
4494,3696,798,808,159600,32333
581,466,115,707,104600,32334
531,389,142,805,68200,32336
27,27,0,-,-,32337
3526,2386,1140,712,113400,32340
1098,936,162,940,164500,32343
4577,3488,1089,675,162500,32344
873,716,157,1418,201500,32346
2455,1738,717,724,112500,32347
3920,3030,890,853,73100,32348
681,558,123,648,77900,32350
5792,3967,1825,655,85200,32351
1810,1400,410,913,107600,32352
152,122,30,880,218800,32355
0,0,0,-,-,32356
545,502,43,888,172100,32358
497,443,54,-,109700,32359
36,36,0,-,107000,32360
207,183,24,908,80200,32361
0,0,0,-,-,32399
8804,4714,4090,925,152300,32401
266,0,266,1715,-,32403
14273,10167,4106,1139,173100,32404
12216,7482,4734,1219,191600,32405
6153,3550,2603,1667,279500,32407
8706,6157,2549,1149,271400,32408
3729,3208,521,1015,158200,32409
279,209,70,1423,262200,32410
6835,5028,1807,1247,280900,32413
1178,1090,88,640,115300,32420
1445,1291,154,646,83500,32421
487,446,41,1660,146900,32423
2179,1587,592,527,113900,32424
4766,3447,1319,774,99600,32425
294,276,18,-,78200,32426
469,269,200,701,108200,32427
5936,4704,1232,729,130200,32428
326,246,80,-,119100,32430
1780,1397,383,709,113500,32431
0,0,0,-,-,32432
6971,5271,1700,873,97500,32433
2694,1900,794,764,143100,32435
282,207,75,806,108900,32437
1756,1549,207,772,68100,32438
5303,4225,1078,1137,257700,32439
1999,1357,642,710,88600,32440
1396,886,510,682,122800,32442
1109,946,163,673,100000,32443
7600,5504,2096,1367,235600,32444
474,313,161,696,69800,32445
3916,2661,1255,792,130200,32446
3349,2309,1040,660,88000,32448
340,309,31,-,66300,32449
1694,1382,312,687,84500,32455
3655,2782,873,1241,262400,32456
7880,6211,1669,1727,432800,32459
1690,1284,406,742,95200,32460
953,783,170,2235,677700,32461
1376,1198,178,750,112000,32462
81,45,36,698,151400,32463
1565,1411,154,727,75400,32464
2273,1841,432,677,118000,32465
2019,1666,353,950,130000,32466
4474,2043,2431,825,195100,32501
1725,891,834,1046,209700,32502
12984,8617,4367,1039,204300,32503
9608,5817,3791,1118,203500,32504
10852,5232,5620,954,76400,32505
14482,8662,5820,1090,154500,32506
13618,8397,5221,1039,192000,32507
555,0,555,1424,-,32508
0,0,0,-,-,32509
0,0,0,-,-,32511
0,0,0,-,-,32512
17435,8239,9196,1143,170600,32514
15004,11933,3071,1162,162800,32526
20,20,0,-,-,32530
2748,2349,399,869,218300,32531
10783,9156,1627,932,201300,32533
6778,4224,2554,1132,139900,32534
1669,1148,521,627,74100,32535
8780,5718,3062,1165,211700,32536
10637,8030,2607,1108,200800,32539
9104,6007,3097,1669,397700,32541
881,0,881,1814,-,32542
416,0,416,1615,-,32544
14313,7652,6661,1157,209800,32547
9937,5717,4220,1103,225200,32548
4251,3034,1217,1546,432800,32550
4123,3240,883,1684,463800,32561
10811,8674,2137,1402,284200,32563
992,860,132,866,116700,32564
2039,1663,376,1045,145300,32565
15286,12358,2928,1541,270400,32566
1574,1251,323,704,162500,32567
1214,1052,162,917,173800,32568
4828,3467,1361,1092,234500,32569
13445,9019,4426,1147,182600,32570
13461,11188,2273,1075,213100,32571
1855,1593,262,880,165800,32577
12862,9498,3364,1440,324500,32578
4452,3105,1347,1422,329100,32579
1535,968,567,1177,285900,32580
9570,7642,1928,1023,177200,32583
8603,2173,6430,943,203400,32601
1740,185,1555,953,227700,32603
11298,8259,3039,1241,216800,32605
10323,4873,5450,1356,254100,32606
12175,4274,7901,1056,231800,32607
20707,8753,11954,1170,276700,32608
7463,3976,3487,937,126000,32609
0,0,0,-,-,32610
4,0,4,-,-,32612
5984,4634,1350,1046,211500,32615
79,18,61,-,-,32616
1432,1253,179,655,126900,32617
3229,2635,594,735,169500,32618
2013,1735,278,593,106700,32619
2016,1591,425,673,92300,32621
575,360,215,638,167500,32622
682,528,154,878,212900,32625
3781,2888,893,733,122900,32626
1581,1264,317,753,82900,32628
183,183,0,-,139400,32631
7,7,0,-,-,32634
127,114,13,-,-,32639
4028,3385,643,917,129200,32640
5142,2898,2244,907,105700,32641
4171,3523,648,939,190400,32643
103,103,0,-,171300,32648
6383,5253,1130,935,208400,32653
5103,4145,958,895,154300,32656
73,58,15,-,68500,32658
139,106,33,1109,173600,32664
2746,2493,253,569,164000,32666
1865,1467,398,953,257900,32667
2279,2000,279,862,167400,32668
5282,4583,699,1126,243100,32669
4197,3653,544,483,84000,32680
63,63,0,-,-,32681
99,54,45,-,-,32683
2344,1529,815,713,255700,32686
40,40,0,-,-,32692
3978,3213,765,768,131100,32693
975,619,356,635,111500,32694
5302,4200,1102,771,158600,32696
68,10,58,1030,76000,32697
11274,5500,5774,1316,202300,32701
1228,763,465,2742,69800,32702
19247,12765,6482,1279,225400,32703
15695,10818,4877,1274,226500,32707
19422,14498,4924,1477,279500,32708
546,479,67,-,286700,32709
15902,12847,3055,1638,301800,32712
9149,8122,1027,1290,251900,32713
15818,7711,8107,1354,220100,32714
12271,8310,3961,1036,225200,32720
0,0,0,-,-,32723
16055,11614,4441,1073,211300,32724
18035,13921,4114,1262,188900,32725
9424,6110,3314,902,174000,32726
2865,1056,1809,1274,215000,32730
1817,1745,72,1112,368200,32732
2169,1789,380,1510,175300,32735
4120,3690,430,1187,296300,32736
15798,12456,3342,1213,183900,32738
1197,1022,175,1095,227800,32744
18501,11862,6639,1606,331300,32746
9522,7009,2513,1362,271900,32750
9243,5915,3328,1441,346800,32751
4664,4246,418,958,214900,32754
12268,8908,3360,1244,257700,32757
1014,843,171,1055,189300,32759
9817,6125,3692,1236,174100,32763
1032,945,87,998,272300,32764
21830,15894,5936,1667,320600,32765
5087,4444,643,1860,411400,32766
1110,966,144,1025,93400,32767
0,0,0,-,-,32768
20680,13088,7592,1289,261800,32771
11807,6529,5278,1269,184100,32773
0,0,0,-,-,32775
4493,3701,792,1335,299200,32776
10458,7904,2554,1048,181500,32778
11083,8925,2158,1732,368800,32779
16126,11493,4633,1047,183200,32780
4258,3202,1056,788,168800,32784
11035,7313,3722,1407,526300,32789
20913,10102,10811,1366,274000,32792
8419,6840,1579,1047,168500,32796
1117,1044,73,991,116300,32798
8621,2393,6228,1407,374600,32801
10420,5610,4810,1546,324200,32803
8676,5715,2961,1427,388700,32804
6944,2893,4051,859,177000,32805
11120,6947,4173,1269,341300,32806
12429,6215,6214,1217,181100,32807
19218,7854,11364,1154,164900,32808
9259,4772,4487,1111,197200,32809
13830,7034,6796,1310,200300,32810
14154,3830,10324,1233,129900,32811
14091,7834,6257,1238,273200,32812
3941,1602,2339,1970,588900,32814
0,0,0,-,-,32816
11123,6518,4605,1432,247700,32817
17486,9831,7655,1211,206500,32818
10034,5978,4056,1590,364100,32819
3123,2692,431,1819,331900,32820
8437,2823,5614,1542,234700,32821
23119,9697,13422,1347,169100,32822
14440,10823,3617,1561,263100,32824
19278,12883,6395,1450,251900,32825
8632,4382,4250,1269,187300,32826
5401,3284,2117,2026,397300,32827
23591,14906,8685,1623,315900,32828
6142,4566,1576,1653,260200,32829
22,22,0,-,95400,32830
35,28,7,-,10000,32831
9545,6355,3190,1819,344600,32832
3271,2542,729,1180,291100,32833
17730,7641,10089,1454,274400,32835
7751,4764,2987,1851,523200,32836
15618,9264,6354,1637,278000,32837
16899,4307,12592,1197,165700,32839
0,0,0,-,-,32899
10648,5116,5532,1099,174300,32901
6233,5224,1009,1466,387100,32903
13444,11024,2420,1474,255200,32904
10685,5935,4750,1174,152000,32905
16193,13762,2431,1339,193000,32907
4270,3740,530,1260,182500,32908
11530,9534,1996,1179,195700,32909
5906,3535,2371,938,270100,32920
6505,3185,3320,893,121100,32922
484,0,484,1734,-,32925
9333,7461,1872,1070,206600,32926
10224,9048,1176,1107,197400,32927
7179,5111,2068,1327,369500,32931
7309,6544,765,1452,301400,32934
17254,10385,6869,1147,182400,32935
11227,8861,2366,1483,328400,32937
18599,15538,3061,1718,335400,32940
1735,1203,532,873,152400,32948
962,923,39,-,382300,32949
1821,1645,176,1269,334800,32950
5826,4878,948,1421,393500,32951
8228,6970,1258,1084,334400,32952
9322,7166,2156,1077,321000,32953
15437,12067,3370,1380,262500,32955
12440,10221,2219,1185,217600,32958
0,0,0,-,-,32959
9367,5641,3726,985,192900,32960
9314,7832,1482,1058,168100,32962
7594,7155,439,1543,678100,32963
8651,6683,1968,1193,204800,32966
8791,6695,2096,1039,292900,32967
5440,4978,462,1714,299300,32968
45,18,27,-,-,32970
5048,4842,206,983,119000,32976
179,121,58,1981,-,33001
7003,3025,3978,1379,251100,33004
20180,10741,9439,1352,225700,33009
15483,4630,10853,1142,286900,33010
24959,12205,12754,1311,277500,33012
9481,5723,3758,1273,307100,33013
14311,6158,8153,1434,336100,33014
23078,11746,11332,1597,306700,33015
15606,7995,7611,1464,233500,33016
16681,12295,4386,1777,330800,33018
6371,4790,1581,1647,490500,33019
19434,6372,13062,1243,242300,33020
18969,12176,6793,1470,319400,33021
0,0,0,-,-,33022
20812,13648,7164,1381,263200,33023
24329,15640,8689,1472,286300,33024
26946,12103,14843,1542,268400,33025
12071,9672,2399,1693,297200,33026
24219,19076,5143,1459,330400,33027
8730,6613,2117,2158,426700,33028
13150,11903,1247,2318,443000,33029
10199,3800,6399,1157,270900,33030
2690,2417,273,1137,408200,33031
16043,9401,6642,1411,279500,33032
19036,10562,8474,1468,274000,33033
5448,1801,3647,1166,158700,33034
5287,2585,2702,1704,205200,33035
1792,1428,364,1622,801000,33036
5159,3986,1173,1702,562000,33037
0,0,0,-,-,33039
14608,6885,7723,1880,679100,33040
2908,2274,634,2249,591300,33042
1896,1498,398,1728,406400,33043
4299,2362,1937,1391,619800,33050
410,281,129,1491,574800,33051
10164,4740,5424,1103,216100,33054
11464,8897,2567,1368,265400,33055
10925,7176,3749,1428,245900,33056
13959,7074,6885,1218,273100,33060
13274,9118,4156,1584,404500,33062
24961,17789,7172,1470,223300,33063
22668,14100,8568,1469,231300,33064
19546,9810,9736,1548,317100,33065
8453,7067,1386,1490,154400,33066
8380,6149,2231,1754,479000,33067
18539,10720,7819,1645,215100,33068
11115,5079,6036,1417,191000,33069
2378,1765,613,1688,605000,33070
13401,9051,4350,1739,424300,33071
11655,6538,5117,1889,356200,33073
12833,11176,1657,2587,566100,33076
0,0,0,-,-,33101
258,242,16,-,"2,000,000+",33109
724,79,645,2184,1089800,33122
20956,5388,15568,1175,289200,33125
18017,6597,11420,1428,261000,33126
9891,2939,6952,1161,298300,33127
3577,117,3460,1045,266300,33128
6906,3112,3794,1977,456000,33129
16124,1695,14429,1399,370900,33130
12296,3804,8492,2324,488900,33131
8126,2132,5994,2217,504300,33132
14203,7314,6889,1655,718200,33133
16171,8964,7207,1598,549800,33134
14245,3110,11135,1133,324400,33135
6634,731,5903,1078,289200,33136
10405,2592,7813,1922,407000,33137
12766,6227,6539,1243,510900,33138
19898,5933,13965,1600,393100,33139
8709,4839,3870,1797,689800,33140
16538,5566,10972,1471,337600,33141
20091,5500,14591,1066,242200,33142
12669,7191,5478,1585,624000,33143
9535,5242,4293,1456,340400,33144
11459,5752,5707,1597,429200,33145
5160,3533,1627,2338,982400,33146
14747,6957,7790,1119,192900,33147
4601,3185,1416,2697,1238000,33149
11030,3151,7879,1000,275800,33150
5687,3431,2256,1895,649400,33154
14866,10052,4814,1701,411900,33155
11749,8462,3287,1809,846000,33156
20554,13612,6942,1318,363100,33157
2017,1915,102,2375,715300,33158
20050,11792,8258,1724,271100,33160
17264,7279,9985,1254,293100,33161
14605,7709,6896,1296,255500,33162
17042,12329,4713,1587,374000,33165
9418,4880,4538,1431,419600,33166
6537,3901,2636,1164,240400,33167
6687,5020,1667,1346,245600,33168
12858,6932,5926,1331,265900,33169
4201,2471,1730,1277,311500,33170
14604,6709,7895,1702,194000,33172
11644,8012,3632,1794,352900,33173
11170,5748,5422,1530,293500,33174
17019,12823,4196,1708,358200,33175
18635,11907,6728,1465,460600,33176
16052,11957,4095,1784,309300,33177
19069,9169,9900,2277,414500,33178
17863,10156,7707,1460,193000,33179
14528,9559,4969,2063,391400,33180
8164,3350,4814,1355,266000,33181
4106,3369,737,2147,369400,33182
12472,7926,4546,1649,299300,33183
6455,4592,1863,1698,303700,33184
8799,7200,1599,2328,396000,33185
22617,15414,7203,1865,337800,33186
5523,4849,674,2124,394000,33187
8156,4564,3592,1342,306900,33189
5118,2472,2646,1523,295000,33190
15548,9491,6057,1612,321800,33193
2093,1608,485,2317,402300,33194
16601,11335,5266,1920,375400,33196
9170,3644,5526,2061,587100,33301
9530,3642,5888,1411,465500,33304
6640,4505,2135,1467,453400,33305
1843,1349,494,1197,445900,33306
15638,10975,4663,1622,438000,33308
14066,8246,5820,1495,235400,33309
24737,11141,13596,1172,215500,33311
18490,11267,7223,1427,299000,33312
21780,9381,12399,1312,175900,33313
10435,3889,6546,1689,228900,33314
5895,3510,2385,1426,356700,33315
5552,3168,2384,1557,660200,33316
12762,9621,3141,1556,350400,33317
20733,13417,7316,1387,173600,33319
21625,15877,5748,1632,199900,33321
18399,15467,2932,1790,201400,33322
8319,5754,2565,2139,362700,33323
19516,11296,8220,1830,267700,33324
10364,7839,2525,1770,331600,33325
10655,7642,3013,2023,423600,33326
6557,5182,1375,2735,592000,33327
9940,8009,1931,1752,417100,33328
4614,4359,255,2541,567400,33330
7454,6278,1176,2416,538400,33331
3393,2973,420,2738,643900,33332
12730,7351,5379,1332,348200,33334
12589,7229,5360,1670,261000,33351
0,0,0,-,-,33388
13578,4704,8874,1480,297700,33401
4922,2181,2741,1261,248000,33403
11356,6016,5340,1245,216200,33404
8368,4898,3470,1192,305700,33405
8451,5683,2768,1397,241500,33406
12174,5748,6426,1313,214200,33407
9535,7517,2018,1585,394000,33408
11569,5080,6489,1401,210000,33409
15085,10629,4456,1786,371200,33410
27024,20452,6572,1621,306800,33411
5551,4699,852,1764,423200,33412
5421,3634,1787,1726,293500,33413
19306,14587,4719,1923,413400,33414
18184,10640,7544,1330,169100,33415
16050,9014,7036,1279,114200,33417
18010,14028,3982,1970,449900,33418
9992,6134,3858,1696,234500,33426
15775,10922,4853,1815,332300,33428
6524,2289,4235,684,116800,33430
7546,5406,2140,1942,434800,33431
10287,6166,4121,1830,680500,33432
19372,13796,5576,1958,326600,33433
10331,8110,2221,1336,259900,33434
14236,8551,5685,1611,230600,33435
19144,14071,5073,1669,266200,33436
18053,15676,2377,1647,315000,33437
153,116,37,-,88600,33438
6985,4878,2107,829,101200,33440
12682,6548,6134,1292,295500,33441
15358,10250,5108,1721,157200,33442
8984,4694,4290,1424,342800,33444
13796,9690,4106,1733,235600,33445
13680,12113,1567,1373,310600,33446
3265,3103,162,2811,491800,33449
9399,8007,1392,1106,295000,33455
20913,15471,5442,1799,416100,33458
12328,5358,6970,1229,255000,33460
15771,7644,8127,1333,193300,33461
12727,7847,4880,1400,251700,33462
20371,14336,6035,1469,244900,33463
21173,18510,2663,1452,326400,33467
6711,5884,827,1785,430600,33469
8961,8116,845,2207,383700,33470
2380,1815,565,675,79400,33471
8020,7558,462,1988,322200,33472
4116,3958,158,3205,594400,33473
2083,731,1352,674,97700,33476
6532,5694,838,1978,473400,33477
5132,4984,148,2518,470200,33478
6436,5361,1075,1720,1008600,33480
6584,4510,2074,2088,625000,33483
14639,11709,2930,1420,167900,33484
8816,6464,2352,1925,505800,33486
9859,7196,2663,1912,442200,33487
860,488,372,988,99500,33493
10121,8507,1614,2274,384900,33496
5742,5158,584,2484,446200,33498
77,57,20,-,332100,33503
11312,6859,4453,1184,213500,33510
22233,11906,10327,1398,237600,33511
4138,3237,901,927,156500,33513
761,461,300,856,119100,33514
206,147,59,838,108600,33521
6552,4748,1804,836,179200,33523
6860,5010,1850,872,184600,33525
5359,4004,1355,802,256200,33527
0,0,0,-,-,33530
5520,3810,1710,1147,214400,33534
2305,1789,516,690,121400,33538
4539,3665,874,858,97200,33540
9991,8254,1737,1117,82500,33541
10393,7268,3125,933,94400,33542
11371,9592,1779,1686,256300,33543
9437,6553,2884,1727,286800,33544
7199,5717,1482,1711,248300,33545
9100,7340,1760,1927,360800,33547
2688,2340,348,1558,405400,33548
7376,5801,1575,1348,249600,33549
0,0,0,-,-,33550
9714,8497,1217,1419,445700,33556
9958,7295,2663,1202,372000,33558
6335,4002,2333,1341,236700,33559
9940,5638,4302,1015,147600,33563
6086,4915,1171,977,189700,33565
7752,5423,2329,1177,232600,33566
3769,3091,678,1108,230100,33567
9421,7742,1679,1690,251700,33569
10296,7465,2831,1044,189300,33570
8767,7376,1391,1738,311900,33572
13640,11133,2507,1697,200400,33573
0,0,0,-,-,33574
2317,2122,195,895,231400,33576
22071,12443,9628,1455,226200,33578
12506,9413,3093,1869,261400,33579
9582,7148,2434,1195,218900,33584
484,380,104,868,190200,33585
4055,2672,1383,862,160800,33592
13077,10174,2903,1521,222500,33594
10198,8519,1679,1935,306800,33596
3187,2600,587,835,138900,33597
7705,6485,1220,965,266400,33598
8892,3072,5820,1778,407100,33602
8560,5050,3510,1100,249500,33603
15302,8620,6682,1061,199800,33604
7140,2502,4638,972,165800,33605
8693,3752,4941,1617,669500,33606
10694,4462,6232,1511,217000,33607
8330,5121,3209,1434,419600,33609
16775,7749,9026,1107,153800,33610
16136,8914,7222,1291,324300,33611
18746,6640,12106,1047,177900,33612
15808,4700,11108,1000,187900,33613
18410,7364,11046,1111,213200,33614
18494,9917,8577,1320,225200,33615
6086,3097,2989,1402,273700,33616
19168,7675,11493,1099,212600,33617
11957,7932,4025,1172,312900,33618
14074,7323,6751,1319,151100,33619
10,0,10,-,-,33620
536,0,536,2349,-,33621
15533,10104,5429,1405,265500,33624
11133,7519,3614,1599,280600,33625
11518,8022,3496,1719,381200,33626
10163,7971,2192,1415,629800,33629
7839,4418,3421,1405,219100,33634
7624,4624,3000,1433,231000,33635
7236,3190,4046,1209,171400,33637
25206,14554,10652,1545,330100,33647
9405,3627,5778,1227,413300,33701
14241,9350,4891,1139,213900,33702
11132,8868,2264,1304,310100,33703
7689,5374,2315,1165,468400,33704
11145,6656,4489,1223,222100,33705
8273,6284,1989,1308,478700,33706
12659,8597,4062,1217,262900,33707
7747,5793,1954,1571,363300,33708
10493,7936,2557,1140,150900,33709
14176,11411,2765,1315,227200,33710
6180,4109,2071,1313,200300,33711
9340,5301,4039,1183,213100,33712
14053,9714,4339,1132,201400,33713
8172,5177,2995,1113,125300,33714
3672,3289,383,2316,390600,33715
9557,1879,7678,1446,138700,33716
0,0,0,-,-,33744
10529,5969,4560,1068,214000,33755
13378,7887,5491,1077,232300,33756
7746,4154,3592,1500,211800,33759
7524,3374,4150,1176,159200,33760
8881,6897,1984,1373,206200,33761
2655,2069,586,1459,248900,33762
9755,7059,2696,1233,154300,33763
12091,8280,3811,1351,236300,33764
6526,3555,2971,1264,222700,33765
4120,3358,762,1778,557200,33767
11275,6895,4380,1160,189800,33770
12788,7713,5075,1186,92300,33771
9904,7235,2669,1247,243600,33772
7043,5387,1656,1287,212600,33773
8330,6438,1892,1236,243000,33774
5004,4555,449,1822,343800,33776
7057,5972,1085,1501,218300,33777
6219,5130,1089,1161,206600,33778
10384,6507,3877,959,175200,33781
9249,6868,2381,1375,186700,33782
2477,1879,598,1371,496900,33785
718,647,71,2353,769000,33786
11630,5786,5844,930,98200,33801
11878,7328,4550,1149,179700,33803
9473,4408,5065,1050,122000,33805
11272,7321,3951,1226,186100,33809
18926,14258,4668,1233,180300,33810
8554,6612,1942,1138,218700,33811
4556,3525,1031,1366,228200,33812
13391,10401,2990,1430,262100,33813
6004,3384,2620,907,23000,33815
12068,8475,3593,885,173200,33823
9905,7206,2699,766,113400,33825
879,774,105,1597,180000,33827
9917,6537,3380,901,161500,33830
1652,1088,564,797,84500,33834
29,0,29,-,-,33835
11775,9461,2314,1544,226800,33837
1492,1007,485,993,166000,33838
1260,941,319,1002,142300,33839
23,0,23,-,-,33840
2841,2160,681,800,121800,33841
3942,3297,645,796,76900,33843
14563,10157,4406,1021,156600,33844
102,78,24,675,112500,33847
209,130,79,905,-,33848
168,126,42,-,148200,33849
3175,2263,912,939,165700,33850
255,228,27,-,174400,33851
8995,7208,1787,913,148000,33852
4452,2364,2088,890,167100,33853
273,85,188,645,74200,33854
37,37,0,-,275000,33855
235,6,229,568,-,33856
619,473,146,-,70100,33857
188,77,111,-,-,33858
4263,3219,1044,949,167000,33859
8556,5756,2800,1003,166800,33860
291,211,80,596,135700,33865
90,90,0,-,86400,33867
4146,3606,540,971,154200,33868
10974,7398,3576,844,108100,33870
5834,5081,753,974,137800,33872
4741,2996,1745,816,105900,33873
4734,3783,951,797,171600,33875
2501,2129,372,933,126300,33876
125,125,0,-,167200,33877
14590,9202,5388,939,150700,33880
13437,9371,4066,1010,113600,33881
13607,10354,3253,1278,211500,33884
1400,1079,321,813,99900,33890
6471,3078,3393,1646,233800,33896
8803,5959,2844,1698,213500,33897
6670,5494,1176,968,123400,33898
9246,3772,5474,1076,238500,33901
10902,8739,2163,969,106300,33903
14605,11214,3391,1296,256900,33904
13046,8575,4471,1303,175900,33905
10805,4427,6378,1233,185900,33907
18899,13211,5688,1446,267900,33908
11751,8274,3477,1456,214700,33909
8609,7361,1248,1476,294400,33912
10000,8706,1294,1496,331600,33913
17216,13901,3315,1353,310700,33914
9339,3175,6164,1091,154500,33916
13709,11209,2500,983,130900,33917
14015,10603,3412,1357,230300,33919
2401,2224,177,869,254400,33920
435,410,25,-,"2,000,000+",33921
1779,1497,282,1098,238900,33922
35,35,0,-,-,33924
13072,11142,1930,1763,323500,33928
292,226,66,-,110300,33930
4695,4231,464,1384,358700,33931
6924,4993,1931,906,130800,33935
9360,5925,3435,1089,152700,33936
106,106,0,-,-,33944
1374,1267,107,-,509000,33946
4885,3827,1058,1155,261500,33947
7666,6523,1143,1182,217300,33948
11693,9581,2112,1172,311200,33950
14601,10767,3834,1048,169300,33952
3037,2946,91,985,250000,33953
4108,3183,925,1377,248700,33954
4684,4413,271,1131,260500,33955
1719,1531,188,2139,238700,33956
3471,3114,357,794,730400,33957
304,263,41,-,181900,33960
0,0,0,-,-,33965
4491,3118,1373,1338,297000,33966
9185,6816,2369,1419,255200,33967
7847,5996,1851,1386,193700,33971
4405,3418,987,1275,219300,33972
4037,830,3207,1166,243800,33973
5180,3384,1796,1377,193700,33974
4708,3225,1483,1364,186200,33976
6038,4740,1298,951,167700,33980
5448,4882,566,1338,273700,33981
4157,3564,593,961,168100,33982
6812,5660,1152,1061,265500,33983
12993,9306,3687,1400,246100,33990
9004,7159,1845,1706,269100,33991
9987,8403,1584,1688,247300,33993
0,0,0,-,-,34101
5334,3864,1470,1273,1025800,34102
5535,4580,955,1461,790400,34103
10888,7271,3617,1464,269700,34104
7766,4963,2803,1785,473900,34105
8389,7103,1286,1694,783400,34108
11908,8396,3512,1466,447300,34109
12584,9146,3438,1790,402200,34110
12938,10014,2924,1226,236800,34112
10341,7241,3100,1452,355600,34113
8634,7142,1492,1573,331100,34114
10541,5697,4844,1369,282100,34116
5331,4407,924,1529,332300,34117
13477,10686,2791,1481,512500,34119
12228,10619,1609,1803,327300,34120
7754,6351,1403,1451,528600,34134
19189,14997,4192,1418,324300,34135
139,114,25,-,135200,34137
326,272,54,-,-,34138
61,61,0,-,350000,34139
60,27,33,-,-,34140
16,3,13,-,-,34141
8598,4069,4529,842,218500,34142
8131,7290,841,1775,689000,34145
1706,1617,89,1835,484900,34201
9519,7227,2292,1810,468200,34202
16032,12187,3845,1200,227900,34203
12856,7737,5119,1093,176300,34205
14881,8983,5898,1093,96200,34207
13860,8022,5838,1207,208800,34208
15080,11916,3164,1409,269800,34209
7618,4798,2820,1226,222800,34210
5004,4423,581,1807,428300,34211
8462,6926,1536,1703,379900,34212
357,338,19,-,766000,34215
610,584,26,-,991900,34216
2042,1655,387,1652,553900,34217
9253,8316,937,1754,320900,34219
18247,14366,3881,1190,219500,34221
5552,4624,928,1194,150900,34222
9827,8266,1561,1137,283100,34223
7624,6173,1451,1002,182500,34224
4106,3850,256,2509,756500,34228
3534,3103,431,1175,547600,34229
15069,9881,5188,1347,294000,34231
14658,10106,4552,1587,249800,34232
8415,5841,2574,1523,295200,34233
8696,5134,3562,1150,159000,34234
6935,5125,1810,1467,260500,34235
7186,4188,2998,1543,741800,34236
6940,3111,3829,1302,200500,34237
10711,8337,2374,1622,408000,34238
6708,4936,1772,1472,325200,34239
4975,4558,417,1237,449300,34240
5865,5079,786,1660,376700,34241
3962,3451,511,1827,768700,34242
13301,10491,2810,1722,307900,34243
145,145,0,-,647700,34250
2322,2112,210,850,385200,34251
9826,6516,3310,781,103900,34266
39,25,14,-,-,34267
86,83,3,-,23100,34268
2256,2025,231,921,156000,34269
9789,8227,1562,1323,332900,34275
10348,8195,2153,1197,251000,34285
7418,6154,1264,1612,211200,34286
11635,8792,2843,1156,167000,34287
5010,4249,761,1421,214400,34288
1434,779,655,1338,282600,34289
2460,2117,343,1419,241600,34291
7919,6264,1655,1793,328000,34292
21260,18758,2502,1475,283200,34293
7081,5007,2074,804,126400,34420
4028,2903,1125,761,207700,34428
4057,3474,583,892,159400,34429
3701,3228,473,736,133100,34431
5699,4884,815,820,159000,34432
2973,2755,218,1055,165200,34433
3421,2881,540,1098,148900,34434
3645,3120,525,636,143700,34436
7673,6677,996,873,208900,34442
0,0,0,-,-,34445
8033,7194,839,882,159000,34446
4699,3860,839,839,117200,34448
1394,1041,353,478,102600,34449
4984,3910,1074,885,154300,34450
5378,4353,1025,1009,144600,34452
4194,3547,647,893,121600,34453
4557,3909,648,885,214700,34461
8026,6390,1636,1009,180800,34465
8723,4871,3852,955,126200,34470
10885,6770,4115,1073,215800,34471
11911,9245,2666,1070,140300,34472
7397,6305,1092,1172,161700,34473
7418,3238,4180,1237,157000,34474
4788,2093,2695,753,95500,34475
10931,9868,1063,1068,189100,34476
5542,3695,1847,1037,152800,34479
8398,6519,1879,941,199500,34480
11958,10720,1238,1093,145700,34481
7422,6084,1338,942,174000,34482
2769,1626,1143,-,308100,34484
0,0,0,-,-,34487
4886,3392,1494,932,62900,34488
13125,11511,1614,981,191200,34491
292,223,69,917,208300,34498
10336,7115,3221,899,108900,34601
2980,2593,387,1021,190400,34602
4425,3895,530,1061,196400,34604
12399,9494,2905,1001,161900,34606
3701,3103,598,1117,252100,34607
14207,10674,3533,1091,167000,34608
16397,13249,3148,1295,199800,34609
5531,4473,1058,1061,183300,34610
8360,7200,1160,1042,127600,34613
2719,2581,138,696,215100,34614
3075,2762,313,1633,293000,34637
10292,8423,1869,1880,290400,34638
10454,8513,1941,1536,275500,34639
11249,6902,4347,1000,149900,34652
15021,9752,5269,1095,131700,34653
8938,6938,2000,1279,187700,34654
18283,14597,3686,1384,269900,34655
166,94,72,-,159900,34661
15467,11497,3970,1054,156000,34667
21043,12566,8477,1087,117900,34668
5467,4629,838,1145,166400,34669
8788,6747,2041,1230,276600,34677
33,33,0,-,-,34679
422,422,0,-,413300,34681
13571,10384,3187,1348,317700,34683
13090,9394,3696,1454,214500,34684
7345,5523,1822,1435,378500,34685
3399,3109,290,1191,389400,34688
11529,8966,2563,996,236400,34689
5163,3156,2007,1100,89300,34690
9391,5744,3647,1055,123600,34691
7116,5964,1152,1386,297600,34695
18883,13695,5188,1148,247700,34698
1122,943,179,867,172900,34705
24097,18599,5498,1629,281600,34711
8159,4070,4089,1390,237500,34714
7537,5696,1841,1591,310900,34715
16,16,0,-,-,34729
4754,3799,955,1065,146800,34731
1300,1081,219,1631,301300,34734
9232,7831,1401,1543,247200,34736
1654,1421,233,1363,253000,34737
247,133,114,-,122900,34739
16380,5257,11123,1281,204200,34741
11739,8528,3211,1389,217000,34743
17589,12021,5568,1200,246600,34744
14803,10714,4089,1485,251100,34746
8069,4251,3818,1614,356800,34747
19237,13901,5336,961,172100,34748
1885,1506,379,1220,184900,34753
1298,1036,262,1211,366700,34756
10796,8423,2373,1418,199700,34758
12708,9376,3332,1403,216600,34759
304,251,53,1542,311500,34760
14022,9896,4126,1430,283100,34761
143,143,0,-,-,34762
8879,6157,2722,1114,212900,34769
7042,6156,886,1356,336700,34771
8931,7681,1250,1448,265300,34772
1220,1051,169,2028,242600,34773
6249,3951,2298,1054,99700,34785
14869,10673,4196,1916,471200,34786
26245,19198,7047,1627,367400,34787
8832,7256,1576,1209,110600,34788
641,619,22,-,261600,34797
1461,1359,102,637,222100,34945
2523,1508,1015,749,108100,34946
4076,1413,2663,979,151000,34947
4435,3450,985,1322,323000,34949
6250,2317,3933,933,116900,34950
6997,6142,855,1068,160700,34951
17478,12090,5388,1358,183900,34952
24483,20642,3841,1676,245400,34953
2484,1687,797,921,101800,34956
10730,7863,2867,1243,297300,34957
6085,4006,2079,895,150500,34972
10109,7989,2120,876,115200,34974
1662,943,719,1243,268000,34981
10768,8044,2724,1076,167400,34982
15387,12798,2589,1501,221700,34983
6161,4963,1198,1678,258900,34984
11487,9635,1852,1659,284900,34986
5464,4157,1307,1812,309800,34987
12039,10713,1326,1712,430900,34990
7841,4731,3110,1200,189600,34994
5825,4807,1018,1177,356400,34996
18365,14975,3390,1239,271300,34997
4616,3423,1193,1114,170600,35004
2869,2359,510,914,104700,35005
1190,1093,97,-,102400,35006
9896,8334,1562,1111,182100,35007
8082,5871,2211,628,104900,35010
27,9,18,-,-,35013
1683,1520,163,1010,99600,35014
6446,4738,1708,658,151800,35016
867,686,181,672,113200,35019
10145,5521,4624,755,76600,35020
9062,7151,1911,930,200700,35022
8632,6656,1976,1048,122900,35023
2601,1898,703,635,119800,35031
22,18,4,-,65600,35032
1250,1065,185,905,120700,35033
1276,906,370,763,87500,35034
364,330,34,-,67300,35035
75,0,75,264,-,35036
6688,5357,1331,1306,159100,35040
2248,1827,421,504,117300,35042
4325,3890,435,1087,258900,35043
3310,2097,1213,683,89400,35044
5676,3785,1891,783,140900,35045
1895,1478,417,746,136600,35046
1373,957,416,694,135000,35049
2897,2201,696,734,172800,35051
19,0,19,-,-,35052
1039,973,66,842,225200,35053
1538,1388,150,1021,263100,35054
9088,5880,3208,807,150800,35055
5022,4087,935,763,157400,35057
3862,2907,955,778,144100,35058
99,99,0,-,108000,35060
427,269,158,1049,155500,35061
3152,2546,606,694,148500,35062
1178,1059,119,913,84900,35063
3917,2071,1846,871,99400,35064
3461,2570,891,1032,164600,35068
42,40,2,-,115500,35070
6837,5270,1567,934,193200,35071
1745,1403,342,548,84400,35072
1260,868,392,824,93500,35073
50,0,50,-,-,35074
5578,3977,1601,757,123500,35077
781,655,126,-,163500,35078
3250,3070,180,868,164900,35079
6466,6000,466,1334,212800,35080
0,0,0,-,-,35082
1381,1124,257,780,151900,35083
2894,2325,569,763,103400,35085
987,818,169,823,119600,35087
559,480,79,703,-,35089
1071,1012,59,1219,219300,35091
5690,4503,1187,819,177000,35094
2975,2574,401,942,141600,35096
709,648,61,1069,125000,35097
533,348,185,793,-,35098
6445,5826,619,883,215600,35111
0,0,0,-,-,35112
2869,2491,378,1095,212600,35114
6046,4153,1893,743,137500,35115
1865,1685,180,946,177000,35116
2275,2111,164,784,166300,35117
1069,840,229,875,122600,35118
28,0,28,-,-,35119
6239,5218,1021,870,156300,35120
6224,4421,1803,672,136300,35121
9752,8230,1522,1190,222600,35124
3961,2588,1373,894,144300,35125
7508,6469,1039,892,156000,35126
3398,2725,673,1076,160600,35127
4177,3218,959,968,189500,35128
1411,1197,214,532,102900,35130
1252,940,312,672,85500,35131
1272,1126,146,743,144100,35133
842,650,192,959,196800,35135
764,583,181,325,159800,35136
1244,1026,218,659,217200,35143
3915,3347,568,642,211500,35146
2004,1788,216,1529,221900,35147
956,663,293,558,113800,35148
80,54,26,-,-,35149
7029,4286,2743,643,114600,35150
2979,2612,367,907,124700,35151
10192,6486,3706,629,110300,35160
1215,1008,207,-,122700,35171
1024,755,269,769,89900,35172
10343,9356,987,1327,269500,35173
2040,1731,309,806,154000,35175
355,210,145,759,107000,35176
1190,995,195,-,124500,35178
3033,2546,487,690,156800,35179
4968,4133,835,753,158400,35180
13,13,0,-,-,35181
312,272,40,-,103000,35183
1891,1577,314,823,90000,35184
0,0,0,-,-,35185
1924,1558,366,1025,226600,35186
829,691,138,847,142600,35188
1563,405,1158,543,273000,35203
4167,1835,2332,682,65200,35204
9251,2713,6538,894,226500,35205
6388,3053,3335,932,92600,35206
3131,1703,1428,691,67100,35207
5663,3385,2278,852,78200,35208
12457,6488,5969,1115,372100,35209
6074,4290,1784,938,169100,35210
11273,4812,6461,885,82700,35211
4245,1831,2414,624,162700,35212
6153,4651,1502,1497,576100,35213
7171,4860,2311,854,119600,35214
17142,9568,7574,924,115100,35215
15492,8661,6831,1157,299400,35216
4759,2498,2261,808,95700,35217
2755,1123,1632,855,64000,35218
1517,1030,487,885,65200,35221
3768,2091,1677,861,332500,35222
4514,3972,542,2047,621100,35223
1971,1072,899,876,67600,35224
14283,11237,3046,1286,313800,35226
3820,2436,1384,877,71200,35228
0,0,0,-,-,35229
1596,221,1375,1368,255100,35233
1941,998,943,639,59100,35234
8290,5630,2660,1131,129000,35235
23129,16847,6282,1211,380400,35242
8474,4814,3660,1416,394600,35243
13462,9611,3851,1271,315400,35244
0,0,0,-,-,35249
0,0,0,-,-,35254
12352,4150,8202,827,115200,35401
8051,4331,3720,934,137300,35404
18842,10292,8550,942,185700,35405
7178,5485,1693,1178,374500,35406
353,321,32,-,66900,35441
1713,1033,680,544,94400,35442
471,365,106,491,54500,35443
1570,1261,309,787,132000,35444
724,608,116,920,103800,35446
1220,926,294,606,118800,35447
1494,1349,145,1285,160700,35452
4294,3543,751,899,132500,35453
1712,1181,531,862,153200,35456
57,57,0,-,-,35457
210,177,33,-,409700,35458
432,329,103,716,63700,35459
322,255,67,-,92400,35460
836,794,42,1092,152200,35461
1813,1172,641,600,90300,35462
725,641,84,1087,165000,35463
158,52,106,486,-,35464
2015,1751,264,571,108200,35466
217,166,51,-,58400,35469
1632,921,711,639,126000,35470
7590,4865,2725,791,190900,35473
2244,1977,267,826,134400,35474
6762,6262,500,774,239400,35475
3071,1238,1833,865,156600,35476
33,33,0,-,-,35477
505,443,62,-,190700,35480
1300,897,403,427,86300,35481
0,0,0,-,-,35487
1833,1454,379,955,142400,35490
0,0,0,-,-,35491
3548,2121,1427,689,135900,35501
3674,3034,640,646,126400,35503
5207,4010,1197,614,165900,35504
969,811,158,521,107300,35540
1480,1271,209,753,153600,35541
372,337,35,708,60300,35542
472,342,130,569,67300,35543
330,225,105,773,-,35544
59,44,15,-,92900,35545
1380,1190,190,516,114200,35546
849,702,147,356,62900,35548
1446,1096,350,607,58200,35549
1956,1607,349,439,83000,35550
464,406,58,335,68200,35552
1772,1433,339,522,75900,35553
408,343,65,596,79400,35554
3693,2525,1168,546,103100,35555
12,2,10,-,-,35559
1386,1103,283,656,96700,35563
851,644,207,548,90000,35564
4448,3371,1077,601,78000,35565
4281,2832,1449,536,96800,35570
248,211,37,-,82500,35571
677,633,44,-,268200,35572
4,4,0,-,-,35573
520,457,63,313,116800,35574
434,356,78,691,77500,35575
1233,1066,167,498,113100,35576
2,2,0,-,-,35577
2014,1742,272,921,97600,35578
1267,1062,205,458,94100,35579
1426,1220,206,624,88700,35580
1858,1372,486,649,85600,35581
1880,1312,568,477,82700,35582
91,68,23,890,48700,35584
502,391,111,-,206400,35585
1468,1094,374,473,78800,35586
258,193,65,719,-,35587
1698,970,728,436,114100,35592
614,507,107,588,88400,35593
2565,1936,629,635,127600,35594
13231,7934,5297,723,110300,35601
13724,10038,3686,729,182600,35603
687,581,106,542,157900,35610
11416,6975,4441,701,149800,35611
7803,6745,1058,1003,225000,35613
2592,2005,587,885,131900,35614
0,0,0,-,-,35615
1438,1013,425,754,85200,35616
834,614,220,527,88700,35618
1723,1326,397,873,139500,35619
4248,3655,593,841,148500,35620
1032,888,144,930,139700,35621
2461,1732,729,770,115800,35622
14573,5990,8583,693,127400,35630
0,0,0,-,-,35632
8210,6882,1328,735,141500,35633
4084,3332,752,811,206800,35634
9942,8015,1927,692,150300,35640
1542,1351,191,663,102600,35643
4929,4145,784,698,192600,35645
1814,1521,293,626,98300,35646
379,338,41,694,127200,35647
1223,993,230,594,115800,35648
32,32,0,-,296400,35649
4980,3988,992,558,133800,35650
474,398,76,-,173400,35651
3664,2945,719,784,149300,35652
3536,2397,1139,598,90100,35653
2903,1966,937,556,138300,35654
4282,2484,1798,725,106300,35660
7466,6054,1412,898,151700,35661
2383,1792,591,664,155000,35670
654,517,137,384,85800,35671
2009,1461,548,567,120600,35672
2685,2042,643,671,150900,35673
7321,5043,2278,731,130200,35674
771,699,72,-,-,35677
2129,1727,402,716,157200,35739
1493,942,551,380,104300,35740
1703,1352,351,1009,274300,35741
705,526,179,691,121600,35744
56,48,8,-,168800,35745
272,272,0,-,-,35746
2287,2017,270,706,180100,35747
2834,2455,379,690,257600,35748
8869,8033,836,1046,204700,35749
5003,3824,1179,917,148700,35750
94,94,0,-,208100,35751
936,646,290,815,76400,35752
2260,1785,475,656,170600,35754
205,139,66,486,-,35755
7855,6663,1192,1333,237600,35756
6344,5282,1062,1210,225800,35757
19142,13168,5974,1106,264500,35758
3967,3770,197,1281,207700,35759
1731,1372,359,728,136200,35760
4780,4006,774,910,163600,35761
7010,6429,581,1719,295500,35763
259,223,36,625,75600,35764
1681,1409,272,573,122000,35765
79,56,23,-,75800,35766
4743,3115,1628,633,113000,35768
4123,3307,816,685,137300,35769
1102,920,182,635,98000,35771
1856,1372,484,696,95900,35772
5475,4756,719,798,138800,35773
58,58,0,-,90000,35774
207,197,10,-,82700,35775
1322,1112,210,516,111600,35776
10555,6885,3670,986,312300,35801
11209,5918,5291,924,249700,35802
11846,9537,2309,998,196100,35803
9252,2916,6336,702,83500,35805
12886,6113,6773,1090,237500,35806
379,13,366,1578,-,35808
12067,7870,4197,942,91800,35810
11011,8308,2703,878,196900,35811
6758,1948,4810,764,91200,35816
4218,2239,1979,1000,267700,35824
0,0,0,-,-,35896
7123,4606,2517,659,144600,35901
7051,4579,2472,720,127200,35903
5056,3856,1200,690,79900,35904
2196,1865,331,718,158200,35905
3882,2305,1577,847,169200,35906
2971,2696,275,999,161500,35907
7185,4731,2454,772,121300,35950
4526,3387,1139,663,123400,35951
3221,2574,647,639,107000,35952
2770,2252,518,951,151300,35953
4642,3782,860,623,101300,35954
2983,2365,618,721,146800,35956
5961,4020,1941,596,104100,35957
1186,979,207,540,134900,35958
1774,1428,346,557,156400,35959
3452,2579,873,697,155700,35960
2049,1481,568,604,77700,35961
2846,2099,747,758,125700,35962
495,375,120,-,-,35963
1259,1070,189,494,113900,35966
6287,4319,1968,645,122400,35967
1766,1341,425,634,110000,35968
1928,1369,559,709,104200,35971
463,417,46,-,76600,35972
1120,935,185,954,79100,35973
644,443,201,634,158500,35974
449,411,38,673,152600,35975
6683,5219,1464,678,199400,35976
1804,1443,361,901,119400,35978
382,346,36,-,132800,35979
1915,1571,344,703,121600,35980
649,502,147,-,97600,35981
1488,1261,227,634,151700,35983
747,560,187,830,161300,35984
3075,2372,703,578,161300,35986
932,738,194,-,119500,35987
802,553,249,587,91200,35988
1288,1078,210,612,78300,35989
0,0,0,-,-,35990
1056,851,205,410,108700,36003
563,479,84,847,118100,36005
699,643,56,1043,171900,36006
0,0,0,-,-,36008
866,628,238,562,89200,36009
1852,1243,609,620,109000,36010
148,148,0,-,368900,36013
1484,975,509,594,56700,36016
791,498,293,414,56000,36017
414,307,107,1009,156700,36020
5373,4717,656,1018,180900,36022
2208,1744,464,728,218100,36024
1581,1129,452,1032,150400,36025
541,522,19,-,283700,36026
5768,3370,2398,621,109200,36027
588,384,204,525,109600,36028
334,277,57,-,153800,36029
126,103,23,659,113300,36030
26,26,0,-,-,36031
862,631,231,416,62600,36032
1306,1021,285,635,77300,36033
309,266,43,575,77800,36034
733,632,101,800,101900,36035
743,634,109,828,119000,36036
4345,2984,1361,684,96600,36037
25,23,2,-,-,36038
92,46,46,-,-,36039
1345,879,466,717,67600,36040
530,474,56,615,100300,36041
404,370,34,-,98800,36042
1307,1097,210,1054,199900,36043
491,470,21,-,112100,36046
385,375,10,-,54400,36047
581,403,178,575,-,36048
1941,1452,489,623,83400,36049
1004,846,158,949,59200,36051
357,325,32,-,591300,36052
910,696,214,491,82800,36053
5706,3867,1839,868,142300,36054
0,0,0,-,-,36057
4305,3668,637,1338,301500,36064
8677,5238,3439,1166,184900,36066
9971,7510,2461,892,143600,36067
919,704,215,822,99500,36069
163,131,32,630,101000,36071
731,629,102,808,83900,36075
5207,3646,1561,785,152800,36078
3340,2646,694,879,127000,36079
843,680,163,876,199300,36080
5606,2493,3113,680,152200,36081
0,0,0,-,-,36082
3399,2059,1340,612,75200,36083
1105,604,501,730,89400,36088
2547,1560,987,553,73600,36089
1532,1195,337,782,104900,36091
7752,5865,1887,919,160800,36092
4235,3896,339,797,266400,36093
0,0,0,-,-,36101
3825,1025,2800,700,77800,36104
4383,2710,1673,897,71700,36105
6220,3478,2742,988,157200,36106
3095,1169,1926,788,62000,36107
6363,3848,2515,660,64800,36108
10058,6635,3423,950,117900,36109
3952,2139,1813,914,63900,36110
4790,2916,1874,961,149800,36111
17,0,17,913,-,36112
270,0,270,1665,-,36113
0,0,0,-,-,36114
242,0,242,1394,-,36115
17215,7971,9244,941,113300,36116
21303,12807,8496,1037,188500,36117
0,0,0,-,-,36130
7388,4554,2834,624,66400,36201
7026,4872,2154,849,140500,36203
423,225,198,726,224800,36205
4172,2681,1491,820,99400,36206
7663,5616,2047,918,171600,36207
1534,1312,222,920,140700,36250
2035,1515,520,380,114900,36251
402,378,24,-,122700,36255
625,548,77,563,112500,36256
550,493,57,-,113800,36258
1398,1141,257,621,129900,36260
567,495,72,767,89300,36262
156,121,35,-,115500,36263
3142,2245,897,695,123900,36264
8338,5501,2837,698,140800,36265
2377,1686,691,575,133300,36266
13,13,0,-,-,36267
2135,1900,235,822,91600,36268
544,399,145,834,110800,36269
2300,2109,191,765,99900,36271
5134,3982,1152,679,90300,36272
1150,987,163,740,113700,36273
4123,3140,983,650,90200,36274
997,788,209,609,85600,36276
1924,1614,310,811,112500,36277
1740,1469,271,603,172700,36278
914,776,138,950,125000,36279
1585,1349,236,757,139800,36280
15084,9101,5983,792,127900,36301
11898,7166,4732,749,148300,36303
6350,4396,1954,996,193200,36305
2408,1853,555,526,102300,36310
912,735,177,658,103200,36311
2339,1697,642,736,134000,36312
140,116,24,-,162200,36313
207,178,29,519,59200,36314
790,687,103,771,148700,36316
266,239,27,-,104000,36317
554,504,50,588,106600,36318
878,714,164,739,114200,36319
1304,1076,228,695,95800,36320
761,604,157,753,132700,36321
3922,2264,1658,679,96800,36322
2970,2295,675,708,85000,36323
14726,9531,5195,905,179700,36330
2327,1533,794,607,112400,36340
535,417,118,928,81600,36343
2100,1533,567,716,152700,36344
3146,2669,477,806,154100,36345
474,424,50,675,113900,36346
2940,1795,1145,689,137000,36350
1509,1232,277,675,119000,36351
1882,1622,260,730,157400,36352
581,533,48,728,96200,36353
7823,5036,2787,676,125400,36360
1461,10,1451,1211,-,36362
398,370,28,543,84100,36370
195,147,48,631,106600,36371
217,192,25,-,60900,36373
222,180,42,864,65700,36374
2611,1913,698,747,113600,36375
915,745,170,767,79300,36376
2577,2002,575,642,82000,36401
4076,2971,1105,629,135800,36420
3581,2606,975,665,122300,36421
293,214,79,-,60000,36425
5328,3668,1660,630,103900,36426
665,463,202,707,81700,36432
167,140,27,-,103700,36435
202,182,20,-,116400,36436
34,21,13,-,206300,36439
1461,1044,417,572,107300,36441
1231,889,342,707,94100,36442
252,200,52,-,70000,36444
1901,1531,370,680,99200,36445
136,99,37,-,86800,36446
1800,1361,439,705,102800,36451
940,738,202,621,81400,36453
22,22,0,-,-,36454
116,71,45,613,73000,36455
648,526,122,450,60000,36456
3735,2469,1266,533,108600,36460
3958,2983,975,638,94900,36467
0,0,0,-,-,36470
310,156,154,673,68000,36471
74,52,22,-,121700,36473
1051,931,120,668,88100,36474
623,560,63,646,108700,36475
11,3,8,-,-,36476
1511,1133,378,580,86600,36477
575,510,65,-,134200,36480
69,57,12,-,154500,36481
363,319,44,-,86900,36482
211,179,32,-,140600,36483
6053,3871,2182,623,120600,36502
0,0,0,-,-,36503
366,331,35,803,138100,36505
7121,5390,1731,780,143500,36507
593,378,215,774,73400,36509
271,271,0,-,119200,36511
7,7,0,-,-,36512
104,104,0,-,93600,36513
785,628,157,607,150500,36518
1949,1763,186,767,135100,36521
2454,1726,728,661,119700,36522
932,675,257,1025,160400,36523
428,355,73,450,108200,36524
744,574,170,821,138100,36525
12682,9214,3468,1239,230400,36526
5926,4316,1610,1351,285000,36527
773,736,37,1094,310900,36528
86,86,0,-,-,36529
2870,2258,612,906,184700,36530
13481,11442,2039,1264,328300,36532
15286,11818,3468,911,202500,36535
146,106,40,-,44500,36538
203,196,7,-,113000,36539
257,208,49,-,-,36540
5214,4557,657,944,126400,36541
7926,5094,2832,1132,272800,36542
5,5,0,-,-,36543
4263,3146,1117,741,114700,36544
3151,2275,876,660,120900,36545
0,0,0,-,-,36547
319,306,13,-,150000,36548
2314,1968,346,1015,152600,36549
143,101,42,-,-,36550
3873,3143,730,973,175500,36551
1007,958,49,625,154100,36553
446,403,43,1050,334600,36555
54,54,0,-,66100,36556
1421,1319,102,523,112300,36558
69,69,0,-,628000,36559
1075,800,275,679,74800,36560
4029,2993,1036,1199,376500,36561
532,437,95,-,106800,36562
0,0,0,-,-,36564
5051,3901,1150,978,164300,36567
55,34,21,-,-,36568
231,225,6,-,67500,36569
6421,5001,1420,918,163200,36571
2395,1958,437,1118,161500,36572
485,405,80,976,137500,36574
7610,6227,1383,963,152700,36575
1701,1381,320,1016,191500,36576
448,427,21,-,217100,36578
430,389,41,592,236100,36579
2072,1743,329,1045,188000,36580
132,132,0,-,233300,36581
9216,7029,2187,794,144600,36582
304,293,11,-,157300,36583
272,237,35,-,76600,36584
297,262,35,853,63900,36585
3942,3145,797,800,133900,36587
588,120,468,345,192700,36602
2971,1036,1935,684,89000,36603
3825,2146,1679,816,181300,36604
9965,5125,4840,919,84300,36605
7943,3945,3998,895,125100,36606
2545,1220,1325,846,114200,36607
15134,7918,7216,945,169200,36608
11099,4733,6366,912,163500,36609
3671,1637,2034,691,46900,36610
2316,1095,1221,834,78600,36611
1414,861,553,719,68200,36612
4140,2993,1147,1022,126900,36613
0,0,0,-,-,36615
5012,2383,2629,986,69700,36617
6801,4991,1810,1021,116700,36618
5606,3865,1741,945,140500,36619
0,0,0,-,-,36652
4,4,0,-,-,36663
96,0,96,594,-,36688
7609,5314,2295,981,166200,36693
19367,13025,6342,1113,198800,36695
7746,4716,3030,752,93100,36701
4756,2676,2080,637,72700,36703
237,196,41,-,63700,36720
66,45,21,-,56300,36722
123,113,10,-,-,36723
1734,1259,475,802,84100,36726
76,76,0,-,"10,000-",36727
137,113,24,-,"10,000-",36728
3178,1937,1241,606,159000,36732
424,374,50,1000,73700,36736
284,198,86,673,62500,36738
361,239,122,640,100900,36740
0,0,0,-,-,36741
1029,851,178,631,64100,36742
2194,1468,726,612,122900,36744
893,639,254,694,85600,36748
297,180,117,-,86500,36749
844,723,121,1007,135100,36750
136,119,17,-,24700,36751
498,464,34,-,116700,36752
27,27,0,-,-,36753
136,110,26,-,-,36754
1490,1049,441,604,81800,36756
453,396,57,-,82700,36758
716,596,120,657,65300,36759
303,201,102,743,31400,36761
38,35,3,-,57100,36763
0,0,0,-,-,36764
513,471,42,1063,70600,36765
16,11,5,-,142500,36766
371,302,69,318,69400,36767
325,232,93,840,64500,36768
829,661,168,-,65300,36769
99,55,44,623,-,36773
584,379,205,1113,87400,36775
569,442,127,-,43200,36776
776,699,77,729,73900,36782
324,207,117,618,61300,36783
2040,1294,746,718,129900,36784
426,322,104,843,100800,36785
981,668,313,399,61400,36786
238,178,60,-,-,36790
469,395,74,-,108400,36792
191,143,48,-,165100,36793
9454,6208,3246,786,158300,36801
6961,5698,1263,655,121200,36804
19492,10485,9007,926,283000,36830
10248,4895,5353,905,173800,36832
0,0,0,-,-,36849
1117,888,229,387,62600,36850
0,0,0,-,-,36851
761,542,219,933,140300,36852
3238,2582,656,760,193700,36853
6201,4085,2116,891,115700,36854
561,487,74,876,134400,36855
2737,2492,245,1619,200800,36856
224,213,11,-,146500,36858
775,560,215,586,63000,36860
1218,1143,75,668,161400,36861
2115,1516,599,601,122500,36862
4549,3140,1409,670,105700,36863
13,7,6,-,121900,36865
1670,1264,406,638,86700,36866
8852,4070,4782,877,144400,36867
8732,5284,3448,808,112000,36869
7254,5429,1825,998,158800,36870
435,392,43,830,95000,36871
3487,3191,296,857,163100,36874
1445,1134,311,684,156400,36875
4020,3090,930,927,151500,36877
826,685,141,666,268100,36879
34,34,0,-,-,36901
1582,1241,341,633,100100,36904
794,678,116,1026,58300,36907
682,594,88,713,76300,36908
6,6,0,-,-,36910
640,543,97,1074,71200,36912
23,23,0,-,-,36913
290,227,63,-,57600,36915
307,245,62,326,72400,36916
700,584,116,438,71000,36919
641,566,75,397,115000,36921
205,178,27,-,73600,36922
1337,802,535,497,41100,36925
1821,1721,100,895,285100,37010
872,690,182,476,166600,37012
35483,19926,15557,1215,226000,37013
1220,1196,24,-,591500,37014
7047,5260,1787,1042,193400,37015
409,345,64,977,168500,37016
750,609,141,1071,107300,37018
266,159,107,774,160000,37019
1974,1847,127,1177,205400,37020
2281,1995,286,1539,185700,37022
529,370,159,1026,134600,37023
1902,1797,105,766,148600,37025
965,826,139,713,172400,37026
21914,18115,3799,1735,658100,37027
194,180,14,-,-,37028
2451,2295,156,821,278600,37029
3099,2183,916,638,178000,37030
1645,1500,145,1152,232700,37031
1732,1377,355,905,213500,37032
3046,2124,922,724,152500,37033
2915,2356,559,1136,221100,37034
1433,1294,139,1142,159600,37035
2055,1807,248,766,193600,37036
2672,2475,197,1613,271200,37037
21037,12468,8569,943,185600,37040
30082,16816,13266,1031,155800,37042
18988,13498,5490,988,257100,37043
2180,2026,154,2029,593800,37046
836,665,171,796,139600,37047
2374,2067,307,956,286900,37048
1383,1137,246,853,248200,37049
623,506,117,690,114700,37050
1431,1213,218,738,183600,37051
844,818,26,-,185800,37052
10449,7625,2824,845,188700,37055
320,220,100,780,165700,37057
2825,2263,562,652,163600,37058
588,395,193,833,132500,37059
963,854,109,1125,277600,37060
1625,1203,422,630,147000,37061
4778,3805,973,1264,271800,37062
22401,17698,4703,1496,485200,37064
22478,15345,7133,1146,284300,37066
12896,7215,5681,1673,518600,37067
7019,6173,846,2067,563700,37069
13324,9090,4234,1157,255200,37072
4974,4242,732,1065,263200,37073
2936,2256,680,667,181800,37074
26699,19774,6925,1272,311200,37075
16614,9569,7045,1224,256300,37076
171,122,49,-,142600,37078
1018,811,207,911,123300,37079
3001,2423,578,936,251300,37080
2222,1803,419,1057,283600,37082
5851,4276,1575,750,147500,37083
1909,1735,174,848,307800,37085
12593,9111,3482,1400,203000,37086
18754,13078,5676,1021,279900,37087
5959,4204,1755,1188,279700,37090
8597,6084,2513,802,165700,37091
953,656,297,805,156900,37095
2126,1663,463,628,95800,37096
757,572,185,769,118400,37097
2170,1553,617,735,133900,37098
2171,1859,312,661,161600,37101
12962,8864,4098,674,125700,37110
17142,7500,9642,1099,209200,37115
449,449,0,-,340200,37118
22563,18665,3898,1578,335100,37122
6901,5461,1440,1165,266800,37127
24552,16535,8017,1319,273900,37128
20894,14503,6391,1281,270100,37129
22855,10178,12677,1000,249500,37130
0,0,0,-,-,37132
1004,787,217,733,114600,37134
6566,6172,394,2600,457800,37135
1136,1004,132,688,104500,37137
9527,7563,1964,1165,265400,37138
83,82,1,-,261900,37140
494,449,45,1164,203600,37141
711,602,109,624,179600,37142
1443,1245,198,1049,246800,37143
1296,1164,132,634,142200,37144
1013,866,147,675,138000,37145
2866,2394,472,1109,264500,37146
8820,6345,2475,931,192600,37148
920,822,98,787,227300,37149
1693,1187,506,681,108400,37150
238,169,69,-,201000,37151
1845,1617,228,1109,305700,37153
12616,7963,4653,809,165900,37160
26,18,8,-,88600,37165
5676,3713,1963,674,153000,37166
21585,12965,8620,1202,240000,37167
358,304,54,-,-,37171
11514,7788,3726,940,204900,37172
16722,12575,4147,1569,330800,37174
341,300,41,-,101800,37175
835,744,91,668,108100,37178
5088,4339,749,1781,375600,37179
1454,1185,269,592,211400,37180
678,562,116,698,142500,37181
1311,1185,126,795,199200,37183
2638,2049,589,862,194000,37184
3392,2583,809,752,139800,37185
3651,2512,1139,875,161000,37186
2962,2198,764,852,191400,37187
6288,4974,1314,1232,239600,37188
1655,1317,338,1004,247500,37189
3416,2558,858,611,180500,37190
1525,1361,164,760,191800,37191
857,404,453,1791,375900,37201
10819,2110,8709,1585,393700,37203
6632,3678,2954,1631,645700,37204
11588,7917,3671,1630,697300,37205
12176,6092,6084,1284,387500,37206
15745,9064,6681,1023,222600,37207
8114,2615,5499,1195,321800,37208
17410,7685,9725,1347,380200,37209
7154,1882,5272,950,245700,37210
29394,14194,15200,1191,283300,37211
6896,2888,4008,1312,650200,37212
24,0,24,-,-,37213
14203,8752,5451,1369,239400,37214
10345,8026,2319,1703,718200,37215
8572,6143,2429,1312,325100,37216
12416,5893,6523,1111,212900,37217
5877,3815,2062,897,209800,37218
991,253,738,1707,296200,37219
2456,2297,159,2069,555400,37220
18388,13375,5013,1471,330600,37221
1249,0,1249,1210,-,37228
0,0,0,-,-,37232
0,0,0,-,-,37238
376,324,52,609,96900,37301
1885,1369,516,907,319300,37302
9900,6711,3189,729,161700,37303
385,383,2,-,56300,37305
892,793,99,-,164500,37306
1882,1537,345,531,132900,37307
1010,838,172,686,212200,37308
853,641,212,885,140900,37309
1430,1141,289,645,172100,37310
11117,4964,6153,769,164100,37311
13706,9475,4231,947,212800,37312
522,440,82,603,133300,37313
0,0,0,-,-,37315
0,0,0,-,-,37316
1217,892,325,552,122300,37317
714,432,282,631,91000,37318
7634,5366,2268,662,137400,37321
3304,2482,822,746,140900,37322
12005,9578,2427,859,164000,37323
2255,1251,1004,756,149700,37324
730,616,114,673,155600,37325
245,98,147,477,145800,37326
4441,3353,1088,771,150500,37327
567,521,46,705,152700,37328
2561,2130,431,650,124200,37329
2813,2368,445,996,151000,37330
2807,2165,642,783,112300,37331
952,844,108,880,137700,37332
231,172,59,-,67500,37333
9380,6736,2644,714,159800,37334
1071,954,117,627,159300,37335
1883,1737,146,953,174200,37336
402,359,43,-,-,37337
1077,833,244,754,108500,37338
540,464,76,760,114600,37339
207,158,49,-,-,37340
5216,4265,951,1038,183400,37341
1460,1129,331,755,144500,37342
16815,12807,4008,998,206700,37343
969,774,195,803,145100,37345
3464,2774,690,759,112100,37347
312,252,60,-,-,37348
770,735,35,1833,523800,37350
150,120,30,-,126200,37351
1211,994,217,648,195700,37352
2033,1670,363,897,186100,37353
6959,5085,1874,646,150500,37354
10981,7390,3591,765,186500,37355
1040,680,360,652,271100,37356
2011,1665,346,733,130400,37357
436,391,45,439,171000,37359
714,547,167,709,215300,37360
760,584,176,755,121600,37361
1351,1078,273,661,88800,37362
14878,11247,3631,1234,273500,37363
536,470,66,465,83400,37365
425,368,57,782,119400,37366
3907,3090,817,682,157800,37367
178,164,14,-,190300,37369
2124,1783,341,803,168300,37370
1119,982,137,1002,210000,37373
666,543,123,941,225500,37374
1053,844,209,1089,259800,37375
216,105,111,-,68800,37376
6159,5368,791,1234,360200,37377
10781,8850,1931,827,197600,37379
2444,1637,807,726,130200,37380
3959,3129,830,734,154900,37381
0,0,0,-,-,37383
3070,2580,490,655,150900,37385
1453,1201,252,650,107000,37387
10692,7352,3340,720,166500,37388
636,473,163,721,143100,37391
51,47,4,-,205800,37394
110,98,12,-,108200,37396
4004,3043,961,727,129400,37397
6150,4465,1685,755,169900,37398
2421,136,2285,423,350000,37402
1801,415,1386,1089,382900,37403
5123,2527,2596,839,172900,37404
8857,4228,4629,1052,327500,37405
5480,2531,2949,771,135100,37406
3168,1027,2141,753,74800,37407
1054,348,706,925,341800,37408
1535,1014,521,947,206200,37409
1494,425,1069,697,62900,37410
7682,4400,3282,909,150500,37411
9774,5924,3850,924,142400,37412
10712,6544,4168,991,194400,37415
6142,3614,2528,910,152000,37416
2600,2068,532,833,233400,37419
21863,12452,9411,1135,226500,37421
0,0,0,-,-,37450
16115,8658,7457,788,152100,37601
16739,8285,8454,805,173300,37604
0,0,0,-,-,37614
9211,6953,2258,855,210300,37615
1982,1461,521,692,143400,37616
5549,4736,813,646,173100,37617
5231,3948,1283,778,141300,37618
16327,11543,4784,716,137800,37620
1518,1166,352,646,108000,37640
4014,3217,797,643,151100,37641
6194,4773,1421,729,142300,37642
13970,9934,4036,655,130800,37643
2251,1922,329,720,156500,37645
5393,4193,1200,610,127500,37650
1484,1269,215,705,189600,37656
349,280,69,604,202000,37657
1550,1271,279,589,145300,37658
11463,9380,2083,821,185600,37659
17343,10781,6562,715,135600,37660
6070,5067,1003,764,182300,37663
12553,8893,3660,688,165000,37664
2180,1324,856,808,98800,37665
197,163,34,-,313400,37680
2495,2078,417,655,152400,37681
31,31,0,-,-,37682
4969,3991,978,546,135200,37683
3148,2539,609,1076,189600,37686
1777,1563,214,847,113900,37687
485,442,43,-,117700,37688
1966,1693,273,644,160500,37690
221,95,126,-,-,37691
2124,1393,731,879,170700,37692
888,758,130,639,156400,37694
3398,2263,1135,917,170700,37701
1733,1386,347,1063,225500,37705
2633,1956,677,580,125600,37708
1479,1125,354,809,176700,37709
421,395,26,675,73800,37710
2053,1738,315,630,94800,37711
533,425,108,773,103400,37713
1648,1231,417,730,158600,37714
331,296,35,428,92300,37715
10468,7357,3111,809,164000,37716
23,19,4,-,-,37719
5595,4813,782,938,168100,37721
2645,2137,508,736,148200,37722
563,474,89,598,107000,37723
1189,661,528,676,135200,37724
6442,5141,1301,792,174500,37725
654,557,97,488,86400,37726
859,729,130,745,114400,37727
553,455,98,-,68800,37729
20,20,0,-,96000,37730
226,204,22,-,-,37731
17,17,0,-,-,37732
0,0,0,-,-,37733
2547,2163,384,927,218400,37737
1910,1411,499,905,228900,37738
2391,2167,224,857,238000,37742
9727,7572,2155,628,153200,37743
7390,5176,2214,650,159300,37745
7014,5036,1978,712,124800,37748
2384,1709,675,799,147100,37752
372,232,140,565,84500,37753
1432,1233,199,898,121300,37754
1144,830,314,529,65400,37755
1286,854,432,550,83800,37756
4033,2841,1192,644,149200,37757
4823,3041,1782,735,182100,37760
1098,620,478,364,113500,37762
6645,5355,1290,768,200400,37763
3763,2927,836,957,177100,37764
253,244,9,-,93300,37765
7144,4285,2859,686,112600,37766
2254,1615,639,592,162500,37769
1263,1119,144,564,110600,37770
6818,4758,2060,806,190400,37771
5308,4538,770,1152,289400,37772
8300,7219,1081,887,248300,37774
5227,3477,1750,749,241300,37777
1331,1085,246,691,126100,37779
11147,7856,3291,885,199700,37801
13025,10563,2462,917,234400,37803
9669,7335,2334,958,174300,37804
1279,834,445,760,130200,37806
4090,3052,1038,785,150700,37807
831,545,286,713,111800,37809
614,485,129,-,98500,37810
1723,1498,225,628,121900,37811
6614,4498,2116,726,118300,37813
13298,8247,5051,775,154000,37814
2156,1730,426,759,95300,37818
241,148,93,520,139300,37819
2804,2277,527,617,155800,37820
8641,5668,2973,717,110000,37821
3831,2662,1169,625,108100,37825
1851,1552,299,794,147100,37826
778,642,136,896,258900,37828
630,522,108,805,114600,37829
13056,8224,4832,919,171900,37830
3943,2837,1106,739,142200,37840
3707,2603,1104,556,118800,37841
1813,1462,351,821,146600,37843
112,79,33,-,85800,37845
1489,1144,345,737,145100,37846
1030,856,174,631,94000,37847
47,39,8,-,126000,37848
10828,8621,2207,857,193500,37849
0,0,0,-,-,37851
1171,963,208,659,111000,37852
1386,1017,369,727,172700,37853
4741,3482,1259,666,114100,37854
7685,5738,1947,629,127600,37857
1556,1066,490,653,141300,37860
3431,2635,796,543,131400,37861
8787,5291,3496,855,230400,37862
2379,1214,1165,756,183300,37863
8987,7375,1612,973,208400,37865
661,583,78,485,238300,37866
1929,1421,508,532,102900,37869
1857,1506,351,638,116500,37870
3506,2363,1143,787,154200,37871
648,539,109,765,101600,37872
1738,1378,360,713,110300,37873
6338,3924,2414,578,135900,37874
12376,9622,2754,848,199300,37876
3403,2909,494,859,153300,37877
173,155,18,-,162900,37878
4784,3550,1234,677,111800,37879
1546,1237,309,645,172200,37880
779,654,125,777,116900,37881
1306,1041,265,865,248100,37882
2591,2067,524,797,224600,37885
1529,1201,328,824,166800,37886
1900,1462,438,681,101100,37887
1297,1092,205,770,107100,37888
3058,2474,584,819,154100,37890
1402,1183,219,680,119200,37891
834,655,179,616,95300,37892
1534,298,1236,1085,408000,37902
7560,3281,4279,984,207800,37909
9766,5031,4735,924,141300,37912
8737,5845,2892,884,152800,37914
2739,591,2148,366,169200,37915
2992,111,2881,975,246300,37916
12255,6068,6187,908,133100,37917
18524,12384,6140,920,177100,37918
13356,7549,5807,1011,336100,37919
17461,10394,7067,905,158200,37920
10972,6879,4093,994,144800,37921
14245,11995,2250,1376,362400,37922
13054,7858,5196,1072,231400,37923
5234,3968,1266,856,170000,37924
0,0,0,-,-,37929
11904,8306,3598,1227,252800,37931
7405,5431,1974,1263,283600,37932
10570,9070,1500,1488,359500,37934
6660,5937,723,1006,216900,37938
1696,1121,575,676,102500,38001
14555,12262,2293,1568,279300,38002
4047,3418,629,1232,220000,38004
1893,1185,708,849,115500,38006
6,6,0,-,-,38007
3652,2297,1355,847,96200,38008
3338,2619,719,888,163300,38011
5234,2807,2427,664,104800,38012
892,748,144,800,154500,38015
18536,10634,7902,1178,190400,38016
19699,15531,4168,1373,357100,38017
14134,8681,5453,1388,189600,38018
5881,3516,2365,801,137100,38019
5,5,0,-,-,38021
1918,1454,464,1065,168000,38023
10532,6465,4067,684,130700,38024
2876,2754,122,1134,393600,38028
15,15,0,-,-,38029
139,54,85,668,119800,38030
1328,1090,238,684,106600,38034
70,40,30,575,151700,38036
521,352,169,710,100000,38037
605,471,134,738,95200,38039
2095,1180,915,669,90700,38040
1038,637,401,618,85200,38041
303,208,95,676,118200,38042
231,185,46,758,95400,38044
5,5,0,-,350000,38046
60,12,48,-,-,38047
1458,1087,371,720,115500,38049
255,149,106,694,69400,38050
1633,1255,378,631,102000,38052
9687,6552,3135,1038,157700,38053
0,0,0,-,-,38054
1383,1087,296,695,236300,38057
3778,3062,716,953,169700,38058
3016,2031,985,780,112900,38059
4183,3637,546,947,196900,38060
432,387,45,-,112100,38061
6036,3611,2425,652,101200,38063
1219,1126,93,660,250000,38066
711,608,103,620,117500,38067
4043,2699,1344,781,190700,38068
1147,832,315,693,111100,38069
70,70,0,-,159100,38070
1551,1118,433,819,102700,38075
355,293,62,833,179800,38076
21,21,0,-,-,38077
1242,648,594,394,129000,38079
964,547,417,459,74400,38080
7594,2504,5090,1374,310200,38103
12667,4630,8037,900,251700,38104
3157,338,2819,767,68500,38105
9414,4075,5339,812,54300,38106
6481,2624,3857,855,102800,38107
6634,2960,3674,746,55400,38108
16268,8996,7272,893,66200,38109
17364,8088,9276,886,109700,38111
6639,3317,3322,874,155800,38112
0,0,0,-,-,38113
9791,4519,5272,790,63600,38114
16352,3879,12473,944,99300,38115
15105,6724,8381,892,96700,38116
11425,9050,2375,1163,225300,38117
12665,5388,7277,1003,77700,38118
9996,5789,4207,1194,225200,38119
6237,4781,1456,1248,370300,38120
8511,4360,4151,1012,80200,38122
14997,8734,6263,1275,173100,38125
2421,300,2121,680,49600,38126
13935,6700,7235,956,66900,38127
15599,6325,9274,991,91200,38128
0,0,0,-,-,38131
0,0,0,-,-,38132
7764,5548,2216,1328,177500,38133
14616,7293,7323,1029,139900,38134
10695,8714,1981,1460,191800,38135
10049,8240,1809,1359,323400,38138
5742,5533,209,2175,439400,38139
7861,5124,2737,1261,115900,38141
0,0,0,-,-,38152
3654,2698,956,629,120700,38201
687,595,92,651,79100,38220
1241,951,290,630,84300,38221
772,693,79,654,147000,38222
296,242,54,483,141700,38224
2236,1549,687,653,82700,38225
154,154,0,-,70000,38226
1127,824,303,598,99600,38229
1684,1335,349,710,76100,38230
696,541,155,725,79300,38231
828,634,194,581,72500,38232
1066,840,226,702,73000,38233
82,54,28,650,72500,38235
407,277,130,434,89200,38236
5773,3328,2445,687,153200,38237
893,605,288,893,84700,38240
393,330,63,498,87900,38241
7936,5687,2249,689,116900,38242
1143,941,202,577,92900,38251
361,252,109,918,130000,38253
0,0,0,-,-,38254
1100,723,377,563,83800,38255
1579,1343,236,846,98500,38256
1839,1345,494,577,102300,38257
575,475,100,807,85500,38258
282,189,93,628,74800,38259
1600,1250,350,702,108800,38260
6554,3725,2829,661,111200,38261
13533,6721,6812,820,93600,38301
20328,13373,6955,982,170900,38305
2385,1851,534,648,102100,38310
387,351,36,-,161500,38311
1344,1317,27,-,142400,38313
1500,1268,232,686,103200,38315
1071,859,212,630,110400,38316
1145,946,199,655,94300,38317
168,133,35,920,-,38318
4223,3002,1221,744,95700,38320
1090,903,187,445,83100,38321
1362,1107,255,819,155600,38326
237,205,32,673,88400,38327
321,306,15,-,-,38328
1158,971,187,608,109900,38329
1452,987,465,717,93400,38330
517,480,37,534,128900,38332
97,65,32,-,-,38333
671,614,57,643,100000,38334
482,372,110,782,113100,38337
25,16,9,913,134400,38338
247,166,81,642,178600,38339
4009,2839,1170,683,123700,38340
1021,869,152,608,86100,38341
577,420,157,507,80000,38342
6550,4315,2235,690,118800,38343
3399,2376,1023,700,105100,38344
628,519,109,797,81100,38345
117,97,20,-,169000,38347
393,342,51,793,103300,38348
6929,4796,2133,703,124900,38351
309,200,109,-,109100,38352
2986,2373,613,909,204000,38355
1200,893,307,652,136100,38356
1106,961,145,713,134300,38357
4402,2955,1447,712,111600,38358
127,105,22,750,79000,38359
530,467,63,652,138100,38361
444,293,151,1266,119000,38362
2102,1619,483,651,92700,38363
0,0,0,-,-,38365
883,768,115,811,119000,38366
1079,854,225,665,128600,38367
714,555,159,729,124500,38368
665,556,109,638,85000,38369
414,323,91,556,102600,38370
385,335,50,733,104800,38371
6678,4696,1982,656,115500,38372
825,622,203,564,110300,38374
3238,2332,906,591,98100,38375
158,93,65,-,66600,38376
602,425,177,814,130800,38379
188,173,15,-,95500,38380
612,402,210,700,93400,38381
3478,2128,1350,632,106500,38382
183,150,33,-,91700,38387
644,544,100,568,99300,38388
17,16,1,-,76700,38389
443,359,84,756,86700,38390
438,304,134,1029,90900,38391
264,220,44,-,-,38392
24948,17618,7330,956,218000,38401
667,548,119,589,137900,38425
1182,991,191,942,138500,38449
1106,853,253,436,79000,38450
1569,1346,223,836,174900,38451
389,368,21,-,91600,38452
123,90,33,-,430000,38453
391,316,75,-,128600,38454
44,42,2,-,118800,38455
1374,1144,230,695,154200,38456
237,169,68,487,92100,38457
147,106,41,476,-,38459
614,579,35,583,156300,38460
551,454,97,1052,199100,38461
3966,3245,721,725,109900,38462
988,898,90,509,115700,38463
9339,6495,2844,687,127500,38464
1949,1490,459,772,152800,38468
1605,1401,204,628,102700,38469
113,93,20,-,102100,38471
1150,963,187,674,163600,38472
359,262,97,900,153400,38473
3053,2326,727,662,172800,38474
310,283,27,-,150400,38475
352,328,24,-,204100,38476
1220,1052,168,770,140400,38477
6901,4288,2613,694,150700,38478
389,314,75,536,78800,38481
600,542,58,1278,225000,38482
2078,1655,423,481,137000,38483
2510,1863,647,602,110200,38485
504,327,177,-,109700,38486
373,320,53,-,258700,38487
956,855,101,777,171100,38488
16743,8488,8255,759,177200,38501
0,0,0,-,-,38503
243,243,0,-,-,38504
0,0,0,-,-,38505
12114,8742,3372,866,174300,38506
687,562,125,782,176000,38541
8,0,8,-,-,38542
142,122,20,-,160700,38543
2707,2258,449,741,156800,38544
526,448,78,635,87100,38545
770,741,29,682,170100,38547
392,369,23,758,201300,38548
1669,1267,402,607,130700,38549
0,0,0,-,-,38550
1636,1120,516,536,114600,38551
98,68,30,521,187500,38552
1075,877,198,846,138900,38553
332,256,76,-,125000,38554
8871,5506,3365,717,170800,38555
5050,3544,1506,563,102400,38556
4699,4103,596,1133,245200,38558
549,418,131,820,134100,38559
420,347,73,757,156900,38560
2477,1995,482,682,117600,38562
895,676,219,745,182700,38563
293,244,49,-,88300,38564
291,270,21,-,132900,38565
319,256,63,529,210000,38567
739,653,86,615,136200,38568
69,44,25,-,-,38569
4119,3209,910,600,127500,38570
5811,4861,950,820,152100,38571
5015,4510,505,735,149800,38572
869,735,134,765,144900,38573
3221,2475,746,631,143300,38574
375,291,84,-,142300,38575
532,393,139,781,91000,38577
86,62,24,657,142200,38578
444,360,84,862,190600,38579
524,442,82,583,175400,38580
1485,1208,277,756,113100,38581
696,661,35,813,187900,38582
9474,7375,2099,767,148200,38583
1858,1349,509,552,99100,38585
570,452,118,776,86400,38587
388,310,78,574,124100,38588
111,107,4,-,-,38589
776,688,88,775,163500,38601
1125,1007,118,688,101000,38603
5193,3727,1466,795,120100,38606
959,707,252,631,88300,38610
5848,4456,1392,913,153700,38611
6412,3389,3023,648,76100,38614
283,119,164,238,59400,38617
4663,3597,1066,854,131300,38618
1906,1058,848,-,76200,38619
1267,1002,265,783,85200,38620
669,331,338,734,58200,38621
282,152,130,450,45000,38622
72,51,21,-,28500,38623
595,309,286,764,77100,38625
392,372,20,-,209100,38626
644,618,26,-,113400,38627
658,553,105,547,123500,38629
497,220,277,457,62100,38631
10426,9027,1399,1074,231600,38632
918,656,262,654,85400,38633
5165,3829,1336,742,121500,38635
9449,5404,4045,1121,117900,38637
197,119,78,475,44100,38639
787,719,68,1304,149200,38641
924,741,183,563,95000,38642
644,259,385,536,47200,38643
33,13,20,-,37500,38644
447,286,161,540,79200,38645
1115,802,313,649,69000,38646
240,153,87,-,-,38647
1476,1133,343,689,133400,38650
2955,2725,230,-,224900,38651
5886,4287,1599,785,123800,38652
20009,16645,3364,1325,225100,38654
16617,9815,6802,1014,234300,38655
979,819,160,850,97600,38658
951,670,281,760,78300,38659
855,840,15,-,127000,38661
4491,3184,1307,573,118200,38663
1229,120,1109,908,147700,38664
994,615,379,1031,143000,38665
2584,1780,804,719,67800,38666
4849,3587,1262,766,168400,38668
370,245,125,772,47900,38670
14273,8781,5492,1093,137400,38671
5422,5091,331,1742,234800,38672
470,459,11,756,246600,38673
513,448,65,-,59800,38674
2130,978,1152,782,96000,38676
0,0,0,-,-,38677
2545,1584,961,956,143200,38680
1456,1011,445,492,74000,38683
594,584,10,-,-,38685
8653,4576,4077,709,97300,38701
4512,2476,2036,812,65000,38703
278,227,51,654,60300,38720
378,262,116,588,68100,38721
61,52,9,-,40000,38722
32,32,0,-,-,38723
339,235,104,636,68700,38725
180,142,38,725,70200,38726
687,439,248,692,169600,38730
5,0,5,-,-,38731
6008,3521,2487,750,143200,38732
0,0,0,-,-,38733
149,140,9,-,100500,38736
1157,536,621,565,71200,38737
24,10,14,-,-,38738
144,124,20,719,-,38740
240,187,53,-,66100,38744
33,12,21,-,-,38745
183,92,91,316,71300,38746
1042,648,394,656,66800,38748
3778,1957,1821,716,104600,38751
520,337,183,635,109100,38753
508,344,164,663,88800,38754
2588,1673,915,649,89400,38756
555,425,130,584,125700,38759
305,194,111,604,70300,38760
679,399,280,613,71800,38761
882,359,523,583,63900,38762
132,101,31,335,103800,38764
40,0,40,-,-,38765
21,21,0,-,-,38767
26,18,8,-,-,38768
760,346,414,349,75600,38769
880,454,426,612,90800,38771
33,33,0,-,-,38772
1181,736,445,650,79000,38773
664,383,281,572,74000,38774
6,6,0,-,-,38776
499,209,290,378,70500,38778
59,17,42,289,112500,38781
11672,7423,4249,825,146800,38801
6666,4025,2641,768,163700,38804
4884,3452,1432,668,131200,38821
2941,2418,523,677,85500,38824
2157,1360,797,889,164600,38826
1469,891,578,674,136500,38827
1443,1102,341,807,89900,38828
6592,4933,1659,578,104400,38829
888,555,333,556,82000,38833
11324,7111,4213,657,126600,38834
453,453,0,-,62000,38838
17,14,3,-,-,38839
1325,1032,293,581,78700,38841
4060,3237,823,707,117700,38843
119,119,0,-,-,38844
725,642,83,589,89300,38846
1417,1129,288,-,51500,38847
330,311,19,-,86200,38848
1918,1512,406,788,133700,38849
1015,839,176,500,68800,38850
3627,2500,1127,693,81500,38851
3773,2716,1057,538,111500,38852
1991,1581,410,743,111400,38855
616,541,75,-,97000,38856
1344,1126,218,611,153500,38857
2296,1698,598,729,90400,38858
194,172,22,-,104800,38859
2174,1475,699,559,81200,38860
995,794,201,748,91000,38862
6852,5055,1797,749,124200,38863
692,565,127,678,108200,38864
1820,1503,317,804,77100,38865
4559,3825,734,791,169800,38866
2083,1569,514,695,95900,38868
129,72,57,841,162500,38869
1074,957,117,783,95600,38870
693,548,145,824,96700,38871
1180,1010,170,658,90000,38873
475,371,104,595,90700,38876
1029,796,233,554,64200,38878
44,44,0,-,68000,38879
7464,5083,2381,719,113100,38901
148,131,17,-,85700,38913
277,235,42,575,64800,38914
1647,1112,535,553,83300,38915
1896,1255,641,572,65900,38916
1314,995,319,806,103800,38917
277,229,48,-,63200,38920
1507,973,534,577,69300,38921
1214,945,269,603,84500,38922
506,378,128,-,122400,38923
152,113,39,820,61500,38924
902,689,213,570,77500,38925
293,219,74,733,49700,38927
108,18,90,604,76200,38928
696,554,142,809,89400,38929
8118,4603,3515,613,88900,38930
601,520,81,-,101900,38940
1184,521,663,647,75100,38941
234,227,7,-,34400,38943
61,18,43,679,82000,38944
85,65,20,683,66300,38946
27,27,0,-,310000,38947
944,636,308,808,58900,38948
139,139,0,-,134900,38949
224,168,56,-,73600,38950
399,269,130,833,63400,38951
168,104,64,-,84000,38952
190,190,0,-,87800,38953
306,263,43,850,63100,38954
212,80,132,1028,95000,38957
250,193,57,-,98100,38961
0,0,0,-,-,38962
1035,623,412,820,74600,38963
19,19,0,-,-,38964
3528,2538,990,694,97800,38965
232,114,118,531,65900,38966
2513,1594,919,621,101100,38967
2012,1173,839,710,68400,39038
1314,1101,213,674,108300,39039
1527,973,554,835,119300,39040
1390,1094,296,551,142300,39041
13576,11480,2096,948,207600,39042
1149,1041,108,1205,93600,39044
808,715,93,787,78600,39045
11397,6543,4854,815,174000,39046
15175,12911,2264,1433,214200,39047
5551,4146,1405,702,84600,39051
113,66,47,1075,-,39054
10573,7334,3239,1062,186000,39056
764,644,120,-,86700,39057
0,0,0,-,-,39058
4248,3509,739,665,91100,39059
0,0,0,-,-,39061
166,118,48,721,84400,39062
1116,687,429,614,49900,39063
1975,1618,357,751,122000,39066
400,332,68,725,78900,39067
1478,934,544,382,66400,39069
2499,1853,646,498,252200,39071
7771,6503,1268,898,152400,39073
4867,3195,1672,728,76300,39074
289,217,72,236,89000,39078
386,174,212,444,78500,39079
332,305,27,-,87700,39082
3330,2387,943,671,76300,39083
441,268,173,-,-,39086
10,10,0,-,-,39088
4673,3084,1589,590,105300,39090
1307,1064,243,562,66400,39092
1468,1286,182,774,96300,39094
2050,1308,742,586,72900,39095
532,374,158,-,60700,39096
160,94,66,807,50000,39097
612,555,57,-,48400,39108
15947,15233,714,1690,278000,39110
3021,2214,807,724,95200,39111
114,23,91,211,59600,39113
3415,2785,630,753,90600,39114
55,55,0,-,45600,39115
896,877,19,-,123900,39116
3512,2704,808,823,84400,39117
2028,1678,350,680,90400,39119
11482,7282,4200,630,91600,39120
888,668,220,879,85100,39140
245,210,35,-,71900,39144
2014,1684,330,792,116600,39145
1135,794,341,542,66400,39146
0,0,0,-,-,39148
629,555,74,-,92600,39149
1796,1331,465,554,72700,39150
377,341,36,-,70100,39152
1039,859,180,538,82800,39153
3382,2891,491,1040,185900,39154
268,252,16,-,55200,39156
10723,5375,5348,1103,201900,39157
942,573,369,504,78100,39159
899,772,127,485,80300,39160
70,69,1,-,129700,39162
200,122,78,317,102800,39166
0,0,0,-,-,39167
2441,2030,411,634,86900,39168
1046,487,559,505,45900,39169
3673,3412,261,854,181900,39170
0,0,0,-,-,39173
39,0,39,-,-,39174
1414,1121,293,635,83900,39175
842,683,159,321,75300,39176
51,35,16,-,132500,39177
582,436,146,880,95400,39179
11962,8290,3672,835,128600,39180
4861,3452,1409,769,158900,39183
1153,801,352,669,72300,39189
2639,2243,396,921,89800,39191
456,410,46,-,58600,39192
16,0,16,-,-,39193
5041,2735,2306,746,107700,39194
543,10,533,1126,-,39201
3568,946,2622,805,184400,39202
2040,620,1420,655,41700,39203
5820,1982,3838,759,57500,39204
9720,4554,5166,957,97700,39206
12412,7865,4547,987,140600,39208
9905,4567,5338,823,64400,39209
0,0,0,-,-,39210
9832,6262,3570,1090,165500,39211
10869,6487,4382,1027,86700,39212
8309,3798,4511,702,61400,39213
1637,729,908,968,230800,39216
78,0,78,-,-,39217
2866,1882,984,1039,116600,39218
3870,2124,1746,1287,220700,39232
0,0,0,-,-,39269
5294,3964,1330,1136,147800,39272
9436,5592,3844,741,84700,39301
8006,5308,2698,951,171000,39305
6129,3142,2987,702,71600,39307
0,0,0,-,-,39309
633,513,120,720,81400,39320
625,554,71,-,52100,39322
489,404,85,1072,69300,39323
0,0,0,-,-,39324
2216,1949,267,656,152800,39325
92,92,0,-,-,39326
1450,1173,277,706,117700,39327
1783,1209,574,286,68300,39328
983,900,83,772,96900,39330
640,511,129,741,115900,39332
875,735,140,941,120700,39335
414,353,61,-,65500,39336
668,588,80,490,68000,39337
1377,1262,115,656,78500,39338
5623,4098,1525,585,107200,39339
2027,1434,593,581,77100,39341
673,311,362,918,163900,39342
2242,1621,621,591,67400,39345
824,648,176,722,81400,39346
587,475,112,321,123200,39347
170,170,0,-,57000,39348
8326,5906,2420,692,86000,39350
203,160,43,-,76800,39352
800,673,127,764,81000,39354
2579,2201,378,858,90700,39355
265,184,81,-,-,39356
282,184,98,450,-,39358
101,64,37,-,87100,39359
1220,1091,129,648,38400,39360
624,580,44,380,75700,39361
1439,1132,307,1022,68400,39362
514,334,180,677,50000,39363
1317,1183,134,931,136100,39364
2831,2213,618,541,87400,39365
333,308,25,-,66000,39366
5532,4827,705,674,85200,39367
16415,7068,9347,815,100700,39401
17276,10100,7176,1064,209100,39402
0,0,0,-,-,39406
1179,1085,94,850,86900,39421
1713,1412,301,582,84000,39422
1110,971,139,575,94500,39423
968,875,93,677,157700,39425
6450,5591,859,958,172700,39426
461,424,37,567,81500,39427
3237,2279,958,748,77100,39428
6224,4737,1487,496,106000,39429
4251,3257,994,702,142900,39437
1734,1521,213,776,91600,39439
7496,4579,2917,743,90700,39440
8167,6534,1633,723,105900,39443
1106,756,350,687,99700,39451
10032,8157,1875,742,127900,39452
3490,2800,690,604,89900,39455
245,237,8,-,133900,39456
1443,1053,390,661,87300,39459
351,239,112,-,117700,39461
436,300,136,582,192900,39462
1033,913,120,758,72800,39464
8157,6409,1748,902,143300,39465
10748,8158,2590,838,133800,39466
4179,3539,640,708,133800,39470
2143,1615,528,661,85700,39474
5429,4113,1316,913,162300,39475
2292,2034,258,583,119600,39476
239,221,18,725,84500,39477
772,668,104,-,145600,39478
2213,1753,460,609,78800,39479
977,902,75,1067,139400,39480
617,535,82,-,140500,39481
4117,3601,516,860,159100,39482
2034,1720,314,830,74400,39483
8822,3161,5661,849,87800,39501
19976,13314,6662,977,157300,39503
7507,3649,3858,978,188900,39507
6423,4436,1987,934,170900,39520
4160,3624,536,897,188600,39525
0,0,0,-,-,39529
3632,1627,2005,792,147400,39530
7821,2872,4949,933,159400,39531
13411,7902,5509,984,177800,39532
0,0,0,-,-,39534
4764,2465,2299,1040,161800,39540
6638,4882,1756,905,127800,39553
2725,2474,251,1064,126100,39556
7145,4810,2335,1074,167300,39560
651,600,51,-,129500,39561
6802,5680,1122,840,138500,39562
4656,3464,1192,924,99600,39563
16632,12108,4524,1082,170800,39564
6905,5974,931,985,175400,39565
3617,2349,1268,864,121300,39567
5216,4302,914,912,176000,39571
564,564,0,-,80800,39572
3347,3081,266,587,159700,39573
4480,3790,690,930,168600,39574
2546,1662,884,852,171300,39576
3489,2274,1215,734,114600,39577
4500,2068,2432,784,104000,39581
0,0,0,-,-,39595
8854,6451,2403,759,96900,39601
2442,2081,361,681,141200,39629
466,187,279,585,65200,39630
1515,1076,439,482,59900,39631
278,213,65,389,44400,39633
103,62,41,-,-,39635
1520,1153,367,655,80700,39638
1842,1536,306,813,115800,39641
380,311,69,886,103400,39643
2153,1610,543,721,84200,39645
233,223,10,-,-,39647
8108,4300,3808,780,94500,39648
3143,2544,599,715,71400,39652
1031,709,322,-,89900,39653
1936,1442,494,768,111100,39654
236,190,46,-,142900,39656
693,608,85,682,86200,39657
897,705,192,920,76800,39661
446,446,0,-,85100,39662
869,634,235,706,104600,39663
813,739,74,785,101300,39664
404,348,56,-,73300,39665
3791,2981,810,788,154000,39666
4460,3754,706,607,102900,39667
326,288,38,-,77400,39668
2038,1765,273,689,72000,39669
5321,2525,2796,705,133700,39701
8268,5429,2839,765,120700,39702
5105,3098,2007,978,192800,39705
4174,2942,1232,653,85400,39730
1549,1159,390,594,123000,39735
173,93,80,348,92100,39736
77,64,13,-,-,39737
989,694,295,591,56500,39739
1983,1485,498,640,146500,39740
651,542,109,-,79900,39741
814,759,55,475,57900,39743
2353,1793,560,622,82700,39744
265,191,74,-,110200,39745
1166,959,207,591,112600,39746
687,486,201,573,84300,39747
1432,1088,344,605,95000,39750
518,417,101,569,84800,39751
957,795,162,594,86200,39752
0,0,0,-,-,39753
385,346,39,-,118500,39755
540,517,23,-,71500,39756
19247,9040,10207,822,184500,39759
0,0,0,-,-,39762
1158,817,341,735,126100,39766
392,347,45,341,65000,39767
609,443,166,-,135200,39769
49,38,11,-,88600,39771
787,685,102,494,72300,39772
6090,4068,2022,659,106500,39773
531,360,171,921,72200,39776
699,475,224,664,79800,39813
499,333,166,761,66500,39815
3830,2299,1531,717,123800,39817
4527,2677,1850,738,141100,39819
3174,2185,989,813,127500,39823
259,207,52,529,53400,39824
621,432,189,879,158600,39825
300,202,98,618,70000,39826
1859,1254,605,860,148600,39827
5336,3104,2232,770,125000,39828
4,4,0,-,-,39832
696,522,174,708,81700,39834
140,91,49,-,-,39836
2591,1715,876,606,102300,39837
1732,808,924,600,78100,39840
290,251,39,387,71000,39841
2720,1501,1219,666,91500,39842
3182,2251,931,778,93900,39845
616,445,171,528,59700,39846
867,572,295,326,60500,39851
1021,832,189,691,70700,39854
356,308,48,613,100700,39859
467,298,169,703,88000,39861
431,297,134,619,94600,39862
150,102,48,395,73600,39866
126,99,27,-,93400,39867
766,462,304,526,106800,39870
231,201,30,575,73200,39877
9,6,3,-,-,39885
537,335,202,493,82300,39886
1402,1137,265,776,95900,39897
699,590,109,964,184400,40003
11967,8727,3240,845,165600,40004
1785,1427,358,665,121500,40006
20,20,0,-,-,40007
1529,1309,220,840,168100,40008
572,511,61,671,56300,40009
181,181,0,-,389100,40010
926,744,182,779,118500,40011
227,149,78,747,-,40012
2275,2111,164,987,223500,40013
7341,6350,991,1111,324100,40014
1411,916,495,713,149200,40019
135,124,11,-,-,40020
291,247,44,-,357200,40022
2165,2033,132,1234,348700,40023
194,193,1,-,952600,40025
2032,1915,117,1565,360800,40026
7995,6363,1632,985,257900,40031
4834,3161,1673,641,128000,40033
124,114,10,-,-,40036
1064,950,114,633,135800,40037
180,143,37,1096,62900,40040
259,71,188,932,404100,40041
1340,1085,255,779,128600,40045
516,498,18,-,177100,40046
8216,7127,1089,835,202900,40047
0,0,0,-,-,40049
712,529,183,717,124700,40050
1768,1440,328,750,142100,40051
194,181,13,-,85700,40052
858,674,184,1099,173100,40055
1270,1213,57,1194,244900,40056
1575,1158,417,947,139300,40057
17,17,0,-,95000,40058
7653,7022,631,1706,467600,40059
500,415,85,610,123700,40060
0,0,0,-,-,40061
77,45,32,1265,151100,40062
0,0,0,-,-,40063
11420,7603,3817,873,197300,40065
2260,1757,503,725,263400,40067
964,795,169,909,215000,40068
3259,2400,859,648,143500,40069
162,132,30,-,120800,40070
5701,4899,802,834,243400,40071
377,290,87,624,138700,40075
1128,914,214,691,172400,40076
266,171,95,782,179200,40077
967,794,173,1014,97800,40078
390,365,25,-,94400,40104
839,687,152,915,173200,40107
4517,3614,903,751,174500,40108
858,800,58,-,200800,40109
188,99,89,-,174500,40110
680,503,177,275,89900,40111
257,232,25,-,108700,40115
912,742,170,1007,142500,40117
3880,2644,1236,956,116000,40118
781,757,24,-,110300,40119
2342,15,2327,1114,-,40121
269,216,53,828,48800,40140
763,589,174,863,148900,40142
2328,1757,571,673,113100,40143
529,529,0,-,105100,40144
205,179,26,-,83000,40145
1368,1009,359,722,101200,40146
1745,1364,381,754,129600,40150
337,337,0,-,146000,40152
461,242,219,775,62900,40155
342,275,67,1042,247600,40157
9047,4622,4425,792,129100,40160
67,38,29,-,-,40161
1935,1734,201,629,178800,40162
14077,11031,3046,840,190500,40165
159,139,20,-,-,40170
114,62,52,-,69500,40171
5328,3984,1344,1086,170900,40175
329,282,47,-,75500,40176
664,476,188,591,109300,40177
182,182,0,-,126600,40178
3030,188,2842,-,319600,40202
8917,1878,7039,681,134100,40203
7684,3793,3891,1085,239600,40204
10561,7864,2697,1019,303200,40205
10524,5618,4906,948,229000,40206
13688,9512,4176,1164,343800,40207
5090,1214,3876,807,121800,40208
209,138,71,690,105800,40209
5733,2269,3464,763,76300,40210
9315,3873,5442,818,78700,40211
6745,3481,3264,769,65900,40212
7116,4365,2751,869,131100,40213
18396,9710,8686,842,147500,40214
7845,3260,4585,848,85200,40215
17401,10743,6658,818,126300,40216
6053,3712,2341,1004,180800,40217
13483,6549,6934,924,149500,40218
15565,8156,7409,852,144700,40219
15339,9543,5796,1089,201800,40220
0,0,0,-,-,40221
10114,5708,4406,1107,281800,40222
10046,7327,2719,1203,296000,40223
7059,5761,1298,1193,178800,40228
14725,10812,3913,1101,154300,40229
0,0,0,-,-,40231
12730,8880,3850,1222,292000,40241
4522,3185,1337,1138,239800,40242
5445,3582,1863,1218,254300,40243
13718,10801,2917,1384,362400,40245
10565,7473,3092,948,138400,40258
14523,10706,3817,1083,142800,40272
8,0,8,-,-,40280
15379,12079,3300,1039,207900,40291
16654,12754,3900,1111,226900,40299
229,172,57,648,75000,40310
2710,1900,810,647,96100,40311
2300,1532,768,664,90600,40312
1076,637,439,751,83700,40313
166,110,56,-,94500,40316
1083,787,296,601,86700,40322
18718,13115,5603,994,203100,40324
436,360,76,575,71900,40328
8169,5874,2295,644,158100,40330
6,6,0,-,-,40334
4985,3531,1454,628,87600,40336
1955,1530,425,654,85400,40337
32,27,5,-,94800,40339
8804,6943,1861,779,168500,40342
213,160,53,648,85300,40346
1362,1021,341,861,286400,40347
352,165,187,570,104200,40348
65,65,0,-,-,40350
7995,4933,3062,714,146300,40351
8734,5424,3310,727,149900,40353
71,34,37,-,-,40355
16571,11492,5079,847,192000,40356
64,17,47,763,86100,40357
474,387,87,398,129700,40358
2602,2154,448,623,121900,40359
2685,1824,861,501,89000,40360
7203,4601,2602,754,165300,40361
15,15,0,-,-,40363
1047,944,103,1061,224100,40370
1100,941,159,609,71500,40371
834,743,91,710,192700,40372
724,567,157,575,86800,40374
15,15,0,-,-,40376
1562,1334,228,923,174700,40379
2366,1651,715,747,109600,40380
9447,6616,2831,816,230400,40383
962,761,201,481,89100,40385
680,527,153,-,81600,40387
2113,1169,944,834,186900,40390
14703,10527,4176,773,158100,40391
780,626,154,-,75000,40402
9795,6611,3184,743,149200,40403
0,0,0,-,-,40404
1392,885,507,674,88600,40409
1583,1250,333,505,112900,40419
9389,6086,3303,736,174900,40422
0,0,0,-,-,40434
1990,1665,325,672,111400,40437
1146,994,152,671,113000,40440
305,294,11,-,115000,40442
5425,4475,950,734,159300,40444
263,229,34,466,76500,40445
3041,2230,811,549,74400,40447
0,0,0,-,-,40448
3622,2703,919,626,104300,40456
352,325,27,-,63800,40460
925,737,188,727,157300,40461
413,367,46,-,107900,40464
848,689,159,863,114500,40468
607,463,144,724,71300,40472
25087,14514,10573,769,186900,40475
139,125,14,-,90400,40481
5001,3709,1292,633,126700,40484
1024,956,68,-,91300,40486
1507,1407,100,661,83600,40489
12866,7474,5392,942,398200,40502
12543,8011,4532,987,222700,40503
11881,3749,8132,794,166100,40504
11010,6614,4396,835,133700,40505
1339,406,933,724,325900,40507
10190,2888,7302,800,139800,40508
18044,11275,6769,1142,270600,40509
417,303,114,-,586300,40510
13036,8215,4821,1047,179400,40511
4395,3299,1096,1218,371700,40513
6393,4586,1807,1301,242700,40514
14686,9133,5553,1105,247900,40515
1051,873,178,1024,181600,40516
16778,6168,10610,950,146700,40517
0,0,0,-,-,40526
0,0,0,-,-,40536
22318,13984,8334,834,155500,40601
11302,7491,3811,656,139600,40701
2071,1719,352,776,72600,40729
1295,895,400,381,89900,40734
515,443,72,707,120000,40737
1380,903,477,722,96100,40740
9389,6602,2787,735,131200,40741
6729,4924,1805,721,129000,40744
793,710,83,619,78400,40759
211,164,47,718,55300,40763
5933,3767,2166,638,77700,40769
608,243,365,-,-,40771
0,0,0,-,-,40801
21,21,0,-,-,40803
872,592,280,591,108300,40806
217,190,27,496,55300,40807
17,17,0,-,63600,40808
494,425,69,627,57500,40810
121,72,49,521,83800,40813
372,246,126,-,52600,40815
0,0,0,-,-,40816
38,38,0,-,-,40818
367,327,40,-,78100,40819
145,145,0,-,32900,40820
1338,732,606,452,71500,40823
244,99,145,683,41500,40824
208,159,49,-,50800,40826
315,250,65,-,85400,40827
1612,1295,317,792,57700,40828
42,9,33,-,-,40829
126,126,0,-,-,40830
1998,1083,915,497,85400,40831
157,138,19,-,53700,40840
47,47,0,-,18600,40843
51,51,0,-,46800,40844
229,186,43,-,62000,40845
59,45,14,-,-,40847
30,23,7,-,214100,40849
436,226,210,577,63400,40854
352,240,112,706,53500,40855
329,241,88,-,59300,40856
75,46,29,-,-,40858
194,163,31,-,59100,40862
184,144,40,-,60900,40863
140,108,32,-,76500,40865
376,288,88,-,91900,40868
239,212,27,602,65900,40870
798,570,228,709,73500,40873
80,56,24,-,64000,40874
328,244,84,579,100200,40902
262,218,44,-,67000,40903
4348,2671,1677,597,85900,40906
114,57,57,-,-,40913
313,137,176,479,51400,40914
326,167,159,399,114600,40915
96,67,29,622,42600,40921
239,186,53,-,93800,40923
250,223,27,-,58300,40927
878,563,315,487,57100,40935
55,55,0,-,-,40939
121,104,17,-,65000,40940
0,0,0,-,-,40941
245,171,74,-,-,40943
20,10,10,-,-,40946
82,49,33,-,143300,40949
157,108,49,-,83100,40953
209,142,67,-,-,40958
6081,4446,1635,601,69700,40962
24,0,24,543,-,40964
4792,2668,2124,549,69800,40965
530,397,133,547,47900,40972
3157,2140,1017,557,65700,40977
0,0,0,-,-,40979
0,0,0,-,-,40981
163,131,32,-,66500,40982
83,66,17,-,-,40983
182,167,15,-,95400,40988
6,6,0,-,-,40995
130,55,75,-,56100,40997
6662,5834,828,933,223300,41001
970,692,278,561,98500,41002
843,585,258,681,139400,41003
1303,958,345,713,94000,41004
8416,6796,1620,1131,195400,41005
1433,1081,352,815,136600,41006
1657,1536,121,933,264100,41007
2775,1673,1102,682,118000,41008
1304,1124,180,728,141600,41010
12605,5550,7055,820,208900,41011
2958,1477,1481,823,109800,41014
8099,5610,2489,723,148300,41015
2770,1967,803,721,134400,41016
15870,12021,3849,863,220600,41017
11497,7422,4075,946,137400,41018
1969,1389,580,823,202600,41030
6433,4532,1901,638,157600,41031
632,562,70,655,191100,41033
477,426,51,607,77900,41034
4386,3088,1298,742,147900,41035
1009,822,187,683,96100,41039
2869,1982,887,792,116500,41040
2939,1929,1010,614,89600,41041
22003,14621,7382,1024,166600,41042
597,501,96,780,151800,41043
455,367,88,720,124600,41044
510,384,126,933,150600,41045
543,452,91,988,140600,41046
5390,4769,621,1204,244600,41048
823,700,123,725,118600,41049
10947,9300,1647,1077,189100,41051
89,62,27,-,-,41052
734,643,91,450,169300,41055
5345,3395,1950,653,144400,41056
1175,989,186,610,170900,41059
1011,923,88,548,161000,41063
794,616,178,604,88400,41064
9653,5095,4558,830,150800,41071
2683,1770,913,811,148900,41073
2564,1600,964,840,112800,41074
6586,4823,1763,940,235500,41075
6658,4987,1671,973,163300,41076
603,547,56,-,209300,41080
475,402,73,700,89600,41083
398,278,120,680,101500,41085
802,684,118,765,87800,41086
7638,7120,518,1321,291200,41091
1110,934,176,852,169100,41092
1074,927,147,758,79400,41093
4841,3840,1001,1070,220900,41094
1359,785,574,704,131700,41095
2436,1741,695,705,151900,41097
638,480,158,718,80700,41098
7714,4698,3016,752,97900,41101
7346,5176,2170,812,133000,41102
632,600,32,-,136500,41121
407,261,146,643,58100,41124
3511,2688,823,627,120700,41129
168,161,7,-,69500,41132
107,77,30,-,82600,41135
3332,2565,767,844,96800,41139
769,614,155,750,54900,41141
28,28,0,-,-,41142
4706,3499,1207,593,124300,41143
3601,2891,710,728,119000,41144
184,149,35,594,69300,41146
154,129,25,868,86500,41149
164,116,48,585,"10,000-",41159
4467,3658,809,604,84800,41164
315,281,34,-,74000,41166
981,852,129,782,115500,41168
2293,1798,495,742,152700,41169
1310,975,335,800,84600,41171
400,341,59,-,108500,41174
2201,1585,616,634,101400,41175
2752,2137,615,517,81300,41179
355,303,52,654,54200,41180
52,52,0,-,-,41181
714,480,234,791,99700,41183
709,532,177,725,92800,41189
71,63,8,-,157300,41201
269,250,19,-,45300,41203
286,221,65,-,104200,41204
152,25,127,-,138800,41214
549,464,85,789,121900,41216
696,551,145,814,96300,41219
995,905,90,-,138900,41222
1566,1253,313,628,79700,41224
74,74,0,-,-,41226
4281,3316,965,754,94600,41230
420,332,88,739,103300,41231
172,64,108,583,62500,41232
202,172,30,650,123500,41234
341,210,131,733,123500,41238
2429,1265,1164,609,147600,41240
417,364,53,-,47600,41250
239,175,64,-,-,41254
261,202,59,-,57500,41255
848,682,166,748,156400,41256
238,131,107,713,-,41257
258,153,105,236,79500,41260
317,257,60,-,52200,41262
107,77,30,-,-,41263
257,208,49,-,104400,41264
460,369,91,669,129400,41265
291,153,138,-,87500,41267
337,276,61,-,133200,41268
89,38,51,-,-,41271
243,131,112,569,-,41274
2143,1470,673,411,64500,41301
0,0,0,-,-,41310
2341,1630,711,551,76100,41311
1577,1084,493,336,66400,41314
224,189,35,-,31000,41317
305,278,27,-,54500,41332
4236,2990,1246,476,58500,41339
465,301,164,468,30600,41348
8,8,0,-,-,41351
242,219,23,-,61000,41352
114,89,25,-,-,41360
65,58,7,-,"10,000-",41364
303,184,119,-,43000,41365
22,5,17,-,-,41366
98,71,27,-,54600,41367
248,214,34,-,52400,41385
11,11,0,-,-,41386
38,38,0,-,171900,41390
60,60,0,-,265900,41397
170,150,20,-,56500,41408
137,126,11,-,-,41421
437,399,38,1363,72100,41425
137,115,22,-,-,41464
4134,3080,1054,613,78900,41465
3300,2520,780,591,82700,41472
9306,5785,3521,763,119800,41501
149,118,31,-,149300,41503
250,235,15,-,88600,41512
196,161,35,-,56200,41513
1190,821,369,778,68300,41514
22,22,0,-,-,41517
312,244,68,-,75800,41519
2004,1519,485,715,76000,41522
95,86,9,-,-,41524
23,0,23,-,-,41526
345,329,16,-,157300,41527
154,134,20,-,-,41528
376,295,81,540,87300,41531
97,97,0,-,-,41534
286,221,65,502,138000,41535
1620,1218,402,466,61400,41537
115,87,28,-,160700,41538
693,596,97,753,58800,41539
95,75,20,-,71700,41540
252,161,91,-,-,41543
209,178,31,-,56500,41544
367,288,79,-,-,41547
453,332,121,575,55300,41548
781,749,32,-,84000,41553
296,268,28,-,-,41554
309,277,32,-,56600,41555
858,758,100,-,131600,41557
310,211,99,621,87300,41558
184,155,29,-,159100,41559
77,64,13,-,108000,41560
955,758,197,-,75300,41562
114,107,7,-,-,41563
241,237,4,-,-,41564
199,119,80,-,74500,41566
33,25,8,-,85000,41567
350,350,0,-,-,41568
208,182,26,-,-,41571
1375,1236,139,759,86000,41572
288,194,94,665,75100,41601
346,297,49,-,74900,41602
671,377,294,844,-,41603
197,185,12,-,69400,41604
347,327,20,-,97700,41605
251,222,29,-,62500,41606
169,162,7,-,20700,41607
126,103,23,-,32800,41612
137,125,12,-,150400,41615
248,175,73,839,-,41616
141,87,54,667,70300,41619
71,51,20,-,-,41621
86,76,10,-,-,41622
337,247,90,580,84900,41630
288,199,89,-,108800,41631
229,156,73,-,-,41632
1263,948,315,817,63800,41635
433,290,143,745,65000,41636
441,315,126,1009,70900,41640
315,170,145,707,103100,41642
65,44,21,-,"10,000-",41643
299,233,66,817,-,41645
502,482,20,-,66900,41647
950,641,309,548,70600,41649
194,123,71,-,48600,41650
76,30,46,496,-,41651
4135,2856,1279,605,112000,41653
477,228,249,-,66000,41655
299,231,68,-,78000,41659
102,102,0,-,80900,41660
115,52,63,-,-,41663
375,277,98,838,69200,41666
115,115,0,-,71900,41667
256,194,62,806,48200,41669
6092,4352,1740,693,88100,41701
118,87,31,-,114400,41712
44,44,0,-,-,41713
172,164,8,-,58800,41714
481,398,83,-,36100,41719
327,237,90,-,-,41721
509,398,111,754,109700,41722
465,312,153,967,54000,41723
181,168,13,-,"10,000-",41725
553,501,52,-,69700,41727
0,0,0,-,-,41729
355,309,46,-,48500,41731
63,34,29,-,74800,41735
48,48,0,-,-,41739
216,163,53,680,121300,41740
187,165,22,-,-,41745
261,209,52,-,58200,41746
939,875,64,779,77500,41749
112,90,22,-,-,41751
263,260,3,-,-,41754
209,127,82,-,29300,41759
180,180,0,-,152400,41760
0,0,0,-,-,41762
233,213,20,-,24500,41763
219,197,22,-,-,41764
209,209,0,-,-,41766
135,118,17,-,66400,41772
504,368,136,553,43700,41773
1033,887,146,711,72700,41774
35,35,0,-,-,41775
464,414,50,-,65700,41776
382,325,57,-,67100,41777
108,108,0,-,-,41778
343,324,19,-,48600,41804
144,104,40,-,-,41810
115,92,23,-,-,41812
282,124,158,-,76600,41815
227,174,53,431,57300,41817
201,187,14,-,58200,41819
89,89,0,-,-,41821
712,491,221,483,56600,41822
331,253,78,-,-,41824
115,78,37,-,66900,41825
233,204,29,-,58200,41826
223,176,47,497,62500,41828
474,362,112,553,111400,41831
141,85,56,-,-,41832
69,46,23,-,94200,41833
142,54,88,-,-,41834
276,217,59,-,51200,41835
344,222,122,-,40000,41836
219,219,0,-,58100,41837
331,197,134,-,57800,41838
224,183,41,764,81400,41839
328,244,84,447,43300,41840
209,165,44,-,43400,41843
499,206,293,469,44400,41844
141,141,0,-,16000,41845
113,78,35,-,-,41847
0,0,0,-,-,41848
73,73,0,-,47700,41849
304,283,21,-,43800,41855
3106,2145,961,597,98800,41858
111,90,21,458,60800,41859
140,113,27,-,40200,41861
360,298,62,565,58700,41862
12874,7898,4976,825,172900,42001
11256,7276,3980,686,129100,42003
777,752,25,634,137200,42020
530,424,106,713,77800,42021
28,28,0,-,-,42022
829,668,161,648,74800,42023
426,308,118,590,148300,42024
8127,6901,1226,717,135700,42025
700,584,116,832,154400,42027
217,203,14,-,77300,42028
2634,1886,748,816,115800,42029
1218,890,328,603,85200,42031
105,98,7,535,66700,42032
353,283,70,690,162000,42035
516,462,54,-,118000,42036
0,0,0,-,-,42037
2037,1673,364,650,156300,42038
552,413,139,439,119000,42039
345,317,28,-,89700,42040
1667,1145,522,571,74200,42041
1508,1312,196,712,191400,42044
904,768,136,663,80700,42045
72,8,64,-,-,42047
721,566,155,591,101500,42048
617,478,139,649,124300,42049
1087,801,286,572,71300,42050
981,877,104,648,114200,42051
2056,1681,375,790,130000,42053
493,344,149,1093,158100,42054
1083,1027,56,672,98000,42055
555,462,93,528,86200,42056
800,705,95,1080,101100,42058
0,0,0,-,-,42060
56,56,0,-,64800,42061
3041,2460,581,659,98900,42064
9457,6453,3004,653,119400,42066
219,173,46,-,140600,42069
11690,7099,4591,724,156000,42071
485,317,168,575,85700,42076
770,688,82,587,68600,42078
460,363,97,713,157100,42079
761,643,118,596,137600,42081
867,803,64,816,120000,42082
187,131,56,-,-,42083
270,255,15,433,89200,42085
1540,1325,215,915,149200,42086
1009,872,137,674,78000,42087
835,659,176,584,92800,42088
22496,10672,11824,802,146000,42101
9100,5445,3655,900,259400,42103
15334,9734,5600,876,224400,42104
848,636,212,748,147700,42120
2056,1882,174,1099,220700,42122
438,355,83,-,109200,42123
30,30,0,-,75300,42124
2894,1575,1319,636,125700,42127
2846,2110,736,571,76800,42129
58,58,0,-,154500,42130
44,44,0,-,267300,42131
550,367,183,647,111000,42133
6876,4501,2375,866,153200,42134
455,353,102,617,74200,42140
12262,8377,3885,750,139100,42141
67,67,0,-,-,42151
31,24,7,-,112500,42153
193,193,0,-,70700,42154
159,159,0,-,97100,42156
168,130,38,525,-,42157
723,512,211,1092,217900,42159
618,417,201,702,126200,42160
21,0,21,-,-,42163
6359,4791,1568,744,131500,42164
877,722,155,686,90000,42166
3460,2363,1097,570,111400,42167
580,465,115,725,208800,42170
2425,1990,435,776,155300,42171
768,594,174,-,107200,42202
280,211,69,-,184900,42204
2128,1599,529,810,107300,42206
451,367,84,633,83000,42207
1970,1564,406,543,84000,42210
5313,4237,1076,580,164300,42211
257,211,46,732,137000,42214
645,560,85,792,168300,42215
1270,1043,227,675,101900,42217
2299,1744,555,693,116300,42220
4346,1,4345,1309,-,42223
210,176,34,-,136200,42232
893,550,343,588,119000,42234
240,177,63,845,96600,42236
16619,8850,7769,767,127100,42240
26,26,0,-,-,42252
117,78,39,636,87800,42254
1984,1757,227,683,99700,42256
416,344,72,733,108300,42259
3551,2488,1063,548,94500,42261
3280,1243,2037,962,118700,42262
329,233,96,574,-,42265
832,693,139,764,170200,42266
264,225,39,480,-,42273
971,845,126,570,147200,42274
310,235,75,1125,123500,42275
6038,4026,2012,626,114600,42276
146,137,9,-,101000,42280
167,158,9,-,152600,42285
495,360,135,766,158200,42286
18528,11574,6954,824,144500,42301
16483,10879,5604,853,145800,42303
3341,2341,1000,732,94100,42320
160,160,0,-,81900,42321
51,51,0,-,-,42322
242,166,76,792,-,42323
413,371,42,494,91900,42324
647,482,165,616,84300,42325
101,82,19,-,126400,42326
1595,1278,317,577,126800,42327
435,364,71,789,84800,42328
3501,2869,632,584,109700,42330
83,55,28,-,39800,42332
332,252,80,675,66800,42333
614,515,99,927,73600,42337
21,21,0,-,-,42338
312,287,25,464,108000,42339
532,426,106,675,99600,42343
325,296,29,-,72700,42344
4513,3560,953,665,118900,42345
2244,1708,536,672,103600,42347
1911,1594,317,677,122100,42348
564,454,110,671,84800,42349
550,473,77,806,139500,42350
1716,1321,395,724,113500,42351
756,548,208,356,89100,42352
87,70,17,617,88800,42354
570,463,107,673,113600,42355
0,0,0,-,-,42356
233,223,10,-,88000,42361
1969,1839,130,807,190300,42366
307,286,21,707,89700,42367
438,424,14,-,113000,42368
103,96,7,-,71400,42369
37,37,0,-,-,42370
127,119,8,-,233600,42371
671,566,105,566,86800,42372
58,50,8,-,-,42374
2336,2063,273,811,143500,42376
1245,1120,125,752,153800,42378
842,697,145,525,69400,42404
979,790,189,756,164700,42406
2579,1922,657,563,65400,42408
814,643,171,574,105100,42409
403,274,129,741,58100,42410
743,652,91,676,82200,42411
1095,962,133,877,158000,42413
15524,9357,6167,697,134400,42420
10884,6769,4115,787,128700,42431
576,412,164,-,116300,42436
2629,1731,898,663,98900,42437
430,327,103,672,75600,42440
579,446,133,523,96900,42441
1194,935,259,699,106800,42442
0,0,0,-,-,42444
4370,3117,1253,625,96400,42445
1636,1209,427,565,63100,42450
222,171,51,-,65400,42451
861,757,104,804,149600,42452
211,168,43,718,67500,42453
1042,649,393,758,82800,42455
641,540,101,844,122000,42456
546,546,0,-,142700,42458
1514,1141,373,548,88100,42459
528,350,178,734,62100,42461
421,404,17,933,116300,42462
75,63,12,-,61000,42463
683,610,73,392,82100,42464
6471,4057,2414,643,102300,42501
10033,6928,3105,765,153700,42503
221,213,8,-,-,42516
1062,803,259,838,103300,42518
1187,932,255,747,83600,42519
654,548,106,676,69000,42528
351,194,157,722,106600,42533
3710,2692,1018,544,113800,42539
112,97,15,-,108700,42541
2412,2064,348,662,129400,42544
2197,1774,423,778,116200,42553
239,195,44,622,-,42565
107,96,11,-,152400,42566
2159,1739,420,859,87300,42567
3754,2745,1009,522,77700,42602
194,163,31,497,49600,42603
2237,1698,539,464,142400,42629
54,0,54,-,-,42631
7333,5239,2094,592,99600,42633
564,508,56,465,47800,42634
1615,905,710,493,92300,42635
46,46,0,-,-,42638
4726,3305,1421,600,97500,42642
1225,870,355,674,60900,42647
634,560,74,602,85300,42649
1380,934,446,580,90500,42653
21283,13107,8176,833,183200,42701
648,527,121,680,78400,42712
761,543,218,558,86700,42713
91,79,12,-,156300,42715
669,522,147,-,160800,42716
2448,1796,652,485,109300,42717
9837,6548,3289,671,130500,42718
1277,1017,260,605,110500,42721
198,173,25,-,159400,42722
1875,1642,233,722,147000,42724
1791,1419,372,615,144300,42726
6078,4555,1523,669,110400,42728
577,508,69,596,119500,42729
673,478,195,933,92100,42732
589,402,187,574,122700,42733
961,642,319,730,147700,42740
121,104,17,-,128900,42741
31,31,0,-,-,42742
3558,2474,1084,542,84000,42743
747,608,139,487,87300,42746
3444,2680,764,739,135200,42748
2070,1491,579,636,89500,42749
304,265,39,689,105100,42753
5816,4177,1639,607,127600,42754
1263,1002,261,681,98400,42757
12,12,0,-,-,42758
6,6,0,-,-,42759
41,26,15,-,-,42762
176,140,36,-,161200,42764
2278,1607,671,610,108700,42765
768,654,114,869,151100,42776
289,256,33,427,69600,42782
1044,798,246,722,111900,42784
140,124,16,-,183500,42788
1072,999,73,1196,277400,43001
319,227,92,-,305400,43002
1095,822,273,886,162400,43003
10941,8821,2120,1147,227800,43004
168,112,56,-,-,43005
156,103,53,779,112500,43006
31,23,8,-,-,43007
1036,727,309,748,120400,43008
680,576,104,930,189600,43009
102,89,13,870,114700,43010
2485,2151,334,702,236300,43011
521,441,80,1097,289900,43013
1194,881,313,712,166200,43014
21467,15122,6345,1042,240800,43015
18509,10393,8116,1299,325200,43016
15888,10497,5391,1325,391500,43017
25,25,0,-,128400,43018
3392,2856,536,912,165300,43019
4392,4100,292,1149,423200,43021
929,590,339,1009,232700,43022
4485,3835,650,1014,350000,43023
2059,1563,496,738,209000,43025
24574,16980,7594,1202,258300,43026
54,0,54,-,-,43027
2802,2405,397,1125,173700,43028
135,83,52,-,225000,43029
104,104,0,-,-,43030
5125,3988,1137,1008,271900,43031
0,0,0,-,-,43032
192,148,44,738,125000,43033
11235,8597,2638,1305,344700,43035
146,81,65,800,108500,43036
62,28,34,963,-,43037
12645,9792,2853,1052,222500,43040
1967,1439,528,812,158400,43044
641,564,77,996,174300,43045
1463,1153,310,993,230500,43046
9,9,0,-,-,43047
12151,8123,4028,810,159400,43050
10624,7045,3579,1485,385700,43054
24398,14845,9553,830,150200,43055
6957,5577,1380,957,169800,43056
1050,767,283,847,149300,43060
1601,1543,58,875,324400,43061
11281,9108,2173,1139,222600,43062
5711,4822,889,1165,343400,43064
15864,14313,1551,1193,364200,43065
465,432,33,1044,268900,43066
439,406,33,-,193200,43067
23078,13383,9695,1051,174000,43068
32,32,0,-,-,43070
790,720,70,825,187100,43071
2312,1819,493,735,145500,43072
5485,4500,985,1334,303600,43074
3331,2914,417,907,231800,43076
61,47,14,1075,143800,43077
8360,6110,2250,770,141000,43078
1604,984,620,868,173500,43080
26339,16659,9680,1224,234900,43081
11822,10321,1501,1421,350100,43082
227,195,32,863,172200,43084
10399,7452,2947,1186,293900,43085
147,68,79,747,93300,43101
1577,1302,275,840,184900,43102
4076,3038,1038,848,194100,43103
3225,2587,638,699,237700,43105
614,414,200,838,84200,43106
1301,1061,240,736,164100,43107
81,33,48,951,187500,43109
15795,9255,6540,1089,194800,43110
41,41,0,-,-,43111
1613,1438,175,955,248300,43112
9721,6426,3295,850,174600,43113
538,381,157,1060,108200,43115
783,740,43,1280,256900,43116
29,5,24,-,-,43117
10988,8580,2408,1122,182600,43119
26411,19367,7044,1126,195800,43123
5496,3260,2236,1080,170700,43125
152,106,46,950,159300,43126
110,71,39,-,73500,43127
906,553,353,688,109500,43128
23921,16396,7525,902,167600,43130
1743,1521,222,548,153800,43135
798,677,121,969,229900,43136
929,800,129,948,159500,43137
7426,5495,1931,700,139700,43138
7806,5641,2165,819,171500,43140
60,36,24,700,91700,43142
2042,1419,623,860,180000,43143
181,124,57,658,67400,43144
815,617,198,843,152400,43145
3655,3230,425,749,241900,43146
14796,12719,2077,1375,250700,43147
689,519,170,646,129100,43148
1074,974,100,923,174000,43149
893,788,105,686,213200,43150
86,56,30,842,102900,43151
310,291,19,-,130100,43152
363,238,125,833,159500,43153
1247,1096,151,1011,186700,43154
982,779,203,587,180000,43155
83,70,13,625,111300,43156
193,129,64,947,122100,43157
132,89,43,935,-,43158
8956,5533,3423,722,122500,43160
2681,2128,553,936,160300,43162
824,588,236,877,135500,43164
14156,2448,11708,1151,317900,43201
9384,2936,6448,1029,260600,43202
4122,1264,2858,793,199000,43203
17589,9212,8377,994,131000,43204
5415,1896,3519,844,242500,43205
11090,5164,5926,1061,221000,43206
18992,11564,7428,953,111200,43207
12061,6967,5094,967,299700,43209
148,0,148,757,-,43210
8696,3309,5387,902,62400,43211
11970,4044,7926,1203,411600,43212
15582,6288,9294,930,148300,43213
12859,8215,4644,1044,308200,43214
10221,2134,8087,1342,373300,43215
738,91,647,987,38100,43217
0,0,0,-,-,43218
11826,5120,6706,1010,126900,43219
13230,6498,6732,1077,384800,43220
14627,10155,4472,1296,341800,43221
1657,425,1232,651,75000,43222
9103,4416,4687,899,86800,43223
18098,9076,9022,889,116500,43224
9985,4809,5176,944,94500,43227
22983,11015,11968,997,150200,43228
21939,8791,13148,926,156300,43229
24594,14566,10028,1177,220500,43230
8528,4416,4112,996,168200,43231
18943,7526,11417,907,110700,43232
19107,10449,8658,1233,269800,43235
3554,1008,2546,1321,221800,43240
19972,12884,7088,788,108700,43302
1142,990,152,917,139200,43310
8089,5485,2604,718,135700,43311
1173,872,301,714,152800,43314
2746,2030,716,864,140800,43315
2514,1741,773,731,129500,43316
60,40,20,958,116700,43317
1628,1359,269,917,160600,43318
406,378,28,-,259800,43319
516,467,49,1033,97500,43320
120,101,19,754,124600,43321
126,87,39,757,83800,43322
312,273,39,763,135900,43323
1074,934,140,870,206200,43324
24,9,15,-,-,43325
5297,3713,1584,685,119800,43326
32,20,12,563,75000,43330
2025,1685,340,843,118100,43331
677,539,138,581,106400,43332
285,261,24,-,123700,43333
2466,2088,378,867,209500,43334
0,0,0,-,-,43336
398,327,71,987,109600,43337
3757,2939,818,680,162300,43338
703,498,205,816,142100,43340
419,389,30,638,119300,43341
1275,1081,194,983,156000,43342
632,514,118,670,121300,43343
2260,1871,389,772,176600,43344
356,333,23,625,152000,43345
15,0,15,-,-,43346
474,405,69,878,121300,43347
1001,598,403,703,112100,43348
101,57,44,1046,78200,43350
4456,3152,1304,663,141000,43351
429,329,100,547,205400,43356
1672,1285,387,584,169500,43357
1006,800,206,933,149400,43358
251,172,79,653,163600,43359
676,551,125,853,205000,43360
14033,6012,8021,771,192900,43402
6,0,6,-,-,43403
698,574,124,586,116600,43406
207,194,13,768,156500,43407
104,94,10,-,109600,43408
3931,3061,870,708,126100,43410
1528,1368,160,949,170200,43412
384,326,58,923,103800,43413
93,93,0,-,-,43414
1242,991,251,593,150400,43416
12191,8266,3925,722,121500,43420
1934,1619,315,828,125900,43430
1762,1494,268,713,124500,43431
425,411,14,-,159400,43432
24,24,0,-,-,43433
37,30,7,850,82500,43434
405,326,79,646,145100,43435
0,0,0,-,-,43436
152,106,46,855,139300,43437
149,140,9,950,302800,43438
44,44,0,-,-,43439
2262,1917,345,795,215500,43440
356,296,60,627,120000,43442
699,566,133,787,156300,43443
462,425,37,-,147500,43445
43,41,2,-,171900,43446
1193,974,219,948,168500,43447
3481,2637,844,791,159400,43449
1466,950,516,985,202000,43450
458,316,142,728,145200,43451
6676,5188,1488,739,161900,43452
179,165,14,-,364600,43456
544,496,48,675,135100,43457
153,123,30,675,83400,43458
2580,1843,737,746,152800,43460
418,382,36,818,116000,43462
204,95,109,684,80900,43463
860,623,237,917,104000,43464
2292,1777,515,767,120400,43465
851,699,152,957,157700,43466
45,32,13,675,54000,43467
215,202,13,-,163100,43468
1170,907,263,549,156800,43469
319,284,35,-,101600,43501
2594,2121,473,678,158600,43502
393,345,48,-,203500,43504
30,18,12,-,118800,43505
6431,4810,1621,723,118300,43506
60,60,0,-,-,43510
418,362,56,-,196200,43511
11550,8747,2803,779,134400,43512
2970,2500,470,723,141700,43515
1036,804,232,846,112800,43516
1482,1181,301,703,105400,43517
1100,969,131,847,127800,43518
124,94,30,-,94900,43519
11,11,0,-,-,43520
1175,819,356,704,107800,43521
1391,1138,253,1028,175000,43522
28,28,0,-,-,43523
437,357,80,805,123500,43524
412,373,39,822,213700,43525
2035,1635,400,694,118000,43526
930,821,109,714,98900,43527
6602,4849,1753,947,212800,43528
95,72,23,929,70700,43529
0,0,0,-,-,43530
124,100,24,-,-,43531
1274,1046,228,814,160100,43532
569,439,130,766,152800,43533
669,549,120,693,128100,43534
239,196,43,850,134800,43535
104,104,0,-,128600,43536
12484,8662,3822,872,196900,43537
550,479,71,961,149900,43540
59,52,7,-,65000,43541
1491,1404,87,-,304700,43542
3267,2577,690,709,98200,43543
5890,4379,1511,796,148300,43545
143,126,17,-,185400,43547
314,293,21,631,136700,43548
529,510,19,713,130400,43549
17755,11851,5904,1049,227600,43551
185,155,30,585,134400,43553
875,613,262,800,117400,43554
117,67,50,-,140100,43555
603,504,99,634,124000,43556
960,776,184,822,116000,43557
5558,4811,747,862,149200,43558
12007,10085,1922,949,216100,43560
155,105,50,911,124600,43565
3475,3097,378,1472,221700,43566
4997,3863,1134,788,141100,43567
1088,834,254,721,133800,43569
1222,900,322,713,108400,43570
2725,2175,550,827,231300,43571
4949,878,4071,420,32700,43604
10059,4441,5618,781,39100,43605
9963,5403,4560,857,130200,43606
8968,4221,4747,794,62100,43607
5455,2733,2722,756,37800,43608
8468,3674,4794,817,51900,43609
1770,990,780,749,61700,43610
7705,5287,2418,714,95200,43611
11577,6148,5429,871,75900,43612
13404,8782,4622,828,102200,43613
13744,7878,5866,780,132300,43614
17948,9780,8168,873,105000,43615
8509,6451,2058,744,154900,43616
2973,2687,286,971,222700,43617
3063,2279,784,800,149700,43619
2290,752,1538,567,107400,43620
9027,5914,3113,813,142100,43623
22739,14747,7992,725,123500,43701
12,10,2,-,-,43711
2415,2016,399,427,119500,43713
833,625,208,669,108000,43716
60,50,10,-,62600,43717
1101,876,225,930,167200,43718
1021,819,202,629,127100,43719
454,445,9,-,123300,43720
89,51,38,-,-,43721
139,77,62,-,95900,43722
1911,1142,769,634,87400,43723
2737,1919,818,641,104800,43724
8414,5626,2788,709,131800,43725
575,525,50,-,124600,43727
501,441,60,778,111100,43728
842,682,160,715,124000,43730
1948,1488,460,664,87100,43731
605,530,75,606,96000,43732
12,12,0,-,-,43733
598,527,71,473,173500,43734
62,27,35,-,-,43735
12,12,0,-,134400,43736
51,47,4,-,83100,43738
810,766,44,892,215100,43739
94,65,29,-,102300,43740
312,276,36,-,150900,43746
522,412,110,718,156500,43747
1061,842,219,730,156600,43748
936,872,64,-,102000,43749
29,29,0,-,69300,43750
466,373,93,485,118300,43754
745,596,149,1014,124300,43755
2168,1569,599,651,100400,43756
1102,892,210,766,111100,43758
68,51,17,810,-,43759
558,361,197,-,96600,43760
45,45,0,-,-,43761
1721,1331,390,756,177500,43762
2867,1923,944,566,100200,43764
513,368,145,652,54400,43766
490,478,12,775,143300,43767
158,80,78,1098,115600,43768
871,644,227,702,113300,43771
743,557,186,690,110600,43772
1061,827,234,861,104800,43773
1940,1432,508,611,90400,43777
479,449,30,850,166600,43778
213,201,12,629,135800,43779
909,821,88,850,159100,43780
226,197,29,642,90300,43782
1898,1588,310,808,157000,43783
33,24,9,-,150000,43786
1152,916,236,712,102900,43787
324,303,21,775,142600,43788
62,52,10,-,-,43791
1956,1369,587,486,110000,43793
381,352,29,580,138900,43802
1064,744,320,731,162300,43804
95,49,46,-,-,43805
290,226,64,817,91300,43811
7767,5108,2659,621,98800,43812
1606,1236,370,779,140100,43821
1876,1552,324,666,126500,43822
1370,1238,132,658,172000,43824
2124,1773,351,739,173800,43830
3328,2445,883,752,99100,43832
59,54,5,-,80800,43836
728,635,93,870,101000,43837
399,372,27,750,132100,43840
107,107,0,-,62500,43842
401,349,52,623,163200,43843
1652,1462,190,809,119700,43844
1808,1362,446,660,96100,43845
800,617,183,735,105400,43901
58,43,15,-,84500,43902
778,620,158,835,115200,43903
173,148,25,-,178000,43905
3177,2306,871,670,100900,43906
2052,1515,537,593,101500,43907
455,354,101,698,103900,43908
25,7,18,-,-,43909
1428,1278,150,384,144600,43910
2696,1943,753,567,89500,43912
500,299,201,531,65000,43913
20,11,9,-,-,43914
548,492,56,623,103600,43915
1242,1086,156,723,96700,43917
9058,6148,2910,649,88600,43920
85,46,39,-,82800,43925
99,62,37,633,91300,43926
43,43,0,-,48700,43928
377,368,9,-,98400,43930
94,94,0,-,155400,43931
375,296,79,747,108700,43932
745,712,33,-,159100,43933
112,112,0,-,64800,43934
3431,2156,1275,721,84200,43935
2400,1778,622,722,83300,43938
130,115,15,696,105100,43939
145,125,20,-,-,43940
979,736,243,391,109900,43942
1346,1151,195,627,96600,43943
913,682,231,872,141900,43944
1177,889,288,721,110200,43945
840,658,182,798,122900,43946
2026,1624,402,739,116600,43947
245,205,40,844,68100,43948
5257,4108,1149,813,175100,43950
31,21,10,-,-,43951
6910,3704,3206,640,102400,43952
4876,3478,1398,765,119800,43953
129,99,30,663,53700,43961
32,20,12,707,80000,43962
615,354,261,667,89300,43963
3946,3141,805,627,104500,43964
51,51,0,-,103500,43967
2595,1919,676,565,84100,43968
470,301,169,572,90300,43971
71,71,0,-,84500,43972
833,712,121,673,140800,43973
35,31,4,-,81000,43974
612,477,135,818,99400,43976
809,582,227,767,91800,43977
117,95,22,475,92500,43981
149,92,57,-,-,43983
90,80,10,-,62000,43985
698,597,101,788,98900,43986
916,685,231,638,113500,43988
8316,7220,1096,841,173400,44001
1566,1199,367,613,90400,44003
13221,8468,4753,724,95800,44004
558,417,141,1825,174200,44010
9137,7902,1235,1312,319400,44011
10311,8410,1901,1211,275800,44012
6978,4874,2104,889,152300,44017
2046,1556,490,921,194400,44021
6846,6157,689,1216,395500,44022
7277,6631,646,2188,336100,44023
8896,7661,1235,886,262200,44024
4343,4048,295,756,258200,44026
3626,3348,278,1330,247800,44028
6020,4648,1372,676,108700,44030
404,392,12,-,154300,44032
26894,16519,10375,785,116800,44035
13297,11678,1619,936,201800,44039
1117,1052,65,2229,455800,44040
5974,3926,2048,739,136100,44041
4281,3713,568,865,186600,44044
289,252,37,750,119900,44045
732,593,139,824,189000,44046
3680,2736,944,818,154500,44047
831,682,149,624,118100,44048
76,58,18,650,111800,44049
2484,2137,347,973,189400,44050
11689,6019,5670,761,85000,44052
8495,5288,3207,765,152300,44053
5359,4253,1106,989,133500,44054
8108,4193,3915,770,74400,44055
4733,4276,457,1525,243300,44056
7599,6201,1398,943,142500,44057
25494,20676,4818,986,186600,44060
4275,3398,877,737,180400,44062
683,617,66,950,196900,44064
1648,1521,127,801,234300,44065
8392,7394,998,1084,195500,44067
84,60,24,-,81200,44068
13289,10199,3090,963,165800,44070
1999,1573,426,1164,268200,44072
3803,2452,1351,798,174900,44074
1784,1333,451,781,144000,44076
23080,16664,6416,872,178800,44077
92,74,18,-,108200,44080
2572,2301,271,810,196600,44081
622,496,126,1004,94900,44082
1465,1276,189,794,161300,44084
1270,1173,97,1239,142500,44085
887,831,56,839,197900,44086
9021,6892,2129,1135,236300,44087
6702,5295,1407,989,153900,44089
3977,3186,791,677,192000,44090
7594,4973,2621,952,136700,44092
465,335,130,704,159000,44093
16940,11000,5940,1015,203000,44094
14517,10934,3583,916,133000,44095
692,610,82,-,158000,44099
0,0,0,-,-,44101
19366,6235,13131,782,79700,44102
6921,2298,4623,587,47400,44103
8283,2153,6130,565,44700,44104
14859,6903,7956,780,51600,44105
10934,2999,7935,869,187600,44106
26319,11542,14777,857,185500,44107
9143,4168,4975,790,53300,44108
16769,8000,8769,761,89100,44109
9303,3529,5774,739,53900,44110
17718,9768,7950,815,97100,44111
8236,3297,4939,714,66100,44112
9718,2579,7139,1138,243400,44113
3847,330,3517,1166,64100,44114
4494,315,4179,697,111800,44115
9704,6892,2812,974,272100,44116
4932,1995,2937,753,103700,44117
16477,10131,6346,1058,163100,44118
6140,2982,3158,797,87000,44119
16790,7870,8920,799,91300,44120
13489,9185,4304,968,104400,44121
15039,9517,5522,1445,269700,44122
8530,3975,4555,918,81700,44123
18946,11812,7134,991,168100,44124
12080,7259,4821,967,82800,44125
7575,5276,2299,873,183400,44126
1882,794,1088,669,35600,44127
12606,6204,6402,869,68200,44128
11988,8441,3547,880,121500,44129
22822,14306,8516,906,146600,44130
8348,7643,705,1338,206400,44131
6749,2841,3908,883,84000,44132
13515,9655,3860,924,224100,44133
16107,12173,3934,1000,123600,44134
11349,6761,4588,741,92500,44135
10527,7658,2869,1076,216600,44136
10298,6149,4149,1084,75400,44137
9477,7430,2047,1129,182300,44138
8926,7536,1390,1229,315500,44139
6065,5640,425,1165,270200,44140
5509,4544,965,1593,309300,44141
7671,6100,1571,942,126700,44142
10996,7907,3089,856,208500,44143
9483,5335,4148,813,103500,44144
14446,10404,4042,1262,275300,44145
14260,7585,6675,879,110900,44146
8110,6741,1369,988,242100,44147
8330,7791,539,1075,241500,44149
2513,2133,380,989,170600,44201
8485,7154,1331,1476,293700,44202
16455,11273,5182,780,117900,44203
18167,13865,4302,970,197700,44212
749,660,89,633,183700,44214
929,768,161,961,165900,44215
3577,3251,326,853,166900,44216
1358,1194,164,728,140500,44217
13659,7773,5886,909,128100,44221
8395,6339,2056,851,160100,44223
16150,10992,5158,1029,203900,44224
3524,2971,553,807,162400,44230
3124,2494,630,811,169600,44231
0,0,0,-,-,44232
2910,2829,81,829,344300,44233
1259,1081,178,810,192900,44234
538,466,72,845,229300,44235
9612,8541,1071,2112,364100,44236
16928,8850,8078,860,170600,44240
7225,4994,2231,1147,145500,44241
0,0,0,-,-,44243
586,485,101,751,87800,44250
400,361,39,1315,265600,44251
1257,1188,69,-,226000,44253
1961,1455,506,748,152900,44254
2847,2314,533,891,155100,44255
25207,20581,4626,1043,236200,44256
5126,4423,703,926,157000,44260
2142,1716,426,848,168700,44262
1200,1033,167,1016,291900,44264
13723,9531,4192,876,131900,44266
3281,2329,952,706,140500,44270
2184,1835,349,901,185200,44272
2819,2325,494,801,206200,44273
97,43,54,-,-,44274
1120,990,130,954,187800,44275
624,540,84,728,179700,44276
7384,6195,1189,909,183100,44278
2019,1735,284,1616,294700,44280
13504,9987,3517,914,209800,44281
45,41,4,-,179700,44285
2584,2454,130,1173,294200,44286
2896,2483,413,860,139700,44287
1214,863,351,902,123300,44288
5811,3455,2356,901,80200,44301
2575,1140,1435,667,90000,44302
3659,1847,1812,803,171700,44303
1296,111,1185,838,67500,44304
9193,5129,4064,886,76100,44305
8986,3930,5056,820,66400,44306
2844,915,1929,774,60200,44307
443,16,427,545,320000,44308
10167,3932,6235,797,74800,44310
2826,429,2397,682,42900,44311
13474,10165,3309,874,114200,44312
12603,7314,5289,894,169600,44313
8104,4268,3836,789,67400,44314
9589,6953,2636,965,158100,44319
8817,4813,4004,790,80900,44320
6467,5025,1442,1198,259100,44321
0,0,0,-,-,44325
7786,6530,1256,1009,265700,44333
958,871,87,492,206300,44401
1104,960,144,664,131600,44402
1805,1593,212,662,123700,44403
603,557,46,588,131700,44404
3289,2105,1184,706,67300,44405
8888,7831,1057,743,215000,44406
4652,3362,1290,617,162700,44408
7471,5958,1513,687,151300,44410
798,755,43,1007,134700,44411
979,877,102,740,189400,44412
2871,2160,711,724,95000,44413
0,0,0,-,-,44415
608,564,44,714,115400,44417
483,474,9,-,121600,44418
6354,4518,1836,682,91200,44420
884,696,188,849,142900,44423
24,10,14,-,-,44424
5826,4687,1139,718,110800,44425
545,460,85,756,86200,44427
1314,1053,261,674,123800,44428
1135,892,243,810,130800,44429
1371,1086,285,639,98200,44430
1859,1616,243,756,111100,44431
4173,3030,1143,695,108200,44432
1488,1288,200,590,115900,44436
1740,1465,275,775,110300,44437
2358,1585,773,771,62800,44438
137,111,26,-,193800,44439
1887,1578,309,667,129200,44440
755,734,21,-,126300,44441
1622,1472,150,587,154100,44442
736,662,74,740,182300,44443
4253,2972,1281,654,106900,44444
1226,982,244,792,119700,44445
9223,5430,3793,726,88200,44446
622,513,109,-,148900,44449
651,537,114,766,159800,44450
1205,970,235,659,174700,44451
1403,1205,198,-,189400,44452
286,263,23,-,158200,44454
527,476,51,851,120900,44455
10505,7729,2776,690,121600,44460
1595,1418,177,564,132300,44470
4344,3067,1277,761,76300,44471
1736,1343,393,868,153200,44473
3729,3196,533,628,151500,44481
11003,6764,4239,745,84500,44483
9094,6645,2449,781,133700,44484
6946,3576,3370,694,59600,44485
351,199,152,710,78100,44490
1115,1036,79,745,167700,44491
54,32,22,-,-,44493
3488,1853,1635,781,31900,44502
516,0,516,360,-,44503
2003,843,1160,646,67800,44504
6788,3641,3147,577,72700,44505
1287,694,593,566,14400,44506
1876,870,1006,684,18600,44507
5114,2978,2136,684,47700,44509
865,432,433,406,42100,44510
8880,6657,2223,679,89000,44511
14304,9376,4928,732,125200,44512
9504,7878,1626,870,158100,44514
12574,8112,4462,736,112500,44515
0,0,0,-,-,44555
13481,8108,5373,728,119100,44601
2478,1977,501,638,209700,44606
13,13,0,-,-,44607
865,546,319,983,107700,44608
1488,1304,184,646,127900,44609
95,39,56,-,277900,44610
907,788,119,507,163000,44611
2233,1571,662,750,191500,44612
739,524,215,809,109500,44613
5479,4403,1076,869,172100,44614
4135,3300,835,694,143200,44615
2534,1944,590,715,186400,44618
94,94,0,-,-,44619
761,645,116,776,156700,44620
1714,1123,591,776,96300,44621
7281,5014,2267,903,158900,44622
1675,1448,227,541,223000,44624
467,353,114,845,196600,44625
1181,1014,167,868,133300,44626
1759,1485,274,570,319400,44627
415,312,103,720,150000,44628
1048,780,268,794,126500,44629
34,34,0,-,-,44630
3785,3020,765,855,216500,44632
689,548,141,679,200000,44633
863,676,187,698,121200,44634
933,718,215,737,137500,44637
421,288,133,620,162700,44638
116,101,15,764,65500,44639
75,60,15,838,72400,44640
7916,5971,1945,775,160800,44641
1455,1167,288,770,130700,44643
2193,1442,751,673,150200,44644
1075,925,150,990,199300,44645
19606,13088,6518,770,144500,44646
7885,5820,2065,841,113500,44647
323,276,47,-,151900,44651
191,134,57,714,208100,44652
257,216,41,925,84700,44653
6191,4664,1527,694,245300,44654
1049,833,216,648,162900,44656
4116,2821,1295,717,128600,44657
56,43,13,596,137500,44659
42,34,8,-,-,44660
108,88,20,-,81400,44661
3931,3218,713,718,146400,44662
11177,7412,3765,791,149900,44663
82,59,23,-,109800,44665
1049,927,122,793,152200,44666
5040,3593,1447,751,156600,44667
587,448,139,740,161600,44669
23,23,0,-,84500,44670
39,39,0,-,-,44671
2168,1083,1085,844,85900,44672
837,635,202,1106,127300,44675
1854,1495,359,738,158300,44676
1000,792,208,839,156300,44677
89,59,30,-,108900,44678
1799,1317,482,732,165100,44680
2664,2041,623,773,263700,44681
469,318,151,764,124700,44682
3039,1947,1092,728,85400,44683
10888,9097,1791,1051,207900,44685
127,66,61,1478,315200,44687
1253,946,307,768,122400,44688
157,95,62,823,96300,44689
52,44,8,-,163400,44690
18109,12583,5526,798,167600,44691
11,7,4,-,-,44693
447,373,74,456,110100,44695
125,122,3,-,325400,44697
298,239,59,-,150200,44699
534,5,529,317,-,44702
3668,1388,2280,741,63400,44703
1428,682,746,745,65700,44704
7239,3865,3374,770,67900,44705
7044,5198,1846,796,110200,44706
3555,1705,1850,535,91400,44707
10803,7425,3378,862,129500,44708
8648,4984,3664,755,123500,44709
3415,1731,1684,816,75300,44710
4234,2612,1622,779,112500,44714
5715,3886,1829,790,231900,44718
16856,12067,4789,874,190400,44720
5366,4726,640,769,176300,44721
2532,1988,544,793,119000,44730
365,342,23,910,136400,44802
536,514,22,925,163400,44804
12550,8762,3788,741,135100,44805
885,734,151,639,101200,44807
69,19,50,-,-,44809
5281,3869,1412,730,123200,44811
2918,2328,590,624,170700,44813
869,701,168,942,178500,44814
292,238,54,734,83300,44815
544,485,59,881,158900,44817
885,741,144,658,109300,44818
7500,5267,2233,684,106300,44820
1111,822,289,831,164400,44822
1417,1179,238,679,156500,44824
71,58,13,765,72000,44825
585,521,64,-,126000,44826
3046,2318,728,592,100200,44827
60,19,41,1053,-,44828
7283,5331,1952,696,90200,44830
7131,4577,2554,738,102000,44833
945,829,116,902,115200,44836
1440,1130,310,724,122100,44837
88,68,20,758,110400,44838
5642,4364,1278,809,194100,44839
1142,990,152,851,168200,44840
268,229,39,688,72900,44841
2116,1607,509,625,150600,44842
1114,994,120,692,173200,44843
270,261,9,-,152100,44844
1312,1108,204,889,168700,44846
1444,1173,271,861,137800,44847
881,746,135,736,110300,44849
9,0,9,-,-,44850
2088,1599,489,721,126500,44851
547,456,91,488,160700,44853
672,506,166,795,100400,44854
449,391,58,847,136100,44855
92,83,9,685,103700,44856
9916,6853,3063,733,147300,44857
849,849,0,-,165200,44859
71,51,20,-,64500,44861
1255,1020,235,815,112600,44864
1142,863,279,783,119900,44865
775,731,44,900,172500,44866
980,723,257,906,133100,44867
17030,10325,6705,799,118200,44870
124,94,30,658,92000,44874
5549,3898,1651,649,125400,44875
944,726,218,833,156700,44878
1027,978,49,-,206400,44880
27,19,8,-,153400,44881
1093,892,201,720,115200,44882
11548,7953,3595,732,122600,44883
316,284,32,681,73300,44887
2774,2329,445,808,184700,44889
4062,2808,1254,755,112300,44890
0,0,0,-,-,44901
1939,618,1321,702,52900,44902
9636,6909,2727,723,146100,44903
6158,4553,1605,697,155400,44904
5175,3914,1261,737,89500,44905
7624,4555,3069,689,104500,44906
7148,3780,3368,676,101600,44907
304,121,183,730,97100,45001
4945,3873,1072,903,226400,45002
211,153,58,777,143200,45003
12328,8944,3384,888,154700,45005
25726,18916,6810,900,211500,45011
20307,14644,5663,881,165800,45013
18753,11766,6987,1030,170100,45014
4892,2848,2044,1014,94000,45015
8443,6815,1628,989,186800,45030
267,184,83,885,128800,45032
177,149,28,-,53600,45033
427,379,48,-,240600,45034
13068,9356,3712,943,248700,45036
10825,9390,1435,1379,246100,45039
20573,15736,4837,1514,320700,45040
130,130,0,-,-,45041
11315,7768,3547,905,153700,45042
19913,12760,7153,868,181300,45044
4406,3413,993,1159,208300,45050
47,0,47,846,-,45051
1644,1453,191,927,227700,45052
1120,1079,41,-,260900,45053
1079,995,84,-,250200,45054
49,40,9,-,-,45055
8413,4109,4304,899,218700,45056
277,250,27,875,118100,45062
1231,1094,137,-,183200,45064
2133,1804,329,1299,182500,45065
9194,8128,1066,1323,275000,45066
4897,3627,1270,1144,151300,45067
4475,3619,856,1063,274300,45068
20251,15977,4274,1393,255000,45069
54,35,19,1057,53500,45070
798,473,325,525,108400,45101
9190,6335,2855,774,168200,45102
13761,9434,4327,900,186600,45103
62,0,62,-,-,45105
4444,3440,1004,708,160000,45106
3645,2552,1093,778,152100,45107
143,138,5,-,229200,45111
13,11,2,-,131300,45112
1573,1400,173,855,226500,45113
121,80,41,-,85800,45115
1384,1184,200,1006,177600,45118
0,0,0,-,-,45119
1067,668,399,667,136000,45120
3591,2480,1111,655,114800,45121
4157,3526,631,1055,162800,45122
3298,2166,1132,674,111500,45123
1469,1197,272,843,136800,45130
97,53,44,845,86500,45131
106,59,47,610,83000,45132
9078,6295,2783,706,135600,45133
1975,1510,465,733,142300,45135
21116,16437,4679,1177,266300,45140
1518,1278,240,784,142400,45142
1517,1150,367,599,83800,45144
425,325,100,908,116900,45146
82,58,24,-,75600,45147
662,505,157,925,154800,45148
13560,10247,3313,925,209100,45150
4405,3905,500,976,248000,45152
761,684,77,996,138100,45153
3109,2184,925,738,147100,45154
150,115,35,699,66300,45155
18,18,0,-,-,45156
3821,3193,628,735,211000,45157
297,232,65,795,153700,45158
1454,1090,364,831,121900,45159
316,70,246,-,146400,45160
992,861,131,975,191000,45162
108,85,23,805,82000,45164
42,0,42,-,-,45166
1415,975,440,623,148800,45167
545,433,112,867,122000,45168
1750,1290,460,664,103200,45169
2144,1764,380,869,152300,45171
92,85,7,-,132900,45172
655,632,23,1594,530300,45174
3990,2759,1231,839,154600,45176
9002,6098,2904,806,166200,45177
8867,2125,6742,1286,385800,45202
1293,400,893,539,246600,45203
2705,1123,1582,664,76900,45204
7080,2557,4523,721,76300,45205
6149,2179,3970,772,235000,45206
2435,1171,1264,782,98500,45207
8426,5501,2925,1222,434700,45208
6078,2319,3759,1046,295300,45209
15479,7848,7631,774,121500,45211
9756,4245,5511,803,165100,45212
5554,3309,2245,800,215100,45213
4170,920,3250,657,73300,45214
12854,7200,5654,865,154500,45215
3612,1760,1852,878,87100,45216
2676,1654,1022,839,122600,45217
1503,1060,443,929,134400,45218
6761,1148,5613,972,177400,45219
6570,1918,4652,822,297700,45220
5652,2390,3262,811,169400,45223
9411,5555,3856,752,128900,45224
4143,499,3644,551,63200,45225
3036,1844,1192,1022,374300,45226
8712,4747,3965,1043,179200,45227
6547,2045,4502,721,203500,45229
11536,8514,3022,846,188900,45230
16877,11971,4906,984,125400,45231
3166,662,2504,449,89700,45232
5583,4591,992,869,218200,45233
11371,7233,4138,916,168200,45236
9739,4795,4944,815,119400,45237
19751,11411,8340,787,135200,45238
11945,7217,4728,841,126000,45239
10596,6302,4294,1076,136300,45240
9900,7403,2497,1037,239400,45241
8862,6860,2002,1523,344500,45242
6167,5577,590,1544,504000,45243
10376,8489,1887,908,284800,45244
8602,5408,3194,994,190800,45245
5705,3117,2588,1121,149800,45246
9311,7522,1789,918,226600,45247
9420,8213,1207,975,162100,45248
5541,3609,1932,1292,389200,45249
8113,6118,1995,1072,137600,45251
1981,1843,138,985,224200,45252
9229,6096,3133,1101,232400,45255
0,0,0,-,-,45267
78,78,0,-,126200,45301
1545,1270,275,983,179500,45302
906,660,246,650,93800,45303
2720,2144,576,763,149400,45304
4497,3501,996,1030,250800,45305
827,640,187,749,167100,45306
115,64,51,691,87500,45307
1627,1231,396,808,127900,45308
4710,3587,1123,850,164100,45309
83,76,7,-,157700,45310
2360,1837,523,681,148100,45311
424,372,52,825,165500,45312
1275,938,337,747,232700,45314
1768,1496,272,851,153200,45315
50,34,16,779,150000,45316
402,338,64,-,169400,45317
2181,1689,492,678,152500,45318
115,91,24,675,111700,45319
6501,4928,1573,746,143700,45320
430,356,74,911,115100,45321
9164,6751,2413,901,134900,45322
2150,1778,372,698,147200,45323
17681,8930,8751,877,140600,45324
1024,965,59,954,187700,45325
491,407,84,686,124100,45326
3537,3039,498,741,156100,45327
177,108,69,917,82300,45328
340,262,78,944,101900,45330
9630,6346,3284,645,127100,45331
241,195,46,496,92800,45332
482,380,102,777,162200,45333
862,553,309,665,138300,45334
2833,2269,564,711,150900,45335
34,30,4,-,110700,45336
666,568,98,741,177400,45337
1929,1458,471,782,144400,45338
470,379,91,809,156900,45339
139,135,4,-,140400,45340
1672,1340,332,822,84100,45341
14681,8962,5719,1052,161700,45342
6559,5103,1456,750,129500,45344
2571,1984,587,763,118800,45345
918,647,271,803,116900,45346
1735,1348,387,670,114700,45347
250,208,42,921,163200,45348
117,90,27,1323,99300,45349
22,21,1,-,112500,45350
117,96,21,705,177300,45351
91,58,33,667,53300,45352
60,54,6,-,-,45353
267,192,75,1314,103600,45354
10502,7014,3488,823,111300,45356
126,103,23,763,128800,45358
694,545,149,655,146000,45359
202,158,44,767,66700,45360
104,75,29,1161,104600,45361
501,432,69,619,189000,45362
600,514,86,834,207100,45363
11557,7656,3901,783,140800,45365
1782,1235,547,632,131700,45368
1638,1427,211,842,171200,45369
1044,912,132,842,295800,45370
8898,6719,2179,951,207500,45371
132,85,47,814,99400,45372
14377,10308,4069,822,179400,45373
6287,3942,2345,744,150500,45377
200,178,22,825,90400,45378
2257,1777,480,617,175100,45380
2308,1890,418,803,160400,45381
412,329,83,893,117000,45382
2724,1975,749,768,122200,45383
240,210,30,-,149300,45384
15670,10903,4767,808,158700,45385
2586,1865,721,811,261700,45387
221,198,23,-,252300,45388
203,160,43,746,84200,45389
1193,829,364,669,85300,45390
4544,1622,2922,789,89100,45402
6118,2228,3890,644,61100,45403
3901,1621,2280,810,59800,45404
8890,2960,5930,724,62000,45405
8855,4266,4589,783,63200,45406
2902,1998,904,1063,173000,45409
7020,3151,3869,834,73800,45410
9517,6177,3340,794,130500,45414
5770,3810,1960,821,135700,45415
1930,1286,644,1079,70800,45416
11451,6277,5174,752,55500,45417
7010,4776,2234,806,188600,45419
11579,6839,4740,816,90900,45420
0,0,0,-,-,45423
20219,15323,4896,956,135900,45424
6566,3376,3190,795,87700,45426
0,0,0,-,-,45428
12085,8449,3636,898,173500,45429
2976,2377,599,1056,195500,45430
11912,6476,5436,1148,156800,45431
6313,4664,1649,867,151100,45432
402,4,398,1242,-,45433
4569,4287,282,1083,249200,45434
0,0,0,-,-,45435
4638,2449,2189,864,92200,45439
9355,5964,3391,950,197500,45440
8478,5286,3192,911,120300,45449
14502,10954,3548,1077,264500,45458
12712,8948,3764,1025,223800,45459
5,0,5,-,-,45469
0,0,0,-,-,45501
6886,6073,813,799,179100,45502
14121,8512,5609,778,124300,45503
6127,4347,1780,788,136900,45504
7960,3941,4019,719,74000,45505
5593,3305,2288,690,81300,45506
21554,14935,6619,787,134600,45601
1791,1442,349,583,117100,45612
1217,945,272,757,144700,45613
1564,1316,248,722,101700,45614
657,527,130,600,151300,45616
0,0,0,-,-,45617
0,0,0,-,-,45618
2904,2211,693,858,125500,45619
277,226,51,692,156700,45620
179,127,52,592,46000,45621
114,114,0,-,-,45622
1175,1033,142,885,104200,45623
0,0,0,-,-,45624
2097,1673,424,809,133100,45628
1013,818,195,879,112200,45629
164,114,50,825,18200,45630
5976,4262,1714,719,128200,45631
726,541,185,644,82800,45634
87,44,43,1231,139300,45636
7954,5422,2532,730,93900,45638
6026,4364,1662,738,132600,45640
0,0,0,-,-,45642
1968,1252,716,741,163400,45644
1085,945,140,833,59900,45645
159,159,0,-,93400,45646
1132,957,175,601,161900,45647
3994,3144,850,724,121100,45648
159,146,13,-,77700,45650
1937,1250,687,646,97400,45651
1404,1195,209,730,103900,45652
1255,932,323,602,130500,45653
407,324,83,1009,125600,45654
2540,2088,452,667,90400,45656
691,555,136,557,74000,45657
881,813,68,632,111900,45658
959,802,157,921,80700,45659
2797,1960,837,647,122200,45660
2505,1557,948,751,101500,45661
11002,5703,5299,651,79300,45662
2684,1961,723,632,84900,45663
3984,3191,793,794,149400,45669
102,97,5,575,-,45671
487,487,0,-,67500,45672
144,68,76,-,111800,45673
189,89,100,683,162500,45674
20,20,0,-,-,45677
446,257,189,917,93200,45678
1061,774,287,714,126400,45679
4684,2971,1713,702,121900,45680
627,500,127,545,145100,45681
936,745,191,754,119400,45682
714,623,91,842,94300,45684
398,295,103,723,99600,45685
1330,1015,315,729,129400,45686
149,106,43,650,-,45688
5597,3644,1953,804,121700,45690
3283,2401,882,532,101000,45692
3194,2298,896,550,125000,45693
4667,3626,1041,772,173500,45694
301,215,86,840,78100,45695
462,373,89,-,106100,45696
2048,1650,398,630,151700,45697
182,180,2,-,108900,45698
0,0,0,-,-,45699
11093,5640,5453,890,191200,45701
2178,1670,508,723,142500,45710
412,341,71,888,155000,45711
4078,2854,1224,779,137600,45714
956,631,325,593,131100,45715
181,135,46,738,89200,45716
332,178,154,778,62200,45719
0,0,0,-,-,45720
12,12,0,-,-,45721
1454,1226,228,645,118800,45723
979,790,189,1005,116900,45724
241,223,18,385,101300,45727
680,677,3,-,162200,45729
1732,1294,438,639,71400,45732
159,127,32,-,-,45734
653,605,48,-,138600,45735
13,13,0,-,-,45739
146,111,35,771,64000,45740
217,217,0,-,83300,45741
1196,1099,97,1075,145500,45742
472,407,65,626,123400,45743
955,855,100,738,147600,45744
510,352,158,962,72500,45745
102,67,35,911,53900,45746
11087,7653,3434,718,150000,45750
1494,1106,388,606,72900,45760
737,555,182,713,94600,45761
2630,1533,1097,751,95800,45764
471,343,128,535,110800,45766
956,650,306,510,135300,45767
626,521,105,-,179900,45768
2246,1676,570,675,108900,45769
349,277,72,-,72900,45770
1455,1040,415,641,112000,45771
537,407,130,512,119900,45772
44,44,0,-,304300,45773
700,683,17,913,105500,45775
331,294,37,523,159100,45776
329,203,126,1141,100800,45778
342,271,71,504,110500,45779
1535,824,711,793,174400,45780
125,72,53,688,25000,45782
114,58,56,-,-,45783
1404,1137,267,561,158900,45784
1123,1006,117,851,160800,45786
290,255,35,549,156300,45788
61,56,5,-,-,45789
8464,4600,3864,724,81000,45801
6175,3396,2779,723,68100,45804
9538,6011,3527,824,124300,45805
4440,3574,866,794,150100,45806
4747,3738,1009,841,164900,45807
153,124,29,870,84700,45808
32,25,7,-,88900,45809
2428,1557,871,772,129300,45810
727,554,173,587,96600,45812
1352,1119,233,654,117400,45813
1069,872,197,636,164000,45814
29,27,2,-,35600,45815
197,170,27,545,94200,45816
2468,2027,441,761,165400,45817
106,68,38,925,83500,45819
231,190,41,679,93300,45820
348,315,33,1271,94700,45821
8059,5908,2151,725,155300,45822
120,100,20,675,200000,45826
822,797,25,596,154900,45827
2328,1970,358,593,191100,45828
2081,1834,247,751,137300,45830
1388,1227,161,661,134200,45831
1188,971,217,716,119300,45832
4431,3335,1096,759,126600,45833
207,194,13,-,88800,45835
607,507,100,675,99800,45836
45,43,2,-,87100,45838
22985,14781,8204,799,162200,45840
419,332,87,731,157300,45841
1440,1149,291,763,106800,45843
1130,991,139,690,183200,45844
1159,1021,138,676,242500,45845
1529,1387,142,568,205300,45846
45,42,3,-,204800,45848
348,279,69,888,83600,45849
1239,1104,135,657,154300,45850
233,191,42,695,122200,45851
597,468,129,820,171300,45853
153,94,59,894,95500,45854
54,41,13,1078,98800,45855
1885,1555,330,888,136000,45856
1042,794,248,699,137900,45858
208,178,30,769,49400,45859
833,629,204,644,261000,45860
139,126,13,-,70000,45861
661,571,90,619,97200,45862
513,467,46,722,99600,45863
70,66,4,-,103800,45864
2077,1770,307,738,227600,45865
58,45,13,695,101400,45866
448,393,55,784,144800,45867
273,239,34,956,152000,45868
1773,1549,224,659,181100,45869
108,108,0,-,110200,45870
711,531,180,804,157100,45871
1782,1251,531,749,106000,45872
873,669,204,530,128800,45873
941,841,100,787,94600,45874
4056,3437,619,733,178600,45875
413,350,63,839,174000,45876
977,758,219,784,144300,45877
2506,1910,596,644,102000,45879
1013,842,171,770,113000,45880
664,585,79,954,116400,45881
1023,869,154,523,119300,45882
1144,1030,114,678,260200,45883
49,39,10,-,109800,45884
5457,4144,1313,809,135300,45885
232,182,50,767,114500,45886
1748,1305,443,667,147700,45887
156,128,28,-,77400,45888
569,544,25,1048,171900,45889
343,270,73,741,119400,45890
6183,4558,1625,701,115300,45891
126,116,10,-,88400,45893
281,254,27,813,155100,45894
7410,5440,1970,749,145100,45895
749,573,176,619,113400,45896
25,25,0,-,-,45897
355,302,53,721,80000,45898
79,65,14,-,64600,45899
4011,3108,903,794,100300,46001
6935,5537,1398,968,127600,46011
8579,5767,2812,908,116100,46012
7881,4993,2888,779,94200,46013
6816,2746,4070,755,54200,46016
2413,1852,561,873,107100,46017
1122,855,267,853,173900,46030
727,573,154,960,135700,46031
19911,13401,6510,1306,371400,46032
14444,12502,1942,1463,382800,46033
2854,2276,578,1089,228800,46034
437,369,68,867,126800,46035
4479,3205,1274,757,83400,46036
16129,13238,2891,1358,336100,46037
16229,11450,4779,1382,239100,46038
233,206,27,-,96200,46039
5446,4704,742,1209,322900,46040
8704,5997,2707,770,122600,46041
1157,950,207,769,119000,46044
19,19,0,-,-,46045
18,0,18,-,-,46047
785,645,140,1149,111000,46048
469,416,53,488,127600,46049
739,590,149,819,148600,46050
1191,907,284,865,138400,46051
9452,7020,2432,832,162100,46052
5249,4568,681,1257,258700,46055
859,764,95,988,168500,46056
421,330,91,745,189000,46057
760,660,100,977,119300,46058
17212,12026,5186,1119,229400,46060
12928,10529,2399,1130,256900,46062
138,84,54,763,72800,46063
5322,4360,962,1002,190300,46064
1066,820,246,937,164200,46065
1045,967,78,735,144800,46068
2868,2229,639,801,195200,46069
835,685,150,741,105700,46070
1308,1137,171,887,184400,46071
3708,2866,842,774,136800,46072
14376,11858,2518,1161,319900,46074
2489,1957,532,1422,240800,46075
547,440,107,791,84100,46076
11609,9816,1793,1437,427200,46077
156,127,29,1069,120400,46102
119,94,25,1078,125000,46103
375,355,20,-,129400,46104
732,597,135,855,208000,46105
3122,2679,443,1496,317100,46106
5163,3283,1880,909,118200,46107
225,225,0,-,192800,46110
162,129,33,1011,126400,46111
14366,11504,2862,1155,232800,46112
6084,4838,1246,1182,168600,46113
638,464,174,721,119600,46115
211,123,88,-,146700,46117
1852,1517,335,910,191600,46118
2487,1846,641,729,147500,46120
1818,1629,189,1146,194300,46121
5876,4658,1218,964,216300,46122
15114,11817,3297,1267,229700,46123
3049,2027,1022,696,149300,46124
16,16,0,-,-,46125
1669,1346,323,675,169100,46126
123,60,63,-,65000,46127
833,738,95,984,161200,46128
916,845,71,573,238600,46130
11907,8471,3436,946,174300,46131
381,313,68,698,106600,46133
6591,4269,2322,833,150300,46135
16570,12068,4502,958,175200,46140
13485,9437,4048,976,208600,46142
21861,15634,6227,1182,210600,46143
122,110,12,-,139300,46144
96,19,77,1041,-,46146
983,823,160,812,184900,46147
2008,1524,484,793,147100,46148
740,666,74,1117,200000,46149
327,258,69,-,145500,46150
11951,9550,2401,809,176300,46151
151,137,14,-,-,46154
88,38,50,-,-,46155
464,369,95,747,89200,46156
1270,1086,184,813,172800,46157
9057,7312,1745,921,182300,46158
2565,2188,377,759,191400,46160
796,636,160,874,146600,46161
167,167,0,-,-,46162
5092,4709,383,1049,245700,46163
1627,1572,55,781,197800,46164
731,627,104,1107,196800,46165
944,728,216,870,136300,46166
2606,2511,95,967,251200,46167
13973,9254,4719,1113,219100,46168
0,0,0,-,-,46170
798,774,24,-,143900,46171
926,747,179,919,99500,46172
4050,2667,1383,746,122000,46173
200,165,35,1048,104800,46175
11536,7641,3895,837,124500,46176
362,341,21,1050,143500,46180
1858,1656,202,865,244900,46181
695,554,141,844,136300,46182
0,0,0,-,-,46183
4554,3933,621,1570,162600,46184
764,723,41,830,162400,46186
13652,5741,7911,843,86000,46201
10289,2995,7294,1075,326000,46202
15047,8485,6562,900,106600,46203
5058,1063,3995,1436,350500,46204
11919,6204,5715,938,214800,46205
0,0,0,-,-,46206
8843,4491,4352,901,133400,46208
10101,4794,5307,931,141100,46214
1274,336,938,1142,218900,46216
13545,10317,3228,1141,162100,46217
12795,5869,6926,910,66500,46218
15848,9158,6690,873,128300,46219
16775,10583,6192,1148,265500,46220
10008,6284,3724,1002,127100,46221
12834,5321,7513,912,75500,46222
15314,5848,9466,874,118000,46224
2158,1062,1096,866,84100,46225
18971,8155,10816,914,104500,46226
23132,10986,12146,879,152500,46227
5724,4589,1135,1112,184300,46228
11418,7025,4393,927,135900,46229
3463,2853,610,1549,146700,46231
10091,8272,1819,1341,167500,46234
12194,6013,6181,786,133000,46235
10147,8877,1270,1352,209300,46236
16543,11790,4753,1073,164900,46237
11076,8975,2101,1106,191000,46239
10050,4576,5474,1034,253700,46240
11278,6441,4837,971,85900,46241
8909,3772,5137,1134,247800,46250
16076,7240,8836,963,131300,46254
9647,6853,2794,967,221300,46256
4767,4501,266,1182,248900,46259
14641,7120,7521,967,215600,46260
10905,5134,5771,1012,156500,46268
3252,3029,223,1113,342800,46278
3447,2179,1268,1375,239500,46280
45,45,0,-,-,46290
293,273,20,1313,480600,46301
33,33,0,-,208300,46302
5860,4805,1055,1007,216800,46303
10606,8069,2537,1073,230600,46304
24846,21917,2929,1140,240700,46307
5063,4326,737,824,174300,46310
8274,7395,879,1205,243300,46311
9953,4389,5564,710,76200,46312
7341,5326,2015,977,151900,46319
5491,2182,3309,728,79800,46320
9070,7837,1233,1155,242500,46321
9922,7886,2036,1133,175300,46322
8062,5288,2774,1072,114000,46323
8642,5931,2711,1019,109100,46324
3845,2167,1678,932,91700,46327
534,503,31,-,138100,46340
3856,3318,538,858,182100,46341
12658,9795,2863,998,152700,46342
43,27,16,867,158900,46345
531,326,205,800,68200,46346
1743,1503,240,810,199900,46347
459,386,73,898,135100,46348
1097,945,152,964,150800,46349
18092,13615,4477,795,159400,46350
6755,5850,905,1040,206100,46356
17680,11725,5955,804,120900,46360
286,276,10,-,190000,46365
2116,1756,360,697,114100,46366
15466,10870,4596,975,166600,46368
1221,1025,196,1040,202300,46371
6187,6008,179,874,306100,46373
278,211,67,834,165100,46374
9528,7590,1938,1108,244100,46375
69,53,16,917,93600,46376
68,52,16,-,-,46377
177,177,0,-,141100,46379
197,161,36,-,-,46381
800,800,0,-,154700,46382
17053,10622,6431,982,210800,46383
15329,13351,1978,1150,256200,46385
1258,1150,108,1140,156800,46390
1976,1654,322,923,190200,46391
2858,2453,405,928,174900,46392
114,77,37,-,-,46393
4827,3016,1811,869,136800,46394
2385,1105,1280,727,63400,46402
4827,2319,2508,849,120200,46403
6502,3459,3043,884,72100,46404
4283,2849,1434,976,89600,46405
3149,1542,1607,851,60800,46406
4126,1747,2379,746,49800,46407
5951,3727,2224,834,78900,46408
2629,1175,1454,1067,58600,46409
16272,10369,5903,1103,150900,46410
1268,891,377,845,107000,46501
0,0,0,-,-,46502
1177,996,181,747,143700,46504
3659,2657,1002,820,177400,46506
3253,2637,616,916,194700,46507
91,87,4,-,92800,46508
1255,1153,102,771,162400,46510
1662,1310,352,801,174200,46511
0,0,0,-,-,46513
16320,12096,4224,918,146100,46514
11892,7359,4533,756,114400,46516
8859,5436,3423,766,141900,46517
849,788,61,828,168500,46524
11372,8203,3169,906,157300,46526
7873,5968,1905,930,196800,46528
11540,10037,1503,1250,254200,46530
623,592,31,1046,108100,46531
523,432,91,823,106200,46532
3921,3108,813,592,136000,46534
1147,906,241,831,168400,46536
260,234,26,591,115300,46537
1573,1315,258,887,226300,46538
1003,801,202,803,109400,46539
4130,3606,524,943,268000,46540
1609,1378,231,806,152100,46542
866,739,127,884,262900,46543
12816,8586,4230,869,120000,46544
12071,5663,6408,888,137600,46545
4148,2786,1362,789,202800,46550
2443,1983,460,626,165900,46552
1119,1010,109,723,220900,46553
1767,1606,161,340,155900,46554
1152,950,202,927,162500,46555
174,9,165,685,-,46556
5338,4564,774,939,165700,46561
1971,1598,373,739,137900,46562
8526,6340,2186,851,147900,46563
2416,2066,350,756,262900,46565
3843,2939,904,845,189700,46567
400,343,57,646,155100,46570
1572,1282,290,796,290100,46571
43,35,8,-,-,46572
1299,1104,195,1008,182900,46573
3246,2761,485,759,119600,46574
8266,5940,2326,801,148000,46580
5814,3950,1864,914,184800,46582
1651,1022,629,951,164500,46590
15,15,0,-,-,46595
2189,451,1738,639,99600,46601
3919,2267,1652,925,57300,46613
12285,9474,2811,766,139600,46614
6224,3832,2392,840,94000,46615
2352,1274,1078,934,92200,46616
4343,2787,1556,1193,170800,46617
7451,5432,2019,805,81800,46619
34,5,29,1542,-,46624
11030,7347,3683,886,125400,46628
2646,2081,565,663,149300,46635
7171,4995,2176,986,150900,46637
3031,2404,627,769,159100,46701
858,767,91,600,85200,46702
7204,5338,1866,780,169700,46703
30,30,0,-,42500,46704
703,566,137,604,115500,46705
7750,6115,1635,742,151600,46706
1745,1492,253,655,158100,46710
2417,1857,560,686,158200,46711
5984,4301,1683,654,129000,46714
1902,1533,369,732,98300,46721
2949,2531,418,923,163500,46723
9736,8005,1731,806,170300,46725
312,308,4,-,157700,46730
263,216,47,-,182500,46731
1010,718,292,879,124200,46732
7682,6044,1638,688,129300,46733
3038,2664,374,1032,149700,46737
3355,2764,591,749,117800,46738
1187,1030,157,658,164900,46740
1381,1245,136,1103,289700,46741
1342,1089,253,865,172100,46742
991,852,139,856,148200,46743
704,679,25,-,164000,46745
1430,1095,335,784,139800,46746
945,851,94,829,149300,46747
2256,2068,188,1625,195800,46748
10793,7918,2875,724,107200,46750
6094,4135,1959,641,122900,46755
158,158,0,-,-,46759
506,387,119,764,128700,46760
4021,3217,804,664,170200,46761
550,516,34,-,162800,46763
439,392,47,864,156300,46764
1932,1855,77,968,223900,46765
180,180,0,-,132000,46766
2815,2237,578,778,153500,46767
1079,902,177,752,142300,46770
39,17,22,-,-,46771
839,776,63,719,177800,46772
1309,1079,230,730,144400,46773
7041,5351,1690,880,135500,46774
654,472,182,709,118100,46776
2634,2101,533,746,150700,46777
44,44,0,-,64400,46778
889,822,67,819,149500,46779
312,285,27,792,124600,46781
2858,2612,246,749,215600,46783
819,677,142,776,165000,46784
592,524,68,833,156400,46785
17,17,0,-,-,46786
1535,1312,223,720,116900,46787
963,888,75,1529,204300,46788
86,26,60,-,-,46789
388,364,24,850,217900,46791
1530,1155,375,868,117900,46792
1710,1420,290,731,143900,46793
587,536,51,-,136700,46794
2493,2125,368,780,199400,46795
46,46,0,-,-,46796
1263,1191,72,847,151900,46797
410,324,86,1065,150600,46798
184,161,23,1114,108400,46799
4887,1700,3187,724,91000,46802
3912,1716,2196,753,59300,46803
12346,8662,3684,953,192600,46804
9524,5319,4205,731,105600,46805
8505,4646,3859,806,56200,46806
6165,3593,2572,849,97300,46807
8471,5312,3159,770,95300,46808
4089,2597,1492,688,95800,46809
5255,4796,459,1082,317300,46814
10246,7643,2603,844,141900,46815
7193,4250,2943,700,93700,46816
7933,6694,1239,1074,170400,46818
4242,2874,1368,861,124300,46819
12623,7624,4999,905,151000,46825
14475,10591,3884,907,149900,46835
10003,8672,1331,1202,246300,46845
16251,11854,4397,723,96800,46901
15522,10516,5006,812,121400,46902
1140,913,227,735,109200,46910
576,552,24,1264,173600,46911
449,413,36,-,167600,46913
960,776,184,582,134600,46914
324,256,68,729,107200,46915
700,599,101,569,123100,46917
776,637,139,618,92500,46919
458,450,8,-,160200,46920
0,0,0,-,-,46922
3149,2414,735,816,133400,46923
573,505,68,681,101400,46926
1935,1535,400,768,100700,46928
1329,984,345,641,110300,46929
70,43,27,800,65400,46930
117,91,26,669,81700,46931
1386,1076,310,584,137400,46932
2635,1966,669,808,103100,46933
2206,1883,323,852,157700,46936
29,29,0,-,-,46937
1152,950,202,862,79300,46938
766,685,81,586,87700,46939
1104,951,153,792,98800,46940
335,300,35,692,120700,46941
45,35,10,-,153100,46943
19,0,19,-,-,46945
39,17,22,-,-,46946
11071,8044,3027,701,90100,46947
237,217,20,-,112200,46950
745,669,76,765,127000,46951
8085,5574,2511,711,111500,46952
8361,5316,3045,742,78200,46953
201,155,46,788,66600,46957
354,331,23,-,75200,46958
236,84,152,645,115200,46959
470,367,103,537,97500,46960
32,32,0,-,-,46961
3167,2333,834,780,129500,46962
0,0,0,-,-,46965
57,41,16,475,-,46967
57,57,0,-,65000,46968
8487,5866,2621,778,88800,46970
0,0,0,-,-,46971
686,470,216,767,118400,46974
5602,4245,1357,737,137200,46975
919,718,201,757,104100,46978
1781,1675,106,850,163800,46979
31,9,22,-,-,46980
1036,865,171,798,133700,46982
17,17,0,-,-,46984
462,362,100,776,101300,46985
688,555,133,641,102900,46986
472,430,42,789,119100,46987
337,208,129,582,79700,46988
1467,1220,247,651,158900,46989
214,208,6,-,123400,46990
823,687,136,813,90200,46991
7168,5547,1621,629,113700,46992
957,827,130,571,114000,46994
2561,1897,664,646,124600,46996
102,65,37,-,-,46998
4353,3454,899,819,156700,47001
475,333,142,733,112500,47003
4809,3751,1058,598,199300,47006
54,54,0,-,-,47010
291,280,11,-,185400,47011
4110,3064,1046,636,173900,47012
369,328,41,638,178900,47016
251,233,18,-,149600,47017
1642,1260,382,876,159100,47018
400,292,108,-,94800,47020
0,0,0,-,-,47021
1159,1118,41,-,257900,47022
872,721,151,1003,120800,47023
1235,942,293,816,82700,47024
8681,7062,1619,754,181600,47025
679,619,60,-,147800,47030
1992,1466,526,851,170300,47031
1222,1135,87,1063,160100,47032
0,0,0,-,-,47033
64,49,15,921,104800,47034
103,103,0,-,182900,47035
369,311,58,782,212200,47036
1700,1258,442,725,141100,47037
348,292,56,605,105000,47038
2281,1818,463,645,145000,47040
2279,2008,271,775,206700,47041
1653,1330,323,551,152100,47042
1996,1396,600,617,130800,47043
2479,2136,343,868,217700,47060
2670,1797,873,713,99600,47102
9,9,0,-,-,47104
1558,1286,272,853,170100,47106
907,719,188,380,108600,47108
202,202,0,-,86100,47110
6372,5401,971,780,204000,47111
6406,5033,1373,800,185500,47112
189,153,36,1025,184400,47114
1037,875,162,455,157300,47115
195,182,13,-,66900,47116
1550,1322,228,848,150800,47117
1270,1126,144,727,102800,47118
4214,3959,255,921,274000,47119
322,290,32,-,184200,47120
3895,3532,363,877,203100,47122
54,38,16,-,27600,47123
1780,1700,80,1047,254500,47124
614,512,102,907,90000,47125
1521,1324,197,793,196400,47126
8304,4838,3466,865,125700,47129
19235,13474,5761,927,153700,47130
341,338,3,-,231100,47135
1498,1430,68,952,207100,47136
608,528,80,880,80300,47137
1859,1685,174,981,150400,47138
1108,788,320,574,90300,47140
607,522,85,-,129100,47141
238,233,5,-,112800,47142
1266,1104,162,1522,200800,47143
848,656,192,982,145900,47145
433,368,65,-,147800,47147
19462,12446,7016,867,155300,47150
31,19,12,743,104200,47160
1163,914,249,980,171000,47161
202,152,50,-,124200,47162
367,355,12,-,156600,47163
1444,1140,304,779,138500,47164
2679,2284,395,765,148900,47165
479,445,34,-,110100,47166
5756,4518,1238,625,126600,47167
5834,3661,2173,791,115400,47170
6969,5788,1181,1073,202300,47172
24,24,0,-,-,47174
315,315,0,-,-,47175
682,609,73,-,117500,47177
18539,11930,6609,1064,169100,47201
10549,8231,2318,845,188400,47203
2139,1721,418,694,134300,47220
371,302,69,1017,-,47223
153,153,0,-,68900,47224
35,35,0,-,-,47225
96,50,46,687,106300,47226
624,555,69,700,136100,47227
1013,833,180,790,105600,47229
761,639,122,744,152300,47230
243,210,33,1060,150800,47231
869,789,80,730,132900,47232
592,514,78,-,151100,47234
605,507,98,733,182400,47235
68,32,36,-,-,47236
8545,6030,2515,811,154500,47240
1854,1372,482,854,144900,47243
191,174,17,888,118600,47244
1406,1196,210,842,158000,47246
73,52,21,792,89200,47247
9313,6171,3142,742,147800,47250
713,631,82,824,77600,47260
71,43,28,838,108000,47263
532,444,88,830,109000,47264
7584,5977,1607,828,105900,47265
185,162,23,-,-,47270
642,505,137,756,89300,47272
924,850,74,685,167200,47273
12352,8186,4166,833,149400,47274
306,269,37,-,137500,47280
513,446,67,-,146600,47281
91,75,16,621,73200,47282
1294,1002,292,638,152000,47283
10774,6724,4050,769,60400,47302
10043,5079,4964,746,83800,47303
13663,9148,4515,842,130600,47304
1675,533,1142,625,64400,47305
0,0,0,-,-,47306
1873,1522,351,675,101100,47320
73,42,31,842,66000,47324
181,160,21,-,133000,47325
583,490,93,547,148700,47326
1779,1427,352,696,102800,47327
2116,1689,427,820,133000,47330
9493,6508,2985,698,88600,47331
1295,1111,184,691,145400,47334
293,202,91,648,83000,47335
1211,987,224,714,69100,47336
63,43,20,1083,81700,47337
1068,877,191,638,79300,47338
182,145,37,759,79400,47339
1255,978,277,792,138800,47340
968,739,229,715,127300,47341
939,753,186,802,78100,47342
73,70,3,850,85100,47344
521,455,66,950,109000,47345
1430,1200,230,732,119100,47346
3870,2947,923,607,83100,47348
176,132,44,970,86200,47351
279,228,51,861,74700,47352
2148,1697,451,825,126300,47353
559,519,40,684,121000,47354
1336,1048,288,785,97200,47355
2360,1806,554,745,128800,47356
309,269,40,668,102600,47357
381,327,54,591,106100,47358
1219,890,329,729,90200,47359
568,464,104,691,138000,47360
96,67,29,853,95600,47361
10731,7892,2839,727,99700,47362
14,0,14,-,-,47366
42,42,0,-,79100,47367
804,706,98,636,86100,47368
778,568,210,851,139900,47369
93,81,12,825,69500,47370
4840,3530,1310,702,101100,47371
873,675,198,685,91900,47373
18684,11647,7037,753,101600,47374
667,540,127,591,74200,47380
71,48,23,735,83300,47381
62,38,24,588,50000,47382
1110,940,170,817,130300,47383
760,676,84,760,112700,47384
739,578,161,621,99600,47385
494,444,50,900,151600,47386
240,182,58,1025,108300,47387
173,154,19,820,115400,47388
2236,1591,645,551,77900,47390
74,74,0,-,-,47392
517,442,75,738,135200,47393
3291,2466,825,750,88900,47394
2724,2491,233,431,152900,47396
18464,10348,8116,1068,271500,47401
14581,8022,6559,982,170400,47403
10798,5918,4880,993,179800,47404
0,0,0,-,-,47405
5,0,5,-,-,47406
8966,3189,5777,963,225900,47408
81,81,0,-,86500,47420
11967,9347,2620,743,128000,47421
3358,2635,723,697,115500,47424
277,186,91,613,-,47427
3002,2608,394,663,168800,47429
546,484,62,-,117100,47431
1834,1477,357,748,100200,47432
1411,987,424,775,129300,47433
10,10,0,-,-,47434
69,69,0,-,-,47435
582,487,95,-,151400,47436
68,68,0,-,157300,47437
1562,1188,374,637,93500,47438
3861,2758,1103,669,90000,47441
455,350,105,736,80000,47443
32,6,26,-,-,47445
3740,3070,670,650,111600,47446
3115,2523,592,886,200500,47448
150,138,12,-,81100,47449
548,325,223,615,103400,47451
1972,1437,535,650,135400,47452
175,94,81,1082,81100,47453
3047,2402,645,703,100800,47454
27,27,0,-,-,47455
553,485,68,1297,162400,47456
9,0,9,-,-,47457
17,17,0,-,-,47458
1383,1232,151,461,169200,47459
4641,3733,908,722,134900,47460
1732,1562,170,817,157000,47462
155,94,61,602,98600,47464
153,121,32,650,96800,47465
0,0,0,-,-,47467
634,574,60,-,214800,47468
697,529,168,663,126400,47469
588,538,50,604,150700,47470
1220,987,233,691,93200,47471
6965,4264,2701,773,128200,47501
1713,1202,511,663,69700,47512
708,671,37,569,89300,47513
131,131,0,-,142400,47514
333,311,22,-,116800,47515
438,405,33,625,160300,47516
197,184,13,1075,196300,47519
1158,867,291,602,109200,47520
341,341,0,-,186500,47521
131,45,86,662,76300,47522
1311,987,324,619,99200,47523
189,179,10,-,79100,47524
117,117,0,-,209400,47525
833,740,93,672,214700,47527
209,119,90,436,56700,47528
389,302,87,635,96700,47529
342,284,58,-,167700,47531
1666,1397,269,803,168500,47532
278,186,92,-,63200,47535
335,246,89,611,213900,47537
438,366,72,675,118500,47541
3969,2912,1057,694,140400,47542
9025,6810,2215,724,176800,47546
232,214,18,-,150000,47550
184,169,15,-,162900,47551
95,95,0,-,-,47552
3076,2436,640,567,166300,47553
573,413,160,930,147300,47557
1349,1173,176,691,193200,47558
675,469,206,578,80100,47561
1685,1307,378,524,176300,47562
573,530,43,-,132400,47564
2545,2081,464,603,111400,47567
224,143,81,719,116100,47568
15,15,0,-,-,47573
83,71,12,-,-,47574
383,298,85,-,195700,47575
152,152,0,-,98400,47576
428,366,62,589,150000,47577
253,228,25,600,106700,47578
1064,984,80,917,187600,47579
147,147,0,-,-,47580
1370,1163,207,535,115100,47581
75,60,15,775,80800,47584
263,240,23,-,178100,47585
4862,3449,1413,567,117900,47586
343,297,46,827,102200,47588
200,182,18,-,168800,47590
10501,6309,4192,715,118300,47591
28,21,7,-,62500,47596
319,267,52,641,117100,47597
1213,963,250,645,82300,47598
5410,4281,1129,806,149800,47601
2028,1632,396,914,129500,47610
349,280,69,494,110900,47611
253,207,46,630,84900,47612
974,915,59,681,174500,47613
721,579,142,785,128100,47615
82,46,36,380,61400,47616
713,652,61,765,120100,47619
5379,3963,1416,712,160400,47620
14441,11510,2931,988,206000,47630
859,721,138,761,158500,47631
982,815,167,633,120100,47633
891,831,60,1146,108900,47634
2303,1675,628,635,128600,47635
584,480,104,726,166800,47637
1275,1144,131,477,230600,47638
1636,1385,251,817,208900,47639
360,337,23,653,74300,47640
1926,1479,447,756,160000,47648
594,502,92,944,120700,47649
11,11,0,-,104200,47654
1822,1381,441,815,101500,47660
1503,1228,275,758,150700,47665
573,449,124,735,93600,47666
4618,3107,1511,729,114900,47670
36,28,8,900,103800,47683
336,96,240,1036,241100,47708
8023,4541,3482,747,105800,47710
13338,10084,3254,889,134900,47711
9726,6303,3423,873,140300,47712
4475,1813,2662,730,70100,47713
14425,8340,6085,822,97300,47714
13255,6689,6566,903,160900,47715
6724,5761,963,962,164900,47720
7442,7131,311,1326,216800,47725
13048,7893,5155,773,145700,47802
9032,6302,2730,844,125200,47803
4662,2606,2056,778,73600,47804
5488,4411,1077,759,121500,47805
5286,1581,3705,808,53800,47807
0,0,0,-,-,47809
0,0,0,-,-,47831
487,412,75,807,97800,47832
311,272,39,-,141000,47833
7724,5783,1941,724,117900,47834
0,0,0,-,-,47836
360,310,50,855,105500,47837
766,632,134,663,77700,47838
798,716,82,654,131800,47840
1032,821,211,635,82700,47841
4179,2975,1204,711,96000,47842
70,70,0,-,-,47845
215,206,9,-,103200,47846
424,377,47,529,56800,47847
543,420,123,631,85100,47848
166,136,30,-,129600,47849
905,764,141,650,89500,47850
0,0,0,-,-,47851
66,39,27,882,105400,47853
244,216,28,-,159100,47854
392,263,129,784,73100,47855
105,85,20,582,87500,47857
438,257,181,-,80200,47858
305,230,75,952,116700,47859
166,108,58,542,43300,47860
210,198,12,-,150000,47861
565,463,102,879,79500,47862
94,94,0,-,-,47863
1,1,0,-,-,47865
168,155,13,-,95800,47866
1251,986,265,883,134500,47868
18,18,0,-,-,47869
0,0,0,-,-,47870
210,149,61,835,83600,47871
2362,1816,546,713,107900,47872
1233,1064,169,784,100000,47874
0,0,0,-,-,47875
0,0,0,-,-,47876
1431,1063,368,655,85200,47879
41,41,0,-,90200,47880
75,64,11,-,67500,47881
3216,2236,980,731,119400,47882
152,150,2,-,59500,47884
3535,2896,639,695,101500,47885
2512,230,2282,840,184400,47901
7211,3215,3996,867,92400,47904
17398,10654,6744,948,170100,47905
25144,11517,13627,951,227300,47906
0,0,0,-,-,47907
16631,10924,5707,946,153400,47909
13,6,7,-,55000,47916
177,161,16,595,143000,47917
2212,1655,557,721,117400,47918
962,849,113,732,199800,47920
423,317,106,928,95400,47921
556,386,170,796,86400,47922
1359,1109,250,788,138500,47923
109,109,0,-,83500,47924
7,7,0,-,-,47925
416,375,41,814,117400,47926
705,585,120,834,76900,47928
263,206,57,729,128800,47929
461,350,111,549,171900,47930
2233,1651,582,736,130400,47932
11509,8279,3230,696,145700,47933
610,521,89,794,133600,47940
490,397,93,865,138500,47941
297,252,45,700,113000,47942
296,228,68,-,251800,47943
1347,967,380,776,102600,47944
741,538,203,640,135300,47946
552,450,102,625,80800,47948
515,456,59,964,97300,47949
287,183,104,-,88300,47950
1135,830,305,729,82300,47951
1253,866,387,738,103400,47952
858,727,131,838,151500,47954
383,296,87,817,89000,47955
714,589,125,916,88900,47957
50,44,6,-,105000,47958
841,634,207,794,106400,47959
6188,4835,1353,756,137400,47960
887,723,164,713,118900,47963
38,33,5,-,75000,47964
234,191,43,916,119000,47965
169,159,10,-,57400,47966
301,268,33,950,87600,47967
423,357,66,919,160000,47968
118,81,37,740,74400,47969
763,563,200,759,131300,47970
719,595,124,616,99700,47971
412,270,142,713,116500,47974
338,278,60,831,141400,47975
936,716,220,693,144400,47977
4165,2945,1220,812,138100,47978
448,353,95,665,140800,47980
299,278,21,-,224000,47981
57,47,10,880,80400,47982
32,32,0,-,101500,47983
0,0,0,-,-,47986
1545,1298,247,694,109100,47987
417,377,40,479,90800,47989
619,535,84,818,100600,47990
475,316,159,730,88900,47991
568,495,73,919,178100,47992
1418,1137,281,767,100600,47993
180,128,52,-,64300,47994
665,544,121,775,116500,47995
58,50,8,581,110600,47997
5142,4308,834,791,184800,48001
1226,1185,41,919,237400,48002
2185,2013,172,1040,221400,48003
1823,1696,127,1023,256900,48005
1411,1340,71,900,192400,48006
9383,7016,2367,1747,580200,48009
1718,1424,294,688,172700,48014
3664,1825,1839,630,110800,48015
5854,4360,1494,970,205200,48017
13351,9157,4194,1131,93800,48021
1064,1034,30,830,188800,48022
1959,1698,261,1155,218100,48023
5679,5277,402,1559,428100,48025
6337,4558,1779,746,162600,48026
1206,1118,88,-,201100,48027
490,489,1,-,292700,48028
6801,3882,2919,1057,104800,48030
771,707,64,955,202600,48032
7628,3814,3814,1176,160500,48033
7619,1491,6128,1164,230600,48034
14668,9159,5509,978,145400,48035
9024,6465,2559,858,165400,48036
20491,12757,7734,1113,193700,48038
3333,2822,511,838,144900,48039
4371,3720,651,863,144500,48040
1667,1454,213,763,234400,48041
11216,10942,274,1135,310400,48042
6506,3750,2756,782,128700,48043
19402,17409,1993,1189,285100,48044
11738,8199,3539,948,205200,48045
15562,12405,3157,954,237700,48047
3183,2563,620,1076,161600,48048
2229,2035,194,942,188900,48049
574,522,52,1356,274800,48050
6576,5536,1040,1023,206900,48051
2928,2525,403,958,237300,48054
6130,5025,1105,864,167300,48059
16558,9862,6696,902,118200,48060
3387,2853,534,796,213000,48062
1545,1399,146,952,247300,48063
1422,1350,72,717,250400,48064
4623,3858,765,861,271600,48065
21020,13414,7606,1048,107300,48066
12556,8524,4032,1309,252600,48067
1175,1128,47,1681,368400,48069
2363,2288,75,2273,386100,48070
13487,8324,5163,989,149500,48071
7067,5934,1133,1288,238200,48072
16458,10572,5886,1131,248000,48073
3634,3291,343,987,141100,48074
9654,5441,4213,1130,169600,48075
9996,7142,2854,1254,199100,48076
4950,4154,796,1024,225000,48079
10882,8393,2489,962,152400,48080
8968,7662,1306,1074,160400,48081
7183,6249,934,1121,158700,48082
9677,6124,3553,1203,246900,48083
6646,3387,3259,1393,364400,48084
9111,8352,759,1630,323700,48085
9641,8150,1491,980,163500,48088
12774,6982,5792,1042,84300,48089
11388,7086,4302,1056,106300,48091
10510,8313,2197,1088,167600,48092
10189,7849,2340,925,152000,48093
7749,6356,1393,1142,333700,48094
1983,1908,75,694,379200,48095
1612,1341,271,959,325700,48096
2182,1703,479,792,139800,48097
7315,6728,587,1455,423900,48098
11796,10148,1648,1063,142300,48101
23876,16178,7698,1522,391400,48103
17660,6467,11193,1407,428000,48104
15170,7569,7601,1416,402000,48105
11879,6414,5465,1115,301600,48108
114,0,114,1148,-,48109
18131,12159,5972,1024,200800,48111
8013,7283,730,1210,313500,48114
11092,9523,1569,1073,289900,48116
4210,3705,505,938,218900,48117
5433,4322,1111,1593,294300,48118
2610,950,1660,1215,202900,48120
4536,2657,1879,997,82500,48122
13389,10640,2749,1118,153100,48124
8133,5713,2420,1145,89800,48125
14607,8326,6281,1065,157500,48126
13804,9798,4006,1063,167600,48127
4343,3861,482,1379,187300,48128
5913,5122,791,1325,370800,48130
3441,2416,1025,1022,209300,48131
2135,1943,192,962,139700,48133
8825,7122,1703,1014,214800,48134
10979,8811,2168,894,131300,48135
1926,1784,142,1414,244800,48137
4241,3872,369,1255,305700,48138
61,45,16,-,169800,48139
1286,1210,76,720,213400,48140
9031,3753,5278,979,59900,48141
64,64,0,-,681800,48143
3999,3714,285,964,200600,48144
1231,1036,195,1103,205600,48145
15284,10767,4517,886,91400,48146
10405,9057,1348,1185,184100,48150
12454,10246,2208,1141,233300,48152
14593,13333,1260,1163,239400,48154
591,456,135,413,142100,48157
3145,2809,336,872,261200,48158
986,822,164,916,196100,48159
4920,3942,978,1020,203400,48160
11207,8158,3049,858,146000,48161
11908,8806,3102,838,158800,48162
3194,3066,128,1537,255100,48164
3221,2425,796,1380,297100,48165
4739,4039,700,1057,139000,48166
9904,7293,2611,1365,363400,48167
8844,8026,818,2013,454400,48168
8307,7665,642,1104,283300,48169
17498,13512,3986,965,344100,48170
4892,4150,742,966,186900,48173
11897,8624,3273,945,119600,48174
8372,7160,1212,1086,342900,48176
113,113,0,-,-,48177
13451,12431,1020,1095,321600,48178
1419,1110,309,1145,190900,48179
24643,15731,8912,895,116600,48180
8443,7151,1292,968,185700,48182
17721,13536,4185,885,175100,48183
7025,4083,2942,820,109600,48184
21729,12160,9569,961,151300,48185
13534,8893,4641,989,134300,48186
19352,13676,5676,1222,279300,48187
16136,13243,2893,1483,293000,48188
6064,4710,1354,1152,233700,48189
76,76,0,-,153400,48190
1487,1338,149,1472,215300,48191
10922,7801,3121,829,126400,48192
6490,4111,2379,936,167700,48193
12566,8461,4105,958,133300,48195
26626,14038,12588,1068,226700,48197
16542,9681,6861,1030,131300,48198
7741,841,6900,667,343000,48201
7202,2094,5108,762,164900,48202
8873,3914,4959,711,51500,48203
8929,4686,4243,861,41700,48204
12504,4073,8431,1042,34800,48205
6325,3215,3110,762,60800,48206
10718,2803,7915,949,142700,48207
3904,1382,2522,712,132300,48208
9081,4638,4443,758,56500,48209
8031,4626,3405,826,44100,48210
1855,744,1111,840,41700,48211
11484,6875,4609,832,70400,48212
7572,4301,3271,718,39500,48213
9542,4062,5480,685,83800,48214
4534,2023,2511,774,96700,48215
2504,891,1613,717,152600,48216
2707,1602,1105,860,42200,48217
2894,1447,1447,663,34000,48218
17738,9501,8237,924,62600,48219
11317,6991,4326,1057,189000,48220
15383,9991,5392,1013,95300,48221
9482,5168,4314,903,75100,48223
13189,7441,5748,1011,50900,48224
5660,3176,2484,1174,109600,48225
3880,440,3440,1610,265900,48226
15118,8387,6731,906,56300,48227
19253,9340,9913,949,39300,48228
3421,2277,1144,838,50400,48229
6919,5362,1557,1284,368300,48230
0,0,0,-,-,48233
12432,6518,5914,890,46500,48234
17830,10019,7811,1021,63600,48235
12209,11093,1116,1325,308200,48236
12262,7195,5067,1176,143700,48237
10052,4838,5214,817,45400,48238
13866,10465,3401,1218,108500,48239
6566,4781,1785,1192,89300,48240
0,0,0,-,-,48242
0,0,0,-,-,48243
5879,5191,688,1648,586900,48301
6558,5738,820,1243,541500,48302
6556,5988,568,1561,397000,48304
9666,9076,590,1348,434400,48306
17983,12293,5690,1304,279600,48307
11203,9102,2101,1469,326600,48309
14882,11248,3634,1179,218200,48310
13677,10375,3302,983,203700,48312
13724,10144,3580,1067,201900,48313
8846,6783,2063,1281,261800,48314
10696,9414,1282,913,311600,48315
11122,8866,2256,1187,303700,48316
12256,7116,5140,1083,205400,48317
2106,1557,549,1092,243200,48320
12610,9484,3126,1852,318600,48322
6191,5509,682,1817,383600,48323
6515,6001,514,1307,340100,48324
10939,5388,5551,1197,186200,48326
9373,6492,2881,909,199300,48327
11393,7325,4068,911,169600,48328
9696,8522,1174,1297,203300,48329
9152,7007,2145,1683,331600,48331
8028,5103,2925,1296,261800,48334
11033,4815,6218,1244,311900,48335
11723,8281,3442,996,210200,48336
10690,4491,6199,925,73400,48340
7735,3755,3980,783,94300,48341
6169,2359,3810,725,73600,48342
9249,6445,2804,1196,242000,48346
8782,8151,631,1088,349900,48348
2781,2368,413,1099,290500,48350
2766,2470,296,1427,236800,48353
3107,2852,255,1033,271100,48356
3226,2827,399,879,255300,48357
4090,2819,1271,1131,272800,48359
4677,3992,685,1226,314900,48360
5830,4948,882,1039,275400,48362
2283,2225,58,-,469200,48363
1601,1515,86,955,327500,48367
534,491,43,-,352000,48370
9477,8305,1172,995,278500,48371
5661,4937,724,1900,466200,48374
9793,6810,2983,1590,295900,48375
8835,4355,4480,1201,281900,48377
2767,2721,46,1886,369900,48380
5479,4459,1020,1074,337400,48381
8450,7816,634,1500,328400,48382
4620,4239,381,1230,269500,48383
7238,6063,1175,1334,255400,48386
10426,7600,2826,1312,231600,48390
8736,4726,4010,824,255500,48393
603,481,122,718,134800,48401
55,48,7,-,90000,48410
28,28,0,-,-,48411
2056,1955,101,922,196700,48412
2883,2103,780,649,117300,48413
1046,964,82,808,145300,48414
3468,2976,492,928,144500,48415
1937,1595,342,723,156900,48416
1112,1040,72,905,146900,48417
1556,1474,82,1000,200200,48418
971,820,151,941,123600,48419
8784,7045,1739,683,135600,48420
2472,2272,200,977,157700,48421
2517,2053,464,759,135100,48422
14412,9649,4763,797,162600,48423
374,317,57,755,112100,48426
1162,911,251,696,97900,48427
2067,1859,208,1061,256500,48428
3786,3060,726,707,119100,48429
15207,12231,2976,1158,253400,48430
248,220,28,780,119600,48432
10141,8691,1450,910,156600,48433
66,49,17,-,96300,48434
872,818,54,1250,117500,48435
1541,1478,63,871,200300,48436
262,144,118,663,109800,48437
2544,2460,84,1107,240400,48438
21012,15819,5193,871,199600,48439
75,46,29,-,278000,48440
1595,1288,307,620,124600,48441
9076,7035,2041,1020,216000,48442
3701,2848,853,764,179100,48444
501,418,83,618,91700,48445
12065,9798,2267,832,172000,48446
1018,891,127,865,107400,48449
2261,1793,468,689,161300,48450
5493,5149,344,893,229300,48451
2012,1446,566,721,113300,48453
462,416,46,738,142400,48454
3160,2906,254,995,306600,48455
295,262,33,744,120800,48456
3234,2613,621,790,132100,48457
7757,5253,2504,839,68200,48458
1049,909,140,646,158000,48460
3047,2599,448,710,167900,48461
4873,4604,269,929,263000,48462
1798,1624,174,739,141300,48463
836,780,56,-,135300,48464
219,183,36,800,146600,48465
632,548,84,717,93700,48466
1220,1040,180,635,135200,48467
530,476,54,629,108500,48468
596,493,103,762,153000,48469
278,230,48,625,120400,48470
2313,1648,665,677,114800,48471
597,499,98,840,108700,48472
9652,8101,1551,920,155400,48473
1015,922,93,708,133100,48475
205,202,3,-,96700,48476
55,0,55,803,-,48502
9609,4936,4673,773,56000,48503
10115,6280,3835,814,41200,48504
7247,3599,3648,698,23500,48505
9904,6934,2970,804,70000,48506
12357,6821,5536,815,71800,48507
3871,3273,598,914,108700,48509
3245,2187,1058,776,113200,48519
3791,2293,1498,777,54100,48529
8214,4768,3446,814,105700,48532
13450,8571,4879,781,45300,48601
11283,6567,4716,777,58500,48602
12244,8142,4102,919,145900,48603
4283,3167,1116,906,80700,48604
677,251,426,885,67400,48607
5290,4559,731,831,144700,48609
1484,1334,150,775,94700,48610
2692,2145,547,752,144600,48611
3625,3006,619,630,122400,48612
385,343,42,647,137500,48613
447,393,54,911,110000,48614
1095,847,248,783,102500,48615
3055,2511,544,725,120800,48616
3293,2544,749,732,130300,48617
2095,1774,321,645,99900,48618
255,227,28,931,142000,48619
56,56,0,-,92000,48620
398,328,70,661,131400,48621
2171,1827,344,744,98500,48622
5119,4422,697,950,177900,48623
6693,5869,824,606,118800,48624
5093,4290,803,564,77600,48625
2278,2130,148,803,175100,48626
47,47,0,-,-,48627
820,779,41,1025,150600,48628
3637,2952,685,712,121900,48629
26,26,0,-,-,48630
1826,1425,401,709,141400,48631
2058,1866,192,726,100200,48632
101,101,0,-,209400,48633
1968,1826,142,637,136300,48634
771,708,63,789,108400,48635
350,321,29,-,80500,48636
1242,1089,153,754,115200,48637
5938,3953,1985,839,135700,48638
13108,9685,3423,815,159400,48640
13844,10223,3621,937,162100,48642
1478,1216,262,686,106500,48647
546,507,39,820,128500,48649
2792,2541,251,704,108000,48650
1995,1488,507,809,136000,48651
769,743,26,1000,123700,48652
4545,4011,534,726,118900,48653
1023,886,137,552,105500,48654
2290,1976,314,724,119300,48655
1818,1512,306,708,76500,48656
3086,2674,412,848,146900,48657
2006,1531,475,529,87400,48658
919,807,112,737,106300,48659
4417,3433,984,715,128600,48661
555,527,28,-,98900,48662
541,450,91,749,82700,48701
1434,1234,200,585,125200,48703
221,217,4,-,110800,48705
16908,12946,3962,755,110500,48706
11366,7608,3758,638,82000,48708
0,0,0,-,-,48710
419,355,64,636,93000,48720
204,200,4,-,140900,48721
1310,1165,145,803,111200,48722
4964,3905,1059,733,102300,48723
355,108,247,-,-,48724
1059,900,159,523,133200,48725
2165,1756,409,677,109600,48726
366,325,41,808,136100,48727
157,145,12,-,120800,48728
579,509,70,633,121800,48729
2234,1691,543,552,113600,48730
661,494,167,738,91300,48731
5140,3668,1472,706,133900,48732
643,533,110,814,79600,48733
3214,2329,885,741,229200,48734
438,377,61,925,102200,48735
589,496,93,854,87300,48737
557,504,53,569,121900,48738
1777,1662,115,670,130400,48739
1099,956,143,693,118300,48740
789,695,94,736,111600,48741
752,644,108,611,135600,48742
27,22,5,-,-,48743
1802,1595,207,886,122100,48744
554,489,65,857,99900,48745
3223,2891,332,803,135500,48746
595,547,48,683,117900,48747
670,621,49,669,98900,48748
482,452,30,695,93000,48749
4305,3369,936,684,89600,48750
362,320,42,647,85500,48754
1248,1028,220,793,141900,48755
1738,1397,341,692,70100,48756
1586,1407,179,743,136200,48757
1537,1252,285,822,84300,48759
542,498,44,857,118600,48760
427,382,45,-,82200,48761
487,471,16,-,132900,48762
1921,1670,251,780,120200,48763
263,247,16,-,84200,48765
529,483,46,771,77200,48766
914,792,122,823,107600,48767
3634,3061,573,646,112500,48768
633,531,102,494,89600,48770
5181,3465,1716,661,93200,48801
645,548,97,929,112500,48806
360,303,57,643,78700,48807
3004,2283,721,1044,224600,48808
4063,2926,1137,821,145000,48809
1255,927,328,649,122800,48811
7618,5987,1631,786,152400,48813
814,729,85,-,192800,48815
180,17,163,-,160900,48816
2395,1694,701,909,132800,48817
983,819,164,694,156300,48818
909,839,70,888,171900,48819
6671,5616,1055,930,241200,48820
2421,2261,160,875,192700,48821
911,893,18,882,209000,48822
21619,9541,12078,1000,209800,48823
0,0,0,-,-,48824
0,0,0,-,-,48825
6033,5135,898,867,170700,48827
1337,1006,331,613,99000,48829
1382,1143,239,743,128100,48831
543,502,41,663,115900,48832
754,608,146,830,120200,48834
1069,967,102,758,165800,48835
5149,4416,733,944,204400,48836
8579,6933,1646,951,202900,48837
7197,5409,1788,788,145800,48838
6095,3804,2291,910,218100,48840
304,261,43,830,151000,48841
9250,6192,3058,1009,167800,48842
17798,13665,4133,1116,265800,48843
290,266,24,754,109400,48845
6745,4735,2010,805,137300,48846
2205,1788,417,679,119400,48847
2847,2499,348,788,204200,48848
2096,1824,272,741,159900,48849
1700,1384,316,652,125400,48850
922,816,106,772,106500,48851
66,51,15,-,77200,48852
254,174,80,397,73000,48853
7413,5908,1505,1018,186300,48854
5716,4865,851,1383,259400,48855
305,242,63,664,97500,48856
1277,1088,189,953,114100,48857
16860,8548,8312,782,146600,48858
24,0,24,-,-,48859
546,429,117,449,153400,48860
733,685,48,875,144500,48861
2,2,0,-,-,48862
8912,5640,3272,1137,290800,48864
654,515,139,821,97600,48865
1729,1426,303,740,137200,48866
11425,8054,3371,737,121400,48867
68,58,10,-,84500,48870
822,669,153,855,160600,48871
2518,2005,513,935,178900,48872
433,401,32,583,161400,48873
72,72,0,-,80500,48874
4117,3185,932,1048,162600,48875
1745,1250,495,834,150800,48876
860,762,98,630,96800,48877
627,513,114,480,113000,48878
6819,5588,1231,822,177200,48879
2625,2157,468,728,105200,48880
2047,1718,329,513,168700,48881
2664,2318,346,694,122200,48883
1647,1502,145,810,124800,48884
425,414,11,-,129700,48885
708,621,87,739,109200,48886
2517,1980,537,781,114600,48888
618,510,108,833,108800,48889
735,558,177,845,135800,48890
1036,888,148,718,128600,48891
1936,1633,303,910,149400,48892
2128,1940,188,773,132400,48893
746,661,85,713,199300,48894
4720,3898,822,958,241400,48895
89,89,0,-,59600,48896
590,509,81,540,152200,48897
10638,7009,3629,911,112900,48906
15183,8354,6829,919,94000,48910
16400,8993,7407,860,104800,48911
8025,3565,4460,943,119200,48912
4012,2258,1754,944,91300,48915
15362,9058,6304,951,166400,48917
1583,119,1464,756,114700,48933
8956,4659,4297,864,109700,49001
8281,5778,2503,814,168300,49002
7268,5467,1801,923,147600,49004
10340,3676,6664,858,154100,49006
4384,1163,3221,836,66900,49007
6614,4079,2535,855,170700,49008
19129,12465,6664,934,263000,49009
6681,5549,1132,903,148800,49010
941,799,142,778,104200,49011
1353,1208,145,1006,205800,49012
1799,1424,375,698,110900,49013
8246,5869,2377,883,121500,49014
11590,8026,3564,873,139700,49015
8605,6253,2352,853,111600,49017
2279,1989,290,817,149600,49021
12857,7253,5604,735,106800,49022
12427,8165,4262,998,194900,49024
849,628,221,830,133800,49026
83,62,21,808,179600,49027
2252,1791,461,763,111800,49028
539,490,49,686,120800,49029
882,729,153,761,119200,49030
3280,2526,754,713,161500,49031
1121,927,194,644,139400,49032
712,647,65,856,208300,49033
871,720,151,838,169000,49034
9346,6730,2616,809,129500,49036
8798,4946,3852,713,71600,49037
3755,2794,961,771,140400,49038
1204,1001,203,778,117600,49040
1892,1467,425,696,128000,49042
893,497,396,613,107500,49043
2410,1973,437,737,143800,49045
3021,2749,272,1004,201400,49046
6053,4571,1482,634,129700,49047
9514,5615,3899,910,111800,49048
499,482,17,639,184000,49050
912,842,70,-,213900,49051
339,282,57,758,141700,49052
2790,2261,529,753,173600,49053
2394,2025,369,844,141500,49055
1190,1005,185,784,119300,49056
2101,1504,597,675,84700,49057
7361,6132,1229,922,155600,49058
906,812,94,569,-,49060
640,585,55,1008,153200,49061
40,40,0,-,-,49063
1363,1073,290,750,136300,49064
2862,2359,503,843,185600,49065
256,214,42,1014,144000,49066
1609,1428,181,908,157600,49067
6383,4884,1499,804,161100,49068
869,784,85,677,153500,49070
4145,3795,350,891,200200,49071
1133,1023,110,836,141400,49072
1924,1578,346,795,141800,49073
63,0,63,384,-,49074
81,62,19,-,72400,49075
1397,1083,314,815,158800,49076
3823,3134,689,973,152600,49078
4869,3821,1048,850,161600,49079
6174,5227,947,796,174300,49080
2359,1995,364,796,121600,49082
2950,2572,378,825,242400,49083
12,11,1,-,115300,49084
10055,7836,2219,944,226700,49085
2232,2012,220,805,235900,49087
1364,1267,97,885,203900,49088
656,513,143,758,113600,49089
5710,4294,1416,795,202800,49090
7620,5428,2192,742,130300,49091
746,608,138,988,114100,49092
7404,5218,2186,753,140000,49093
1408,1019,389,738,108500,49094
914,795,119,890,228100,49095
1133,970,163,840,151700,49096
4641,4001,640,741,182900,49097
2244,1790,454,777,108300,49098
2446,1858,588,689,136300,49099
1238,1033,205,913,174100,49101
648,578,70,968,203300,49102
4166,2366,1800,821,173500,49103
0,0,0,-,-,49104
2106,1650,456,957,189900,49106
4187,3305,882,756,154400,49107
1295,1160,135,854,136200,49111
4221,3470,751,890,178100,49112
788,586,202,805,136600,49113
86,86,0,-,271200,49115
70,70,0,-,445500,49116
1741,1371,370,647,352100,49117
55,39,16,617,165600,49119
14534,11137,3397,789,127700,49120
957,852,105,597,186800,49125
451,376,75,780,118900,49126
4426,3448,978,972,233000,49127
1405,1193,212,816,179700,49128
310,297,13,-,418600,49129
539,455,84,708,273800,49130
16480,11999,4481,851,164300,49201
8433,4530,3903,804,82400,49202
15379,10322,5057,916,113200,49203
1056,919,137,630,180800,49220
15432,10765,4667,860,130100,49221
4423,3049,1374,763,89400,49224
458,385,73,694,136700,49227
2070,1678,392,918,144200,49228
1274,1108,166,682,188500,49229
4440,3988,452,840,204100,49230
944,784,160,698,169800,49232
1182,1045,137,1148,181800,49233
1074,982,92,775,218000,49234
817,720,97,868,131500,49235
1914,1679,235,861,167800,49236
1106,962,144,791,137400,49237
683,601,82,750,164000,49238
3594,3357,237,1163,242500,49240
843,772,71,850,149200,49241
5589,3863,1726,714,148600,49242
1512,1146,366,768,118300,49245
1347,1231,116,1014,186900,49246
2167,1746,421,883,109500,49247
319,286,33,1196,130500,49248
1397,1287,110,825,176400,49249
2284,1815,469,763,129100,49250
2407,2102,305,1036,158600,49251
1037,773,264,712,108300,49252
1237,1140,97,688,190700,49253
1795,1507,288,877,143500,49254
634,546,88,932,100400,49255
1512,1185,327,780,89800,49256
4,0,4,-,-,49258
1117,1046,71,836,200900,49259
77,47,30,-,135200,49261
478,407,71,750,112000,49262
14,8,6,-,-,49263
555,507,48,686,200200,49264
2125,1873,252,843,208700,49265
1264,1103,161,687,129300,49266
1472,1299,173,1186,203900,49267
504,420,84,752,122800,49268
2081,1850,231,806,151500,49269
2038,1859,179,800,223400,49270
859,642,217,821,117200,49271
1001,961,40,-,165200,49272
1432,1136,296,707,150600,49274
394,357,37,1040,147400,49276
1184,1075,109,917,150600,49277
379,331,48,713,140900,49279
30,20,10,-,-,49282
1002,776,226,726,186600,49283
1076,912,164,934,132500,49284
2477,2053,424,725,167500,49285
5762,4467,1295,855,173200,49286
844,781,63,-,176900,49287
539,385,154,725,112200,49288
23,23,0,-,66300,49289
6941,6665,276,1679,410100,49301
3020,2914,106,1110,300600,49302
325,273,52,780,152500,49303
1521,1148,373,593,89700,49304
1063,900,163,722,89400,49305
3939,3797,142,-,273500,49306
7082,4367,2715,742,141200,49307
759,658,101,659,99000,49309
996,934,62,775,135800,49310
99,88,11,789,90000,49312
8738,7879,859,1112,278800,49315
8949,7926,1023,1113,273500,49316
484,417,67,1068,173400,49318
6997,6098,899,957,186700,49319
112,74,38,962,140900,49320
6731,4439,2292,880,195500,49321
422,341,81,1023,120700,49322
3714,3622,92,1015,217500,49323
745,679,66,808,175900,49325
1452,1349,103,838,160200,49326
3131,2583,548,676,153600,49327
1559,1395,164,691,170400,49328
3134,2655,479,814,138500,49329
1855,1472,383,924,179400,49330
6600,5584,1016,943,244900,49331
1414,1284,130,744,125000,49332
4835,4161,674,1067,236300,49333
12,12,0,-,-,49335
1540,1287,253,832,99500,49336
4768,4038,730,778,149900,49337
696,571,125,962,121100,49338
823,746,77,855,162600,49339
998,836,162,634,120400,49340
14091,12866,1225,1067,264600,49341
547,467,80,962,99000,49342
2177,1856,321,706,177200,49343
1455,1256,199,911,235700,49344
4909,4240,669,817,188900,49345
2020,1810,210,753,179300,49346
563,494,69,839,113900,49347
5163,4143,1020,1059,202000,49348
3026,2572,454,749,106400,49349
8022,4542,3480,1088,230300,49401
681,617,64,800,133600,49402
934,860,74,1100,212900,49403
3087,2552,535,904,225600,49404
605,540,65,744,117000,49405
386,356,30,1536,363900,49406
3779,3213,566,802,166100,49408
61,61,0,-,109700,49409
709,621,88,979,116600,49410
720,691,29,971,175600,49411
4454,3695,759,770,141800,49412
2643,2477,166,896,175900,49415
13079,10225,2854,916,236400,49417
11774,8983,2791,985,224500,49418
3004,2657,347,862,257400,49419
2319,1924,395,749,120300,49420
2130,1836,294,689,112700,49421
17196,12541,4655,976,198800,49423
18059,13772,4287,976,209200,49424
1319,1117,202,723,123100,49425
13399,12108,1291,1008,262300,49426
10250,8621,1629,1165,214400,49428
32,32,0,-,-,49430
7392,5364,2028,777,170000,49431
12,12,0,-,-,49434
1373,1244,129,800,218900,49435
733,655,78,719,182800,49436
2566,2193,373,713,156100,49437
657,135,522,540,157100,49440
14690,10535,4155,872,143000,49441
15716,10476,5240,768,90300,49442
0,0,0,-,-,49443
9628,6866,2762,868,109700,49444
8712,7886,826,974,159700,49445
792,699,93,704,152500,49446
1620,1325,295,693,211700,49448
1182,1034,148,637,232800,49449
983,612,371,799,100200,49450
2181,1909,272,841,162100,49451
763,681,82,686,102000,49452
1256,1063,193,732,378200,49453
1770,1332,438,693,126700,49454
1808,1507,301,788,108900,49455
8775,7114,1661,920,243600,49456
3990,3727,263,757,155500,49457
38,35,3,-,86400,49458
554,474,80,889,81400,49459
2949,2745,204,1132,279500,49460
3630,3137,493,744,193400,49461
10380,9184,1196,918,234900,49464
16301,6368,9933,981,173200,49503
16544,9798,6746,980,168200,49504
13575,8859,4716,1035,168100,49505
12462,9443,3019,1097,271400,49506
12726,7727,4999,961,135700,49507
15761,9307,6454,1049,184300,49508
10415,7258,3157,917,139200,49509
8530,3687,4843,991,225800,49512
10935,6129,4806,974,158800,49519
11868,9646,2222,1254,238200,49525
9323,6259,3064,1033,221200,49534
4311,2546,1765,938,192300,49544
13084,8884,4200,1110,305000,49546
12437,8972,3465,956,116700,49548
8731,6725,2006,723,129700,49601
146,138,8,-,82200,49611
601,530,71,782,202300,49612
285,268,17,788,203900,49613
1134,1073,61,950,154700,49614
1805,1534,271,659,221000,49615
853,760,93,810,163300,49616
1211,1143,68,692,241200,49617
363,317,46,943,126800,49618
358,315,43,896,118400,49619
976,816,160,952,153200,49620
1404,1285,119,1083,248200,49621
1035,915,120,939,152500,49622
422,397,25,925,102700,49623
493,448,45,850,131500,49625
115,114,1,-,95000,49626
80,73,7,-,628700,49627
81,77,4,-,170300,49628
960,764,196,1019,264400,49629
682,620,62,417,343800,49630
2208,1807,401,685,97300,49631
475,406,69,765,114500,49632
1470,1306,164,883,124900,49633
40,40,0,-,84200,49634
1318,1099,219,913,251300,49635
257,257,0,-,720500,49636
1135,1046,89,1078,151800,49637
339,304,35,684,105200,49638
958,816,142,762,99600,49639
549,526,23,729,263500,49640
383,290,93,641,65100,49642
2817,2466,351,591,216200,49643
801,750,51,700,143000,49644
685,567,118,840,116600,49645
3455,2744,711,707,131100,49646
1150,1078,72,1141,318100,49648
2273,1958,315,882,191200,49649
1268,1203,65,1360,202500,49650
3102,2536,566,807,131800,49651
733,691,42,821,351500,49653
292,201,91,1102,545300,49654
1168,1058,110,719,130900,49655
625,546,79,893,95900,49656
1327,1029,298,690,142600,49657
2826,2489,337,777,111200,49659
5614,4595,1019,732,149600,49660
2157,1799,358,792,112000,49663
802,726,76,1025,303200,49664
1545,1369,176,598,108100,49665
264,199,65,714,94800,49667
1299,1113,186,896,114700,49668
825,777,48,1339,375000,49670
41,41,0,-,506000,49674
376,312,64,563,220800,49675
1410,1263,147,746,190300,49676
2728,2148,580,636,98700,49677
449,416,33,1063,155700,49679
677,619,58,861,115600,49680
1832,1547,285,797,301500,49682
812,661,151,722,134400,49683
8985,5977,3008,1055,288500,49684
8353,6504,1849,1122,232300,49685
11063,7992,3071,1052,244800,49686
836,720,116,836,130600,49688
612,569,43,549,122100,49689
2517,2188,329,1080,257700,49690
3848,3422,426,994,238800,49696
358,284,74,616,184000,49701
322,269,53,737,155400,49705
2081,1612,469,708,160400,49706
9889,7465,2424,591,110700,49707
1639,1495,144,583,106100,49709
181,139,42,500,118600,49710
3738,3153,585,900,201600,49712
920,826,94,871,164800,49713
1334,1161,173,583,125800,49715
328,319,9,1458,227900,49716
73,73,0,-,264400,49717
260,191,69,950,146600,49718
648,542,106,775,197500,49719
4160,3188,972,765,213000,49720
5658,4740,918,746,141100,49721
43,43,0,-,-,49722
367,343,24,1058,144800,49724
299,285,14,781,153600,49725
552,513,39,717,186700,49726
2919,2465,454,659,145000,49727
148,127,21,830,122200,49728
666,593,73,900,154700,49729
799,735,64,833,135800,49730
730,642,88,840,111000,49733
8583,6261,2322,755,158400,49735
219,200,19,-,112000,49736
4127,3245,882,775,120800,49738
3220,2868,352,974,258800,49740
349,337,12,600,115500,49743
339,296,43,845,160100,49744
471,326,145,639,110600,49745
1545,1282,263,623,112500,49746
872,789,83,729,135100,49747
71,62,9,700,115600,49748
2047,1744,303,731,158100,49749
870,771,99,865,143200,49751
292,266,26,-,111300,49752
798,745,53,681,113300,49753
760,697,63,855,134300,49755
1809,1620,189,788,120900,49756
424,152,272,908,422700,49757
708,663,45,583,129700,49759
357,331,26,995,99200,49760
297,277,20,-,108900,49762
79,36,43,-,-,49764
1713,1459,254,510,90600,49765
901,794,107,656,109200,49766
191,168,23,-,160600,49768
685,538,147,913,110400,49769
7305,5117,2188,953,232400,49770
924,845,79,853,136400,49774
24,24,0,-,175000,49775
672,579,93,538,100700,49776
867,840,27,823,184400,49777
2086,1766,320,597,103500,49779
584,548,36,1016,105800,49780
1692,1117,575,593,127000,49781
301,277,24,625,270500,49782
7786,4965,2821,754,119600,49783
0,0,0,-,-,49784
879,362,517,761,82900,49788
106,87,19,-,177200,49791
62,62,0,-,162500,49793
791,634,157,817,133700,49795
171,133,38,1000,196900,49796
917,810,107,773,129600,49799
5216,4216,1000,667,139500,49801
2635,1957,678,680,88300,49802
211,178,33,-,104400,49805
238,223,15,-,225600,49806
1402,1254,148,646,131400,49807
122,90,32,-,187000,49808
335,289,46,1260,121800,49812
438,412,26,636,108900,49814
132,121,11,-,100400,49815
280,266,14,605,146400,49816
262,234,28,717,167300,49817
470,458,12,-,138200,49818
106,89,17,331,142700,49820
506,465,41,875,110100,49821
83,70,13,800,158300,49822
94,94,0,-,147000,49825
52,16,36,-,-,49826
427,325,102,738,91400,49827
7573,5232,2341,541,111500,49829
262,253,9,1125,118800,49831
42,42,0,-,95000,49833
210,193,17,675,112500,49834
314,286,28,875,127700,49835
464,411,53,592,151100,49836
3782,3096,686,733,133700,49837
204,195,9,-,144500,49838
161,124,37,734,147300,49839
306,281,25,967,155300,49840
2840,1927,913,670,134200,49841
478,407,71,610,98300,49847
41,36,5,-,87300,49848
4892,3947,945,618,118200,49849
57,54,3,-,67500,49852
455,418,37,705,146000,49853
2824,2351,473,540,118400,49854
13278,8200,5078,885,193700,49855
5229,3973,1256,639,102200,49858
224,213,11,492,191900,49861
1446,1089,357,638,127900,49862
74,74,0,-,56300,49863
26,20,6,-,-,49864
3343,2897,446,656,157700,49866
1703,1250,453,780,80000,49868
1547,1267,280,648,106400,49870
220,179,41,644,64700,49871
98,80,18,638,136400,49872
43,43,0,-,143800,49873
369,286,83,515,151000,49874
496,464,32,-,98100,49876
4,2,2,-,-,49877
1467,1340,127,513,139600,49878
554,485,69,708,74300,49879
489,440,49,719,119000,49880
138,128,10,-,238500,49881
61,56,5,-,133300,49883
222,158,64,633,134800,49884
673,657,16,1097,170500,49885
226,195,31,992,100800,49886
1061,906,155,604,144700,49887
210,200,10,1125,158300,49891
829,755,74,721,161400,49892
559,531,28,573,157100,49893
312,312,0,-,104900,49894
338,273,65,-,159700,49895
521,392,129,406,144300,49896
145,144,1,-,72500,49901
104,89,15,554,29400,49902
114,104,10,333,50000,49903
760,698,62,888,178600,49905
1006,703,303,527,110200,49908
128,120,8,-,179200,49910
1181,973,208,461,87900,49911
422,376,46,-,98800,49912
2968,2214,754,569,71000,49913
223,179,44,725,46300,49915
1215,985,230,720,167500,49916
81,75,6,750,59200,49917
56,46,10,-,225000,49918
51,51,0,-,85000,49919
1828,1649,179,752,99900,49920
117,34,83,1577,55300,49921
348,274,74,734,109000,49922
259,227,32,-,85000,49925
166,155,11,1125,54100,49927
78,78,0,-,58600,49929
2662,1724,938,680,139600,49930
3095,1277,1818,754,204400,49931
354,329,25,688,66900,49934
2612,2061,551,521,84400,49935
3704,2823,881,484,72700,49938
91,78,13,-,69500,49942
1295,1029,266,463,110500,49945
1579,1224,355,561,90700,49946
324,319,5,-,86100,49947
229,207,22,1611,60700,49948
527,463,64,554,159400,49950
53,46,7,-,141700,49952
1097,936,161,521,77100,49953
139,139,0,-,66800,49955
381,365,16,-,136600,49958
186,141,45,509,70500,49959
85,85,0,-,46300,49960
62,62,0,-,74300,49961
111,109,2,-,157800,49962
245,189,56,635,72000,49963
240,235,5,-,211800,49965
192,189,3,-,89600,49967
933,783,150,588,61200,49968
517,406,111,475,254500,49969
140,129,11,-,-,49970
205,191,14,615,45700,49971
230,207,23,1225,325000,50001
589,437,152,848,144000,50002
3441,2678,763,698,293000,50003
374,312,62,780,111000,50005
674,443,231,532,108000,50006
203,203,0,-,247300,50007
317,264,53,527,71700,50008
7688,5402,2286,1072,218700,50009
14020,7495,6525,894,206900,50010
0,0,0,-,-,50012
0,0,0,-,-,50013
12611,4675,7936,1033,248200,50014
535,470,65,803,91000,50020
11411,8487,2924,1248,241800,50021
3789,2500,1289,640,134200,50022
15555,11115,4440,1094,259500,50023
1357,1059,298,677,86000,50025
201,159,42,911,85000,50026
157,112,45,760,67600,50027
668,517,151,641,166400,50028
248,209,39,721,57300,50029
16,16,0,-,48900,50031
238,238,0,-,43200,50032
7,6,1,-,-,50033
134,110,24,595,86800,50034
2987,2713,274,1038,251100,50035
6521,5127,1394,784,130200,50036
90,90,0,-,-,50038
182,153,29,775,223600,50039
66,44,22,-,72900,50040
47,26,21,-,-,50041
88,80,8,900,85000,50042
400,342,58,571,108300,50044
729,615,114,905,168300,50046
2234,1884,350,872,181700,50047
339,249,90,931,89100,50048
2651,1895,756,675,98200,50049
283,229,54,738,78200,50050
136,134,2,-,-,50051
43,38,5,-,70000,50052
1120,919,201,761,142400,50054
456,333,123,712,175600,50055
484,391,93,1092,141800,50056
112,112,0,-,137100,50057
762,580,182,662,127000,50058
1002,732,270,675,89600,50060
793,767,26,790,490400,50061
292,238,54,629,93100,50062
971,835,136,625,225200,50063
63,43,20,-,111200,50064
274,217,57,703,72000,50065
111,94,17,1016,-,50066
113,108,5,1063,69200,50067
115,114,1,-,193800,50068
409,338,71,743,165000,50069
484,403,81,1040,171300,50070
381,311,70,583,53200,50071
1059,890,169,868,252400,50072
497,422,75,745,245300,50073
143,119,24,-,346300,50074
310,224,86,804,132100,50075
648,545,103,550,85900,50076
44,32,12,813,45000,50078
15,7,8,-,-,50101
50,50,0,-,52500,50102
155,133,22,600,65600,50103
41,30,11,706,70000,50104
467,393,74,907,226500,50105
429,358,71,600,88300,50106
361,247,114,696,76000,50107
151,127,24,575,54600,50108
1325,1146,179,1013,285700,50109
18,18,0,-,46700,50110
5945,4149,1796,934,247500,50111
4782,3075,1707,742,163700,50112
1151,885,266,702,120800,50115
70,69,1,-,-,50116
61,49,12,-,137500,50117
321,299,22,1063,144900,50118
139,108,31,772,81500,50119
179,157,22,-,142200,50120
575,501,74,585,94800,50122
361,305,56,575,89000,50123
1604,1420,184,955,240000,50124
7523,5484,2039,845,203300,50125
2767,1968,799,818,107700,50126
0,0,0,-,-,50127
156,125,31,575,83900,50128
2313,1692,621,777,103800,50129
575,483,92,817,112600,50130
9352,6620,2732,1159,288700,50131
139,100,39,725,63300,50132
219,173,46,698,137500,50133
303,234,69,860,205000,50134
550,419,131,679,124300,50135
175,136,39,841,85000,50136
36,22,14,-,-,50137
5106,3715,1391,723,124000,50138
456,419,37,760,115000,50139
1056,623,433,625,96100,50140
185,177,8,425,120100,50141
358,301,57,633,120100,50142
230,183,47,578,192000,50143
1069,647,422,485,109800,50144
33,33,0,-,207500,50145
181,144,37,864,146200,50146
159,115,44,521,48000,50147
179,156,23,595,86800,50148
353,268,85,734,119700,50149
377,326,51,645,93700,50150
257,237,20,1700,144000,50151
65,54,11,-,150000,50152
404,349,55,710,140100,50153
261,205,56,592,146900,50154
85,77,8,-,87400,50155
1986,1664,322,763,174500,50156
289,169,120,689,93200,50157
11669,8010,3659,783,103500,50158
240,181,59,723,137500,50160
857,733,124,644,163500,50161
526,363,163,1122,130800,50162
320,268,52,688,79200,50163
256,217,39,511,117600,50164
16,14,2,-,105000,50165
673,617,56,750,180100,50166
332,254,78,817,145900,50167
349,281,68,813,221800,50168
931,750,181,745,160000,50169
1241,1026,215,731,151100,50170
1163,833,330,796,192900,50171
329,271,58,750,142600,50173
444,359,85,805,93400,50174
3551,2649,902,789,156000,50201
187,157,30,541,93000,50206
972,717,255,517,125700,50207
7752,5670,2082,745,133100,50208
584,535,49,906,262900,50210
5670,4775,895,908,254700,50211
1213,974,239,674,158200,50212
2901,1946,955,568,124300,50213
281,264,17,-,256700,50214
1152,975,177,928,186900,50216
222,195,27,475,115500,50217
138,124,14,725,97500,50218
4956,3596,1360,865,226400,50219
3557,2230,1327,809,112600,50220
167,160,7,850,154800,50222
141,104,37,575,106800,50223
1273,997,276,766,154200,50225
2362,2147,215,1026,326600,50226
27,21,6,-,62900,50227
932,724,208,869,155900,50228
369,367,2,-,334800,50229
393,349,44,486,120900,50230
73,60,13,763,102500,50231
263,179,84,876,205500,50232
552,490,62,717,170200,50233
187,177,10,-,114600,50234
122,90,32,1022,88000,50235
783,650,133,728,158600,50236
1352,1235,117,576,307800,50237
515,453,62,634,65700,50238
32,26,6,-,-,50239
894,740,154,728,227700,50240
55,40,15,1042,128600,50241
194,154,40,779,137500,50242
129,111,18,950,145500,50243
781,655,126,765,194500,50244
294,212,82,491,95000,50246
905,701,204,699,152700,50247
1759,1296,463,867,164300,50248
524,435,89,725,98900,50249
1018,787,231,745,148300,50250
550,478,72,821,139600,50251
114,112,2,-,281300,50252
80,80,0,-,-,50254
40,40,0,-,17500,50255
262,234,28,-,121200,50256
392,342,50,855,195600,50257
378,348,30,572,92500,50258
1007,870,137,873,238300,50261
116,112,4,-,63900,50262
9513,6881,2632,1119,267400,50263
203,178,25,675,-,50264
14380,9380,5000,955,218700,50265
16383,8620,7763,1148,281300,50266
390,280,110,772,60700,50268
62,49,13,-,45700,50269
250,210,40,607,115000,50271
54,52,2,-,55600,50272
3441,2651,790,964,182500,50273
90,73,17,-,134600,50274
209,175,34,675,154700,50275
855,765,90,852,201800,50276
200,162,38,684,95700,50277
308,235,73,669,139200,50278
6141,727,5414,992,306100,50309
13007,9221,3786,934,169400,50310
6386,3069,3317,850,179600,50311
7767,4969,2798,970,226500,50312
6955,5146,1809,986,124900,50313
3909,1598,2311,843,115900,50314
14956,9104,5852,853,134800,50315
5376,3350,2026,832,108100,50316
14082,9936,4146,953,132400,50317
0,0,0,-,-,50319
8067,6016,2051,944,175400,50320
3377,1975,1402,1028,217300,50321
12592,8899,3693,987,213800,50322
5435,4879,556,1037,366500,50323
2137,1629,508,1112,202200,50324
6959,5322,1637,1007,309700,50325
4503,3566,937,1033,247900,50327
13410,9038,4372,779,118900,50401
146,115,31,369,70800,50420
1124,899,225,668,92700,50421
1118,932,186,935,90500,50423
714,574,140,591,95600,50424
46,35,11,850,51500,50426
77,77,0,-,74800,50427
4138,2994,1144,696,202100,50428
191,152,39,493,54500,50430
80,49,31,588,67300,50431
114,94,20,725,79000,50432
81,77,4,-,117000,50433
259,237,22,709,-,50434
248,184,64,760,121000,50435
2196,1699,497,663,130800,50436
1673,1278,395,700,138400,50438
125,117,8,-,77200,50439
174,126,48,578,96000,50440
2182,1547,635,712,92200,50441
136,110,26,706,109800,50444
215,169,46,650,119800,50446
526,427,99,652,67500,50447
336,276,60,600,109700,50448
352,268,84,688,82500,50449
1233,901,332,639,121700,50450
187,143,44,725,39300,50451
391,236,155,867,105600,50452
220,192,28,764,131500,50453
40,40,0,-,83300,50454
142,138,4,-,102500,50455
702,510,192,569,95000,50456
152,121,31,754,76600,50457
886,773,113,674,124700,50458
1277,1049,228,850,121600,50459
177,127,50,468,200800,50460
2304,1923,381,635,121800,50461
213,182,31,1022,123200,50464
78,67,11,750,34200,50465
776,538,238,593,123000,50466
49,40,9,850,133300,50467
575,440,135,703,104800,50468
590,499,91,483,152400,50469
95,83,12,600,54400,50470
274,201,73,763,82000,50471
1037,830,207,756,179900,50472
104,93,11,-,66900,50473
523,453,70,600,115500,50475
304,258,46,563,72100,50476
95,53,42,581,57000,50477
414,331,83,663,89400,50478
282,224,58,605,99000,50479
321,305,16,750,62500,50480
317,253,64,874,172300,50482
288,259,29,536,144200,50483
153,147,6,-,92100,50484
12008,7733,4275,704,111800,50501
413,299,114,641,86400,50510
3250,2285,965,795,155400,50511
557,482,75,597,89000,50514
117,89,28,758,34200,50515
321,267,54,667,109500,50516
429,310,119,575,79300,50517
138,128,10,500,117500,50518
261,189,72,494,85000,50519
63,58,5,-,38400,50520
14,0,14,-,-,50521
353,302,51,873,71100,50522
222,165,57,-,82800,50523
232,189,43,594,200400,50524
1563,1079,484,650,95300,50525
52,46,6,-,70000,50527
119,81,38,500,109500,50528
367,286,81,835,87500,50529
511,389,122,588,111700,50530
103,81,22,-,100500,50531
336,259,77,644,158800,50532
1581,1125,456,718,90000,50533
474,351,123,725,82500,50535
1868,1349,519,549,129800,50536
226,168,58,650,59300,50538
186,177,9,625,65500,50539
429,353,76,518,85900,50540
402,305,97,661,80900,50541
386,337,49,793,82300,50542
548,466,82,585,92800,50543
215,184,31,625,131900,50544
75,71,4,-,159400,50545
171,143,28,625,53900,50546
2490,1691,799,603,143200,50548
20,8,12,-,-,50551
29,25,4,-,-,50552
771,606,165,668,69100,50554
84,76,8,413,38300,50556
376,299,77,545,90500,50557
228,204,24,1000,104000,50558
136,79,57,713,143800,50559
231,169,62,641,61300,50560
221,178,43,475,64300,50561
167,135,32,796,59800,50562
1148,906,242,607,133800,50563
159,148,11,820,61300,50565
185,162,23,950,176600,50566
106,98,8,690,148300,50567
539,428,111,638,106700,50568
348,298,50,553,76500,50569
74,48,26,-,118300,50570
146,135,11,-,51500,50571
25,20,5,-,-,50573
986,751,235,622,99000,50574
303,257,46,608,66200,50575
129,94,35,758,80000,50576
183,164,19,650,58300,50577
243,209,34,587,48600,50578
1028,786,242,651,91500,50579
333,259,74,831,77500,50581
105,93,12,550,57500,50582
1161,824,337,550,106400,50583
489,403,86,767,80400,50585
116,109,7,588,110400,50586
4628,2850,1778,736,151700,50588
377,305,72,565,53700,50590
168,125,43,1125,156000,50591
53,26,27,1081,-,50592
17,17,0,-,43800,50593
133,66,67,701,162500,50594
3637,2495,1142,775,97400,50595
446,354,92,550,152500,50597
370,339,31,575,97000,50598
224,196,28,660,130600,50599
1028,836,192,547,96100,50601
662,495,167,527,98000,50602
171,152,19,500,83200,50603
669,531,138,643,134200,50604
112,92,20,675,46300,50605
315,259,56,454,96400,50606
162,159,3,-,127700,50607
28,28,0,-,162500,50608
160,151,9,708,160400,50609
172,125,47,725,70900,50611
156,134,22,-,257900,50612
16415,10844,5571,992,216200,50613
4306,3014,1292,578,109800,50616
825,607,218,787,126000,50619
27,22,5,-,92000,50620
639,477,162,850,140900,50621
1190,1055,135,817,218900,50622
66,66,0,-,-,50623
639,542,97,641,212500,50624
378,306,72,669,70600,50625
600,503,97,684,176200,50626
1274,919,355,633,93600,50627
514,412,102,494,108000,50628
873,734,139,622,156000,50629
690,558,132,676,146400,50630
114,83,31,588,82100,50631
548,471,77,608,95200,50632
218,99,119,477,71000,50633
337,289,48,692,149000,50634
570,475,95,675,122100,50635
944,765,179,732,124300,50636
1326,1116,210,655,142900,50638
445,374,71,700,104800,50641
235,207,28,977,180100,50642
1091,1001,90,910,207000,50643
3516,2663,853,778,157100,50644
579,521,58,607,89100,50645
814,756,58,575,241800,50647
1418,1244,174,777,169800,50648
4,4,0,-,-,50649
313,243,70,720,85500,50650
1357,1082,275,727,153400,50651
47,40,7,775,93300,50652
243,201,42,572,100500,50653
147,127,20,1125,-,50654
325,251,74,565,113200,50655
40,35,5,-,104200,50657
1031,789,242,666,114600,50658
2347,1909,438,658,145800,50659
453,371,82,734,122200,50660
2840,2023,817,711,97300,50662
83,83,0,-,115500,50664
1095,878,217,716,177200,50665
310,256,54,863,155200,50666
320,294,26,675,179200,50667
429,385,44,705,144100,50668
971,755,216,779,136000,50669
907,782,125,570,155200,50670
112,72,40,588,95000,50671
207,144,63,597,107900,50672
74,66,8,775,103100,50673
1519,1274,245,733,134200,50674
909,689,220,897,127800,50675
902,773,129,667,124400,50676
4636,3655,981,825,193800,50677
451,400,51,542,86500,50680
177,158,19,763,89200,50681
621,529,92,829,150200,50682
13026,8533,4493,781,155800,50701
8642,5322,3320,792,122300,50702
7910,4296,3614,858,73400,50703
3531,2560,971,776,111100,50707
3782,2745,1037,669,113500,50801
649,511,138,620,97200,50830
10,9,1,-,-,50831
855,682,173,580,86000,50833
38,24,14,-,108300,50835
186,148,38,650,104500,50836
158,140,18,1025,68900,50837
25,25,0,-,-,50839
268,227,41,542,-,50840
1055,828,227,664,85000,50841
32,31,1,-,62500,50842
196,136,60,654,63300,50843
271,230,41,800,96400,50845
472,336,136,710,79400,50846
36,26,10,-,35000,50847
95,80,15,618,-,50848
1124,723,401,560,113700,50849
826,676,150,520,100000,50851
315,241,74,594,129400,50853
953,690,263,620,102900,50854
88,78,10,-,171400,50857
324,278,46,610,104000,50858
275,232,43,1039,86700,50859
53,49,4,-,207000,50860
121,114,7,863,95000,50861
62,51,11,1042,-,50862
72,62,10,658,64300,50863
838,616,222,712,90300,50864
945,674,271,666,130400,51001
1008,809,199,798,120900,51002
665,582,83,685,178000,51003
450,324,126,1022,88200,51004
669,485,184,549,133900,51005
474,357,117,388,71800,51006
231,231,0,-,167100,51007
68,48,20,-,115600,51008
63,47,16,434,62500,51009
205,166,39,671,108600,51010
28,23,5,681,110400,51011
2747,1981,766,536,129500,51012
254,186,68,1005,114000,51014
32,32,0,-,112000,51015
476,445,31,375,82500,51016
252,200,52,531,311500,51018
224,186,38,600,91300,51019
228,147,81,548,73500,51020
319,272,47,684,139700,51022
1209,872,337,751,119000,51023
883,721,162,907,303400,51024
784,611,173,614,107300,51025
366,352,14,1071,203700,51026
471,404,67,840,196700,51027
881,702,179,626,170700,51028
162,151,11,-,125700,51029
624,529,95,600,229900,51030
5022,3592,1430,797,172300,51031
205,173,32,914,94300,51033
731,569,162,657,87600,51034
712,568,144,543,132200,51035
287,260,27,714,231300,51036
111,90,21,-,-,51037
679,589,90,-,158200,51038
1090,889,201,800,171000,51039
1459,1071,388,710,104700,51040
2390,1856,534,714,197900,51041
103,89,14,525,76500,51044
32,32,0,-,160000,51045
656,504,152,648,116200,51046
310,276,34,675,88800,51047
185,125,60,756,83800,51048
271,239,32,575,58400,51049
1037,828,209,638,178100,51050
26,23,3,-,-,51051
471,383,88,730,205500,51052
434,403,31,614,88500,51053
1924,1494,430,988,235700,51054
526,424,102,813,161500,51055
170,159,11,817,72500,51056
446,366,80,350,81700,51058
290,217,73,620,72500,51060
146,100,46,493,51300,51061
235,194,41,635,304000,51062
450,340,110,827,98100,51063
338,40,298,499,170800,51101
6448,4064,2384,826,98300,51103
8418,5510,2908,865,160700,51104
3886,1608,2278,734,70300,51105
10762,7860,2902,875,156100,51106
2017,1842,175,912,132500,51108
1422,1116,306,895,107800,51109
30,0,30,-,-,51111
2379,1637,742,624,156200,51201
194,193,1,-,163400,51230
209,171,38,-,159900,51231
343,280,63,800,84500,51232
442,383,59,826,162500,51234
367,316,51,580,198800,51235
723,583,140,731,100200,51237
519,463,56,558,146800,51238
1056,915,141,765,188100,51239
696,552,144,1045,155000,51240
787,700,87,775,245600,51241
114,95,19,-,153400,51242
259,235,24,550,71700,51243
62,60,2,-,91700,51244
463,375,88,718,108500,51245
1275,1073,202,695,201400,51246
1800,1433,367,880,187400,51247
683,531,152,765,119200,51248
1408,1074,334,692,117600,51249
3095,2380,715,735,237500,51250
5418,3590,1828,710,144100,51301
580,466,114,673,262900,51331
171,141,30,875,193800,51333
2823,2156,667,685,93800,51334
394,312,82,590,101000,51338
44,41,3,-,79400,51340
17,16,1,-,-,51341
563,457,106,475,76100,51342
75,70,5,-,103600,51343
212,126,86,838,122100,51345
841,657,184,685,86500,51346
653,563,90,919,146200,51347
188,137,51,-,56800,51350
2038,1700,338,841,209200,51351
515,457,58,593,88800,51354
461,339,122,902,294000,51355
314,242,72,734,77500,51357
562,434,128,545,119100,51358
3991,2929,1062,909,221300,51360
69,66,3,-,71800,51363
315,265,50,806,112500,51364
159,132,27,595,98900,51365
137,109,28,908,102300,51366
5285,3816,1469,639,158300,51401
407,297,110,708,131100,51430
211,155,56,574,74200,51431
13,13,0,-,68800,51432
215,122,93,648,68300,51433
378,272,106,690,169400,51436
350,237,113,668,60500,51439
106,105,1,-,114600,51440
145,132,13,630,85000,51441
3323,2117,1206,710,104300,51442
550,488,62,583,142900,51443
143,140,3,-,118800,51444
1143,907,236,563,109000,51445
232,192,40,1039,107700,51446
86,74,12,681,253800,51447
236,189,47,700,97500,51448
804,653,151,622,90600,51449
676,590,86,536,128700,51450
38,34,4,-,66000,51451
76,62,14,400,95600,51452
231,183,48,806,70500,51453
472,383,89,574,110300,51454
1025,860,165,563,108200,51455
496,437,59,535,87000,51458
31,27,4,-,60800,51459
47,35,12,700,31500,51460
537,396,141,447,107600,51461
429,329,100,805,120400,51462
226,197,29,775,151100,51463
288,250,38,675,98100,51465
438,389,49,606,167000,51466
237,216,21,625,132100,51467
14122,9114,5008,876,109500,51501
14845,10216,4629,913,198300,51503
1357,1037,320,1016,124400,51510
83,76,7,706,-,51520
819,648,171,762,150600,51521
156,136,20,792,94500,51523
479,384,95,606,153400,51525
678,586,92,817,235200,51526
231,203,28,610,118000,51527
300,193,107,614,85000,51528
784,527,257,732,109100,51529
251,180,71,634,113500,51530
282,222,60,539,129300,51531
261,196,65,643,75400,51532
418,333,85,844,134400,51533
3348,2710,638,727,214900,51534
726,599,127,817,105800,51535
174,152,22,725,87900,51536
2865,2044,821,908,142100,51537
121,108,13,-,159600,51540
137,105,32,867,122900,51541
374,353,21,1359,280900,51542
181,126,55,867,88500,51543
285,259,26,633,69100,51544
123,97,26,463,36900,51545
1215,981,234,792,156500,51546
183,167,16,-,187500,51548
217,181,36,730,150800,51549
55,50,5,-,76700,51550
635,518,117,838,164600,51551
127,98,29,635,178000,51552
381,324,57,644,166300,51553
48,48,0,-,125000,51554
1899,1356,543,723,131100,51555
194,170,24,950,120500,51556
379,342,37,758,127300,51557
234,201,33,1013,63100,51558
720,512,208,899,164800,51559
760,527,233,682,127200,51560
321,292,29,922,215800,51561
188,175,13,-,163900,51562
276,219,57,873,144000,51563
199,164,35,675,71400,51564
249,152,97,716,118500,51565
2894,1984,910,689,89700,51566
419,318,101,812,130700,51570
210,152,58,2647,150000,51571
221,167,54,511,80600,51572
391,323,68,836,96100,51573
590,499,91,881,203600,51575
698,617,81,843,254100,51576
459,344,115,813,115500,51577
62,52,10,650,82500,51578
836,644,192,780,155900,51579
2343,1456,887,708,93500,51601
58,58,0,-,-,51630
145,107,38,850,134400,51631
2504,1723,781,662,107500,51632
213,159,54,757,95000,51636
112,109,3,688,60400,51637
616,490,126,600,71700,51638
334,258,76,573,110600,51639
660,503,157,642,94600,51640
108,93,15,-,116000,51645
340,278,62,739,83900,51646
96,82,14,-,-,51647
142,124,18,-,151700,51648
118,100,18,1014,153800,51649
119,106,13,717,39200,51650
68,62,6,825,66400,51651
604,461,143,598,104600,51652
521,399,122,723,173700,51653
130,80,50,1205,206700,51654
16,15,1,-,72500,51656
18026,11505,6521,816,139200,52001
6900,5097,1803,906,231400,52002
5423,4674,749,885,226200,52003
161,113,48,785,98100,52030
2041,1782,259,639,191800,52031
580,547,33,613,180700,52032
1246,997,249,738,175600,52033
441,376,65,630,127200,52035
64,45,19,550,114000,52036
368,339,29,708,149200,52037
187,153,34,569,155200,52038
325,319,6,975,219500,52039
2364,2065,299,916,184100,52040
737,611,126,681,172400,52041
614,474,140,496,158200,52042
853,607,246,723,120700,52043
75,70,5,-,-,52044
1050,817,233,775,199200,52045
937,755,182,841,225900,52046
270,238,32,557,103600,52047
131,85,46,702,137500,52048
501,432,69,729,141700,52049
199,153,46,706,143800,52050
1332,1025,307,739,166800,52052
450,356,94,-,178600,52053
335,284,51,1054,188500,52054
85,83,2,-,143400,52056
3315,2731,584,704,145800,52057
3415,2662,753,610,109900,52060
319,264,55,663,141900,52064
318,264,54,931,173000,52065
46,41,5,-,92500,52066
1672,1510,162,549,291200,52068
604,447,157,678,148800,52069
491,392,99,667,157000,52070
63,62,1,-,167500,52071
220,123,97,-,143800,52072
574,506,68,846,267400,52073
121,104,17,1393,221100,52074
66,58,8,-,125000,52075
931,681,250,592,115100,52076
140,120,20,588,63800,52077
261,209,52,604,168300,52078
351,283,68,700,206100,52079
5088,3779,1309,753,210400,52101
708,507,201,648,186300,52132
247,236,11,688,97300,52133
113,106,7,413,158300,52134
291,248,43,496,111400,52135
2299,1756,543,764,131500,52136
226,213,13,-,160500,52140
534,471,63,575,78700,52141
634,389,245,713,100400,52142
454,431,23,638,145600,52144
396,359,37,683,166800,52146
410,357,53,717,123900,52147
848,687,161,665,121800,52151
349,305,44,575,138900,52154
547,468,79,618,106100,52155
223,200,23,919,184800,52156
822,588,234,668,147100,52157
161,129,32,575,89500,52158
1047,782,265,847,130700,52159
399,362,37,569,182300,52160
612,526,86,638,140400,52161
1187,837,350,762,109700,52162
147,137,10,600,79500,52163
123,116,7,-,117300,52164
449,394,55,582,242500,52165
55,54,1,-,74300,52166
201,138,63,809,129900,52168
156,130,26,492,95000,52169
254,238,16,525,185900,52170
409,313,96,623,127100,52171
2605,2051,554,658,141000,52172
1465,1008,457,715,129300,52175
565,445,120,725,143500,52201
402,334,68,535,176700,52202
923,816,107,638,205100,52203
3093,2431,662,793,170300,52205
966,903,63,503,251000,52206
139,133,6,-,73800,52207
1266,1061,205,609,96300,52208
393,304,89,635,131600,52209
276,209,67,855,127100,52210
1155,858,297,798,135700,52211
187,154,33,-,116700,52212
1537,1286,251,919,205200,52213
1213,1015,198,893,212500,52214
368,348,20,428,113000,52215
612,416,196,754,140000,52216
231,210,21,925,85000,52217
663,588,75,705,154900,52218
64,52,12,710,87100,52219
83,83,0,-,170800,52220
100,77,23,1340,156300,52221
299,263,36,288,89700,52222
437,385,52,729,163000,52223
807,654,153,656,157500,52224
187,187,0,-,126000,52225
1086,899,187,786,264700,52227
1357,1235,122,1222,255800,52228
316,253,63,768,159300,52229
138,119,19,687,161200,52231
102,91,11,671,-,52232
2913,1938,975,748,166000,52233
353,226,127,1082,181000,52235
200,200,0,-,187500,52236
535,482,53,465,144100,52237
15159,7675,7484,1047,207100,52240
9259,5086,4173,944,241200,52241
36,0,36,-,-,52242
9329,5820,3509,1190,252300,52245
9925,4006,5919,939,268400,52246
1776,1297,479,809,216900,52247
675,587,88,650,115500,52248
367,306,61,904,133300,52249
245,227,18,417,114100,52251
30,30,0,-,-,52252
1102,913,189,813,184900,52253
399,248,151,902,81300,52254
549,441,108,817,121300,52255
95,85,10,-,-,52257
1582,1273,309,615,116200,52301
17244,13366,3878,802,183800,52302
279,227,52,722,118900,52305
587,477,110,575,128700,52306
50,28,22,-,131300,52307
94,79,15,425,80800,52308
265,236,29,722,126400,52309
2628,2053,575,630,150700,52310
35,29,6,-,56300,52312
136,112,24,850,163800,52313
1804,1469,335,679,225900,52314
517,415,102,592,152200,52315
586,460,126,644,108700,52316
8035,5985,2050,1217,271100,52317
409,325,84,938,148600,52318
470,355,115,687,109200,52320
201,160,41,657,116700,52321
785,644,141,794,191200,52322
380,297,83,665,95700,52323
702,655,47,1199,255400,52324
269,240,29,635,197500,52325
287,232,55,822,112200,52326
1365,989,376,1047,232900,52327
1014,961,53,1221,289600,52328
293,252,41,644,149000,52329
349,233,116,-,140600,52330
632,559,73,820,179800,52332
2692,2374,318,1044,317300,52333
82,82,0,-,199000,52334
277,215,62,686,79400,52335
1075,932,143,858,168100,52336
333,231,102,887,108400,52337
1419,1309,110,945,313700,52338
1479,934,545,759,100900,52339
1852,1512,340,1128,258200,52340
414,373,41,835,378700,52341
1195,886,309,868,111000,52342
33,10,23,-,-,52344
507,463,44,715,177900,52345
371,306,65,804,168600,52346
521,464,57,718,113100,52347
31,30,1,-,62500,52348
3220,2535,685,663,164800,52349
519,472,47,733,232500,52351
746,644,102,441,172100,52352
3704,2330,1374,838,134100,52353
120,116,4,-,175000,52354
99,91,8,600,106600,52355
1114,813,301,795,185400,52356
1529,1258,271,916,197300,52358
113,111,2,-,170800,52359
2027,1312,715,687,165800,52361
360,321,39,639,99400,52362
1232,256,976,709,123600,52401
17967,12288,5679,881,157700,52402
10338,7957,2381,796,156200,52403
17102,11686,5416,798,138700,52404
11351,8655,2696,899,147200,52405
2858,2824,34,-,350700,52411
12170,7891,4279,847,85800,52501
373,316,57,545,167900,52530
2279,1802,477,604,120600,52531
459,388,71,911,96000,52533
203,166,37,813,60900,52534
372,314,58,581,98600,52535
388,350,38,675,118900,52536
2500,2108,392,762,127900,52537
460,340,120,710,85900,52540
177,155,22,1023,102300,52542
123,110,13,-,117000,52543
3150,2083,1067,697,87100,52544
38,26,12,-,70000,52548
205,187,18,825,95600,52549
288,281,7,275,105000,52550
217,191,26,-,138400,52551
367,324,43,716,160700,52552
649,521,128,829,129200,52553
500,424,76,600,75700,52554
84,59,25,863,73900,52555
5162,3158,2004,808,134100,52556
0,0,0,-,-,52557
68,64,4,-,83600,52560
378,215,163,592,87900,52561
39,33,6,-,-,52562
581,384,197,725,104900,52563
783,604,179,577,111000,52565
81,67,14,913,63600,52566
246,194,52,784,151700,52567
40,37,3,-,63000,52568
300,290,10,1094,76500,52569
349,310,39,521,74200,52570
533,463,70,725,137200,52571
418,277,141,650,74600,52572
81,75,6,-,121500,52573
226,184,42,781,67900,52574
171,159,12,475,210600,52576
5738,3649,2089,732,120900,52577
303,272,31,665,101200,52580
127,77,50,667,136300,52581
140,117,23,-,95000,52583
193,185,8,788,86200,52584
327,264,63,730,100000,52585
249,173,76,-,95800,52586
6,6,0,-,-,52588
453,390,63,564,92200,52590
1200,836,364,789,113200,52591
76,57,19,-,156900,52593
169,166,3,-,116700,52594
184,110,74,677,77100,52595
12501,8571,3930,847,104700,52601
303,225,78,776,122300,52619
322,267,55,-,128800,52620
289,226,63,866,150900,52621
768,664,104,778,165400,52623
248,221,27,-,170300,52624
892,727,165,677,162700,52625
507,430,77,563,70500,52626
5173,3945,1228,835,92800,52627
147,116,31,950,47500,52630
22,22,0,-,166700,52631
5178,3535,1643,721,86500,52632
367,227,140,964,76300,52635
1121,842,279,692,143200,52637
204,154,50,648,138800,52638
697,619,78,766,123000,52639
539,486,53,958,121400,52640
4524,3267,1257,709,137700,52641
143,139,4,-,138700,52644
1427,1116,311,663,108300,52645
138,132,6,825,131300,52646
70,43,27,689,104500,52647
320,286,34,767,194300,52649
296,216,80,1061,226300,52650
198,189,9,575,80400,52651
35,27,8,-,-,52652
1264,898,366,753,116900,52653
606,460,146,700,109400,52654
1754,1148,606,788,149700,52655
999,886,113,465,165800,52656
28,25,3,-,162500,52657
408,391,17,1087,200300,52658
544,437,107,575,98200,52659
143,104,39,-,203900,52660
45,25,20,-,102500,52701
351,283,68,775,160900,52720
354,282,72,673,150000,52721
15923,12086,3837,979,248600,52722
2223,2059,164,1015,241200,52726
115,79,36,-,181800,52727
410,307,103,644,108900,52728
335,299,36,667,138200,52729
2304,1858,446,684,145900,52730
304,271,33,821,122000,52731
10863,7527,3336,693,107500,52732
104,100,4,-,90000,52737
1238,900,338,645,122800,52738
284,180,104,818,75800,52739
2887,2465,422,807,202400,52742
205,169,36,860,167800,52745
421,315,106,1146,236800,52746
802,601,201,773,184100,52747
3477,2796,681,855,253200,52748
391,365,26,729,193100,52749
159,135,24,730,137500,52750
411,311,100,776,137000,52751
178,151,27,772,99400,52752
2122,1702,420,979,277500,52753
566,515,51,830,163900,52754
788,657,131,805,175300,52755
691,673,18,1536,292300,52756
100,87,13,775,96500,52757
122,100,22,1114,150000,52758
49,42,7,-,95700,52759
229,173,56,-,132400,52760
11699,8331,3368,886,139600,52761
163,125,38,1036,194100,52765
347,323,24,593,110300,52766
94,84,10,-,-,52767
533,472,61,942,215500,52768
220,182,38,788,197900,52769
33,16,17,-,-,52771
2174,1778,396,690,172500,52772
1082,806,276,760,164900,52773
57,43,14,793,85600,52774
1680,1217,463,902,151700,52776
516,451,65,644,97400,52777
1704,1290,414,713,137100,52778
854,0,854,820,-,52801
3996,2931,1065,836,73200,52802
8993,6071,2922,791,135200,52803
11092,7166,3926,824,126900,52804
11222,7763,3459,847,154100,52806
6643,3646,2997,793,281000,52807
855,724,131,713,195000,53001
918,701,217,837,263400,53002
53,48,5,-,167200,53003
1470,1318,152,875,209900,53004
8191,6930,1261,1635,322600,53005
771,649,122,863,179500,53006
835,322,513,852,170600,53007
3016,2578,438,843,239300,53010
887,778,109,727,212900,53011
7802,6234,1568,918,335900,53012
1351,1183,168,833,198600,53013
3366,2705,661,677,169500,53014
1106,999,107,782,170500,53015
155,121,34,842,110100,53016
1856,1835,21,-,373700,53017
3057,2322,735,1329,393400,53018
724,606,118,847,187300,53019
1561,1341,220,973,259000,53020
1715,1378,337,920,252000,53021
7823,6113,1710,1179,282300,53022
513,464,49,846,168700,53023
8070,5654,2416,940,286100,53024
9640,6864,2776,908,237500,53027
8013,6431,1582,1045,375700,53029
31,12,19,-,-,53031
2196,1542,654,767,157200,53032
2422,2347,75,1231,299100,53033
630,453,177,810,183200,53034
909,791,118,1099,225100,53035
1135,915,220,1098,290300,53036
3777,2647,1130,994,245100,53037
1605,1254,351,998,246400,53038
1692,1318,374,821,176800,53039
3265,2610,655,821,251700,53040
2728,2187,541,789,169100,53042
856,766,90,1069,281900,53044
9623,7498,2125,1598,357700,53045
619,525,94,531,159200,53046
62,50,12,900,228800,53047
1459,857,602,942,183800,53048
967,846,121,945,219300,53049
2911,2179,732,784,160300,53050
15751,11822,3929,1191,275300,53051
721,662,59,598,189100,53057
1316,844,472,1331,392900,53058
708,598,110,738,257700,53059
2208,1760,448,758,143000,53061
653,573,80,651,208600,53063
874,755,119,769,209800,53065
14660,11507,3153,1093,329800,53066
351,338,13,-,432500,53069
1906,1580,326,767,214100,53070
11827,9025,2802,1159,331200,53072
6254,4587,1667,768,194400,53073
5444,3547,1897,939,220800,53074
1377,1056,321,772,218900,53075
1226,1150,76,682,370000,53076
722,639,83,973,279400,53078
577,471,106,723,183400,53079
2308,1463,845,868,231500,53080
18719,11391,7328,765,134100,53081
8680,6469,2211,854,191500,53083
5078,3650,1428,779,185700,53085
3816,2800,1016,986,287600,53086
150,98,52,760,137500,53088
7416,5927,1489,1111,308600,53089
8915,6790,2125,998,218200,53090
875,713,162,917,170600,53091
8278,6564,1714,1499,368700,53092
731,670,61,919,195600,53093
7214,4687,2527,916,174300,53094
12046,8708,3338,897,236200,53095
2232,2148,84,1889,442300,53097
4411,3057,1354,1049,197000,53098
5,5,0,-,-,53099
1584,1496,88,900,320600,53103
2192,1956,236,1183,267200,53104
12090,8565,3525,894,249900,53105
1297,1217,80,792,249800,53108
8663,5307,3356,858,164900,53110
938,772,166,796,174800,53114
6578,4536,2042,875,174000,53115
3031,2604,427,1326,325400,53118
2186,2031,155,1513,316800,53119
4248,3223,1025,1235,246600,53120
7554,5384,2170,911,226300,53121
2272,2009,263,1256,412800,53122
1267,1079,188,950,453400,53125
2814,2380,434,1129,315700,53126
41,33,8,-,-,53127
3346,2765,581,1122,190800,53128
6126,4280,1846,1003,239400,53129
3043,1652,1391,1218,250600,53130
13649,10739,2910,1150,281300,53132
617,575,42,783,278500,53137
936,827,109,1277,233000,53139
12685,6305,6380,925,151500,53140
12659,9383,3276,1164,212800,53142
8590,4991,3599,1033,150000,53143
10021,5344,4677,982,206600,53144
3197,3061,136,1094,274600,53146
7815,5407,2408,1048,251000,53147
7176,6080,1096,972,318200,53149
9916,8597,1319,1157,323800,53150
14092,10025,4067,1316,284800,53151
974,898,76,963,339300,53153
15262,9194,6068,1194,248800,53154
1395,1071,324,685,192400,53156
0,0,0,-,-,53157
6544,5221,1323,1302,278100,53158
233,43,190,878,325900,53167
3566,2917,649,1087,229700,53168
865,648,217,909,224800,53170
8612,5387,3225,941,170900,53172
64,64,0,-,166400,53176
2677,2075,602,1186,192100,53177
1079,772,307,789,263200,53178
2610,2197,413,959,219400,53179
3305,2591,714,1010,233700,53181
3214,2395,819,987,244600,53182
1073,886,187,1191,316900,53183
1533,940,593,941,218800,53184
7444,6246,1198,1095,289900,53185
14733,7935,6798,1016,224600,53186
14053,9105,4948,1087,261300,53188
10199,8326,1873,1046,314400,53189
6152,2919,3233,840,215000,53190
1441,1090,351,830,259600,53191
49,48,1,-,-,53192
38,31,7,817,168800,53195
16138,3357,12781,1050,261000,53202
1208,158,1050,1573,421300,53203
13058,3365,9693,846,77500,53204
3351,902,2449,659,97000,53205
7966,2660,5306,873,53100,53206
16267,9624,6643,986,176100,53207
11778,4511,7267,804,155700,53208
19419,8295,11124,898,111500,53209
9366,3239,6127,904,118700,53210
15003,6294,8709,1057,351500,53211
13133,4230,8903,908,161500,53212
12124,7185,4939,1074,267400,53213
16166,8243,7923,871,146900,53214
19435,8913,10522,834,111500,53215
12541,5496,7045,902,97600,53216
11661,8828,2833,1366,365400,53217
14765,6304,8461,919,90900,53218
14668,9202,5466,838,155400,53219
12100,7196,4904,952,169700,53220
16483,9389,7094,969,161400,53221
10663,7088,3575,939,161500,53222
12400,6495,5905,956,151300,53223
7468,3620,3848,1032,154000,53224
10148,3931,6217,940,139600,53225
7895,4828,3067,1180,258800,53226
10856,5058,5798,942,168700,53227
6852,3584,3268,1168,219700,53228
4416,134,4282,771,88800,53233
4759,2255,2504,783,169600,53235
0,0,0,-,-,53295
14218,10054,4164,920,178000,53402
10409,5529,4880,925,133900,53403
5231,2287,2944,848,98900,53404
10942,8056,2886,911,140600,53405
11308,8150,3158,872,214800,53406
104,64,40,-,-,53501
941,751,190,821,192900,53502
877,692,185,847,187500,53503
919,765,154,561,164700,53504
171,150,21,1596,195700,53505
440,358,82,745,120800,53506
836,673,163,1066,282500,53507
2306,1912,394,923,256500,53508
582,447,135,711,173000,53510
18283,11744,6539,860,123800,53511
1061,857,204,840,262100,53515
965,807,158,625,217900,53516
752,571,181,1071,359400,53517
647,562,85,644,135800,53518
2894,2173,721,801,164400,53520
1360,1150,210,1087,296200,53521
378,300,78,625,159100,53522
2080,1713,367,953,242000,53523
1620,1249,371,936,180900,53525
234,195,39,642,120800,53526
4245,3517,728,1408,321300,53527
2431,1863,568,1066,346500,53528
902,629,273,600,300300,53529
1823,1416,407,822,134300,53530
1657,1329,328,880,276700,53531
5968,4803,1165,1126,267800,53532
3023,2118,905,868,213100,53533
4877,3541,1336,943,213100,53534
3795,2941,854,908,218800,53536
396,294,102,869,118500,53537
7662,5702,1960,926,199900,53538
62,34,28,933,-,53540
364,315,49,708,177100,53541
715,593,122,575,165600,53543
298,240,58,764,269100,53544
10434,6739,3695,905,158900,53545
12197,8642,3555,921,168000,53546
8356,5756,2600,892,169600,53548
4469,3186,1283,921,198100,53549
435,366,69,828,172100,53550
3496,2767,729,896,230400,53551
269,222,47,387,137900,53553
364,300,64,742,148100,53554
3833,3033,800,1056,316700,53555
1054,866,188,696,151000,53556
169,135,34,600,139000,53557
5135,3955,1180,1272,309500,53558
2399,1815,584,917,238100,53559
1558,1292,266,951,278600,53560
795,707,88,975,343300,53561
12609,7019,5590,1192,420700,53562
4503,3623,880,896,226400,53563
1952,1444,508,698,204400,53565
6578,4431,2147,787,161200,53566
406,330,76,824,159800,53569
1184,880,304,752,190200,53570
14,14,0,-,-,53571
3751,2727,1024,1060,318200,53572
1276,1021,255,586,128300,53573
1484,1229,255,867,248900,53574
6882,5343,1539,1029,315700,53575
948,711,237,-,163600,53576
515,396,119,788,198600,53577
2700,1947,753,1032,276300,53578
632,473,159,803,171100,53579
177,130,47,942,92900,53580
4195,2990,1205,683,143700,53581
420,363,57,840,185100,53582
2522,2040,482,785,241300,53583
10,10,0,-,-,53584
830,570,260,874,172200,53585
823,649,174,707,123100,53586
478,384,94,625,142400,53587
1694,1368,326,900,216700,53588
8502,6716,1786,974,251800,53589
17249,11604,5645,1174,283600,53590
10826,7890,2936,1374,376100,53593
2353,1688,665,870,200100,53594
7968,5842,2126,1141,371600,53597
1493,926,567,1251,308000,53598
55,42,13,-,77400,53599
18702,2528,16174,1287,407800,53703
21392,11906,9486,1115,225100,53704
11791,5846,5945,1187,365200,53705
0,0,0,-,-,53706
20921,13057,7864,1200,324600,53711
10851,3452,7399,1031,210700,53713
7756,4593,3163,1042,218900,53714
5077,1102,3975,1367,348400,53715
8286,6139,2147,1157,256100,53716
6193,3308,2885,1184,334800,53717
7636,4624,3012,1399,267200,53718
15036,7450,7586,1264,292300,53719
2408,895,1513,1347,488000,53726
0,0,0,-,-,53792
428,345,83,-,106600,53801
30,22,8,-,106300,53802
522,387,135,732,127600,53803
503,418,85,594,137800,53804
2139,1475,664,645,123000,53805
747,615,132,582,123300,53806
1732,1391,341,786,177400,53807
377,278,99,672,150000,53808
1670,1204,466,677,156100,53809
150,129,21,425,121900,53810
1266,868,398,828,224200,53811
130,130,0,-,177200,53812
2274,1604,670,761,164000,53813
275,230,45,725,195800,53816
127,109,18,620,117200,53817
5614,3035,2579,815,179900,53818
923,771,152,627,161700,53820
3105,2056,1049,738,132700,53821
192,151,41,-,152900,53825
578,456,122,622,132900,53826
127,114,13,788,126000,53827
5942,3935,2007,887,172000,53901
1474,930,544,627,102100,53910
528,440,88,1121,244200,53911
9376,6116,3260,855,172200,53913
10095,6473,3622,838,164400,53916
823,652,171,714,170800,53919
216,183,33,871,206900,53920
421,376,45,757,209800,53922
817,626,191,632,164800,53923
580,470,110,733,164700,53924
3531,2553,978,798,213900,53925
621,478,143,792,171300,53926
43,40,3,-,115000,53928
1047,866,181,760,153600,53929
526,437,89,733,165900,53930
125,86,39,907,102800,53931
911,671,240,1080,225200,53932
1295,830,465,1020,189600,53933
2067,1719,348,742,132300,53934
110,96,14,930,111600,53935
575,520,55,784,88100,53936
370,324,46,810,193800,53937
126,107,19,650,99700,53939
0,0,0,-,-,53940
1123,996,127,756,196400,53941
43,41,2,-,101800,53942
395,308,87,867,207900,53943
935,779,156,905,157200,53944
1737,1412,325,721,198800,53946
122,86,36,731,169600,53947
3259,2451,808,803,140600,53948
2799,2264,535,697,165400,53949
1943,1591,352,781,140100,53950
930,712,218,744,150000,53951
1260,1123,137,808,147200,53952
90,64,26,696,105000,53953
2677,2267,410,875,209100,53954
2342,1900,442,823,252500,53955
1228,1004,224,625,165400,53956
5408,3859,1549,819,186500,53959
1383,1110,273,698,199800,53960
397,351,46,983,177900,53961
21,10,11,442,139300,53962
5141,3543,1598,711,141700,53963
1368,986,382,776,164100,53964
4727,3564,1163,842,171000,53965
864,695,169,791,161200,53968
110,84,26,-,158000,53969
3187,2573,614,816,183900,54001
2495,1961,534,952,216300,54002
420,390,30,1148,257200,54003
931,787,144,746,181800,54004
1154,949,205,644,189800,54005
333,290,43,567,165800,54006
403,346,57,822,197000,54007
931,788,143,918,185100,54009
2693,2068,625,794,218800,54011
1497,1184,313,1088,241500,54013
852,752,100,969,232400,54014
1489,1149,340,875,222400,54015
12833,10477,2356,1277,340800,54016
7209,5279,1930,911,247500,54017
3111,2337,774,895,217300,54020
2847,2186,661,1094,264500,54021
8370,5684,2686,914,276200,54022
1696,1399,297,1529,287200,54023
2065,1608,457,818,216300,54024
2739,2212,527,940,262400,54025
906,744,162,810,255900,54026
421,393,28,1143,257900,54027
1013,699,314,842,197000,54028
565,565,0,-,366700,54082
1116,1043,73,780,216100,54101
421,370,51,496,117000,54102
215,196,19,850,110900,54103
570,542,28,-,117600,54104
2160,1920,240,745,220600,54106
1356,1097,259,635,166300,54107
2157,1772,385,762,163700,54110
1007,863,144,810,168700,54111
1145,829,316,639,139900,54112
1401,1192,209,915,192100,54113
2675,2155,520,638,146600,54114
18998,12589,6409,928,239100,54115
248,190,58,775,137500,54119
121,112,9,-,150000,54120
1490,1324,166,290,143700,54121
78,57,21,558,95000,54123
1423,1172,251,754,109200,54124
231,188,43,527,87100,54125
1541,1357,184,835,209600,54126
31,21,10,-,129200,54127
765,570,195,-,129000,54128
1457,1264,193,869,197900,54129
10828,8271,2557,882,173800,54130
840,552,288,571,111200,54135
2885,1785,1100,707,153000,54136
466,439,27,738,181800,54137
412,365,47,854,158800,54138
1245,1033,212,700,155000,54139
3732,2334,1398,874,159600,54140
1058,1049,9,-,227000,54141
6640,4835,1805,718,110700,54143
590,562,28,606,159200,54149
316,210,106,576,55300,54150
1419,1196,223,746,108300,54151
96,34,62,736,76400,54152
3090,2310,780,734,131300,54153
2375,1670,705,620,165600,54154
2796,1796,1000,854,282600,54155
686,591,95,755,105300,54156
2481,1848,633,676,142400,54157
568,532,36,743,148300,54159
107,84,23,750,144400,54160
1184,1050,134,678,157700,54161
3410,2647,763,729,226200,54162
3007,2147,860,809,202900,54165
7006,4922,2084,706,130800,54166
1176,1137,39,969,281500,54169
1505,1302,203,721,185900,54170
1399,1325,74,-,237300,54171
1408,1197,211,1213,276900,54173
1408,1216,192,734,137500,54174
600,578,22,742,212900,54175
1285,1073,212,623,146100,54177
1191,936,255,1121,219800,54180
2152,1755,397,755,148200,54201
844,691,153,1063,306800,54202
773,683,90,831,261900,54204
780,731,49,675,192000,54205
83,58,25,560,137500,54207
2270,1918,352,810,208200,54208
718,627,91,933,354800,54209
361,314,47,719,310000,54210
154,135,19,865,417900,54211
368,334,34,871,385900,54212
578,514,64,563,154100,54213
286,235,51,715,225500,54214
111,81,30,655,115800,54215
2584,2104,480,725,142500,54216
2824,2329,495,809,219200,54217
17278,11933,5345,693,126800,54220
683,634,49,610,214400,54227
1194,978,216,691,144200,54228
2099,1580,519,1067,226700,54229
1647,1484,163,525,175600,54230
497,430,67,639,114800,54232
1062,757,305,919,317900,54234
8073,6412,1661,854,195500,54235
6503,5002,1501,696,108400,54241
867,728,139,762,169700,54245
451,398,53,775,248300,54246
981,829,152,619,169200,54247
9660,6226,3434,856,165300,54301
12854,6197,6657,749,128600,54302
12195,5925,6270,750,124500,54303
12486,7295,5191,811,150600,54304
0,0,0,-,-,54307
14438,9546,4892,946,223900,54311
15137,12585,2552,951,241800,54313
13204,8584,4620,837,156500,54401
10433,6994,3439,831,156000,54403
994,694,300,828,119100,54405
1632,1419,213,743,227900,54406
532,474,58,886,234200,54407
480,413,67,538,140100,54408
5594,4034,1560,666,106400,54409
826,759,67,565,165500,54410
1902,1684,218,688,166900,54411
817,706,111,631,166600,54412
91,84,7,-,110700,54413
1277,1055,222,614,152600,54414
651,521,130,578,115900,54416
8,8,0,-,73300,54417
346,322,24,542,145700,54418
454,365,89,486,156000,54420
1237,924,313,739,137900,54421
441,301,140,720,102100,54422
789,745,44,730,256800,54423
646,616,30,750,191100,54424
723,550,173,708,129200,54425
1672,1425,247,719,165300,54426
461,402,59,694,155600,54427
455,378,77,566,147200,54428
54,49,5,-,116900,54430
656,553,103,658,157900,54433
838,752,86,695,177000,54435
775,618,157,669,140200,54436
1145,888,257,611,131500,54437
1088,973,115,728,168100,54440
355,327,28,575,180500,54441
527,453,74,846,174800,54442
849,734,115,756,228300,54443
1118,907,211,683,133200,54446
201,160,41,685,105000,54447
1684,1477,207,696,205900,54448
11462,8026,3436,716,163600,54449
156,139,17,796,79200,54450
4346,3301,1045,720,158300,54451
8030,6131,1899,666,130500,54452
525,471,54,673,155200,54454
7633,6059,1574,848,189000,54455
2455,1945,510,621,130600,54456
3752,3277,475,695,144300,54457
52,36,16,800,100000,54458
561,526,35,850,103000,54459
912,746,166,690,125700,54460
163,145,18,775,153100,54462
373,268,105,717,211500,54463
25,18,7,-,75000,54464
322,313,9,583,188500,54465
1120,953,167,644,150800,54466
6072,3728,2344,907,192900,54467
730,578,152,743,109400,54469
814,672,142,654,125800,54470
621,596,25,1229,230500,54471
1012,872,140,672,180500,54473
1928,1280,648,698,144800,54474
580,551,29,610,152400,54475
7948,4832,3116,860,168700,54476
1375,1120,255,498,150000,54479
526,436,90,680,149500,54480
11491,6717,4774,782,157300,54481
4049,3338,711,886,205500,54482
2437,2090,347,913,196300,54484
154,153,1,-,176400,54485
915,787,128,769,131100,54486
4191,3567,624,702,179000,54487
459,363,96,650,119300,54488
638,530,108,861,134600,54489
374,335,39,605,159600,54490
724,549,175,618,130000,54491
277,255,22,900,167300,54493
11688,8785,2903,859,137400,54494
3396,1871,1525,735,96700,54495
831,643,188,815,107700,54498
1161,885,276,659,148200,54499
8551,7083,1468,780,157200,54501
577,513,64,671,122500,54511
583,512,71,678,225000,54512
248,232,16,675,152100,54513
945,803,142,540,144000,54514
264,234,30,750,88100,54515
89,89,0,-,324500,54517
559,492,67,1023,200900,54519
1497,1095,402,508,142600,54520
3787,3151,636,804,207700,54521
333,227,106,-,149000,54524
114,80,34,758,74000,54525
310,281,29,625,89900,54526
410,351,59,600,101000,54527
440,412,28,720,214900,54529
344,309,35,-,84300,54530
546,514,32,950,240100,54531
1163,892,271,560,86500,54534
88,77,11,669,56900,54536
229,206,23,-,95000,54537
1376,925,451,497,233200,54538
544,507,37,876,217500,54539
414,357,57,700,231300,54540
502,391,111,688,136600,54541
229,211,18,-,123300,54542
483,379,104,1007,567300,54545
501,413,88,578,89900,54546
639,549,90,700,253600,54547
2472,1919,553,869,247000,54548
260,246,14,717,100000,54550
2137,1585,552,630,115300,54552
500,428,72,625,181300,54554
2164,1688,476,749,150800,54555
542,432,110,720,100800,54556
465,444,21,721,348800,54557
1108,891,217,823,175100,54558
378,280,98,420,122500,54559
319,286,33,865,158200,54560
32,32,0,-,-,54561
812,715,97,839,272300,54562
316,285,31,719,161100,54563
181,158,23,340,160300,54564
25,20,5,-,90000,54565
640,517,123,535,159700,54566
2062,1681,381,738,219600,54568
20886,11446,9440,905,178300,54601
6672,3311,3361,817,147000,54603
687,526,161,819,163800,54610
461,358,103,805,120200,54611
2105,1399,706,835,165300,54612
855,730,125,704,133800,54613
1014,798,216,749,191700,54614
4234,2940,1294,719,156600,54615
971,725,246,757,134700,54616
828,649,179,850,144300,54618
1288,1110,178,769,174200,54619
471,358,113,713,225700,54621
857,764,93,640,167700,54622
831,702,129,908,174400,54623
691,622,69,683,153200,54624
220,195,25,588,156700,54625
601,494,107,673,186800,54626
855,732,123,717,196200,54627
424,394,30,708,163400,54628
1081,893,188,956,175200,54629
1630,1290,340,871,197700,54630
683,539,144,691,139300,54631
450,415,35,644,196500,54632
1515,1215,300,671,150800,54634
650,551,99,868,151200,54635
6061,4663,1398,955,235900,54636
87,53,34,-,99500,54637
593,501,92,573,205700,54638
1023,790,233,598,144400,54639
789,666,123,943,166200,54642
0,0,0,-,-,54643
496,419,77,538,244700,54644
47,25,22,573,117500,54645
1631,1341,290,835,125800,54646
528,417,111,648,153900,54648
10663,7226,3437,937,225200,54650
450,355,95,594,159300,54651
378,309,69,660,123500,54652
445,350,95,900,214400,54653
59,58,1,-,75000,54654
641,497,144,615,177400,54655
6863,5001,1862,861,163800,54656
128,93,35,686,154200,54657
1040,825,215,1054,192200,54658
498,398,100,705,162000,54659
6767,4379,2388,867,158400,54660
1531,1167,364,922,206100,54661
606,496,110,775,131300,54664
3488,2490,998,743,175100,54665
1081,874,207,792,168700,54666
1845,1531,314,799,168800,54667
3083,2454,629,967,224400,54669
502,437,65,728,174800,54670
16576,9840,6736,839,213000,54701
17729,11360,6369,874,173500,54703
3549,2103,1446,858,182000,54720
520,421,99,850,153500,54721
1489,1181,308,719,196400,54722
438,348,90,788,153300,54723
2807,2161,646,712,172800,54724
1328,1111,217,798,150100,54725
694,543,151,838,152200,54726
1903,1501,402,708,167700,54727
2483,2123,360,844,166800,54728
14209,9649,4560,932,202500,54729
1992,1544,448,624,180500,54730
313,267,46,728,124700,54731
1168,959,209,650,135300,54732
483,413,70,820,141400,54733
287,246,41,917,165500,54734
1790,1400,390,657,139500,54736
216,177,39,862,198800,54737
1259,995,264,933,237100,54738
1920,1421,499,928,200800,54739
800,630,170,806,176200,54740
650,538,112,677,129900,54741
1813,1604,209,1025,228600,54742
907,786,121,828,194400,54745
291,236,55,883,96700,54746
1036,690,346,827,156400,54747
560,469,91,864,181400,54748
577,415,162,875,166600,54749
409,355,54,717,257300,54750
9764,5368,4396,859,189200,54751
656,521,135,736,131400,54754
2912,2204,708,709,168500,54755
413,321,92,645,170300,54756
1430,1265,165,759,175700,54757
1947,1565,382,745,172000,54758
605,499,106,766,164100,54759
85,46,39,594,159200,54760
463,319,144,691,158900,54761
525,438,87,648,143200,54762
478,384,94,571,144800,54763
725,624,101,800,133500,54766
1387,1188,199,850,186800,54767
1776,1259,517,757,152600,54768
271,253,18,756,253100,54769
790,641,149,798,174500,54770
1514,1199,315,674,147900,54771
416,323,93,800,161700,54772
1329,978,351,679,150500,54773
2809,2094,715,745,165500,54801
656,492,164,702,128400,54805
4713,3266,1447,671,133800,54806
1054,887,167,900,201500,54810
2177,1448,729,663,131300,54812
234,210,24,698,180000,54813
1298,948,350,561,184900,54814
934,818,116,663,222000,54817
1039,829,210,568,125900,54819
383,322,61,772,187500,54820
680,591,89,650,198900,54821
1896,1439,457,826,169200,54822
999,776,223,764,159000,54824
291,268,23,665,183800,54826
177,175,2,-,215000,54827
340,281,59,422,110600,54828
2255,1785,470,772,175800,54829
1571,1413,158,730,200100,54830
165,126,39,-,175000,54832
454,364,90,540,148800,54835
382,380,2,-,176200,54836
1550,1267,283,699,165400,54837
500,459,41,917,199500,54838
129,117,12,-,137500,54839
1815,1474,341,779,147000,54840
133,106,27,-,104200,54841
58,55,3,-,174100,54842
5495,4123,1372,620,198500,54843
117,106,11,-,171000,54844
40,40,0,-,156800,54845
254,239,15,1025,121300,54846
1162,912,250,886,214800,54847
2543,1820,723,735,102900,54848
811,727,84,788,215500,54849
151,135,16,592,228100,54850
1596,1278,318,757,176500,54853
355,339,16,850,176000,54854
291,257,34,688,153000,54855
670,611,59,854,148800,54856
7,7,0,-,-,54857
723,536,187,650,155600,54858
1010,841,169,835,179900,54859
70,8,62,377,-,54861
149,149,0,-,148800,54862
554,519,35,820,172600,54864
275,237,38,463,153800,54865
211,162,49,665,80000,54867
6603,4548,2055,787,167600,54868
756,707,49,956,232600,54870
1193,970,223,771,164800,54871
1201,928,273,817,171500,54872
1417,1229,188,775,182900,54873
1547,1359,188,931,161600,54874
548,467,81,730,144200,54875
760,590,170,775,213400,54876
13163,8014,5149,804,143700,54880
563,497,66,650,187300,54888
1234,890,344,717,193900,54889
1477,1150,327,812,172800,54891
1736,1408,328,625,179300,54893
378,330,48,713,161200,54895
732,645,87,575,159900,54896
13583,7159,6424,843,138500,54901
9800,6063,3737,739,134800,54902
9683,7518,2165,813,219400,54904
804,676,128,824,159300,54909
10268,5937,4331,824,159200,54911
9229,6524,2705,976,297300,54913
13661,8749,4912,822,164700,54914
17087,12264,4823,814,191400,54915
552,487,65,725,152300,54921
486,423,63,788,152000,54922
3641,2754,887,786,140500,54923
71,67,4,-,63700,54926
159,126,33,785,213000,54927
168,153,15,1188,178800,54928
3938,3078,860,690,132000,54929
685,571,114,606,142000,54930
154,129,25,548,169000,54931
441,423,18,1528,219700,54932
134,67,67,722,88600,54933
17641,10609,7032,782,137500,54935
8396,6519,1877,923,182900,54937
1860,1655,205,862,240300,54940
1165,927,238,698,224400,54941
3947,3594,353,973,266900,54942
839,700,139,596,166500,54943
3369,2990,379,735,243100,54944
1536,1190,346,658,169800,54945
0,0,0,-,-,54946
989,892,97,882,230800,54947
88,76,12,900,104200,54948
1530,1196,334,720,159300,54949
1047,851,196,684,126700,54950
11961,7845,4116,815,156600,54952
19100,13146,5954,873,184700,54956
1148,1000,148,710,166300,54960
5677,4176,1501,786,167000,54961
426,377,49,642,163100,54962
2996,2399,597,884,174000,54963
354,316,38,884,199500,54964
579,545,34,888,154100,54965
779,642,137,644,123600,54966
202,159,43,425,137500,54967
1235,963,272,623,149800,54968
1318,1039,279,697,116600,54970
4436,2969,1467,712,150700,54971
616,561,55,658,195100,54974
614,553,61,835,209900,54977
28,26,2,-,-,54978
642,579,63,626,233800,54979
151,142,9,-,138200,54980
6885,4984,1901,715,166400,54981
2963,2386,577,722,156900,54982
1767,1380,387,807,174400,54983
1365,972,393,765,166200,54984
0,0,0,-,-,54985
2252,1827,425,736,232600,54986
1179,1132,47,2068,560200,55001
1014,794,220,1541,287500,55003
1580,1446,134,1606,260600,55005
1376,1090,286,930,166300,55006
954,878,76,900,172600,55007
6147,4848,1299,1090,219300,55008
3277,2650,627,866,272800,55009
3817,3757,60,1568,305900,55011
683,607,76,1063,286900,55012
2644,2009,635,1099,290200,55013
10394,9025,1369,1389,262000,55014
12719,11196,1523,1571,281100,55016
300,272,28,1750,232400,55017
381,346,35,1431,256300,55018
751,721,30,1167,242000,55019
1373,1360,13,-,380700,55020
11406,8143,3263,975,210000,55021
12212,10822,1390,1250,289500,55024
9845,7484,2361,1167,304000,55025
160,146,14,-,239100,55026
981,830,151,879,239000,55027
26,23,3,-,107500,55029
486,419,67,1058,168900,55030
651,577,74,941,323400,55031
1283,1197,86,1293,276200,55032
11427,8925,2502,1067,273100,55033
23,20,3,-,90000,55036
1890,1479,411,843,163600,55037
8520,7633,887,1610,305900,55038
5107,4389,718,1117,227400,55040
3301,2597,704,951,225900,55041
4138,3910,228,1189,484000,55042
1532,1349,183,1306,297600,55043
20177,17743,2434,1616,372800,55044
2844,2573,271,984,301600,55045
2042,1752,290,1297,256400,55046
956,896,60,1938,448800,55047
918,795,123,711,195600,55049
3795,3045,750,753,173200,55051
745,655,90,889,227400,55052
343,313,30,1125,262100,55053
795,673,122,1348,337600,55054
1706,1202,504,981,246000,55055
5229,4565,664,948,242400,55056
7818,5676,2142,881,277100,55057
12016,8988,3028,856,189200,55060
3799,3046,753,709,198200,55063
470,413,57,1293,308200,55065
8107,5941,2166,899,196700,55066
11078,9633,1445,1465,294600,55068
1918,1494,424,839,205800,55069
2787,2429,358,1047,238600,55070
2298,1681,617,1667,225500,55071
1341,1027,314,957,143500,55072
1309,1136,173,882,398600,55073
851,779,72,1136,238800,55074
8326,5804,2522,984,220100,55075
9258,7288,1970,1209,253900,55076
5283,3307,1976,1222,423400,55077
3239,3076,163,983,273800,55079
1104,1006,98,1487,271500,55080
13914,10832,3082,1343,380600,55082
686,565,121,861,231800,55084
170,154,16,850,244900,55085
166,158,8,517,182700,55087
604,577,27,1342,449200,55088
611,552,59,1182,309700,55089
162,142,20,1786,221300,55090
4178,3871,307,1020,274700,55092
4662,1165,3497,1435,210800,55101
10142,4537,5605,1108,233700,55102
5246,2120,3126,893,194900,55103
18023,9410,8613,970,246400,55104
11104,7437,3667,1134,390000,55105
18707,10402,8305,1061,178700,55106
5395,2893,2502,982,206100,55107
6585,3601,2984,1236,294900,55108
12628,8222,4406,1142,238500,55109
15822,12188,3634,1323,282200,55110
95,0,95,814,-,55111
17360,11703,5657,1122,275200,55112
18225,12211,6014,1170,278000,55113
1751,478,1273,1351,249700,55114
3237,2698,539,1637,393300,55115
12167,5948,6219,1121,348000,55116
16654,9697,6957,1066,220300,55117
12466,8315,4151,1107,278500,55118
15958,10107,5851,1150,212200,55119
2058,1385,673,884,391300,55120
3761,1778,1983,1339,255200,55121
13628,9629,3999,1335,277900,55122
10191,8247,1944,1402,356800,55123
21128,16013,5115,1458,291400,55124
17239,13525,3714,1662,328800,55125
11640,9621,2019,1250,314500,55126
7488,6133,1355,1433,334900,55127
11641,9102,2539,1137,241400,55128
9981,8476,1505,1756,426300,55129
5897,2471,3426,973,168100,55130
58,47,11,725,275000,55150
0,0,0,-,-,55155
4436,3602,834,1335,248400,55301
2854,2425,429,825,288600,55302
19090,14379,4711,1218,275800,55303
16651,15659,992,1519,335700,55304
9979,5852,4127,1550,358800,55305
6166,4199,1967,1354,304300,55306
1262,929,333,763,194400,55307
3198,2955,243,920,247200,55308
6920,6185,735,1242,269400,55309
607,514,93,609,97400,55310
13888,12285,1603,1678,390800,55311
530,457,73,640,173000,55312
9246,7441,1805,1110,247300,55313
421,341,80,660,142200,55314
2219,2004,215,1169,349300,55315
8725,7845,880,1362,271300,55316
8057,6947,1110,1529,403200,55317
10940,7858,3082,1231,320200,55318
1903,1802,101,1075,282600,55319
1927,1648,279,902,261600,55320
1856,1442,414,844,220500,55321
1403,1266,137,731,332800,55322
461,436,25,640,277800,55324
1702,1437,265,759,247200,55325
1825,1772,53,1207,377100,55327
3457,2868,589,965,311100,55328
731,633,98,748,187500,55329
15212,13001,2211,1112,277500,55330
7382,6399,983,1102,595000,55331
765,644,121,545,101200,55332
252,201,51,588,92900,55333
1089,769,320,802,161800,55334
666,566,100,795,101500,55335
3088,2377,711,789,190100,55336
18906,12743,6163,1320,266800,55337
428,409,19,-,194600,55338
362,313,49,726,236800,55339
3055,2918,137,1618,533100,55340
1154,1040,114,1531,332400,55341
723,595,128,869,106500,55342
12711,5455,7256,1214,300200,55343
6850,2584,4266,1471,278700,55344
8680,7269,1411,1338,388200,55345
6572,5701,871,1623,371000,55346
11604,10606,998,1693,422100,55347
1482,1161,321,843,216900,55349
7833,5717,2116,780,185800,55350
3435,2822,613,1176,332400,55352
1193,1046,147,671,265500,55353
990,892,98,595,206200,55354
3940,3049,891,760,170200,55355
2171,1905,266,1232,556800,55356
1124,1018,106,1043,433500,55357
1939,1606,333,889,229900,55358
2400,2058,342,1006,463200,55359
1102,1041,61,1530,271800,55360
7250,5464,1786,1156,254700,55362
1876,1531,345,991,223900,55363
6242,5007,1235,898,351700,55364
208,140,68,598,111900,55366
374,331,43,878,251700,55367
737,514,223,1035,219800,55368
15340,12372,2968,1636,283200,55369
217,201,16,1036,238000,55370
6376,5255,1121,825,232800,55371
12052,10853,1199,1224,365100,55372
2093,1691,402,1156,231600,55373
5329,4651,678,1331,360500,55374
1353,1273,80,929,323700,55375
6078,5560,518,1084,297900,55376
11228,9428,1800,1564,339400,55378
16637,12385,4252,1297,300000,55379
786,680,106,718,200000,55381
1395,1288,107,1063,280900,55382
1232,255,977,1136,536600,55384
470,399,71,632,144600,55385
3143,2898,245,2029,466600,55386
5166,4215,951,1106,348900,55387
2132,1847,285,859,266700,55388
933,793,140,485,214500,55389
1076,965,111,934,257100,55390
6557,5229,1328,1436,632300,55391
1125,864,261,670,175900,55395
949,747,202,697,152800,55396
1102,929,173,991,281600,55397
5868,5344,524,1156,261000,55398
7317,2400,4917,1830,347500,55401
415,0,415,1653,-,55402
11021,2576,8445,1094,249900,55403
12410,2011,10399,940,263300,55404
8047,3090,4957,1068,375100,55405
16397,10737,5660,1101,271600,55406
14981,9163,5818,1104,257300,55407
15990,3737,12253,1199,313100,55408
4821,3185,1636,1198,298100,55409
8389,6842,1547,1442,478900,55410
9979,4820,5159,1026,188200,55411
8907,6391,2516,1190,181700,55412
6951,2679,4272,1192,311000,55413
12403,1976,10427,1292,367300,55414
2593,854,1739,1793,494300,55415
17390,8821,8569,1453,381600,55416
10820,8843,1977,1153,300500,55417
13878,8698,5180,1097,272700,55418
11270,8735,2535,1299,405300,55419
8917,5943,2974,1139,249200,55420
12249,7396,4853,1067,211900,55421
12332,9005,3327,1232,250500,55422
15679,9815,5864,1206,259200,55423
3735,3513,222,1741,780200,55424
4191,1722,2469,1268,251300,55425
12014,7748,4266,1291,281000,55426
10686,7471,3215,1203,274000,55427
12983,7518,5465,1129,229000,55428
10251,5591,4660,1138,208600,55429
7796,4915,2881,1182,188600,55430
8297,5782,2515,1510,287000,55431
12667,8086,4581,1165,226000,55432
13643,9342,4301,1185,217800,55433
11832,9884,1948,1439,221100,55434
7536,3219,4317,1514,283500,55435
6034,4553,1481,1516,522600,55436
8536,5942,2594,1397,292800,55437
7293,5673,1620,1422,334300,55438
3476,3112,364,1416,575000,55439
7832,4583,3249,1344,359600,55441
5534,4357,1177,1544,362000,55442
11900,8940,2960,1174,272400,55443
5448,4899,549,1139,240000,55444
4496,3595,901,1843,266700,55445
10088,8297,1791,1578,474400,55446
8857,6704,2153,1535,377600,55447
10750,8844,1906,1494,244200,55448
10836,9620,1216,1589,333800,55449
6,6,0,-,-,55450
3520,388,3132,655,140500,55454
0,0,0,-,-,55455
77,71,6,-,203600,55601
175,173,2,-,162500,55602
193,144,49,615,143800,55603
1631,1313,318,831,267100,55604
271,154,117,703,118500,55605
106,106,0,-,285700,55606
83,78,5,-,179200,55607
85,85,0,-,523900,55609
233,202,31,1028,294300,55612
118,111,7,-,241300,55613
1112,981,131,873,121300,55614
140,101,39,1319,252800,55615
3310,2631,679,681,204000,55616
190,167,23,1281,234600,55702
348,313,35,1027,141100,55703
445,372,73,486,172500,55704
1541,1297,244,430,97300,55705
837,711,126,630,79000,55706
1202,1043,159,747,183200,55707
328,263,65,717,83100,55708
1641,1504,137,896,166400,55709
573,552,21,-,148800,55710
203,166,37,950,170200,55711
271,256,15,-,133900,55712
474,349,125,919,109500,55713
149,84,65,756,68100,55716
125,120,5,-,273700,55717
1168,977,191,794,227000,55718
2368,1834,534,665,115200,55719
7025,5182,1843,865,169000,55720
1358,1227,131,587,216100,55721
368,285,83,753,119300,55722
943,811,132,538,152600,55723
379,349,30,-,162900,55724
54,52,2,-,294400,55725
363,274,89,888,174300,55726
2703,2021,682,587,183000,55731
668,643,25,-,135400,55732
2042,1956,86,1246,266800,55733
2756,2101,655,751,133400,55734
694,642,52,656,173700,55735
651,545,106,658,123900,55736
232,221,11,-,115700,55738
1430,1248,182,577,118500,55741
91,91,0,-,193800,55742
8114,6138,1976,848,188400,55744
7851,5941,1910,609,114800,55746
534,426,108,800,161900,55748
240,210,30,975,210100,55749
897,834,63,695,69900,55750
636,592,44,758,144800,55751
178,167,11,-,159700,55752
504,412,92,725,59300,55753
115,104,11,-,165600,55756
287,255,32,800,177000,55757
75,70,5,513,62000,55758
1234,992,242,769,201600,55760
282,259,23,-,164800,55763
221,163,58,639,76800,55764
368,329,39,625,145100,55765
1158,848,310,779,174500,55767
1219,894,325,602,168400,55768
1085,943,142,811,128300,55769
673,570,103,766,152800,55771
62,21,41,773,-,55772
594,581,13,-,176300,55775
1460,1312,148,1516,230100,55779
85,69,16,482,168300,55780
294,281,13,-,307400,55781
240,202,38,485,75300,55782
946,877,69,936,207300,55783
63,57,6,-,177100,55784
121,110,11,-,158700,55785
123,108,15,475,86800,55786
252,225,27,842,153400,55787
863,757,106,540,267600,55790
4791,2888,1903,681,103800,55792
271,237,34,558,159100,55793
656,568,88,781,188300,55795
65,42,23,843,73300,55796
563,511,52,950,203000,55797
223,204,19,625,207000,55798
1297,438,859,468,412400,55802
7446,6118,1328,1214,257700,55803
6056,5368,688,1264,240600,55804
4837,1357,3480,841,136700,55805
4369,1985,2384,825,126200,55806
4213,2954,1259,791,134900,55807
2520,1818,702,837,120700,55808
3343,2900,443,786,169100,55810
10925,7858,3067,1137,242100,55811
3488,1570,1918,939,238200,55812
0,0,0,-,-,55814
22829,14863,7966,1144,234700,55901
11354,8128,3226,1299,351800,55902
0,0,0,-,-,55903
11465,7459,4006,1067,192100,55904
0,0,0,-,-,55905
7974,6260,1714,929,286400,55906
521,462,59,573,169500,55909
512,456,56,688,221600,55910
11517,8180,3337,831,127500,55912
1376,1195,181,782,157300,55917
392,341,51,682,131500,55918
454,422,32,583,163700,55919
3095,2643,452,1000,285600,55920
1987,1577,410,678,143900,55921
329,272,57,538,99100,55922
1742,1448,294,803,217100,55923
468,418,50,886,159400,55924
418,395,23,518,235300,55925
282,209,73,650,165100,55926
1579,1299,280,769,174200,55927
437,388,49,723,235300,55929
168,134,34,490,133300,55931
791,626,165,655,230400,55932
91,85,6,875,163300,55933
1437,1123,314,730,243800,55934
391,330,61,677,168900,55935
707,583,124,672,171700,55936
774,631,143,721,163100,55939
1099,836,263,836,188400,55940
485,318,167,777,184400,55941
1194,993,201,718,188300,55943
2867,2570,297,694,223900,55944
607,522,85,770,183500,55945
1355,1111,244,740,198800,55946
3185,2702,483,881,216900,55947
771,619,152,526,194900,55949
53,47,6,-,92500,55950
576,437,139,807,121600,55951
900,712,188,810,184000,55952
343,269,74,639,151200,55953
524,455,69,723,109700,55954
942,872,70,800,339400,55955
866,722,144,903,241700,55956
298,239,59,695,248600,55957
867,669,198,721,171000,55959
1188,1136,52,1565,318000,55960
183,154,29,931,127600,55961
324,280,44,692,196600,55962
2209,1611,598,848,282900,55963
1743,1422,321,692,190300,55964
978,752,226,543,162100,55965
352,327,25,1071,234000,55967
73,57,16,975,193800,55968
407,359,48,771,211100,55969
397,353,44,729,152200,55970
1114,922,192,745,181700,55971
2013,1664,349,816,222300,55972
97,86,11,1438,208300,55973
968,730,238,875,147300,55974
1779,1484,295,734,164800,55975
3175,2617,558,928,219500,55976
67,54,13,-,165600,55977
368,287,81,1087,212900,55979
1655,1337,318,671,190400,55981
251,238,13,838,259500,55982
699,561,138,550,218400,55983
657,536,121,1039,168000,55985
14273,9154,5119,741,170300,55987
397,318,79,808,146500,55990
603,547,56,827,249700,55991
2334,1759,575,706,219400,55992
19459,10992,8467,968,210200,56001
6307,4871,1436,827,220600,56003
9011,6747,2264,746,128200,56007
577,494,83,800,137800,56009
513,425,88,688,135600,56010
3425,2995,430,988,265700,56011
2002,1411,591,751,122400,56013
282,237,45,500,78100,56014
378,339,39,813,156300,56016
720,590,130,780,241400,56017
344,278,66,539,104700,56019
39,38,1,-,80000,56020
449,380,69,850,218600,56021
40,40,0,-,52200,56022
222,181,41,550,107700,56023
1239,820,419,1217,215500,56024
193,175,18,1321,132600,56025
762,660,102,842,195400,56026
294,242,52,775,50600,56027
464,395,69,1093,300500,56028
270,243,27,594,96700,56029
7,7,0,-,-,56030
5213,3660,1553,715,148500,56031
145,132,13,892,78700,56032
160,145,15,525,64600,56033
159,144,15,546,154700,56034
187,156,31,525,143800,56035
756,649,107,675,141900,56036
659,587,72,581,210900,56037
359,320,39,741,124500,56039
423,360,63,631,160000,56041
334,278,56,498,175000,56042
175,152,23,-,150000,56043
774,686,88,882,234300,56044
367,344,23,611,120000,56045
47,45,2,-,85000,56046
1676,1439,237,749,177400,56048
525,441,84,655,239900,56050
297,246,51,937,52100,56051
252,232,20,1625,287500,56052
361,327,34,750,153500,56054
1600,1303,297,713,180400,56055
33,32,1,-,60000,56056
1510,1235,275,739,204200,56057
2523,1830,693,745,193600,56058
168,141,27,467,59100,56060
1190,866,324,619,141000,56062
1143,980,163,750,331600,56063
994,790,204,663,177200,56065
403,329,74,685,134200,56068
1897,1547,350,960,209400,56069
4418,3788,630,1076,309900,56071
871,690,181,687,161400,56072
7121,5466,1655,836,160200,56073
692,546,146,955,211800,56074
73,60,13,713,78600,56075
192,161,31,1219,150700,56078
280,242,38,-,162300,56080
2443,1870,573,640,105800,56081
4683,3191,1492,898,215400,56082
352,307,45,768,88200,56083
2108,1796,312,623,136100,56085
1306,1017,289,667,118000,56087
868,646,222,633,105700,56088
98,75,23,592,-,56089
274,220,54,875,124500,56090
131,115,16,850,105800,56091
5001,3922,1079,861,165200,56093
1179,945,234,742,203000,56096
1551,1256,295,608,96500,56097
831,662,169,660,99300,56098
2499,1879,620,723,130300,56101
619,516,103,725,173200,56110
193,171,22,775,79500,56111
96,88,8,-,90000,56113
150,127,23,1031,161000,56114
516,424,92,905,171600,56115
223,190,33,658,223100,56116
125,89,36,1299,103700,56117
193,188,5,-,165500,56118
330,303,27,-,152800,56119
358,327,31,692,82600,56120
309,248,61,1281,98600,56121
218,185,33,629,107500,56122
177,153,24,838,84500,56123
31,31,0,-,44400,56125
212,125,87,1016,101300,56127
771,660,111,825,151600,56128
290,222,68,700,86400,56129
897,761,136,744,133100,56131
231,210,21,825,209300,56132
172,135,37,581,118800,56134
614,492,122,663,163800,56136
430,368,62,575,110600,56137
405,316,89,900,161000,56138
158,130,28,688,117500,56139
37,35,2,-,74800,56140
136,119,17,656,83700,56141
428,370,58,756,74400,56142
2054,1570,484,745,135200,56143
466,365,101,950,87900,56144
207,189,18,625,69700,56145
23,18,5,-,106300,56146
77,62,15,-,153100,56147
516,399,117,588,130700,56149
1146,938,208,820,110600,56150
300,282,18,913,142100,56151
558,482,76,575,109000,56152
77,69,8,-,66500,56153
223,193,30,590,74100,56155
2554,1953,601,619,165700,56156
288,224,64,933,157100,56157
137,120,17,654,111100,56158
980,778,202,545,107100,56159
102,87,15,525,73600,56160
144,136,8,-,107400,56161
101,98,3,-,85000,56162
2453,1775,678,556,119700,56164
125,109,16,600,163800,56165
75,70,5,575,150000,56166
296,254,42,514,113900,56167
303,261,42,558,139800,56168
281,243,38,625,110100,56169
250,217,33,775,85800,56170
738,590,148,583,127700,56171
1295,999,296,534,161300,56172
122,92,30,750,100000,56173
152,124,28,833,76300,56174
1106,906,200,633,108900,56175
418,354,64,608,100300,56176
685,535,150,659,119900,56178
443,346,97,486,88100,56180
516,448,68,610,95500,56181
597,456,141,537,84700,56183
214,195,19,645,116500,56185
158,135,23,-,153300,56186
5032,3364,1668,825,148800,56187
9184,5935,3249,768,161100,56201
92,83,9,825,82100,56207
968,724,244,537,72500,56208
913,748,165,829,178900,56209
5,5,0,-,106300,56210
196,170,26,656,100000,56211
203,180,23,625,66400,56212
275,225,50,746,93200,56214
2035,1404,631,759,124100,56215
333,289,44,1250,121000,56216
214,202,12,820,78800,56218
413,288,125,721,101800,56219
1151,984,167,512,124400,56220
321,265,56,654,103800,56221
842,619,223,1049,136500,56222
542,445,97,669,92300,56223
129,111,18,755,96100,56224
299,216,83,679,103900,56225
92,77,15,-,176100,56226
112,93,19,-,232100,56227
383,332,51,657,113800,56228
753,604,149,641,168600,56229
309,228,81,747,118000,56230
144,134,10,888,155000,56231
896,742,154,524,135100,56232
216,186,30,963,105000,56235
156,146,10,-,112900,56236
247,209,38,525,102700,56237
244,202,42,833,150700,56239
341,236,105,648,106800,56240
1597,1166,431,696,140800,56241
688,543,145,737,149600,56243
582,462,120,759,147100,56244
222,183,39,620,78100,56245
350,279,71,516,127500,56248
129,113,16,525,91300,56249
363,317,46,754,171600,56251
492,352,140,701,155300,56252
414,364,50,725,172700,56253
174,122,52,589,135000,56255
1085,888,197,780,94900,56256
216,179,37,833,56300,56257
5979,3577,2402,688,173900,56258
407,299,108,586,123200,56260
308,259,49,775,75000,56262
192,166,26,479,152600,56263
857,680,177,647,151700,56264
3172,2198,974,733,121200,56265
573,464,109,946,116400,56266
2679,1658,1021,668,180500,56267
434,390,44,800,86500,56270
507,375,132,900,154900,56271
1989,1740,249,858,256100,56273
78,78,0,-,158300,56274
96,86,10,-,65000,56276
1257,838,419,720,152000,56277
1293,906,387,627,111900,56278
462,401,61,886,181300,56279
218,184,34,770,173100,56280
228,206,22,800,157600,56281
585,443,142,800,161900,56282
2579,1824,755,785,149400,56283
751,616,135,850,107900,56284
453,381,72,744,105300,56285
32,31,1,-,-,56287
1994,1762,232,723,306900,56288
305,272,33,694,259800,56289
185,172,13,625,150000,56291
216,196,20,917,117100,56292
478,390,88,592,143100,56293
53,38,15,-,-,56294
132,101,31,628,75600,56295
843,693,150,528,86800,56296
322,289,33,575,99700,56297
12614,6652,5962,965,207800,56301
10725,6741,3984,833,154100,56303
6961,3079,3882,846,183300,56304
1912,1592,320,545,232200,56307
11546,7993,3553,796,264200,56308
563,451,112,833,236300,56309
1991,1732,259,927,231900,56310
307,255,52,680,152300,56311
940,775,165,748,180700,56312
32,24,8,-,95000,56313
467,429,38,864,226800,56314
713,590,123,655,192800,56315
583,488,95,733,163800,56316
432,381,51,692,185100,56318
578,524,54,1016,234900,56319
3102,2613,489,923,254700,56320
0,0,0,-,-,56321
230,178,52,633,106000,56323
468,431,37,810,196100,56324
81,78,3,-,135300,56325
728,605,123,610,206000,56326
345,338,7,840,320000,56327
77,67,10,817,123200,56328
2703,2239,464,743,222900,56329
656,598,58,861,206000,56330
771,694,77,738,228300,56331
686,635,51,796,255400,56332
2510,1985,525,738,218700,56334
90,89,1,-,125500,56335
647,587,60,395,241300,56336
676,607,69,953,222400,56338
400,302,98,636,142200,56339
926,840,86,910,239000,56340
1218,1054,164,693,191000,56342
414,383,31,482,185800,56343
6274,4553,1721,793,180100,56345
2918,2207,711,765,151600,56347
318,271,47,679,216500,56349
200,174,26,956,125000,56350
2458,1950,508,894,180400,56352
3619,2853,766,797,183800,56353
591,541,50,769,291200,56354
214,188,26,1052,246600,56355
97,97,0,-,140200,56356
386,364,22,-,227800,56357
1257,1115,142,944,186500,56358
1338,939,399,804,170000,56359
1762,1380,382,674,203400,56360
925,797,128,700,180400,56361
2168,1787,381,688,211400,56362
85,64,21,1034,125000,56363
2099,1788,311,778,201300,56364
2598,2353,245,970,226000,56367
1646,1487,159,748,261400,56368
226,110,116,746,170400,56369
37,24,13,990,112500,56371
1179,941,238,677,223100,56373
3280,2590,690,888,216700,56374
337,316,21,730,195100,56375
128,110,18,291,165300,56376
7870,5031,2839,1070,231100,56377
3354,2445,909,720,195100,56378
6897,4595,2302,847,203700,56379
997,833,164,805,170000,56381
534,477,57,625,195700,56382
134,74,60,638,126600,56384
445,382,63,-,162700,56385
308,245,63,713,225000,56386
3515,1386,2129,952,190000,56387
36,34,2,-,100000,56389
12558,8992,3566,784,190200,56401
3447,2345,1102,1015,211700,56425
3695,3145,550,818,220100,56431
773,669,104,861,192600,56433
71,65,6,625,163400,56434
1198,1084,114,815,188800,56435
464,372,92,619,87300,56437
1068,879,189,745,152700,56438
517,415,102,725,117100,56440
1722,1095,627,741,148800,56441
1376,1201,175,906,383500,56442
626,571,55,943,264200,56443
1341,1199,142,664,249400,56444
640,568,72,630,123800,56446
365,337,28,1188,253100,56447
218,214,4,-,300000,56448
725,683,42,939,213100,56449
492,419,73,924,161600,56450
934,826,108,650,265700,56452
301,283,18,813,109100,56453
649,482,167,908,145800,56455
148,131,17,817,177900,56458
1306,1203,103,820,192400,56461
1672,1400,272,749,164600,56464
889,826,63,1313,279500,56465
1306,1064,242,709,174700,56466
1064,1014,50,745,260400,56467
1776,1649,127,973,346400,56468
486,453,33,733,196200,56469
4384,3224,1160,788,226400,56470
3379,2876,503,778,243900,56472
1307,1171,136,837,192600,56473
1864,1441,423,772,163300,56474
641,568,73,673,166300,56475
1136,923,213,625,145300,56477
1832,1478,354,882,131700,56479
888,744,144,589,143200,56481
2975,1988,987,598,143000,56482
1359,1038,321,713,239400,56484
7284,5411,1873,847,242100,56501
926,702,224,548,108500,56510
798,728,70,738,272100,56511
1414,1180,234,745,189400,56514
1243,1107,136,807,323800,56515
122,107,15,-,161900,56516
95,79,16,-,140800,56517
152,127,25,830,103100,56518
111,91,20,1050,98800,56519
1713,1213,500,524,147100,56520
311,255,56,700,113400,56521
175,146,29,1042,132600,56522
156,125,31,613,120800,56523
296,259,37,800,290400,56524
32,32,0,-,125000,56525
314,265,49,820,175500,56527
750,646,104,1036,265700,56528
1847,1449,398,799,231800,56529
788,608,180,733,133200,56531
116,99,17,1175,150700,56533
530,488,42,850,186800,56534
516,381,135,751,155700,56535
145,133,12,539,167700,56536
8610,6126,2484,721,171800,56537
726,605,121,684,158600,56540
27,24,3,-,85500,56541
1042,757,285,797,153600,56542
96,87,9,-,177100,56543
2120,1735,385,804,191600,56544
268,238,30,313,122100,56545
93,90,3,-,187500,56546
945,801,144,589,234100,56547
304,228,76,708,103700,56548
1783,1493,290,737,265300,56549
141,117,24,775,119200,56550
918,701,217,731,189300,56551
202,174,28,675,126600,56552
122,120,2,-,-,56553
1096,999,97,671,254100,56554
448,330,118,688,114300,56556
984,626,358,694,92100,56557
17665,10608,7057,908,212700,56560
0,0,0,-,-,56562
0,0,0,-,-,56563
38,34,4,-,105000,56565
197,95,102,434,104800,56566
1297,1028,269,617,159100,56567
56,52,4,400,128600,56568
464,383,81,472,154900,56569
465,433,32,640,221900,56570
785,710,75,912,270500,56571
2165,1837,328,525,242700,56572
2712,2070,642,713,221000,56573
115,113,2,-,99600,56574
272,212,60,563,210000,56575
383,332,51,975,306700,56576
293,283,10,-,259600,56578
393,355,38,809,175900,56579
474,451,23,742,201600,56580
130,116,14,-,103300,56581
67,54,13,-,-,56583
558,452,106,850,99200,56584
484,392,92,563,168500,56585
813,736,77,1007,247800,56586
568,511,57,734,278400,56587
185,177,8,-,253300,56588
692,578,114,679,163200,56589
157,137,20,789,112500,56590
216,50,166,199,61100,56591
157,133,24,635,117800,56592
183,167,16,-,148600,56594
13661,9034,4627,870,195100,56601
1666,1296,370,721,144800,56621
1058,886,172,668,180100,56623
87,72,15,921,155000,56626
136,108,28,480,50000,56627
650,549,101,954,187800,56628
74,74,0,-,181800,56629
851,667,184,621,146400,56630
1556,1042,514,783,130100,56633
615,475,140,696,168100,56634
1932,1673,259,626,168100,56636
73,69,4,-,166900,56637
207,177,30,-,160500,56639
132,101,31,838,157300,56641
281,233,48,500,134400,56644
155,129,26,613,175700,56646
313,260,53,775,187500,56647
4189,3322,867,709,116100,56649
424,384,40,580,160200,56650
191,160,31,713,117900,56651
186,172,14,-,188100,56652
560,488,72,-,124500,56653
38,31,7,-,98300,56654
758,695,63,705,243200,56655
90,81,9,-,178100,56657
0,0,0,-,-,56658
64,63,1,-,184400,56659
119,113,6,-,113800,56660
402,356,46,-,125000,56661
249,244,5,-,277400,56662
84,77,7,-,-,56663
210,97,113,377,88100,56666
305,275,30,1141,179200,56667
95,82,13,-,157100,56668
108,106,2,-,207100,56669
300,235,65,572,76100,56670
831,474,357,492,89300,56671
892,743,149,684,216400,56672
165,154,11,1075,183600,56673
714,652,62,878,161600,56676
615,567,48,1031,162700,56678
54,50,4,-,150000,56680
104,90,14,817,158900,56681
253,231,22,938,201000,56683
139,129,10,550,142200,56684
62,53,9,-,173400,56685
337,298,39,-,134200,56686
64,64,0,-,120600,56688
5562,4053,1509,809,161800,56701
191,166,25,500,112200,56710
5,5,0,-,-,56711
409,327,82,395,137500,56713
467,397,70,685,112700,56714
137,120,17,465,190600,56715
3791,2315,1476,755,151200,56716
8,8,0,-,-,56720
4165,2891,1274,699,218800,56721
145,133,12,-,165600,56722
313,259,54,905,198400,56723
51,49,2,-,77200,56724
346,302,44,-,160500,56725
601,551,50,395,121200,56726
351,327,24,653,121700,56727
492,407,85,739,118800,56728
48,47,1,-,-,56729
46,43,3,-,124400,56731
430,329,101,580,107500,56732
164,149,15,720,87900,56733
189,154,35,667,66700,56734
274,215,59,696,135900,56735
326,300,26,1063,173400,56736
354,306,48,472,102800,56737
528,460,68,683,165600,56738
311,268,43,800,102900,56742
198,177,21,613,109500,56744
252,192,60,763,117000,56748
1005,825,180,595,132400,56750
2207,1711,496,754,164200,56751
224,212,12,1083,206900,56754
32,32,0,-,57500,56755
210,190,20,763,125000,56756
355,302,53,850,108700,56757
132,121,11,-,105700,56758
124,119,5,-,159200,56759
189,167,22,825,151900,56760
157,152,5,-,130600,56761
1023,773,250,767,121300,56762
1874,1408,466,588,149400,56763
668,533,135,648,140600,57001
611,481,130,743,183900,57002
659,603,56,924,214400,57003
1493,1124,369,770,196300,57004
4410,3501,909,878,271600,57005
9540,5048,4492,801,205800,57006
0,0,0,-,-,57007
280,196,84,-,169300,57010
469,355,114,586,146600,57012
1751,1380,371,647,171000,57013
690,547,143,632,153400,57014
285,248,37,558,234500,57015
326,300,26,1000,175000,57016
493,416,77,750,169700,57017
550,461,89,637,166000,57018
605,571,34,1023,229700,57020
159,133,26,-,-,57021
2162,1749,413,861,237800,57022
218,193,25,581,108500,57024
1139,890,249,722,164700,57025
546,391,155,690,185000,57026
64,60,4,-,111600,57027
1230,767,463,612,153500,57028
888,708,180,632,123800,57029
1121,864,257,735,226100,57030
393,358,35,463,116900,57031
2982,2591,391,1078,234200,57032
2169,1728,441,920,244000,57033
368,298,70,-,123100,57034
368,329,39,638,197100,57035
261,224,37,-,107100,57036
405,240,165,715,112800,57037
613,565,48,-,257800,57038
1496,1218,278,708,185900,57039
145,131,14,625,97500,57040
29,29,0,-,272500,57041
3213,2090,1123,753,166800,57042
568,455,113,718,155000,57043
454,377,77,495,87400,57045
360,284,76,745,156700,57046
140,110,30,625,39800,57047
512,418,94,522,242200,57048
3248,1975,1273,1058,309200,57049
136,124,12,-,141700,57050
133,119,14,379,62300,57051
104,77,27,375,-,57052
803,688,115,650,199200,57053
247,219,28,588,94100,57054
512,480,32,-,326200,57055
93,85,8,-,237500,57057
718,579,139,864,159400,57058
542,457,85,533,90900,57059
64,60,4,-,67400,57061
498,356,142,630,117100,57062
337,297,40,933,90500,57063
2351,1710,641,999,257000,57064
165,118,47,657,120000,57065
662,500,162,732,90400,57066
94,70,24,1125,-,57067
609,520,89,959,168300,57068
4535,2252,2283,723,185300,57069
578,393,185,657,136900,57070
1360,958,402,859,200400,57071
265,194,71,810,152900,57072
188,157,31,586,95900,57073
461,412,49,499,370000,57075
194,148,46,-,259200,57076
484,467,17,890,181500,57077
8254,5570,2684,683,173500,57078
14095,9544,4551,845,193500,57103
11731,4765,6966,731,136800,57104
9568,6308,3260,867,195200,57105
20037,12389,7648,912,222400,57106
4183,2871,1312,918,190000,57107
12512,8124,4388,1191,326200,57108
7639,4944,2695,930,286500,57110
0,0,0,-,-,57117
0,0,0,-,-,57197
11005,7186,3819,821,189100,57201
838,658,180,648,186800,57212
164,138,26,1545,112500,57213
51,47,4,-,63000,57214
602,516,86,709,157800,57216
111,86,25,-,150000,57217
147,112,35,1708,204500,57218
208,148,60,870,75000,57219
349,286,63,575,165000,57220
313,235,78,567,180100,57221
474,397,77,650,173200,57223
76,67,9,768,81000,57224
731,565,166,568,106500,57225
756,502,254,536,151900,57226
110,83,27,-,142500,57227
681,557,124,688,157600,57231
161,149,12,767,359400,57232
70,61,9,-,267900,57233
468,422,46,497,152900,57234
321,269,52,592,187500,57235
55,50,5,-,-,57236
282,246,36,446,-,57237
184,139,45,660,152600,57238
148,138,10,-,272500,57239
327,263,64,656,138500,57241
130,126,4,-,173400,57242
276,232,44,725,79900,57243
73,51,22,1350,117500,57245
72,71,1,-,72100,57246
87,71,16,-,219600,57247
391,278,113,859,195500,57248
385,295,90,446,142900,57249
45,33,12,-,-,57251
1953,1623,330,529,148000,57252
155,120,35,525,76900,57255
66,59,7,-,-,57256
220,139,81,544,-,57257
55,48,7,-,105000,57258
255,216,39,1078,103100,57259
383,332,51,716,122000,57260
119,90,29,392,105000,57261
1831,945,886,573,111200,57262
192,164,28,575,85000,57263
107,90,17,463,104300,57264
83,74,9,-,80000,57265
194,140,54,675,88000,57266
220,181,39,337,103800,57268
77,74,3,-,231000,57269
268,165,103,553,52400,57270
50,47,3,-,89000,57271
74,70,4,-,154500,57272
411,271,140,650,105900,57273
1193,911,282,510,157000,57274
462,381,81,638,134400,57276
261,218,43,639,159300,57278
439,377,62,621,119400,57279
7917,4919,2998,742,156600,57301
529,449,80,845,150600,57311
288,255,33,731,91700,57312
455,344,111,633,82900,57313
253,208,45,485,110400,57314
464,364,100,667,86200,57315
206,134,72,482,93300,57317
340,269,71,990,106000,57319
115,102,13,-,108800,57321
114,93,21,-,101400,57322
101,85,16,-,55000,57323
166,153,13,-,144200,57324
1157,731,426,690,164100,57325
435,318,117,830,132100,57328
140,114,26,738,95000,57329
184,139,45,536,134200,57330
130,102,28,182,184700,57331
272,249,23,675,114100,57332
335,239,96,819,147200,57334
110,98,12,413,48800,57335
45,45,0,-,-,57337
345,143,202,516,89000,57339
87,86,1,-,161400,57340
49,41,8,-,177100,57341
130,127,3,-,78000,57342
45,45,0,-,71500,57344
475,422,53,830,94700,57345
28,0,28,450,-,57346
282,182,100,646,112500,57348
580,450,130,523,76700,57349
6316,4192,2124,734,121000,57350
283,257,26,436,165400,57353
16,16,0,-,-,57354
533,376,157,853,138500,57355
622,410,212,615,83200,57356
11,9,2,-,17800,57358
216,172,44,775,131300,57359
72,47,25,372,23300,57361
885,579,306,485,110800,57362
424,301,123,-,163400,57363
5,0,5,-,-,57364
262,210,52,771,240000,57365
1013,761,252,685,146600,57366
106,86,20,696,219000,57367
419,318,101,734,108900,57368
999,726,273,718,202300,57369
271,198,73,728,100900,57370
75,40,35,-,-,57371
188,136,52,-,150000,57373
129,118,11,-,157400,57374
255,213,42,-,105800,57375
403,302,101,388,73800,57376
35,32,3,-,72500,57379
959,658,301,635,123000,57380
214,174,40,434,82000,57381
546,415,131,483,104200,57382
343,272,71,657,120000,57383
440,390,50,561,113400,57384
535,378,157,475,106300,57385
154,105,49,583,104700,57386
13755,8471,5284,707,174100,57401
53,38,15,-,109400,57420
25,25,0,-,-,57421
88,76,12,-,76700,57422
83,79,4,-,57900,57424
5,0,5,-,-,57426
199,199,0,-,286900,57427
211,167,44,568,84300,57428
45,40,5,-,37500,57429
819,646,173,715,122400,57430
153,151,2,-,-,57432
202,172,30,582,146900,57433
200,166,34,566,102800,57434
121,99,22,-,171900,57435
213,176,37,615,58900,57436
600,494,106,476,66500,57437
397,315,82,733,99800,57438
28,28,0,-,-,57439
152,136,16,570,62900,57440
210,196,14,850,106300,57441
899,677,222,665,137200,57442
728,554,174,831,153800,57445
268,260,8,525,-,57446
194,179,15,425,46500,57448
100,61,39,-,116000,57449
204,163,41,-,93800,57450
837,670,167,693,218700,57451
105,91,14,-,45600,57452
272,238,34,536,89200,57454
50,36,14,-,58800,57455
221,169,52,702,73000,57456
46,39,7,-,50800,57457
99,83,16,-,-,57460
138,114,24,836,108300,57461
152,146,6,-,110900,57465
64,52,12,-,-,57466
122,111,11,-,-,57467
152,126,26,680,81700,57468
1290,923,367,629,135000,57469
25,17,8,-,51700,57470
232,195,37,817,66000,57471
369,292,77,850,99200,57472
80,77,3,-,120300,57473
63,58,5,-,-,57474
53,49,4,-,103100,57475
157,142,15,640,138900,57476
50,44,6,-,66700,57477
224,204,20,818,184800,57479
159,151,8,-,142500,57481
7233,5194,2039,812,188300,57501
88,62,26,-,88800,57520
64,43,21,-,40800,57521
232,135,97,725,114400,57522
409,314,95,471,112500,57523
361,234,127,579,83200,57528
106,93,13,-,-,57529
36,26,10,-,-,57531
1249,1023,226,794,160200,57532
682,501,181,661,93400,57533
70,62,8,-,187500,57534
157,123,34,763,105200,57536
37,32,5,-,-,57537
84,74,10,-,70000,57538
35,26,9,-,313300,57540
34,18,16,1028,-,57541
273,178,95,563,105000,57543
162,137,25,805,122600,57544
56,48,8,-,57000,57547
343,106,237,525,57000,57548
731,444,287,682,102100,57551
260,227,33,-,90900,57552
47,44,3,-,160000,57553
1068,574,494,486,40000,57555
294,205,89,673,90500,57559
175,91,84,-,-,57560
22,22,0,-,78900,57562
36,14,22,392,-,57563
353,314,39,873,151500,57564
187,80,107,438,"10,000-",57566
439,337,102,690,141100,57567
231,193,38,727,143300,57568
105,75,30,-,64200,57569
480,160,320,505,30500,57570
11,11,0,-,63900,57571
374,181,193,507,22700,57572
77,49,28,-,280500,57574
66,46,20,-,97800,57576
216,83,133,508,-,57577
359,226,133,698,53800,57579
1628,1185,443,739,116100,57580
28,23,5,-,53000,57584
70,47,23,-,61300,57585
1646,1060,586,740,95300,57601
259,207,52,858,77500,57620
51,11,40,483,11900,57621
83,28,55,700,-,57622
254,166,88,623,63600,57623
1115,571,544,624,58400,57625
291,224,67,529,100000,57626
22,22,0,-,212500,57630
189,179,10,-,153900,57631
297,229,68,672,77600,57632
177,139,38,650,65800,57633
34,27,7,-,114400,57634
28,22,6,-,110000,57636
791,637,154,621,83800,57638
73,8,65,250,-,57639
54,37,17,-,275000,57640
121,98,23,438,43800,57641
525,234,291,542,52900,57642
144,111,33,-,161300,57644
65,59,6,-,26500,57645
97,93,4,-,101100,57646
180,146,34,667,71100,57648
98,78,20,-,77500,57649
4,0,4,-,-,57650
49,47,2,-,98000,57651
83,48,35,546,83700,57652
312,226,86,554,73600,57656
55,46,9,-,66300,57657
87,39,48,413,60800,57658
1,1,0,-,-,57659
32,24,8,-,109100,57660
53,26,27,-,-,57661
18311,10635,7676,834,175800,57701
14615,11030,3585,957,278900,57702
6421,5375,1046,1172,191600,57703
502,0,502,1466,-,57706
160,40,120,588,114500,57714
154,117,37,-,-,57716
3281,2475,806,889,161700,57717
3090,2729,361,1059,207400,57718
3974,2532,1442,1046,211900,57719
297,191,106,547,120500,57720
81,68,13,-,72500,57722
91,58,33,-,192900,57724
131,98,33,-,-,57725
2433,1889,544,949,244900,57730
1064,669,395,684,217200,57732
589,431,158,775,78600,57735
0,0,0,-,-,57737
157,150,7,-,-,57738
68,53,15,-,-,57741
731,700,31,931,307100,57744
713,587,126,913,257200,57745
2687,2078,609,757,159000,57747
83,66,17,-,156300,57748
49,25,24,-,167500,57750
357,291,66,446,265200,57751
424,166,258,395,-,57752
1772,1197,575,774,172700,57754
57,41,16,-,56500,57755
131,0,131,553,-,57756
48,33,15,-,22800,57758
56,56,0,-,-,57759
365,307,58,-,123300,57760
377,312,65,746,167700,57761
205,184,21,967,190900,57762
129,109,20,900,72500,57763
469,266,203,464,-,57764
61,61,0,-,80900,57766
98,85,13,-,-,57767
1520,1371,149,1024,249200,57769
1017,523,494,564,52700,57770
321,218,103,908,33300,57772
100,88,12,-,"10,000-",57773
93,76,17,-,180000,57775
0,0,0,-,-,57776
137,137,0,-,245100,57779
37,17,20,-,"10,000-",57780
13,11,2,-,316700,57782
7096,4270,2826,867,254500,57783
4067,2936,1131,632,190400,57785
206,155,51,774,154000,57787
174,144,30,-,-,57788
373,284,89,600,152000,57790
85,65,20,-,161200,57791
51,51,0,-,100900,57792
721,587,134,788,186500,57793
54,24,30,-,-,57794
0,0,0,-,-,57799
113,100,13,-,100000,58001
0,0,0,-,-,58002
147,123,24,-,134400,58004
330,330,0,-,326700,58005
187,160,27,600,212500,58006
37,31,6,-,320600,58007
99,87,12,-,164600,58008
9,9,0,-,-,58009
181,161,20,-,205200,58011
1162,742,420,707,238900,58012
68,66,2,-,-,58013
90,80,10,-,246400,58015
122,94,28,-,117200,58016
138,88,50,500,65000,58017
146,130,16,-,185000,58018
178,167,11,-,207600,58021
636,484,152,771,99200,58027
17,13,4,-,325000,58029
263,245,18,456,83200,58030
144,136,8,-,84000,58031
313,231,82,656,153300,58032
183,167,16,575,225000,58033
96,91,5,-,167200,58035
93,88,5,-,207700,58036
107,91,16,438,145200,58038
517,328,189,829,159200,58040
622,544,78,385,120700,58041
497,461,36,895,299800,58042
69,66,3,-,82200,58043
910,666,244,613,145100,58045
233,190,43,536,107700,58046
1618,1576,42,550,416200,58047
173,151,22,588,138600,58048
138,129,9,-,106600,58049
600,502,98,610,319000,58051
242,212,30,725,201500,58052
538,425,113,634,75300,58053
1270,903,367,806,150900,58054
65,38,27,-,-,58056
88,80,8,-,173100,58057
45,45,0,-,128100,58058
502,447,55,1058,228000,58059
505,386,119,725,146900,58060
128,99,29,425,158200,58061
72,72,0,-,125000,58062
148,141,7,-,-,58063
203,154,49,481,210800,58064
7,7,0,-,-,58065
106,89,17,710,107500,58067
141,106,35,-,72900,58068
67,48,19,-,109400,58069
188,132,56,504,152600,58071
3521,2487,1034,735,156100,58072
21,21,0,-,-,58074
3818,2224,1594,682,139700,58075
0,0,0,-,-,58076
291,256,35,923,216700,58077
14978,10083,4895,961,256300,58078
133,133,0,-,226100,58079
377,334,43,588,157200,58081
13823,6427,7396,765,207000,58102
23452,9668,13784,776,198700,58103
19233,9550,9683,978,289000,58104
14,11,3,-,-,58105
18957,9172,9785,883,239200,58201
193,7,186,1157,-,58202
7468,2949,4519,781,175000,58203
587,0,587,1486,-,58204
0,0,0,-,-,58205
128,114,14,580,78900,58210
180,127,53,442,73700,58212
160,144,16,720,222200,58214
65,40,25,-,-,58216
324,287,37,675,200900,58218
36,36,0,-,60000,58219
972,627,345,710,134500,58220
102,93,9,-,59400,58222
59,47,12,-,124200,58223
7,7,0,-,-,58224
429,332,97,492,102300,58225
228,198,30,584,106800,58227
341,223,118,731,138500,58228
39,39,0,-,66400,58229
287,202,85,555,71100,58230
159,144,15,-,68700,58231
136,117,19,-,116300,58233
206,174,32,763,78000,58235
39,37,2,-,-,58236
2204,1570,634,595,112800,58237
33,32,1,-,-,58238
12,9,3,-,-,58239
498,430,68,652,154000,58240
73,54,19,1263,143800,58241
231,208,23,880,92000,58243
16,15,1,-,104200,58244
1003,804,199,623,128100,58249
100,74,26,-,72900,58250
820,589,231,686,167100,58251
221,191,30,-,90400,58254
0,0,0,-,-,58255
298,268,30,1125,176100,58256
791,454,337,724,157300,58257
128,125,3,-,88200,58258
242,183,59,688,101900,58259
73,64,9,-,75600,58260
508,445,63,500,113400,58261
24,14,10,-,-,58262
176,171,5,-,91300,58265
55,29,26,-,-,58266
511,410,101,681,175500,58267
109,91,18,1056,62000,58269
794,604,190,1043,97200,58270
238,180,58,629,113600,58271
104,97,7,-,91900,58272
82,75,7,-,71900,58273
429,335,94,488,161600,58274
313,284,29,575,156900,58275
210,190,20,663,77500,58276
75,69,6,-,157300,58277
787,730,57,621,270900,58278
34,34,0,-,-,58281
590,400,190,588,97000,58282
4267,2364,1903,620,178600,58301
0,0,0,-,-,58310
29,23,6,-,-,58311
34,31,3,-,74100,58313
1706,1141,565,443,82500,58316
81,77,4,-,42900,58317
1572,1209,363,863,174800,58318
36,34,2,-,220000,58321
21,21,0,-,-,58323
625,435,190,626,117400,58324
21,20,1,-,-,58325
108,101,7,-,218800,58327
801,574,227,363,70300,58329
256,169,87,721,62500,58330
84,77,7,-,107300,58331
122,92,30,590,74600,58332
247,94,153,374,52600,58335
47,45,2,-,112500,58338
5,1,4,-,-,58339
1122,768,354,549,140000,58341
17,16,1,-,146400,58343
378,261,117,575,109300,58344
69,64,5,-,83300,58345
215,168,47,571,75000,58346
334,255,79,573,86800,58348
144,120,24,660,119400,58351
162,144,18,663,95000,58352
42,23,19,565,183000,58353
16,16,0,-,57500,58355
777,460,317,585,101200,58356
174,136,38,311,55800,58357
116,78,38,1550,225000,58361
0,0,0,-,-,58362
37,37,0,-,143800,58363
89,70,19,472,56700,58365
316,225,91,514,112100,58366
511,329,182,650,91500,58367
1454,1117,337,717,150200,58368
329,268,61,631,150900,58369
305,203,102,340,59700,58370
39,39,0,-,-,58372
304,253,51,546,99000,58374
136,95,41,620,72500,58377
54,17,37,633,-,58379
173,137,36,484,154900,58380
139,126,13,700,-,58381
70,59,11,-,157000,58382
168,152,16,675,48800,58384
63,57,6,-,117200,58385
35,26,9,-,53300,58386
7758,4631,3127,724,180800,58401
0,0,0,-,-,58402
0,0,0,-,-,58405
563,411,152,494,67900,58413
68,65,3,-,-,58415
170,153,17,383,71900,58416
194,158,36,563,73300,58418
92,89,3,-,169500,58420
1255,948,307,668,162200,58421
48,39,9,-,150700,58422
31,31,0,-,142500,58423
133,116,17,723,220600,58424
522,430,92,495,132600,58425
74,56,18,-,134400,58426
102,61,41,-,166900,58428
132,92,40,1053,162500,58429
57,57,0,-,-,58430
55,53,2,-,-,58431
518,386,132,480,113300,58433
667,508,159,695,131800,58436
368,308,60,520,75000,58438
55,55,0,-,225000,58439
59,47,12,-,-,58440
135,108,27,-,156900,58441
187,168,19,1042,94700,58442
64,58,6,-,-,58443
83,68,15,520,-,58444
73,64,9,-,155000,58445
148,110,38,604,94300,58448
41,38,3,-,65000,58451
13,8,5,-,-,58452
166,156,10,442,89300,58454
114,100,14,843,78300,58455
260,223,37,625,85000,58456
421,337,84,545,141400,58458
69,62,7,531,49300,58460
184,165,19,-,118400,58461
291,223,68,398,70300,58463
101,97,4,-,143800,58464
211,192,19,569,108300,58466
237,185,52,531,85600,58467
150,140,10,825,168800,58472
1068,864,204,642,132300,58474
84,79,5,-,29600,58475
200,190,10,1075,115900,58476
61,47,14,-,88500,58477
68,63,5,-,-,58478
69,62,7,-,105600,58479
100,84,16,715,77100,58480
124,107,17,-,228800,58481
442,324,118,565,134200,58482
132,107,25,300,145800,58483
38,30,8,-,72500,58484
75,66,9,-,80000,58486
185,155,30,638,71000,58487
83,68,15,465,-,58488
105,102,3,-,95000,58490
199,173,26,540,181300,58492
140,109,31,1016,75000,58494
502,366,136,617,110100,58495
99,49,50,430,158500,58496
81,57,24,-,99400,58497
11794,7003,4791,864,234300,58501
14766,11125,3641,1037,338000,58503
11443,8407,3036,846,250300,58504
0,0,0,-,-,58505
101,95,6,-,-,58520
287,283,4,-,389400,58521
1337,1078,259,781,201700,58523
43,43,0,-,148600,58524
152,57,95,435,91300,58528
308,256,52,735,66700,58529
427,352,75,538,169000,58530
180,180,0,-,278300,58531
143,101,42,-,89800,58532
449,398,51,553,109800,58533
207,180,27,850,88800,58535
634,225,409,408,104600,58538
1186,939,247,685,175800,58540
253,210,43,730,115300,58541
126,111,15,1625,89200,58542
241,191,50,-,88400,58544
1460,1221,239,991,174400,58545
95,88,7,-,141700,58549
746,571,175,561,90300,58552
11361,8126,3235,929,233000,58554
340,301,39,1591,289200,58558
116,104,12,-,203800,58559
89,76,13,678,294400,58560
453,368,85,746,87800,58561
149,140,9,-,68000,58562
793,665,128,746,178700,58563
42,42,0,-,51700,58564
96,73,23,-,209000,58565
94,55,39,-,-,58566
178,118,60,693,60000,58568
45,45,0,-,-,58569
174,152,22,875,124000,58570
263,244,19,600,114200,58571
122,114,8,-,262500,58572
266,211,55,493,81500,58573
371,308,63,781,168500,58575
462,384,78,661,198200,58576
817,615,202,770,216200,58577
487,433,54,838,212200,58579
199,191,8,833,-,58580
129,96,33,375,31000,58581
11644,7020,4624,909,247200,58601
64,50,14,-,90000,58620
555,430,125,744,114600,58621
653,523,130,979,176600,58622
764,585,179,775,163100,58623
110,109,1,-,289100,58625
179,121,58,840,173500,58626
63,50,13,-,-,58627
235,169,66,1113,232400,58630
468,385,83,742,96000,58631
81,71,10,-,124300,58632
162,127,35,-,228500,58634
336,272,64,840,155300,58636
399,320,79,733,99700,58638
797,570,227,575,122700,58639
515,374,141,1045,267800,58640
37,32,5,-,156300,58641
99,61,38,-,257500,58642
67,56,11,575,75000,58643
7,7,0,-,-,58644
89,57,32,-,-,58645
464,368,96,686,95000,58646
456,344,112,766,122000,58647
129,102,27,-,56800,58649
210,185,25,538,90500,58650
223,202,21,705,88100,58651
476,432,44,533,166300,58652
290,246,44,900,116400,58653
92,87,5,-,81900,58654
253,214,39,735,259200,58655
152,134,18,535,191700,58656
14218,8453,5765,843,236700,58701
9229,5494,3735,953,216400,58703
1290,4,1286,1490,-,58704
0,0,0,-,-,58705
0,0,0,-,-,58707
256,239,17,614,114500,58710
81,81,0,-,204700,58711
40,35,5,-,75000,58712
32,32,0,-,607100,58713
123,121,2,-,258900,58716
424,379,45,617,211300,58718
214,169,45,463,105500,58721
654,511,143,995,185000,58722
78,59,19,-,143800,58723
162,153,9,-,164100,58725
83,76,7,-,117500,58727
516,314,202,1051,159900,58730
149,109,40,769,132800,58731
155,147,8,-,168800,58733
115,111,4,-,104200,58734
136,130,6,-,311900,58735
238,215,23,663,66400,58736
55,54,1,-,73800,58737
262,211,51,878,172800,58740
291,252,39,590,115100,58741
67,65,2,-,170300,58744
638,462,176,768,130100,58746
58,52,6,-,-,58748
148,109,39,833,181500,58750
147,97,50,644,112500,58752
98,98,0,-,-,58755
92,73,19,-,-,58756
305,123,182,755,169600,58757
117,115,2,-,117300,58758
247,227,20,1188,206000,58759
108,101,7,-,170800,58760
316,254,62,838,124100,58761
73,51,22,438,105200,58762
1372,744,628,663,165500,58763
155,128,27,-,82300,58765
118,114,4,-,171900,58768
136,108,28,708,158600,58769
573,330,243,634,160600,58770
215,178,37,960,164300,58771
75,51,24,588,79400,58772
368,326,42,1015,204500,58773
66,43,23,482,-,58775
154,26,128,1193,454500,58776
64,64,0,-,322200,58778
123,100,23,-,-,58779
206,190,16,908,198800,58781
202,179,23,675,88800,58782
182,165,17,506,182600,58783
985,647,338,1023,196100,58784
584,534,50,1250,263500,58785
61,54,7,-,120000,58787
435,352,83,100-,89500,58788
140,124,16,1375,74000,58789
601,436,165,661,188500,58790
101,79,22,-,232500,58792
211,194,17,-,116400,58793
88,48,40,-,350000,58794
74,48,26,581,95000,58795
12965,6540,6425,999,248700,58801
88,82,6,-,211800,58830
397,310,87,1165,287500,58831
85,64,21,525,159600,58833
320,302,18,-,292000,58835
137,106,31,582,205000,58838
251,232,19,1525,400000,58843
40,33,7,-,-,58844
336,289,47,-,183000,58845
112,74,38,-,305600,58847
529,406,123,829,220900,58849
834,595,239,973,183100,58852
197,124,73,-,165400,58853
3074,1612,1462,1238,339300,58854
31,29,2,-,208300,58856
645,517,128,917,275300,59001
59,29,30,983,-,59002
501,198,303,510,104200,59003
563,343,220,742,225200,59006
66,38,28,860,158300,59007
147,109,38,1036,254200,59008
103,59,44,-,163500,59010
1165,915,250,676,236100,59011
32,22,10,-,155000,59012
69,64,5,-,358300,59013
663,447,216,717,198100,59014
147,129,18,850,168400,59015
254,174,80,587,151500,59016
265,207,58,731,253500,59018
1631,1362,269,783,265000,59019
50,24,26,1075,450000,59020
424,280,144,594,81400,59022
142,103,39,563,156300,59024
24,0,24,-,-,59025
83,44,39,923,150000,59026
412,333,79,725,368800,59027
252,195,57,808,414900,59028
334,284,50,980,237500,59029
744,346,398,660,374500,59030
87,78,9,-,182100,59031
201,153,48,571,152900,59032
53,50,3,-,-,59033
1665,1074,591,726,149600,59034
118,99,19,-,99800,59035
592,429,163,719,154300,59036
862,845,17,-,246000,59037
274,205,69,890,170100,59038
13,8,5,-,-,59039
829,710,119,1074,289800,59041
645,408,237,545,104100,59043
4883,3642,1241,949,251000,59044
209,173,36,695,174400,59046
5792,4033,1759,869,321400,59047
359,264,95,600,160000,59050
63,47,16,1146,1175000,59052
159,140,19,-,167200,59053
141,108,33,675,159800,59054
34,11,23,-,189600,59055
330,315,15,225,335500,59057
15,15,0,-,118800,59058
90,62,28,-,225000,59059
150,129,21,869,393800,59061
32,22,10,-,-,59062
727,589,138,918,251700,59063
102,76,26,-,276700,59064
75,71,4,-,453900,59065
127,87,40,-,158800,59066
92,53,39,828,281300,59067
1678,1059,619,754,364300,59068
282,267,15,1656,311500,59069
399,312,87,1103,357600,59070
45,33,12,-,306300,59071
1914,1537,377,777,202300,59072
193,173,20,667,97500,59074
88,74,14,-,167000,59075
18,2,16,-,-,59076
21,11,10,-,-,59077
74,51,23,413,102100,59078
1407,1324,83,1308,267800,59079
45,43,2,-,576600,59081
9,5,4,-,208300,59082
0,0,0,-,-,59083
56,56,0,-,76000,59085
456,357,99,1106,262800,59086
177,131,46,531,119200,59087
454,297,157,973,197700,59088
135,81,54,475,199000,59089
16739,9706,7033,829,196200,59101
20841,13905,6936,999,246500,59102
12962,9794,3168,1060,255400,59105
7799,5951,1848,1261,393600,59106
1683,1084,599,606,113200,59201
50,44,6,-,51400,59211
129,108,21,738,183300,59212
226,183,43,-,63200,59213
27,24,3,-,-,59214
460,370,90,542,168500,59215
70,70,0,-,192200,59217
374,289,85,773,233200,59218
92,78,14,-,104700,59219
856,721,135,925,187500,59221
111,91,20,-,95800,59222
26,26,0,-,445500,59223
144,92,52,463,84000,59225
172,140,32,613,155300,59226
1866,1413,453,674,174400,59230
143,122,21,-,19300,59231
8,8,0,-,-,59240
190,131,59,539,104200,59241
26,23,3,-,119600,59242
117,84,33,650,235400,59243
14,13,1,-,287500,59244
166,118,48,740,77900,59247
355,293,62,722,174600,59248
78,61,17,-,-,59250
30,23,7,-,104200,59252
34,34,0,-,315000,59253
790,595,195,705,149800,59254
804,495,309,476,67200,59255
33,33,0,-,-,59256
32,27,5,-,-,59257
74,44,30,-,76700,59258
141,115,26,-,108200,59259
41,30,11,-,183300,59260
204,160,44,508,123200,59261
284,171,113,645,159400,59262
619,478,141,505,162800,59263
3486,2308,1178,756,244800,59270
5,4,1,-,-,59273
152,118,34,-,105600,59274
181,158,23,575,68800,59275
9,9,0,-,237500,59276
4702,3069,1633,862,181400,59301
74,59,15,-,-,59311
3,3,0,-,-,59312
956,655,301,795,173000,59313
36,22,14,-,366700,59314
32,27,5,-,-,59315
13,13,0,-,-,59316
446,339,107,650,131900,59317
41,41,0,-,207400,59318
10,8,2,-,"2,000,000+",59319
29,12,17,-,400000,59322
913,747,166,848,123700,59323
379,268,111,568,108300,59324
88,35,53,797,235000,59326
921,606,315,656,163400,59327
3674,2545,1129,737,156300,59330
80,37,43,-,-,59332
7,7,0,-,153100,59333
92,83,9,-,232700,59336
284,198,86,703,152100,59337
88,85,3,-,261500,59338
52,48,4,-,113900,59339
22,17,5,-,-,59343
213,184,29,-,345000,59344
33,20,13,-,187500,59345
149,116,33,-,341200,59347
391,323,68,504,98300,59349
93,76,17,-,-,59351
434,347,87,1052,107800,59353
7,7,0,-,-,59354
6105,3352,2753,711,160700,59401
10913,9227,1686,869,225000,59404
13631,7639,5992,819,187700,59405
284,207,77,588,168100,59410
164,126,38,-,-,59411
606,491,115,811,217400,59412
342,218,124,763,124200,59414
174,113,61,757,104200,59416
2096,1193,903,440,135700,59417
32,16,16,775,140000,59418
44,30,14,-,100000,59419
79,65,14,-,167000,59420
885,731,154,714,279300,59421
1035,740,295,864,176900,59422
17,8,9,-,350000,59424
1388,926,462,827,163300,59425
1585,1182,403,754,123100,59427
230,177,53,693,167500,59430
65,49,16,771,203100,59432
203,138,65,841,102700,59433
170,131,39,850,148600,59434
22,22,0,-,-,59435
828,660,168,898,237700,59436
115,64,51,-,224400,59440
31,18,13,-,-,59441
681,521,160,658,164000,59442
211,180,31,-,216700,59443
125,57,68,838,143800,59444
209,173,36,815,98200,59446
113,93,20,775,169300,59447
140,70,70,458,57100,59448
220,161,59,1107,216900,59450
79,53,26,-,-,59451
211,165,46,519,166100,59452
137,119,18,525,118800,59453
64,54,10,-,57800,59454
43,33,10,-,-,59456
4146,2691,1455,765,148500,59457
111,107,4,-,94000,59460
5,5,0,-,-,59461
93,86,7,-,90000,59462
65,59,6,-,196700,59463
206,152,54,773,164400,59464
24,24,0,-,162500,59465
49,23,26,-,106300,59466
29,23,6,-,263900,59467
263,217,46,883,215000,59468
37,34,3,-,162500,59469
131,92,39,497,181300,59471
297,211,86,815,169500,59472
1306,774,532,657,163800,59474
121,92,29,675,168200,59477
345,232,113,354,146900,59479
134,119,15,792,209800,59480
219,129,90,746,112500,59482
146,128,18,-,283300,59483
51,41,10,-,161300,59484
260,259,1,-,234300,59485
488,371,117,685,116400,59486
536,417,119,775,157500,59487
196,166,30,725,-,59489
4972,3411,1561,765,182600,59501
433,276,157,408,114100,59520
1096,495,601,320,80100,59521
479,224,255,610,127400,59522
941,667,274,608,171000,59523
252,180,72,497,55400,59524
100,61,39,535,88500,59525
753,411,342,507,68100,59526
271,162,109,472,55300,59527
110,76,34,-,83800,59528
49,27,22,-,256300,59529
52,52,0,-,-,59530
149,125,24,-,76200,59531
67,67,0,-,122800,59532
10,6,4,-,-,59535
14,14,0,-,-,59537
1174,910,264,509,159700,59538
188,94,94,574,107100,59540
111,72,39,625,76400,59542
79,41,38,270,210900,59544
33,33,0,-,91800,59545
95,90,5,-,779400,59546
28,19,9,-,127500,59547
14555,8442,6113,863,277200,59601
11079,9359,1720,1173,298600,59602
0,0,0,-,-,59623
0,0,0,-,-,59625
152,132,20,-,220700,59631
786,564,222,680,212100,59632
140,140,0,-,319700,59633
1856,1703,153,1041,380800,59634
3157,2670,487,912,243600,59635
0,0,0,-,-,59636
221,196,25,-,164300,59638
634,540,94,733,223100,59639
58,41,17,-,138800,59640
34,27,7,-,-,59642
299,299,0,-,216800,59643
1916,1536,380,857,241500,59644
627,579,48,967,186400,59645
165,149,16,-,322700,59647
182,125,57,871,277100,59648
14565,10071,4494,712,162200,59701
126,91,35,622,293800,59710
4295,2941,1354,585,150300,59711
63,50,13,775,-,59713
8928,6335,2593,1170,335400,59714
14900,8394,6506,1066,616000,59715
1009,678,331,1395,606500,59716
16949,10001,6948,1392,416300,59718
148,132,16,-,-,59720
173,133,40,775,328300,59721
1828,1217,611,637,129100,59722
51,23,28,-,193800,59724
3306,2161,1145,735,239700,59725
115,94,21,638,308100,59727
136,111,25,725,302500,59728
1031,835,196,775,340300,59729
768,606,162,868,614800,59730
51,46,5,-,260000,59731
74,34,40,817,300000,59732
58,19,39,-,312500,59733
95,78,17,-,355300,59735
74,50,24,-,318200,59736
146,128,18,-,166400,59739
209,180,29,-,580000,59740
1980,1485,495,1294,383600,59741
84,64,20,840,-,59743
43,34,9,-,161100,59745
62,54,8,-,331300,59746
65,56,9,-,260000,59747
110,101,9,-,235000,59748
762,669,93,589,301000,59749
108,104,4,-,331600,59750
68,54,14,867,175000,59751
1544,1217,327,1168,293500,59752
419,251,168,1208,258300,59754
55,48,7,-,250000,59755
16,0,16,-,-,59756
679,483,196,641,391900,59758
1631,1335,296,789,265300,59759
116,89,27,769,177100,59760
157,115,42,592,267200,59761
125,110,15,933,343800,59762
14518,5498,9020,945,295300,59801
8808,4240,4568,927,316700,59802
6307,4672,1635,1081,376000,59803
3128,1988,1140,1050,387500,59804
8865,5685,3180,1086,321500,59808
0,0,0,-,-,59812
804,697,107,831,264800,59820
963,679,284,845,292800,59821
736,631,105,771,390200,59823
576,415,161,847,264500,59824
870,780,90,792,272000,59825
282,269,13,1075,428900,59826
145,126,19,-,415600,59827
2293,1775,518,1082,280300,59828
1100,799,301,790,337000,59829
76,57,19,-,120800,59830
212,147,65,638,117700,59831
319,238,81,569,234700,59832
2211,1957,254,798,356800,59833
837,713,124,1622,324300,59834
143,98,45,817,280800,59837
6665,4771,1894,886,287500,59840
192,126,66,1269,211500,59841
49,45,4,-,196600,59842
110,46,64,384,433300,59843
253,200,53,1065,373700,59844
607,407,200,568,133500,59845
599,583,16,-,355500,59846
2626,2000,626,934,301000,59847
45,36,9,-,175000,59848
60,28,32,-,-,59851
385,311,74,740,300700,59853
94,63,31,675,233000,59854
205,137,68,638,84700,59855
64,57,7,-,-,59856
647,517,130,908,230000,59858
1749,1288,461,683,310700,59859
4539,3183,1356,791,304100,59860
98,98,0,-,-,59863
2460,1627,833,720,193000,59864
1291,939,352,483,276700,59865
466,378,88,858,257100,59866
21,12,9,-,-,59867
974,909,65,746,255000,59868
4695,3767,928,821,350800,59870
169,117,52,-,285900,59871
938,762,176,639,190000,59872
1284,996,288,583,207700,59873
823,695,128,-,365100,59874
1632,1384,248,695,307000,59875
22127,16227,5900,878,297700,59901
272,194,78,966,543100,59910
3676,3073,603,975,480200,59911
5843,4507,1336,881,295600,59912
280,236,44,-,418800,59913
153,109,44,1108,618100,59914
123,68,55,-,-,59915
78,78,0,-,285300,59916
2027,1664,363,891,311500,59917
228,194,34,1086,289300,59918
308,236,72,1050,-,59919
577,498,79,814,426900,59920
1040,839,201,920,434000,59922
4411,3316,1095,631,176400,59923
572,527,45,723,295200,59925
176,158,18,-,-,59926
129,76,53,571,270000,59927
84,64,20,-,469600,59928
69,69,0,-,320800,59929
217,194,23,-,155300,59930
131,128,3,-,687500,59931
698,493,205,951,482400,59932
7,7,0,-,-,59933
299,220,79,783,237500,59934
1269,1001,268,717,173000,59935
179,139,40,656,506000,59936
6114,4453,1661,990,466900,59937
9506,7444,2062,1083,234600,60002
20494,15763,4731,1527,362800,60004
12405,7906,4499,1384,350700,60005
12745,9553,3192,1422,294100,60007
8731,6217,2514,1399,249800,60008
16999,14906,2093,2172,545200,60010
3929,3655,274,1854,335900,60012
9470,8434,1036,1405,249300,60013
17177,13815,3362,1325,244900,60014
10246,8594,1652,2045,535200,60015
24144,16603,7541,1196,256500,60016
9685,7072,2613,1033,257600,60018
4869,3631,1238,1275,174600,60020
2007,1680,327,1227,231400,60021
3106,2896,210,1657,1079300,60022
16088,12676,3412,1461,452700,60025
5463,3884,1579,1797,602800,60026
178,174,4,-,869800,60029
13928,11160,2768,1373,234100,60030
14258,10590,3668,1376,269100,60031
4783,3201,1582,1021,168700,60033
769,500,269,949,212000,60034
12082,10101,1981,1812,523600,60035
1974,890,1084,1544,369700,60040
3442,2714,728,947,180000,60041
3184,2562,622,1570,195300,60042
755,719,36,"3,500+",1286500,60043
4236,2911,1325,1605,516800,60044
7659,6672,987,1944,801800,60045
12024,9882,2142,1459,238700,60046
14588,13016,1572,1702,455500,60047
10455,8873,1582,1418,470000,60048
12805,9791,3014,1415,200600,60050
8956,7474,1482,1446,226200,60051
9456,8181,1275,2094,332100,60053
21788,15210,6578,1241,336100,60056
13041,9695,3346,1438,255700,60060
10486,7171,3315,1794,341500,60061
16453,13682,2771,1721,550200,60062
5611,2315,3296,1018,110400,60064
15301,11653,3648,1394,376800,60067
15179,12843,2336,1509,458900,60068
3572,2946,626,2685,513800,60069
6272,4099,2173,1246,307000,60070
1866,1273,593,1082,285800,60071
338,318,20,882,339300,60072
19392,14972,4420,1380,174000,60073
14463,8799,5664,1238,252800,60074
13,13,0,-,-,60075
11506,9041,2465,1369,346500,60076
10878,6830,4048,1209,295200,60077
3199,2984,215,1099,290500,60081
3366,3125,241,1652,258800,60083
6348,5095,1253,1252,247800,60084
24250,10749,13501,995,131800,60085
9425,5933,3492,1148,154200,60087
1330,8,1322,1726,-,60088
15953,12855,3098,1800,341400,60089
15298,9551,5747,1349,213200,60090
10292,9052,1240,1464,709700,60091
7240,6471,769,1839,996600,60093
2745,2228,517,1086,205600,60096
4433,3726,707,1202,168200,60097
12451,8876,3575,1125,211100,60098
11012,7020,3992,1081,155000,60099
13402,8892,4510,1129,269900,60101
11971,10170,1801,1709,272300,60102
14272,12022,2250,1769,294500,60103
6056,4517,1539,1055,174400,60104
7593,4112,3481,1212,236300,60106
12854,10985,1869,1704,216300,60107
9196,6745,2451,1397,320300,60108
197,136,61,1000,248400,60109
11722,8731,2991,1283,184400,60110
70,53,17,-,353100,60111
1661,1193,468,1374,168500,60112
93,68,25,1057,114100,60113
16873,6789,10084,923,173600,60115
6270,4436,1834,1205,292900,60118
3962,3679,283,1393,290600,60119
15953,10446,5507,1130,184500,60120
17570,11789,5781,1095,197100,60123
8744,8454,290,1944,331600,60124
17332,14056,3276,1639,451200,60126
104,95,9,-,137500,60129
6961,3522,3439,1164,265100,60130
5895,4315,1580,1044,221000,60131
11220,8487,2733,1399,215900,60133
10896,9339,1557,1720,365200,60134
2703,1891,812,977,192700,60135
2749,2278,471,2064,265600,60136
14629,11827,2802,1169,419000,60137
11429,7351,4078,1357,208900,60139
7007,5600,1407,1609,285000,60140
137,0,137,609,-,60141
12494,11210,1284,1367,277000,60142
4658,3511,1147,1476,354300,60143
43,35,8,1125,255000,60144
992,759,233,1049,213600,60145
927,631,296,952,173800,60146
20198,14504,5694,1521,278700,60148
674,456,218,863,157600,60150
1530,1356,174,1597,269200,60151
4580,3393,1187,976,213700,60152
7875,4801,3074,1046,166500,60153
6829,6236,593,1587,257500,60154
3089,2045,1044,1026,177800,60155
9912,8340,1572,1572,247400,60156
967,945,22,-,396300,60157
7949,4259,3690,1132,222700,60160
2987,1854,1133,1341,196600,60162
1913,1775,138,985,185500,60163
7162,5257,1905,987,203400,60164
1307,654,653,1064,191700,60165
12161,7769,4392,1439,255100,60169
3762,2342,1420,1168,216800,60171
9289,7221,2068,1398,275100,60172
6534,2276,4258,1554,300800,60173
12490,8274,4216,1513,295900,60174
8701,8414,287,2919,403200,60175
4299,2396,1903,1166,230400,60176
8111,6670,1441,1538,258100,60177
8419,5757,2662,947,223100,60178
555,472,83,1692,259600,60180
11261,7668,3593,1417,250600,60181
0,0,0,-,-,60183
919,873,46,-,592300,60184
10743,8248,2495,1259,269900,60185
10341,7390,2951,1547,386400,60187
15018,10589,4429,1327,269200,60188
11835,9439,2396,1574,400600,60189
4406,4039,367,2082,330000,60190
5184,4024,1160,1536,249100,60191
5785,5176,609,2193,360600,60192
16016,11788,4228,1488,282100,60193
8093,5663,2430,1662,259500,60194
2271,704,1567,1497,172000,60195
16240,9285,6955,1630,510600,60201
14016,7785,6231,1465,336500,60202
1670,1534,136,1773,443400,60203
0,0,0,-,-,60208
1842,353,1489,2034,201000,60301
14375,8490,5885,1217,420600,60302
6576,4811,1765,1220,409500,60304
4428,3956,472,1375,601300,60305
2895,2369,526,949,192900,60401
22272,13701,8571,1058,236400,60402
7597,5186,2411,1230,181100,60403
6944,6374,570,1654,269900,60404
8971,4511,4460,950,132200,60406
600,469,131,1114,136300,60407
2109,1660,449,1123,185400,60408
13895,8152,5743,1000,110600,60409
4511,3976,535,1520,242900,60410
17999,11736,6263,1034,110000,60411
5415,3046,2369,1025,171000,60415
3913,3022,891,1035,191400,60416
6133,5386,747,1128,189700,60417
4686,3444,1242,1094,165100,60418
7789,5491,2298,1315,113600,60419
1811,1254,557,840,134500,60420
1537,1406,131,1000,205000,60421
3721,3391,330,2022,250200,60422
10904,10096,808,1275,322100,60423
844,648,196,939,161300,60424
3073,2594,479,1574,142000,60425
8572,4443,4129,930,75900,60426
3492,2353,1139,1514,92700,60428
5228,3298,1930,1314,130200,60429
7594,5994,1600,1211,171200,60430
8678,7618,1060,1561,226500,60431
6278,3390,2888,1066,145600,60432
5304,3414,1890,1113,134000,60433
18683,11794,6889,1039,178000,60435
6356,3343,3013,1139,139500,60436
34,30,4,-,116700,60437
11306,7863,3443,1069,136100,60438
8571,7579,992,1140,392300,60439
17175,12823,4352,1425,210400,60440
12122,9827,2295,1344,243300,60441
4336,3938,398,988,283900,60442
8207,6268,1939,1274,179400,60443
717,581,136,925,182200,60444
5751,4457,1294,1116,158500,60445
12458,10563,1895,1670,201400,60446
5138,4476,662,1232,237600,60447
8978,8112,866,1316,316300,60448
3635,3408,227,872,233900,60449
8456,5417,3039,1036,221600,60450
12328,11493,835,1205,305800,60451
10163,8166,1997,1128,213000,60452
22064,17959,4105,1144,222400,60453
6061,4105,1956,972,204700,60455
1895,1369,526,-,132200,60456
4984,3566,1418,1008,244200,60457
5190,2648,2542,1141,187200,60458
9482,7537,1945,1142,215800,60459
557,440,117,770,126500,60460
1908,1633,275,2861,238900,60461
16086,13259,2827,1342,286100,60462
5159,4902,257,1447,302700,60463
3727,3409,318,2008,402900,60464
7727,6037,1690,1161,206100,60465
8108,4711,3397,1310,77300,60466
9534,8807,727,1396,335000,60467
2262,1704,558,968,244400,60468
1642,1180,462,1105,143100,60469
162,138,24,625,111200,60470
5070,2693,2377,1068,165100,60471
1475,849,626,883,85700,60472
7480,6145,1335,1703,160600,60473
308,255,53,1034,142000,60474
4196,2770,1426,903,110000,60475
983,779,204,1031,111400,60476
15474,12480,2994,1246,222600,60477
5729,4453,1276,1589,139500,60478
342,256,86,1048,163500,60479
2141,1705,436,1335,289500,60480
4642,3434,1208,894,176200,60481
4543,2711,1832,1090,179300,60482
2441,1561,880,1062,129000,60484
9099,8627,472,1196,289300,60487
6345,5885,460,2230,323300,60490
7634,7222,412,1170,352300,60491
3635,2118,1517,923,194200,60501
8313,6623,1690,1741,324600,60502
5501,4789,712,1758,257900,60503
13819,8552,5267,1720,221000,60504
18434,10961,7473,1131,151000,60505
17374,11285,6089,1157,195100,60506
10580,8310,2270,1181,321200,60510
666,573,93,1152,237500,60511
368,287,81,-,214100,60512
7608,6097,1511,1079,276200,60513
3756,3020,736,1154,475200,60514
11854,9213,2641,1452,392100,60515
11822,9127,2695,1548,354100,60516
12680,8248,4432,1398,290400,60517
1511,1044,467,942,133900,60518
24,24,0,-,207100,60519
1146,896,250,1204,244000,60520
6020,5261,759,1847,861900,60521
4359,3483,876,638,703000,60523
12230,9751,2479,1240,364100,60525
5192,3802,1390,1243,371200,60526
12056,9717,2339,1545,443300,60527
237,193,44,955,168800,60530
793,580,213,1438,182800,60531
12698,7153,5545,1381,348100,60532
3900,2478,1422,1006,195400,60534
50,40,10,1063,162500,60536
244,224,20,1063,170000,60537
9528,7710,1818,1633,210400,60538
0,0,0,-,-,60539
15524,11772,3752,1624,435600,60540
1115,942,173,1375,266800,60541
7024,5239,1785,1342,263100,60542
13874,11803,2071,1030,276700,60543
10038,8708,1330,1616,259200,60544
4720,3555,1165,1517,196400,60545
6546,4908,1638,1153,321300,60546
4430,3538,892,1087,188800,60548
151,124,27,-,263200,60549
493,366,127,764,173600,60550
1445,1233,212,920,215100,60551
1547,1197,350,1317,219300,60552
266,230,36,1042,146000,60553
4398,4107,291,1321,301900,60554
5281,4148,1133,1517,236500,60555
750,622,128,880,190100,60556
84,84,0,-,115700,60557
4510,4398,112,2234,623400,60558
10091,5720,4371,1280,300000,60559
8991,7630,1361,1492,274900,60560
9281,7483,1798,1561,342700,60561
15718,8646,7072,1570,357000,60563
14950,12905,2045,1953,458900,60564
13639,12092,1547,1660,415100,60565
7377,6676,701,1978,341500,60585
13980,12863,1117,1918,245800,60586
8787,2715,6072,2331,519700,60601
581,382,199,2137,-,60602
734,486,248,2246,562500,60603
401,123,278,2169,575000,60604
17467,7939,9528,2228,414400,60605
2388,877,1511,2125,335500,60606
13169,6038,7131,2118,439400,60607
27804,10977,16827,1071,288900,60608
22402,8453,13949,889,207500,60609
24654,9467,15187,1829,465000,60610
22394,10343,12051,2159,586100,60611
13766,4502,9264,1130,299100,60612
28334,10975,17359,1464,361100,60613
33922,15355,18567,1811,665800,60614
21709,6587,15122,1276,272400,60615
24622,9510,15112,1179,351700,60616
30141,16994,13147,917,144600,60617
36855,18599,18256,1327,452000,60618
28030,12354,15676,951,172200,60619
25825,12356,13469,985,154900,60620
10783,2580,8203,895,102100,60621
24839,9957,14882,1735,547000,60622
26225,9635,16590,943,173000,60623
13204,3487,9717,1055,188700,60624
30888,12259,18629,1318,358700,60625
23272,6426,16846,1111,238400,60626
23198,13274,9924,1047,127800,60628
33175,18908,14267,938,192500,60629
21358,14253,7105,1193,321500,60630
12189,9106,3083,1292,379300,60631
26080,14496,11584,924,203200,60632
5127,3287,1840,1065,145800,60633
27567,20292,7275,1151,284900,60634
11391,5267,6124,981,104900,60636
21450,5338,16112,1024,215200,60637
20775,16475,4300,1102,242800,60638
26363,12759,13604,1094,253500,60639
36521,12131,24390,1230,321800,60640
24917,13403,11514,1121,325500,60641
10515,3832,6683,1910,494700,60642
18075,13140,4935,1225,196300,60643
17870,5278,12592,992,202900,60644
16806,8550,8256,1274,290200,60645
10946,8540,2406,1145,446200,60646
36880,13972,22908,1459,465600,60647
23349,5592,17757,981,172600,60649
20564,9216,11348,1116,216100,60651
13479,11284,2195,1250,194400,60652
16925,4917,12008,809,290600,60653
14294,5107,9187,2340,456200,60654
10730,9069,1661,1183,271100,60655
12471,7733,4738,1269,307400,60656
38263,14732,23531,1684,475000,60657
13838,6146,7692,1217,306900,60659
21179,7677,13502,1136,264600,60660
6850,2327,4523,2239,382900,60661
9408,7061,2347,1170,309100,60706
15551,9923,5628,1181,277400,60707
4766,3818,948,2398,398500,60712
11744,8979,2765,1148,302100,60714
8925,5759,3166,993,168700,60803
23915,12853,11062,1015,190500,60804
7495,6240,1255,1160,212600,60805
9589,3694,5895,948,99400,60827
13338,7959,5379,924,123200,60901
225,152,73,872,116400,60910
494,382,112,956,132700,60911
233,184,49,677,87200,60912
712,636,76,638,186300,60913
9493,6707,2786,1070,194900,60914
3943,2531,1412,992,122000,60915
181,165,16,1278,167400,60917
279,262,17,825,87400,60918
227,164,63,950,110900,60919
81,72,9,850,129300,60920
685,483,202,602,97000,60921
1008,751,257,913,145300,60922
661,492,169,655,120600,60924
41,38,3,-,71300,60926
938,731,207,936,153600,60927
228,181,47,750,98400,60928
276,199,77,836,83800,60929
295,222,73,844,123600,60930
228,198,30,694,113000,60931
127,121,6,-,589100,60932
131,97,34,788,76800,60933
94,72,22,700,201900,60934
426,384,42,1112,208600,60935
1943,1441,502,619,121300,60936
726,586,140,636,111100,60938
0,0,0,-,-,60939
1100,927,173,982,227300,60940
650,521,129,719,182200,60941
2298,1655,643,777,62200,60942
94,82,12,950,83100,60945
192,151,41,860,58900,60946
644,604,40,825,221400,60948
201,137,64,492,100800,60949
4849,3314,1535,895,204500,60950
328,240,88,767,151500,60951
226,190,36,760,76000,60952
937,711,226,667,76200,60953
2233,1620,613,832,135800,60954
580,529,51,667,95200,60955
50,34,16,867,85000,60956
2204,1730,474,701,112500,60957
646,445,201,784,72900,60958
447,327,120,610,79600,60959
317,260,57,689,69200,60960
297,264,33,1148,132000,60961
221,140,81,836,58200,60962
491,360,131,796,85200,60963
1879,1347,532,750,156900,60964
649,480,169,721,67400,60966
26,26,0,-,-,60967
198,181,17,530,80900,60968
24,17,7,-,-,60969
2870,2032,838,697,102400,60970
107,74,33,821,62100,60973
106,81,25,700,75800,60974
544,465,79,1156,191900,61001
611,456,155,683,129800,61006
142,128,14,-,151400,61007
12529,9928,2601,908,156100,61008
2849,2220,629,988,183300,61010
919,876,43,1718,235600,61011
850,719,131,1063,133000,61012
291,269,22,575,94400,61013
494,398,96,1000,88500,61014
328,255,73,-,208300,61015
2087,1849,238,795,183300,61016
416,334,82,750,117000,61018
1275,1095,180,1006,166400,61019
964,870,94,1000,168200,61020
8907,6322,2585,691,120200,61021
990,780,210,682,144400,61024
1946,1460,486,751,149000,61025
48,17,31,-,-,61027
865,678,187,822,142900,61028
824,662,162,717,117300,61030
639,439,200,742,106400,61031
13052,8406,4646,701,85200,61032
3377,2704,673,731,224400,61036
55,55,0,-,99300,61037
417,405,12,-,119400,61038
304,244,60,690,138100,61039
609,396,213,665,111300,61041
192,149,43,595,164100,61042
50,35,15,868,131300,61043
76,72,4,-,-,61044
1093,935,158,672,134100,61046
664,551,113,819,169100,61047
1678,1430,248,567,139900,61048
216,165,51,934,161100,61049
102,85,17,-,226800,61050
605,505,100,531,90500,61051
388,348,40,935,144800,61052
1132,941,191,661,99600,61053
1830,1134,696,585,116700,61054
26,26,0,-,-,61057
80,54,26,1102,84400,61059
577,464,113,543,125300,61060
2986,2234,752,766,173500,61061
718,601,117,775,157400,61062
1633,1477,156,1021,136000,61063
1793,1173,620,759,139200,61064
3477,3005,472,1555,164100,61065
359,296,63,840,160300,61067
5960,3544,2416,840,140200,61068
524,466,58,843,171400,61070
5803,4324,1479,729,86900,61071
4184,3553,631,736,186500,61072
7140,5913,1227,1203,189500,61073
1966,1322,644,718,80800,61074
421,374,47,702,179100,61075
0,0,0,-,-,61077
484,422,62,575,121600,61078
80,65,15,1042,87600,61079
4298,3266,1032,832,136400,61080
8786,6132,2654,734,109800,61081
1106,980,126,767,165300,61084
1374,1077,297,717,99100,61085
637,552,85,637,89400,61087
2514,2247,267,860,160000,61088
293,229,64,679,120500,61089
10,10,0,-,-,61091
7719,4109,3610,830,70400,61101
6199,3795,2404,773,73300,61102
10002,5210,4792,829,88500,61103
8061,3071,4990,729,67900,61104
12975,8690,4285,914,133100,61107
11956,7517,4439,894,107700,61108
10802,6892,3910,824,105900,61109
9744,6490,3254,938,119200,61111
71,0,71,"3,500+",-,61112
6474,4570,1904,1119,163100,61114
8518,6634,1884,1030,126000,61115
15443,9441,6002,738,106400,61201
379,335,44,817,128800,61230
2114,1344,770,714,118000,61231
621,531,90,715,138500,61232
107,77,30,750,108700,61233
507,386,121,595,129700,61234
706,575,131,739,108100,61235
31,26,5,-,94000,61236
0,0,0,-,-,61237
1066,948,118,862,115400,61238
522,168,354,867,88800,61239
2464,2176,288,1080,198400,61240
2812,2314,498,835,143600,61241
527,455,72,867,163700,61242
139,121,18,-,256100,61243
9173,6298,2875,742,120500,61244
1161,847,314,788,148300,61250
179,170,9,-,168000,61251
2472,1844,628,775,128800,61252
4965,4163,802,860,182600,61254
834,666,168,894,153800,61256
331,272,59,1649,75000,61257
79,74,5,-,60000,61258
541,491,50,1039,182000,61259
307,252,55,540,91700,61260
347,285,62,1076,97300,61261
295,266,29,642,175000,61262
313,226,87,729,113700,61263
4655,3530,1125,828,135800,61264
18784,12519,6265,810,124200,61265
2733,2256,477,851,137300,61270
486,367,119,-,105300,61272
1154,967,187,767,152500,61273
99,90,9,-,121200,61274
1724,1433,291,587,226400,61275
22,22,0,-,-,61276
1164,926,238,724,120200,61277
273,244,29,919,200000,61278
422,351,71,918,125200,61279
965,877,88,703,187200,61281
3978,2149,1829,854,137600,61282
498,407,91,679,95300,61283
881,819,62,-,211200,61284
693,590,103,726,144900,61285
4394,2878,1516,884,107000,61301
1536,1117,419,757,156900,61310
138,121,17,-,96300,61311
174,137,37,983,119100,61312
109,100,9,-,201200,61313
352,296,56,744,81400,61314
87,54,33,717,45800,61315
106,89,17,864,86300,61316
218,173,45,800,84100,61317
273,184,89,744,142500,61318
515,451,64,764,132800,61319
251,208,43,831,133700,61320
104,91,13,713,85200,61321
507,401,106,855,55600,61322
57,50,7,-,101300,61323
42,42,0,-,102800,61324
415,362,53,543,149600,61325
822,620,202,646,112100,61326
549,485,64,729,180100,61327
45,45,0,-,-,61328
513,423,90,775,104600,61329
465,391,74,663,124100,61330
0,0,0,-,-,61331
68,61,7,794,72800,61332
115,113,2,-,100500,61333
264,205,59,828,102800,61334
128,109,19,781,118300,61335
197,144,53,664,168200,61336
188,154,34,910,85900,61337
115,85,30,650,85600,61338
213,174,39,807,135900,61340
2952,2192,760,982,156800,61341
3412,2514,898,747,123200,61342
124,105,19,940,74500,61344
300,274,26,729,105700,61345
35,32,3,-,60000,61346
1917,1515,402,547,109700,61348
416,345,71,614,99700,61349
10016,6848,3168,868,138200,61350
462,350,112,774,141700,61353
4577,3323,1254,753,146900,61354
4753,3539,1214,704,136500,61356
144,136,8,775,78900,61358
185,157,28,622,85700,61359
1321,1039,282,945,188600,61360
498,405,93,782,107200,61361
2484,1527,957,648,112500,61362
135,106,29,563,87800,61363
8275,5518,2757,714,79400,61364
351,201,150,888,170300,61367
545,441,104,752,98200,61368
618,487,131,703,96600,61369
504,413,91,711,142800,61370
42,0,42,-,-,61371
77,57,20,681,134700,61372
759,651,108,796,189000,61373
33,27,6,-,135900,61374
465,444,21,756,131300,61375
813,599,214,1003,109600,61376
663,476,187,703,106700,61377
124,96,28,1063,143800,61378
512,403,109,769,81100,61379
13569,8223,5346,613,79800,61401
0,0,0,-,-,61402
1586,1124,462,639,80800,61410
198,98,100,487,105500,61411
514,488,26,493,81600,61412
415,332,83,767,112300,61413
285,256,29,657,85900,61414
801,660,141,665,95500,61415
131,119,12,-,46900,61416
115,106,9,-,81300,61417
282,275,7,775,85100,61418
51,45,6,-,82100,61419
406,333,73,728,83000,61420
575,455,120,818,75100,61421
1226,926,300,660,72300,61422
296,206,90,-,125000,61423
17,15,2,-,68300,61424
173,159,14,-,92500,61425
17,17,0,-,-,61426
797,655,142,773,97600,61427
418,393,25,525,226900,61428
291,228,63,683,108800,61430
124,117,7,-,108900,61431
267,239,28,-,76100,61432
17,8,9,-,-,61433
1206,965,241,692,76800,61434
67,46,21,-,-,61435
353,281,72,663,136900,61436
267,186,81,-,116700,61437
282,244,38,689,105000,61438
97,69,28,775,79500,61439
303,256,47,690,80000,61440
363,312,51,703,78100,61441
312,256,56,523,63700,61442
5603,3940,1663,684,63800,61443
481,448,33,638,87200,61447
1530,1310,220,656,111700,61448
127,124,3,-,41000,61449
764,655,109,554,82500,61450
69,59,10,-,105700,61451
88,83,5,-,69800,61452
240,172,68,721,74200,61453
186,138,48,575,67700,61454
7069,3759,3310,674,101900,61455
230,198,32,716,87800,61458
119,118,1,-,62700,61459
101,93,8,719,83900,61460
4352,3276,1076,630,87300,61462
535,478,57,573,100500,61465
102,97,5,738,83100,61466
469,387,82,755,107900,61467
88,88,0,-,80700,61468
936,822,114,725,81100,61469
204,189,15,833,94200,61470
44,44,0,-,56700,61471
219,205,14,650,140500,61472
520,355,165,631,87700,61473
114,92,22,-,60000,61474
90,79,11,-,98600,61475
201,190,11,-,153900,61476
201,166,35,793,80000,61477
89,89,0,-,-,61478
23,18,5,-,195800,61479
456,346,110,673,105400,61480
227,180,47,708,71900,61482
807,588,219,685,91800,61483
343,305,38,289,52500,61484
183,159,24,675,77500,61485
592,494,98,717,106500,61486
534,430,104,502,103600,61488
329,292,37,513,96200,61489
496,381,115,548,126100,61490
938,783,155,583,94100,61491
759,583,176,625,59500,61501
267,248,19,675,105400,61516
1099,913,186,767,234500,61517
93,79,14,650,114200,61519
6522,4742,1780,648,101800,61520
4454,3558,896,777,132400,61523
147,130,17,750,108300,61524
3891,3287,604,1170,283400,61525
339,330,9,-,218000,61526
1094,1080,14,-,268700,61528
1134,935,199,651,147000,61529
2655,1761,894,788,158200,61530
1321,960,361,750,100200,61531
204,154,50,782,84800,61532
821,667,154,665,139900,61533
684,550,134,825,138400,61534
653,639,14,-,218700,61535
1324,1078,246,816,155400,61536
1189,885,304,586,99400,61537
79,68,11,525,65000,61539
1028,860,168,789,123200,61540
53,38,15,906,70000,61541
1425,1186,239,653,101200,61542
60,43,17,-,49500,61543
284,245,39,906,82700,61544
313,289,24,991,204800,61545
1604,1388,216,673,118900,61546
1427,1367,60,542,195300,61547
4538,4038,500,1046,214700,61548
7476,5940,1536,936,206300,61550
111,111,0,-,84500,61552
85,74,11,731,59400,61553
17422,12486,4936,715,110600,61554
1386,1141,245,812,146300,61559
258,230,28,-,215400,61560
908,707,201,981,133200,61561
61,61,0,-,78500,61562
234,213,21,672,59000,61563
381,307,74,813,87100,61564
609,501,108,592,136900,61565
267,234,33,790,75000,61567
1636,1216,420,782,184300,61568
398,369,29,767,174000,61569
704,573,131,836,88100,61570
9512,7442,2070,904,178800,61571
445,345,100,714,84400,61572
495,79,416,779,197200,61602
6566,3130,3436,863,66800,61603
11992,7980,4012,802,90900,61604
5775,2242,3533,741,41800,61605
2552,1145,1407,782,103000,61606
4214,3699,515,852,134700,61607
2131,1610,521,642,76600,61610
10006,7649,2357,818,147900,61611
13133,8058,5075,855,150400,61614
10147,6466,3681,992,181600,61615
2873,1716,1157,848,92000,61616
0,0,0,-,-,61625
15810,8920,6890,797,119700,61701
15046,9884,5162,940,204100,61704
4839,3818,1021,1118,268400,61705
84,76,8,1050,85800,61720
217,181,36,956,126300,61721
230,200,30,1000,113800,61722
1071,895,176,739,115100,61723
163,151,12,640,99000,61724
598,560,38,1315,235000,61725
1033,732,301,762,123300,61726
4011,2825,1186,729,101900,61727
456,339,117,741,118900,61728
429,373,56,870,205500,61729
145,111,34,825,145100,61730
45,31,14,-,-,61731
766,672,94,951,166300,61732
354,285,69,1034,168800,61733
1019,857,162,796,126000,61734
162,150,12,825,167200,61735
911,805,106,1060,246200,61736
184,173,11,545,123000,61737
1558,1211,347,800,138800,61738
1935,1398,537,771,149600,61739
580,479,101,759,119500,61740
626,516,110,595,124600,61741
465,429,36,936,219000,61742
64,59,5,-,114600,61743
658,508,150,650,129900,61744
1643,1337,306,903,176000,61745
644,498,146,861,160900,61747
959,913,46,385,176700,61748
315,272,43,675,80200,61749
26,12,14,-,-,61750
31,31,0,-,79400,61751
1737,1464,273,681,148700,61752
1228,1061,167,749,186800,61753
414,320,94,1084,119800,61754
1890,1598,292,786,165900,61755
913,702,211,725,136600,61756
564,463,101,597,129900,61759
984,692,292,904,111700,61760
20141,11230,8911,858,173700,61761
5358,3518,1840,790,104600,61764
247,235,12,950,95900,61769
440,346,94,789,97400,61770
265,252,13,900,200000,61771
70,54,16,-,259100,61772
130,120,10,675,110000,61773
368,298,70,842,114800,61774
122,107,15,1031,114000,61775
527,471,56,858,183000,61776
420,341,79,681,124400,61777
225,214,11,596,75900,61778
10938,3370,7568,844,146000,61801
8709,4646,4063,877,142400,61802
97,88,9,558,90000,61810
278,221,57,823,110100,61811
139,120,19,641,95000,61812
685,542,143,660,91100,61813
475,399,76,845,101500,61814
160,115,45,905,124200,61815
144,119,25,913,118800,61816
1090,829,261,848,105100,61817
675,518,157,831,104000,61818
14582,3114,11468,918,145500,61820
12401,7153,5248,954,147300,61821
11083,7573,3510,1157,230000,61822
174,150,24,817,110600,61830
98,98,0,-,121300,61831
13589,8124,5465,711,69900,61832
829,652,177,768,57500,61833
2509,2172,337,793,150100,61834
219,169,50,735,88100,61839
198,181,17,-,226800,61840
462,421,41,688,100400,61841
1058,892,166,852,132700,61842
815,678,137,803,154500,61843
354,315,39,1042,114200,61844
172,159,13,-,215000,61845
2128,1592,536,695,74900,61846
490,433,57,838,150800,61847
92,70,22,690,68300,61848
847,752,95,882,145900,61849
150,147,3,675,63700,61850
152,115,37,668,106500,61851
76,68,8,-,-,61852
4809,4167,642,1062,229500,61853
526,463,63,946,140800,61854
44,44,0,-,82100,61855
3282,2685,597,1003,186500,61856
87,76,11,-,58800,61857
1078,906,172,633,108300,61858
513,480,33,950,151100,61859
222,192,30,704,126700,61862
360,331,29,950,175500,61863
593,536,57,954,167900,61864
537,452,85,664,91500,61865
5477,2886,2591,842,94100,61866
487,334,153,760,76700,61870
166,135,31,950,145500,61871
245,233,12,850,147300,61872
2090,1805,285,643,196200,61873
3412,1932,1480,939,236000,61874
306,250,56,880,232100,61875
232,216,16,625,66100,61876
513,436,77,912,161300,61877
541,450,91,775,103700,61878
1688,1306,382,731,184800,61880
255,233,22,842,116900,61882
1799,1422,377,645,85100,61883
427,397,30,-,213300,61884
1437,1065,372,734,123200,61910
1660,1291,369,704,147400,61911
549,474,75,645,85200,61912
586,490,96,639,90900,61913
876,698,178,831,99400,61914
240,191,49,-,69500,61917
318,271,47,491,134100,61919
8423,4490,3933,755,120600,61920
906,659,247,681,97300,61924
464,396,68,567,117400,61925
305,276,29,1083,108300,61928
308,253,55,725,94800,61929
257,211,46,820,70500,61930
498,432,66,931,118800,61931
230,157,73,850,69300,61932
457,333,124,323,64400,61933
125,113,12,-,110800,61936
761,516,245,634,80200,61937
9495,5746,3749,666,89100,61938
139,101,38,631,45200,61940
63,63,0,-,84500,61941
446,401,45,817,91500,61942
730,572,158,469,90000,61943
5365,3829,1536,664,85900,61944
80,64,16,530,69100,61949
2947,2427,520,799,120300,61951
2637,1898,739,759,139900,61953
69,57,12,1063,53200,61955
1258,999,259,726,97100,61956
714,559,155,667,94500,61957
689,552,137,675,154400,62001
13431,8789,4642,829,96800,62002
162,162,0,-,166700,62006
723,501,222,724,72800,62009
4619,3661,958,819,146800,62010
105,105,0,-,-,62011
2318,2152,166,845,140600,62012
157,145,12,775,116100,62013
1404,1138,266,838,154300,62014
202,152,50,1008,82900,62015
1396,1034,362,819,108800,62016
454,373,81,766,85500,62017
1102,815,287,888,74900,62018
155,108,47,767,-,62019
362,362,0,-,189900,62021
360,330,30,-,213300,62022
37,37,0,-,65000,62023
4141,3086,1055,780,106000,62024
12304,9016,3288,1055,237500,62025
0,0,0,-,-,62026
210,179,31,-,97700,62027
269,205,64,692,139800,62028
33,18,15,970,81400,62030
286,271,15,-,101400,62031
268,239,29,703,64400,62032
1847,1344,503,687,93800,62033
6000,4209,1791,1023,228600,62034
6792,5609,1183,1046,148400,62035
208,192,16,-,192900,62036
727,610,117,283,192500,62037
16719,11683,5036,791,87800,62040
735,599,136,703,100200,62044
154,152,2,-,166700,62045
352,253,99,875,191900,62046
388,339,49,-,124400,62047
775,584,191,866,65500,62048
2640,1986,654,691,101100,62049
115,98,17,681,94800,62050
358,245,113,829,110200,62051
4720,3533,1187,732,141800,62052
138,107,31,544,77000,62053
131,113,18,538,80400,62054
3841,2743,1098,572,99000,62056
351,267,84,755,85900,62058
181,98,83,391,32500,62059
1843,879,964,793,50500,62060
633,552,81,818,157000,62061
3510,2901,609,1012,205500,62062
359,270,89,729,120900,62063
870,759,111,624,181700,62067
1392,1107,285,694,82500,62069
473,447,26,1014,203400,62074
1296,1029,267,734,74400,62075
48,43,5,-,86400,62076
113,101,12,742,58100,62077
23,20,3,-,-,62078
80,55,25,-,261800,62079
872,750,122,756,89300,62080
96,92,4,-,83900,62081
973,833,140,679,71600,62082
97,97,0,-,210900,62083
694,517,177,826,84600,62084
70,60,10,694,70000,62085
480,423,57,650,75400,62086
787,540,247,722,80400,62087
2759,2077,682,767,105400,62088
307,258,49,807,67100,62089
443,207,236,734,44600,62090
143,121,22,-,77700,62091
1018,775,243,594,53100,62092
209,175,34,775,59300,62093
340,256,84,480,63300,62094
4518,3221,1297,810,93600,62095
1092,1030,62,828,167600,62097
10,10,0,-,-,62098
2099,729,1370,379,57500,62201
2186,1639,547,936,59800,62203
2447,1442,1005,644,38600,62204
2304,1475,829,795,59600,62205
4431,2081,2350,963,40900,62206
3083,979,2104,664,55400,62207
7148,4370,2778,1049,141400,62208
450,390,60,675,154700,62214
782,650,132,1057,171800,62215
1046,858,188,914,174000,62216
324,286,38,779,87300,62217
732,682,50,657,175500,62218
398,328,70,870,87000,62219
7242,4916,2326,858,118500,62220
11940,8153,3787,975,173300,62221
7309,5570,1739,897,126300,62223
1444,12,1432,1632,-,62225
12270,7592,4678,843,131100,62226
2630,2162,468,753,162400,62230
2647,2087,560,901,140500,62231
2693,2040,653,977,96300,62232
2519,1866,653,629,101600,62233
13690,9530,4160,897,138200,62234
5357,4606,751,947,254400,62236
1051,939,112,730,117300,62237
207,174,33,710,68800,62238
1814,1194,620,860,87000,62239
602,398,204,1034,69800,62240
344,314,30,764,113800,62241
597,522,75,533,79300,62242
2267,1804,463,1001,213500,62243
363,288,75,932,203500,62244
738,658,80,702,163300,62245
3453,2375,1078,546,138200,62246
228,176,52,616,135500,62248
6898,5254,1644,783,180800,62249
240,222,18,810,92500,62250
294,226,68,540,69700,62253
2342,1689,653,1057,148400,62254
359,325,34,663,141200,62255
17,12,5,-,187500,62256
862,702,160,560,90000,62257
3448,2498,950,988,174200,62258
2714,2308,406,1021,195500,62260
33,33,0,-,-,62261
745,678,67,733,97900,62262
2145,1726,419,699,136300,62263
1322,1151,171,917,124700,62264
1834,1255,579,1137,167600,62265
12,12,0,-,-,62266
398,348,50,591,123500,62268
13217,9750,3467,1132,223900,62269
808,639,169,630,146800,62271
652,471,181,583,114800,62272
111,91,20,875,102800,62273
2670,2001,669,466,86000,62274
1124,922,202,885,152500,62275
405,342,63,700,93000,62277
2559,1969,590,772,162000,62278
24,24,0,-,273100,62279
197,196,1,-,196600,62280
1127,1071,56,1250,260400,62281
285,245,40,775,138000,62282
274,247,27,713,123700,62284
1728,1545,183,782,211200,62285
2412,1618,794,733,118600,62286
1136,830,306,714,134400,62288
159,127,32,840,63200,62289
357,220,137,647,64200,62292
1735,1411,324,703,171800,62293
5615,4333,1282,894,213600,62294
533,428,105,1110,168700,62295
173,139,34,873,266900,62297
6868,5682,1186,833,225500,62298
13630,8150,5480,689,106100,62301
7651,6500,1151,799,177300,62305
388,286,102,-,101700,62311
652,479,173,525,80300,62312
142,128,14,-,70000,62313
224,168,56,673,127800,62314
285,221,64,250,63900,62316
110,107,3,-,87700,62319
885,745,140,675,132300,62320
1672,1340,332,622,101900,62321
82,73,9,-,112500,62323
564,424,140,570,114300,62324
167,139,28,1533,102300,62325
1009,717,292,665,86100,62326
670,534,136,756,77100,62330
80,68,12,521,73300,62334
35,33,2,-,66300,62336
481,469,12,-,153800,62338
416,345,71,600,114500,62339
699,500,199,517,89800,62340
1401,1084,317,712,102100,62341
318,283,35,632,74800,62343
10,3,7,-,-,62344
134,104,30,540,72200,62345
75,72,3,-,78300,62346
717,605,112,538,181600,62347
74,61,13,-,99000,62348
297,265,32,725,91900,62349
750,637,113,805,125100,62351
88,69,19,1018,75000,62352
1369,909,460,656,108000,62353
509,389,120,755,119000,62354
264,240,24,-,101700,62355
193,157,36,514,68600,62356
137,87,50,574,85300,62357
200,195,5,-,124000,62358
48,48,0,-,96300,62359
696,596,100,725,102900,62360
111,102,9,-,110200,62361
164,136,28,545,64500,62362
2254,1769,485,634,108200,62363
184,166,18,613,94100,62365
468,384,84,625,73400,62366
611,525,86,651,89200,62367
118,108,10,-,64200,62370
145,134,11,-,72000,62373
180,176,4,-,76700,62374
270,257,13,975,120500,62375
433,307,126,788,153100,62376
355,302,53,417,97600,62378
762,639,123,684,81700,62379
113,108,5,-,45000,62380
7933,5755,2178,671,167300,62401
484,459,25,481,101300,62410
1756,1408,348,811,119200,62411
138,138,0,-,145800,62413
675,540,135,661,112700,62414
1046,770,276,775,66100,62417
813,630,183,667,114800,62418
91,83,8,733,49400,62419
1824,1492,332,740,87500,62420
204,188,16,811,71400,62421
404,311,93,581,101400,62422
229,229,0,-,121700,62423
872,710,162,599,167200,62424
256,256,0,-,76900,62425
365,305,60,532,63100,62426
804,764,40,705,88800,62427
1160,957,203,606,85800,62428
351,270,81,633,76900,62431
242,226,16,1268,-,62432
507,376,131,643,77500,62433
153,153,0,-,-,62434
291,262,29,650,100700,62436
65,65,0,-,211000,62438
2862,1995,867,741,86600,62439
506,423,83,1028,104300,62440
2850,2247,603,732,121900,62441
1057,790,267,595,70900,62442
704,646,58,-,150800,62443
161,161,0,-,108800,62444
406,371,35,513,134400,62445
138,118,20,828,88800,62446
1201,993,208,705,135400,62447
2234,1778,456,657,96700,62448
1359,1046,313,529,88000,62449
5027,3522,1505,613,98200,62450
933,778,155,648,81000,62451
144,114,30,-,50000,62452
3860,2852,1008,726,110300,62454
906,827,79,679,87700,62458
109,103,6,-,75600,62459
448,347,101,683,75100,62460
357,315,42,528,148600,62461
471,384,87,654,123200,62462
463,410,53,758,113000,62463
48,40,8,-,90700,62464
325,284,41,808,97700,62465
1027,918,109,616,83700,62466
1545,1253,292,632,186900,62467
1003,731,272,697,102300,62468
121,80,41,-,-,62469
3373,2389,984,655,93800,62471
483,429,54,490,109400,62473
285,249,36,694,68500,62474
139,139,0,-,62100,62475
610,553,57,629,83400,62476
282,245,37,1257,119600,62477
120,103,17,-,78600,62478
294,218,76,790,147100,62479
233,183,50,632,86800,62480
135,135,0,-,45300,62481
901,825,76,893,150500,62501
771,472,299,590,79300,62510
252,214,38,-,107100,62512
652,537,115,1000,107300,62513
147,98,49,-,74000,62514
426,329,97,883,134800,62515
88,52,36,750,70000,62517
96,75,21,-,124400,62518
30,30,0,-,-,62519
602,509,93,967,169800,62520
14020,10224,3796,768,107900,62521
5814,3805,2009,707,87600,62522
265,29,236,319,-,62523
14349,8342,6007,696,82200,62526
632,521,111,843,114000,62530
707,586,121,688,106600,62531
50,50,0,-,93300,62532
338,251,87,659,116100,62533
490,384,106,738,90400,62534
1356,1275,81,1236,244500,62535
314,314,0,-,274800,62536
101,92,9,-,102100,62537
169,140,29,665,106300,62538
522,436,86,623,86400,62539
587,446,141,690,78600,62540
24,24,0,-,-,62541
226,154,72,495,94700,62543
615,522,93,809,123000,62544
571,526,45,808,150600,62545
596,507,89,660,105300,62546
338,322,16,911,85300,62547
973,833,140,555,113700,62548
2296,1853,443,721,146100,62549
1102,887,215,908,111400,62550
331,277,54,614,92600,62551
144,136,8,638,95600,62553
682,604,78,842,123000,62554
205,164,41,588,125000,62555
131,126,5,-,72500,62556
2972,2373,599,663,90400,62557
1463,1177,286,788,154400,62558
496,374,122,801,106800,62560
2245,1604,641,1029,144400,62561
2255,2131,124,1078,216300,62563
3196,2350,846,681,107600,62565
395,293,102,772,98800,62567
6391,4604,1787,710,101600,62568
246,211,35,746,68500,62570
620,471,149,753,93800,62571
204,171,33,500,170400,62572
494,382,112,549,105900,62573
114,104,10,-,98100,62601
72,55,17,717,48800,62610
463,441,22,790,121800,62611
627,512,115,810,111300,62612
1544,1232,312,825,170400,62613
1977,1637,340,947,145200,62615
268,239,29,638,69600,62617
2763,2031,732,628,76700,62618
445,365,80,644,77700,62621
8,8,0,-,-,62622
132,121,11,-,95000,62624
375,340,35,844,232300,62625
2913,2023,890,814,106300,62626
441,376,65,880,75900,62627
305,265,40,815,90200,62628
5650,4493,1157,1086,201600,62629
254,238,16,840,104300,62630
127,101,26,721,104700,62631
234,206,28,592,68000,62633
426,364,62,677,120300,62634
295,200,95,836,118500,62635
528,452,76,825,116800,62638
118,89,29,-,-,62639
1235,974,261,834,131600,62640
545,425,120,610,84500,62642
278,182,96,838,80800,62643
2105,1576,529,691,80700,62644
176,127,49,818,88800,62649
9923,6484,3439,681,117900,62650
233,186,47,639,78100,62655
6828,4436,2392,725,113000,62656
540,459,81,931,108700,62661
88,82,6,-,81900,62663
1277,1012,265,610,87900,62664
572,457,115,547,61200,62665
176,139,37,807,81200,62666
247,201,46,583,126600,62667
492,432,60,661,104700,62668
1048,833,215,736,158400,62670
202,153,49,739,114400,62671
73,64,9,775,54000,62672
162,129,33,455,101300,62673
551,430,121,623,79100,62674
2582,2024,558,752,166700,62675
844,755,89,777,172700,62677
2095,1607,488,802,101100,62681
279,246,33,690,68600,62682
2038,1855,183,1009,247700,62684
692,558,134,596,116900,62685
329,295,34,690,87800,62688
251,226,25,772,74400,62689
1565,1130,435,737,96600,62690
910,694,216,594,86700,62691
842,673,169,698,91900,62692
659,578,81,832,163600,62693
1197,975,222,529,102400,62694
198,177,21,786,106400,62695
515,19,496,563,-,62701
15167,9250,5917,812,86400,62702
12391,7038,5353,854,85700,62703
18930,11255,7675,841,139700,62704
0,0,0,-,-,62706
3500,3153,347,830,146600,62707
7384,5948,1436,987,258900,62711
4328,3701,627,974,226900,62712
7711,5469,2242,689,81000,62801
420,261,159,767,123100,62803
1384,1037,347,699,100300,62806
381,334,47,331,125800,62807
664,531,133,631,110400,62808
134,129,5,-,91900,62809
387,323,64,444,100500,62810
130,99,31,744,36800,62811
4773,3433,1340,658,86000,62812
707,613,94,686,88600,62814
94,64,30,430,64000,62815
464,411,53,718,73500,62816
269,223,46,834,-,62817
177,155,22,721,71800,62818
148,135,13,694,50800,62819
71,59,12,-,46300,62820
3089,2316,773,708,93000,62821
1195,769,426,641,60600,62822
680,560,120,620,105100,62823
675,554,121,518,96300,62824
118,102,16,-,80000,62825
497,360,137,421,65100,62827
480,415,65,620,71400,62828
59,33,26,-,-,62829
590,445,145,341,119700,62830
197,181,16,619,107000,62831
3786,2598,1188,635,84700,62832
143,119,24,-,68800,62833
504,443,61,421,73800,62835
338,273,65,783,89700,62836
3779,2778,1001,609,99700,62837
697,579,118,668,78100,62838
2747,2059,688,667,96200,62839
50,50,0,-,73800,62841
297,257,40,745,85700,62842
74,35,39,-,42500,62843
856,606,250,659,68500,62844
299,219,80,634,78900,62846
271,226,45,745,74500,62848
792,709,83,609,78700,62849
145,128,17,-,-,62850
91,91,0,-,82300,62851
61,56,5,-,47800,62852
347,276,71,905,82900,62853
752,646,106,607,77900,62854
140,119,21,758,53900,62856
1183,827,356,665,91400,62858
2167,1616,551,640,93900,62859
207,191,16,-,95600,62860
56,56,0,-,45000,62861
132,123,9,-,76500,62862
3992,3077,915,668,82500,62863
9580,6249,3331,774,98200,62864
870,765,105,663,143100,62865
150,117,33,429,36500,62867
674,553,121,730,85900,62868
916,759,157,545,92600,62869
877,666,211,782,87600,62870
241,226,15,488,75800,62871
416,368,48,1075,85000,62872
192,160,32,627,52500,62874
489,439,50,700,82700,62875
68,64,4,-,64300,62876
186,167,19,910,85800,62877
154,148,6,-,82000,62878
14,10,4,-,-,62879
251,215,36,542,95600,62880
4497,3245,1252,697,90000,62881
902,708,194,586,64900,62882
238,216,22,-,125000,62883
1110,967,143,621,79600,62884
238,181,57,445,93600,62885
113,96,17,-,81100,62886
84,59,25,1106,33000,62887
787,702,85,759,98500,62888
436,349,87,-,116400,62889
967,752,215,923,85600,62890
298,265,33,575,60800,62891
93,85,8,-,87000,62892
351,295,56,823,137800,62893
352,296,56,531,101300,62894
805,656,149,508,91200,62895
4722,3367,1355,605,82400,62896
181,143,38,950,108900,62897
810,730,80,826,145100,62898
555,470,85,-,106300,62899
10482,3296,7186,714,131300,62901
1834,1228,606,729,178700,62902
1278,563,715,739,147200,62903
220,179,41,437,119200,62905
2996,2154,842,683,107500,62906
659,596,63,648,110400,62907
151,140,11,-,88300,62908
808,679,129,642,68200,62910
569,478,91,709,81500,62912
681,488,193,450,32600,62914
208,96,112,510,69000,62915
307,268,39,631,150000,62916
951,745,206,577,68300,62917
4384,3153,1231,903,155700,62918
290,242,48,419,76900,62919
1213,1061,152,-,140600,62920
127,89,38,-,74100,62921
1262,1127,135,585,124500,62922
162,150,12,740,62700,62923
1137,615,522,769,83500,62924
732,580,152,618,95300,62926
149,118,31,763,36000,62927
28,18,10,570,-,62928
2567,1895,672,704,68200,62930
602,448,154,190,83500,62931
502,332,170,660,67600,62932
518,392,126,723,118400,62933
280,242,38,461,98800,62934
845,694,151,785,88100,62935
1029,844,185,286,107400,62938
1105,997,108,682,139400,62939
243,150,93,622,23900,62940
266,239,27,950,85000,62941
255,178,77,565,30000,62942
133,123,10,-,101300,62943
5152,3737,1415,694,90700,62946
199,172,27,-,155000,62947
5468,3588,1880,758,100400,62948
377,202,175,-,61900,62949
67,40,27,-,108300,62950
2103,1785,318,656,70900,62951
1150,927,223,642,97700,62952
89,59,30,575,-,62953
342,289,53,-,87800,62954
410,352,58,644,69000,62956
231,128,103,849,55300,62957
823,629,194,754,113900,62958
11667,8145,3522,786,147600,62959
4239,3218,1021,706,99200,62960
11,11,0,-,36300,62961
0,0,0,-,-,62962
217,106,111,588,38300,62963
498,362,136,531,49200,62964
10,5,5,638,-,62965
6124,3830,2294,716,105800,62966
108,106,2,-,76700,62967
101,69,32,906,27600,62969
217,170,47,509,69800,62970
425,409,16,-,169900,62972
635,581,54,927,132400,62974
80,72,8,-,-,62975
117,77,40,555,75200,62976
281,231,50,841,87200,62977
469,373,96,527,71600,62979
400,299,101,463,63200,62982
723,591,132,688,65400,62983
637,426,211,464,73700,62984
259,230,29,477,97300,62985
545,458,87,758,132500,62987
420,358,62,508,74400,62988
318,279,39,525,140600,62990
234,197,37,477,80900,62992
254,230,24,733,120600,62994
1388,1003,385,544,121600,62995
154,142,12,-,72400,62996
217,189,28,750,57900,62997
88,88,0,-,132500,62998
621,394,227,579,51700,62999
7118,6247,871,1330,587400,63005
13768,10583,3185,991,170800,63010
14309,12330,1979,1454,313700,63011
3861,3475,386,980,185000,63012
528,528,0,-,257000,63013
305,275,30,692,160900,63014
805,706,99,-,162100,63015
2865,2574,291,906,166100,63016
17110,13722,3388,1352,379100,63017
1904,1361,543,781,152600,63019
7781,6315,1466,840,151700,63020
22254,17896,4358,1198,274800,63021
2035,1796,239,980,170200,63023
6094,5182,912,1075,308300,63025
17026,13388,3638,925,229100,63026
10679,7996,2683,853,177300,63028
80,47,33,-,167700,63030
18634,13224,5410,1165,114700,63031
16702,11416,5286,984,125800,63033
6592,6125,467,1652,188300,63034
549,473,76,833,179000,63036
1246,1076,170,641,161000,63037
2645,2530,115,-,439200,63038
195,195,0,-,117900,63039
3188,2727,461,1274,346700,63040
122,117,5,-,-,63041
8451,4332,4119,895,114300,63042
9456,6841,2615,1098,172400,63043
4290,2772,1518,847,194700,63044
0,0,0,-,-,63045
0,0,0,-,-,63047
1411,1152,259,1974,176900,63048
6514,5623,891,897,175500,63049
6238,5206,1032,870,208600,63050
4583,3719,864,942,163300,63051
10438,8529,1909,862,201700,63052
40,28,12,960,184100,63053
655,565,90,848,292200,63055
628,564,64,-,173000,63056
792,731,61,1098,114500,63060
53,53,0,-,150700,63061
2048,1772,276,743,190300,63068
5591,4081,1510,807,229600,63069
2995,2143,852,771,149900,63070
493,319,174,771,112100,63071
1229,1151,78,614,170400,63072
542,542,0,-,672200,63073
6989,3567,3422,902,96900,63074
4698,3486,1212,713,131600,63077
105,101,4,-,120300,63079
5543,4073,1470,790,140000,63080
7385,5397,1988,778,182300,63084
323,238,85,528,188900,63087
4249,2254,1995,1136,191700,63088
2073,1708,365,1055,158100,63089
8899,6995,1904,761,203900,63090
521,441,80,475,178100,63091
2133,662,1471,1103,196300,63101
1277,45,1232,986,184800,63102
5051,824,4227,868,167600,63103
9644,4290,5354,987,225300,63104
6515,3664,2851,1428,614400,63105
4008,532,3476,669,163400,63106
3841,1825,2016,806,49700,63107
11016,3130,7886,1007,324300,63108
14028,8737,5291,837,195700,63109
8737,3638,5099,979,260000,63110
8659,3420,5239,784,93100,63111
8859,3250,5609,824,185100,63112
4471,2293,2178,786,70400,63113
14870,8520,6350,975,89500,63114
6860,2897,3963,841,54600,63115
19618,10693,8925,845,127500,63116
4816,2604,2212,1066,266700,63117
11522,4515,7007,851,166400,63118
14777,10449,4328,1077,283800,63119
2506,1154,1352,844,46000,63120
10663,5569,5094,882,78000,63121
16719,13469,3250,1144,375800,63122
22071,15769,6302,887,166300,63123
4790,3617,1173,1298,784800,63124
13612,9457,4155,855,136400,63125
6161,5284,877,1021,240700,63126
2220,1674,546,-,517300,63127
13083,10115,2968,966,261600,63128
21243,16877,4366,940,233000,63129
12804,7886,4918,1103,275500,63130
6822,6312,510,2146,635100,63131
6313,3529,2784,1140,347300,63132
2936,1054,1882,896,50100,63133
5066,2450,2616,1048,69800,63134
8247,4368,3879,1003,77700,63135
18718,7977,10741,916,65400,63136
8410,4537,3873,931,65300,63137
7197,3481,3716,875,104200,63138
10570,6529,4041,925,166800,63139
122,21,101,769,"10,000-",63140
9092,6380,2712,1296,479900,63141
4803,2195,2608,810,184400,63143
4555,3011,1544,1362,241700,63144
15092,8862,6230,1157,240400,63146
3504,1781,1723,844,64100,63147
0,0,0,-,-,63155
20441,14165,6276,931,197500,63301
20679,15419,5260,1163,242600,63303
15685,14164,1521,1380,271300,63304
50,45,5,413,-,63330
577,550,27,-,349800,63332
312,265,47,680,175600,63333
2471,1705,766,669,109200,63334
469,335,134,714,124000,63336
318,282,36,-,115000,63339
1364,1195,169,1097,357800,63341
1672,1205,467,967,119500,63343
676,562,114,733,162500,63344
261,221,40,388,69700,63345
903,821,82,733,161500,63347
3766,3274,492,1250,315800,63348
666,578,88,857,194700,63349
233,185,48,753,166300,63350
666,491,175,803,183800,63351
575,424,151,580,82700,63352
1933,1365,568,658,84400,63353
2052,1868,184,1023,181900,63357
557,389,168,663,170100,63359
1932,1399,533,673,150200,63361
3057,2548,509,910,169900,63362
616,480,136,727,122000,63363
33,28,5,-,280000,63365
19650,16200,3450,1097,229000,63366
9831,8094,1737,1303,309000,63367
16470,13772,2698,1220,265600,63368
886,643,243,842,252400,63369
255,236,19,860,191400,63373
28824,24244,4580,1092,210800,63376
1184,1047,137,735,196100,63377
9754,7721,2033,922,182000,63379
268,197,71,982,145300,63380
208,160,48,776,212500,63381
1177,814,363,616,75900,63382
5765,4385,1380,833,176100,63383
793,638,155,700,74900,63384
16258,13636,2622,1100,266000,63385
169,138,31,806,176300,63386
49,35,14,775,83000,63387
395,340,55,-,63500,63388
2346,1779,567,777,159900,63389
4056,3346,710,927,188800,63390
8690,5622,3068,713,130800,63401
206,196,10,-,104500,63430
110,110,0,-,114100,63431
187,161,26,-,114300,63432
0,0,0,-,-,63433
252,138,114,393,104700,63434
1424,1019,405,552,125100,63435
586,477,109,575,145300,63436
582,436,146,571,70900,63437
121,110,11,-,100900,63438
85,51,34,-,212500,63439
366,279,87,700,96100,63440
462,371,91,620,79400,63441
193,122,71,414,71300,63443
1268,860,408,502,85300,63445
138,124,14,663,70000,63446
358,242,116,600,67500,63447
545,439,106,660,97200,63448
87,50,37,-,-,63450
121,112,9,-,40000,63451
455,396,59,586,80500,63452
115,109,6,-,205100,63453
350,320,30,695,85800,63454
1909,1207,702,650,138200,63456
101,97,4,-,110900,63457
32,19,13,-,-,63458
1502,1364,138,761,146300,63459
89,86,3,-,83300,63460
2211,1649,562,597,131500,63461
594,473,121,506,104500,63462
296,238,58,602,126900,63463
149,104,45,-,59200,63465
23,23,0,-,-,63466
19,19,0,-,139600,63467
909,686,223,647,68300,63468
413,330,83,586,96400,63469
271,253,18,-,202800,63471
203,170,33,336,-,63472
104,104,0,-,203100,63473
164,121,43,571,-,63474
7382,4275,3107,705,127800,63501
366,302,64,525,98500,63530
116,109,7,558,77300,63531
491,425,66,658,89000,63532
269,223,46,713,147300,63533
334,294,40,575,79600,63534
21,13,8,-,-,63535
333,276,57,344,122400,63536
606,521,85,569,80800,63537
69,62,7,-,93300,63538
100,88,12,-,-,63539
64,62,2,-,66000,63540
172,150,22,635,95600,63541
64,49,15,-,-,63543
333,284,49,560,114300,63544
341,273,68,600,87500,63545
505,429,76,650,115200,63546
190,166,24,583,67500,63547
286,231,55,515,87600,63548
870,597,273,499,99400,63549
93,93,0,-,-,63551
3011,2091,920,633,115500,63552
1156,877,279,465,108400,63555
1126,802,324,692,78900,63556
83,83,0,-,184400,63557
235,217,18,675,112100,63558
599,501,98,408,117200,63559
40,19,21,-,43800,63560
300,213,87,444,81100,63561
207,174,33,-,220400,63563
1366,1073,293,589,87900,63565
37,33,4,-,90600,63566
29,15,14,-,-,63567
6337,4165,2172,665,92400,63601
367,298,69,471,111700,63620
571,467,104,583,122200,63621
425,284,141,521,78100,63622
301,259,42,696,126400,63623
1371,1087,284,664,82500,63624
152,144,8,-,165400,63625
455,444,11,-,95400,63626
1184,1044,140,1050,191200,63627
5022,3865,1157,667,138700,63628
460,400,60,230,110000,63629
1266,996,270,761,91500,63630
351,293,58,788,152700,63631
235,190,45,574,111000,63633
192,147,45,721,68700,63636
401,367,34,-,136300,63637
910,654,256,627,92800,63638
9865,6608,3257,745,161700,63640
4152,3089,1063,713,116800,63645
505,401,104,765,102100,63648
1653,1247,406,749,88000,63650
492,276,216,758,47300,63653
283,248,35,682,175300,63654
503,386,117,574,104600,63655
172,155,17,-,112500,63656
1024,894,130,640,88100,63660
417,374,43,-,91700,63662
301,173,128,621,92100,63663
3300,2458,842,603,107500,63664
94,82,12,-,83200,63665
4567,3742,825,763,174100,63670
741,613,128,645,191800,63673
19,19,0,-,-,63674
15,15,0,-,-,63675
14735,9354,5381,788,168200,63701
3588,1630,1958,770,107200,63703
1414,1157,257,663,93200,63730
346,320,26,689,159700,63732
337,215,122,-,66800,63735
1548,1118,430,771,128600,63736
0,0,0,-,-,63738
224,142,82,-,142000,63739
2000,1552,448,794,131200,63740
30,27,3,-,57500,63742
17,17,0,-,-,63743
67,49,18,669,106300,63744
38,35,3,-,108000,63745
20,18,2,-,-,63746
236,233,3,-,121800,63747
498,462,36,772,118600,63748
13,13,0,-,116100,63750
412,345,67,862,142800,63751
9950,7934,2016,922,184400,63755
170,117,53,744,164200,63758
179,153,26,-,184400,63760
60,60,0,-,90000,63763
1663,1290,373,663,117000,63764
568,508,60,469,147000,63766
244,190,54,685,78600,63767
480,407,73,867,152900,63769
72,57,15,700,92500,63770
935,678,257,675,101500,63771
76,41,35,767,-,63774
6148,4356,1792,810,162000,63775
2248,1590,658,707,128300,63780
481,399,82,924,163800,63781
102,100,2,-,101200,63782
62,62,0,-,103800,63783
59,51,8,-,69000,63784
496,444,52,810,142100,63785
249,217,32,-,79200,63787
8993,5590,3403,755,129800,63801
98,81,17,-,45000,63820
288,225,63,528,40300,63821
1017,690,327,674,82200,63822
489,358,131,623,92600,63823
73,29,44,844,117500,63824
1550,1076,474,675,86000,63825
40,30,10,-,57500,63826
210,157,53,450,71700,63827
68,55,13,-,33600,63828
408,213,195,672,46800,63829
2477,1302,1175,673,111700,63830
82,76,6,-,-,63833
1686,1008,678,646,84200,63834
570,350,220,495,52400,63837
136,43,93,710,53800,63839
28,28,0,-,48800,63840
5454,3569,1885,679,138100,63841
2276,1364,912,702,81700,63845
455,374,81,668,94900,63846
11,11,0,-,-,63847
407,289,118,641,53900,63848
104,47,57,-,106500,63849
8,8,0,-,-,63850
1361,701,660,640,64400,63851
550,373,177,541,73000,63852
68,56,12,-,55000,63853
353,299,54,500,63800,63855
4781,3040,1741,575,92500,63857
85,59,26,-,64300,63860
471,307,164,660,62700,63862
2179,1237,942,591,79300,63863
196,96,100,596,24400,63866
385,278,107,646,81700,63867
386,224,162,575,61800,63868
1554,904,650,676,102800,63869
421,254,167,546,47500,63870
1626,1068,558,653,109200,63873
112,84,28,625,60500,63874
761,478,283,652,82300,63876
1333,772,561,618,121000,63877
34,34,0,-,42500,63878
316,260,56,635,56100,63879
32,14,18,-,-,63880
150,99,51,617,33400,63882
13129,8308,4821,692,118400,63901
350,255,95,533,67400,63932
1230,904,326,641,74400,63933
9,9,0,-,-,63934
2942,2378,564,579,100900,63935
173,100,73,730,172400,63936
911,717,194,592,173900,63937
392,317,75,-,86600,63939
521,402,119,840,111600,63940
59,45,14,-,-,63941
201,173,28,517,88800,63942
189,135,54,763,110900,63943
582,547,35,575,131700,63944
439,368,71,660,146900,63945
15,15,0,-,-,63950
93,74,19,-,-,63951
98,83,15,450,94700,63952
380,300,80,564,74500,63953
299,269,30,475,66500,63954
78,62,16,-,-,63955
292,147,145,508,155700,63956
2096,1497,599,601,86000,63957
1048,821,227,675,89100,63960
711,491,220,633,86700,63961
41,0,41,-,-,63962
134,76,58,-,-,63964
848,552,296,442,108900,63965
905,748,157,634,111900,63966
636,517,119,494,96300,63967
287,236,51,738,104700,64001
1427,1242,185,702,274300,64011
11250,7720,3530,1192,166500,64012
10286,7021,3265,1109,187900,64014
12125,8943,3182,1019,192600,64015
1876,1581,295,872,177800,64016
122,99,23,-,67400,64017
276,227,49,1146,216000,64018
955,791,164,1051,170500,64019
1282,890,392,704,136500,64020
203,178,25,1036,80000,64021
50,45,5,775,113300,64022
5392,3942,1450,840,152600,64024
89,84,5,-,187500,64028
7385,5536,1849,1146,218000,64029
10806,5487,5319,862,127300,64030
3265,2986,279,1668,255000,64034
342,260,82,1014,93000,64035
135,66,69,778,-,64036
2389,1627,762,773,142300,64037
2325,1885,440,650,192400,64040
1357,1190,167,892,266600,64048
9448,4508,4940,816,110900,64050
9398,5138,4260,948,98400,64052
2479,1158,1321,863,62200,64053
1096,687,409,1018,75800,64054
15411,10465,4946,943,141100,64055
5952,3748,2204,1032,133200,64056
6054,3564,2490,1075,183100,64057
2497,2009,488,982,149900,64058
5916,4975,941,1041,252400,64060
1124,1045,79,791,224200,64061
2136,1802,334,939,195300,64062
8662,5585,3077,1043,187400,64063
7310,6188,1122,1169,307200,64064
7,0,7,588,-,64065
21,16,5,-,-,64066
2274,1506,768,766,148300,64067
13467,9755,3712,975,209200,64068
1222,1093,129,959,248500,64070
249,195,54,625,98600,64071
158,130,28,879,58800,64072
238,178,60,1583,254300,64074
4185,3050,1135,875,183200,64075
3273,2521,752,813,183100,64076
565,432,133,948,117200,64077
3712,3156,556,909,210400,64078
4680,3267,1413,1272,251400,64079
5108,3930,1178,1060,240100,64080
9766,7316,2450,1236,271500,64081
6161,5403,758,1563,319000,64082
9292,7622,1670,1213,246100,64083
644,593,51,-,233700,64084
3376,2265,1111,646,134200,64085
8908,6910,1998,1170,231100,64086
501,451,50,988,285300,64088
5021,4276,745,963,238200,64089
54,50,4,-,110400,64090
19,0,19,-,-,64092
10802,5974,4828,742,173100,64093
437,303,134,735,88800,64096
384,296,88,870,125000,64097
1228,949,279,798,252400,64098
5,0,5,-,-,64101
0,0,0,-,-,64102
3677,535,3142,1388,210800,64105
5368,860,4508,992,170700,64106
4704,1733,2971,1225,223500,64108
4519,1870,2649,834,177300,64109
7441,3555,3886,1013,192100,64110
10418,3195,7223,1040,223600,64111
4826,2022,2804,1259,401100,64112
4679,4489,190,1500,435700,64113
12707,8085,4622,1123,209000,64114
8564,3812,4752,964,188700,64116
6422,3333,3089,904,129500,64117
18043,10460,7583,1007,158900,64118
13185,9432,3753,1110,165500,64119
184,100,84,784,55000,64120
3918,2237,1681,900,84500,64123
3692,1829,1863,811,81300,64124
665,353,312,863,56500,64125
2083,1242,841,774,45600,64126
7112,3108,4004,821,49300,64127
5056,2233,2823,826,48800,64128
3623,1904,1719,915,87900,64129
8559,4573,3986,888,55200,64130
9735,4545,5190,1013,172300,64131
5112,2193,2919,887,76700,64132
15298,8945,6353,967,132400,64133
8812,4301,4511,1120,98400,64134
673,407,266,1176,123800,64136
4584,2154,2430,1047,146800,64137
10468,6045,4423,971,124600,64138
829,630,199,1208,332900,64139
1935,1626,309,1294,294300,64145
780,666,114,-,171500,64146
134,0,134,635,-,64147
167,156,11,-,342600,64149
1820,794,1026,797,239000,64150
11577,6960,4617,1142,233800,64151
11802,9903,1899,1077,270400,64152
2722,1422,1300,1108,257400,64153
5685,2821,2864,1212,278200,64154
10574,7313,3261,1167,220800,64155
2261,1653,608,1343,302500,64156
7118,6346,772,1613,286500,64157
2374,1179,1195,1250,258400,64158
134,84,50,1259,117400,64161
453,236,217,741,204400,64163
23,23,0,-,-,64164
63,63,0,-,-,64165
168,119,49,-,249100,64166
190,190,0,-,378300,64167
396,374,22,688,177500,64401
924,708,216,491,89400,64402
15,8,7,-,150000,64420
379,324,55,1040,77800,64421
162,118,44,-,137900,64422
350,291,59,341,124600,64423
1514,987,527,528,103900,64424
141,97,44,712,65800,64426
265,187,78,567,126800,64427
259,198,61,504,65200,64428
3693,2371,1322,913,148000,64429
315,268,47,826,168100,64430
154,108,46,483,97500,64431
19,19,0,-,78800,64432
23,19,4,-,92800,64433
215,193,22,416,178800,64434
358,301,57,1337,206800,64436
206,181,25,742,120500,64437
46,41,5,-,62500,64438
644,504,140,663,189800,64439
317,246,71,775,164000,64440
47,41,6,-,102200,64441
301,273,28,496,86900,64442
647,501,146,698,254500,64443
545,426,119,613,124300,64444
129,96,33,688,83600,64445
456,312,144,511,80300,64446
440,380,60,743,162000,64448
207,183,24,663,103400,64449
198,156,42,344,68400,64451
63,61,2,-,231900,64453
962,830,132,789,169800,64454
153,118,35,371,98300,64455
508,413,95,323,62000,64456
89,87,2,-,-,64457
62,62,0,-,65200,64458
215,206,9,-,163000,64459
337,276,61,680,67500,64461
558,413,145,678,116600,64463
1581,1263,318,758,159700,64465
192,143,49,386,87500,64466
104,86,18,-,176200,64467
5720,2784,2936,688,154500,64468
938,657,281,676,116700,64469
651,497,154,613,96100,64470
187,136,51,588,61400,64471
541,431,110,606,102100,64473
347,236,111,681,112800,64474
131,89,42,667,99000,64475
125,105,20,-,106300,64476
1485,1124,361,667,173100,64477
349,278,71,663,93500,64479
118,106,12,-,159100,64480
344,257,87,554,74200,64481
897,643,254,625,103000,64482
192,168,24,667,113900,64483
382,311,71,731,103300,64484
3181,2305,876,774,150600,64485
102,78,24,290,45500,64486
288,219,69,683,80100,64487
723,574,149,583,122600,64489
696,590,106,761,168200,64490
798,525,273,562,79500,64491
704,572,132,735,164800,64492
211,162,49,982,-,64493
440,334,106,814,115000,64494
98,63,35,-,-,64496
151,143,8,625,310300,64497
106,99,7,-,65500,64498
59,58,1,-,84500,64499
4508,1909,2599,762,88500,64501
4833,3242,1591,874,110600,64503
4119,2796,1323,823,90200,64504
5116,3562,1554,888,145400,64505
8714,5282,3432,818,178000,64506
5265,3449,1816,857,111600,64507
4524,3017,1507,687,122000,64601
215,202,13,731,112500,64620
162,123,39,522,87400,64622
136,125,11,839,70200,64623
601,490,111,703,90000,64624
287,210,77,567,79100,64625
2310,1775,535,628,87200,64628
245,204,41,655,155900,64630
305,252,53,475,76800,64631
158,149,9,500,61800,64632
1774,1191,583,726,97600,64633
176,152,24,700,107100,64635
121,101,20,763,60600,64636
233,178,55,563,95600,64637
178,136,42,446,111100,64638
72,65,7,-,62300,64639
1206,915,291,681,128800,64640
249,190,59,333,85000,64641
309,249,60,618,62900,64642
444,345,99,491,117500,64643
1118,837,281,795,131900,64644
77,69,8,238,-,64645
85,70,15,425,106300,64646
195,125,70,521,52900,64647
666,558,108,556,98700,64648
308,274,34,575,105400,64649
263,215,48,638,159500,64650
196,138,58,703,64500,64651
146,123,23,488,110400,64652
259,239,20,607,87800,64653
14,9,5,-,-,64654
85,85,0,-,-,64655
133,84,49,513,90000,64656
121,91,30,-,67400,64657
1219,938,281,539,110500,64658
369,273,96,546,125600,64659
172,165,7,525,91600,64660
304,212,92,-,78100,64661
105,87,18,555,107200,64664
85,71,14,938,37300,64667
650,521,129,814,84900,64668
326,229,97,486,159500,64670
722,610,112,625,127200,64671
53,50,3,-,-,64672
842,712,130,396,82100,64673
125,108,17,319,120000,64674
46,39,7,-,57500,64676
300,194,106,-,81400,64679
59,55,4,-,74400,64681
151,140,11,-,87300,64682
2950,2017,933,632,99200,64683
102,97,5,-,86300,64686
215,167,48,707,152100,64688
192,160,32,827,90700,64689
5715,3862,1853,818,183600,64701
1530,1165,365,723,137300,64720
139,106,33,615,76700,64722
337,266,71,718,154400,64723
757,528,229,398,80300,64724
769,538,231,908,164400,64725
119,99,20,1104,169900,64726
163,135,28,725,87000,64728
2457,1608,849,647,138000,64730
465,353,112,638,153600,64733
793,632,161,1115,272400,64734
5724,3931,1793,667,136200,64735
587,494,93,812,160700,64738
338,298,40,823,239400,64739
740,644,96,631,87200,64740
64,58,6,581,109400,64741
890,711,179,759,191900,64742
90,55,35,833,126300,64743
2876,1889,987,757,135300,64744
27,23,4,-,63100,64745
624,505,119,865,172600,64746
1587,1324,263,794,177000,64747
593,417,176,590,81600,64748
117,103,14,-,113100,64750
257,220,37,825,93600,64752
873,710,163,647,127900,64755
283,240,43,500,56400,64756
2907,1901,1006,647,112000,64759
559,439,120,779,144400,64761
614,488,126,569,72500,64762
588,457,131,675,93800,64763
3,2,1,-,-,64765
267,242,25,-,89500,64767
274,232,42,-,39800,64769
522,397,125,757,115400,64770
157,130,27,505,154300,64771
5437,3936,1501,665,116800,64772
1590,1239,351,544,121100,64776
168,138,30,766,90000,64778
853,698,155,653,80700,64779
162,129,33,685,96300,64780
45,39,6,-,63500,64781
284,261,23,489,84100,64783
500,375,125,460,83100,64784
622,490,132,736,154800,64788
355,256,99,747,105000,64790
15267,8734,6533,802,132300,64801
14853,10559,4294,826,141300,64804
285,174,111,960,75300,64830
2416,1705,711,668,119200,64831
455,354,101,870,130000,64832
20,18,2,-,105600,64833
3510,2761,749,1081,165800,64834
701,501,200,772,81600,64835
9039,5611,3428,792,137300,64836
1131,929,202,689,141200,64840
360,215,145,711,88100,64841
312,235,77,711,88900,64842
1158,874,284,724,89800,64843
1693,1235,458,772,92500,64844
169,62,107,471,55000,64847
197,182,15,582,135700,64848
71,69,2,-,83100,64849
8541,5722,2819,737,124700,64850
1480,647,833,680,68300,64854
988,886,102,814,150700,64855
1465,929,536,683,151600,64856
156,132,24,805,68900,64857
210,210,0,-,253900,64858
496,354,142,521,104400,64859
414,289,125,597,170800,64861
1344,1029,315,768,91000,64862
506,287,219,587,82100,64863
1886,1431,455,770,121500,64865
389,348,41,906,79600,64866
349,287,62,835,88600,64867
58,58,0,-,-,64868
5887,3717,2170,798,133900,64870
294,285,9,-,78200,64873
237,141,96,450,76400,64874
126,122,4,-,162500,65001
2870,2202,668,1014,222300,65010
632,516,116,-,124600,65011
1160,833,327,618,159000,65013
992,754,238,512,127700,65014
518,473,45,768,203000,65016
465,374,91,740,129200,65017
3053,2307,746,691,148800,65018
5320,4239,1081,727,195800,65020
698,626,72,835,193400,65023
432,369,63,709,97400,65024
299,186,113,650,154500,65025
4746,3502,1244,691,122900,65026
562,507,55,678,139800,65032
315,293,22,-,86100,65034
642,553,89,-,197700,65035
2195,1934,261,700,212400,65037
1067,999,68,319,308900,65039
423,363,60,-,145600,65040
2278,1781,497,490,165400,65041
3705,2993,712,809,157000,65043
578,543,35,398,158300,65046
464,305,159,471,277900,65047
87,76,11,-,-,65048
2929,2345,584,703,275500,65049
175,159,16,567,206500,65050
1824,1398,426,584,146300,65051
1208,1113,95,689,253700,65052
577,548,29,675,230000,65053
367,338,29,-,172900,65054
413,347,66,531,138200,65058
437,315,122,822,188800,65059
194,183,11,-,82300,65061
11,11,0,-,-,65062
1279,1101,178,817,194800,65063
272,256,16,-,-,65064
2671,1801,870,774,267100,65065
2415,1902,513,632,123200,65066
176,136,40,905,99800,65067
307,264,43,588,153000,65068
191,168,23,-,203100,65069
721,639,82,1321,190400,65072
1176,987,189,690,157700,65074
354,307,47,479,216000,65075
223,188,35,545,165600,65076
171,171,0,-,226900,65077
1327,1056,271,811,85600,65078
1978,1794,184,933,277800,65079
490,427,63,1115,247200,65080
1104,785,319,659,126500,65081
388,343,45,630,155800,65082
58,47,11,-,-,65083
2341,1722,619,536,135700,65084
514,447,67,490,223100,65085
10431,7009,3422,672,187100,65101
16602,10717,5885,742,169700,65109
18057,5987,12070,936,177900,65201
18952,11984,6968,955,167000,65202
25279,15817,9462,920,259400,65203
0,0,0,-,-,65215
0,0,0,-,-,65216
194,166,28,469,70700,65230
1166,857,309,549,166300,65231
133,118,15,708,83300,65232
3791,2844,947,716,154400,65233
485,312,173,395,97000,65236
446,335,111,581,111000,65237
661,633,28,820,152400,65239
3385,2597,788,449,146200,65240
810,763,47,725,155100,65243
162,141,21,-,127500,65244
23,23,0,-,55000,65246
237,219,18,-,84300,65247
1250,896,354,742,138600,65248
168,162,6,-,129200,65250
7148,4891,2257,730,153900,65251
661,579,82,650,111000,65254
1885,1453,432,905,172400,65255
733,696,37,944,228900,65256
591,519,72,817,108800,65257
230,200,30,760,143800,65258
977,802,175,716,111000,65259
170,155,15,-,77900,65260
395,297,98,391,97800,65261
341,288,53,906,172900,65262
568,484,84,663,107500,65263
379,351,28,384,87000,65264
5717,3863,1854,643,104200,65265
6067,3709,2358,694,124700,65270
641,516,125,503,136300,65274
968,805,163,478,110700,65275
630,492,138,620,152000,65276
38,25,13,688,55000,65278
615,565,50,957,230600,65279
109,89,20,-,-,65280
950,774,176,602,112100,65281
75,75,0,-,-,65282
243,239,4,-,209200,65283
761,568,193,743,143900,65284
197,187,10,-,113400,65285
24,20,4,-,-,65286
87,85,2,-,229200,65287
13513,9015,4498,774,132200,65301
1002,0,1002,1143,-,65305
30,29,1,-,162500,65320
150,118,32,635,92900,65321
232,189,43,765,107800,65322
333,280,53,492,94400,65323
572,506,66,767,195000,65324
1153,888,265,728,156700,65325
819,696,123,909,145500,65326
79,71,8,775,117200,65327
92,71,21,-,245000,65329
180,132,48,678,106800,65330
595,533,62,578,148900,65332
289,271,18,541,90500,65333
456,304,152,1103,139900,65334
126,115,11,-,-,65335
2576,1711,865,924,156500,65336
698,476,222,648,130900,65337
1094,861,233,792,111100,65338
148,119,29,775,69600,65339
5075,3553,1522,682,121000,65340
61,48,13,725,175000,65344
202,181,21,-,168800,65345
362,325,37,706,128600,65347
587,451,136,600,160800,65348
1055,716,339,494,85800,65349
662,550,112,840,183800,65350
794,616,178,693,112300,65351
229,111,118,831,184000,65354
4593,3780,813,740,133700,65355
1663,1221,442,650,114900,65360
13226,7400,5826,740,165700,65401
8,8,0,-,-,65409
0,0,0,-,-,65436
1051,849,202,543,85600,65438
33,33,0,-,-,65439
133,133,0,-,96000,65440
2142,1652,490,797,149100,65441
39,39,0,-,194300,65443
333,240,93,536,111500,65444
209,94,115,-,114600,65446
108,93,15,-,59800,65449
1004,797,207,630,113200,65452
3317,2332,985,653,149200,65453
157,145,12,-,-,65456
121,110,11,-,223000,65457
2511,2057,454,739,146600,65459
69,69,0,-,160300,65461
577,559,18,675,62100,65462
598,363,235,-,110700,65463
267,233,34,-,132100,65464
489,328,161,663,170700,65466
3,3,0,-,-,65468
361,319,42,-,117700,65470
2103,16,2087,1130,-,65473
84,84,0,-,67200,65479
1825,1331,494,668,119000,65483
25,25,0,-,-,65484
1327,1185,142,509,115300,65486
68,68,0,-,-,65501
102,102,0,-,82700,65529
224,203,21,-,-,65534
514,419,95,800,78100,65535
11909,8271,3638,718,122600,65536
92,92,0,-,305100,65541
2066,1501,565,571,104400,65542
234,191,43,-,200800,65543
2169,1585,584,592,121800,65548
1231,933,298,636,109900,65550
684,612,72,-,161800,65552
489,379,110,440,91200,65555
2069,1586,483,523,106800,65556
31,31,0,-,-,65557
3320,2258,1062,733,156900,65559
5632,3941,1691,638,110800,65560
45,25,20,-,-,65564
2090,1501,589,704,127800,65565
295,216,79,617,79600,65566
582,472,110,767,119400,65567
276,260,16,1107,87500,65570
716,537,179,403,112700,65571
293,238,55,-,181400,65580
909,651,258,614,124600,65582
4857,2524,2333,1037,168700,65583
4061,2011,2050,1051,172400,65584
8,8,0,-,-,65586
839,666,173,530,101600,65588
34,15,19,-,-,65589
839,655,184,777,152800,65590
468,359,109,904,166300,65591
264,224,40,578,144800,65601
91,91,0,-,-,65603
1498,1197,301,670,145800,65604
4955,3463,1492,806,117400,65605
1030,726,304,767,119600,65606
3201,2386,815,632,117500,65608
270,207,63,738,79200,65609
1867,1649,218,790,201300,65610
992,873,119,796,176700,65611
682,488,194,431,256700,65612
6513,4346,2167,714,150300,65613
193,158,35,864,144800,65614
10522,6406,4116,906,179600,65616
586,532,54,952,162000,65617
42,42,0,-,-,65618
3696,2612,1084,825,167600,65619
96,56,40,-,351900,65620
3252,2197,1055,572,140800,65622
3,0,3,-,-,65623
656,638,18,-,215000,65624
3025,2028,997,656,128500,65625
871,719,152,623,135800,65626
320,233,87,840,109400,65627
227,179,48,-,228800,65629
155,138,17,-,467600,65630
2304,1965,339,1080,169300,65631
966,760,206,708,156400,65632
1204,894,310,873,113400,65633
133,119,14,438,129700,65634
205,175,30,669,163400,65635
346,262,84,531,163700,65637
254,203,51,-,162100,65638
265,260,5,-,146000,65640
507,423,84,479,144400,65641
727,649,78,798,148300,65644
707,618,89,581,117300,65646
1202,973,229,745,133900,65647
2111,1794,317,764,174000,65648
878,681,197,817,167600,65649
583,507,76,620,101600,65650
1343,1124,219,563,160400,65652
2545,1980,565,621,149500,65653
116,79,37,-,88300,65654
1023,714,309,703,112400,65655
1612,1394,218,618,195500,65656
85,51,34,-,161600,65657
619,498,121,498,217400,65658
134,129,5,-,198600,65660
897,654,243,503,92700,65661
398,330,68,-,121900,65662
880,644,236,594,153400,65663
16,1,15,960,-,65664
53,53,0,-,-,65666
1080,851,229,427,163200,65667
725,572,153,901,77900,65668
871,735,136,946,177500,65669
3491,2351,1140,738,144100,65672
979,663,316,608,79700,65674
10,8,2,-,-,65675
200,131,69,-,88800,65676
1325,852,473,692,168900,65679
455,435,20,1058,122100,65680
885,862,23,-,167800,65681
773,530,243,779,95600,65682
340,303,37,530,69400,65685
2157,1769,388,777,208400,65686
28,21,7,-,595600,65688
2220,1712,508,572,116000,65689
71,56,15,-,-,65690
336,247,89,819,109400,65692
87,76,11,-,209000,65702
1596,1122,474,516,123400,65704
1433,936,497,810,119200,65705
6121,4845,1276,645,173400,65706
796,598,198,818,106300,65707
4887,3028,1859,757,143300,65708
443,333,110,720,160600,65710
3207,2539,668,621,92500,65711
3499,2378,1121,624,127600,65712
883,697,186,585,125800,65713
12643,9135,3508,880,210700,65714
16,16,0,-,-,65715
799,624,175,525,134100,65717
269,238,31,675,147600,65720
12135,8924,3211,867,192100,65721
415,328,87,723,110500,65722
1114,831,283,721,125400,65723
645,604,41,-,74100,65724
1104,944,160,848,163300,65725
0,0,0,-,-,65726
71,71,0,-,-,65727
13,13,0,-,-,65728
84,65,19,-,197800,65729
9,9,0,-,-,65730
78,60,18,-,-,65731
401,335,66,764,198300,65732
274,240,34,-,70000,65733
1210,801,409,688,84900,65734
43,22,21,-,66700,65735
3057,2426,631,820,176000,65737
7909,5186,2723,964,146800,65738
384,358,26,-,246900,65739
1268,924,344,861,94800,65740
0,0,0,-,-,65741
4965,3923,1042,679,192300,65742
24,19,5,-,162500,65744
924,572,352,791,100300,65745
2863,2346,517,635,150100,65746
1713,1641,72,938,215600,65747
199,137,62,756,110400,65752
1849,1540,309,721,162800,65753
232,217,15,-,177800,65754
214,198,16,-,140400,65755
321,298,23,688,206200,65756
2847,2386,461,888,212200,65757
385,322,63,759,129400,65759
236,232,4,-,129400,65760
531,490,41,686,171000,65761
162,134,28,-,158300,65762
451,417,34,-,89800,65764
21,17,4,-,66300,65766
734,571,163,488,184000,65767
134,105,29,524,218600,65768
1046,926,120,623,130800,65769
1093,928,165,642,142000,65770
541,541,0,-,262700,65771
879,788,91,661,141400,65772
212,190,22,-,-,65773
436,369,67,609,86100,65774
9943,6477,3466,683,125000,65775
76,76,0,-,94500,65777
195,104,91,-,139300,65778
645,505,140,623,95000,65779
3158,2299,859,974,163600,65781
37,29,8,-,-,65783
0,0,0,-,-,65784
2290,1716,574,711,119900,65785
633,538,95,569,162500,65786
449,404,45,1271,198100,65787
135,131,4,-,70200,65788
566,441,125,495,131400,65789
317,303,14,-,71700,65790
1496,1038,458,653,109800,65791
2331,1573,758,523,97300,65793
0,0,0,-,-,65801
19169,10513,8656,793,124000,65802
18143,10075,8068,788,127100,65803
18992,10243,8749,781,172400,65804
7673,929,6744,719,72800,65806
27017,12584,14433,861,136400,65807
4665,3970,695,911,290200,65809
9380,7017,2363,938,226300,65810
18,0,18,-,-,65897
4632,3121,1511,717,113200,66002
2760,2077,683,1001,228900,66006
3513,2853,660,982,281700,66007
100,97,3,-,98800,66008
258,213,45,485,137800,66010
3660,2824,836,1060,204000,66012
816,803,13,-,504400,66013
190,154,36,-,363000,66014
327,253,74,508,106600,66015
207,193,14,-,159200,66016
144,111,33,721,87600,66017
2358,1561,797,896,291400,66018
524,450,74,913,258000,66020
893,749,144,1043,174500,66021
430,385,45,723,101000,66023
257,178,79,817,71100,66024
2736,1974,762,1219,198900,66025
211,202,9,-,159600,66026
1568,10,1558,1747,-,66027
8552,5891,2661,1185,219200,66030
0,0,0,-,-,66031
1908,1297,611,739,130900,66032
360,299,61,726,150300,66033
281,216,65,545,119400,66035
280,248,32,763,145000,66039
1493,1164,329,865,125600,66040
374,358,16,-,91600,66041
242,202,40,425,136100,66042
3066,2263,803,1130,193000,66043
11620,4297,7323,920,187100,66044
0,0,0,-,-,66045
8221,3967,4254,821,174300,66046
8986,3830,5156,1047,254300,66047
14077,8477,5600,865,164100,66048
14340,7974,6366,1080,281500,66049
784,709,75,938,191800,66050
735,534,201,1138,219500,66052
2899,2278,621,1426,241200,66053
1032,880,152,957,184400,66054
666,513,153,656,120400,66056
105,86,19,615,74000,66058
479,399,80,745,134500,66060
22894,17074,5820,1042,276600,66061
27740,20601,7139,1187,272900,66062
2153,1506,647,865,111100,66064
1037,927,110,766,200300,66066
6269,4137,2132,801,143600,66067
773,748,25,588,168500,66070
5322,4185,1137,926,224800,66071
490,466,24,1100,215400,66072
1032,815,217,901,166900,66073
910,672,238,629,94500,66075
864,716,148,811,155900,66076
369,311,58,735,168100,66078
281,239,42,810,123400,66079
400,320,80,763,134400,66080
3816,3165,651,1049,268900,66083
3709,3340,369,1614,426100,66085
3783,3085,698,1072,217000,66086
866,684,182,704,100200,66087
1074,786,288,686,171500,66088
973,739,234,650,116100,66090
199,158,41,584,82300,66091
1534,1264,270,1031,202500,66092
230,209,21,-,122200,66093
134,85,49,589,102500,66094
355,301,54,800,187500,66095
468,399,69,689,174000,66097
4904,1934,2970,669,68000,66101
10043,5193,4850,877,78500,66102
6163,2487,3676,996,108800,66103
9418,5915,3503,902,86800,66104
877,358,519,758,45500,66105
8392,5725,2667,901,119800,66106
9566,7504,2062,1469,196900,66109
3760,2904,856,1002,117900,66111
4884,2377,2507,973,140500,66112
0,0,0,-,-,66115
0,0,0,-,-,66118
0,0,0,-,-,66160
8474,4405,4069,1034,215500,66202
7881,5024,2857,992,186100,66203
8582,4007,4575,1156,176600,66204
6294,5008,1286,1218,267500,66205
4562,3952,610,2197,480200,66206
6194,4865,1329,1604,312100,66207
9299,7327,1972,1569,344700,66208
8076,5945,2131,1217,447500,66209
9021,4929,4092,1243,298800,66210
2629,1892,737,1353,473800,66211
14579,8696,5883,1100,223200,66212
12750,7530,5220,1322,357100,66213
5181,2426,2755,951,248200,66214
11240,6954,4286,1273,240000,66215
9559,8174,1385,1108,261900,66216
2553,1423,1130,1086,353200,66217
2588,2225,363,1486,322600,66218
6598,2471,4127,1309,309000,66219
2848,2670,178,1282,458400,66220
8085,6787,1298,1496,557800,66221
9984,5859,4125,1493,344300,66223
4626,4017,609,1552,488600,66224
4684,4041,643,1182,327100,66226
2926,2614,312,1538,363400,66227
7,0,7,-,-,66251
733,546,187,627,158800,66401
1145,908,237,745,204500,66402
272,239,33,765,258300,66403
142,128,14,-,225000,66404
217,153,64,290,159800,66406
135,106,29,1163,150000,66407
129,110,19,838,-,66408
1635,1577,58,780,260500,66409
525,440,85,867,63600,66411
111,88,23,-,312500,66412
805,583,222,630,105100,66413
994,832,162,648,126400,66414
268,228,40,875,72900,66415
177,154,23,556,154200,66416
182,157,25,823,58800,66417
155,139,16,675,85500,66418
116,104,12,929,88000,66419
304,280,24,-,"10,000-",66422
337,277,60,585,86300,66423
211,163,48,614,108200,66424
252,196,56,-,103100,66425
507,448,59,675,101600,66427
98,75,23,-,121900,66428
175,154,21,-,137800,66429
192,163,29,1059,114400,66431
172,109,63,700,-,66432
1746,1265,481,678,101700,66434
2395,1588,807,640,167500,66436
52,31,21,945,231300,66438
1010,627,383,557,74000,66439
839,754,85,877,162800,66440
10268,5222,5046,919,136800,66441
4002,47,3955,1240,-,66442
449,382,67,859,164400,66449
583,493,90,770,133600,66451
119,101,18,1188,101600,66501
17645,7539,10106,888,196300,66502
6893,4240,2653,1110,279600,66503
0,0,0,-,-,66506
330,267,63,682,172200,66507
1754,1319,435,625,111800,66508
1002,764,238,768,150300,66509
295,217,78,826,151900,66510
1124,975,149,847,149100,66512
690,612,78,1070,211200,66514
120,115,5,-,104000,66515
117,98,19,810,86400,66516
683,366,317,1032,126600,66517
134,134,0,-,89500,66518
245,211,34,588,191100,66520
555,359,196,762,119800,66521
65,10,55,954,-,66522
1564,995,569,773,137700,66523
970,897,73,700,163100,66524
309,242,67,920,206500,66526
70,49,21,811,75000,66527
266,208,58,1075,103300,66528
664,600,64,1060,167500,66531
226,191,35,750,160200,66532
649,478,171,850,186200,66533
1578,1111,467,639,141300,66534
1368,1043,325,928,196000,66535
1140,878,262,790,166200,66536
471,414,57,905,90000,66537
1309,1023,286,754,198000,66538
1094,900,194,727,158000,66539
232,214,18,769,135000,66540
112,111,1,-,73500,66541
1061,995,66,933,170500,66542
443,367,76,1055,137700,66543
120,103,17,-,86400,66544
391,371,20,-,209000,66546
2942,2367,575,972,179700,66547
341,293,48,613,83400,66548
612,494,118,848,162100,66549
202,175,27,931,106500,66550
215,147,68,446,104600,66552
253,229,24,950,175700,66554
636,114,522,570,49500,66603
10029,5652,4377,938,100700,66604
7926,5675,2251,814,117400,66605
4769,2614,2155,867,91700,66606
3251,1522,1729,717,40900,66607
2117,1313,804,826,59500,66608
2929,2128,801,846,106300,66609
4339,4123,216,1580,261700,66610
4651,2387,2264,849,105900,66611
1283,256,1027,622,44600,66612
14567,9784,4783,912,149800,66614
1423,946,477,1102,243100,66615
2370,1450,920,858,69200,66616
3338,2803,535,988,167000,66617
3785,3468,317,814,175200,66618
917,305,612,1254,78700,66619
0,0,0,-,-,66621
0,0,0,-,-,66622
4819,3310,1509,728,87200,66701
250,216,34,805,68700,66710
267,202,65,583,26900,66711
764,480,284,711,84300,66712
2063,1498,565,682,85500,66713
61,57,4,-,45000,66714
189,155,34,817,41800,66716
216,196,20,625,49200,66717
4255,3097,1158,607,85000,66720
366,306,60,650,76700,66724
2083,1369,714,594,82900,66725
75,72,3,-,67500,66732
917,681,236,523,73300,66733
112,94,18,-,-,66734
248,194,54,871,84800,66735
1440,1052,388,718,84300,66736
109,106,3,-,107300,66738
2136,1417,719,622,77800,66739
74,69,5,638,183800,66740
84,78,6,-,204700,66741
17,13,4,-,-,66742
1562,980,582,765,88300,66743
67,58,9,-,-,66746
1135,902,233,483,89300,66748
2873,1869,1004,741,83500,66749
307,250,57,675,49600,66751
537,487,50,506,84500,66753
124,82,42,991,-,66754
365,293,72,567,87600,66755
447,374,73,336,75700,66756
1297,936,361,660,87700,66757
73,55,18,1050,-,66758
0,0,0,-,-,66760
90,90,0,-,97100,66761
10029,5215,4814,785,103500,66762
1326,848,478,756,135300,66763
158,123,35,763,-,66767
176,158,18,-,102500,66769
315,263,52,663,108600,66770
368,282,86,577,115000,66771
92,70,22,673,-,66772
222,194,28,700,51400,66773
66,59,7,-,209700,66775
595,458,137,744,102500,66776
221,197,24,556,82700,66777
0,0,0,-,-,66778
247,221,26,625,91000,66779
205,202,3,-,139300,66780
320,223,97,827,58700,66781
45,39,6,-,33900,66782
879,728,151,533,66500,66783
11433,6191,5242,712,121000,66801
87,81,6,-,83600,66830
245,183,62,437,-,66833
362,277,85,796,111900,66834
442,307,135,852,109200,66835
69,66,3,-,115600,66838
1509,1047,462,714,143600,66839
219,189,30,675,84700,66840
183,148,35,956,114600,66842
54,54,0,-,92300,66843
451,347,104,525,92900,66845
1290,994,296,700,112200,66846
190,171,19,678,83400,66849
101,64,37,1085,123100,66850
292,194,98,707,43000,66851
255,185,70,596,87500,66852
169,153,16,713,36100,66853
266,202,64,642,66100,66854
669,593,76,658,136400,66856
475,377,98,692,85000,66857
149,128,21,632,65600,66858
84,79,5,-,107400,66859
554,416,138,533,72400,66860
1316,1075,241,624,108400,66861
54,44,10,542,120000,66862
32,32,0,-,-,66863
158,150,8,-,72100,66864
418,324,94,675,163500,66865
649,491,158,703,86600,66866
303,260,43,831,126900,66868
292,228,64,391,113100,66869
53,44,9,-,88000,66870
536,442,94,786,122400,66871
427,351,76,727,85800,66872
97,94,3,-,40000,66873
2478,1648,830,696,88200,66901
74,55,19,-,-,66930
26,23,3,-,63800,66932
164,124,40,688,101100,66933
1039,696,343,640,88900,66935
140,112,28,-,40000,66936
330,281,49,404,71800,66937
491,401,90,715,67300,66938
180,128,52,631,91300,66939
164,136,28,-,42400,66940
58,52,6,-,55000,66941
88,70,18,-,34000,66942
204,134,70,575,81300,66943
111,109,2,-,212500,66944
360,326,34,542,94700,66945
96,73,23,-,120500,66946
185,167,18,444,76100,66948
229,184,45,515,65800,66949
345,293,52,826,60800,66951
195,174,21,-,73800,66952
253,188,65,436,120300,66953
33,33,0,-,-,66955
469,411,58,908,71300,66956
120,86,34,-,41700,66958
100,93,7,-,30800,66959
47,38,9,-,15000,66960
11,11,0,-,-,66961
104,82,22,575,111100,66962
104,61,43,-,33200,66963
87,83,4,-,20200,66964
288,192,96,572,73200,66966
800,645,155,589,78300,66967
631,479,152,529,80800,66968
29,29,0,-,86400,66970
754,662,92,950,304200,67001
5382,4169,1213,1408,234600,67002
962,683,279,748,72900,67003
348,289,59,600,112300,67004
6059,4230,1829,701,74500,67005
269,193,76,589,122000,67008
362,231,131,614,47900,67009
5578,4310,1268,854,150300,67010
6,6,0,-,-,67012
1346,1036,310,748,118900,67013
160,131,29,970,116000,67016
681,592,89,1195,194700,67017
53,36,17,-,-,67018
333,280,53,653,74000,67019
510,417,93,701,88400,67020
10,10,0,-,-,67021
657,484,173,608,66500,67022
75,62,13,719,70000,67023
464,350,114,554,102500,67024
1261,1018,243,918,147900,67025
1655,1387,268,941,193300,67026
99,98,1,-,25000,67028
491,333,158,704,66400,67029
875,754,121,1083,195500,67030
873,670,203,810,142800,67031
358,287,71,680,103600,67035
59,45,14,-,48100,67036
11389,8145,3244,1003,183200,67037
259,219,40,571,84400,67038
1057,876,181,717,153500,67039
87,84,3,-,114900,67041
6421,4243,2178,806,112600,67042
1284,933,351,611,73300,67045
310,245,65,443,73500,67047
20,20,0,-,186100,67049
724,598,126,877,198500,67050
155,152,3,-,76200,67051
2654,2279,375,1294,206100,67052
195,153,42,617,86300,67053
498,353,145,639,156000,67054
39,27,12,-,133100,67055
1147,819,328,772,147600,67056
125,81,44,498,45700,67057
738,544,194,723,77100,67058
299,238,61,688,87500,67059
5230,4194,1036,870,137800,67060
61,34,27,629,-,67061
1731,943,788,630,156500,67062
1285,1048,237,679,135600,67063
119,111,8,-,-,67065
165,92,73,928,137500,67066
795,607,188,1568,198200,67067
1885,1243,642,739,82000,67068
391,285,106,481,82000,67070
55,55,0,-,158500,67071
175,97,78,477,44200,67072
118,104,14,967,108900,67073
539,464,75,695,109700,67074
2522,1261,1261,962,173500,67101
24,16,8,-,90000,67102
64,58,6,867,107100,67103
788,588,200,623,72000,67104
69,60,9,-,86700,67105
171,109,62,-,152200,67106
1081,800,281,701,162500,67107
614,541,73,760,133600,67108
154,101,53,617,72500,67109
3204,2700,504,790,142700,67110
94,72,22,1098,205300,67111
108,97,11,-,95000,67112
8183,6102,2081,831,117000,67114
816,495,321,718,183400,67117
299,242,57,790,88300,67118
549,359,190,513,86600,67119
328,313,15,-,205400,67120
85,60,25,-,-,67122
343,317,26,675,104600,67123
3038,2011,1027,758,103900,67124
313,270,43,392,56500,67127
112,94,18,-,254300,67131
105,83,22,714,184400,67132
2364,2097,267,1213,174800,67133
139,112,27,553,134400,67134
1169,922,247,1014,176900,67135
169,146,23,665,46700,67137
202,186,16,780,254400,67138
393,330,63,571,83500,67140
127,110,17,429,94000,67142
61,32,29,-,-,67143
980,857,123,856,131300,67144
707,581,126,697,126000,67146
3898,3028,870,887,182600,67147
367,358,9,-,202100,67149
6,6,0,-,-,67150
219,161,58,909,-,67151
3322,2117,1205,798,84700,67152
651,559,92,842,124500,67154
44,34,10,-,-,67155
5132,3399,1733,724,115400,67156
65,54,11,-,67100,67159
1200,174,1026,933,-,67202
12899,6053,6846,785,106900,67203
8604,6326,2278,862,119200,67204
6825,5544,1281,1290,249900,67205
7719,4717,3002,1080,263800,67206
11072,4933,6139,863,162800,67207
7213,3788,3425,899,134900,67208
5085,3817,1268,877,162400,67209
3097,1283,1814,808,144900,67210
8022,3360,4662,749,81600,67211
18369,11547,6822,943,154500,67212
8579,3739,4840,789,71200,67213
6216,2222,3994,686,63500,67214
2041,1844,197,1355,161700,67215
8516,4605,3911,787,80200,67216
11926,7944,3982,886,91600,67217
9915,4867,5048,769,94700,67218
4361,3027,1334,949,120400,67219
5422,3324,2098,859,157400,67220
0,0,0,-,-,67221
188,188,0,-,351900,67223
8241,4710,3531,996,233000,67226
77,77,0,-,-,67227
741,738,3,-,368500,67228
3877,3623,254,1764,334000,67230
254,254,0,-,421600,67232
4867,4625,242,1294,244400,67235
0,0,0,-,-,67260
5268,3733,1535,727,89900,67301
561,429,132,600,91800,67330
54,47,7,-,78800,67332
1031,784,247,600,83800,67333
29,21,8,-,24200,67334
1309,940,369,704,84100,67335
561,444,117,498,60200,67336
4491,3030,1461,651,65800,67337
152,136,16,-,52500,67340
185,185,0,-,133100,67341
350,307,43,706,113900,67342
257,219,38,800,76300,67344
56,49,7,-,-,67345
129,104,25,688,46800,67346
174,173,1,-,159400,67347
391,310,81,461,68700,67349
154,106,48,637,115300,67351
227,180,47,537,54000,67352
187,156,31,625,61700,67353
242,194,48,517,76000,67354
66,61,5,-,131500,67355
1046,763,283,583,78200,67356
4793,3563,1230,722,85600,67357
161,134,27,-,45600,67360
646,535,111,710,53300,67361
56,56,0,-,87900,67363
105,102,3,-,107300,67364
20683,13461,7222,808,145600,67401
4378,3317,1061,683,133200,67410
373,318,55,833,169000,67416
60,30,30,-,-,67417
62,35,27,-,51700,67418
1652,1111,541,644,97300,67420
511,451,60,813,161800,67422
87,70,17,920,75000,67423
205,171,34,750,127500,67425
179,160,19,667,41300,67427
514,384,130,881,130100,67428
259,194,65,649,79300,67430
809,628,181,763,165000,67431
2525,1734,791,638,109600,67432
218,157,61,771,57900,67436
416,320,96,530,85100,67437
87,74,13,591,80000,67438
1094,845,249,631,131500,67439
349,283,66,688,89400,67441
75,75,0,-,-,67442
748,649,99,675,165300,67443
247,224,23,600,57100,67444
253,236,17,767,39200,67445
286,214,72,409,160700,67446
141,96,45,389,85000,67447
402,368,34,794,113500,67448
1336,971,365,816,69900,67449
241,199,42,583,85000,67450
400,285,115,614,99500,67451
115,115,0,-,83600,67452
334,299,35,648,86800,67454
700,528,172,519,82700,67455
1569,1186,383,736,157900,67456
254,196,58,705,132100,67457
156,121,35,-,163400,67458
131,121,10,-,61900,67459
6943,4794,2149,820,176900,67460
476,411,65,711,97700,67464
309,224,85,667,81200,67466
1118,803,315,600,133900,67467
104,79,25,718,61900,67468
233,161,72,-,157100,67470
822,593,229,556,73800,67473
95,94,1,-,44500,67474
52,46,6,-,-,67475
14,14,0,-,-,67476
43,37,6,-,22700,67478
613,528,85,745,144900,67480
309,272,37,533,86000,67481
42,31,11,-,96100,67482
165,121,44,609,74100,67483
389,346,43,603,105200,67484
180,127,53,382,104700,67485
549,426,123,773,152800,67487
385,318,67,714,82200,67490
126,95,31,694,113800,67491
78,62,16,688,110000,67492
9336,5649,3687,766,72200,67501
9929,7643,2286,869,146600,67502
1376,817,559,544,120000,67505
105,89,16,936,121100,67510
96,90,6,-,96700,67511
102,93,9,-,54000,67512
50,41,9,-,-,67513
342,241,101,726,70100,67514
23,20,3,-,-,67515
199,170,29,434,63100,67516
13,10,3,-,181300,67518
86,72,14,-,322000,67519
119,116,3,-,45500,67520
63,41,22,-,66900,67521
727,564,163,695,126800,67522
149,109,40,1058,58300,67523
241,181,60,600,51700,67524
382,336,46,506,92400,67525
1002,766,236,594,98100,67526
69,55,14,382,32900,67529
7118,4540,2578,695,104100,67530
902,750,152,701,90000,67543
1241,824,417,813,93300,67544
78,72,6,-,-,67545
1022,819,203,833,164200,67546
710,532,178,646,59500,67547
713,482,231,563,79200,67548
2070,1225,845,683,86700,67550
341,291,50,600,61000,67552
32,26,6,967,60000,67553
1750,1237,513,659,78300,67554
82,76,6,-,55000,67556
267,205,62,483,67800,67557
23,21,2,-,-,67559
618,520,98,703,88600,67560
527,378,149,714,74400,67561
134,111,23,533,81700,67563
80,72,8,-,55000,67564
173,157,16,850,78500,67565
477,452,25,923,85100,67566
251,221,30,-,70800,67567
92,80,12,608,126400,67568
505,403,102,695,110400,67570
173,167,6,575,58400,67572
65,63,2,-,-,67573
58,46,12,635,60000,67574
193,166,27,683,76300,67575
717,607,110,613,101800,67576
445,319,126,633,54400,67578
1026,806,220,567,118400,67579
148,140,8,-,68700,67581
421,325,96,568,65500,67583
87,75,12,663,53700,67584
9960,5896,4064,785,180700,67601
121,108,13,475,66700,67621
298,196,102,565,67800,67622
76,61,15,656,23500,67623
132,114,18,466,-,67625
123,97,26,620,108300,67626
35,35,0,-,115300,67627
55,51,4,-,-,67628
53,51,2,-,61300,67629
49,48,1,-,76000,67631
125,85,40,600,82500,67632
83,77,6,525,81700,67634
47,40,7,-,97100,67635
1118,858,260,-,142500,67637
93,67,26,456,-,67638
86,84,2,-,137500,67639
169,123,46,832,86800,67640
818,610,208,638,89000,67642
99,92,7,-,-,67643
89,64,25,-,62700,67644
231,205,26,413,29300,67645
372,277,95,527,65200,67646
67,52,15,563,112500,67647
259,223,36,564,-,67648
119,111,8,233,78300,67649
149,142,7,-,63800,67650
229,175,54,576,37500,67651
131,92,39,709,66000,67653
1262,1011,251,686,97800,67654
72,62,10,-,137500,67656
121,98,23,600,93300,67657
37,31,6,-,-,67658
29,29,0,-,39300,67659
28,22,6,-,-,67660
1328,927,401,598,85700,67661
1016,720,296,658,80500,67663
108,91,17,595,112500,67664
2098,1658,440,712,129200,67665
78,77,1,-,110200,67667
792,607,185,541,76500,67669
674,461,213,840,158800,67671
1099,879,220,612,103200,67672
43,20,23,-,-,67673
27,27,0,-,-,67674
83,80,3,-,34400,67675
2511,1664,847,597,141500,67701
796,517,279,767,109800,67730
334,220,114,549,92200,67731
201,160,41,650,127400,67732
33,19,14,-,135400,67733
109,77,32,1352,137500,67734
2003,1215,788,775,132700,67735
69,54,15,520,42000,67736
244,172,72,594,108800,67737
182,167,15,625,94100,67738
115,100,15,395,39500,67739
689,537,152,620,129500,67740
190,172,18,796,100400,67741
60,60,0,-,-,67743
44,32,12,-,118800,67744
185,131,54,-,-,67745
75,57,18,-,158900,67747
1045,692,353,755,131500,67748
987,732,255,710,64200,67749
105,93,12,-,88600,67751
654,485,169,665,120100,67752
232,178,54,-,96300,67753
890,751,139,666,91200,67756
171,145,26,575,102200,67757
486,339,147,472,84300,67758
96,84,12,550,96000,67761
95,50,45,525,86200,67762
142,121,21,-,72800,67764
10049,6608,3441,838,106800,67801
443,323,120,666,62500,67831
432,333,99,757,85100,67834
948,717,231,690,164900,67835
53,51,2,-,-,67836
414,324,90,600,179200,67837
319,261,58,775,57500,67838
467,367,100,423,78700,67839
37,35,2,-,-,67840
152,134,18,850,75800,67841
191,136,55,665,101800,67842
65,0,65,788,-,67843
304,193,111,727,117800,67844
11810,7635,4175,886,161200,67846
136,114,22,604,67500,67849
194,124,70,495,65800,67850
974,864,110,-,169800,67851
286,241,45,880,145500,67853
486,395,91,865,74300,67854
729,548,181,666,65900,67855
42,10,32,-,158300,67857
255,214,41,793,96500,67859
891,642,249,923,145600,67860
782,586,196,642,90000,67861
111,97,14,-,63400,67862
172,144,28,-,78500,67863
778,547,231,669,125500,67864
412,342,70,813,100700,67865
521,430,91,725,129200,67867
59,44,15,-,206000,67868
577,395,182,678,115500,67869
455,346,109,646,93200,67870
2134,1197,937,772,163300,67871
628,487,141,761,140700,67876
775,637,138,705,122900,67877
702,577,125,871,95300,67878
543,400,143,643,98300,67879
2550,1741,809,623,140400,67880
149,96,53,637,193800,67882
6886,4333,2553,795,109100,67901
616,411,205,656,93400,67950
1595,1054,541,814,108300,67951
176,117,59,935,133000,67952
42,29,13,-,101000,67953
293,206,87,827,71400,67954
16,16,0,-,57500,68001
1008,789,219,792,229700,68002
1963,1460,503,726,214800,68003
444,332,112,758,107700,68004
8917,5049,3868,910,152700,68005
5004,4579,425,1350,302700,68007
4895,3873,1022,810,199800,68008
15,1,14,1125,-,68010
141,102,39,706,122700,68014
462,418,44,911,145700,68015
165,153,12,1167,322300,68016
793,699,94,992,169600,68017
163,147,16,-,166400,68018
195,173,22,779,109600,68019
322,259,63,490,84500,68020
10849,8128,2721,1175,381300,68022
1104,798,306,909,322700,68023
12214,7605,4609,810,156400,68025
5625,4763,862,1149,303900,68028
332,232,100,613,134800,68029
281,218,63,790,140400,68030
634,436,198,775,159100,68031
135,118,17,775,173100,68033
297,243,54,970,185600,68034
211,171,40,843,129300,68036
993,804,189,868,268300,68037
566,426,140,614,95800,68038
268,81,187,730,56100,68039
142,111,31,-,183000,68040
427,360,67,928,176000,68041
24,24,0,-,116700,68042
255,226,29,859,101800,68044
774,593,181,612,134600,68045
11159,8409,2750,1031,256000,68046
690,546,144,759,138000,68047
5117,4137,980,880,201400,68048
231,208,23,717,111500,68050
100,71,29,725,60800,68055
0,0,0,-,-,68056
595,469,126,753,108600,68057
114,103,11,933,326900,68058
1345,1199,146,972,266700,68059
908,714,194,672,120700,68061
113,92,21,675,150000,68062
102,75,27,955,87700,68063
1764,1262,502,858,285100,68064
507,461,46,775,213700,68065
2093,1440,653,848,169200,68066
308,195,113,624,44300,68067
71,71,0,-,149100,68068
1304,1135,169,800,270400,68069
395,374,21,886,180400,68070
574,280,294,628,72100,68071
82,79,3,-,159700,68072
863,752,111,865,196600,68073
4840,710,4130,1151,310500,68102
15502,9161,6341,876,119700,68104
9863,4254,5609,884,137700,68105
10117,5967,4150,1106,158600,68106
9195,5939,3256,901,103800,68107
5400,2604,2796,1009,102500,68108
3163,1492,1671,809,81400,68110
8490,3400,5090,958,70100,68111
4330,3018,1312,1087,113400,68112
232,0,232,1305,-,68113
8054,4074,3980,1095,205400,68114
12354,9791,2563,1213,249900,68116
3082,2303,779,1151,126000,68117
3414,2809,605,1420,294500,68118
4380,3589,791,1181,183100,68122
11956,6792,5164,1276,219100,68123
6590,4117,2473,1060,229100,68124
9666,4321,5345,901,177300,68127
7812,4494,3318,1094,213100,68128
7980,6236,1744,1444,310000,68130
6109,1564,4545,958,157000,68131
6063,3371,2692,864,262500,68132
5069,3964,1105,1209,292600,68133
12782,6942,5840,931,160000,68134
10315,9313,1002,1476,261500,68135
6573,5797,776,1405,269600,68136
10337,6799,3538,1164,172800,68137
4592,3473,1119,974,170800,68138
1932,1842,90,1388,236500,68142
10564,7479,3085,950,200700,68144
4287,3409,878,993,158600,68147
2794,2144,650,1029,226500,68152
9918,5944,3974,1012,242200,68154
2047,1401,646,1143,167500,68157
12077,7763,4314,1129,189600,68164
180,0,180,858,-,68178
0,0,0,-,-,68182
0,0,0,-,-,68183
646,550,96,855,265700,68301
126,111,15,450,77500,68303
122,116,6,700,265200,68304
1731,1244,487,585,93700,68305
156,128,28,786,175000,68307
47,42,5,-,37500,68309
6160,3973,2187,639,130000,68310
262,217,45,1318,130500,68313
146,136,10,-,121200,68314
34,21,13,-,-,68315
206,177,29,625,102000,68316
767,716,51,1068,225900,68317
172,136,36,949,58000,68318
207,154,53,824,142900,68319
163,99,64,623,96400,68320
154,139,15,-,218800,68321
165,124,41,352,104200,68322
103,72,31,1021,-,68323
27,27,0,-,104200,68324
58,47,11,579,49000,68325
116,97,19,-,134700,68326
170,152,18,766,72900,68327
161,145,16,-,143300,68328
228,188,40,391,75300,68329
20,20,0,-,65000,68330
369,314,55,1208,169700,68331
46,43,3,-,36300,68332
3002,2081,921,736,115000,68333
215,174,41,757,70700,68335
263,221,42,947,339500,68336
156,141,15,588,74600,68337
106,91,15,463,83800,68338
457,424,33,449,330000,68339
354,264,90,625,69500,68340
398,317,81,783,133900,68341
280,192,88,484,111800,68342
375,307,68,548,122900,68343
201,182,19,936,202600,68344
82,68,14,840,94000,68345
198,165,33,722,130100,68346
896,875,21,690,209500,68347
120,105,15,345,127300,68348
465,421,44,838,186900,68349
100,90,10,-,67000,68350
364,288,76,578,85300,68351
2071,1282,789,664,102300,68352
442,364,78,590,64900,68354
2285,1658,627,655,79000,68355
147,133,14,-,136700,68357
512,467,45,832,297100,68358
604,500,104,717,153900,68359
206,186,20,1302,178600,68360
893,696,197,595,120900,68361
15,12,3,-,40000,68362
114,111,3,-,155100,68364
114,108,6,-,137500,68365
328,300,28,930,156700,68366
148,118,30,638,62400,68367
177,166,11,864,277800,68368
794,558,236,678,93600,68370
542,435,107,786,130400,68371
1322,1205,117,1343,265400,68372
72,64,8,-,-,68375
579,420,159,576,71200,68376
194,162,32,-,110700,68377
251,240,11,538,122200,68378
33,33,0,-,110400,68379
22,22,0,-,37900,68380
55,44,11,-,63000,68381
19,8,11,-,95000,68382
356,322,34,775,129200,68401
405,340,65,892,292900,68402
103,89,14,741,145800,68403
439,413,26,-,223400,68404
1269,824,445,802,183500,68405
191,169,22,675,112000,68406
339,290,49,930,305900,68407
294,238,56,1016,168500,68409
3367,2342,1025,818,140500,68410
193,164,29,-,205000,68413
104,63,41,738,70400,68414
229,207,22,650,111900,68415
97,76,21,288,86200,68416
117,97,20,1063,36300,68417
451,398,53,1023,170900,68418
103,86,17,763,162500,68419
496,422,74,520,64100,68420
340,252,88,456,103500,68421
259,208,51,1014,228900,68422
423,371,52,930,189100,68423
303,253,50,843,104600,68424
498,459,39,1702,370100,68428
43,33,10,619,85000,68429
695,650,45,794,382500,68430
109,109,0,-,69600,68431
79,52,27,-,42200,68433
3222,2169,1053,798,197300,68434
237,202,35,763,125000,68436
156,134,22,-,81400,68437
58,51,7,975,143800,68438
287,271,16,689,107100,68439
54,45,9,-,-,68440
76,58,18,-,-,68441
124,90,34,-,104500,68442
397,331,66,714,122700,68443
17,12,5,-,-,68444
66,41,25,-,-,68445
1184,887,297,674,163700,68446
251,213,38,675,-,68447
149,130,19,1067,105000,68448
925,558,367,764,121100,68450
37,31,6,-,-,68452
131,100,31,-,89300,68453
279,215,64,975,154800,68454
267,201,66,1347,268100,68455
510,376,134,814,153200,68456
197,172,25,679,71200,68457
77,74,3,-,95000,68458
256,220,36,725,150000,68460
315,301,14,-,375000,68461
1609,1299,310,918,221600,68462
580,429,151,765,158600,68463
248,228,20,610,73300,68464
877,622,255,736,161300,68465
678,517,161,642,62100,68466
3819,2716,1103,825,146000,68467
11476,6029,5447,744,169800,68502
6311,2284,4027,803,121800,68503
7843,2676,5167,880,136900,68504
7264,4189,3075,1002,174500,68505
12703,8047,4656,969,194000,68506
6511,4500,2011,880,161900,68507
5580,536,5044,684,79300,68508
9128,5389,3739,783,175700,68510
5630,3683,1947,1122,246500,68512
119,119,0,-,339200,68514
18258,12534,5724,1067,270100,68516
201,182,19,-,345800,68517
766,658,108,1417,384500,68520
14582,8237,6345,1032,183000,68521
4275,3112,1163,1123,172700,68522
670,636,34,-,402700,68523
2102,1270,832,846,168300,68524
2860,2352,508,1208,359100,68526
606,606,0,-,415300,68527
2458,1542,916,1089,176500,68528
75,68,7,-,429400,68531
215,215,0,-,382900,68532
0,0,0,-,-,68588
11640,8333,3307,810,163600,68601
1169,868,301,608,178600,68620
122,106,16,-,159600,68621
131,97,34,467,143800,68622
170,145,25,665,34600,68623
360,323,37,688,121200,68624
246,202,44,768,136000,68626
264,238,26,620,101300,68627
324,266,58,783,126900,68628
484,427,57,488,76100,68629
139,113,26,807,153800,68631
1552,1115,437,679,140400,68632
490,386,104,705,129700,68633
267,261,6,-,133000,68634
223,161,62,682,151600,68635
566,434,132,660,89600,68636
157,122,35,586,84400,68637
690,569,121,618,92800,68638
440,383,57,829,120100,68640
490,429,61,529,94600,68641
713,650,63,800,239400,68642
392,346,46,625,111300,68643
287,205,82,743,121300,68644
302,274,28,857,148900,68647
138,82,56,-,132800,68648
813,632,181,738,163600,68649
459,377,82,611,120300,68651
296,248,48,679,116700,68652
260,246,14,1063,117600,68653
227,181,46,809,76600,68654
38,35,3,-,153400,68655
278,251,27,815,129900,68658
80,68,12,940,188900,68659
454,358,96,625,112800,68660
2211,1567,644,773,95400,68661
453,404,49,645,134100,68662
419,359,60,725,148700,68663
112,94,18,939,82900,68664
288,249,39,737,79500,68665
567,449,118,586,126200,68666
53,48,5,-,197500,68667
209,184,25,619,106300,68669
12624,8420,4204,764,167100,68701
290,231,59,509,112000,68710
44,23,21,-,-,68711
946,718,228,657,156800,68713
496,385,111,565,87500,68714
611,538,73,830,173600,68715
407,253,154,733,88300,68716
107,82,25,625,104500,68717
779,541,238,639,101400,68718
80,75,5,-,156500,68719
108,89,19,950,80800,68720
190,155,35,443,58300,68722
251,234,17,765,126300,68723
75,60,15,725,106300,68724
252,220,32,588,77900,68725
259,154,105,762,69200,68726
246,174,72,519,97800,68727
93,84,9,-,90000,68728
718,541,177,688,117700,68729
795,672,123,475,158200,68730
1010,833,177,948,144700,68731
102,97,5,-,129200,68732
424,298,126,613,114500,68733
47,18,29,-,-,68734
362,269,93,642,76100,68735
272,219,53,-,-,68736
1081,962,119,619,154300,68739
327,283,44,990,201000,68740
271,209,62,1090,175600,68741
93,80,13,688,160000,68742
195,160,35,925,165600,68743
606,478,128,704,121400,68745
184,166,18,550,59300,68746
56,48,8,-,-,68747
839,637,202,733,110500,68748
24,21,3,-,31300,68749
25,21,4,-,52500,68751
303,268,35,568,117700,68752
33,25,8,-,143800,68753
149,116,33,-,106400,68755
749,533,216,700,103800,68756
309,261,48,661,88200,68757
484,346,138,645,87900,68758
117,102,15,-,-,68759
467,306,161,463,78800,68760
181,157,24,779,46400,68761
1814,1216,598,747,142900,68763
309,244,65,438,82700,68764
463,380,83,593,132300,68765
151,116,35,620,95200,68766
1362,1074,288,729,208500,68767
266,168,98,616,156300,68768
713,502,211,792,101000,68769
625,457,168,631,107700,68770
561,408,153,771,122800,68771
88,68,20,621,203100,68773
118,106,12,-,186400,68774
5300,3187,2113,898,130500,68776
249,193,56,650,98600,68777
232,187,45,675,85700,68778
856,606,250,673,127300,68779
346,240,106,731,125000,68780
589,470,119,575,111600,68781
330,261,69,463,87500,68783
609,439,170,722,94900,68784
95,84,11,788,173300,68785
347,310,37,664,83500,68786
2557,1686,871,745,148900,68787
1875,1288,587,791,148300,68788
34,34,0,-,-,68789
391,324,67,647,152400,68790
762,545,217,703,118200,68791
182,170,12,825,93300,68792
10900,6464,4436,813,139600,68801
10484,6753,3731,806,177900,68803
339,273,66,853,109300,68810
209,178,31,733,183300,68812
175,113,62,545,83500,68813
396,272,124,985,86800,68814
285,227,58,517,154200,68815
73,69,4,-,123900,68816
171,145,26,719,72100,68817
2203,1661,542,793,190700,68818
136,112,24,-,100000,68820
43,34,9,613,161400,68821
2021,1373,648,714,119900,68822
915,734,181,448,121800,68823
615,429,186,751,159800,68824
428,337,91,528,160000,68825
1446,1025,421,691,154300,68826
251,186,65,800,136400,68827
105,85,20,1406,100700,68828
283,209,74,950,150700,68831
839,697,142,1026,225600,68832
76,59,17,-,101800,68833
87,78,9,575,78300,68834
256,187,69,700,100400,68835
660,506,154,806,153800,68836
41,37,4,-,270800,68837
109,102,7,-,225000,68838
1134,856,278,914,147900,68840
224,185,39,697,165300,68841
241,174,67,694,75000,68842
292,245,47,785,152400,68843
107,101,6,-,213500,68844
8128,4918,3210,859,223800,68845
111,94,17,571,75300,68846
7121,4740,2381,840,183500,68847
0,0,0,-,-,68849
3927,2309,1618,853,133600,68850
224,174,50,619,95000,68852
640,427,213,694,99300,68853
283,255,28,850,166200,68854
146,106,40,622,165000,68855
271,165,106,817,146900,68856
140,106,34,650,137500,68858
237,194,43,381,68600,68859
128,107,21,427,63000,68860
51,51,0,-,101400,68861
1211,906,305,538,130200,68862
551,333,218,534,106800,68863
418,360,58,763,116700,68864
371,320,51,698,250000,68865
420,327,93,543,188800,68866
922,619,303,721,115400,68869
214,178,36,790,168200,68870
109,100,9,-,115600,68871
357,302,55,1182,171300,68872
1331,982,349,739,173400,68873
309,231,78,904,62600,68874
226,197,29,523,82100,68875
691,517,174,744,124300,68876
178,121,57,706,97200,68878
155,110,45,663,70000,68879
23,23,0,-,-,68881
198,144,54,728,56800,68882
935,757,178,787,141500,68883
10708,6956,3752,752,137300,68901
607,505,102,639,141400,68920
465,369,96,779,87200,68922
33,33,0,-,150800,68923
560,467,93,1040,201300,68924
198,177,21,768,189700,68925
230,184,46,546,59300,68926
505,417,88,719,157400,68927
143,136,7,-,61100,68928
77,69,8,-,48500,68929
570,452,118,621,150300,68930
140,126,14,756,57000,68932
377,327,50,561,110000,68933
69,46,23,-,-,68934
275,164,111,480,85700,68935
101,78,23,641,31400,68936
797,650,147,730,244700,68937
233,198,35,644,133300,68938
442,349,93,431,82900,68939
162,146,16,729,210000,68940
330,273,57,668,175900,68941
134,122,12,763,55700,68942
95,82,13,535,-,68943
496,367,129,606,96600,68944
99,56,43,775,210000,68945
23,23,0,-,29400,68946
269,244,25,594,105000,68947
174,130,44,739,65600,68948
2870,2026,844,673,139800,68949
122,98,24,575,105100,68950
33,22,11,-,53300,68952
7,7,0,-,-,68954
780,715,65,763,212900,68955
479,389,90,788,146000,68956
220,206,14,532,79300,68957
226,183,43,686,157600,68958
1563,1203,360,697,169800,68959
84,75,9,-,45000,68960
286,240,46,-,100700,68961
23,23,0,-,-,68964
206,172,34,425,59200,68966
444,330,114,817,109400,68967
604,499,105,563,64100,68970
150,121,29,1077,118800,68971
89,59,30,-,86800,68972
175,143,32,707,119800,68973
112,111,1,-,80200,68974
43,43,0,-,-,68975
72,57,15,863,106900,68976
89,71,18,577,49200,68977
994,767,227,552,70300,68978
719,613,106,766,139100,68979
161,126,35,900,172900,68980
104,81,23,-,90800,68981
249,162,87,800,133300,68982
3702,2515,1187,680,135100,69001
180,140,40,831,74700,69020
598,444,154,467,107500,69021
740,611,129,769,87000,69022
137,112,25,-,225800,69023
449,325,124,877,88100,69024
386,246,140,429,136900,69025
71,49,22,-,187500,69026
16,11,5,-,-,69027
318,244,74,700,141000,69028
152,124,28,430,90000,69029
88,65,23,770,61700,69030
179,131,48,-,95400,69032
1038,814,224,697,177000,69033
325,268,57,675,87500,69034
26,17,9,538,25800,69036
81,81,0,-,-,69037
201,139,62,598,83400,69038
50,26,24,-,228600,69039
266,218,48,646,59300,69040
28,21,7,-,-,69041
1,1,0,-,-,69042
215,185,30,569,58500,69043
283,178,105,569,78800,69044
403,273,130,617,75900,69045
104,95,9,-,214100,69046
11901,7882,4019,818,156200,69101
452,337,115,663,104600,69120
128,95,33,775,114600,69121
282,209,73,750,85000,69122
340,289,51,716,145700,69123
118,71,47,810,62900,69125
334,282,52,575,124600,69127
161,102,59,1086,74300,69128
553,474,79,627,89100,69129
2133,1469,664,755,98400,69130
331,260,71,1076,90000,69131
41,21,20,-,157500,69132
174,155,19,917,86700,69133
158,134,24,520,119200,69134
4,4,0,-,-,69135
1650,1223,427,771,121800,69138
691,536,155,799,130200,69140
193,158,35,788,85000,69141
51,30,21,395,137500,69142
681,593,88,754,160600,69143
55,40,15,-,272200,69144
1158,790,368,768,78800,69145
171,143,28,-,158500,69146
243,212,31,660,105100,69147
71,28,43,346,-,69148
301,249,52,750,89000,69149
153,139,14,850,163800,69150
344,291,53,733,187100,69151
329,198,131,556,97400,69152
2786,2078,708,668,132300,69153
516,433,83,758,77800,69154
397,302,95,702,115100,69155
282,246,36,694,94800,69156
54,44,10,-,57500,69157
44,36,8,-,242900,69161
3244,1898,1346,820,106600,69162
358,276,82,641,117100,69163
701,552,149,805,156800,69165
260,135,125,617,110400,69166
154,111,43,559,105200,69167
77,68,9,850,62200,69168
235,136,99,483,92200,69169
116,85,31,675,107500,69170
0,0,0,-,-,69171
1510,870,640,724,139900,69201
925,741,184,630,91000,69210
159,103,56,580,95800,69211
157,47,110,347,72100,69212
85,45,40,-,154500,69214
91,53,38,678,69400,69216
161,157,4,-,46200,69217
164,117,47,-,104700,69218
22,20,2,-,275000,69219
17,9,8,-,-,69220
39,20,19,-,-,69221
4096,3066,1030,713,134600,69301
30,22,8,-,-,69331
77,59,18,-,-,69333
846,743,103,668,109300,69334
19,16,3,-,-,69335
934,686,248,714,102200,69336
2670,1574,1096,759,141100,69337
555,443,112,826,67700,69339
20,14,6,-,-,69340
4245,3160,1085,788,146800,69341
974,610,364,666,78000,69343
152,96,56,983,187500,69345
206,136,70,886,74000,69346
552,427,125,705,98700,69347
516,384,132,727,106300,69348
177,119,58,625,89200,69350
73,49,24,-,115600,69351
276,206,70,690,61400,69352
32,27,5,-,49500,69353
63,32,31,-,109400,69354
61,50,11,825,36700,69355
716,557,159,466,126000,69356
1507,1182,325,804,137300,69357
940,692,248,528,139700,69358
529,338,191,834,73400,69360
7170,4450,2720,843,137200,69361
0,0,0,-,-,69365
110,82,28,-,164300,69366
112,104,8,463,132700,69367
17834,9091,8743,994,259600,70001
8463,4432,4031,1000,339100,70002
16232,12659,3573,984,214700,70003
11479,7630,3849,1047,330700,70005
5814,3637,2177,1061,278500,70006
1399,1250,149,1374,177200,70030
514,462,52,-,157800,70031
1703,1200,503,877,176800,70032
335,326,9,-,158800,70036
5615,3622,1993,1436,280000,70037
13,13,0,-,-,70038
806,583,223,1098,205100,70039
567,522,45,-,103200,70040
1062,929,133,845,64300,70041
7795,4659,3136,972,164000,70043
4784,3797,987,1141,264900,70047
507,494,13,-,129900,70049
14,0,14,-,-,70050
602,542,60,-,125500,70051
1056,886,170,897,190900,70052
7432,3502,3930,919,183700,70053
14112,8136,5976,1049,185500,70056
1471,1183,288,618,189700,70057
14652,9481,5171,1087,162500,70058
6152,3165,2987,957,154300,70062
20207,12658,7549,999,209100,70065
1003,878,125,870,182300,70067
11970,9592,2378,982,165600,70068
4975,4181,794,1307,217400,70070
1123,916,207,-,163300,70071
20586,15243,5343,1037,160200,70072
1721,1583,138,748,183800,70075
49,49,0,-,159700,70076
1128,745,383,1148,188400,70079
339,290,49,-,154900,70080
110,96,14,-,33000,70082
753,622,131,874,91800,70083
2220,1873,347,901,122700,70084
1569,1315,254,1073,128600,70085
714,511,203,588,109600,70086
2650,2008,642,760,161500,70087
2797,2127,670,618,150300,70090
81,58,23,-,-,70091
2508,2018,490,962,140000,70092
11995,7383,4612,1052,115200,70094
2205,219,1986,985,436200,70112
3748,760,2988,819,184300,70113
9622,4198,5424,962,165900,70114
14437,7867,6570,1242,504900,70115
5730,2250,3480,1111,338600,70116
12145,5655,6490,1041,216600,70117
12880,6379,6501,1090,366800,70118
16864,6045,10819,1150,293400,70119
5625,3179,2446,994,206000,70121
14939,8306,6633,1058,231200,70122
12619,7614,5005,1183,268800,70123
7867,5618,2249,1556,481700,70124
6515,2794,3721,1129,359100,70125
10691,4929,5762,1042,161200,70126
9714,4292,5422,951,162300,70127
7917,4864,3053,1091,187700,70128
3067,2109,958,1061,152600,70129
7268,2542,4726,1256,488300,70130
10847,6401,4446,1005,196800,70131
0,0,0,-,-,70139
130,0,130,640,-,70148
0,0,0,-,-,70163
17614,13298,4316,881,183300,70301
0,0,0,-,-,70310
2119,1858,261,738,135300,70339
46,46,0,-,-,70340
1458,1079,379,968,100700,70341
1775,1389,386,674,147600,70342
1839,1624,215,-,170900,70343
2138,1755,383,757,88500,70344
3661,2813,848,765,156100,70345
3720,2422,1298,711,161900,70346
116,72,44,-,-,70352
346,325,21,-,-,70353
1761,1361,400,1005,103800,70354
422,396,26,-,127900,70355
730,515,215,655,93400,70356
1088,809,279,477,113200,70357
414,254,160,1096,219700,70358
3598,2925,673,931,137100,70359
11213,8064,3149,958,252700,70360
9433,6628,2805,896,126000,70363
10680,7451,3229,916,167800,70364
954,844,110,988,91000,70372
2368,1809,559,678,130700,70373
2494,1893,601,780,140800,70374
51,51,0,-,230400,70375
1353,1092,261,681,95400,70377
8251,5290,2961,824,122300,70380
2628,1865,763,707,108400,70390
92,38,54,-,-,70391
2909,1920,989,745,126600,70392
38,38,0,-,-,70393
5620,4457,1163,668,160900,70394
1641,1333,308,748,155100,70395
323,276,47,-,136900,70397
7632,3695,3937,847,179400,70401
0,0,0,-,-,70402
11266,7615,3651,905,169100,70403
2933,2364,569,974,237200,70420
4787,3275,1512,682,146000,70422
2140,1485,655,395,96700,70426
6910,4047,2863,722,103300,70427
2028,1955,73,1514,232200,70431
15989,11388,4601,1212,277200,70433
7525,6688,837,1136,236000,70435
175,152,23,-,272100,70436
3057,2819,238,773,251300,70437
7698,5703,1995,677,128900,70438
2187,1601,586,678,59200,70441
109,109,0,-,206400,70442
2724,2109,615,848,100900,70443
3835,3034,801,794,157700,70444
3977,3352,625,963,189800,70445
2354,2146,208,1102,166700,70446
5557,5203,354,2240,314000,70447
9590,7658,1932,1406,278100,70448
1233,1091,142,797,222000,70449
1117,831,286,-,137500,70450
79,0,79,-,-,70451
4788,4131,657,755,178600,70452
318,290,28,-,-,70453
12167,9912,2255,990,181600,70454
699,699,0,-,172400,70455
946,835,111,642,103700,70456
0,0,0,-,-,70457
15246,10887,4359,1246,183000,70458
7896,6039,1857,1111,151500,70460
11795,8750,3045,984,224000,70461
1969,1763,206,781,176200,70462
57,37,20,673,-,70463
68,48,20,-,-,70464
152,111,41,717,24000,70465
3453,2384,1069,649,159500,70466
8630,6582,2048,1154,316200,70471
11037,4910,6127,842,103600,70501
11730,8095,3635,1083,265400,70503
17938,9497,8441,888,182300,70506
6964,4944,2020,873,178600,70507
16263,10392,5871,1086,254400,70508
9606,6815,2791,688,134800,70510
3801,2981,820,480,109500,70512
68,26,42,-,-,70513
751,350,401,836,109300,70514
1080,806,274,585,94800,70515
388,345,43,-,96600,70516
9638,7338,2300,838,131500,70517
5733,4566,1167,906,235100,70518
67,67,0,-,-,70519
7765,6369,1396,762,172200,70520
74,74,0,-,-,70522
217,148,69,843,106900,70523
114,62,52,567,75000,70524
5222,3792,1430,722,121900,70525
6737,4085,2652,595,126200,70526
900,723,177,758,106000,70528
5520,4357,1163,725,159100,70529
770,643,127,-,187100,70531
1088,817,271,403,84700,70532
2565,2014,551,715,128600,70533
214,139,75,555,85700,70534
6356,4042,2314,704,151500,70535
174,139,35,-,-,70537
4887,3451,1436,776,92000,70538
387,123,264,579,120800,70541
1186,1024,162,590,104900,70542
1498,1171,327,566,150100,70543
3865,2958,907,721,96400,70544
6126,4221,1905,706,136800,70546
3548,2750,798,659,99600,70548
1215,841,374,657,99600,70549
0,0,0,-,-,70550
197,180,17,-,-,70551
367,234,133,790,97100,70552
2084,1313,771,468,84800,70554
2867,2367,500,912,204300,70555
358,291,67,471,46200,70556
24,0,24,-,-,70558
897,597,300,434,96100,70559
14261,8192,6069,787,112400,70560
7852,6151,1701,998,171600,70563
14304,10003,4301,686,134800,70570
0,0,0,-,-,70575
351,206,145,678,132100,70576
1570,1180,390,616,111100,70577
6200,4782,1418,738,138700,70578
85,38,47,-,-,70580
267,210,57,-,176700,70581
7609,5948,1661,656,121200,70582
3926,2908,1018,805,108600,70583
2473,1927,546,720,150600,70584
123,98,25,519,58900,70585
7333,4672,2661,639,98400,70586
1120,833,287,537,139900,70589
1658,1435,223,789,155500,70591
9161,7975,1186,1142,206100,70592
13469,7516,5953,785,136200,70601
15508,11677,3831,1203,249600,70605
10538,6220,4318,874,149200,70607
0,0,0,-,-,70609
7700,6373,1327,1029,210600,70611
4418,2494,1924,890,116700,70615
0,0,0,-,-,70629
668,615,53,-,167000,70630
126,126,0,-,-,70631
199,199,0,-,152700,70632
2344,1915,429,643,167800,70633
9727,7472,2255,810,146600,70634
388,337,51,-,-,70637
277,194,83,992,98800,70638
126,120,6,-,103100,70639
116,83,33,529,86100,70640
123,90,33,-,-,70643
221,207,14,-,-,70644
353,315,38,-,210800,70645
114,62,52,-,152900,70646
3772,3101,671,935,216900,70647
2550,1912,638,633,134800,70648
66,10,56,-,-,70650
62,39,23,-,-,70651
551,470,81,-,101300,70652
1320,1126,194,416,86300,70653
36,36,0,-,-,70654
945,754,191,661,83800,70655
1250,1070,180,1021,57900,70656
1744,1652,92,-,173700,70657
239,216,23,635,80500,70658
529,316,213,731,141700,70659
652,542,110,-,-,70660
572,471,101,354,71600,70661
126,114,12,-,-,70662
10891,8243,2648,850,153800,70663
4203,3608,595,1361,174300,70665
2188,1614,574,813,115800,70668
3573,3012,561,865,137600,70669
7349,6324,1025,1106,195400,70706
2228,1820,408,896,209700,70710
1815,1452,363,738,209600,70711
131,17,114,867,"10,000-",70712
6369,4868,1501,980,136500,70714
401,366,35,525,60400,70715
1340,1118,222,1053,214300,70719
212,175,37,659,178900,70721
2075,1673,402,534,142900,70722
398,338,60,1104,140400,70723
616,578,38,-,-,70725
20141,15425,4716,1066,182200,70726
241,224,17,-,248300,70729
1309,1169,140,810,248300,70730
413,364,49,957,170800,70732
480,356,124,928,182900,70733
2954,2320,634,1042,278900,70734
215,204,11,-,94400,70736
17603,13442,4161,1243,209700,70737
4710,4454,256,1584,265800,70739
403,292,111,-,114000,70740
190,190,0,-,172600,70743
1924,1810,114,1012,136800,70744
172,50,122,-,-,70747
1682,1221,461,625,159100,70748
613,422,191,775,195500,70749
540,404,136,548,68600,70750
263,211,52,-,142700,70752
270,247,23,-,72500,70753
4484,3552,932,1072,143500,70754
604,505,99,654,151600,70755
188,158,30,-,-,70756
1240,898,342,581,113100,70757
622,525,97,1061,139900,70759
2621,1781,840,821,140400,70760
240,188,52,1054,147100,70761
294,267,27,-,208100,70762
1658,1491,167,650,258100,70763
5923,4653,1270,885,153200,70764
5984,4246,1738,932,168800,70767
16270,14818,1452,1109,252700,70769
1387,1206,181,981,197800,70770
411,401,10,-,85800,70772
73,16,57,-,-,70773
3589,3091,498,1039,222800,70774
3560,2661,899,925,214400,70775
1403,904,499,897,247900,70776
1583,1226,357,928,165000,70777
1181,1061,120,958,231500,70778
403,356,47,-,-,70780
48,32,16,-,280400,70782
956,822,134,1281,289400,70783
7731,6693,1038,993,195400,70785
0,0,0,-,-,70786
113,64,49,-,-,70787
1486,863,623,641,151400,70788
323,261,62,328,111200,70789
10815,8859,1956,1118,238400,70791
189,0,189,1582,-,70801
10088,3392,6696,834,82400,70802
0,0,0,-,-,70803
8955,4040,4915,768,80400,70805
12499,5598,6901,916,268100,70806
5348,2466,2882,770,90200,70807
15472,8292,7180,1139,332500,70808
11832,6485,5347,1188,268000,70809
16214,11634,4580,1188,314400,70810
4615,2834,1781,918,132800,70811
3697,2672,1025,1085,118700,70812
0,0,0,-,-,70813
4360,2964,1396,959,160000,70814
10540,6919,3621,911,185100,70815
17452,9089,8363,1034,194100,70816
13399,10762,2637,1167,246000,70817
3324,2732,592,996,214700,70818
1335,1123,212,826,143500,70819
7816,2381,5435,887,263400,70820
0,0,0,-,-,70825
241,0,241,1272,-,70836
1756,1193,563,667,78800,71001
92,69,23,-,89500,71002
437,345,92,863,66600,71003
202,150,52,1000,157400,71004
5403,4803,600,1105,273200,71006
527,481,46,-,-,71007
207,153,54,619,54300,71008
44,44,0,-,63900,71009
626,491,135,-,70800,71016
470,344,126,325,48200,71018
2672,1961,711,616,85300,71019
264,163,101,275,46000,71021
1255,1100,155,861,77600,71023
497,453,44,471,88300,71024
524,378,146,1078,-,71027
555,423,132,456,79200,71028
63,56,7,-,86000,71029
394,382,12,-,165900,71030
311,245,66,489,76300,71031
883,743,140,1027,159400,71032
1642,1471,171,535,144400,71033
105,93,12,-,75900,71034
7622,6299,1323,963,164600,71037
1651,1102,549,444,74900,71038
593,513,80,846,71800,71039
2274,1533,741,662,69500,71040
184,170,14,381,67100,71043
307,264,43,650,100000,71044
240,182,58,345,120800,71045
372,321,51,-,98900,71046
3849,3370,479,825,123600,71047
84,73,11,-,53200,71048
1363,1003,360,657,75800,71049
996,858,138,1811,71300,71051
3603,2140,1463,580,78500,71052
7359,4360,2999,740,105900,71055
1049,851,198,921,98800,71060
716,405,311,705,108300,71061
309,247,62,-,48800,71063
1249,1029,220,600,72300,71064
402,287,115,500,70400,71065
13,5,8,-,"10,000-",71066
1089,626,463,655,83900,71067
1569,1209,360,347,67400,71068
235,145,90,619,66900,71069
454,365,89,573,73700,71070
946,706,240,383,79600,71071
605,530,75,487,68500,71072
906,638,268,692,125000,71073
2330,1223,1107,670,80100,71075
2621,2227,394,983,221200,71078
35,29,6,-,-,71079
1922,1373,549,720,65500,71082
3338,915,2423,668,78000,71101
2225,953,1272,786,81600,71103
5768,2747,3021,937,145800,71104
9643,5105,4538,1080,187500,71105
12373,8012,4361,750,273600,71106
12007,7585,4422,833,135000,71107
7093,3179,3914,923,78400,71108
7149,3149,4000,783,76400,71109
1042,0,1042,1512,-,71110
16339,9391,6948,937,219700,71111
12362,7736,4626,1026,156000,71112
6568,4007,2561,995,203800,71115
8920,5493,3427,868,144400,71118
4500,3321,1179,958,170100,71119
5654,3353,2301,827,158300,71129
8900,4872,4028,798,213100,71201
8838,4078,4760,721,67900,71202
14326,7817,6509,895,154000,71203
0,0,0,-,-,71209
0,0,0,-,-,71212
0,0,0,-,-,71218
388,309,79,1105,79600,71219
7421,4966,2455,632,85300,71220
1144,790,354,536,85700,71222
147,86,61,629,46200,71223
2721,2348,373,788,217400,71225
721,496,225,581,68900,71226
1553,1209,344,835,140500,71227
540,431,109,460,136800,71229
0,0,0,-,-,71230
2166,1397,769,716,102700,71232
56,30,26,-,-,71233
1310,1236,74,1053,129800,71234
1691,1221,470,807,115900,71235
420,278,142,894,91100,71237
929,799,130,798,121000,71238
2998,2435,563,644,106900,71241
6,0,6,-,-,71242
68,68,0,-,147700,71243
1644,697,947,692,112400,71245
470,300,170,688,64000,71247
22,17,5,-,-,71250
2634,1574,1060,583,83500,71251
198,136,62,585,-,71253
2040,1137,903,599,73200,71254
275,234,41,425,48800,71256
769,651,118,826,110600,71259
1144,934,210,419,72800,71260
636,435,201,-,73600,71261
2521,2053,468,605,87000,71263
456,364,92,-,120700,71264
600,466,134,721,88300,71266
1070,954,116,513,120700,71268
4261,2598,1663,691,109200,71269
11984,5733,6251,757,185300,71270
0,0,0,-,-,71272
1252,854,398,713,78200,71275
26,20,6,-,83300,71276
665,461,204,1281,69700,71277
56,0,56,-,-,71279
1704,1201,503,1008,218200,71280
2826,1662,1164,653,83400,71282
131,131,0,-,74200,71286
13793,9183,4610,869,180200,71291
7899,5390,2509,750,105300,71292
5062,3674,1388,663,82300,71295
7572,3594,3978,833,141800,71301
5171,3074,2097,773,88400,71302
8709,5069,3640,989,199700,71303
29,29,0,-,-,71316
79,71,8,-,-,71320
2209,1339,870,776,88400,71322
312,275,37,-,147900,71323
655,465,190,606,88500,71325
305,249,56,550,63100,71326
1344,981,363,678,109200,71327
2886,2606,280,981,150500,71328
29,29,0,-,-,71330
395,368,27,-,144900,71331
239,189,50,710,-,71333
3032,2136,896,728,75800,71334
653,496,157,573,97900,71336
7,7,0,-,-,71339
391,321,70,535,103200,71340
1077,689,388,845,110800,71341
2467,2052,415,820,116800,71342
2391,1886,505,675,86300,71343
55,0,55,-,-,71345
878,658,220,629,143100,71346
1565,1138,427,639,119300,71350
4578,3062,1516,702,106000,71351
597,524,73,400,107400,71353
469,441,28,-,110000,71354
987,809,178,575,110000,71355
236,191,45,-,90200,71356
596,400,196,492,68300,71357
449,304,145,719,89500,71358
0,0,0,-,-,71359
13519,8811,4708,804,168600,71360
774,568,206,-,104000,71362
640,464,176,608,94700,71366
647,549,98,579,140800,71367
426,291,135,534,-,71368
935,682,253,425,74700,71369
682,600,82,-,121700,71371
2217,1571,646,831,110300,71373
266,166,100,508,73900,71375
866,581,285,615,103400,71378
17,17,0,-,-,71401
1494,1199,295,1079,147900,71403
223,164,59,-,71700,71404
2067,1703,364,845,159100,71405
29,13,16,-,-,71406
375,339,36,-,406900,71407
1986,1403,583,795,122700,71409
25,18,7,-,-,71410
1312,617,695,541,102500,71411
98,19,79,822,81000,71414
122,66,56,678,-,71415
313,151,162,625,84100,71416
1790,1260,530,697,89400,71417
1911,1259,652,728,78500,71418
629,538,91,825,89600,71419
598,507,91,675,99000,71422
1413,1147,266,873,130800,71423
468,447,21,-,120700,71424
10,0,10,-,-,71425
42,27,15,638,53600,71426
93,70,23,-,61900,71427
0,0,0,-,-,71428
1262,897,365,538,101900,71429
1066,761,305,697,154700,71430
404,345,59,750,83000,71432
1371,1065,306,446,76700,71433
8,8,0,-,-,71434
1312,984,328,819,128300,71435
519,444,75,-,134600,71438
667,534,133,942,109500,71439
341,278,63,-,-,71441
8259,5328,2931,881,135500,71446
493,309,184,772,96100,71447
3199,2066,1133,533,129000,71449
420,301,119,780,-,71450
93,14,79,-,55800,71452
839,614,225,705,64100,71454
82,36,46,-,-,71455
464,284,180,822,222900,71456
9119,4611,4508,763,166000,71457
3189,5,3184,1056,-,71459
995,473,522,746,114700,71461
674,535,139,658,61300,71462
2862,2019,843,712,105800,71463
1050,828,222,711,93600,71465
244,194,50,-,140400,71466
1840,1433,407,594,162600,71467
306,215,91,820,184000,71468
836,495,341,789,69200,71469
82,82,0,-,-,71472
158,145,13,-,45900,71473
147,117,30,689,143800,71474
2,2,0,-,-,71475
243,182,61,573,107400,71479
224,199,25,850,77800,71480
3235,2062,1173,592,104000,71483
1000,823,177,960,252800,71485
1907,1399,508,701,90800,71486
230,4,226,478,-,71497
4859,2535,2324,765,62100,71601
5711,3564,2147,772,124900,71602
11659,7874,3785,762,97600,71603
189,149,40,575,77500,71630
238,202,36,-,40000,71631
4184,2935,1249,563,79100,71635
1143,804,339,566,68200,71638
2318,1475,843,627,89300,71639
1175,747,428,556,50600,71640
271,223,48,-,55200,71642
478,343,135,463,58700,71643
223,180,43,594,104300,71644
2319,1800,519,549,84000,71646
647,476,171,472,63800,71647
28,28,0,-,224100,71651
356,288,68,675,75000,71652
1745,1267,478,365,107000,71653
1813,1115,698,590,91300,71654
5716,3642,2074,714,109400,71655
208,153,55,695,62600,71658
11,11,0,-,-,71659
343,262,81,-,120100,71660
98,58,40,738,33500,71661
24,0,24,-,-,71662
231,194,37,467,59500,71663
1871,1486,385,599,95300,71665
8,0,8,-,-,71666
2523,2052,471,651,94400,71667
507,378,129,531,84000,71670
2912,1823,1089,570,95900,71671
243,193,50,783,72300,71674
768,684,84,820,105900,71675
196,150,46,540,51000,71676
51,45,6,-,-,71677
0,0,0,-,-,71678
6560,4548,2012,635,82700,71701
883,596,287,562,65200,71720
0,0,0,-,-,71721
25,19,6,-,-,71722
137,97,40,-,56400,71724
140,111,29,347,72100,71725
500,449,51,384,75100,71726
24,24,0,-,-,71728
11034,7752,3282,719,104600,71730
417,326,91,628,159200,71740
1501,1043,458,500,75500,71742
1284,851,433,662,78000,71743
1054,858,196,678,83900,71744
47,45,2,-,73000,71745
365,346,19,561,61900,71747
31,31,0,-,204400,71748
1312,1135,177,690,83000,71749
327,307,20,783,100600,71751
303,224,79,517,56800,71752
5540,3698,1842,707,122900,71753
59,59,0,-,-,71758
165,164,1,-,134400,71759
1112,862,250,790,59100,71762
577,472,105,436,73900,71763
520,461,59,367,-,71764
941,849,92,583,45400,71765
180,167,13,433,73200,71766
1188,1048,140,592,70100,71770
7,7,0,-,-,71772
5740,3622,2118,712,92800,71801
38,38,0,-,-,71820
3154,2518,636,630,91800,71822
18,16,2,-,82500,71823
125,105,20,663,83300,71825
395,301,94,615,43900,71826
350,297,53,-,22400,71827
21,21,0,-,-,71831
3521,2066,1455,649,103900,71832
806,670,136,392,74100,71833
555,555,0,-,51400,71834
355,324,31,471,106300,71835
1071,901,170,529,73800,71836
1541,1266,275,884,71000,71837
446,356,90,909,102100,71838
226,135,91,422,41700,71839
288,260,28,775,64800,71841
781,562,219,658,104900,71842
697,480,217,546,81600,71845
904,644,260,604,72500,71846
165,155,10,-,-,71847
843,610,233,787,86800,71851
3935,2691,1244,675,124100,71852
144,113,31,606,41400,71853
13918,8596,5322,796,123000,71854
138,119,19,-,72900,71855
1895,1119,776,669,73000,71857
699,587,112,538,39000,71858
195,145,50,-,114600,71859
822,673,149,497,60300,71860
717,572,145,645,70300,71861
290,236,54,631,23900,71862
23,21,2,-,101400,71864
114,81,33,875,74500,71865
232,188,44,616,195800,71866
11829,7331,4498,746,140500,71901
9027,7660,1367,1118,207200,71909
19744,12674,7070,854,143100,71913
1165,914,251,691,83400,71921
67,31,36,660,37500,71922
5887,3324,2563,634,136300,71923
1715,1609,106,-,109600,71929
507,353,154,501,115100,71933
279,268,11,-,109700,71935
862,662,200,667,104200,71937
639,530,109,607,74100,71940
808,647,161,594,105800,71941
51,45,6,-,86500,71942
1625,1109,516,654,98900,71943
263,212,51,572,86300,71944
621,467,154,621,82800,71945
477,352,125,-,132100,71949
249,179,70,-,98100,71950
17,17,0,-,117500,71952
5377,4232,1145,694,126700,71953
632,477,155,638,60600,71956
1312,996,316,543,146100,71957
991,765,226,493,86000,71958
203,175,28,-,106100,71959
539,443,96,586,125600,71960
446,363,83,1571,84800,71961
321,274,47,382,92800,71962
2002,1732,270,896,155600,71964
116,55,61,-,84600,71965
1998,1734,264,1051,157300,71968
147,121,26,-,124200,71969
244,244,0,-,113900,71970
221,144,77,733,159900,71971
122,90,32,-,75000,71972
570,362,208,548,74800,71973
0,0,0,-,-,71998
0,0,0,-,-,71999
292,224,68,545,80800,72001
7044,6128,916,837,165100,72002
286,246,40,831,108300,72003
297,212,85,602,73300,72004
43,40,3,-,71700,72005
969,702,267,553,95600,72006
3207,2666,541,900,168300,72007
2222,1527,695,696,106700,72010
1649,1392,257,848,132100,72011
4800,3393,1407,708,139400,72012
860,581,279,-,113900,72013
16,15,1,-,-,72014
10815,7573,3242,886,138900,72015
979,761,218,709,151600,72016
214,139,75,606,56900,72017
10743,8295,2448,917,197800,72019
1252,1029,223,575,72800,72020
1476,894,582,552,74200,72021
7135,4934,2201,855,179500,72022
13635,9623,4012,888,169900,72023
1567,1312,255,657,109100,72024
310,282,28,431,80500,72025
65,44,21,-,-,72026
587,476,111,305,114300,72027
0,0,0,-,-,72028
639,390,249,418,69300,72029
396,339,57,-,-,72030
2662,1892,770,581,108100,72031
12940,7789,5151,868,145000,72032
19259,9445,9814,868,204600,72034
0,0,0,-,-,72035
269,170,99,441,39600,72036
53,47,6,-,157800,72038
835,713,122,922,122600,72039
993,641,352,571,75900,72040
525,402,123,719,29800,72041
2059,1498,561,721,99100,72042
440,398,42,-,150700,72044
509,446,63,862,105300,72045
1636,1040,596,733,89600,72046
323,280,43,532,244800,72047
18,18,0,-,110700,72048
151,108,43,-,81500,72051
38,28,10,-,65000,72052
62,24,38,-,-,72053
261,206,55,700,106300,72055
479,438,41,-,111100,72057
6484,5073,1411,787,167800,72058
27,27,0,-,-,72059
257,231,26,625,68000,72060
37,37,0,-,-,72061
714,592,122,581,115000,72063
1018,768,250,784,89400,72064
1963,1622,341,831,142200,72065
52,29,23,-,-,72066
1253,964,289,648,137900,72067
307,183,124,667,63900,72068
484,321,163,415,64800,72069
713,586,127,650,121100,72070
140,126,14,-,72500,72072
294,197,97,697,86000,72073
39,35,4,-,82100,72074
1,1,0,-,-,72075
15490,8216,7274,827,130100,72076
165,165,0,-,125400,72079
199,194,5,-,-,72080
2822,1857,965,673,108100,72081
821,400,421,670,68100,72082
87,60,27,681,77900,72083
373,302,71,580,70000,72084
113,61,52,781,93200,72085
4348,3236,1112,820,125900,72086
639,613,26,763,139700,72087
1383,1218,165,895,125600,72088
0,0,0,-,-,72099
1249,866,383,585,82000,72101
1130,952,178,671,84100,72102
5248,4174,1074,960,107700,72103
8223,6022,2201,645,98000,72104
2120,1645,475,809,151800,72106
21,21,0,-,91300,72107
0,0,0,-,-,72108
4684,2535,2149,658,110600,72110
464,416,48,625,142700,72111
3771,2379,1392,601,81800,72112
11348,6625,4723,937,220300,72113
4849,1310,3539,758,71400,72114
9388,6376,3012,921,189400,72116
5465,3447,2018,979,95900,72117
8992,5260,3732,893,102200,72118
0,0,0,-,-,72119
13654,9672,3982,926,163900,72120
1201,898,303,752,117400,72121
440,410,30,-,160200,72122
129,85,44,475,38100,72123
306,240,66,700,99600,72125
1330,990,340,576,113200,72126
950,801,149,635,117400,72127
274,205,69,906,99200,72128
457,416,41,613,82600,72129
140,99,41,527,89500,72130
1831,1505,326,791,126800,72131
1256,964,292,1042,89200,72132
12,0,12,-,-,72133
238,200,38,-,98000,72134
1376,1178,198,757,234800,72135
769,636,133,-,148100,72136
799,679,120,714,105400,72137
118,56,62,344,67500,72139
106,86,20,-,98300,72140
171,116,55,-,89100,72141
933,838,95,694,166900,72142
12595,7997,4598,741,157600,72143
4767,3492,1275,759,150400,72150
264,164,100,-,-,72152
1280,1118,162,678,124000,72153
230,213,17,-,225300,72156
478,383,95,645,150400,72157
3546,2114,1432,690,133100,72160
28,16,12,-,-,72165
73,69,4,-,107500,72166
566,503,63,663,82400,72167
72,61,11,-,53900,72168
34,29,5,-,44400,72169
135,125,10,-,73400,72170
3522,3075,447,676,165000,72173
148,92,56,910,69000,72175
3183,2125,1058,913,133900,72176
17,17,0,-,95000,72178
140,117,23,-,76200,72179
20,20,0,-,-,72180
6,6,0,-,-,72181
81,57,24,-,115100,72182
0,0,0,-,-,72183
0,0,0,-,-,72199
553,136,417,1050,342100,72201
5219,1559,3660,920,178900,72202
12219,7146,5073,924,101400,72204
10422,5001,5421,948,178500,72205
8300,5454,2846,761,108400,72206
5329,3771,1558,999,351300,72207
11739,5365,6374,870,81500,72209
6197,3818,2379,883,187700,72210
10803,5686,5117,963,219200,72211
5111,4418,693,1079,282800,72212
10790,6643,4147,1155,371100,72223
5032,3305,1727,893,211800,72227
9796,4569,5227,742,89400,72301
36,31,5,-,49700,72311
0,0,0,-,-,72313
7927,4638,3289,711,102100,72315
30,30,0,-,80000,72320
17,17,0,-,58800,72322
878,629,249,803,78300,72324
3,1,2,-,-,72325
946,597,349,646,83200,72326
561,434,127,588,125000,72327
16,0,16,-,-,72328
0,0,0,-,-,72329
172,135,37,627,57900,72330
929,507,422,616,70300,72331
46,7,39,645,88300,72332
165,116,49,413,54300,72333
5424,2568,2856,721,72300,72335
14,5,9,-,-,72338
74,62,12,733,-,72339
42,42,0,-,65000,72340
92,41,51,838,55300,72341
1626,558,1068,603,104600,72342
209,180,29,-,81800,72346
319,198,121,548,51000,72347
1007,644,363,503,100600,72348
405,230,175,531,61500,72350
300,166,134,727,95000,72351
5,5,0,-,-,72352
13,13,0,-,-,72353
866,574,292,545,68500,72354
816,583,233,613,85600,72355
487,309,178,605,41300,72358
153,91,62,-,19100,72359
1975,1099,876,591,73600,72360
5792,4008,1784,910,169300,72364
996,655,341,579,60100,72365
849,566,283,600,54700,72366
0,0,0,-,-,72367
441,345,96,700,88000,72368
0,0,0,-,-,72369
2829,1332,1497,704,89300,72370
668,495,173,588,63400,72372
368,200,168,487,43800,72373
260,196,64,-,83400,72374
584,502,82,550,85600,72376
23,0,23,-,-,72377
6,6,0,-,-,72379
44,44,0,-,-,72383
277,165,112,688,59600,72384
616,443,173,567,67600,72386
0,0,0,-,-,72387
190,110,80,281,72100,72389
2473,1225,1248,624,67900,72390
18,18,0,-,-,72391
171,141,30,-,83100,72392
104,78,26,725,33200,72394
515,316,199,750,138000,72395
4748,3115,1633,770,101000,72396
16785,7756,9029,773,150700,72401
11396,7645,3751,886,186800,72404
5950,3884,2066,970,182200,72405
135,85,50,-,45000,72410
1058,594,464,843,86200,72411
204,196,8,-,-,72412
245,190,55,583,62200,72413
142,83,59,419,70700,72414
398,335,63,613,59200,72415
1973,1464,509,811,124200,72416
2018,1304,714,835,134400,72417
690,499,191,603,58900,72419
143,69,74,595,72600,72421
1799,1189,610,476,78500,72422
34,25,9,-,32900,72424
132,128,4,-,80600,72425
68,48,20,463,90000,72426
22,17,5,-,70600,72427
53,20,33,-,112500,72428
122,71,51,539,64600,72429
182,134,48,563,32500,72430
167,114,53,572,-,72431
2290,1656,634,687,92900,72432
1053,665,388,561,70600,72433
847,746,101,388,86700,72434
161,148,13,-,-,72435
342,298,44,843,90000,72436
1313,972,341,745,96500,72437
930,590,340,516,103100,72438
80,67,13,692,80700,72440
16,16,0,-,48300,72441
1702,1118,584,619,127100,72442
1323,884,439,746,91500,72443
656,541,115,549,83500,72444
17,13,4,-,85800,72445
737,505,232,534,98500,72447
64,44,20,1071,46700,72449
15127,9656,5471,744,144000,72450
66,66,0,-,102600,72453
2039,1403,636,689,82800,72454
5178,3700,1478,714,103600,72455
218,192,26,738,70500,72456
99,92,7,-,84300,72457
195,186,9,-,77000,72458
596,486,110,494,74300,72459
331,236,95,565,-,72460
1508,1086,422,570,73700,72461
163,73,90,553,50700,72462
7,5,2,-,-,72464
402,326,76,445,74300,72466
41,0,41,-,-,72467
470,385,85,625,100400,72469
102,82,20,-,51000,72470
390,279,111,454,54400,72471
3799,2283,1516,665,95600,72472
908,699,209,608,75400,72473
2821,1694,1127,658,76100,72476
101,101,0,-,67200,72478
506,307,199,689,74600,72479
511,428,83,515,57500,72482
9852,6532,3320,716,107500,72501
873,692,181,605,83000,72512
1103,836,267,479,101400,72513
0,0,0,-,-,72515
102,102,0,-,-,72517
936,749,187,477,120500,72519
263,263,0,-,23300,72520
1904,1301,603,562,79500,72521
194,140,54,467,76800,72522
426,366,60,491,80500,72523
177,93,84,826,252600,72524
34,25,9,-,77500,72526
201,169,32,-,181300,72527
153,130,23,-,159400,72528
2002,1684,318,805,71500,72529
622,581,41,-,126000,72530
271,256,15,-,137500,72531
426,360,66,592,86900,72532
133,112,21,850,92500,72533
594,561,33,-,57100,72534
118,102,16,-,57800,72536
355,281,74,1255,83600,72537
327,307,20,-,-,72538
129,129,0,-,153200,72539
35,21,14,-,97500,72540
1558,1414,144,542,84000,72542
5329,3813,1516,754,154300,72543
384,324,60,-,162200,72544
32,32,0,-,160000,72546
296,293,3,-,96100,72550
76,67,9,-,109900,72553
1035,896,139,505,88300,72554
138,105,33,-,139400,72555
1296,906,390,580,85500,72556
3175,2168,1007,516,134000,72560
208,182,26,300,111500,72561
957,643,314,627,79800,72562
139,116,23,-,77300,72564
306,263,43,576,79400,72565
199,188,11,663,56900,72566
88,73,15,813,56500,72567
432,353,79,850,85400,72568
210,181,29,-,-,72569
193,193,0,-,-,72571
147,94,53,-,156600,72572
133,111,22,-,-,72573
1333,891,442,553,87200,72576
339,221,118,-,116100,72577
80,80,0,-,338500,72578
549,401,148,770,-,72579
585,535,50,-,119400,72581
595,480,115,804,69800,72583
92,92,0,-,87900,72584
100,100,0,-,85700,72585
6,6,0,-,-,72587
12270,8381,3889,656,139200,72601
641,515,126,788,99100,72611
13,9,4,-,87000,72615
3831,2923,908,669,132800,72616
80,79,1,-,66600,72617
766,558,208,558,133100,72619
295,295,0,-,104800,72623
123,107,16,-,115000,72624
749,619,130,534,159400,72626
405,356,49,-,117200,72628
215,201,14,-,67400,72629
55,44,11,825,98600,72630
2025,1675,350,656,182700,72631
2070,1551,519,696,178500,72632
790,744,46,560,129600,72633
1724,1324,400,666,142300,72634
1415,1014,401,788,99400,72635
5,5,0,-,-,72636
2588,1758,830,588,152200,72638
233,167,66,-,106400,72639
237,237,0,-,136900,72640
831,563,268,593,167000,72641
1011,869,142,713,135600,72642
1028,901,127,675,88800,72644
652,462,190,464,87700,72645
114,80,34,-,157800,72648
1683,1253,430,578,100500,72650
571,413,158,857,114600,72651
13065,9543,3522,743,143500,72653
191,158,33,-,107200,72655
575,477,98,593,112500,72658
273,264,9,925,113500,72660
377,341,36,-,92300,72661
1042,691,351,522,139500,72662
98,75,23,-,-,72663
64,64,0,-,-,72666
109,109,0,-,275500,72668
42,40,2,-,-,72669
49,38,11,-,-,72670
108,88,20,-,32200,72672
559,409,150,503,122600,72675
254,209,45,747,129900,72677
9,0,9,-,-,72679
341,257,84,939,120900,72680
53,48,5,-,-,72682
146,61,85,-,180400,72683
468,400,68,443,154000,72685
73,73,0,-,107600,72686
2933,2305,628,772,135300,72687
17206,7352,9854,823,265200,72701
15642,6188,9454,834,260400,72703
11967,7141,4826,1026,237800,72704
13964,7951,6013,1024,292500,72712
8231,4375,3856,1085,283300,72713
5486,4765,721,1074,191800,72714
7067,6233,834,961,187700,72715
495,358,137,724,125000,72717
1601,1511,90,1829,289200,72718
5780,3930,1850,1185,199600,72719
236,215,21,-,220100,72721
1034,644,390,852,112300,72722
2541,2066,475,862,152200,72727
98,98,0,-,338800,72729
3597,2923,674,983,181300,72730
2043,1856,187,825,175000,72732
3398,2414,984,938,153700,72734
2493,2028,465,917,198600,72736
779,696,83,692,139000,72738
215,117,98,1048,-,72739
3257,2617,640,605,122300,72740
265,252,13,-,-,72742
1783,1197,586,919,134000,72744
4640,3122,1518,917,188500,72745
46,46,0,-,-,72747
65,26,39,-,-,72749
3052,2227,825,1293,174300,72751
119,75,44,-,95900,72752
3640,2631,1009,799,180100,72753
15360,9613,5747,778,174200,72756
15243,9138,6105,1099,256500,72758
108,94,14,-,100000,72760
7562,4778,2784,798,180600,72761
14821,10489,4332,967,204100,72762
19337,8758,10579,824,166800,72764
450,310,140,641,164400,72768
440,345,95,746,-,72769
530,426,104,-,119000,72773
2584,2098,486,1070,157700,72774
322,301,21,-,117500,72776
6222,2778,3444,720,117600,72801
8726,7337,1389,819,155200,72802
675,442,233,628,83000,72821
2299,1687,612,766,109700,72823
676,367,309,780,104000,72824
1,1,0,-,-,72826
75,46,29,-,-,72827
65,6,59,-,-,72828
0,0,0,-,-,72829
6147,3836,2311,666,121900,72830
325,214,111,458,72000,72832
1225,774,451,559,112100,72833
3593,2540,1053,678,118900,72834
316,281,35,-,113100,72835
3145,2454,691,755,98300,72837
102,102,0,-,77100,72838
192,160,32,-,59200,72839
801,638,163,597,79700,72840
93,59,34,-,-,72841
411,334,77,632,69100,72842
843,725,118,732,99500,72843
357,333,24,692,88500,72845
1422,1199,223,655,110200,72846
1121,1020,101,852,99300,72847
300,282,18,-,151400,72851
65,57,8,-,116600,72852
950,668,282,466,102600,72853
238,200,38,-,80600,72854
2433,1746,687,590,97100,72855
104,104,0,-,-,72856
619,470,149,314,106300,72857
1188,1006,182,598,151200,72858
49,42,7,-,206300,72860
619,534,85,709,117900,72863
481,417,64,817,132200,72865
9046,3927,5119,668,102200,72901
11024,5588,5436,729,181000,72903
7848,3985,3863,727,84400,72904
0,0,0,-,-,72905
5875,3804,2071,833,147100,72908
4292,3008,1284,856,224000,72916
4586,3404,1182,681,152100,72921
2048,1324,724,1031,105600,72923
260,190,70,740,168800,72926
3067,1884,1183,648,95100,72927
340,274,66,634,126400,72928
112,98,14,-,98000,72930
647,621,26,906,114400,72932
2029,1593,436,640,86200,72933
507,496,11,620,-,72934
231,153,78,483,131100,72935
5547,4326,1221,757,149400,72936
1405,1108,297,693,114700,72937
504,416,88,622,100900,72938
584,490,94,725,112900,72940
1875,1548,327,687,143800,72941
992,761,231,739,117900,72943
1072,840,232,677,93500,72944
174,71,103,843,60500,72945
1249,1173,76,531,106800,72946
1293,1128,165,609,99200,72947
64,64,0,-,-,72948
3953,2702,1251,632,108000,72949
275,196,79,-,151000,72950
317,259,58,616,73800,72951
943,908,35,-,100800,72952
132,122,10,-,-,72955
13296,9443,3853,754,133300,72956
2699,1965,734,663,78900,72958
1172,1088,84,669,153100,72959
20,11,9,-,-,73001
381,335,46,638,82400,73002
9176,5424,3752,1243,177200,73003
326,269,57,983,112500,73004
2958,1921,1037,593,78700,73005
1068,829,239,638,93100,73006
1074,958,116,817,402000,73007
8023,4421,3602,934,132100,73008
380,297,83,563,98500,73009
6640,5678,962,874,202300,73010
232,216,16,675,81700,73011
14450,11598,2852,1689,247500,73012
20754,16022,4732,1337,239700,73013
434,351,83,885,135100,73014
937,689,248,583,76200,73015
702,619,83,1110,197400,73016
498,380,118,571,74000,73017
7782,4749,3033,768,99200,73018
0,0,0,-,-,73019
8983,7800,1183,1186,202600,73020
107,88,19,625,150000,73021
0,0,0,-,-,73022
220,182,38,692,95000,73024
5068,4920,148,2549,375800,73025
4165,3827,338,1021,217600,73026
560,421,139,708,-,73027
1537,1162,375,909,115900,73028
518,426,92,746,106800,73029
1566,1000,566,735,128900,73030
21,18,3,-,-,73031
78,50,28,929,75000,73032
140,93,47,700,81300,73033
16712,12163,4549,1049,312900,73034
7107,4276,2831,792,127300,73036
642,544,98,571,85000,73038
623,410,213,707,93100,73040
135,117,18,596,108900,73041
381,291,90,705,96800,73042
72,67,5,-,72100,73043
8739,7044,1695,800,157200,73044
3962,3174,788,906,168800,73045
1292,923,369,756,115700,73047
961,752,209,689,129200,73048
2256,1805,451,758,160200,73049
89,35,54,567,-,73050
2795,2152,643,816,115800,73051
2378,1722,656,816,122300,73052
237,187,50,525,128400,73053
1736,1568,168,678,171900,73054
3760,3006,754,707,124500,73055
210,205,5,663,55400,73056
911,705,206,732,128100,73057
60,58,2,-,160700,73058
1135,801,334,532,112700,73059
683,574,109,788,173200,73061
533,411,122,471,77500,73062
316,291,25,554,150300,73063
9504,7652,1852,1119,189000,73064
3598,3009,589,813,198900,73065
48,26,22,-,-,73066
684,609,75,850,110800,73067
4476,3434,1042,979,154500,73068
10946,5371,5575,874,166300,73069
0,0,0,-,-,73070
17735,8339,9396,933,168700,73071
18817,10423,8394,953,240800,73072
316,286,30,-,312100,73073
427,296,131,770,108100,73074
3687,2330,1357,707,110000,73075
2312,1791,521,720,103200,73077
4184,3946,238,1557,231900,73078
192,153,39,810,109100,73079
3676,2537,1139,798,169800,73080
1141,876,265,640,94400,73082
2741,1913,828,784,98700,73084
2999,2274,725,788,133600,73086
4727,4202,525,855,206200,73089
223,155,68,755,158000,73090
304,227,77,667,85000,73092
1240,1022,218,1038,227000,73093
796,653,143,800,132200,73095
5188,2881,2307,696,201900,73096
49,49,0,-,-,73097
1340,943,397,740,110300,73098
29538,22366,7172,1131,178400,73099
1103,114,989,1036,218900,73102
3110,997,2113,890,287600,73103
2018,351,1667,1288,315400,73104
2933,1127,1806,969,118400,73105
4766,1739,3027,856,183500,73106
11013,6504,4509,886,111800,73107
5118,2087,3031,720,61400,73108
7095,3458,3637,717,71200,73109
14143,6220,7923,877,99400,73110
4693,2639,2054,841,70800,73111
15276,7959,7317,876,139600,73112
8164,3006,5158,963,105400,73114
8383,4777,3606,897,86000,73115
4411,3196,1215,1049,253100,73116
2801,1223,1578,727,88500,73117
7079,3892,3187,936,185200,73118
10254,5050,5204,842,69000,73119
17948,9450,8498,898,186500,73120
1237,946,291,797,196300,73121
5435,3219,2216,844,126600,73122
8928,4144,4784,807,119000,73127
2713,1790,923,1303,155200,73128
6646,3401,3245,788,59000,73129
8238,6152,2086,1058,149300,73130
1337,1277,60,-,268200,73131
11070,5914,5156,889,168400,73132
3610,606,3004,1075,188100,73134
8210,4924,3286,1071,135000,73135
7898,3457,4441,835,127900,73139
909,708,201,847,94000,73141
6799,4126,2673,1018,280100,73142
607,5,602,1428,-,73145
1818,950,868,858,69100,73149
1937,1613,324,731,247000,73150
669,661,8,-,504700,73151
12553,7419,5134,959,119500,73159
23146,15243,7903,1089,154200,73160
11754,8799,2955,1037,190800,73162
2620,2540,80,933,275400,73165
996,734,262,1086,203400,73169
15710,12732,2978,1215,206600,73170
1278,1215,63,-,312000,73173
2220,1866,354,1405,166200,73179
13870,8748,5122,842,141600,73401
83,78,5,-,313300,73425
526,485,41,629,119400,73430
383,279,104,725,101800,73432
959,724,235,700,112500,73433
204,157,47,895,102100,73434
26,17,9,692,48100,73435
44,23,21,650,66300,73436
28,21,7,-,-,73437
1262,1000,262,622,60300,73438
2543,2035,508,757,117500,73439
88,62,26,667,90000,73440
71,59,12,488,80700,73441
150,140,10,-,92500,73442
1116,784,332,790,130000,73443
83,83,0,-,107200,73444
3001,2174,827,688,114800,73446
416,331,85,795,84200,73447
2088,1410,678,726,109300,73448
1302,1012,290,797,112200,73449
522,445,77,725,104600,73450
242,183,59,669,257000,73453
236,180,56,814,57600,73455
648,535,113,531,78500,73456
345,245,100,917,144500,73458
457,307,150,914,145300,73459
1641,1087,554,592,103200,73460
233,170,63,638,80000,73461
1431,1252,179,708,101200,73463
333,296,37,535,76000,73481
56,38,18,513,57100,73487
6,3,3,-,-,73488
306,233,73,834,87500,73491
7635,3350,4285,725,110200,73501
1701,0,1701,1217,-,73503
18718,9503,9215,789,128300,73505
8494,4718,3776,837,135500,73507
44,38,6,533,60000,73520
7935,4719,3216,815,108000,73521
0,0,0,-,-,73523
765,573,192,711,126200,73526
1719,1401,318,732,162700,73527
187,143,44,629,118800,73528
1774,1364,410,669,85500,73529
172,147,25,510,39300,73530
120,109,11,646,108000,73531
216,124,92,738,113300,73532
10704,7687,3017,756,123800,73533
237,208,29,771,44300,73537
2212,1649,563,985,219000,73538
78,71,7,-,80600,73539
128,93,35,529,173800,73540
1490,1249,241,823,139400,73541
1511,1045,466,668,50500,73542
793,629,164,1020,88300,73543
105,92,13,-,54000,73544
494,331,163,709,48000,73546
546,402,144,-,108700,73547
147,133,14,910,65900,73548
117,95,22,850,225900,73549
795,532,263,753,80500,73550
14,14,0,-,47500,73551
475,420,55,875,114000,73552
4,3,1,-,-,73553
1320,891,429,592,69300,73554
55,46,9,-,34700,73555
46,35,11,588,107800,73556
111,91,20,1159,274400,73557
187,127,60,442,36800,73559
320,139,181,535,77400,73560
206,176,30,767,120000,73562
188,164,24,467,96300,73564
329,244,85,418,53700,73565
507,386,121,527,83400,73566
329,237,92,461,105000,73567
378,298,80,548,46800,73568
196,137,59,463,47500,73569
370,293,77,480,66200,73570
31,20,11,-,-,73571
1184,916,268,707,101800,73572
869,596,273,538,65700,73573
4025,3145,880,766,120800,73601
492,331,161,603,143600,73620
121,99,22,825,63500,73622
707,321,386,722,93600,73624
190,158,32,725,86000,73625
342,283,59,805,156300,73626
187,172,15,1054,-,73627
642,477,165,756,123100,73628
1174,899,275,602,90500,73632
44,37,7,-,272500,73638
287,176,111,1081,104700,73639
202,156,46,542,57300,73641
61,46,15,-,57700,73642
5779,3751,2028,768,152200,73644
445,307,138,717,88300,73645
157,155,2,-,113000,73646
220,179,41,788,156900,73647
331,316,15,600,122500,73650
1513,1069,444,701,53300,73651
287,254,33,775,116300,73654
311,236,75,525,65100,73655
108,92,16,-,62400,73658
55,42,13,-,-,73659
139,104,35,-,106800,73660
187,160,27,783,76700,73661
1595,1093,502,682,103600,73662
399,318,81,924,137500,73663
548,430,118,596,83400,73664
157,117,40,-,126000,73666
180,131,49,625,59400,73667
17,4,13,-,-,73668
562,454,108,577,123400,73669
195,137,58,-,52500,73673
9060,5112,3948,741,83800,73701
11696,7934,3762,991,163000,73703
21,0,21,-,-,73705
213,177,36,480,78600,73716
2550,1736,814,740,121600,73717
231,217,14,-,127800,73718
27,24,3,-,162500,73719
86,74,12,-,68800,73720
85,65,20,488,121600,73722
318,242,76,671,57100,73724
180,139,41,744,55000,73726
52,52,0,-,161300,73727
778,586,192,767,109500,73728
229,208,21,779,84400,73729
307,266,41,834,141200,73730
80,68,12,-,78000,73731
67,54,13,-,106700,73733
320,252,68,908,175800,73734
274,254,20,800,104400,73735
247,221,26,-,222900,73736
1512,1196,316,606,111800,73737
382,318,64,805,94000,73738
177,170,7,-,100000,73739
173,144,29,513,71300,73741
1347,966,381,813,128300,73742
36,29,7,-,71700,73743
37,35,2,-,-,73744
11,6,5,-,-,73746
100,46,54,-,-,73747
229,196,33,720,75000,73749
2565,1961,604,849,175400,73750
231,206,25,1356,130100,73753
467,378,89,773,117500,73754
274,226,48,470,97800,73755
138,112,26,814,123200,73756
62,44,18,-,-,73757
73,66,7,-,55900,73758
483,379,104,703,52900,73759
151,131,20,495,111700,73760
119,110,9,-,78500,73761
720,585,135,911,189100,73762
621,359,262,708,103400,73763
125,108,17,643,161300,73764
415,290,125,794,97100,73766
599,493,106,705,121000,73768
0,0,0,-,-,73770
154,125,29,588,-,73771
1339,922,417,644,115700,73772
856,578,278,854,122600,73773
6293,3958,2335,794,150500,73801
473,421,52,622,97600,73832
606,537,69,777,87000,73834
103,73,30,592,73000,73835
227,209,18,425,155100,73838
199,165,34,900,83700,73840
186,142,44,650,83600,73841
234,205,29,-,206900,73842
305,212,93,728,83300,73843
114,98,16,-,90500,73844
565,413,152,685,84700,73848
65,58,7,-,208000,73851
720,616,104,804,146300,73852
193,160,33,1108,181700,73853
55,31,24,-,152100,73855
357,314,43,1250,200000,73857
553,389,164,714,115300,73858
492,351,141,783,123300,73859
468,368,100,831,114200,73860
77,43,34,-,92200,73901
254,190,64,821,95000,73931
694,506,188,768,98000,73932
520,404,116,600,59300,73933
80,64,16,-,95000,73937
229,200,29,941,72200,73938
379,207,172,693,95000,73939
4482,2794,1688,808,135300,73942
154,103,51,563,48300,73944
926,675,251,830,121500,73945
9,4,5,-,-,73946
214,172,42,513,83500,73947
460,347,113,583,129100,73949
417,355,62,795,140400,73950
391,351,40,775,56100,73951
21,16,5,-,-,73960
115,100,15,563,64000,74001
622,485,137,636,100200,74002
5414,3297,2117,769,82400,74003
10765,8108,2657,827,151100,74006
10831,8288,2543,1111,246400,74008
3856,2666,1190,705,123900,74010
11744,9267,2477,1176,192600,74011
23769,15786,7983,1075,177500,74012
14142,12407,1735,1191,190000,74014
3438,2285,1153,868,154100,74015
2201,1572,629,683,100700,74016
10541,7355,3186,939,147200,74017
7397,6134,1263,885,184000,74019
2800,2014,786,828,111200,74020
7758,6369,1389,1062,175500,74021
790,725,65,613,97100,74022
4476,2835,1641,683,113400,74023
283,207,76,720,74500,74026
322,256,66,606,85600,74027
612,510,102,650,132600,74028
1916,1372,544,693,109900,74029
1408,1017,391,507,69400,74030
808,656,152,701,116500,74032
4340,3124,1216,1138,147000,74033
50,48,2,-,36300,74034
1338,1034,304,645,70500,74035
2628,2164,464,819,161300,74036
7930,6031,1899,1302,222500,74037
798,701,97,911,117000,74038
1455,1082,373,822,136400,74039
985,800,185,962,165600,74041
153,101,52,617,53500,74042
2911,2308,603,804,153400,74044
123,98,25,725,219000,74045
45,12,33,643,-,74046
2384,2045,339,817,150900,74047
2245,1584,661,666,97300,74048
199,116,83,631,71700,74050
770,698,72,783,123400,74051
417,276,141,642,64100,74052
1814,1479,335,869,168400,74053
252,182,70,513,66000,74054
17299,12441,4858,1084,209200,74055
1988,1431,557,647,87900,74056
1362,977,385,671,99100,74058
2138,1535,603,740,133000,74059
171,123,48,714,66800,74060
796,652,144,832,151800,74061
336,257,79,617,116000,74062
12036,9640,2396,902,149600,74063
12026,9206,2820,921,137500,74066
10,10,0,-,-,74068
5292,3838,1454,862,165300,74070
96,32,64,-,82900,74071
675,529,146,773,121400,74072
1886,1620,266,890,172400,74073
12253,6194,6059,896,199900,74074
10590,4599,5991,824,172500,74075
0,0,0,-,-,74077
36,0,36,-,-,74078
1690,1269,421,672,124500,74079
973,791,182,793,206500,74080
675,634,41,1026,88700,74081
96,31,65,1096,72500,74082
378,317,61,944,145300,74083
196,155,41,670,40500,74084
1022,811,211,751,104500,74085
421,5,416,1409,-,74103
5253,2468,2785,998,175400,74104
12612,6797,5815,872,264700,74105
7080,3270,3810,682,73900,74106
8020,4298,3722,843,98900,74107
2870,1949,921,983,101800,74108
5042,2515,2527,811,59900,74110
9503,5296,4207,933,120700,74112
7356,5758,1598,1108,226500,74114
8300,4457,3843,883,62800,74115
1266,522,744,758,98700,74116
0,0,0,-,-,74117
2072,549,1523,911,187400,74119
2776,997,1779,882,312100,74120
3951,2357,1594,881,56500,74126
6613,3789,2824,869,93100,74127
4411,2592,1819,911,88900,74128
7070,3472,3598,823,115300,74129
731,502,229,899,64000,74130
892,718,174,913,164100,74131
4006,2286,1720,975,224600,74132
20426,10865,9561,978,206500,74133
7924,5081,2843,888,160500,74134
9326,4706,4620,853,187300,74135
14079,5269,8810,815,245900,74136
11449,7907,3542,973,323600,74137
7597,4417,3180,913,130100,74145
5541,1975,3566,726,106600,74146
0,0,0,-,-,74171
3983,2726,1257,807,110100,74301
1110,924,186,790,137500,74330
3220,2422,798,841,144500,74331
612,431,181,740,113700,74332
346,296,50,667,120800,74333
1651,1343,308,687,89900,74337
1704,1304,400,638,98600,74338
813,555,258,599,61700,74339
80,60,20,633,106300,74340
949,789,160,914,72000,74342
1246,883,363,670,95900,74343
6283,4620,1663,812,166600,74344
2703,1808,895,656,91300,74346
1139,1005,134,692,82200,74347
343,260,83,786,193800,74349
292,213,79,683,110800,74350
2092,1565,527,699,102000,74352
6649,4299,2350,731,102500,74354
87,66,21,917,47500,74358
61,41,20,838,68800,74359
9,9,0,-,-,74360
6550,4388,2162,789,149900,74361
1031,799,232,686,96300,74363
691,621,70,800,123700,74364
1623,1179,444,656,103700,74365
598,517,81,725,79200,74366
238,224,14,-,84700,74367
30,17,13,690,55000,74368
679,516,163,690,119600,74369
1479,1134,345,540,111000,74370
6437,3793,2644,723,101400,74401
11268,7180,4088,725,120800,74403
1525,1202,323,834,146700,74421
405,359,46,1030,103100,74422
310,236,74,650,103600,74423
422,310,112,625,104200,74425
3420,2642,778,629,97400,74426
583,561,22,767,117000,74427
326,290,36,850,105600,74428
5315,4083,1232,855,169900,74429
285,233,52,589,97800,74430
344,282,62,716,74200,74431
3945,3166,779,682,136400,74432
3763,2948,815,699,149900,74434
1159,907,252,760,104400,74435
1909,1539,370,786,121600,74436
3616,2606,1010,703,81200,74437
117,87,30,607,68100,74438
1878,1505,373,778,122700,74441
260,218,42,925,136500,74442
1040,715,325,739,132300,74445
199,163,36,733,75200,74446
6009,3764,2245,677,85400,74447
580,511,69,750,78400,74450
1588,1372,216,739,136500,74451
108,97,11,-,185500,74452
1326,1042,284,591,155100,74454
1079,880,199,718,103800,74455
56,41,15,575,96400,74456
116,98,18,-,133300,74457
36,32,4,-,183300,74458
40,35,5,658,77000,74459
192,165,27,575,-,74460
2882,2121,761,675,121300,74462
75,44,31,667,-,74463
11412,6585,4827,714,134800,74464
5523,3699,1824,769,120900,74467
152,139,13,771,55000,74468
697,459,238,630,93800,74469
679,504,175,-,115300,74470
521,452,69,473,112500,74471
250,201,49,913,92600,74472
9,0,9,-,-,74477
10828,7559,3269,768,127800,74501
25,15,10,700,38500,74521
87,84,3,-,186300,74522
2112,1563,549,515,85500,74523
3379,2467,912,604,106900,74525
43,39,4,-,57500,74528
88,76,12,-,53800,74530
297,218,79,644,76400,74531
346,272,74,730,88900,74533
58,48,10,-,155600,74534
34,34,0,-,58000,74535
621,431,190,329,100100,74536
1538,1104,434,613,80100,74538
67,55,12,525,89500,74540
174,158,16,-,163700,74543
274,173,101,767,73100,74546
1163,879,284,663,96400,74547
35,22,13,-,131800,74549
377,311,66,564,115100,74552
487,393,94,688,104300,74553
864,491,373,753,87300,74554
225,183,42,648,126900,74555
144,124,20,500,116700,74556
230,208,22,775,109600,74557
143,111,32,450,81400,74558
179,144,35,725,100000,74560
739,558,181,590,80000,74561
294,235,59,450,82200,74562
774,617,157,716,87500,74563
171,136,35,754,81300,74565
51,42,9,445,48300,74567
226,182,44,689,76000,74569
458,386,72,775,110800,74570
1405,977,428,460,80900,74571
286,244,42,746,76600,74572
482,398,84,583,95000,74574
88,79,9,-,261600,74576
122,91,31,473,33400,74577
2238,1463,775,694,88100,74578
7239,4305,2934,735,81500,74601
4736,3701,1035,708,162100,74604
191,144,47,573,105100,74630
2632,1778,854,786,67800,74631
218,177,41,600,-,74632
151,127,24,613,108500,74633
86,58,28,763,104200,74636
619,522,97,508,45300,74637
90,82,8,-,80000,74640
249,233,16,450,119900,74641
174,133,41,809,61300,74643
205,180,25,525,71000,74644
65,65,0,-,-,74646
1200,922,278,646,91600,74647
184,158,26,608,81300,74650
360,259,101,461,261700,74651
384,338,46,675,67500,74652
1584,1113,471,612,72800,74653
9777,5285,4492,810,147900,74701
166,120,46,697,64500,74720
0,0,0,-,-,74721
58,43,15,-,104700,74722
512,401,111,579,107500,74723
56,46,10,-,77500,74724
849,609,240,605,95200,74726
862,574,288,608,84700,74727
3953,2873,1080,607,113000,74728
1016,822,194,760,103000,74729
1940,1252,688,855,142200,74730
583,538,45,730,87600,74731
1236,836,400,731,103200,74733
354,295,59,521,98400,74734
695,547,148,727,110000,74735
313,265,48,610,138200,74736
17,16,1,-,83300,74737
184,152,32,525,74300,74738
777,582,195,592,71900,74740
347,284,63,568,100800,74741
3298,1947,1351,547,106700,74743
3543,2282,1261,597,86500,74745
165,109,56,613,114000,74747
196,180,16,582,69600,74748
75,68,7,588,73300,74750
35,17,18,-,-,74753
177,144,33,-,52900,74754
18,18,0,-,-,74755
241,193,48,788,134400,74756
492,426,66,664,89500,74759
64,21,43,558,-,74760
25,21,4,775,87500,74761
1253,964,289,618,110600,74764
435,360,75,529,65700,74766
8381,4918,3463,744,105500,74801
7783,5442,2341,816,163500,74804
11852,7231,4621,783,142100,74820
412,366,46,636,141000,74824
683,523,160,783,89600,74825
503,427,76,796,133500,74826
135,107,28,625,145800,74827
202,160,42,490,83700,74829
57,49,8,-,31800,74830
258,207,51,675,178500,74831
309,245,64,800,80800,74832
193,149,44,684,90700,74833
2844,2283,561,670,150300,74834
131,110,21,-,-,74836
74,61,13,850,65400,74837
229,178,51,631,58100,74839
711,560,151,744,123500,74840
116,80,36,529,105000,74842
90,85,5,750,201800,74843
120,87,33,766,98800,74844
123,103,20,425,88300,74845
2090,1540,550,544,77700,74848
1153,820,333,632,100400,74849
102,81,21,800,64500,74850
3562,2912,650,671,132500,74851
540,462,78,750,107600,74852
642,510,132,496,64200,74854
1620,1211,409,810,124300,74855
240,194,46,775,112500,74856
4056,3603,453,1011,143600,74857
2257,1538,719,593,91900,74859
582,531,51,579,125900,74860
1719,1388,331,696,141700,74864
744,652,92,756,109700,74865
29,25,4,-,-,74866
229,164,65,721,60700,74867
4380,2968,1412,675,77700,74868
283,222,61,1114,97100,74869
1004,864,140,589,142800,74871
1130,781,349,560,112500,74872
3880,2965,915,810,106700,74873
354,297,57,719,103500,74875
684,626,58,725,116900,74878
683,544,139,546,72300,74880
1956,1594,362,631,116000,74881
788,534,254,550,76800,74883
2088,1350,738,706,74900,74884
718,440,278,648,63100,74901
1676,1187,489,678,96100,74902
777,653,124,614,82900,74930
452,386,66,650,95600,74931
885,680,205,723,119400,74932
64,44,20,733,55000,74935
454,341,113,772,100600,74936
1776,1279,497,704,68700,74937
213,155,58,525,78100,74939
855,651,204,646,100200,74940
882,628,254,594,84700,74941
53,37,16,475,63000,74942
41,32,9,-,63300,74943
445,359,86,510,68000,74944
61,48,13,630,55000,74945
29,15,14,525,36300,74946
33,22,11,594,-,74947
4298,3315,983,716,97400,74948
131,97,34,913,83600,74949
562,347,215,768,95300,74951
4280,2878,1402,744,137200,74953
1627,1038,589,712,103600,74954
5519,3759,1760,753,107100,74955
721,524,197,731,101300,74956
340,295,45,483,104700,74957
2340,1676,664,763,87400,74959
4105,2735,1370,577,95000,74960
1622,1223,399,670,102400,74962
194,166,28,-,88900,74963
822,638,184,777,94300,74964
1689,1080,609,508,95000,74965
1276,1060,216,655,94100,74966
8835,1402,7433,1473,343700,75001
22095,17603,4492,1712,315600,75002
18161,9303,8858,1333,244700,75006
19938,13770,6168,1383,284300,75007
7649,6839,810,1605,379700,75009
11912,5988,5924,1473,351300,75010
15596,10453,5143,1588,436000,75013
16834,11136,5698,1526,431500,75019
9179,5540,3639,955,129700,75020
3462,2732,730,854,146500,75021
8756,7604,1152,1885,468700,75022
18162,11298,6864,1579,315300,75023
17539,6718,10821,1578,458900,75024
18342,12324,6018,1713,375200,75025
16938,14042,2896,1851,361400,75028
11621,9723,1898,1524,361900,75032
14047,10630,3417,1737,445100,75033
19088,8192,10896,1432,554700,75034
26190,20006,6184,1943,422200,75035
10912,9604,1308,1850,395800,75036
13540,2430,11110,1230,290600,75038
11027,1679,9348,1607,477800,75039
20033,13860,6173,1401,183300,75040
9799,5990,3809,1116,168500,75041
11552,6583,4969,1086,166300,75042
21955,13229,8726,1252,194400,75043
15958,10347,5611,1402,240200,75044
9387,8511,876,1632,282900,75048
15559,6876,8683,1191,165100,75050
13150,6181,6969,1045,138400,75051
30366,20497,9869,1443,215700,75052
4789,4349,440,1872,364700,75054
25494,15184,10310,1489,331100,75056
6198,2373,3825,1400,134100,75057
984,799,185,1373,381000,75058
14542,9178,5364,1193,168000,75060
18502,7352,11150,1086,168000,75061
17490,7275,10215,1168,196500,75062
17190,6362,10828,1403,393300,75063
4693,3378,1315,1302,245100,75065
27002,9814,17188,1287,249600,75067
20531,16968,3563,1742,292700,75068
14537,7490,7047,1245,322200,75069
20576,11473,9103,1495,342900,75070
20893,15513,5380,1807,355900,75071
17585,14383,3202,2148,370100,75072
17678,9736,7942,1425,267400,75074
14473,8855,5618,1437,319100,75075
3384,2705,679,1194,180300,75076
13420,10913,2507,1468,351000,75077
10613,9420,1193,1842,486700,75078
18861,10280,8581,1531,337900,75080
13677,7292,6385,1457,273000,75081
11054,5971,5083,1695,383200,75082
13795,11237,2558,1373,314100,75087
9261,7588,1673,1697,246500,75088
11218,9198,2020,1634,263700,75089
8466,5507,2959,885,110500,75090
11395,6360,5035,1074,187700,75092
19245,11617,7628,1555,491700,75093
6377,5760,617,2244,386900,75094
20326,15616,4710,1731,276800,75098
222,117,105,980,77000,75101
596,506,90,898,109000,75102
6220,5158,1062,1029,176300,75103
16342,11582,4760,1583,206600,75104
37,34,3,-,167200,75105
1626,1367,259,1163,124900,75109
10160,6208,3952,858,118900,75110
1996,1732,264,1174,201800,75114
19906,13587,6319,1303,215500,75115
7030,4135,2895,1248,161700,75116
1543,1179,364,1059,162600,75117
9900,6812,3088,1055,166700,75119
1776,1444,332,864,132100,75124
2210,1741,469,1007,132200,75125
19298,15830,3468,1714,253900,75126
762,627,135,720,164400,75127
0,0,0,-,-,75132
6653,4904,1749,1317,160900,75134
2504,2073,431,1271,233300,75135
6832,4770,2062,1458,198000,75137
2589,2014,575,731,99800,75140
1005,530,475,1312,83100,75141
7291,5475,1816,1092,149200,75142
5815,4750,1065,954,124300,75143
1326,932,394,741,131200,75144
8585,5273,3312,1231,171800,75146
2621,1884,737,794,168300,75147
2552,1902,650,796,142800,75148
19362,12810,6552,1190,154600,75149
22642,11121,11521,1206,171200,75150
1871,1423,448,1352,133000,75152
146,93,53,-,137500,75153
14798,12470,2328,1265,229700,75154
963,771,192,836,94600,75155
6734,4945,1789,809,152500,75156
111,93,18,590,71000,75157
1766,1552,214,990,232700,75158
6356,4950,1406,1192,166700,75159
8486,5866,2620,1068,161700,75160
2869,2356,513,926,165100,75161
1118,951,167,742,-,75163
151,142,9,-,159200,75164
16267,10342,5925,1191,230300,75165
1853,1621,232,1708,266700,75166
3984,3678,306,1800,307100,75167
5583,4198,1385,821,131800,75169
1779,1083,696,929,73900,75172
2488,2236,252,1144,222400,75173
7483,4795,2688,1114,153100,75180
7865,6866,999,1697,207500,75181
2569,2207,362,1021,409900,75182
11731,10554,1177,1518,248500,75189
11165,1196,9969,1834,636300,75201
1461,455,1006,1761,247000,75202
6229,2233,3996,976,111900,75203
18689,3725,14964,1599,386600,75204
9143,5417,3726,1865,1211000,75205
20910,6066,14844,1419,459400,75206
2209,9,2200,1665,-,75207
11638,6388,5250,1250,346200,75208
6721,4048,2673,1512,604200,75209
2855,921,1934,827,82700,75210
22504,12042,10462,1027,139900,75211
8099,4300,3799,822,124300,75212
15278,8630,6648,1372,562700,75214
7008,2249,4759,941,84300,75215
18934,9616,9318,960,85200,75216
23912,13846,10066,1026,110500,75217
9434,5991,3443,1462,386200,75218
15936,4931,11005,1513,330600,75219
14009,4339,9670,987,332400,75220
4580,2075,2505,1140,183400,75223
11712,5945,5767,996,158500,75224
8869,6962,1907,1981,1185900,75225
2381,171,2210,1390,79200,75226
18465,10531,7934,1045,143600,75227
24624,11424,13200,1013,186300,75228
11429,7799,3630,1298,459200,75229
12934,8029,4905,1205,703400,75230
17536,3001,14535,1025,384400,75231
11559,7500,4059,1143,161100,75232
4984,2543,2441,1092,193800,75233
11789,7353,4436,1418,227600,75234
8698,2039,6659,1312,219900,75235
6501,1972,4529,1036,168500,75236
7943,1065,6878,983,150300,75237
12950,6539,6411,1094,415100,75238
10230,2541,7689,1144,259000,75240
10481,6439,4042,1047,109700,75241
27814,6930,20884,1046,290200,75243
5701,2826,2875,1604,467300,75244
1250,208,1042,897,349000,75246
229,0,229,1051,-,75247
16306,8499,7807,1347,440100,75248
5315,4048,1267,1683,176100,75249
2292,0,2292,1458,-,75251
12458,5417,7041,1160,418200,75252
6468,4178,2290,1174,91900,75253
11285,2327,8958,1276,269800,75254
0,0,0,-,-,75261
0,0,0,-,-,75270
26947,6057,20890,1171,355400,75287
0,0,0,-,-,75390
7952,4104,3848,1016,110700,75401
6933,4648,2285,1177,172100,75402
7998,5980,2018,1442,219100,75407
6823,5244,1579,1711,232400,75409
2029,1769,260,812,144000,75410
327,148,179,1331,86400,75411
240,195,45,-,84800,75412
70,47,23,1057,59600,75413
1116,919,197,775,179000,75414
122,112,10,-,-,75415
1083,897,186,845,129200,75416
878,676,202,1102,117900,75417
4953,3389,1564,871,146400,75418
604,525,79,691,112300,75420
235,203,32,777,-,75421
1161,894,267,950,144400,75422
1146,933,213,863,138700,75423
1282,1083,199,1209,219100,75424
1704,1219,485,599,58500,75426
3742,1887,1855,882,109300,75428
0,0,0,-,-,75429
506,376,130,897,69000,75431
1082,823,259,804,119200,75432
1175,897,278,841,132300,75433
0,0,0,-,-,75434
471,325,146,536,68800,75435
749,563,186,492,156400,75436
434,397,37,1031,151900,75437
350,260,90,1550,117300,75438
417,213,204,936,91700,75439
2578,2064,514,843,178400,75440
102,94,8,-,65500,75441
3843,3051,792,1287,240600,75442
1377,1033,344,775,138100,75446
423,388,35,-,172700,75447
343,317,26,-,118800,75448
438,266,172,753,92400,75449
177,168,9,-,213400,75450
541,496,45,-,119500,75451
1484,1066,418,884,179200,75452
1046,883,163,1047,156700,75453
4705,4127,578,1922,325800,75454
9116,5881,3235,738,113500,75455
1936,1389,547,861,166400,75457
1988,1358,630,930,166900,75459
10235,5202,5033,766,93800,75460
4294,3244,1050,802,176300,75462
379,348,31,-,117000,75468
142,128,14,725,180300,75469
108,83,25,-,57500,75470
645,408,237,1071,117000,75471
1623,1225,398,847,131900,75472
1410,1324,86,-,143500,75473
5969,4713,1256,927,130200,75474
25,25,0,-,94200,75475
491,431,60,-,188800,75476
380,261,119,655,-,75477
317,241,76,877,111100,75478
730,584,146,857,138100,75479
739,739,0,-,226300,75480
145,136,9,-,142200,75481
9550,6225,3325,868,156000,75482
939,860,79,829,172000,75486
480,394,86,651,100600,75487
281,240,41,883,222900,75488
368,203,165,999,161200,75489
1025,870,155,1297,215000,75490
1859,1499,360,696,173600,75491
129,114,15,-,155700,75492
180,107,73,506,50700,75493
3812,3067,745,860,150700,75494
3043,2532,511,1084,275700,75495
1265,1008,257,838,148700,75496
1587,1352,235,768,165900,75497
13008,7626,5382,721,115800,75501
10214,6398,3816,1009,184400,75503
298,266,32,475,81900,75550
4283,3268,1015,817,126400,75551
837,713,124,667,130900,75554
668,577,91,635,75900,75555
414,295,119,825,81800,75556
640,640,0,-,80300,75558
2154,1494,660,621,97800,75559
432,347,85,1025,49700,75560
1932,1351,581,767,92100,75561
33,33,0,-,-,75562
1570,1151,419,586,100400,75563
0,0,0,-,-,75564
34,7,27,-,157500,75565
243,240,3,-,121900,75566
1601,1162,439,712,109900,75567
1223,851,372,793,95500,75568
1200,701,499,785,121600,75569
3166,2162,1004,710,103600,75570
973,897,76,651,98100,75571
1458,1111,347,636,57300,75572
68,19,49,907,"10,000-",75573
482,388,94,425,78200,75574
5714,3605,2109,825,156700,75601
7272,4839,2433,789,88200,75602
2632,2289,343,862,126800,75603
11638,6716,4922,890,151000,75604
14201,7701,6500,1026,199100,75605
1028,872,156,795,89900,75630
897,702,195,796,108300,75631
4811,3560,1251,721,128700,75633
1939,1454,485,648,94300,75638
918,833,85,-,116100,75639
2000,1557,443,881,216900,75640
45,25,20,-,-,75641
25,25,0,-,-,75642
867,707,160,718,125300,75643
4342,3065,1277,825,148100,75644
3901,3402,499,1040,163200,75645
4670,3330,1340,850,130100,75647
3239,2204,1035,1014,165400,75650
841,682,159,868,168300,75651
4015,2894,1121,924,165900,75652
4797,3747,1050,878,138100,75654
1649,1212,437,745,96300,75656
3026,2238,788,784,96800,75657
8,8,0,-,-,75658
0,0,0,-,-,75659
885,702,183,726,79400,75661
8510,6563,1947,918,130400,75662
528,417,111,891,85900,75667
967,626,341,821,129800,75668
261,261,0,-,114100,75669
6303,3761,2542,763,79700,75670
0,0,0,-,-,75671
5886,4713,1173,896,153700,75672
0,0,0,-,-,75680
1059,941,118,900,132100,75681
256,250,6,-,156900,75682
1450,1200,250,1010,100700,75683
2144,1802,342,935,116800,75684
4628,3549,1079,734,131100,75686
0,0,0,-,-,75687
56,54,2,-,-,75689
1500,1133,367,852,141100,75691
1813,1640,173,1144,124000,75692
2146,1509,637,1066,184600,75693
0,0,0,-,-,75694
12080,7141,4939,1006,150400,75701
8409,4385,4024,792,82600,75702
16830,8998,7832,1082,250300,75703
3091,2454,637,892,124900,75704
804,640,164,-,-,75705
3139,2419,720,718,95500,75706
5635,4378,1257,1235,199200,75707
3028,2311,717,820,127700,75708
2018,1157,861,1217,163100,75709
0,0,0,-,-,75711
1293,975,318,863,136400,75750
5776,3548,2228,837,123900,75751
2773,2453,320,872,145200,75752
2910,2302,608,954,203700,75754
1762,1102,660,878,124300,75755
1599,1177,422,1014,122400,75756
4967,4212,755,1087,207400,75757
3721,3019,702,878,108400,75758
33,31,2,-,-,75759
1118,915,203,585,137900,75760
5219,4302,917,1103,225000,75762
2334,2047,287,876,104500,75763
74,40,34,558,72900,75764
3059,2607,452,852,131300,75765
9562,6702,2860,776,115700,75766
1010,879,131,1003,185900,75770
7680,6352,1328,1124,213500,75771
5245,3833,1412,828,159900,75773
1038,772,266,876,111100,75778
0,0,0,-,-,75779
123,106,17,821,76400,75780
20,16,4,-,-,75782
3293,2825,468,820,131500,75783
217,191,26,854,118500,75784
3389,2562,827,819,120300,75785
28,0,28,-,-,75788
3128,2430,698,1017,165900,75789
1287,944,343,834,142600,75790
5005,3589,1416,1210,181800,75791
1046,803,243,1057,120000,75792
5930,3545,2385,868,125300,75801
5845,4159,1686,856,134900,75803
1871,1259,612,800,84300,75831
933,676,257,538,122000,75833
4411,2935,1476,723,129900,75835
143,112,31,-,169100,75838
1993,1574,419,953,99400,75839
2321,1717,604,721,157800,75840
1779,1265,514,726,113500,75844
939,702,237,681,76800,75845
1128,885,243,742,167300,75846
554,418,136,925,94800,75847
35,21,14,592,-,75848
43,27,16,825,80800,75849
499,446,53,-,161500,75850
840,710,130,881,122100,75851
467,406,61,953,110000,75852
343,301,42,-,208300,75853
1160,963,197,745,121900,75855
76,20,56,-,-,75856
31,17,14,-,-,75858
948,732,216,1218,163400,75859
1665,1432,233,736,102300,75860
731,409,322,773,84000,75861
4365,3113,1252,703,99700,75862
3,3,0,-,-,75865
0,0,0,-,-,75884
0,0,0,-,-,75886
10313,6782,3531,927,127800,75901
57,0,57,859,-,75903
12687,7649,5038,906,129700,75904
1316,816,500,730,91800,75925
522,416,106,691,93000,75926
420,376,44,-,64100,75928
603,442,161,678,145500,75929
690,596,94,1006,73400,75930
824,693,131,788,154100,75931
527,508,19,-,91400,75932
552,514,38,-,60800,75933
56,56,0,-,-,75934
4439,3362,1077,837,79900,75935
291,258,33,-,146200,75936
444,380,64,617,58900,75937
944,761,183,759,100800,75938
1604,1117,487,599,77900,75939
2484,1959,525,-,89300,75941
39,0,39,-,-,75942
421,359,62,1184,154200,75943
421,391,30,809,81900,75944
1466,1076,390,690,125400,75946
2570,2243,327,724,136800,75948
3290,2330,960,708,75100,75949
5691,4277,1414,825,104200,75951
1006,763,243,679,77900,75954
3167,2514,653,718,123500,75956
245,215,30,-,134200,75959
205,198,7,-,115500,75960
6276,2979,3297,819,122400,75961
0,0,0,-,-,75962
6775,4331,2444,818,96700,75964
7619,3898,3721,808,195800,75965
1540,1055,485,759,87200,75966
855,673,182,568,78600,75968
1434,1187,247,1132,141600,75969
2492,1825,667,644,70200,75972
1111,927,184,874,101300,75973
1194,841,353,430,82000,75974
1319,971,348,714,124300,75975
347,216,131,678,52900,75976
158,121,37,843,62600,75977
3519,2702,817,826,86800,75979
1009,862,147,869,72700,75980
11238,8883,2355,1593,252600,76001
9625,8121,1504,1873,229400,76002
1267,1210,57,-,386100,76005
12127,2946,9181,1131,259400,76006
7224,6633,591,1461,365700,76008
6814,5251,1563,1070,136200,76009
17995,5966,12029,1045,142000,76010
9863,1972,7891,1084,174700,76011
10905,6870,4035,1155,241900,76012
13098,6415,6683,1083,231800,76013
10639,5065,5574,1265,158100,76014
6226,2975,3251,1296,179800,76015
11043,8965,2078,1698,238400,76016
15906,10682,5224,1258,215500,76017
8375,6237,2138,1650,177500,76018
11697,9294,2403,1032,200700,76020
14596,7890,6706,1216,279400,76021
5717,2834,2883,1247,202700,76022
2430,2100,330,1101,220200,76023
25330,19229,6101,1476,230800,76028
6163,4748,1415,965,150600,76031
9925,6511,3414,1102,161700,76033
9002,8563,439,2549,586200,76034
897,715,182,1192,282900,76035
9607,7114,2493,1528,215100,76036
17165,6656,10509,1428,250700,76039
11623,4868,6755,1007,224000,76040
173,173,0,-,111000,76041
2410,1903,507,686,231900,76043
2331,2017,314,965,305100,76044
10566,7428,3138,1036,165200,76048
11845,10485,1360,1251,245800,76049
2483,1967,516,1058,183700,76050
20488,10638,9850,1590,368000,76051
8180,7450,730,1723,307900,76052
11202,6132,5070,1169,189700,76053
4650,3822,828,1315,281700,76054
1126,858,268,846,126400,76055
7054,5142,1912,1126,147100,76058
1589,609,980,855,142200,76059
2908,2121,787,1114,269900,76060
79,79,0,-,-,76061
24778,18833,5945,1474,302200,76063
702,411,291,1294,199500,76064
13446,11106,2340,1371,295700,76065
1547,1266,281,-,311000,76066
7037,4820,2217,849,119600,76067
307,307,0,-,-,76070
1346,1069,277,961,214300,76071
2231,1892,339,1033,192200,76073
183,183,0,-,196500,76077
2974,2446,528,1255,207800,76078
7281,6088,1193,1068,184000,76082
2967,2615,352,971,178200,76084
3695,3272,423,1305,266100,76085
8301,4420,3881,1107,164800,76086
10920,9835,1085,1255,284300,76087
5154,4296,858,1068,277600,76088
9454,9030,424,1497,725300,76092
1291,922,369,992,88600,76093
3897,961,2936,1422,276700,76102
5364,3322,2042,990,143500,76103
7178,2898,4280,1109,102600,76104
6934,3741,3193,940,84500,76105
10809,5154,5655,1025,98200,76106
15053,7058,7995,1265,346400,76107
16071,10934,5137,1221,180000,76108
9528,5025,4503,1365,526500,76109
11280,6718,4562,1094,168000,76110
7298,4222,3076,1070,126200,76111
17012,8226,8786,1044,154300,76112
9572,5359,4213,1040,131600,76114
6125,2880,3245,980,95100,76115
22075,7624,14451,1056,250700,76116
10991,5927,5064,1026,141400,76117
5740,4066,1674,1226,217100,76118
14645,7593,7052,1050,98200,76119
7592,3852,3740,1134,219000,76120
11887,8963,2924,1856,206800,76123
8922,7343,1579,1395,251900,76126
45,0,45,1809,-,76127
0,0,0,-,-,76129
15471,11931,3540,1556,240700,76131
12615,3991,8624,1158,325800,76132
19012,11572,7440,1214,168500,76133
9800,5742,4058,1107,156200,76134
7682,5203,2479,1067,188500,76135
21343,12900,8443,1429,218800,76137
9767,6598,3169,1194,147200,76140
7965,6418,1547,1576,165500,76148
3354,37,3317,1197,-,76155
4283,2458,1825,987,95000,76164
7730,3925,3805,1557,265800,76177
23515,18079,5436,1639,242300,76179
14909,7508,7401,1238,221900,76180
11294,9484,1810,1423,287000,76182
11076,2160,8916,989,207200,76201
0,0,0,-,-,76203
7612,2816,4796,1150,251800,76205
6254,3981,2273,1317,284800,76207
8281,5483,2798,1361,285200,76208
10316,4617,5699,1206,204100,76209
15670,11834,3836,1553,276300,76210
1271,1054,217,851,199800,76225
11659,10860,799,2356,435000,76226
15459,12086,3373,1656,280500,76227
488,395,93,914,87700,76228
3972,3169,803,886,148700,76230
1257,923,334,984,186300,76233
6671,5190,1481,1181,245800,76234
124,103,21,-,108800,76238
483,357,126,736,184600,76239
11487,7256,4231,1016,155800,76240
4,4,0,-,-,76241
23997,18217,5780,1646,276400,76244
808,609,199,716,117000,76245
5496,4703,793,1692,250000,76247
14267,11576,2691,1763,419700,76248
3256,2784,472,1324,218300,76249
418,373,45,1057,198000,76250
241,198,43,1238,164800,76251
935,751,184,958,219400,76252
105,98,7,-,-,76253
2174,1515,659,676,122500,76255
2650,1926,724,994,281100,76258
2078,1681,397,1051,230400,76259
90,61,29,-,51000,76261
14188,10420,3768,1403,410100,76262
4,4,0,-,-,76263
539,425,114,773,164300,76264
609,459,150,736,120300,76265
6339,5107,1232,1298,245100,76266
13,0,13,-,-,76267
49,36,13,-,-,76268
682,658,24,-,212800,76270
652,526,126,1554,278400,76271
1788,1580,208,706,232800,76272
3814,2815,999,1012,195100,76273
6060,3036,3024,706,57100,76301
4893,2925,1968,893,112700,76302
1923,1522,401,715,134100,76305
5634,3098,2536,813,86100,76306
8327,4658,3669,922,157500,76308
5617,3414,2203,861,98300,76309
7514,5597,1917,965,153600,76310
636,6,630,1307,-,76311
790,575,215,560,88500,76351
4823,3156,1667,816,117800,76354
191,156,35,738,83800,76357
1205,876,329,540,48600,76360
105,99,6,-,-,76363
89,48,41,1575,62500,76364
1822,1414,408,672,113100,76365
804,657,147,827,119800,76366
3918,3340,578,1125,113000,76367
158,133,25,-,55000,76370
562,497,65,-,49100,76371
397,285,112,555,65000,76372
61,54,7,-,-,76373
1607,1075,532,658,72500,76374
206,173,33,575,68400,76377
186,137,49,905,108000,76379
1518,1040,478,529,73500,76380
4354,2728,1626,745,77200,76384
88,65,23,788,52500,76388
511,438,73,678,153700,76389
10806,5994,4812,1009,186900,76401
0,0,0,-,-,76402
3081,2363,718,751,76900,76424
3864,2782,1082,937,169500,76426
348,201,147,850,100600,76427
78,78,0,-,166700,76429
944,794,150,-,148800,76430
1577,1353,224,1132,150500,76431
430,393,37,708,103800,76432
691,609,82,1196,322000,76433
188,173,15,950,81300,76435
54,47,7,-,-,76436
2005,1603,402,679,101500,76437
0,0,0,-,-,76439
2825,2374,451,610,111600,76442
809,571,238,495,98600,76443
1366,1059,307,494,75700,76444
73,73,0,-,-,76445
3113,2637,476,870,140800,76446
2058,1482,576,708,150100,76448
1029,887,142,736,203000,76449
5399,4031,1368,755,158400,76450
53,53,0,-,1021600,76452
680,585,95,891,250900,76453
664,411,253,586,74700,76454
332,304,28,660,86100,76455
1478,1134,344,818,137700,76457
2003,1433,570,753,98800,76458
52,52,0,-,70600,76459
144,101,43,-,123000,76460
1557,1360,197,1289,200000,76462
204,172,32,715,68800,76463
197,171,26,808,91300,76464
99,75,24,-,-,76466
40,40,0,-,60000,76469
1379,913,466,755,52400,76470
646,494,152,577,56300,76471
474,372,102,876,125000,76472
104,100,4,-,319600,76474
391,294,97,663,78500,76475
1166,980,186,996,168300,76476
70,56,14,-,-,76481
383,275,108,-,57800,76483
281,260,21,717,161200,76484
431,359,72,589,268400,76486
931,794,137,2121,157500,76487
31,15,16,-,-,76490
185,140,45,721,85200,76491
6595,4117,2478,773,120400,76501
16488,11066,5422,1174,183700,76502
9722,3255,6467,929,114400,76504
872,684,188,689,120600,76511
14535,9580,4955,993,189700,76513
522,390,132,615,145000,76518
127,127,0,-,-,76519
2815,1928,887,805,113300,76520
14682,9063,5619,913,132400,76522
111,104,7,-,157100,76523
1292,1026,266,1124,162400,76524
461,348,113,691,115000,76525
1583,1047,536,779,306900,76527
6762,4816,1946,765,134400,76528
966,782,184,775,171900,76530
1461,1192,269,766,129300,76531
1108,887,221,890,168900,76534
3474,2820,654,1492,205600,76537
471,410,61,-,125800,76538
3189,2895,294,830,200900,76539
7908,1959,5949,741,76400,76541
18486,10823,7663,1150,170500,76542
12893,4932,7961,938,102400,76543
3291,43,3248,1195,-,76544
11250,6249,5001,965,206300,76548
18619,9235,9384,1167,161200,76549
5097,3783,1314,792,167200,76550
840,612,228,984,145600,76554
716,641,75,439,104000,76556
2089,1623,466,915,161800,76557
2369,1537,832,1020,153100,76559
442,329,113,834,111100,76561
52,52,0,-,266700,76565
125,121,4,-,235000,76566
3717,2637,1080,793,128200,76567
894,782,112,1025,94700,76569
904,714,190,642,69500,76570
3394,2882,512,1064,295500,76571
12,12,0,-,-,76573
7438,5370,2068,942,192500,76574
1255,969,286,826,144700,76577
544,425,119,966,209700,76578
2086,1383,703,873,146500,76579
0,0,0,-,-,76596
0,0,0,-,-,76597
0,0,0,-,-,76598
0,0,0,-,-,76599
366,347,19,1063,205400,76621
546,463,83,800,165800,76622
69,52,17,-,-,76623
876,773,103,767,129300,76624
491,373,118,1022,110100,76626
572,511,61,1068,96500,76627
33,33,0,-,-,76628
758,585,173,797,113500,76629
664,589,75,874,205400,76630
170,128,42,935,101800,76631
534,424,110,-,87700,76632
1989,1884,105,914,250400,76633
2838,2199,639,822,148400,76634
498,373,125,693,91900,76635
540,470,70,628,177200,76636
181,126,55,488,240000,76637
1066,983,83,1154,264400,76638
676,431,245,541,100600,76639
1136,829,307,908,125400,76640
602,515,87,690,112200,76641
2105,1520,585,704,164400,76642
5655,3840,1815,1293,188700,76643
3859,2332,1527,840,104800,76645
997,724,273,761,88200,76648
276,229,47,930,125600,76649
48,42,6,-,103600,76650
1467,1013,454,965,154300,76651
449,386,63,686,158700,76652
533,427,106,-,133700,76653
82,66,16,-,142900,76654
2946,2580,366,1149,224400,76655
860,658,202,808,102100,76656
4013,2997,1016,1152,306500,76657
200,146,54,845,100000,76660
2145,1337,808,452,48400,76661
1280,934,346,909,106100,76664
1117,699,418,600,111900,76665
66,42,24,-,85000,76666
3701,2685,1016,692,88400,76667
538,386,152,867,114500,76670
647,543,104,688,158100,76671
377,312,65,795,108700,76673
104,99,5,-,116100,76676
43,43,0,-,95500,76678
330,323,7,-,113600,76679
34,34,0,-,-,76680
211,154,57,1115,91400,76681
1077,889,188,997,111800,76682
28,28,0,-,-,76685
104,75,29,894,91300,76686
827,713,114,919,228500,76687
1446,1129,317,978,149100,76689
413,318,95,892,102300,76690
2427,1904,523,890,158400,76691
3839,2981,858,739,112100,76692
808,580,228,699,133800,76693
759,148,611,1195,115000,76701
3287,1037,2250,696,106900,76704
11109,6232,4877,784,125900,76705
14079,5575,8504,903,137900,76706
5808,3013,2795,929,85600,76707
9508,5967,3541,925,154500,76708
10705,5287,5418,919,171700,76710
3894,2030,1864,1180,78700,76711
10264,7056,3208,1164,231800,76712
0,0,0,-,-,76798
9477,6196,3281,826,104800,76801
2141,1719,422,963,142400,76802
61,50,11,-,329200,76820
1759,1306,453,925,81400,76821
993,792,201,611,91400,76823
0,0,0,-,-,76824
2610,1744,866,812,79900,76825
283,261,22,675,157300,76827
99,99,0,-,-,76828
0,0,0,-,-,76831
194,114,80,1033,112500,76832
2103,1485,618,719,80700,76834
2,2,0,-,-,76836
417,313,104,721,75300,76837
12,0,12,-,-,76841
89,89,0,-,152500,76842
1227,1032,195,625,146700,76844
101,86,15,-,259500,76845
39,39,0,-,1055000,76848
1465,1131,334,636,124500,76849
136,114,22,631,191300,76852
538,404,134,850,164800,76853
110,23,87,-,-,76854
1307,1029,278,594,229500,76856
926,655,271,1319,-,76857
112,102,10,-,65000,76858
934,676,258,593,85100,76859
654,504,150,803,132900,76861
83,81,2,-,-,76862
314,289,25,675,232000,76864
86,81,5,-,92400,76865
208,184,24,859,134100,76866
41,41,0,-,-,76869
20,16,4,-,257100,76870
230,183,47,1075,157700,76871
287,231,56,729,136300,76872
50,43,7,-,826600,76873
0,0,0,-,-,76874
249,216,33,863,138300,76875
1467,1091,376,782,117200,76877
607,443,164,438,64700,76878
0,0,0,-,-,76880
96,80,16,-,214000,76882
18,14,4,-,-,76884
52,33,19,-,86100,76885
53,43,10,-,-,76887
75,45,30,-,-,76888
357,295,62,721,116100,76890
12181,8772,3409,981,141300,76901
0,0,0,-,-,76902
11805,7323,4482,810,90100,76903
14828,9175,5653,920,211300,76904
4606,3152,1454,1181,142300,76905
0,0,0,-,-,76908
0,0,0,-,-,76909
33,33,0,-,84500,76930
1055,722,333,914,100400,76932
492,350,142,782,107600,76933
295,259,36,860,66400,76934
666,666,0,-,273400,76935
883,746,137,489,89300,76936
37,35,2,-,108800,76937
0,0,0,-,-,76939
0,0,0,-,-,76940
599,488,111,995,111200,76941
1274,792,482,547,122000,76943
780,540,240,339,63600,76945
1128,769,359,659,130100,76950
397,357,40,906,78900,76951
35,26,9,-,-,76953
89,80,9,-,177500,76955
46,10,36,-,-,76957
91,86,5,-,187500,76958
5971,672,5299,1601,236200,77002
5140,2278,2862,1439,308800,77003
14740,5095,9645,1119,334700,77004
9973,7075,2898,1845,1155700,77005
13345,4741,8604,1512,525300,77006
21209,10877,10332,1780,443800,77007
17500,11046,6454,1341,474500,77008
14745,8365,6380,995,321000,77009
536,25,511,3293,-,77010
6152,3079,3073,749,137900,77011
5942,2186,3756,822,92100,77012
5978,2529,3449,1003,110700,77013
11862,6081,5781,1048,163300,77014
18110,9514,8596,1035,124800,77015
9790,6083,3707,993,85500,77016
10440,5125,5315,968,113500,77017
11641,8011,3630,1034,442100,77018
11326,5197,6129,1722,663200,77019
8885,4413,4472,812,95500,77020
10542,3906,6636,1037,129100,77021
9097,4278,4819,878,144700,77022
10306,4705,5601,917,171800,77023
15846,9386,6460,1601,1080300,77024
13601,5478,8123,1378,462600,77025
7898,3410,4488,777,76700,77026
10887,3199,7688,1623,780200,77027
6288,3520,2768,982,81100,77028
5461,3763,1698,892,85500,77029
5358,2177,3181,1500,639800,77030
5959,2579,3380,973,178600,77031
4336,1705,2631,1017,91700,77032
9253,5530,3723,1035,72700,77033
12243,5809,6434,1062,136300,77034
13788,5836,7952,959,233800,77035
25658,4645,21013,892,171200,77036
5149,3695,1454,901,114600,77037
8897,5013,3884,1094,140000,77038
7931,4445,3486,998,109900,77039
18537,9660,8877,1177,175100,77040
10984,8072,2912,1557,223000,77041
18836,5091,13745,1103,296900,77042
9804,5616,4188,1240,304300,77043
15712,12184,3528,1632,223600,77044
10053,6079,3974,1187,106500,77045
751,371,380,1746,-,77046
11891,8611,3280,1379,167200,77047
6561,3526,3035,1072,114200,77048
11422,7924,3498,1258,165500,77049
1663,965,698,952,85100,77050
6570,2963,3607,950,112500,77051
9175,6498,2677,1389,113600,77053
14448,1672,12776,1270,149900,77054
15758,7199,8559,1092,494500,77055
11805,4497,7308,1731,721700,77056
20858,6677,14181,1184,313400,77057
9265,2777,6488,1145,202700,77058
6239,5719,520,1408,322200,77059
14720,3426,11294,895,109400,77060
9147,3410,5737,846,164600,77061
9442,7205,2237,1160,231800,77062
19672,4561,15111,1180,239400,77063
15654,9746,5908,1316,187400,77064
15937,7039,8898,1184,203600,77065
11855,8612,3243,1347,173400,77066
10005,4425,5580,977,141000,77067
3747,2629,1118,1124,232500,77068
8313,4939,3374,1225,283800,77069
21474,10377,11097,1369,212700,77070
9903,5162,4741,977,173300,77071
18997,8431,10566,1094,133200,77072
13288,8286,5002,1108,159100,77073
12941,4314,8627,955,156700,77074
12287,7235,5052,1101,175500,77075
9801,4832,4969,1022,111900,77076
29031,10274,18757,1264,314600,77077
4625,2800,1825,1076,102900,77078
13372,7206,6166,1405,557900,77079
15248,7138,8110,1111,262700,77080
18515,1197,17318,895,335800,77081
21398,8012,13386,1168,181300,77082
23129,14852,8277,1190,171400,77083
34699,21208,13491,1330,183900,77084
5500,3729,1771,1146,139200,77085
8660,4910,3750,1051,144900,77086
11344,6228,5116,844,108200,77087
17164,11072,6092,1019,129300,77088
18118,12662,5456,1250,183100,77089
16174,3978,12196,1067,170000,77090
11113,4036,7077,923,146900,77091
14368,5467,8901,1035,199600,77092
13476,7920,5556,907,92100,77093
3977,3314,663,1623,394700,77094
24622,17813,6809,1419,233600,77095
12819,6381,6438,1079,364900,77096
8541,2754,5787,1743,656200,77098
16046,5742,10304,1061,139000,77099
0,0,0,-,-,77204
10473,5965,4508,1060,143500,77301
6394,5172,1222,1250,209200,77302
7595,5619,1976,1117,168000,77303
14903,8901,6002,1195,249300,77304
5069,4328,741,777,129800,77306
9754,8742,1012,1271,351700,77316
6994,5588,1406,987,231000,77318
9813,6095,3718,960,165400,77320
63,63,0,-,157500,77326
9334,7393,1941,813,113800,77327
5891,4307,1584,960,126300,77328
2930,2435,495,812,169300,77331
23,0,23,-,-,77334
906,786,120,825,103900,77335
4142,3201,941,1138,219100,77336
16315,8652,7663,1135,165200,77338
17063,10014,7049,1470,222800,77339
11979,5050,6929,899,175500,77340
0,0,0,-,-,77341
0,0,0,-,-,77342
9209,8155,1054,1694,311500,77345
22385,18876,3509,1482,228900,77346
40,29,11,-,-,77350
11726,9137,2589,879,140800,77351
12789,10185,2604,1339,287800,77354
10032,8636,1396,1220,260500,77355
12040,10250,1790,1432,292700,77356
9258,7050,2208,1076,148200,77357
1963,1547,416,596,159400,77358
82,27,55,-,-,77359
2350,1878,472,940,103300,77360
2156,1902,254,1249,189800,77362
1227,1053,174,985,229200,77363
1048,934,114,819,123300,77364
12145,10345,1800,1169,222200,77365
176,106,70,1352,203200,77367
0,0,0,-,-,77368
215,166,49,-,-,77369
2154,1597,557,811,89900,77371
4157,3574,583,1141,154200,77372
21156,15118,6038,1545,170100,77373
199,179,20,-,48200,77374
22022,15584,6438,1294,228600,77375
309,303,6,-,-,77376
12618,10509,2109,1551,277600,77377
5538,4338,1200,1121,150900,77378
27746,21549,6197,1370,271700,77379
13980,4852,9128,1395,297700,77380
13441,10556,2885,1564,359100,77381
13149,10459,2690,1794,446200,77382
9135,5209,3926,1250,342500,77384
8464,6754,1710,1476,235700,77385
20228,15970,4258,1663,266200,77386
17511,12468,5043,1647,218400,77388
13448,10790,2658,1723,325200,77389
19482,12884,6598,1308,173000,77396
6256,5557,699,2175,855600,77401
19349,16468,2881,1549,323400,77406
20776,16141,4635,1585,281600,77407
0,0,0,-,-,77412
9279,5885,3394,923,143700,77414
110,70,40,-,117900,77415
780,489,291,859,88200,77417
3814,2840,974,725,264300,77418
294,278,16,-,122800,77419
835,613,222,857,160400,77420
4955,4248,707,1028,166300,77422
4177,3414,763,1078,236800,77423
788,559,229,1309,293800,77426
0,0,0,-,-,77428
29886,25162,4724,1416,275000,77429
665,643,22,-,210100,77430
241,241,0,-,-,77431
0,0,0,-,-,77432
30506,24570,5936,1680,318000,77433
1256,1007,249,812,58200,77434
1484,1207,277,933,207200,77435
0,0,0,-,-,77436
6580,4202,2378,845,155100,77437
51,16,35,-,-,77440
7108,6745,363,1739,453700,77441
252,167,85,663,156700,77442
62,0,62,-,-,77443
309,276,33,-,-,77444
5398,3201,2197,989,203600,77445
650,83,567,967,226600,77446
5964,5195,769,1354,235700,77447
72,16,56,-,-,77448
37043,25936,11107,1616,180200,77449
24737,17443,7294,1445,275200,77450
193,145,48,950,103600,77451
50,0,50,-,-,77453
0,0,0,-,-,77454
679,578,101,936,154400,77455
366,290,76,850,137700,77456
257,209,48,694,-,77457
36,12,24,-,-,77458
24974,20989,3985,1874,310900,77459
33,33,0,-,-,77460
3878,2905,973,1042,230400,77461
164,80,84,1080,146200,77464
2638,2069,569,685,113700,77465
190,136,54,-,214900,77466
0,0,0,-,-,77467
0,0,0,-,-,77468
19346,15570,3776,1199,248300,77469
178,143,35,-,-,77470
14862,8258,6604,1153,186800,77471
13,13,0,-,-,77473
5607,4682,925,1031,190700,77474
331,310,21,-,184300,77475
99,83,16,-,327000,77476
12850,5500,7350,1321,189900,77477
8777,6613,2164,1630,331000,77478
28515,23935,4580,1944,391500,77479
2851,2361,490,952,143100,77480
116,27,89,-,257500,77481
498,414,84,-,152000,77482
133,133,0,-,144600,77483
4524,3147,1377,1033,230100,77484
1464,1002,462,842,155300,77485
2682,1901,781,1129,182200,77486
5241,3308,1933,825,152900,77488
12720,9567,3153,1534,150700,77489
14876,12216,2660,1533,252000,77493
40280,29747,10533,1833,367600,77494
16423,11545,4878,1614,227200,77498
10845,6957,3888,1054,126100,77502
8005,4131,3874,1014,118100,77503
9064,3728,5336,1060,160200,77504
7848,5438,2410,1345,221300,77505
10434,3971,6463,932,89300,77506
240,0,240,1446,-,77507
5214,4387,827,929,222000,77510
16869,11600,5269,1142,168900,77511
2106,1746,360,1045,139600,77514
11596,8163,3433,1023,164900,77515
2126,1976,150,-,221400,77517
3544,2127,1417,1069,146900,77518
232,208,24,-,51500,77519
12833,7213,5620,1016,108500,77520
21895,13350,8545,1145,175500,77521
8554,7032,1522,1160,304300,77523
9052,6447,2605,953,126000,77530
6005,3429,2576,1128,168800,77531
10710,8722,1988,1006,195500,77532
379,287,92,865,81700,77533
902,827,75,1051,192000,77534
10551,9002,1549,947,161700,77535
11485,8818,2667,1190,190800,77536
276,249,27,-,142000,77538
16961,12842,4119,1217,194600,77539
6523,4370,2153,1016,113700,77541
8199,6766,1433,1817,209100,77545
18608,14004,4604,1574,282400,77546
2671,1859,812,1033,83300,77547
10940,4598,6342,971,195100,77550
9311,4374,4937,1131,202400,77551
4212,2810,1402,1251,316000,77554
0,0,0,-,-,77555
339,309,30,-,-,77560
8,8,0,-,-,77561
3565,2734,831,881,158100,77562
4162,3088,1074,1047,179700,77563
634,611,23,-,110400,77564
2948,1753,1195,1415,290800,77565
11295,7384,3911,1326,216300,77566
7287,5470,1817,1017,149600,77568
13157,9560,3597,1200,168200,77571
34240,25918,8322,1510,280800,77573
5602,4248,1354,781,145300,77575
480,447,33,850,201800,77577
8103,6615,1488,1325,293800,77578
0,0,0,-,-,77580
17078,13355,3723,1324,260600,77581
174,174,0,-,-,77582
10883,9746,1137,994,232600,77583
29822,22336,7486,1564,277900,77584
422,383,39,-,-,77585
9040,6073,2967,1342,270800,77586
4880,2635,2245,1048,129900,77587
12764,6619,6145,1035,132800,77590
5687,2982,2705,1088,152000,77591
174,148,26,-,-,77597
12214,2513,9701,1153,172500,77598
3375,2571,804,874,166000,77611
3591,3190,401,600,88400,77612
385,333,52,1034,158600,77613
247,186,61,-,111500,77614
133,100,33,1025,81400,77615
84,84,0,-,-,77616
32,24,8,-,-,77617
5964,4425,1539,1054,126600,77619
509,455,54,-,181100,77622
290,269,21,-,80500,77623
238,230,8,-,136800,77624
3014,2462,552,872,89300,77625
8654,6387,2267,1128,152400,77627
336,323,13,-,114200,77629
10432,7131,3301,904,129600,77630
8034,6439,1595,922,148300,77632
6716,4456,2260,972,71300,77640
13526,7047,6479,815,82500,77642
1116,985,131,-,279600,77650
4900,3813,1087,1035,183700,77651
163,152,11,-,120700,77655
6102,4868,1234,841,104100,77656
7951,6626,1325,872,185100,77657
1901,1615,286,944,163000,77659
419,377,42,-,123200,77660
139,86,53,-,-,77661
9543,7910,1633,774,107000,77662
386,234,152,-,190800,77663
912,792,120,482,147200,77664
2008,1604,404,847,147600,77665
4610,2329,2281,836,59400,77701
1470,819,651,910,142500,77702
4333,2135,2198,784,78000,77703
10760,6231,4529,726,102700,77705
12857,7354,5503,960,193100,77706
6293,4453,1840,973,135500,77707
5256,2620,2636,909,138200,77708
5620,3481,2139,1173,172100,77713
5879,775,5104,883,124000,77801
10993,5838,5155,1106,189000,77802
9635,5819,3816,972,103000,77803
4332,2667,1665,1144,193900,77807
5531,5166,365,1041,278400,77808
1125,959,166,856,299300,77830
1134,964,170,833,79100,77831
10945,7698,3247,1023,198100,77833
1318,1094,224,1319,285200,77835
4696,3702,994,719,154800,77836
596,430,166,832,95500,77837
19972,2247,17725,964,210800,77840
0,0,0,-,-,77843
27033,17911,9122,1211,285700,77845
0,0,0,-,-,77852
471,384,87,738,109500,77853
21,21,0,-,-,77855
1608,1225,383,794,203500,77856
401,352,49,1050,233300,77857
2839,2049,790,696,107200,77859
841,724,117,775,207600,77861
29,0,29,-,-,77863
2535,1872,663,716,114300,77864
704,577,127,1098,120500,77865
0,0,0,-,-,77866
97,93,4,-,"10,000-",77867
5467,3632,1835,736,166600,77868
1188,890,298,667,163200,77871
755,620,135,911,139800,77872
515,479,36,486,159200,77873
12,12,0,-,-,77875
55,55,0,-,-,77876
236,144,92,638,-,77878
2197,1684,513,787,101800,77879
905,831,74,-,253500,77880
14,14,0,-,-,77882
14916,8275,6641,951,112500,77901
11118,7859,3259,1075,203600,77904
6307,5112,1195,1106,152900,77905
73,60,13,-,82000,77950
564,413,151,633,52200,77951
3348,2152,1196,852,156500,77954
3070,2208,862,854,100500,77957
37,37,0,-,-,77960
133,71,62,-,-,77961
1124,783,341,797,159300,77962
1888,1474,414,646,151100,77963
3165,2209,956,832,202100,77964
1117,947,170,736,255400,77968
60,60,0,-,-,77969
111,69,42,777,59500,77970
297,226,71,-,178200,77971
11,0,11,-,-,77973
190,125,65,1106,158100,77974
646,458,188,841,160300,77975
19,19,0,-,177500,77976
273,250,23,-,46700,77977
188,97,91,971,79800,77978
6237,4674,1563,795,120100,77979
433,337,96,-,215500,77982
877,708,169,1073,116500,77983
1625,1403,222,825,175700,77984
9,9,0,-,-,77986
79,70,9,-,-,77987
44,44,0,-,36900,77988
331,279,52,950,75600,77990
90,71,19,-,116800,77991
42,42,0,-,-,77993
132,105,27,-,-,77994
3887,2928,959,769,138000,77995
0,0,0,-,-,78001
2447,1787,660,985,123400,78002
3679,3154,525,947,205700,78003
177,153,24,-,460900,78004
828,454,374,-,312100,78005
14831,11052,3779,1377,397000,78006
42,33,9,675,-,78007
121,75,46,-,-,78008
2653,2249,404,1045,223000,78009
1535,1149,386,-,185300,78010
578,537,41,-,49100,78011
109,73,36,-,76900,78012
2156,1798,358,917,285400,78013
1531,1142,389,906,79700,78014
7364,6822,542,1411,428700,78015
3508,2475,1033,763,128400,78016
941,656,285,492,92700,78017
420,377,43,-,90900,78019
3,3,0,-,-,78021
1576,1214,362,807,123400,78022
9465,8498,967,1651,326600,78023
514,387,127,851,430600,78024
2143,1594,549,896,162400,78025
2520,1661,859,862,113200,78026
169,169,0,-,229700,78027
16905,11108,5797,1002,213700,78028
0,0,0,-,-,78029
875,765,110,875,67000,78039
11316,4894,6422,780,85400,78040
14740,7570,7170,867,169400,78041
12728,6782,5946,890,117700,78043
134,104,30,-,217600,78044
19986,15235,4751,1197,188500,78045
16935,12883,4052,895,108700,78046
173,136,37,-,75000,78050
1998,1710,288,940,112800,78052
754,682,72,-,242900,78055
862,785,77,-,434900,78056
496,496,0,-,635300,78057
387,350,37,-,338100,78058
1996,1830,166,843,156900,78059
2588,1623,965,830,85400,78061
0,0,0,-,-,78062
3749,3407,342,1283,219500,78063
5190,3884,1306,1071,164300,78064
3583,2823,760,788,100200,78065
245,233,12,-,171300,78066
186,186,0,-,81900,78067
1897,1623,274,753,118500,78069
6718,6231,487,1146,335600,78070
1008,728,280,794,141200,78071
122,102,20,1250,83000,78072
2770,2214,556,933,106100,78073
44,44,0,-,-,78074
94,62,32,-,109400,78075
4191,3060,1131,506,83000,78076
3188,2902,286,704,223800,78101
7087,4696,2391,900,100800,78102
31,0,31,855,-,78104
220,153,67,-,63700,78107
13889,11801,2088,1815,247200,78108
16409,12200,4209,1376,183500,78109
0,0,0,-,-,78111
3151,2795,356,1057,104200,78112
1095,882,213,927,217100,78113
8002,6684,1318,965,218100,78114
116,116,0,-,278600,78116
301,279,22,-,311400,78117
1241,898,343,789,87800,78118
1822,1127,695,825,91300,78119
4755,4304,451,1111,278500,78121
157,144,13,-,181300,78122
1028,925,103,921,190100,78123
2574,2350,224,1034,197200,78124
10,10,0,-,-,78125
32258,20333,11925,1302,232200,78130
12813,10938,1875,1249,425500,78132
8912,7643,1269,1061,232200,78133
1240,857,383,854,81000,78140
347,286,61,850,67100,78141
34,29,5,-,-,78142
55,55,0,-,151300,78143
18,0,18,-,-,78144
26,16,10,-,24400,78145
211,99,112,937,122500,78146
546,340,206,955,144600,78147
8170,4097,4073,1126,197700,78148
0,0,0,-,-,78150
612,382,230,-,95200,78151
926,905,21,1375,247100,78152
14512,10114,4398,1417,232500,78154
18594,13242,5352,998,179200,78155
306,234,72,788,49900,78159
1775,1539,236,921,165600,78160
196,185,11,-,-,78161
132,83,49,-,159800,78162
5141,4903,238,1380,357700,78163
1390,1133,257,791,173600,78164
17249,8056,9193,907,137000,78201
4245,2044,2201,891,116300,78202
2285,1145,1140,808,98000,78203
4727,2204,2523,1165,98500,78204
1118,58,1060,1081,554100,78205
16488,7311,9177,731,72100,78207
1817,607,1210,792,109100,78208
19257,9308,9949,1188,404000,78209
12187,6988,5199,955,119200,78210
9702,6187,3515,930,82200,78211
11670,5212,6458,948,227300,78212
16940,8215,8725,1006,159900,78213
8174,4732,3442,851,91500,78214
2121,154,1967,1624,-,78215
19294,6525,12769,1048,231700,78216
14597,6180,8417,1032,161200,78217
13630,6472,7158,1007,135300,78218
5524,2849,2675,975,112300,78219
5635,3173,2462,1025,89600,78220
13185,8669,4516,969,107600,78221
7884,5393,2491,1085,147600,78222
19398,11023,8375,910,115500,78223
6231,3428,2803,974,110400,78224
5173,3518,1655,892,87400,78225
2324,887,1437,838,89500,78226
15192,8642,6550,947,109300,78227
19593,11355,8238,889,118600,78228
16492,2463,14029,1088,151200,78229
19217,9225,9992,1134,281100,78230
3841,2634,1207,1146,333200,78231
15202,8723,6479,1286,276800,78232
17579,10625,6954,1300,158700,78233
945,3,942,1838,-,78234
1156,0,1156,1238,-,78235
470,0,470,1812,-,78236
12450,7850,4600,849,77600,78237
10306,4955,5351,993,153800,78238
9892,7115,2777,1175,163200,78239
24089,8633,15456,1160,194000,78240
10105,5447,4658,985,92200,78242
0,0,0,-,-,78243
11958,8543,3415,1357,150500,78244
28417,20544,7873,1326,183800,78245
18466,14112,4354,1297,197000,78247
5717,3972,1745,1227,375300,78248
21969,11278,10691,1292,223200,78249
19931,14672,5259,1307,174100,78250
21540,11127,10413,1194,193500,78251
4121,3481,640,1384,172200,78252
19330,15340,3990,1297,268600,78253
22486,18529,3957,1488,232700,78254
6020,5135,885,1446,382200,78255
4799,1491,3308,1356,446200,78256
4881,1914,2967,1475,436000,78257
18077,10956,7121,1440,365600,78258
9940,6787,3153,1293,295100,78259
11365,10170,1195,1905,360000,78260
8515,7039,1476,1416,338300,78261
1877,1589,288,1116,217800,78263
3926,3265,661,1050,111000,78264
2706,2576,130,2214,440600,78266
216,193,23,1042,78400,78330
8913,5922,2991,797,78500,78332
4533,3036,1497,943,146900,78336
0,0,0,-,-,78338
135,135,0,-,65200,78339
189,168,21,1125,131300,78340
383,241,142,840,66000,78341
74,39,35,-,-,78342
1632,1404,228,855,94100,78343
139,125,14,-,77300,78344
24,24,0,-,-,78347
161,159,2,-,89500,78349
183,59,124,936,67500,78351
51,51,0,-,45000,78352
175,79,96,-,-,78353
2345,1540,805,409,71700,78355
878,630,248,725,80000,78357
493,409,84,-,-,78358
634,394,240,599,82800,78359
0,0,0,-,-,78360
1423,958,465,647,88000,78361
3805,2663,1142,1217,157100,78362
10901,5796,5105,912,98400,78363
3534,2789,745,602,77800,78368
77,57,20,-,18300,78369
1635,1211,424,1001,132700,78370
49,42,7,-,-,78371
1577,1233,344,818,98000,78372
1552,1167,385,1593,405500,78373
6811,4327,2484,1597,185200,78374
1067,712,355,692,71000,78375
93,65,28,1094,65500,78376
946,634,312,616,87000,78377
649,568,81,1259,92400,78379
8442,6353,2089,967,119400,78380
8306,6679,1627,1014,185600,78382
1715,1471,244,794,143500,78383
1481,1123,358,488,70100,78384
48,5,43,-,-,78385
3247,2019,1228,706,86500,78387
694,584,110,868,51400,78389
1895,1227,668,1044,90400,78390
50,19,31,-,-,78391
686,549,137,715,82400,78393
1573,257,1316,804,62300,78401
116,86,30,-,180300,78402
6009,2995,3014,1025,127100,78404
5216,2933,2283,782,60900,78405
370,139,231,1352,-,78406
625,347,278,1099,117500,78407
3953,2139,1814,770,74100,78408
854,456,398,773,106300,78409
9418,6312,3106,1147,178300,78410
9118,5686,3432,1094,144400,78411
15606,7270,8336,1093,149700,78412
14357,8001,6356,1181,187600,78413
17224,10996,6228,1343,218200,78414
14095,7891,6204,1055,113000,78415
5329,2996,2333,940,79900,78416
1392,888,504,1136,124600,78417
12068,7644,4424,1154,224700,78418
176,0,176,1656,-,78419
21666,11034,10632,807,121800,78501
6254,3822,2432,974,113900,78503
18738,12677,6061,1003,156600,78504
10016,7677,2339,678,68900,78516
18844,10677,8167,732,95900,78520
26194,15497,10697,763,74100,78521
16374,11441,4933,936,123600,78526
253,190,63,725,67600,78535
134,123,11,-,113600,78536
13667,10101,3566,650,60900,78537
2840,2258,582,529,67100,78538
13310,7257,6053,881,157200,78539
0,0,0,-,-,78540
14304,7533,6771,810,109000,78541
21034,15920,5114,785,89700,78542
2566,1965,601,638,67000,78543
205,199,6,-,35700,78545
185,155,30,-,59000,78547
456,388,68,670,47500,78548
295,249,46,-,49500,78549
18778,9848,8930,770,93000,78550
13416,10169,3247,886,105700,78552
3746,2856,890,756,111300,78557
187,157,30,-,-,78558
4185,3163,1022,868,78500,78559
1359,784,575,601,86800,78560
213,162,51,-,60000,78561
513,381,132,371,84800,78562
55,55,0,-,-,78563
13,0,13,-,-,78564
52,42,10,-,-,78565
6934,4989,1945,778,111200,78566
100,71,29,-,44200,78567
1247,1001,246,532,88100,78569
9137,6726,2411,565,69200,78570
24561,17820,6741,814,95800,78572
11363,7861,3502,760,116600,78573
16238,12379,3859,741,89000,78574
1665,1125,540,965,157000,78575
3048,2315,733,583,87900,78576
23279,13534,9745,830,85700,78577
4038,2775,1263,653,147500,78578
902,798,104,549,-,78579
3305,1987,1318,769,60200,78580
12139,9166,2973,608,89400,78582
2035,1708,327,725,122100,78583
5253,3575,1678,587,69000,78584
0,0,0,-,-,78585
14410,11123,3287,749,68100,78586
48,37,11,-,19200,78588
10970,8376,2594,811,92200,78589
127,93,34,-,41000,78590
146,141,5,-,-,78591
173,149,24,631,33800,78592
1407,1012,395,726,51000,78593
516,395,121,247,48500,78594
1999,1720,279,519,70900,78595
11323,7413,3910,785,79900,78596
1118,739,379,1313,411800,78597
70,62,8,-,176700,78598
8519,6462,2057,762,81400,78599
11077,8295,2782,1196,221700,78602
2588,2350,238,1060,173000,78605
2621,2043,578,773,303400,78606
67,59,8,-,336800,78607
114,114,0,-,222700,78608
841,679,162,866,189000,78609
14937,11824,3113,1404,284100,78610
4728,3801,927,974,214000,78611
5655,4761,894,1195,195400,78612
32007,21325,10682,1487,339400,78613
184,139,45,-,262500,78614
523,386,137,1029,213000,78615
2462,1977,485,1036,158200,78616
7662,6315,1347,1253,189700,78617
129,108,21,1021,328200,78618
2159,1952,207,1311,572800,78619
6538,5583,955,1381,467300,78620
8103,6628,1475,1127,203700,78621
134,112,22,1344,88600,78622
564,518,46,-,354500,78623
9794,6828,2966,1082,329800,78624
12337,7988,4349,1393,265500,78626
14334,10992,3342,1297,355200,78628
4518,2865,1653,889,144900,78629
1018,854,164,1317,233800,78631
559,500,59,-,168200,78632
12911,11904,1007,1622,353400,78633
13271,10698,2573,1717,237800,78634
104,54,50,-,-,78635
1613,1137,476,939,288400,78636
769,708,61,1098,162200,78638
3291,2526,765,852,198300,78639
21074,14976,6098,1416,212300,78640
26921,21800,5121,1618,311600,78641
6010,5048,962,1119,385600,78642
2714,2090,624,829,248700,78643
6381,4530,1851,1059,184500,78644
6099,5270,829,1014,312800,78645
2980,1907,1073,974,136900,78648
781,692,89,1014,222000,78650
1632,1440,192,2023,355400,78652
8868,7793,1075,1606,221400,78653
7242,5192,2050,1142,243800,78654
1336,911,425,1075,161200,78655
883,527,356,949,80500,78656
3018,2616,402,1288,329500,78657
35,35,0,-,-,78658
1151,1066,85,-,221600,78659
37699,27468,10231,1518,276400,78660
104,99,5,-,98600,78661
1074,824,250,878,192900,78662
291,274,17,-,255400,78663
22089,12166,9923,1371,240700,78664
21317,14305,7012,1522,324000,78665
31811,11253,20558,1159,202500,78666
4097,3650,447,873,460100,78669
64,43,21,1288,278800,78670
334,213,121,777,160800,78671
455,432,23,-,169400,78672
47,31,16,-,78800,78674
92,78,14,-,-,78675
6473,5181,1292,1173,359800,78676
0,0,0,-,-,78677
19661,14626,5035,1573,346200,78681
6096,2848,3248,2121,517300,78701
11093,4829,6264,1558,470900,78702
10865,5428,5437,1993,1023800,78703
26619,8358,18261,1532,632100,78704
8910,812,8098,1435,432300,78705
0,0,0,-,-,78712
12736,7268,5468,1486,425500,78717
588,505,83,859,117500,78719
4130,2213,1917,1405,348100,78721
3048,1461,1587,1470,488900,78722
14496,7060,7436,1270,387400,78723
7611,5099,2512,1325,162000,78724
3503,3074,429,1898,208800,78725
5769,2582,3187,1460,497400,78726
13304,6071,7233,1584,340900,78727
12665,3567,9098,1267,304600,78728
14329,6085,8244,1392,334600,78729
3997,2518,1479,1412,805400,78730
13148,7085,6063,1396,674600,78731
7102,5200,1902,1482,570500,78732
3076,2767,309,2132,719100,78733
9164,7436,1728,1828,467100,78734
8644,4213,4431,1726,632800,78735
3854,2672,1182,1664,394600,78736
7610,6794,816,1829,515300,78737
10467,8112,2355,1759,595500,78738
6574,6092,482,2818,538600,78739
21432,3946,17486,1240,271000,78741
307,202,105,1091,-,78742
17126,8545,8581,1320,213600,78744
28447,13477,14970,1435,339100,78745
10661,7252,3409,1774,1016800,78746
7143,5736,1407,1698,257200,78747
22407,12506,9901,1558,325200,78748
15372,9818,5554,1599,394500,78749
11634,7262,4372,1612,440800,78750
8550,1944,6606,1458,525000,78751
9755,2020,7735,1230,275200,78752
22306,7786,14520,1221,242800,78753
10990,6829,4161,1382,247000,78754
4389,1948,2441,1185,599500,78756
11082,6594,4488,1346,481100,78757
22641,5939,16702,1340,295700,78758
21605,10142,11463,1394,485800,78759
7092,4981,2111,886,99200,78801
0,0,0,-,-,78802
382,278,104,505,78300,78827
64,64,0,-,-,78828
272,187,85,1081,37800,78829
197,163,34,631,44400,78830
1039,774,265,693,98800,78832
367,204,163,798,67200,78833
2293,1373,920,647,55200,78834
30,19,11,-,-,78836
88,88,0,-,-,78837
60,60,0,-,365600,78838
2830,2018,812,630,65800,78839
15985,10402,5583,827,114200,78840
0,0,0,-,-,78841
0,0,0,-,-,78842
15,0,15,-,-,78843
287,243,44,768,-,78850
45,45,0,-,-,78851
17349,11481,5868,715,106600,78852
0,0,0,-,-,78860
4448,3264,1184,1011,148500,78861
280,218,62,-,150000,78870
9,9,0,-,-,78871
292,199,93,-,51900,78872
470,426,44,725,232500,78873
341,293,48,-,-,78877
70,50,20,-,-,78879
475,369,106,623,71300,78880
592,448,144,585,68200,78881
135,121,14,-,275000,78883
461,367,94,793,168500,78884
38,34,4,-,322200,78885
138,138,0,-,-,78886
83,83,0,-,-,78931
181,165,16,850,169600,78932
597,460,137,-,156900,78933
2234,1848,386,832,178900,78934
388,388,0,-,-,78935
88,74,14,-,216700,78938
821,755,66,743,200300,78940
1073,895,178,822,202500,78941
3245,2366,879,978,168700,78942
191,118,73,-,22700,78943
295,295,0,-,364300,78944
4019,3310,709,755,222200,78945
381,303,78,1094,176100,78946
1683,1482,201,938,224700,78947
262,186,76,-,269800,78948
184,177,7,-,176600,78949
871,790,81,1047,245800,78950
0,0,0,-,-,78951
508,322,186,1313,-,78953
506,474,32,1679,297800,78954
1784,1304,480,1039,189000,78956
3747,2896,851,1009,210500,78957
674,541,133,541,86400,78959
1756,1444,312,637,204900,78962
215,209,6,-,224300,78963
54,38,16,-,111100,79001
24,24,0,-,-,79002
75,44,31,-,72200,79003
604,464,140,782,118900,79005
4520,3536,984,799,83100,79007
0,0,0,-,-,79008
562,358,204,755,100300,79009
61,18,43,-,-,79010
88,61,27,840,157500,79011
0,0,0,-,-,79012
981,399,582,625,52500,79013
1337,975,362,866,192300,79014
7923,5611,2312,857,226100,79015
0,0,0,-,-,79016
136,71,65,696,87800,79018
680,579,101,917,153700,79019
32,7,25,958,75000,79021
3415,2452,963,986,121200,79022
135,91,44,713,101100,79024
4,4,0,-,-,79025
1534,860,674,745,88100,79027
4942,3309,1633,898,128500,79029
460,345,115,696,80700,79031
44,28,16,-,85000,79032
22,7,15,-,-,79033
181,135,46,688,106300,79034
1906,1330,576,847,106600,79035
1781,1669,112,783,96000,79036
308,249,59,929,117900,79039
642,488,154,877,118200,79040
1102,843,259,617,86800,79041
440,336,104,794,88500,79042
500,270,230,723,53600,79043
259,134,125,1172,159400,79044
6031,3951,2080,759,90300,79045
222,181,41,1579,108100,79046
0,0,0,-,-,79051
498,397,101,769,88600,79052
11,11,0,-,81700,79053
190,143,47,819,40200,79054
37,37,0,-,79500,79056
480,332,148,833,49200,79057
0,0,0,-,-,79058
264,236,28,517,95800,79059
101,95,6,542,83200,79061
97,80,17,663,68800,79062
248,214,34,558,183000,79063
788,564,224,652,71700,79064
7219,5268,1951,785,86000,79065
6,6,0,-,-,79066
1261,984,277,905,117100,79068
3489,2546,943,895,106400,79070
8396,4955,3441,709,82700,79072
4,2,2,-,-,79073
50,46,4,-,44400,79078
1011,717,294,841,67000,79079
159,152,7,-,34100,79080
1166,853,313,738,106100,79081
82,75,7,-,45000,79082
714,576,138,734,81600,79083
530,424,106,695,95000,79084
0,0,0,-,-,79085
1105,840,265,906,97300,79086
286,196,90,820,102800,79087
1793,1213,580,653,79600,79088
17,17,0,-,-,79091
481,415,66,900,115600,79092
39,39,0,-,-,79093
8,8,0,-,-,79094
976,737,239,534,67200,79095
714,533,181,845,123200,79096
413,378,35,-,116600,79097
177,150,27,1106,132900,79098
1195,70,1125,786,77000,79101
4206,2107,2099,855,122700,79102
3731,2543,1188,968,99400,79103
2288,1229,1059,826,65700,79104
11800,5727,6073,875,135300,79106
10960,6208,4752,896,71600,79107
4350,3337,1013,1017,120100,79108
18539,10912,7627,862,173000,79109
6949,4641,2308,1111,117400,79110
457,11,446,1132,-,79111
9883,8029,1854,1131,183900,79118
8402,5352,3050,1086,262300,79119
2511,1853,658,895,208500,79121
4189,3666,523,1014,276000,79124
2091,1280,811,780,99300,79201
62,38,24,-,102600,79220
19,19,0,-,-,79223
283,219,64,727,62500,79225
968,670,298,700,67700,79226
495,371,124,533,51800,79227
123,117,6,-,41500,79229
36,34,2,-,-,79230
0,0,0,-,-,79231
40,19,21,-,-,79233
30,19,11,-,225000,79234
1151,801,350,680,73300,79235
75,27,48,-,22800,79236
204,179,25,638,80500,79237
63,57,6,-,86200,79239
26,20,6,-,91700,79240
688,560,128,761,79600,79241
9,4,5,-,-,79243
293,198,95,661,59600,79244
895,637,258,555,64100,79245
20,18,2,-,-,79247
610,361,249,425,47200,79248
466,339,127,581,56600,79250
17,17,0,-,117000,79251
979,622,357,583,57500,79252
213,139,74,758,99600,79255
115,83,32,685,49000,79256
346,263,83,-,67200,79257
31,31,0,-,-,79258
14,14,0,-,-,79259
122,77,45,525,39600,79261
1402,1054,348,677,114100,79311
319,259,60,593,50600,79312
574,411,163,895,57400,79313
39,14,25,-,-,79314
3655,2293,1362,732,82800,79316
671,480,191,450,58800,79322
2475,1660,815,701,162300,79323
12,12,0,-,-,79324
596,392,204,948,128300,79325
3,3,0,-,-,79326
1227,921,306,693,156400,79329
41,36,5,-,158300,79330
3998,2781,1217,757,83500,79331
5917,4143,1774,737,108300,79336
2373,1713,660,777,63700,79339
121,114,7,-,95000,79342
567,453,114,638,88700,79343
0,0,0,-,-,79344
304,216,88,713,80000,79345
811,537,274,717,43000,79346
1941,1418,523,628,94600,79347
218,209,9,-,57400,79350
498,352,146,846,81700,79351
8,8,0,-,-,79353
624,380,244,734,80000,79355
1649,1193,456,897,79500,79356
757,559,198,673,60700,79357
445,337,108,836,140300,79358
1238,915,323,602,56800,79359
5013,3917,1096,791,152900,79360
2137,1775,362,966,171600,79363
2785,1867,918,883,88600,79364
457,438,19,1390,243600,79366
231,126,105,810,74500,79367
38,38,0,-,-,79369
525,401,124,581,60600,79370
630,515,115,655,95200,79371
504,377,127,788,81000,79372
1080,753,327,908,89400,79373
19,9,10,-,-,79376
78,55,23,-,88300,79377
74,51,23,485,102100,79378
181,150,31,661,67200,79379
23,19,4,-,-,79380
504,398,106,835,165000,79381
3115,2385,730,1058,210200,79382
22,12,10,-,60000,79383
3782,377,3405,968,105400,79401
0,0,0,-,-,79402
5783,3348,2435,827,67000,79403
3375,2192,1183,810,64700,79404
0,0,0,-,-,79406
9340,4202,5138,981,146200,79407
4345,1512,2833,1177,157900,79410
3076,1130,1946,823,103800,79411
5732,2870,2862,834,86300,79412
8756,5026,3730,1146,163300,79413
8436,3065,5371,979,119400,79414
6285,2439,3846,910,69500,79415
13587,6729,6858,1106,156500,79416
15931,11397,4534,1170,174500,79423
20086,13881,6205,983,226700,79424
1193,939,254,781,71500,79501
414,333,81,546,56100,79502
79,57,22,-,94800,79503
1103,875,228,623,73000,79504
81,59,22,473,44600,79505
288,230,58,540,61800,79506
445,378,67,886,163500,79508
2906,2420,486,848,117400,79510
415,347,68,1046,123600,79511
1964,1560,404,711,69900,79512
66,55,11,-,-,79517
22,22,0,-,-,79518
48,48,0,-,188400,79519
986,706,280,792,60400,79520
1238,823,415,588,60500,79521
1068,1009,59,807,115000,79525
360,311,49,923,113900,79526
103,97,6,-,82500,79527
214,171,43,823,65200,79528
470,352,118,922,44300,79529
220,175,45,694,49000,79530
233,195,38,563,63400,79532
218,160,58,-,26200,79533
73,73,0,-,114600,79534
70,66,4,-,60000,79535
1937,1631,306,889,109400,79536
21,11,10,-,-,79537
66,65,1,-,-,79538
82,64,18,733,95000,79539
21,21,0,-,12300,79540
453,353,100,-,-,79541
490,385,105,680,64900,79543
170,134,36,817,56300,79544
742,649,93,822,78900,79545
696,464,232,434,60700,79546
345,273,72,1068,53900,79547
62,54,8,-,79100,79548
5500,4331,1169,794,94700,79549
1322,1020,302,748,62900,79553
4698,2894,1804,807,79900,79556
54,27,27,-,96100,79560
252,208,44,950,68600,79561
1450,1322,128,1131,235800,79562
424,347,77,854,57800,79563
75,68,7,-,71700,79565
72,55,17,-,212500,79566
1101,817,284,608,58400,79567
7748,3738,4010,831,141300,79601
9454,7150,2304,972,182900,79602
8755,5183,3572,844,90800,79603
11493,6263,5230,955,126300,79605
11330,6171,5159,1038,207400,79606
883,57,826,1226,445200,79607
0,0,0,-,-,79699
10769,6840,3929,1089,151200,79701
8071,5238,2833,1443,182000,79703
16635,11599,5036,1349,280200,79705
10450,8391,2059,1207,237000,79706
14786,9017,5769,1258,325100,79707
272,193,79,532,138100,79713
6263,4570,1693,1229,156500,79714
194,148,46,1046,-,79718
135,111,24,780,-,79719
11564,7736,3828,891,122200,79720
0,0,0,-,-,79721
47,47,0,-,34400,79730
1557,1328,229,869,106100,79731
123,64,59,332,-,79733
946,853,93,1076,155300,79734
4359,3031,1328,787,112900,79735
71,46,25,-,133300,79738
372,231,141,569,199000,79739
113,94,19,-,150000,79741
230,180,50,630,84200,79742
96,52,44,365,75000,79743
489,312,177,1005,126000,79744
2334,1825,509,907,84500,79745
72,45,27,-,-,79748
168,129,39,817,143100,79749
828,599,229,841,78000,79752
33,16,17,-,-,79754
37,4,33,-,-,79755
3533,2695,838,1026,113200,79756
823,739,84,1543,365000,79758
0,0,0,-,-,79759
12448,7097,5351,1104,119900,79761
15322,8716,6606,1211,182200,79762
12967,9209,3758,1066,105600,79763
9088,6532,2556,750,136800,79764
7788,5200,2588,1425,256300,79765
3165,2551,614,1112,136600,79766
0,0,0,-,-,79769
0,0,0,-,-,79770
3868,2930,938,836,100100,79772
0,0,0,-,-,79776
55,44,11,-,175000,79777
537,411,126,-,93600,79778
11,0,11,-,-,79780
57,57,0,-,-,79781
1608,1073,535,627,138100,79782
94,73,21,-,542600,79783
13,13,0,-,45800,79785
330,309,21,633,68700,79788
389,314,75,769,114600,79789
1716,1408,308,828,97800,79821
3887,2393,1494,743,191300,79830
0,0,0,-,-,79832
163,5,158,727,-,79834
4001,2949,1052,812,81600,79835
2405,1848,557,801,94000,79836
84,40,44,-,22100,79837
1992,1392,600,583,67100,79838
454,336,118,669,51400,79839
289,197,92,427,96100,79842
1064,658,406,634,175800,79843
1104,696,408,425,46800,79845
27,0,27,-,-,79846
30,24,6,-,-,79847
381,360,21,-,87800,79848
3840,2659,1181,747,82300,79849
136,111,25,769,-,79851
307,219,88,508,98200,79852
880,839,41,854,78400,79853
64,56,8,-,73000,79854
617,461,156,808,66100,79855
3516,266,3250,464,72600,79901
8724,3455,5269,694,190400,79902
6125,3705,2420,797,101600,79903
11609,4712,6897,878,98300,79904
7866,3776,4090,584,86000,79905
1569,0,1569,1380,-,79906
16389,9704,6685,798,90900,79907
1098,0,1098,1617,-,79908
2854,2256,598,1341,242000,79911
29596,16463,13133,1051,199200,79912
13119,7603,5516,685,93700,79915
0,0,0,-,-,79916
0,0,0,-,-,79918
0,0,0,-,-,79920
2686,2366,320,1181,259600,79922
20922,12983,7939,902,106000,79924
14788,7898,6890,890,143600,79925
12952,10408,2544,854,97600,79927
21374,18688,2686,1018,141500,79928
10479,4959,5520,798,101500,79930
9682,6768,2914,926,194900,79932
9565,6404,3161,1226,156400,79934
6466,3346,3120,911,165400,79935
35736,24329,11407,1051,135700,79936
26423,20745,5678,1216,158500,79938
9168,4850,4318,1511,392100,80002
14298,9857,4441,1475,379800,80003
14691,10488,4203,1480,450200,80004
11210,9850,1360,1771,480700,80005
6074,5775,299,2262,658800,80007
13913,5629,8284,1153,313400,80010
17454,9331,8123,1382,292100,80011
18865,9223,9642,1439,311900,80012
25850,19829,6021,1745,355500,80013
18468,11018,7450,1525,320800,80014
24088,19823,4265,1865,430100,80015
21874,17705,4169,1810,593200,80016
14037,8582,5455,1462,313300,80017
4701,4001,700,2011,433000,80018
1390,1146,244,1217,345900,80019
20733,14356,6377,1802,427000,80020
15839,8479,7360,1788,401200,80021
17427,12640,4787,1403,356400,80022
9321,7467,1854,1825,647600,80023
18,7,11,-,-,80024
15,15,0,-,-,80025
13439,9517,3922,1753,524100,80026
13086,8535,4551,1960,671400,80027
6634,3782,2852,1153,324300,80030
14219,10504,3715,1687,403900,80031
12488,6229,6259,1336,450600,80033
698,0,698,1815,-,80045
208,150,58,1680,404500,80101
2169,1825,344,1109,393000,80102
871,730,141,1354,428900,80103
12645,9898,2747,1680,446300,80104
620,560,60,530,331800,80105
1857,1782,75,868,508800,80106
4843,4571,272,1603,548300,80107
10760,9191,1569,1775,678900,80108
8945,7279,1666,1829,488100,80109
9839,5632,4207,1367,361100,80110
12677,7967,4710,1776,723000,80111
14946,8352,6594,1740,482500,80112
10333,5461,4872,1297,574600,80113
1749,1667,82,2048,690800,80116
928,822,106,1090,465100,80117
2270,2168,102,2025,665300,80118
13342,7804,5538,1262,468500,80120
7134,6094,1040,1682,525400,80121
12632,10787,1845,1807,480500,80122
19186,14229,4957,1709,453800,80123
9286,5132,4154,1808,616400,80124
4073,3868,205,2218,519700,80125
15812,13457,2355,1988,581500,80126
16950,14763,2187,1862,499700,80127
14335,11896,2439,1750,445800,80128
11882,8587,3295,2029,504900,80129
9357,7153,2204,2298,523100,80130
119,114,5,-,289500,80131
9774,8466,1308,1818,526000,80132
1069,984,85,1122,343900,80133
26038,21010,5028,1786,508500,80134
1501,1379,122,1332,639400,80135
1903,1711,192,1367,406200,80136
587,507,80,1161,565100,80137
11737,9650,2087,1718,538700,80138
10497,2641,7856,1961,642100,80202
15040,3037,12003,1327,398500,80203
15339,6108,9231,1432,446700,80204
15924,6230,9694,1531,516900,80205
13925,6430,7495,1438,709600,80206
8887,6629,2258,1495,523900,80207
13534,6358,7176,1587,729000,80209
16401,9671,6730,1683,685900,80210
18061,8958,9103,1646,582900,80211
9767,6369,3398,1387,584700,80212
11707,4291,7416,1272,421300,80214
8568,5201,3367,1491,498000,80215
5524,1796,3728,1625,324200,80216
11649,3947,7702,1343,482000,80218
22222,12059,10163,1273,335000,80219
16401,9317,7084,1404,575500,80220
13892,9162,4730,1399,349800,80221
11011,4843,6168,1446,466800,80222
8688,4095,4593,1408,377000,80223
8013,4665,3348,1381,448000,80224
13469,7252,6217,1509,407100,80226
15312,10039,5273,1557,415600,80227
14797,10081,4716,1566,467800,80228
19251,12486,6765,1473,294300,80229
4840,2611,2229,1765,706500,80230
15965,6426,9539,1471,385400,80231
9314,6509,2805,1460,385200,80232
17154,10534,6620,1649,352200,80233
11714,6985,4729,1556,402800,80234
3887,1974,1913,1475,445600,80235
6055,3713,2342,1501,393700,80236
11300,4879,6421,1663,471700,80237
10124,7153,2971,1842,637500,80238
13385,7893,5492,1587,312500,80239
11834,9508,2326,1761,389800,80241
7369,1606,5763,1424,541400,80246
14878,5709,9169,1499,238900,80247
11655,9252,2403,1922,361500,80249
12251,7273,4978,1350,144800,80260
0,0,0,-,-,80264
0,0,0,-,-,80266
192,0,192,2405,-,80290
0,0,0,-,-,80293
0,0,0,-,-,80294
11750,6511,5239,1758,585400,80301
12294,4786,7508,1645,928800,80302
11128,5153,5975,1620,775300,80303
11072,7520,3552,1692,917200,80304
6744,4247,2497,2003,788700,80305
0,0,0,-,-,80310
16535,10964,5571,1641,588800,80401
8435,7396,1039,1668,602500,80403
0,0,0,-,-,80419
328,272,56,1212,381500,80420
3373,3127,246,1389,424100,80421
1992,1777,215,1143,405200,80422
44,44,0,-,331800,80423
3727,2569,1158,2253,696400,80424
73,47,26,-,416100,80425
46,46,0,-,558300,80426
375,167,208,1340,330700,80427
194,164,30,-,562500,80428
55,55,0,-,307900,80430
159,159,0,-,330900,80432
3557,3209,348,1809,544700,80433
14,14,0,-,-,80434
2584,1601,983,1221,630700,80435
179,179,0,-,323300,80436
372,232,140,1538,218200,80438
10271,9085,1186,1739,641400,80439
1178,895,283,1264,398100,80440
772,423,349,1261,510700,80442
1849,1264,585,2010,688900,80443
548,340,208,1109,312300,80444
1468,989,479,1024,313300,80446
975,711,264,872,448200,80447
0,0,0,-,-,80448
489,489,0,-,339600,80449
305,251,54,961,302500,80451
1561,1182,379,1119,384000,80452
108,81,27,-,375000,80453
640,615,25,-,586800,80454
213,174,39,1536,348900,80455
179,172,7,-,332600,80456
206,169,37,-,457000,80457
836,610,226,879,269000,80459
2651,2068,583,1169,256100,80461
68,63,5,-,-,80463
5927,5273,654,1882,484700,80465
1650,1104,546,1590,570100,80466
1004,757,247,1049,434100,80467
152,38,114,549,-,80468
136,107,29,-,336100,80469
1560,1465,95,1237,474200,80470
0,0,0,-,-,80471
40,7,33,-,-,80473
114,114,0,-,447100,80474
9,9,0,-,-,80475
87,62,25,874,508600,80476
520,478,42,-,636400,80478
0,0,0,-,-,80479
523,396,127,681,211000,80480
236,217,19,1804,453000,80481
620,516,104,1297,529900,80482
237,209,28,1200,266800,80483
7431,5599,1832,1581,672900,80487
3347,2490,857,1561,567900,80498
17570,10009,7561,1365,368000,80501
14591,10159,4432,1699,572300,80503
21219,17420,3799,1690,429300,80504
176,136,40,-,383700,80510
853,801,52,2717,478400,80512
5929,5232,697,1444,438300,80513
2056,1589,467,1505,347500,80514
349,349,0,-,328100,80515
11227,9726,1501,2532,564500,80516
5071,3720,1351,1101,490500,80517
670,560,110,1669,319400,80520
14179,5303,8876,1250,426900,80521
15527,10414,5113,1395,407400,80524
23060,14158,8902,1525,443400,80525
18546,10372,8174,1417,414200,80526
8083,5844,2239,1733,529200,80528
1820,1572,248,1935,361800,80530
107,107,0,-,358300,80532
6699,5413,1286,1514,419600,80534
1092,824,268,1067,349000,80535
892,872,20,-,442900,80536
19064,12461,6603,1413,368000,80537
20358,14292,6066,1512,374100,80538
2103,1816,287,1455,591600,80540
1475,1438,37,-,436500,80542
3065,2690,375,1142,337200,80543
16,16,0,-,-,80544
603,597,6,-,264000,80545
70,70,0,-,328600,80546
1991,1898,93,1836,585000,80547
4994,4253,741,2027,358000,80549
14320,11713,2607,1502,435600,80550
13120,9053,4067,1427,367800,80601
12446,11490,956,2234,509200,80602
5279,4790,489,1558,352500,80603
1311,975,336,1125,348200,80610
274,226,48,850,375900,80611
115,105,10,-,355400,80612
3376,3005,371,1040,402100,80615
6318,4292,2026,1281,252200,80620
4611,3321,1290,1173,340200,80621
67,67,0,-,-,80622
339,293,46,1420,227800,80623
334,232,102,1831,465700,80624
17183,8084,9099,985,238200,80631
22988,16705,6283,1351,327200,80634
4471,3536,935,1723,360600,80640
1688,1303,385,1517,400800,80642
1256,1001,255,1414,364400,80643
973,733,240,942,299400,80644
1636,1346,290,1239,304800,80645
0,0,0,-,-,80646
415,392,23,2089,375000,80648
197,137,60,786,424000,80649
633,581,52,1250,286200,80650
1437,1195,242,1082,340600,80651
101,101,0,-,409700,80652
307,216,91,825,309900,80653
956,644,312,927,337600,80654
6104,3672,2432,960,246100,80701
356,212,144,823,110800,80705
1028,724,304,781,168100,80720
120,88,32,-,210000,80721
149,122,27,-,206300,80722
2581,1810,771,928,215900,80723
179,95,84,695,217300,80726
264,169,95,816,103400,80727
384,318,66,746,185000,80728
197,136,61,692,175000,80729
582,445,137,558,188700,80731
4,4,0,-,-,80732
226,150,76,950,186100,80733
1119,744,375,787,229900,80734
145,76,69,789,214300,80735
218,178,40,920,121600,80736
702,430,272,610,123600,80737
35,21,14,375,225000,80740
388,307,81,1151,301500,80741
129,85,44,675,154200,80742
477,315,162,823,173600,80743
182,160,22,630,72900,80744
32,23,9,-,203100,80745
20,8,12,800,125000,80746
180,138,42,1019,144000,80747
133,105,28,625,138300,80749
77,58,19,-,121700,80750
6421,4297,2124,789,175400,80751
58,40,18,535,193800,80754
38,24,14,-,-,80755
102,53,49,-,118100,80757
1375,976,399,905,182600,80758
1736,1318,418,917,197900,80759
54,50,4,-,151700,80801
48,27,21,-,-,80802
154,90,64,388,150000,80804
149,123,26,975,131900,80805
1890,1176,714,796,157400,80807
2441,1847,594,997,276300,80808
436,389,47,1500,379900,80809
462,346,116,760,161500,80810
114,84,30,867,150000,80812
742,388,354,1147,150800,80813
1801,1433,368,1167,350300,80814
360,241,119,733,179700,80815
2998,2785,213,2021,286600,80816
10827,7619,3208,1570,286500,80817
150,133,17,775,119700,80818
393,257,136,1137,340200,80819
304,283,21,-,352000,80820
539,380,159,942,164000,80821
114,83,31,968,164100,80822
86,61,25,532,-,80823
152,117,35,-,216200,80824
162,124,38,563,118800,80825
0,0,0,-,-,80826
322,322,0,-,294200,80827
846,538,308,808,162700,80828
2573,1444,1129,994,462000,80829
46,41,5,-,267900,80830
9679,9001,678,1960,367600,80831
353,315,38,-,325300,80832
457,416,41,661,167400,80833
130,93,37,632,129200,80834
304,179,125,1034,192400,80835
387,258,129,937,157800,80836
643,0,643,1779,-,80840
232,170,62,729,159300,80860
83,68,15,725,250000,80861
21,21,0,-,265600,80862
5023,3862,1161,1611,364800,80863
565,487,78,781,233100,80864
3300,7,3293,1751,-,80902
7427,3207,4220,943,334900,80903
10552,6371,4181,1201,324900,80904
8039,3997,4042,1162,270100,80905
15068,9395,5673,1389,422900,80906
12512,6884,5628,1116,266100,80907
7111,6579,532,1443,546400,80908
16460,8340,8120,1039,264600,80909
12705,5792,6913,1099,207100,80910
12224,9672,2552,1443,258000,80911
0,0,0,-,-,80913
0,0,0,-,-,80914
8438,6097,2341,1198,263800,80915
14249,7704,6545,1304,213800,80916
13096,8072,5024,1203,267500,80917
19196,12188,7008,1324,326400,80918
11375,8314,3061,1463,432500,80919
13880,9765,4115,1728,375300,80920
8755,6916,1839,1759,494700,80921
10496,7761,2735,1723,318600,80922
11670,8306,3364,1741,341700,80923
4339,2988,1351,1904,482300,80924
4261,3639,622,1813,325200,80925
708,650,58,-,482600,80926
1638,1471,167,2658,431400,80927
277,227,50,1714,164400,80928
29,29,0,-,345000,80929
557,222,335,1693,247100,80930
188,188,0,-,355600,80938
0,0,0,-,-,80939
1649,1299,350,1945,299300,80951
12628,6478,6150,846,148800,81001
5774,2865,2909,733,121400,81003
11169,5919,5250,855,126000,81004
12975,9696,3279,869,196500,81005
4406,3569,837,829,255400,81006
11507,9698,1809,1141,262900,81007
4844,2809,2035,1210,187900,81008
721,470,251,997,152600,81019
489,400,89,825,100600,81020
3,3,0,-,-,81021
518,431,87,1345,192100,81022
642,538,104,-,253500,81023
145,128,17,-,297600,81024
378,322,56,960,96300,81025
63,32,31,675,49300,81027
133,96,37,-,54300,81029
67,55,12,-,129500,81030
56,45,11,-,57500,81033
463,371,92,767,103900,81036
748,516,232,847,116100,81039
125,125,0,-,241000,81040
242,178,64,554,74100,81041
24,23,1,-,-,81043
67,59,8,575,81400,81044
37,26,11,1550,66700,81045
0,0,0,-,-,81046
617,440,177,400,86100,81047
96,62,34,2656,123500,81049
4281,2834,1447,760,116200,81050
3340,2312,1028,727,113600,81052
1482,825,657,706,80100,81054
703,598,105,1148,301500,81055
131,100,31,688,141700,81057
428,329,99,688,93200,81058
19,19,0,-,-,81059
337,238,99,825,81000,81062
760,484,276,955,83500,81063
112,86,26,715,88000,81064
1878,1249,629,825,90400,81067
885,793,92,1021,276500,81069
84,42,42,795,210000,81071
774,544,230,440,126000,81073
187,121,66,1083,48100,81076
309,263,46,569,133300,81077
89,48,41,-,240900,81081
5121,3522,1599,773,172400,81082
40,20,20,-,87500,81084
69,37,32,393,67700,81087
1862,1275,587,640,123900,81089
468,372,96,233,130700,81090
378,264,114,624,218000,81091
301,238,63,669,209400,81092
5902,3243,2659,700,159100,81101
1061,792,269,742,102300,81120
160,144,16,1250,230800,81121
3432,2819,613,1291,360200,81122
346,266,80,807,97100,81123
59,59,0,-,-,81124
1459,856,603,499,108900,81125
74,74,0,-,138200,81126
30,17,13,-,632800,81128
7,7,0,-,-,81129
369,270,99,823,348600,81130
604,442,162,959,259800,81131
1513,1232,281,754,156200,81132
422,327,95,704,170100,81133
112,49,63,653,158000,81136
2250,1624,626,944,259600,81137
24,12,12,-,-,81138
797,627,170,628,165300,81140
409,322,87,760,125000,81141
340,270,70,-,150000,81143
2551,1744,807,709,189500,81144
336,233,103,920,163700,81146
5437,3864,1573,1145,361400,81147
137,111,26,775,91500,81148
418,324,94,654,139500,81149
662,547,115,610,128100,81151
492,324,168,601,108500,81152
474,393,81,923,237300,81154
140,112,28,-,341700,81155
4119,2969,1150,1288,447500,81201
184,155,29,-,653200,81210
3280,2234,1046,1117,374500,81211
11622,8297,3325,901,226800,81212
64,56,8,-,307100,81220
140,122,18,860,118000,81221
210,210,0,-,275000,81222
951,874,77,1316,217100,81223
1564,1060,504,1367,689200,81224
488,342,146,1336,552500,81225
2510,1848,662,810,175400,81226
0,0,0,-,-,81227
0,0,0,-,-,81228
4189,2349,1840,1035,362000,81230
23,23,0,-,-,81232
434,352,82,-,305900,81233
414,331,83,838,347600,81235
626,549,77,-,521600,81236
48,48,0,-,370600,81237
116,116,0,-,-,81239
1434,1221,213,1169,235500,81240
101,97,4,-,319200,81241
522,411,111,932,385100,81242
38,29,9,-,475000,81243
219,201,18,706,161800,81244
74,74,0,-,-,81248
144,128,16,-,318800,81251
1831,1562,269,777,249500,81252
198,198,0,-,-,81253
12202,8173,4029,1280,489100,81301
3595,2748,847,1253,425200,81303
207,207,0,-,172200,81320
5775,3994,1781,864,209300,81321
2182,1610,572,756,279100,81323
767,686,81,628,144400,81324
71,58,13,-,120000,81325
1045,907,138,1024,397500,81326
200,164,36,-,294900,81327
1710,1487,223,956,358600,81328
75,0,75,-,-,81330
66,66,0,-,197700,81331
217,186,31,1444,413700,81332
428,231,197,515,160600,81334
33,33,0,-,-,81335
9486,6799,2687,967,256000,81401
4557,3739,818,1119,349100,81403
783,657,126,896,284200,81410
20,18,2,-,-,81411
2265,1701,564,908,277600,81413
783,673,110,1227,313300,81415
5041,3411,1630,824,256800,81416
526,420,106,1207,239200,81418
1324,959,365,947,264500,81419
217,153,64,760,143800,81422
699,509,190,1158,315500,81423
509,397,112,670,148900,81424
1880,1427,453,983,226300,81425
71,57,14,-,595000,81426
526,387,139,832,476700,81427
1623,1272,351,839,290000,81428
36,36,0,-,214300,81429
326,273,53,1986,615800,81430
156,140,16,-,270000,81431
1403,1044,359,1250,582400,81432
307,169,138,988,313000,81433
86,74,12,-,-,81434
2492,1333,1159,1268,573500,81435
10534,4648,5886,846,215700,81501
6066,4550,1516,971,241000,81503
11942,9157,2785,1164,219900,81504
4962,3562,1400,1257,352500,81505
5076,3279,1797,962,333100,81506
6471,5838,633,1404,375400,81507
5258,3269,1989,970,165300,81520
5865,4525,1340,1271,286800,81521
52,52,0,-,-,81522
442,368,74,-,536100,81523
784,739,45,-,483700,81524
498,349,149,1294,255400,81525
2193,1765,428,928,351300,81526
688,561,127,-,339500,81527
5945,3844,2101,1306,557100,81601
100,60,40,650,169200,81610
4218,2682,1536,1644,495400,81611
31,0,31,-,-,81612
1503,1090,413,-,-,81615
4037,2393,1644,1724,687800,81620
2357,1722,635,1855,848300,81621
6024,4001,2023,1621,643200,81623
493,442,51,942,320000,81624
4935,3275,1660,873,201400,81625
415,332,83,1082,253100,81630
2616,1998,618,1423,639100,81631
3641,2626,1015,1723,735800,81632
0,0,0,-,-,81633
2698,1827,871,862,203800,81635
2875,2124,751,1774,377700,81637
34,28,6,-,-,81638
1041,818,223,1196,335000,81639
27,19,8,-,275000,81640
1578,1149,429,829,240300,81641
12,0,12,-,-,81642
204,178,26,-,436200,81643
379,237,142,1898,797300,81645
82,76,6,-,373000,81646
2371,1794,577,1366,379100,81647
899,740,159,760,183900,81648
99,57,42,1813,556300,81649
4586,3350,1236,1089,301400,81650
1972,1552,420,1620,379300,81652
0,0,0,-,-,81653
518,437,81,-,468100,81654
147,130,17,-,"2,000,000+",81655
158,158,0,-,-,81656
2327,1751,576,1541,723800,81657
16085,10094,5991,934,223700,82001
0,0,0,-,-,82005
8736,5756,2980,1040,176300,82007
14092,11941,2151,882,329500,82009
127,117,10,950,142200,82050
4,4,0,-,-,82051
38,38,0,-,440600,82052
502,420,82,1344,187800,82053
270,254,16,-,-,82054
170,142,28,-,325000,82055
16,16,0,-,-,82058
124,124,0,-,216700,82059
149,149,0,-,325500,82060
0,0,0,-,-,82061
47,29,18,-,350000,82063
8405,4451,3954,881,246900,82070
7111,3329,3782,814,243300,82072
12,12,0,-,-,82073
28,18,10,-,-,82081
738,633,105,910,267800,82082
130,71,59,1550,99000,82083
42,42,0,-,-,82084
219,0,219,539,-,82190
2941,2353,588,721,217200,82201
156,134,22,571,218800,82210
263,203,60,1083,212800,82212
188,154,34,575,172900,82213
515,419,96,909,158300,82214
70,44,26,1074,-,82215
32,32,0,-,100000,82217
6,6,0,-,-,82218
10,10,0,-,-,82219
244,178,66,530,167300,82221
62,57,5,-,-,82222
373,277,96,824,180700,82223
2,2,0,-,-,82224
745,522,223,915,191100,82225
118,101,17,-,88100,82227
0,0,0,-,-,82229
3764,2759,1005,695,191800,82240
27,27,0,-,264500,82242
45,45,0,-,-,82243
205,150,55,531,173400,82244
3296,2189,1107,680,188300,82301
12,12,0,-,-,82310
243,168,75,886,205600,82321
72,68,4,-,-,82322
84,65,19,-,116800,82323
78,48,30,-,208700,82324
391,322,69,867,180800,82325
304,206,98,1085,104800,82327
172,138,34,-,100700,82329
1082,809,273,733,247400,82331
23,8,15,-,-,82332
226,191,35,598,157600,82334
0,0,0,-,-,82335
81,28,53,885,-,82336
2997,2197,800,618,174400,82401
780,625,155,635,121500,82410
202,139,63,736,128800,82411
180,146,34,920,143800,82412
6881,4926,1955,1009,304400,82414
233,212,21,925,167000,82420
130,120,10,850,100000,82421
0,0,0,-,-,82422
84,40,44,568,105800,82423
1138,873,265,801,159700,82426
72,55,17,-,57700,82428
29,29,0,-,103100,82430
1086,800,286,812,175000,82431
147,100,47,-,125000,82432
525,315,210,639,233000,82433
28,8,20,-,-,82434
4919,3682,1237,812,278200,82435
101,47,54,-,-,82440
92,83,9,-,391200,82441
436,286,150,641,300000,82442
2048,1516,532,734,182900,82443
80,80,0,-,381600,82450
6946,4753,2193,793,187000,82501
245,155,90,438,131300,82510
158,92,66,679,-,82512
791,598,193,832,236400,82513
418,252,166,472,108800,82514
160,125,35,743,189000,82515
135,103,32,654,219400,82516
4846,3544,1302,920,253900,82520
324,280,44,950,210500,82523
11183,7785,3398,800,212100,82601
10494,8503,1991,1028,216400,82604
8359,5146,3213,958,248500,82609
111,74,37,839,347200,82620
0,0,0,-,-,82630
4042,3260,782,698,227400,82633
43,23,20,525,-,82635
1491,1075,416,761,198200,82636
1599,1257,342,911,226100,82637
17,17,0,-,-,82638
273,216,57,1118,221400,82639
77,77,0,-,-,82640
27,24,3,-,333300,82642
106,89,17,706,60600,82643
766,613,153,807,137200,82644
13,13,0,-,-,82646
35,35,0,-,-,82648
425,314,111,588,144400,82649
1985,1777,208,693,184000,82701
98,90,8,-,248600,82710
10,10,0,-,-,82711
140,109,31,-,-,82712
0,0,0,-,-,82714
6783,4825,1958,798,192900,82716
8789,7238,1551,930,255700,82718
301,218,83,725,162500,82720
1067,904,163,739,250600,82721
71,71,0,-,-,82723
102,84,18,-,195300,82725
679,597,82,-,286300,82727
1135,816,319,793,263100,82729
801,635,166,729,161100,82730
85,13,72,-,-,82731
738,625,113,963,182400,82732
10771,7146,3625,865,283100,82801
104,97,7,-,354900,82831
510,460,50,-,-,82832
139,44,95,-,-,82833
3398,2471,927,936,248800,82834
144,72,72,790,297400,82835
380,302,78,937,263000,82836
13,7,6,-,312500,82837
235,217,18,-,507800,82838
535,468,67,667,287100,82839
233,178,55,-,-,82842
20,8,12,-,-,82844
26,26,0,-,-,82845
10225,7577,2648,858,210900,82901
169,169,0,-,591900,82922
276,276,0,-,616500,82923
162,162,0,-,292600,82925
18,0,18,-,-,82929
5629,4279,1350,698,186900,82930
301,191,110,-,118800,82932
200,200,0,-,301100,82933
56,52,4,-,119600,82934
4494,3431,1063,878,233000,82935
6,6,0,-,-,82936
1171,1012,159,871,191000,82937
99,99,0,-,315500,82938
583,393,190,790,182500,82939
1781,1402,379,1260,274000,82941
45,45,0,-,-,82942
76,22,54,-,-,82943
114,114,0,-,-,82944
62,54,8,-,38200,82945
7296,4200,3096,1639,935300,83001
104,104,0,-,956300,83011
41,0,41,-,-,83012
65,65,0,-,-,83013
1225,944,281,1322,1014400,83014
435,134,301,-,-,83025
1439,1091,348,667,157300,83101
1750,1241,509,589,252200,83110
189,153,36,-,197300,83111
186,186,0,-,403800,83112
833,613,220,767,216100,83113
272,228,44,1083,170700,83114
116,116,0,-,470800,83115
328,267,61,623,94500,83116
339,339,0,-,439500,83118
78,44,34,-,-,83119
136,101,35,-,421700,83120
0,0,0,-,-,83121
184,147,37,-,429300,83122
265,218,47,950,256700,83123
51,45,6,-,-,83124
178,178,0,-,422100,83126
1515,1303,212,1313,355000,83127
502,367,135,1266,365600,83128
13995,9401,4594,749,172800,83201
8313,5959,2354,842,213200,83202
13,0,13,-,-,83203
7722,4909,2813,619,165200,83204
217,0,217,586,-,83209
1362,1061,301,476,132000,83210
2154,1436,718,677,164400,83211
126,113,13,367,117400,83212
450,342,108,541,83100,83213
233,164,69,-,173100,83214
28,26,2,-,63800,83215
320,268,52,854,198300,83217
151,123,28,867,174100,83218
44,25,19,-,104200,83220
9076,6944,2132,693,192000,83221
84,66,18,1125,278000,83223
832,547,285,611,193300,83226
23,23,0,-,-,83227
314,262,52,761,219000,83228
130,121,9,-,210200,83232
95,95,0,-,-,83233
482,400,82,770,138200,83234
92,92,0,-,-,83235
884,730,154,700,212500,83236
381,327,54,946,292200,83237
36,30,6,-,-,83238
187,173,14,933,159200,83239
775,658,117,575,159800,83241
16,16,0,-,-,83243
177,129,48,-,214100,83244
844,740,104,827,246900,83245
359,308,51,689,234600,83246
664,607,57,754,223200,83250
518,452,66,927,237300,83251
1736,1530,206,808,190900,83252
22,22,0,-,-,83253
1335,976,359,557,120300,83254
382,318,64,772,214100,83255
207,187,20,782,175700,83261
308,278,30,-,131500,83262
3218,2605,613,688,235000,83263
106,92,14,-,150000,83271
84,77,7,-,256300,83272
3310,2538,772,835,230000,83274
1392,1096,296,688,158600,83276
61,51,10,-,256000,83277
197,190,7,-,605100,83278
3,3,0,-,-,83281
54,54,0,-,-,83283
7,7,0,-,-,83285
434,345,89,1035,223200,83286
117,117,0,-,412500,83287
22622,15287,7335,835,199900,83301
83,48,35,-,109600,83302
244,188,56,596,233300,83311
46,41,5,-,-,83312
1249,1046,203,1295,439200,83313
375,288,87,837,174100,83314
3969,3168,801,677,204200,83316
6215,4063,2152,787,181700,83318
342,289,53,800,199000,83320
197,153,44,788,301000,83321
33,11,22,-,239300,83322
591,406,185,775,258000,83323
197,132,65,686,182100,83324
233,136,97,870,159500,83325
267,185,82,925,166600,83327
2011,1458,553,1084,200900,83328
2355,1558,797,755,156100,83330
1196,907,289,798,209700,83332
4333,3049,1284,648,488900,83333
886,506,380,837,159200,83334
632,428,204,544,135200,83335
2015,1409,606,904,189700,83336
17,12,5,-,-,83337
6947,4790,2157,796,211800,83338
2234,1670,564,1199,797200,83340
2498,2263,235,892,297500,83341
436,375,61,633,190700,83342
369,241,128,983,185100,83344
412,330,82,742,167000,83346
1141,852,289,682,205300,83347
32,15,17,-,-,83348
420,316,104,650,140200,83349
4261,3007,1254,724,160500,83350
1210,859,351,799,155500,83352
503,465,38,2268,930800,83353
10,10,0,-,-,83354
1517,1116,401,695,157800,83355
14702,10564,4138,927,219000,83401
10529,6340,4189,789,197100,83402
8948,6699,2249,887,259100,83404
6279,4662,1617,1006,250000,83406
227,209,18,-,712500,83414
865,698,167,744,216200,83420
169,169,0,-,202500,83421
1106,746,360,1202,373500,83422
249,149,100,674,123100,83423
28,28,0,-,-,83424
162,131,31,950,209000,83425
730,699,31,1295,252300,83427
237,217,20,700,406900,83428
380,376,4,-,475000,83429
320,246,74,832,197000,83431
28,28,0,-,350000,83433
622,497,125,733,183000,83434
210,112,98,1263,205000,83435
228,196,32,1118,225600,83436
64,46,18,-,216000,83438
10436,5147,5289,849,266800,83440
7050,6043,1007,906,261900,83442
368,296,72,690,108800,83443
412,244,168,558,185900,83444
2245,1780,465,683,170800,83445
20,19,1,-,95000,83446
772,539,233,1137,236000,83448
92,80,12,950,406700,83449
324,210,114,794,144600,83450
327,265,62,794,185500,83451
849,698,151,1215,394000,83452
77,65,12,-,139400,83454
2216,1712,504,938,392100,83455
0,0,0,-,-,83460
198,186,12,-,-,83462
29,29,0,-,173400,83463
110,69,41,727,79600,83464
31,23,8,-,258300,83465
111,83,28,-,222800,83466
2776,2291,485,716,224200,83467
71,55,16,-,323400,83468
0,0,0,-,-,83469
14818,10748,4070,786,225100,83501
64,37,27,696,226300,83520
688,545,143,788,181800,83522
358,319,39,810,134700,83523
410,312,98,803,177700,83524
142,113,29,-,263900,83525
109,92,17,808,203600,83526
2238,1513,725,910,209500,83530
76,52,24,763,281300,83533
444,311,133,933,220500,83535
1845,1444,401,601,197900,83536
418,355,63,735,185700,83537
848,704,144,714,199600,83539
835,525,310,784,150100,83540
488,450,38,708,216700,83541
74,53,21,-,240600,83542
260,210,50,640,151300,83543
2375,1772,603,819,194300,83544
187,171,16,825,155500,83545
208,172,36,-,121200,83546
160,131,29,-,250800,83547
44,36,8,875,112500,83548
288,217,71,688,274200,83549
393,346,47,721,213600,83552
544,452,92,419,164600,83553
155,146,9,910,195800,83554
169,139,30,670,177800,83555
7,7,0,-,-,83602
226,152,74,550,235300,83604
12489,7927,4562,875,200800,83605
10712,8422,2290,1039,258700,83607
372,270,102,658,184400,83610
853,762,91,825,286900,83611
855,655,200,756,215200,83612
325,255,70,1325,203900,83615
12248,10593,1655,1527,497400,83616
6378,4749,1629,706,223100,83617
3258,2483,775,893,190900,83619
948,827,121,850,313000,83622
530,344,186,594,109000,83623
575,298,277,688,207700,83624
420,282,138,1140,214800,83626
230,187,43,-,142400,83627
1676,1087,589,782,143800,83628
836,673,163,844,278800,83629
552,424,128,682,-,83631
162,128,34,833,243300,83632
239,170,69,-,275000,83633
9016,7385,1631,1435,283600,83634
104,60,44,-,226900,83636
130,121,9,-,200900,83637
2477,1940,537,890,393000,83638
1153,920,233,569,280800,83639
1232,1040,192,1004,239500,83641
19115,13743,5372,1203,353800,83642
41,41,0,-,122900,83643
4616,4099,517,938,278600,83644
280,247,33,589,257200,83645
24139,20183,3956,1467,355800,83646
8752,5919,2833,891,181000,83647
748,6,742,1405,-,83648
174,145,29,-,253500,83650
13180,9212,3968,1070,201600,83651
642,556,86,740,317000,83654
1917,1564,353,757,253300,83655
195,161,34,1044,163300,83656
55,55,0,-,308300,83657
2057,1477,580,898,258800,83660
3687,2278,1409,760,174000,83661
31,26,5,-,154200,83666
4523,3886,637,1000,354700,83669
224,211,13,-,196600,83670
3450,2452,998,778,165300,83672
1827,1352,475,683,266600,83676
55,55,0,-,-,83677
18375,13511,4864,1073,262200,83686
12317,8673,3644,1109,259700,83687
11329,5825,5504,981,520500,83702
7624,4905,2719,1111,333900,83703
16506,10150,6356,1081,251600,83704
12249,6662,5587,977,248400,83705
14663,7003,7660,1108,367000,83706
20640,16833,3807,1422,311700,83709
4147,2568,1579,1096,514400,83712
11355,8811,2544,1292,302200,83713
10670,7566,3104,1130,304800,83714
7687,5999,1688,1544,416200,83716
0,0,0,-,-,83720
0,0,0,-,-,83725
2620,2207,413,993,332700,83801
15,8,7,-,-,83802
381,320,61,-,-,83803
734,690,44,814,257700,83804
3047,2394,653,773,268000,83805
78,70,8,-,87100,83806
46,42,4,-,197500,83808
147,147,0,-,-,83809
669,607,62,-,380200,83810
709,445,264,910,163600,83811
15,15,0,-,-,83812
313,313,0,-,360700,83813
11604,6460,5144,998,378400,83814
15027,9874,5153,1148,332800,83815
107,99,8,-,446400,83821
917,782,135,680,191000,83822
639,536,103,925,280300,83823
117,99,18,750,322000,83824
95,78,17,1875,325800,83825
36,36,0,-,-,83826
70,61,9,-,114800,83827
144,144,0,-,191300,83830
657,572,85,935,245100,83832
772,715,57,950,456800,83833
62,62,0,-,360000,83834
9101,7930,1171,1274,346000,83835
433,376,57,898,429600,83836
1305,746,559,747,134700,83837
507,396,111,837,214200,83839
270,231,39,1513,230400,83840
222,103,119,936,-,83841
58,42,16,-,227300,83842
11385,5403,5982,778,264200,83843
22,0,22,-,-,83844
876,643,233,634,252000,83845
357,261,96,796,105900,83846
533,389,144,-,271400,83847
74,62,12,-,-,83848
895,749,146,642,138200,83849
933,748,185,821,148400,83850
640,459,181,761,156400,83851
562,166,396,865,293800,83852
16984,12406,4578,1093,293600,83854
810,655,155,817,206900,83855
2828,2372,456,542,256500,83856
403,403,0,-,309700,83857
6249,5368,881,1132,314200,83858
2695,2270,425,873,374600,83860
2647,1980,667,744,207600,83861
7533,5475,2058,1108,342600,83864
117,86,31,-,-,83866
221,207,14,-,189100,83867
321,247,74,888,88200,83868
1825,1677,148,935,303000,83869
126,91,35,433,307100,83870
862,729,133,671,263700,83871
235,203,32,1265,421800,83872
722,472,250,549,147800,83873
34,34,0,-,332000,83874
679,556,123,661,284800,83876
199,191,8,725,192700,84001
105,86,19,-,209100,84002
14430,11133,3297,1411,423100,84003
2780,2391,389,3071,698900,84004
9731,8633,1098,1663,356800,84005
336,211,125,1325,274600,84006
139,92,47,-,230000,84007
0,0,0,-,-,84008
10682,9991,691,1827,424600,84009
15337,11082,4255,1190,373000,84010
211,203,8,-,349200,84013
5688,4844,844,1376,374800,84014
21039,15949,5090,1133,276000,84015
1487,1194,293,1039,340900,84017
74,74,0,-,380000,84018
14910,11304,3606,1501,569700,84020
1157,885,272,906,173900,84021
224,40,184,878,-,84022
59,29,30,248,295800,84023
14,11,3,-,-,84024
6758,5584,1174,1315,432800,84025
277,200,77,605,135700,84026
221,203,18,-,192500,84027
121,82,39,800,275000,84028
3528,3061,467,810,301500,84029
71,65,6,-,-,84031
7204,5409,1795,1411,449000,84032
335,265,70,775,310000,84033
49,27,22,-,77000,84034
256,237,19,-,150600,84035
2590,2070,520,1263,487800,84036
10945,9714,1231,1217,429400,84037
183,175,8,-,342500,84038
191,173,18,-,173900,84039
8424,7303,1121,1548,360200,84040
17664,11444,6220,1135,292700,84041
3000,2372,628,1336,478800,84042
19629,15572,4057,1564,415900,84043
8906,7085,1821,1212,252900,84044
8721,7392,1329,1678,402100,84045
138,125,13,-,176900,84046
15321,7076,8245,1237,297400,84047
2238,1793,445,2731,608200,84049
3430,2971,459,1301,457500,84050
158,137,21,-,205800,84051
383,295,88,686,158400,84052
207,198,9,-,170600,84053
7206,4965,2241,1327,363500,84054
435,375,60,-,428400,84055
998,7,991,1446,-,84056
11920,7545,4375,1117,300400,84057
10263,4759,5504,1154,324900,84058
4377,2309,2068,1618,399100,84059
3029,2122,907,1661,1502700,84060
159,111,48,930,602300,84061
13789,9738,4051,1325,365300,84062
97,79,18,-,233000,84063
193,98,95,571,150000,84064
14448,12282,2166,1472,445800,84065
4176,3186,990,846,197800,84066
12912,10867,2045,1197,252100,84067
178,140,38,988,265200,84069
10741,6513,4228,1365,330600,84070
612,596,16,644,341700,84071
156,127,29,831,260900,84072
104,104,0,-,188100,84073
16301,13756,2545,1136,261200,84074
8480,7781,699,1828,375900,84075
92,83,9,-,-,84076
9369,6770,2599,723,219800,84078
98,86,12,1100,187500,84080
14098,11844,2254,1419,371900,84081
280,272,8,-,438400,84082
386,106,280,598,136700,84083
10516,7589,2927,1516,304500,84084
92,65,27,-,151000,84085
164,159,5,-,151300,84086
4861,4163,698,1446,359500,84087
12432,9265,3167,1309,341300,84088
9087,8435,652,1874,542300,84092
7720,6810,910,1766,479700,84093
9366,7268,2098,1508,358800,84094
12578,9548,3030,1492,511500,84095
18672,15751,2921,1511,420400,84096
6703,4984,1719,1163,381800,84097
6304,5231,1073,2032,855200,84098
3888,930,2958,1087,417700,84101
9818,2256,7562,1111,384000,84102
11720,5473,6247,1106,580500,84103
7713,4304,3409,1102,230700,84104
9775,6102,3673,1270,471100,84105
14994,8736,6258,1360,392300,84106
15655,7388,8267,1171,311000,84107
7549,5931,1618,1448,630200,84108
9011,6994,2017,1420,502200,84109
6854,1575,5279,1013,336700,84111
236,0,236,915,-,84112
0,0,0,-,-,84113
0,0,0,-,-,84114
11684,4407,7277,999,290500,84115
12109,7011,5098,1112,246600,84116
10306,6996,3310,1435,432700,84117
11518,9420,2098,1537,248100,84118
15966,8478,7488,1208,239600,84119
13829,10012,3817,1221,273900,84120
15503,11529,3974,1451,441900,84121
13798,7943,5855,1210,314700,84123
8361,6369,1992,1255,545800,84124
8429,7441,988,1602,282500,84128
11854,9658,2196,1306,289900,84129
0,0,0,-,-,84138
0,0,0,-,-,84150
0,0,0,-,-,84180
262,226,36,1318,252500,84301
8578,6032,2546,830,248300,84302
29,29,0,-,-,84304
265,252,13,738,215400,84305
124,124,0,-,389900,84306
367,328,39,850,245500,84307
93,81,12,650,244200,84308
144,140,4,-,291700,84309
1735,1627,108,2526,589000,84310
227,165,62,833,244900,84311
1579,1195,384,745,247300,84312
13,6,7,-,-,84313
348,303,45,1036,276400,84314
2801,2786,15,-,367600,84315
101,89,12,883,158900,84316
1036,950,86,-,450000,84317
1435,1269,166,963,338500,84318
2758,2275,483,803,261700,84319
765,607,158,793,241500,84320
15261,7463,7798,835,260200,84321
0,0,0,-,-,84322
297,284,13,983,395600,84324
663,610,53,685,368300,84325
715,633,82,831,328900,84326
247,222,25,582,259300,84327
468,450,18,850,404300,84328
44,31,13,-,-,84329
134,126,8,-,228300,84330
91,74,17,1125,221900,84331
2548,2217,331,1168,356900,84332
924,749,175,761,262700,84333
64,64,0,-,250000,84334
4209,3497,712,949,276500,84335
74,70,4,775,170400,84336
4611,3522,1089,922,232900,84337
174,125,49,575,241000,84338
1562,1394,168,798,296300,84339
1093,948,145,1267,295500,84340
8246,3798,4448,1068,299900,84341
15301,8998,6303,960,281500,84401
13353,9165,4188,941,287900,84403
21856,16131,5725,1044,244800,84404
11700,8676,3024,1110,287800,84405
0,0,0,-,-,84408
9607,8156,1451,1154,345200,84414
4782,3312,1470,792,166200,84501
1332,973,359,792,208200,84511
215,186,29,-,74000,84512
491,393,98,685,143800,84513
0,0,0,-,-,84515
35,30,5,-,168800,84516
301,229,72,706,189200,84518
431,249,182,777,67200,84520
214,177,37,639,149500,84521
112,100,12,-,93300,84522
579,436,143,554,168400,84523
324,234,90,484,104600,84525
1763,1242,521,673,163100,84526
982,727,255,599,145400,84528
59,35,24,-,178100,84529
65,46,19,-,-,84530
118,111,7,-,29700,84531
4392,2891,1501,926,337100,84532
43,0,43,-,-,84533
758,642,116,622,58900,84534
952,773,179,1054,213800,84535
482,418,64,-,35000,84536
412,328,84,777,156000,84537
132,110,22,-,39100,84539
22,22,0,-,-,84540
595,394,201,704,132300,84542
11051,4826,6225,977,275300,84601
82,0,82,411,-,84602
11652,6097,5555,993,391700,84604
10178,2389,7789,959,308200,84606
402,378,24,675,171200,84620
42,42,0,-,-,84621
460,395,65,733,233500,84622
20,20,0,-,-,84623
1959,1322,637,834,202100,84624
99,69,30,-,319700,84626
1815,1025,790,783,295000,84627
227,215,12,-,150500,84628
1163,1101,62,1105,259600,84629
127,52,75,763,175000,84630
886,674,212,649,188600,84631
372,330,42,923,210000,84632
328,245,83,1005,225000,84633
595,487,108,985,216000,84634
296,187,109,901,97100,84635
173,141,32,1057,166800,84636
203,138,65,-,188600,84637
97,91,6,788,200700,84638
285,243,42,840,221500,84639
66,44,22,-,207700,84640
1181,795,386,1007,189400,84642
198,161,37,859,285400,84643
96,85,11,813,196900,84644
695,612,83,908,313000,84645
552,500,52,710,177300,84646
1404,1177,227,1130,215100,84647
2253,1633,620,821,300100,84648
289,256,33,530,167200,84649
7722,6428,1294,1243,313900,84651
302,262,40,758,171700,84652
2803,2577,226,1314,421000,84653
941,720,221,743,174500,84654
4016,3504,512,978,323800,84655
119,113,6,767,185600,84656
164,127,37,871,203800,84657
12118,9336,2782,1171,341000,84660
493,450,43,936,232400,84662
9904,6995,2909,1227,323000,84663
2993,2633,360,1444,502200,84664
180,169,11,-,246300,84665
111,67,44,819,244200,84667
2726,1823,903,685,209200,84701
51,34,17,1018,280000,84710
310,301,9,-,225000,84711
63,59,4,-,225000,84712
1242,1007,235,933,247200,84713
269,199,70,-,217300,84714
170,147,23,765,194200,84715
167,118,49,721,196400,84716
124,93,31,1009,173800,84718
30,24,6,-,-,84719
7563,4634,2929,840,276000,84720
8058,5642,2416,897,241600,84721
389,379,10,-,294200,84722
144,125,19,725,221500,84723
416,374,42,820,150000,84724
496,433,63,1205,251100,84725
382,264,118,743,184400,84726
20,6,14,-,-,84728
125,118,7,-,151100,84729
230,212,18,650,253800,84730
9,9,0,-,-,84731
18,18,0,-,281300,84732
151,136,15,-,-,84733
137,66,71,573,114300,84734
49,38,11,-,400000,84735
99,83,16,-,124200,84736
7255,5027,2228,1069,295100,84737
3713,3011,702,1287,367200,84738
183,124,59,850,173100,84739
87,82,5,-,145000,84740
2538,1941,597,1084,244700,84741
137,121,16,663,255000,84742
85,78,7,-,216700,84743
78,55,23,613,155200,84744
1428,1055,373,1118,239000,84745
438,395,43,836,367500,84746
389,246,143,805,260000,84747
86,86,0,-,300000,84749
190,162,28,-,213000,84750
592,494,98,922,156400,84751
283,244,39,919,201300,84752
0,0,0,-,-,84753
1437,1305,132,-,215700,84754
10,10,0,-,333300,84755
113,81,32,-,-,84756
586,511,75,1401,471300,84757
176,158,18,850,198100,84758
672,575,97,684,215500,84759
333,292,41,1029,218100,84760
1086,697,389,916,182500,84761
63,36,27,-,-,84762
120,94,26,960,380400,84763
89,12,77,655,-,84764
2343,1768,575,1627,382900,84765
66,47,19,-,178200,84766
227,170,57,725,694000,84767
16188,9319,6869,1107,312000,84770
97,44,53,641,292900,84772
78,52,26,-,169400,84773
506,478,28,1450,352200,84774
195,155,40,-,-,84775
187,163,24,925,185100,84776
264,235,29,881,371300,84779
9155,6386,2769,1266,370700,84780
116,104,12,-,424600,84781
235,187,48,-,312200,84782
444,367,77,-,449200,84783
168,83,85,983,340600,84784
17191,12670,4521,1254,373200,84790
4282,1443,2839,1110,420000,85003
4052,931,3121,1517,321500,85004
9286,3411,5875,932,280300,85006
5333,2101,3232,893,298300,85007
22582,6467,16115,1052,232200,85008
14167,6915,7252,926,143100,85009
4183,1820,2363,1364,538200,85012
10003,4463,5540,1143,369000,85013
12757,4753,8004,1140,337800,85014
15938,5484,10454,978,226400,85015
18082,8943,9139,1245,370700,85016
11948,5353,6595,978,164400,85017
16966,9208,7758,1137,621700,85018
7898,4040,3858,1087,178500,85019
16169,8538,7631,1127,310800,85020
16273,6386,9887,998,331100,85021
23116,11888,11228,1219,298700,85022
13599,8001,5598,1167,267100,85023
10054,6508,3546,1458,313500,85024
0,0,0,-,-,85026
16102,8676,7426,1211,233900,85027
7557,6412,1145,1456,430000,85028
18414,10192,8222,1116,227400,85029
8495,5102,3393,1115,178200,85031
28279,16105,12174,1180,292500,85032
16404,8649,7755,1109,177400,85033
2331,406,1925,889,240900,85034
15445,6989,8456,1097,176800,85035
14939,9155,5784,1347,204900,85037
10761,4850,5911,1030,191000,85040
17994,13023,4971,1213,221300,85041
14847,9144,5703,1228,239900,85042
10796,7079,3717,1300,207700,85043
17275,10898,6377,1440,333700,85044
2609,2345,264,2084,425900,85045
13195,9269,3926,1542,401000,85048
11738,8913,2825,1820,399300,85050
15641,8397,7244,982,204800,85051
11127,6693,4434,1092,242300,85053
4201,1522,2679,1714,403300,85054
6476,5985,491,1753,433800,85083
10265,6253,4012,1484,435300,85085
15500,12941,2559,1836,399500,85086
3366,3166,200,1505,387800,85087
6303,5834,469,1146,306100,85118
10377,8123,2254,953,211700,85119
13622,11111,2511,802,102500,85120
640,231,409,464,82800,85121
19441,12683,6758,1030,165800,85122
3874,2763,1111,903,147100,85123
5062,3294,1768,880,134100,85128
3334,2127,1207,808,141600,85131
8913,7304,1609,1052,195300,85132
141,121,20,-,51100,85135
908,736,172,1108,117100,85137
14714,12215,2499,1653,238600,85138
6265,4822,1443,1291,206100,85139
14790,11972,2818,1619,274500,85140
140,114,26,930,-,85141
23923,20568,3355,1736,361700,85142
12917,10002,2915,1538,241100,85143
1124,1007,117,1257,197100,85145
1237,706,531,333,92300,85147
618,299,319,908,128300,85172
1284,962,322,735,116300,85173
45,45,0,-,99800,85191
956,849,107,619,128000,85192
1489,1143,346,924,88800,85193
2966,2639,327,1009,241700,85194
21388,7470,13918,1105,202900,85201
16480,7889,8591,1123,257700,85202
13093,7319,5774,1146,285400,85203
23207,13247,9960,1174,232700,85204
18992,13373,5619,1125,235500,85205
15656,9858,5798,1378,235600,85206
18678,15054,3624,1313,345400,85207
14686,11518,3168,1275,186300,85208
17164,12779,4385,1447,262100,85209
15326,6688,8638,1090,231200,85210
13299,11032,2267,1603,367500,85212
13172,10598,2574,1299,315000,85213
7409,5859,1550,1554,292000,85215
20077,10555,9522,1486,293700,85224
27448,16560,10888,1358,278200,85225
16284,9898,6386,1430,342500,85226
14552,10154,4398,1612,337400,85233
17100,12310,4790,1575,378100,85234
0,0,0,-,-,85236
17310,13419,3891,1598,365400,85248
15533,13973,1560,2059,435900,85249
8212,6137,2075,1569,390900,85250
21337,9906,11431,1387,381400,85251
7462,6267,1195,1887,1423600,85253
18581,13169,5412,1604,537000,85254
17959,13303,4656,2023,734900,85255
1380,1076,304,639,77100,85256
14674,9208,5466,1389,326900,85257
12331,8895,3436,1627,590800,85258
9650,7298,2352,1384,704700,85259
17996,11032,6964,1712,483100,85260
6010,5703,307,2270,903300,85262
1674,1595,79,-,589700,85263
370,334,36,575,324300,85264
5247,5079,168,2566,788400,85266
11048,9080,1968,1419,451700,85268
26312,5398,20914,1289,272500,85281
23101,10228,12873,1346,282300,85282
19006,8719,10287,1359,305000,85283
7070,5756,1314,1837,480100,85284
16256,11368,4888,1768,411600,85286
17654,11770,5884,1588,378800,85295
16227,11987,4240,1742,364100,85296
10276,8054,2222,1774,381100,85297
13223,12223,1000,2271,440400,85298
22028,8261,13767,969,162100,85301
14502,7255,7247,1033,225400,85302
10001,5871,4130,1208,215100,85303
9494,7360,2134,1194,251000,85304
4631,2912,1719,1439,295400,85305
8985,5498,3487,1288,259400,85306
4005,1800,2205,1400,239500,85307
24944,18108,6836,1449,308100,85308
0,0,0,-,-,85309
6758,5697,1061,1888,364400,85310
249,201,48,1265,318600,85320
1607,1157,450,812,93200,85321
186,177,9,-,183500,85322
13468,8032,5436,1274,235500,85323
1233,1072,161,768,171600,85324
655,630,25,-,104500,85325
19376,15337,4039,1296,234500,85326
117,117,0,-,37400,85328
809,573,236,1100,167500,85329
12124,11125,999,1847,493700,85331
810,677,133,1110,210100,85332
236,143,93,874,105100,85333
558,301,257,606,-,85334
11300,7541,3759,1407,204700,85335
3085,1531,1554,691,153500,85336
799,415,384,786,102700,85337
19110,14660,4450,1515,296100,85338
14482,11113,3369,1693,288200,85339
11398,9019,2379,1669,371100,85340
16,0,16,-,-,85341
854,733,121,682,198600,85342
30,30,0,-,-,85343
4304,2826,1478,718,144100,85344
22323,14673,7650,1267,202800,85345
1341,906,435,1013,100700,85346
180,44,136,-,115900,85347
1261,1182,79,-,55900,85348
6027,4279,1748,705,143800,85349
5730,4093,1637,834,158500,85350
17400,14651,2749,1206,180600,85351
156,90,66,751,92700,85352
11274,7574,3700,1391,240400,85353
2432,2110,322,1095,205000,85354
3983,3713,270,2041,350400,85355
1896,1530,366,690,95200,85356
311,239,72,-,44500,85357
36,36,0,-,177800,85360
2319,2070,249,873,321800,85361
437,290,147,834,163800,85362
2588,1249,1339,1035,196900,85363
26634,15656,10978,864,155600,85364
18889,14101,4788,1092,145600,85365
9894,8276,1618,1082,137500,85367
131,29,102,-,-,85371
9223,8018,1205,1660,252100,85373
18619,14243,4376,1598,256700,85374
15811,13993,1818,1299,263600,85375
1797,1603,194,1493,796500,85377
4018,2265,1753,1092,169300,85378
14871,10921,3950,1690,287300,85379
10433,6844,3589,1412,298900,85381
17240,11902,5338,1551,291900,85382
21972,20210,1762,1874,443900,85383
6181,5731,450,1724,353800,85387
10011,8118,1893,1763,294400,85388
4424,3573,851,896,295800,85390
13267,8096,5171,1443,271800,85392
12412,10114,2298,1678,380500,85395
10599,9818,781,1805,345700,85396
5181,3746,1435,857,124400,85501
464,416,48,-,33900,85530
243,67,176,1686,172900,85531
111,98,13,-,113500,85532
1132,963,169,707,77900,85533
931,750,181,541,122700,85534
0,0,0,-,-,85535
160,128,32,-,129200,85536
1207,846,361,806,75300,85539
1158,0,1158,503,-,85540
10712,8618,2094,1042,252100,85541
746,310,436,480,30400,85542
1435,1029,406,905,153800,85543
1419,1211,208,950,320000,85544
377,280,97,697,171700,85545
6231,4689,1542,791,151100,85546
1300,709,591,336,52800,85550
131,103,28,561,154700,85551
2069,1451,618,874,198000,85552
883,741,142,379,154100,85553
276,222,54,543,246700,85554
330,276,54,-,72600,85601
4131,3152,979,760,149500,85602
3229,2348,881,786,162700,85603
228,147,81,575,73900,85605
361,290,71,753,152900,85606
5519,3717,1802,648,107700,85607
0,0,0,-,-,85608
195,195,0,-,-,85609
311,276,35,613,128900,85610
586,552,34,-,268400,85611
882,0,882,1297,-,85613
13132,10788,2344,1091,200700,85614
3781,3423,358,693,192700,85615
2271,1505,766,829,133000,85616
554,435,119,511,106500,85617
541,419,122,777,63800,85618
17,17,0,-,-,85619
334,281,53,596,66000,85620
7482,3797,3685,600,137200,85621
3576,3254,322,1130,260300,85622
2304,2030,274,938,264200,85623
672,362,310,964,291000,85624
969,853,116,722,118800,85625
353,302,51,-,82800,85626
179,178,1,-,123300,85627
9152,7690,1462,1390,233100,85629
876,665,211,706,123200,85630
1609,1259,350,680,91100,85631
384,316,68,672,123000,85632
12,0,12,-,-,85633
1650,966,684,594,80600,85634
15395,9204,6191,895,164500,85635
464,416,48,-,388400,85637
793,586,207,803,145800,85638
104,62,42,-,-,85639
43,43,0,-,-,85640
9993,9311,682,1686,275400,85641
3087,2150,937,690,121900,85643
627,571,56,-,181600,85645
660,569,91,1615,361000,85646
6669,5463,1206,921,163700,85648
5929,4933,996,1101,247000,85650
6626,5462,1164,1031,195700,85653
0,0,0,-,-,85654
6457,5704,753,1393,358000,85658
2939,776,2163,985,340100,85701
15821,9024,6797,1165,314300,85704
24779,11674,13105,770,89700,85705
18211,10320,7891,882,116000,85706
0,0,0,-,-,85707
1309,10,1299,1398,-,85708
0,0,0,-,-,85709
24664,13595,11069,999,185000,85710
17570,8563,9007,866,181600,85711
16437,6435,10002,814,186000,85712
16496,10378,6118,850,123700,85713
5561,2927,2634,747,135900,85714
8581,5748,2833,1104,255500,85715
15729,6353,9376,848,223400,85716
12747,8379,4368,1047,562100,85718
18548,5289,13259,902,245100,85719
0,0,0,-,-,85721
0,0,0,-,-,85723
0,0,0,-,-,85724
0,0,0,-,-,85726
15441,10462,4979,996,163600,85730
0,0,0,-,-,85734
4060,3637,423,1033,154300,85735
1794,1529,265,889,109300,85736
9666,7392,2274,1540,339100,85737
8471,7630,841,1266,312200,85739
14053,8442,5611,1206,202800,85741
11516,8832,2684,1341,244500,85742
11768,10016,1752,1351,249300,85743
16314,10244,6070,925,244800,85745
15645,10893,4752,1034,162600,85746
8791,7026,1765,1502,250500,85747
8082,6005,2077,1227,255400,85748
7663,6481,1182,1195,438500,85749
11659,8684,2975,1108,428900,85750
7731,6865,866,1499,359300,85755
11200,8869,2331,1114,155100,85756
6448,5213,1235,800,202000,85757
7494,5502,1992,945,193800,85901
0,0,0,-,-,85902
333,172,161,536,59200,85911
98,98,0,-,118400,85912
293,255,38,892,275000,85920
44,44,0,-,231400,85922
229,208,21,-,155200,85923
892,856,36,-,126400,85924
1447,1204,243,601,182500,85925
251,66,185,378,66700,85926
39,39,0,-,-,85927
211,133,78,1034,294800,85928
3226,2402,824,1014,187600,85929
306,161,145,487,93600,85930
96,87,9,-,382600,85931
181,181,0,-,376700,85932
1373,1075,298,807,223800,85933
236,201,35,-,310300,85934
2003,1676,327,758,267700,85935
928,798,130,686,117800,85936
2786,2299,487,1006,187200,85937
873,629,244,822,121900,85938
1445,1199,246,-,219300,85939
477,416,61,-,193300,85940
2739,1620,1119,518,64000,85941
0,0,0,-,-,85942
12703,4848,7855,1382,412400,86001
29,22,7,-,164300,86003
13863,8907,4956,1428,367600,86004
6607,3926,2681,1367,444400,86005
33,2,31,1148,-,86011
545,470,75,-,398000,86015
19,19,0,-,-,86016
493,479,14,-,324300,86017
333,269,64,2122,382000,86018
635,570,65,590,65300,86020
708,352,356,1750,173000,86021
752,569,183,673,149100,86022
453,112,341,729,32800,86023
485,462,23,-,323300,86024
1686,1076,610,747,113400,86025
15,15,0,-,-,86028
27,27,0,-,-,86029
278,230,48,-,111300,86030
646,480,166,715,60900,86031
578,415,163,822,153600,86032
2584,1462,1122,625,32300,86033
535,343,192,562,67300,86034
572,444,128,436,65300,86035
88,57,31,-,100700,86036
39,39,0,-,270800,86038
537,499,38,750,114700,86039
3777,2391,1386,1065,90000,86040
628,329,299,842,68100,86042
589,463,126,-,96000,86043
1120,848,272,648,44300,86044
3300,1971,1329,769,54700,86045
2438,1787,651,1027,257800,86046
4118,2385,1733,733,96500,86047
0,0,0,-,-,86052
716,618,98,568,49300,86053
578,409,169,544,54700,86054
11194,7962,3232,1205,354400,86301
9352,6381,2971,941,378400,86303
8549,6899,1650,917,482300,86305
0,0,0,-,-,86313
15876,10156,5720,1108,265400,86314
3689,3259,430,1820,356600,86315
1240,1144,96,813,151700,86320
878,108,770,565,31200,86321
4308,3304,1004,761,214800,86322
8248,6730,1518,1018,268100,86323
2375,1751,624,844,308500,86324
2502,1861,641,1243,286000,86325
11417,7054,4363,967,233500,86326
4726,4227,499,1075,295500,86327
454,373,81,989,202400,86329
226,144,82,867,328200,86331
1030,919,111,707,137500,86332
2635,2036,599,732,126600,86333
1773,1239,534,906,241500,86334
2462,1463,999,1099,221600,86335
5647,4169,1478,1240,548500,86336
747,613,134,538,107000,86337
261,175,86,760,694000,86338
61,37,24,-,307500,86343
3407,2245,1162,1348,498700,86351
11657,8139,3518,946,188600,86401
8197,5166,3031,889,224500,86403
8365,6813,1552,1044,316800,86404
11683,9001,2682,1086,321500,86406
12832,8848,3984,814,135900,86409
202,188,14,-,138900,86411
4914,4306,608,666,92000,86413
6588,5292,1296,925,198600,86426
3968,2589,1379,889,275900,86429
189,107,82,570,89100,86431
1852,1330,522,736,119400,86432
26,26,0,-,-,86433
518,268,250,568,69300,86434
0,0,0,-,-,86435
763,429,334,-,79500,86436
23,18,5,-,259100,86437
338,324,14,-,139300,86438
3255,2584,671,687,203700,86440
924,825,99,942,84300,86441
14982,9106,5876,845,132600,86442
0,0,0,-,-,86443
786,721,65,-,88600,86444
129,129,0,-,136200,86445
300,285,15,630,36500,86502
3005,2248,757,516,31100,86503
1599,1163,436,623,34700,86504
1963,1656,307,485,32500,86505
422,405,17,608,41300,86506
576,530,46,-,48000,86507
182,171,11,-,25700,86508
1323,1056,267,553,111100,86510
951,890,61,608,44700,86511
714,485,229,563,62800,86512
873,632,241,800,48000,86514
994,580,414,533,55700,86515
706,646,60,775,62900,86520
343,337,6,-,41100,86535
554,401,153,476,23900,86538
228,180,48,418,33300,86540
356,312,44,438,49500,86544
340,299,41,600,41800,86545
266,243,23,-,40900,86547
560,370,190,388,41600,86556
1061,724,337,766,251600,87001
7501,5801,1700,774,133400,87002
4693,3504,1189,810,174100,87004
67,67,0,-,-,87005
305,281,24,-,183900,87006
309,187,122,227,-,87007
1157,1048,109,1145,291300,87008
615,371,244,1164,304900,87010
0,0,0,-,-,87011
190,136,54,-,320300,87012
1557,1160,397,678,87300,87013
259,223,36,-,20100,87014
5929,5360,569,1208,215700,87015
1088,883,205,663,127800,87016
154,151,3,-,184400,87017
196,129,67,-,48800,87018
3430,2268,1162,765,117600,87020
917,679,238,743,46200,87021
217,211,6,-,-,87022
182,182,0,-,146200,87023
615,430,185,909,124300,87024
629,588,41,1150,370300,87025
1124,902,222,435,83100,87026
157,73,84,592,108900,87027
49,49,0,-,-,87028
160,138,22,-,168200,87029
14324,11832,2492,1038,154800,87031
92,92,0,-,-,87032
705,666,39,-,86400,87034
2301,1872,429,683,120100,87035
584,507,77,-,112900,87036
441,366,75,625,66000,87037
73,73,0,-,-,87038
146,146,0,-,42000,87040
319,271,48,790,137100,87041
1376,1175,201,595,214800,87042
1909,1733,176,1201,423000,87043
73,73,0,-,-,87044
488,448,40,497,25500,87045
74,74,0,-,225000,87046
1897,1665,232,1161,323600,87047
3673,3371,302,1154,437500,87048
68,68,0,-,-,87049
424,424,0,-,72400,87051
548,386,162,683,-,87052
345,241,104,870,179200,87053
496,467,29,1048,211600,87056
4056,3724,332,1207,275100,87059
0,0,0,-,-,87060
132,132,0,-,-,87061
538,446,92,752,71600,87062
110,80,30,-,83000,87063
55,55,0,-,-,87064
1904,1789,115,818,230700,87068
9,0,9,-,-,87070
177,154,23,542,116700,87072
238,217,21,1225,159600,87083
0,0,0,-,-,87101
9798,3373,6425,754,133500,87102
5856,3809,2047,944,260100,87104
18886,13621,5265,802,151500,87105
11909,5009,6900,804,274400,87106
12334,7801,4533,815,242500,87107
17128,5941,11187,721,171600,87108
18919,9603,9316,954,245500,87109
18135,10939,7196,944,207000,87110
25998,15756,10242,1108,286900,87111
18760,11212,7548,905,200800,87112
6417,4475,1942,1298,305800,87113
26615,18207,8408,1173,234200,87114
1384,54,1330,1410,271200,87116
0,0,0,-,-,87117
25860,19962,5898,1206,219200,87120
25665,18570,7095,1093,150800,87121
6559,5969,590,1617,524500,87122
18500,12035,6465,858,193600,87123
21614,16458,5156,1130,199100,87124
16204,13332,2872,1292,220200,87144
0,0,0,-,-,87151
7428,4097,3331,741,120700,87301
601,567,34,-,46700,87305
288,266,22,-,64100,87310
1241,991,250,774,33500,87311
171,136,35,-,24300,87312
1614,1017,597,505,67400,87313
56,56,0,-,-,87315
485,282,203,941,58300,87316
329,284,45,-,81200,87317
735,640,95,-,36700,87319
193,175,18,-,34600,87320
725,546,179,1064,111700,87321
137,134,3,-,101300,87322
1388,1234,154,823,76900,87323
672,571,101,636,55100,87325
591,562,29,-,53800,87326
1804,1509,295,521,72200,87327
800,296,504,561,42300,87328
117,81,36,-,119200,87347
327,175,152,538,-,87357
497,449,48,425,65000,87364
22,19,3,-,-,87365
1155,1064,91,1061,37200,87375
15255,9694,5561,894,168100,87401
3509,2654,855,968,229500,87402
5838,4380,1458,827,166200,87410
438,391,47,-,142000,87412
5168,3888,1280,784,158900,87413
825,594,231,1311,168100,87415
1349,1087,262,907,77700,87416
1473,892,581,731,156600,87417
357,334,23,-,168800,87418
161,123,38,-,98300,87419
3201,1936,1265,587,74800,87420
513,443,70,-,104100,87421
520,453,67,594,28500,87455
451,429,22,-,40100,87461
293,247,46,770,82500,87499
7913,5104,2809,1429,509600,87501
15273,9449,5824,1171,375100,87505
6710,5433,1277,969,375500,87506
19449,13355,6094,1126,248600,87507
7333,6567,766,1546,394500,87508
449,361,88,-,-,87510
697,551,146,380,158500,87511
84,84,0,-,-,87512
433,349,84,-,426200,87513
542,542,0,-,425900,87514
82,66,16,-,355900,87515
28,28,0,-,-,87516
216,182,34,-,233300,87517
0,0,0,-,-,87518
281,252,29,-,-,87519
568,486,82,467,185300,87520
335,261,74,825,160000,87521
1276,1094,182,-,182500,87522
161,144,17,-,112100,87523
118,118,0,-,-,87524
22,22,0,-,444400,87525
250,250,0,-,268800,87527
753,446,307,507,70600,87528
1921,1639,282,1313,337100,87529
436,436,0,-,-,87530
91,91,0,-,-,87531
7091,4804,2287,793,187800,87532
917,694,223,1132,295500,87535
841,619,222,582,181700,87537
143,71,72,-,166100,87538
54,54,0,-,-,87539
515,324,191,-,543700,87540
45,45,0,-,-,87543
5993,4012,1981,1129,338500,87544
2036,1951,85,1555,351300,87547
233,174,59,-,-,87548
486,426,60,-,149700,87549
109,109,0,-,-,87551
915,704,211,684,114800,87552
477,380,97,767,163400,87553
0,0,0,-,-,87554
922,758,164,697,147400,87556
1965,1599,366,1172,319400,87557
380,210,170,880,428800,87558
563,450,113,617,123600,87560
139,113,26,-,-,87562
44,44,0,-,-,87564
190,190,0,-,-,87565
644,565,79,613,339700,87566
344,226,118,854,-,87567
282,270,12,-,157300,87569
4372,3208,1164,869,319600,87571
14,14,0,-,-,87573
318,187,131,842,-,87575
136,136,0,-,-,87577
143,80,63,977,155800,87578
423,309,114,-,130600,87579
222,222,0,-,-,87580
15,15,0,-,-,87581
340,293,47,-,230600,87582
173,124,49,-,69400,87583
7799,5028,2771,634,141100,87701
642,508,134,800,295000,87710
260,237,23,-,54000,87711
174,174,0,-,"10,000-",87712
176,151,25,-,-,87713
564,257,307,554,149500,87714
225,203,22,-,-,87715
272,226,46,959,155400,87718
436,423,13,-,114400,87722
177,177,0,-,114700,87723
22,0,22,-,-,87724
182,125,57,489,75000,87728
45,45,0,-,597200,87729
9,5,4,-,112500,87730
132,113,19,-,211700,87731
434,364,70,-,-,87732
31,20,11,-,91700,87733
107,92,15,-,-,87734
43,24,19,-,-,87735
22,22,0,-,-,87736
3258,2267,991,625,111200,87740
145,145,0,-,234800,87742
123,83,40,930,-,87743
410,396,14,-,122800,87745
26,24,2,-,226500,87746
601,477,124,605,90600,87747
39,39,0,-,-,87749
0,0,0,-,-,87750
295,231,64,498,91300,87752
24,24,0,-,-,87753
2918,2008,910,666,134100,87801
75,70,5,-,109800,87820
336,320,16,-,259000,87821
94,94,0,-,118200,87823
48,48,0,-,-,87824
780,671,109,763,81500,87825
105,48,57,-,-,87827
139,126,13,-,158800,87828
358,327,31,-,186900,87829
285,217,68,683,162500,87830
81,75,6,-,-,87831
67,67,0,-,-,87832
2708,1850,858,541,85900,87901
303,227,76,-,201200,87930
404,272,132,778,129300,87931
55,55,0,-,-,87933
1003,902,101,1054,172000,87935
113,113,0,-,126600,87936
1044,830,214,404,108700,87937
96,96,0,-,358300,87939
133,93,40,-,-,87940
253,121,132,-,-,87941
441,355,86,720,112800,87942
107,107,0,-,-,87943
14806,6473,8333,713,123100,88001
374,18,356,1164,-,88002
0,0,0,-,-,88003
0,0,0,-,-,88004
10949,6309,4640,775,164500,88005
8690,6965,1725,722,195600,88007
4001,3137,864,891,197600,88008
0,0,0,-,-,88009
13486,7871,5615,948,270500,88011
10579,8354,2225,1078,156200,88012
306,258,48,-,108300,88020
5141,3735,1406,607,117500,88021
266,205,61,641,159300,88022
898,569,329,625,87300,88023
180,102,78,478,70300,88024
40,40,0,-,-,88025
587,399,188,629,82100,88026
245,188,57,673,176000,88027
110,83,27,-,207300,88028
385,222,163,363,71800,88029
8662,5478,3184,550,91100,88030
10,10,0,-,-,88034
107,74,33,-,-,88038
292,273,19,-,120800,88039
32,23,9,-,56500,88040
463,375,88,-,111600,88041
200,168,32,-,241700,88042
642,483,159,898,72200,88043
912,801,111,-,120700,88044
1151,782,369,617,83100,88045
358,208,150,843,218400,88046
588,555,33,-,88100,88047
1206,1040,166,584,85300,88048
376,321,55,-,164600,88049
52,35,17,-,99200,88051
96,56,40,793,-,88052
85,24,61,703,-,88053
21,21,0,-,-,88055
111,93,18,-,123300,88056
7176,4758,2418,730,153300,88061
4074,2974,1100,545,106200,88063
284,234,50,-,134100,88065
619,470,149,426,87900,88072
4139,2883,1256,749,82300,88081
17171,9526,7645,920,140700,88101
0,0,0,-,-,88103
112,101,11,-,347500,88112
38,16,22,-,57500,88113
25,25,0,-,243200,88114
15,15,0,-,-,88115
149,120,29,-,66000,88116
141,111,30,385,-,88118
549,349,200,656,143100,88119
174,93,81,-,117100,88120
59,47,12,558,154200,88121
365,299,66,742,113800,88124
21,6,15,-,-,88125
7,7,0,-,-,88126
6395,3755,2640,773,119700,88130
102,45,57,627,114200,88132
36,14,22,-,-,88134
523,374,149,885,112000,88135
13,8,5,-,-,88136
9968,7119,2849,928,172300,88201
10641,6610,4031,752,97200,88203
6915,4481,2434,945,179600,88210
14453,10582,3871,1100,164300,88220
1706,1273,433,775,89200,88230
1226,966,260,1048,110700,88231
638,492,146,652,113600,88232
13876,8677,5199,983,143700,88240
2606,2083,523,994,206300,88242
0,0,0,-,-,88244
107,61,46,-,-,88250
840,641,199,703,90600,88252
291,203,88,930,104200,88253
44,36,8,-,-,88254
27,27,0,-,-,88255
676,487,189,1003,138200,88256
4620,3436,1184,895,142400,88260
4,4,0,-,-,88262
62,46,16,-,-,88263
0,0,0,-,-,88264
70,70,0,-,221000,88265
584,419,165,833,69300,88267
0,0,0,-,-,88268
630,540,90,568,73200,88301
15049,9689,5360,777,132700,88310
434,380,54,571,72200,88311
1181,1181,0,-,275900,88312
59,59,0,-,-,88314
943,782,161,858,145000,88316
778,671,107,699,178300,88317
170,140,30,-,205600,88318
141,116,25,-,-,88321
0,0,0,-,-,88323
47,47,0,-,-,88324
430,363,67,-,223900,88325
1179,0,1179,1141,-,88330
171,150,21,-,-,88336
827,686,141,578,121600,88337
113,72,41,-,-,88338
225,225,0,-,233100,88339
1041,603,438,297,35700,88340
270,259,11,-,232400,88341
0,0,0,-,-,88342
13,13,0,-,-,88343
27,27,0,-,116900,88344
3669,2749,920,828,196700,88345
1017,595,422,560,106700,88346
17,17,0,-,-,88347
352,284,68,-,-,88348
0,0,0,-,-,88349
51,51,0,-,-,88350
107,80,27,-,261300,88351
1401,1221,180,844,124200,88352
124,68,56,382,48200,88353
57,57,0,-,-,88354
53,53,0,-,-,88355
2563,1622,941,595,62000,88401
60,60,0,-,-,88410
37,33,4,-,237500,88411
33,13,20,-,-,88414
999,694,305,449,119800,88415
109,109,0,-,-,88416
21,0,21,-,-,88417
118,79,39,675,-,88418
20,16,4,-,-,88419
19,0,19,-,-,88421
38,23,15,-,-,88422
19,15,4,-,-,88424
453,386,67,945,88300,88426
42,37,5,-,83000,88427
76,68,8,-,-,88430
43,43,0,-,-,88431
107,66,41,547,90000,88434
888,710,178,388,110500,88435
34,24,10,-,-,88436
0,0,0,-,-,88439
510,368,142,666,130000,89001
12737,10395,2342,1494,338800,89002
514,200,314,709,75000,89003
110,83,27,-,397200,89004
6163,4441,1722,1171,331000,89005
235,186,49,-,291000,89007
479,292,187,664,155300,89008
171,112,59,345,109100,89010
11975,8000,3975,1380,338700,89011
15372,9399,5973,1632,382200,89012
125,88,37,534,62500,89013
16801,8293,8508,1349,324800,89014
14698,9041,5657,1141,284800,89015
22,22,0,-,-,89017
255,200,55,832,180400,89018
1122,849,273,668,190500,89019
644,376,268,528,118600,89020
946,760,186,1016,334400,89021
0,0,0,-,-,89022
359,225,134,713,231500,89025
0,0,0,-,-,89026
7172,5272,1900,965,258300,89027
4286,2215,2071,840,184300,89029
15547,5372,10175,958,181900,89030
22927,16616,6311,1544,279700,89031
15383,9477,5906,1333,264100,89032
1350,1286,64,1647,374100,89034
138,104,34,710,72200,89039
1555,1091,464,991,153400,89040
328,260,68,814,209800,89042
389,316,73,-,191000,89043
10165,8577,1588,1768,410600,89044
993,624,369,919,61300,89045
237,143,94,588,96100,89046
59,33,26,-,34100,89047
9938,7095,2843,1051,228500,89048
1286,596,690,725,156200,89049
23531,14813,8718,1647,444500,89052
94,94,0,-,-,89054
4883,3908,975,795,166100,89060
3087,2608,479,1388,259800,89061
0,0,0,-,-,89070
20496,11948,8548,1467,354400,89074
12436,7826,4610,1509,289400,89081
10271,6830,3441,1614,349300,89084
1375,1222,153,2060,345600,89085
2437,966,1471,1368,299000,89086
15669,2900,12769,820,195600,89101
15234,3992,11242,1004,284400,89102
22333,7123,15210,1088,203100,89103
14867,6451,8416,959,219300,89104
9353,2919,6434,1024,191700,89106
13016,6447,6569,1127,227500,89107
26508,12018,14490,1165,229800,89108
3259,1076,2183,970,401900,89109
21368,11352,10016,1125,232300,89110
13607,7714,5893,1456,371700,89113
18947,6770,12177,1079,185100,89115
22820,10742,12078,1326,383900,89117
8737,3702,5035,1309,318800,89118
22229,4401,17828,986,249500,89119
9254,5109,4145,1167,285000,89120
24244,11876,12368,1087,215200,89121
18997,10919,8078,1148,209900,89122
23534,13235,10299,1408,337000,89123
282,256,26,1057,390700,89124
15000,7774,7226,1342,290000,89128
20417,13785,6632,1457,332700,89129
12473,8776,3697,1435,310300,89130
16970,12882,4088,1706,396200,89131
11252,9267,1985,1717,352300,89134
12782,9407,3375,1993,487400,89135
7082,5610,1472,1983,596000,89138
13350,8101,5249,1657,349600,89139
12596,9146,3450,1743,394500,89141
10548,6387,4161,1226,236900,89142
4115,3076,1039,1571,324000,89143
7962,5135,2827,1672,401700,89144
9638,6219,3419,1289,264600,89145
7635,3327,4308,1184,319700,89146
21163,10927,10236,1458,290400,89147
21838,12832,9006,1654,349300,89148
15731,10703,5028,1497,372700,89149
9750,5602,4148,1127,207700,89156
288,179,109,2028,1437500,89158
213,184,29,-,466700,89161
9077,6262,2815,1555,352700,89166
9957,1884,8073,969,216400,89169
13921,9894,4027,1657,355500,89178
3736,3108,628,1818,334900,89179
14375,7431,6944,1464,289500,89183
0,0,0,-,-,89191
2652,1879,773,852,168200,89301
107,82,25,-,96000,89310
78,48,30,-,-,89311
89,48,41,425,35000,89314
14,14,0,-,-,89315
278,182,96,718,183800,89316
138,138,0,-,206900,89317
445,302,143,1362,117600,89318
137,137,0,-,66300,89319
82,54,28,-,"2,000,000+",89402
6219,5000,1219,1165,297400,89403
17,17,0,-,-,89404
53,0,53,-,-,89405
9753,6584,3169,1003,223700,89406
8050,5977,2073,1246,280900,89408
86,64,22,-,35600,89409
4814,3348,1466,1118,423400,89410
413,387,26,-,904000,89411
48,30,18,-,-,89412
359,332,27,-,"2,000,000+",89413
50,50,0,-,114500,89414
1267,948,319,916,156900,89415
92,92,0,-,45300,89418
1364,827,537,634,148400,89419
6,0,6,-,-,89420
228,196,32,-,61200,89421
95,89,6,-,-,89422
4501,3897,604,1675,491800,89423
164,141,23,431,54500,89424
215,160,55,-,207300,89425
64,64,0,-,-,89426
362,244,118,502,56400,89427
39,30,9,-,373300,89428
3288,2666,622,1089,196600,89429
58,44,14,-,352600,89430
15340,6962,8378,1008,262700,89431
7257,4919,2338,1047,227100,89433
10698,6687,4011,1448,329400,89434
16844,12508,4336,1710,402300,89436
0,0,0,-,-,89437
13,13,0,-,-,89438
775,622,153,921,508300,89439
259,259,0,-,355400,89440
4692,3948,744,1913,466100,89441
320,207,113,704,120500,89442
1498,1265,233,1110,327400,89444
6614,4619,1995,861,222900,89445
0,0,0,-,-,89446
3576,2406,1170,734,167800,89447
895,735,160,1457,913900,89448
1415,801,614,1302,664600,89449
0,0,0,-,-,89450
4041,2867,1174,1628,1053200,89451
5533,4131,1402,1184,382700,89460
0,0,0,-,-,89496
2647,631,2016,877,355700,89501
18903,6334,12569,1056,309600,89502
12692,5643,7049,1123,350700,89503
15252,10228,5024,1377,308400,89506
4942,4610,332,1640,331200,89508
16834,8958,7876,1203,500400,89509
522,475,47,550,405700,89510
11854,8245,3609,1581,720800,89511
11246,3264,7982,951,266500,89512
3793,3026,767,1769,684500,89519
14060,10245,3815,1735,467200,89521
15139,9121,6018,1469,442300,89523
0,0,0,-,-,89557
10605,6231,4374,995,322000,89701
4777,3384,1393,839,456300,89703
1815,1730,85,973,454900,89704
2243,1727,516,1381,343300,89705
8474,4726,3748,1108,252900,89706
9444,5865,3579,1110,224000,89801
5012,4501,511,1485,266700,89815
2207,1694,513,792,176100,89820
260,231,29,1077,-,89821
778,474,304,1025,167500,89822
156,150,6,-,445900,89823
329,111,218,581,-,89825
0,0,0,-,-,89826
134,122,12,-,-,89828
15,15,0,-,-,89830
26,26,0,-,-,89831
384,236,148,476,53200,89832
51,21,30,-,-,89833
23,14,9,-,-,89834
476,348,128,959,223500,89835
1884,855,1029,725,176200,89883
13421,4774,8647,1262,425200,90001
13011,5132,7879,1287,411500,90002
17759,4851,12908,1293,430800,90003
22231,3632,18599,1530,1148400,90004
15993,1273,14720,1413,964700,90005
18850,1780,17070,1234,716900,90006
12211,1447,10764,1252,717300,90007
14425,4801,9624,1377,781600,90008
2247,359,1888,2253,822100,90010
24603,6733,17870,1307,452100,90011
14361,882,13479,1859,633000,90012
7724,643,7081,855,664800,90013
5803,160,5643,1460,625000,90014
11746,847,10899,2094,715000,90015
17387,6232,11155,1436,677500,90016
12996,643,12353,1280,697100,90017
16394,5298,11096,1356,704300,90018
23584,6239,17345,1574,1033900,90019
16881,1590,15291,1524,650300,90020
1454,120,1334,756,1013900,90021
17266,6000,11266,1208,471000,90022
11832,3086,8746,1260,479600,90023
16359,5428,10931,2441,1231000,90024
21470,5418,16052,2271,905900,90025
25968,6222,19746,1497,962100,90026
21133,4282,16851,1684,1287200,90027
16833,765,16068,1612,723000,90028
13218,1498,11720,1367,898400,90029
11868,3951,7917,1277,616900,90031
13314,6936,6378,1351,605400,90032
13240,2750,10490,1196,538900,90033
24938,5087,19851,1925,1152500,90034
11310,3747,7563,2183,1494600,90035
18990,3022,15968,2393,1634700,90036
17772,4440,13332,1265,502000,90037
12595,1127,11468,1542,945000,90038
11992,5298,6694,1887,972900,90039
3424,1907,1517,1156,452100,90040
10001,5141,4860,1627,886800,90041
20844,9439,11405,1581,731600,90042
17052,9297,7755,1260,684500,90043
28202,8259,19943,1235,461200,90044
15666,7846,7820,2542,1103500,90045
28249,6388,21861,1860,1290400,90046
16853,9393,7460,1310,519400,90047
11474,3450,8024,2162,1441200,90048
16116,8674,7442,2554,"2,000,000+",90049
0,0,0,-,-,90052
3556,2035,1521,1911,1114900,90056
17179,524,16655,1260,576200,90057
979,188,791,882,419600,90058
10162,4720,5442,1131,415100,90059
7844,3151,4693,1304,438800,90061
9796,4621,5175,1375,550600,90062
13616,5113,8503,1252,481100,90063
11144,5838,5306,2282,1388300,90064
16180,7556,8624,1588,833400,90065
24647,9066,15581,1901,1282100,90066
1531,1121,410,3362,1344900,90067
11528,5451,6077,1837,1500800,90068
12844,5117,7727,2092,890100,90069
10,10,0,-,-,90071
0,0,0,-,-,90073
2899,2491,408,2667,"2,000,000+",90077
0,0,0,-,-,90079
5,0,5,-,-,90089
5560,1980,3580,3479,1132000,90094
0,0,0,-,-,90095
23847,5459,18388,1368,440500,90201
7947,5931,2016,2872,"2,000,000+",90210
3801,1315,2486,2369,"2,000,000+",90211
5503,1236,4267,2367,"2,000,000+",90212
13704,8548,5156,1278,394900,90220
12531,6709,5822,1366,412600,90221
8511,4478,4033,1295,420700,90222
13792,7998,5794,2129,849200,90230
7101,2872,4229,2245,1219100,90232
7670,4893,2777,1730,646900,90240
14098,5795,8303,1636,627700,90241
12729,6220,6509,1703,557700,90242
7070,2969,4101,2210,1244200,90245
16082,6350,9732,1483,540800,90247
3857,2582,1275,1410,571200,90248
8869,5072,3797,1375,584000,90249
31962,10121,21841,1465,661400,90250
8926,4535,4391,2498,1674500,90254
18168,5868,12300,1215,455000,90255
10281,4603,5678,1686,597300,90260
15026,7294,7732,1355,449600,90262
0,0,0,-,-,90263
6463,5120,1343,3103,"2,000,000+",90265
13422,9096,4326,2893,"2,000,000+",90266
6320,1728,4592,1226,481800,90270
8074,6379,1695,2977,"2,000,000+",90272
8962,7983,979,2931,1757700,90274
15397,12143,3254,3045,1247000,90275
16590,7789,8801,2315,1143800,90277
15889,9310,6579,2222,992600,90278
23824,10717,13107,1278,470200,90280
2003,1405,598,"3,500+",1184900,90290
13535,5010,8525,2304,1899800,90291
13048,4277,8771,3179,1076900,90292
6625,3082,3543,2380,899000,90293
12110,3220,8890,1420,547900,90301
10456,3296,7160,1550,590000,90302
6844,2635,4209,1498,606100,90303
7067,2108,4959,1255,586600,90304
5880,3591,2289,1662,646500,90305
4678,279,4399,2201,1393800,90401
4906,3555,1351,2083,"2,000,000+",90402
13164,3355,9809,2200,1523400,90403
10562,2294,8268,1900,922900,90404
14247,4519,9728,1970,1430800,90405
14423,6800,7623,1578,724900,90501
6342,4282,2060,1550,520700,90502
17173,9043,8130,1943,861000,90503
11662,7136,4526,1889,712300,90504
14177,7889,6288,2000,916100,90505
0,0,0,-,-,90506
10782,6443,4339,1567,626500,90601
8032,3025,5007,1466,601600,90602
6490,5303,1187,1963,649600,90603
11781,7793,3988,1630,591400,90604
11107,7344,3763,1572,556000,90605
8692,5999,2693,1606,509600,90606
13124,9657,3467,2066,622700,90620
10744,3939,6805,1743,643200,90621
4944,3234,1710,1941,739200,90623
16118,11005,5113,2068,700100,90630
21886,13527,8359,1747,628900,90631
14803,11433,3370,1796,630100,90638
0,0,0,-,-,90639
19191,8520,10671,1543,558600,90640
26353,17595,8758,1738,487800,90650
16996,11760,5236,1569,490300,90660
5212,3533,1679,1638,492100,90670
9667,4771,4896,1771,472800,90680
4417,2355,2062,1856,635000,90701
15687,11897,3790,2459,762700,90703
1543,503,1040,1677,863800,90704
24018,9126,14892,1570,535300,90706
9150,4962,4188,1321,523400,90710
10247,7676,2571,2058,622800,90712
9583,8126,1457,2268,638600,90713
6573,3666,2907,1873,555400,90715
3659,1640,2019,1584,442000,90716
8255,3497,4758,1528,649400,90717
8247,5338,2909,2194,1004200,90720
14360,5993,8367,1555,411900,90723
23155,7832,15323,1453,657700,90731
8680,6256,2424,2244,657400,90732
12836,9829,3007,2152,442000,90740
324,125,199,1954,1140400,90742
200,142,58,2150,"2,000,000+",90743
14995,5350,9645,1245,471000,90744
15337,10556,4781,1608,516000,90745
8547,7234,1313,2450,585600,90746
0,0,0,-,-,90747
4603,2242,2361,1565,553100,90755
21450,4423,17027,1520,460300,90802
17502,7590,9912,1831,943000,90803
14975,3208,11767,1508,541000,90804
28175,11933,16242,1407,469100,90805
12555,4678,7877,1355,568400,90806
12788,6752,6036,1643,661100,90807
14195,11729,2466,1933,708300,90808
9871,5477,4394,1327,464500,90810
17485,2259,15226,1312,430500,90813
8817,3064,5753,1743,738900,90814
14998,9758,5240,2054,701600,90815
0,0,0,-,-,90822
0,0,0,-,-,90831
0,0,0,-,-,90840
12330,9554,2776,1824,887100,91001
10464,7499,2965,1795,1074000,91006
11708,6086,5622,1833,1056600,91007
278,233,45,-,1414100,91008
8462,5453,3009,1820,560900,91010
6447,5786,661,3413,1671000,91011
14701,7405,7296,1780,707400,91016
3224,888,2336,1826,719600,91020
4961,2857,2104,1825,1048300,91024
10345,4926,5419,1914,1174400,91030
7412,5627,1785,1657,638100,91040
9872,5379,4493,1518,617400,91042
98,15,83,1350,-,91046
10391,1541,8850,1980,615200,91101
8480,3847,4633,1690,780200,91103
13421,7063,6358,1737,836500,91104
5463,3132,2331,2663,1306200,91105
10442,3696,6746,1885,811200,91106
12753,7685,5068,1984,913700,91107
4031,3378,653,"3,500+","2,000,000+",91108
0,0,0,-,-,91125
8147,2395,5752,1792,916000,91201
8738,3610,5128,1988,876700,91202
6748,1272,5476,2014,592600,91203
6564,546,6018,1658,561800,91204
13709,1904,11805,1686,677200,91205
12610,4517,8093,1904,910500,91206
4121,2445,1676,2011,1092700,91207
5964,3860,2104,2059,1054700,91208
125,4,121,3240,-,91210
10577,7680,2897,2149,851700,91214
9059,7399,1660,2985,871000,91301
9761,6818,2943,2620,1341400,91302
9887,2215,7672,1754,536400,91303
18190,9146,9044,1697,677700,91304
14463,7832,6631,1609,592400,91306
8562,7098,1464,3267,714600,91307
14156,9122,5034,1978,679000,91311
12372,6302,6070,1886,724500,91316
14902,11164,3738,2441,755800,91320
11240,6482,4758,1851,513500,91321
10045,4875,5170,1947,680200,91324
12590,5786,6804,1730,720900,91325
12518,9372,3146,2229,846700,91326
0,0,0,-,-,91330
23182,14856,8326,1510,487600,91331
24289,11698,12591,1618,580500,91335
8829,5439,3390,1490,515000,91340
24793,16742,8051,1767,520900,91342
17977,8972,9005,1565,608500,91343
17529,12755,4774,2016,690300,91344
5448,4016,1432,1770,558000,91345
12914,10588,2326,2152,605800,91350
10380,7746,2634,2001,471900,91351
12040,6562,5478,1603,584100,91352
10766,8570,2196,2579,648600,91354
12052,7577,4475,2303,600200,91355
11803,6794,5009,1720,1023000,91356
15260,10341,4919,2168,735100,91360
8005,5658,2347,2438,1042900,91361
13859,9642,4217,2364,878300,91362
10254,6834,3420,2575,949000,91364
17953,8987,8966,2384,786200,91367
0,0,0,-,-,91371
5018,3589,1429,2764,823300,91377
6590,4317,2273,2348,851300,91381
6982,6004,978,1767,579800,91384
13789,8576,5213,2186,599500,91387
6288,5515,773,2194,647600,91390
14596,5007,9589,1595,798900,91401
20133,6899,13234,1408,483700,91402
11867,5244,6623,2150,1129100,91403
18374,4960,13414,1494,581600,91405
18686,7196,11490,1642,608600,91406
9037,2578,6459,1647,759300,91411
14925,5702,9223,2044,1066600,91423
6011,4686,1325,2804,1545300,91436
7834,2817,5017,1864,827400,91501
5530,589,4941,1671,761400,91502
10151,5421,4730,1853,819100,91504
13042,6102,6940,2007,812500,91505
8125,4615,3510,1778,850600,91506
17086,2851,14235,1780,744500,91601
10124,3256,6868,1895,873700,91602
14350,6700,7650,2228,1263200,91604
16304,6101,10203,1586,605900,91605
15255,5252,10003,1493,648100,91606
13384,4251,9133,1761,864100,91607
8,0,8,-,-,91608
12845,10069,2776,1976,577200,91701
16175,9310,6865,1663,474100,91702
17857,10658,7199,1617,465900,91706
4096,1757,2339,2413,488900,91708
24961,17899,7062,2318,676800,91709
22214,14764,7450,1689,512600,91710
12452,8405,4047,1828,714400,91711
10321,7111,3210,1692,513600,91722
6250,2499,3751,1545,579100,91723
8987,6305,2682,1865,613400,91724
24460,11850,12610,1927,452400,91730
7928,2926,5002,1369,497100,91731
15260,6616,8644,1503,517800,91732
10786,4977,5809,1439,486400,91733
7760,5462,2298,2157,659500,91737
11336,7978,3358,2067,648400,91739
8449,5543,2906,1861,590200,91740
8856,6502,2354,1865,757100,91741
18303,12139,6164,1670,463200,91744
16309,12511,3798,1952,647300,91745
6981,5346,1635,1491,488400,91746
13720,9031,4689,1704,663600,91748
12191,8675,3516,1771,630400,91750
9157,5549,3608,1838,521900,91752
11689,6325,5364,1587,687700,91754
8604,3956,4648,1667,639900,91755
175,146,29,1383,380000,91759
17624,11515,6109,1679,452900,91761
18012,9727,8285,1490,437700,91762
9896,5353,4543,1524,423700,91763
16291,7429,8862,1743,415600,91764
15119,11774,3345,2193,709800,91765
19134,9974,9160,1507,452700,91766
14712,7834,6878,1498,449500,91767
8635,4846,3789,1411,427500,91768
16192,8311,7881,1565,601300,91770
11705,8202,3503,2012,625400,91773
7992,5122,2870,1789,861400,91775
11470,4698,6772,1627,698900,91776
11656,7163,4493,1771,766200,91780
8992,7734,1258,2353,666800,91784
19456,8148,11308,1624,483400,91786
12695,10489,2206,2548,790500,91789
12465,8084,4381,1982,594000,91790
10674,7132,3542,1697,647400,91791
9184,5248,3936,1918,557100,91792
20080,6991,13089,1671,662100,91801
10002,4859,5143,1567,643900,91803
6313,4651,1662,1768,644200,91901
6041,4761,1280,1989,732000,91902
562,399,163,-,280400,91905
1343,945,398,1176,282800,91906
25531,13095,12436,1677,549100,91910
25756,13283,12473,1725,485300,91911
15469,10952,4517,2658,578600,91913
4744,3646,1098,3055,739300,91914
9713,6912,2801,2687,604600,91915
671,568,103,2462,479600,91916
198,128,70,1602,433300,91917
304,268,36,-,-,91931
9187,2920,6267,1683,639200,91932
271,152,119,-,265500,91934
2980,2720,260,1898,681300,91935
12486,7949,4537,1698,684900,91941
16960,7203,9757,1688,578600,91942
9162,4863,4299,1477,478800,91945
59,59,0,-,240300,91948
17769,5958,11811,1333,450700,91950
971,854,117,1850,433300,91962
112,63,49,-,350000,91963
19730,12135,7595,1664,493000,91977
3320,2130,1190,2050,454100,91978
0,0,0,-,-,91980
1627,1009,618,1786,720300,92003
1336,1049,287,896,320600,92004
4289,2627,1662,2341,1304000,92007
11976,5646,6330,2060,881300,92008
16512,11515,4997,2427,964200,92009
6388,4118,2270,2260,776000,92010
9474,5869,3605,2601,924700,92011
5452,3785,1667,3000,1827000,92014
15091,10176,4915,1848,576700,92019
19997,8414,11583,1519,576200,92020
23331,12157,11174,1557,469100,92021
19480,12651,6829,2234,1063400,92024
16799,7110,9689,1562,558600,92025
18432,11064,7368,1800,539900,92026
17263,10443,6820,1696,493300,92027
16649,11617,5032,1450,627900,92028
7459,5619,1840,2063,690900,92029
1360,1195,165,1226,425900,92036
16342,10422,5920,2222,1614900,92037
15446,10407,5039,1602,540200,92040
14910,6034,8876,1665,648800,92054
0,0,0,-,-,92055
19344,12434,6910,2140,583700,92056
18440,12652,5788,2180,530600,92057
14201,3706,10495,2241,510400,92058
491,330,161,1292,234200,92059
99,88,11,-,-,92060
647,547,100,-,611500,92061
16282,12438,3844,1835,767500,92064
12229,9012,3217,1754,593100,92065
177,115,62,1604,364900,92066
2991,2668,323,3453,"2,000,000+",92067
14824,8398,6426,1788,569500,92069
355,182,173,-,335700,92070
20678,14954,5724,1854,524100,92071
4978,3233,1745,2624,1442900,92075
17988,12624,5364,2112,665300,92078
10420,5329,5091,2121,599400,92081
6134,5256,878,1389,620700,92082
11316,5401,5915,1766,467600,92083
14672,8758,5914,1741,600600,92084
524,447,77,1155,265800,92086
609,527,82,3029,1359400,92091
0,0,0,-,-,92092
0,0,0,-,-,92093
0,0,0,-,-,92096
25702,6569,19133,2008,626000,92101
14420,4773,9647,1560,477100,92102
18550,6306,12244,1717,835300,92103
21951,6038,15913,1668,679300,92104
22779,7361,15418,1368,459200,92105
7678,4551,3127,2022,1070000,92106
13507,5014,8493,1836,982300,92107
11847,3551,8296,2309,469300,92108
21942,6883,15059,1942,962000,92109
11875,4410,7465,1962,688800,92110
16870,9000,7870,1798,604600,92111
13757,3830,9927,1363,406600,92113
18163,12647,5516,1653,461500,92114
20892,7656,13236,1596,580800,92115
16356,5529,10827,1645,690400,92116
20681,11651,9030,1899,690000,92117
7147,3803,3344,2787,1656900,92118
9224,7001,2223,1868,632500,92119
11544,7494,4050,2100,654100,92120
1694,914,780,2188,821100,92121
19242,6346,12896,2266,780000,92122
12035,5511,6524,2315,600900,92123
11201,5210,5991,2673,704400,92124
24903,13417,11486,2290,599500,92126
15909,10785,5124,2244,914200,92127
20465,13149,7316,2337,681900,92128
18049,12851,5198,2327,815300,92129
20632,13277,7355,2789,1189300,92130
12550,10083,2467,2630,885500,92131
0,0,0,-,-,92132
0,0,0,-,-,92134
0,0,0,-,-,92135
0,0,0,-,-,92136
9929,5647,4282,1768,466100,92139
0,0,0,-,-,92140
0,0,0,-,-,92145
0,0,0,-,-,92147
22724,13876,8848,1794,477900,92154
0,0,0,-,-,92155
0,0,0,-,-,92161
8064,2420,5644,1362,388700,92173
0,0,0,-,-,92179
0,0,0,-,-,92182
25316,16082,9234,1161,272400,92201
12228,9908,2320,1655,368900,92203
2517,1934,583,919,750700,92210
12946,9135,3811,1627,400000,92211
11617,8103,3514,1212,259600,92220
9,9,0,-,-,92222
18462,14747,3715,1360,354000,92223
5036,3027,2009,788,165000,92225
7597,4116,3481,850,226700,92227
807,582,225,1059,211900,92230
9005,4733,4272,998,233300,92231
1014,714,300,791,158400,92233
18827,11772,7055,1328,325200,92234
15722,11056,4666,896,262300,92236
139,113,26,2375,112500,92239
13962,7164,6798,1126,230300,92240
3498,2868,630,865,92600,92241
599,498,101,733,101600,92242
13080,6612,6468,867,216700,92243
1869,1307,562,860,220200,92249
2031,1104,927,645,234300,92250
5907,4112,1795,1170,271600,92251
3597,2130,1467,982,217900,92252
15358,11179,4179,1531,453600,92253
3251,2566,685,608,160400,92254
1515,1100,415,1024,183300,92256
479,201,278,704,57800,92257
231,141,90,625,69100,92258
140,96,44,-,158000,92259
14717,9661,5056,1351,363400,92260
13062,7896,5166,1232,447800,92262
11005,7393,3612,1333,386800,92264
123,39,84,830,-,92266
22,0,22,-,-,92267
279,205,74,1325,427900,92268
8817,7072,1745,1490,570400,92270
444,276,168,813,158800,92273
5746,5117,629,916,113200,92274
629,599,30,975,145600,92275
2879,2134,745,1274,206000,92276
9873,3590,6283,1064,158900,92277
0,0,0,-,-,92278
0,0,0,-,-,92280
562,261,301,813,160600,92281
430,359,71,1440,225000,92282
531,276,255,701,-,92283
10285,7122,3163,1075,225100,92284
1062,889,173,861,157100,92285
8605,5111,3494,1247,238600,92301
0,0,0,-,-,92304
149,107,42,-,296400,92305
13224,8813,4411,1111,301700,92307
13856,9591,4265,1150,282100,92308
229,70,159,728,86300,92309
2790,14,2776,1430,-,92310
11526,5441,6085,912,144900,92311
4721,2981,1740,1452,378100,92313
4399,2927,1472,1250,307100,92314
2212,1347,865,1077,467800,92315
7550,5101,2449,1242,339100,92316
385,297,88,1633,504900,92317
3653,3187,466,1538,279200,92320
440,317,123,895,370900,92321
399,399,0,-,273100,92322
17955,9428,8527,1292,326000,92324
3317,2593,724,1386,278800,92325
379,67,312,674,151700,92327
474,98,376,730,68500,92328
65,17,48,-,-,92332
237,185,52,1266,372600,92333
24921,12017,12904,1379,344200,92335
26519,21178,5341,1841,460100,92336
9720,7125,2595,1794,403600,92337
0,0,0,-,-,92338
506,353,153,1440,335700,92339
155,132,23,1113,255200,92341
2467,2039,428,1549,266100,92342
5629,4438,1191,1726,345700,92344
25960,16112,9848,1217,277100,92345
17966,12099,5867,1306,367300,92346
303,214,89,-,72000,92347
54,0,54,-,-,92350
2021,1714,307,1240,457800,92352
8515,3757,4758,1502,411400,92354
2428,1658,770,960,169100,92356
351,289,62,1391,418800,92358
3251,2161,1090,1104,341600,92359
2079,1160,919,646,125400,92363
12,0,12,-,-,92364
1019,730,289,959,117600,92365
289,151,138,973,259800,92368
0,0,0,-,-,92369
5745,4381,1364,1370,272700,92371
1823,1423,400,884,294100,92372
12793,6771,6022,1623,530800,92373
14568,8515,6053,1648,413600,92374
22101,12953,9148,1376,332100,92376
5257,4373,884,1779,418300,92377
143,112,31,1285,289500,92378
1696,1274,422,1284,296600,92382
18,0,18,-,-,92384
101,101,0,-,322000,92385
876,558,318,1573,304800,92386
126,112,14,-,103800,92389
884,535,349,736,277100,92391
16641,10711,5930,1550,276900,92392
9636,6109,3527,1366,261300,92394
15252,8298,6954,1244,255100,92395
2262,1752,510,1353,360900,92397
646,303,343,581,-,92398
18504,12965,5539,1305,368400,92399
740,129,611,912,264300,92401
18591,8792,9799,1137,289900,92404
9226,4463,4763,1229,277800,92405
17574,10768,6806,1483,367300,92407
3633,1483,2150,1095,304900,92408
12949,5633,7316,1064,207500,92410
6683,3568,3115,1235,238400,92411
0,0,0,-,-,92415
6562,2868,3694,1395,358700,92501
24338,16271,8067,1597,426000,92503
15659,9610,6049,1541,391600,92504
14152,7215,6937,1674,408100,92505
14415,10812,3603,1579,503700,92506
16875,5957,10918,1459,396100,92507
9763,7839,1924,2307,536600,92508
18749,13343,5406,1513,391900,92509
488,8,480,2073,-,92518
0,0,0,-,-,92521
16083,10465,5618,1516,368200,92530
7684,5794,1890,1940,413400,92532
965,813,152,1373,374100,92536
1545,1190,355,965,242300,92539
13145,7145,6000,1115,169000,92543
16058,10921,5137,1243,271700,92544
15347,10687,4660,1482,252000,92545
2232,1565,667,1300,192700,92548
1308,923,385,1172,400300,92549
8171,5343,2828,1732,332400,92551
19158,9571,9587,1613,321800,92553
11493,8741,2752,2022,403300,92555
14516,9475,5041,1730,362200,92557
694,613,81,1167,369100,92561
20226,14034,6192,1939,478500,92562
21383,15075,6308,2151,459800,92563
2592,1931,661,1323,379400,92567
14230,9620,4610,1289,326200,92570
13351,9282,4069,1628,336100,92571
5066,3958,1108,1904,339000,92582
9984,6167,3817,1214,251700,92583
15668,12667,3001,2140,422000,92584
7180,6242,938,1869,371400,92585
9155,6574,2581,1389,276200,92586
5888,4379,1509,2060,442700,92587
1919,774,1145,1103,1071800,92590
13382,8191,5191,1955,501600,92591
24499,18874,5625,2236,522400,92592
10286,7769,2517,1721,417300,92595
8824,7120,1704,2205,475400,92596
9125,4025,5100,2541,933600,92602
7131,4222,2909,2993,1303200,92603
10407,6580,3827,2468,818400,92604
9018,3511,5507,2520,853800,92606
4229,3196,1033,2438,807300,92610
14122,4117,10005,2458,789000,92612
11223,4192,7031,2516,789500,92614
4092,1140,2952,1482,585600,92617
20890,8039,12851,2606,960800,92618
21158,11841,9317,2721,982000,92620
2555,1579,976,2278,913400,92624
5860,3630,2230,3190,"2,000,000+",92625
19364,8025,11339,2153,842500,92626
22141,8681,13460,1960,842100,92627
11642,7210,4432,2402,981600,92629
23246,15971,7275,2242,694800,92630
11933,8172,3761,1912,327000,92637
21399,16330,5069,2201,814900,92646
21002,9224,11778,2128,793300,92647
19726,9014,10712,2061,985800,92648
14696,8320,6376,2187,885000,92649
10976,7305,3671,2448,"2,000,000+",92651
10738,7512,3226,2346,771800,92653
2505,714,1791,1378,583300,92655
19701,11392,8309,2428,679300,92656
3648,2817,831,2938,"2,000,000+",92657
15806,7978,7828,2848,1905400,92660
1652,635,1017,2629,"2,000,000+",92661
1217,763,454,2276,"2,000,000+",92662
10552,4957,5595,2210,1590000,92663
15185,7651,7534,2091,980200,92672
9774,7976,1798,3044,972200,92673
12460,9249,3211,2158,770000,92675
760,684,76,1850,712200,92676
25361,17000,8361,2449,909500,92677
242,214,28,2000,777000,92678
10493,9488,1005,2871,970200,92679
27611,14407,13204,1791,651200,92683
15446,10726,4720,2276,673400,92688
16400,12502,3898,2233,750800,92691
16588,13029,3559,2456,795500,92692
11292,8402,2890,2722,844700,92694
0,0,0,-,-,92697
12341,3547,8794,1432,521700,92701
13543,6573,6970,1737,486000,92703
19686,10117,9569,1858,534800,92704
14959,9504,5455,1916,914900,92705
10076,5508,4568,1589,673300,92706
14142,7109,7033,1847,539700,92707
18852,12753,6099,2199,816900,92708
17420,8007,9413,1895,669400,92780
10988,6686,4302,2440,879300,92782
18522,6849,11673,1771,543200,92801
11946,4238,7708,1734,577500,92802
24586,10464,14122,1776,594400,92804
20593,8633,11960,1771,583800,92805
12521,5145,7376,1918,623300,92806
12248,9760,2488,2339,731100,92807
7797,5738,2059,2502,807100,92808
14822,8900,5922,1978,700900,92821
1762,1472,290,2943,913900,92823
12401,5234,7167,1806,676300,92831
8203,2897,5306,1806,615300,92832
16584,9696,6888,1782,686700,92833
9120,6685,2435,1953,831100,92835
15530,8401,7129,1657,590900,92840
9531,5124,4407,1701,609900,92841
11802,5777,6025,1670,570200,92843
6733,2813,3920,1863,545400,92844
5380,4199,1181,2574,668900,92845
7060,5970,1090,1792,595300,92860
1965,1815,150,-,1287100,92861
6813,4470,2343,2038,652400,92865
5626,2053,3573,1766,722200,92866
12948,8709,4239,1944,780900,92867
7990,2815,5175,2088,531900,92868
11243,8446,2797,2009,770700,92869
16727,10698,6029,1942,696700,92870
13758,7831,5927,1730,452900,92879
18961,14539,4422,2400,601700,92880
9057,7489,1568,1945,615000,92881
19622,12464,7158,1731,521000,92882
11248,9092,2156,2364,538500,92883
16777,13678,3099,2562,864700,92886
7071,5990,1081,2245,903900,92887
12810,5627,7183,1584,630400,93001
20167,11830,8337,1853,617700,93003
11183,7451,3732,2016,608100,93004
16264,10375,5889,2099,662300,93010
13273,9232,4041,2440,657700,93012
6208,3549,2659,2147,822400,93013
5531,3228,2303,1641,456600,93015
12059,9381,2678,2247,690900,93021
2135,1617,518,2083,610500,93022
8471,5858,2613,1709,692700,93023
14801,6919,7882,1605,530000,93030
16704,9762,6942,1677,442700,93033
8850,5369,3481,2045,632800,93035
13525,7224,6301,1913,527700,93036
510,330,180,1417,393500,93040
7287,3197,4090,1841,446800,93041
0,0,0,-,-,93042
0,0,0,-,-,93043
9970,5288,4682,1445,446700,93060
19624,13701,5923,2198,626900,93063
0,0,0,-,-,93064
25194,18393,6801,2338,642900,93065
957,662,295,1615,1068500,93066
208,82,126,1705,1875000,93067
12934,3033,9901,1816,905500,93101
7663,3719,3944,2107,1117000,93103
10915,5923,4992,2247,1180200,93105
14,0,14,-,-,93106
4536,3337,1199,2941,"2,000,000+",93108
4569,2454,2115,2586,1413400,93109
6474,4037,2437,2093,875700,93110
6390,4292,2098,2527,961100,93111
16458,6321,10137,1861,838300,93117
311,117,194,826,91000,93201
1077,710,367,1211,187500,93202
4770,2413,2357,956,192800,93203
3036,1431,1605,955,180200,93204
969,611,358,817,109500,93205
445,178,267,944,152200,93206
103,92,11,-,200000,93207
81,20,61,-,-,93208
4831,2793,2038,913,203100,93210
4230,2077,2153,882,176400,93212
12251,6919,5332,943,215100,93215
160,124,36,1167,134500,93218
2487,1107,1380,816,162500,93219
33,0,33,-,-,93220
4506,3068,1438,1096,278600,93221
1018,823,195,1388,282500,93222
2823,1775,1048,804,189100,93223
158,135,23,1219,152200,93224
2027,1393,634,1022,247900,93225
37,25,12,-,227600,93226
41,0,41,-,-,93227
21661,13008,8653,1072,252300,93230
1786,363,1423,784,190000,93234
1262,696,566,801,175600,93235
94,56,38,-,228400,93237
344,290,54,-,-,93238
478,78,400,946,-,93239
2482,1503,979,984,177900,93240
4293,1765,2528,851,147600,93241
998,543,455,963,264100,93242
461,285,176,642,359400,93243
47,38,9,-,177800,93244
12059,5952,6107,1270,261400,93245
0,0,0,-,-,93246
5274,3035,2239,847,208800,93247
526,189,337,783,149100,93249
3594,1918,1676,983,203700,93250
87,42,45,582,-,93251
565,335,230,899,151100,93252
382,301,81,1058,182200,93254
448,399,49,-,131500,93255
1540,674,866,975,162700,93256
23034,12557,10477,989,211800,93257
383,80,303,881,95000,93258
86,70,16,-,143200,93260
552,216,336,750,127600,93261
0,0,0,-,-,93262
5723,3406,2317,1023,206700,93263
1346,1234,112,923,305900,93265
397,147,250,1169,-,93266
1833,1318,515,792,143000,93267
5993,2955,3038,895,164200,93268
1530,1021,509,864,221700,93270
1184,809,375,1350,333600,93271
1138,356,782,1136,185200,93272
22146,12640,9506,1124,246600,93274
48,26,22,617,-,93276
18755,10777,7978,1142,256600,93277
6506,3831,2675,839,188300,93280
1031,892,139,703,119800,93283
1212,964,248,1063,101600,93285
2874,1502,1372,827,232800,93286
44,44,0,-,221900,93287
18167,10600,7567,1104,294800,93291
13737,8491,5246,1276,252500,93292
5190,1755,3435,950,190600,93301
15219,6454,8765,1008,179300,93304
10842,3985,6857,939,169300,93305
21818,13668,8150,1101,227700,93306
22520,11545,10975,1018,187100,93307
19677,9052,10625,1071,242800,93308
22310,10667,11643,1106,226200,93309
15676,11013,4663,1533,324800,93311
18220,14332,3888,1684,328400,93312
16231,12623,3608,1652,283400,93313
10412,8623,1789,1705,412200,93314
12612,6120,6492,1615,775100,93401
6237,4340,1897,1721,616100,93402
8332,2881,5451,1816,753500,93405
5,0,5,-,-,93407
0,0,0,-,-,93408
0,0,0,-,-,93409
0,0,0,-,-,93410
12182,8551,3631,1703,710000,93420
13049,8702,4347,1593,573000,93422
570,424,146,1907,888000,93424
551,405,146,748,446200,93426
2191,1463,728,1996,621600,93427
2830,2085,745,1469,705200,93428
37,17,20,-,-,93429
1277,830,447,1508,896700,93430
424,331,93,-,657700,93432
5067,2738,2329,1682,577300,93433
2051,1067,984,1272,337100,93434
17701,9480,8221,1353,373600,93436
1097,0,1097,2253,-,93437
491,378,113,1128,553800,93440
411,311,100,2075,927500,93441
5107,2919,2188,1640,711900,93442
7327,5357,1970,1714,643200,93444
2843,1819,1024,1260,425200,93445
17239,11493,5746,1595,502500,93446
4283,2987,1296,2002,771400,93449
224,91,133,1292,338100,93450
1586,906,680,1791,427400,93451
238,83,155,1152,281800,93452
1206,757,449,-,504200,93453
11721,6318,5403,1461,375900,93454
15517,11795,3722,2024,452600,93455
13830,5891,7939,1555,361300,93458
2260,1650,610,2164,962500,93460
479,315,164,1577,346500,93461
3588,2237,1351,1575,892900,93463
3740,2967,773,1946,763200,93465
1855,906,949,975,120300,93501
4512,2527,1985,846,169100,93505
2420,2156,264,1402,589000,93510
100,86,14,-,228800,93512
660,476,184,844,269600,93513
5980,4158,1822,1072,337700,93514
1051,569,482,878,74500,93516
235,229,6,-,254200,93517
415,357,58,2021,235800,93518
0,0,0,-,-,93519
36,36,0,-,-,93522
1210,292,918,1807,81200,93523
0,0,0,-,-,93524
318,228,90,975,223500,93526
859,758,101,1271,212100,93527
45,15,30,-,-,93528
114,99,15,-,485000,93529
31,6,25,-,-,93530
163,153,10,-,444600,93531
992,782,210,1552,318700,93532
15438,5217,10221,1272,257600,93534
22797,13631,9166,1348,241800,93535
22752,15432,7320,1530,377300,93536
202,134,68,-,216300,93541
3573,2425,1148,1406,266000,93543
574,494,80,-,270400,93544
647,393,254,736,197600,93545
3631,2096,1535,1225,493800,93546
138,81,57,1296,163800,93549
22825,12151,10674,1308,280900,93550
16820,12865,3955,1865,410900,93551
10897,7917,2980,1662,324500,93552
537,484,53,1449,288800,93553
44,44,0,-,"10,000-",93554
13093,8130,4963,993,194600,93555
8,8,0,-,-,93558
6736,4971,1765,1023,240800,93560
12250,9536,2714,1117,295000,93561
742,415,327,680,57600,93562
38,28,10,-,-,93563
0,0,0,-,-,93581
2022,1551,471,1268,207200,93591
582,428,154,829,327800,93601
1287,1120,167,895,291300,93602
133,64,69,-,-,93603
154,154,0,-,639500,93604
39,21,18,1375,297700,93605
227,122,105,1069,169200,93606
336,101,235,723,154600,93608
1439,763,676,1069,206000,93609
4887,2684,2203,1036,250600,93610
15078,11643,3435,1798,365400,93611
13740,5373,8367,1151,243900,93612
4393,4007,386,1577,307300,93614
1407,673,734,1106,171900,93615
668,354,314,925,198000,93616
8228,4610,3618,971,237000,93618
14936,13006,1930,2126,452500,93619
2775,1497,1278,989,267700,93620
14,14,0,-,-,93621
2699,1141,1558,688,185900,93622
0,0,0,-,-,93623
204,7,197,672,-,93624
2581,1352,1229,1077,298100,93625
822,761,61,1063,509400,93626
68,0,68,-,-,93627
226,47,179,-,-,93628
5601,2702,2899,1050,262200,93630
5430,3672,1758,1063,326800,93631
0,0,0,-,-,93633
0,0,0,-,-,93634
12686,6982,5704,1328,343000,93635
3991,3611,380,1344,375000,93636
11645,6844,4801,1163,275900,93637
12433,6893,5540,1079,239700,93638
3033,1413,1620,825,204600,93640
90,73,17,-,-,93641
1180,891,289,891,237800,93643
3283,2477,806,1229,301300,93644
132,60,72,-,-,93645
2715,1039,1676,828,201700,93646
2874,1583,1291,867,167400,93647
3938,1901,2037,890,186100,93648
840,298,542,1025,192600,93650
606,398,208,1331,366400,93651
129,75,54,878,169900,93652
572,499,73,1583,443500,93653
8248,4858,3390,1015,250200,93654
1621,667,954,891,208200,93656
10627,7057,3570,1038,307100,93657
868,364,504,907,207900,93660
8757,4764,3993,1026,216900,93662
184,168,16,-,527800,93664
83,57,26,-,-,93665
184,32,152,697,-,93666
802,660,142,1212,283300,93667
300,197,103,1187,370600,93668
89,65,24,-,-,93669
67,0,67,-,-,93670
121,67,54,900,176100,93673
1285,1034,251,1040,240800,93675
3699,476,3223,748,164100,93701
12674,4179,8495,940,159800,93702
10324,4219,6105,968,183200,93703
11475,6017,5458,1127,291600,93704
12791,5573,7218,1103,213400,93705
11653,4456,7197,914,186300,93706
12170,4860,7310,1101,281800,93710
15949,9688,6261,1294,398800,93711
18500,10589,7911,1717,370800,93720
2414,203,2211,785,181500,93721
26424,15524,10900,1292,270900,93722
3249,2644,605,1471,374300,93723
6820,3974,2846,1070,226200,93725
14643,5923,8720,1095,214600,93726
23239,14054,9185,1045,287000,93727
6116,2263,3853,1082,210500,93728
4602,3659,943,2167,522200,93730
2044,1815,229,1595,387300,93737
0,0,0,-,-,93740
56,41,15,-,-,93741
10494,4937,5557,1579,569700,93901
13709,5531,8178,1467,444400,93905
17729,9575,8154,1790,466900,93906
7157,5018,2139,1796,566800,93907
4379,3506,873,1645,846200,93908
569,171,398,1057,1081500,93920
1365,639,726,2285,1646400,93921
5375,4202,1173,1894,1199000,93923
2615,2122,493,1633,987100,93924
342,139,203,1122,531300,93925
2418,1298,1120,1307,453700,93926
4402,2127,2275,1534,350400,93927
0,0,0,-,-,93928
4423,2309,2114,1442,336200,93930
215,133,82,1125,388100,93932
9180,3706,5474,1697,599700,93933
14534,5876,8658,1939,861000,93940
0,0,0,-,-,93943
0,0,0,-,-,93944
6731,3146,3585,2115,929200,93950
1701,1423,278,"3,500+",1418400,93953
100,40,60,1427,230800,93954
10493,4110,6383,1977,588100,93955
4090,2328,1762,1237,432200,93960
121,87,34,-,562500,93962
11013,6217,4796,2675,1678500,94002
1997,1265,732,2273,923800,94005
16244,10150,6094,2443,"2,000,000+",94010
13980,8214,5766,1971,865400,94014
20236,12274,7962,2551,932200,94015
1392,1038,354,2086,1244200,94018
5298,3840,1458,1966,1273400,94019
845,635,210,-,838200,94020
90,53,37,-,-,94021
7263,5832,1431,"3,500+","2,000,000+",94022
8036,7043,993,"3,500+","2,000,000+",94024
14512,8838,5674,2813,"2,000,000+",94025
2260,1999,261,"3,500+","2,000,000+",94027
2482,2150,332,"3,500+","2,000,000+",94028
8108,5110,2998,2897,1606700,94030
1040,908,132,-,1244300,94037
1109,982,127,3067,995800,94038
14975,5688,9287,2617,"2,000,000+",94040
6310,1908,4402,2695,1804400,94041
13429,6124,7305,2670,1341300,94043
14000,9623,4377,2719,1012200,94044
367,184,183,-,1012800,94060
13256,7144,6112,2493,1558300,94061
9668,7051,2617,2454,"2,000,000+",94062
10907,3567,7340,2479,1002400,94063
4731,2964,1767,"3,500+",1545800,94065
15308,9307,6001,2490,1027400,94066
11611,8233,3378,2598,1910300,94070
58,58,0,-,1086500,94074
22016,13640,8376,2428,963700,94080
8795,3500,5295,2843,1217000,94085
19461,6260,13201,2708,1504000,94086
20576,11552,9024,2896,1945100,94087
8733,4800,3933,3169,338100,94089
19213,1776,17437,1339,968000,94102
16373,3013,13360,1597,960000,94103
234,36,198,755,"2,000,000+",94104
7156,2993,4163,3234,1401000,94105
14248,5345,8903,3069,1134600,94107
6583,626,5957,1356,1129100,94108
32183,5247,26936,2013,1171200,94109
26765,10242,16523,2130,1233600,94110
2368,504,1864,2388,1183200,94111
23480,15921,7559,2072,1022100,94112
17121,7514,9607,2426,1593400,94114
17009,4455,12554,2128,1515600,94115
15583,11612,3971,2647,1188000,94116
17650,4726,12924,2545,1478600,94117
17485,6231,11254,2343,1609400,94118
18051,7896,10155,1988,1506400,94121
22649,11425,11224,2413,1239600,94122
12992,3712,9280,2868,"2,000,000+",94123
10665,5453,5212,1181,873900,94124
7325,5944,1381,3121,1572100,94127
0,0,0,-,-,94128
1340,0,1340,"3,500+",-,94129
650,0,650,2301,-,94130
12764,6903,5861,2636,1458500,94131
10697,4901,5796,2303,1171000,94132
13151,2212,10939,1561,1393700,94133
12660,7836,4824,1796,925900,94134
4827,1525,3302,2446,1226700,94158
0,0,0,-,-,94188
7145,3955,3190,2788,"2,000,000+",94301
14451,8268,6183,2210,1567000,94303
1893,386,1507,3286,"2,000,000+",94304
3545,1008,2537,1731,"2,000,000+",94305
10698,5822,4876,2667,"2,000,000+",94306
12869,6042,6827,2453,944300,94401
10282,6493,3789,3009,1882300,94402
16895,8843,8052,2971,1499300,94403
14137,7593,6544,3428,1404600,94404
25516,10245,15271,2074,969500,94501
4984,4232,752,3200,978600,94502
5622,4436,1186,2107,557800,94503
5546,4901,645,2717,674800,94505
9286,8378,908,"3,500+",1380000,94506
4989,4654,335,"3,500+",1799100,94507
1017,617,400,1496,684400,94508
22921,12809,10112,1834,435600,94509
10883,7688,3195,2079,628300,94510
864,646,218,1297,433300,94511
0,0,0,-,-,94512
21326,17154,4172,2238,635600,94513
582,383,199,2253,711000,94514
2730,1818,912,1535,731200,94515
77,62,15,932,685500,94516
4359,3924,435,3282,815600,94517
10216,7217,2999,2142,649100,94518
7082,4759,2323,2151,608400,94519
13095,4444,8651,1840,480300,94520
15676,11483,4193,2068,649100,94521
13969,9015,4954,2230,827200,94523
1529,910,619,1670,591000,94525
12655,10551,2104,2751,1265000,94526
232,232,0,-,"2,000,000+",94528
10761,6208,4553,2174,891700,94530
12807,9303,3504,2660,528200,94531
24343,13403,10940,1655,393700,94533
13267,9996,3271,2319,589000,94534
1009,20,989,2654,-,94535
24776,14748,10028,2485,989600,94536
21726,10169,11557,2558,888400,94538
16409,13228,3181,2995,1548800,94539
22134,10139,11995,1979,641200,94541
5029,3557,1472,2265,884200,94542
23037,11857,11180,2035,624800,94544
9966,7172,2794,2142,664400,94545
16218,10831,5387,2101,811300,94546
9068,7347,1721,2741,590800,94547
185,170,15,-,817500,94548
10108,7472,2636,2782,1547800,94549
17450,13281,4169,2350,925400,94550
14391,9868,4523,2282,774200,94551
5048,4654,394,"3,500+",1056100,94552
19163,13503,5660,1918,628400,94553
11718,8025,3693,2773,1078400,94555
5534,4703,831,2378,1224100,94556
24070,16576,7494,2032,693700,94558
10131,5136,4995,1817,704900,94559
14354,9738,4616,2425,870200,94560
12924,9772,3152,1872,501200,94561
0,0,0,-,-,94562
7226,6795,431,1797,1539900,94563
6794,4823,1971,2133,590900,94564
29146,16945,12201,1918,442300,94565
16088,11345,4743,2408,1195200,94566
241,156,85,1861,383300,94567
22946,14777,8169,2894,983000,94568
169,55,114,-,586300,94569
5320,4196,1124,1309,398900,94571
3234,1758,1476,1603,546400,94572
34,13,21,-,-,94573
3443,2323,1120,1648,1295900,94574
0,0,0,-,-,94575
52,36,16,-,861100,94576
16954,9598,7356,1857,667600,94577
14091,5566,8525,1823,633500,94578
6607,4928,1679,1939,659600,94579
8938,6521,2417,2087,649600,94580
16025,11224,4801,2526,1153600,94582
13361,9774,3587,2595,987300,94583
9486,5811,3675,1896,419200,94585
299,252,47,-,1166700,94586
20800,13643,7157,2434,860300,94587
12169,7882,4287,2783,1050600,94588
9731,6215,3516,1724,372000,94589
15234,6407,8827,1442,381400,94590
19652,13147,6505,1891,482700,94591
425,358,67,2896,653700,94592
9514,7802,1712,2219,673500,94595
10501,4481,6020,2275,1081800,94596
10839,5294,5545,2421,806800,94597
10430,7996,2434,2834,1050800,94598
1639,1050,589,1531,758600,94599
15758,5156,10602,1437,581800,94601
12034,7077,4957,1684,919900,94602
10174,4462,5712,1672,447000,94603
16812,9955,6857,1619,695000,94605
15712,2852,12860,1525,643100,94606
11678,3840,7838,1508,640800,94607
15442,5207,10235,2340,691300,94608
10321,3433,6888,1931,937000,94609
15656,5707,9949,1965,1125700,94610
17675,10452,7223,1822,1199600,94611
9429,954,8475,1543,848500,94612
0,0,0,-,-,94613
7409,4743,2666,2414,1440300,94618
9457,6613,2844,1929,790500,94619
9900,3228,6672,1358,445600,94621
7094,3415,3679,1669,958700,94702
7962,3115,4847,1936,1061200,94703
7843,750,7093,1885,787300,94704
5837,3328,2509,1949,1420900,94705
7968,3964,4004,2121,964500,94706
4932,4195,737,2097,1301800,94707
4574,3897,677,2635,1208400,94708
5084,1542,3542,1794,1001900,94709
3368,1209,2159,2160,898500,94710
154,33,121,2031,1337500,94720
9931,4762,5169,1537,475100,94801
9317,6771,2546,1888,614700,94803
15463,7255,8208,1475,526600,94804
5578,3912,1666,1891,613400,94805
20357,9746,10611,1854,479200,94806
15851,7735,8116,2035,1136000,94901
12591,8238,4353,2433,940800,94903
5643,3618,2025,2330,1635600,94904
5025,3580,1445,3252,"2,000,000+",94920
100,100,0,-,854200,94922
556,354,202,1452,1077700,94923
557,378,179,1396,1119300,94924
3930,2776,1154,2792,1372500,94925
17183,8682,8501,1927,546100,94928
160,94,66,"3,500+",1265000,94929
3803,2554,1249,2106,927100,94930
3539,2112,1427,1568,663100,94931
516,294,222,2952,879500,94933
580,442,138,1480,1007400,94937
265,204,61,"3,500+",933600,94938
3416,1570,1846,2852,1697200,94939
100,78,22,-,886400,94940
12469,8298,4171,2693,1582800,94941
7137,5115,2022,1920,909300,94945
285,215,70,1898,1736600,94946
9236,6871,2365,2166,851100,94947
7082,4361,2721,2316,829100,94949
7,7,0,-,-,94950
1483,1051,432,1482,955000,94951
13510,8103,5407,1953,866200,94952
13929,9212,4717,2225,661700,94954
623,457,166,1953,1299500,94956
671,556,115,3199,"2,000,000+",94957
5988,4242,1746,2306,1308500,94960
129,114,15,-,928600,94963
127,0,127,-,-,94964
6149,3319,2830,2443,1173700,94965
300,173,127,2065,1593800,94970
121,110,11,-,845200,94971
38,5,33,-,-,94972
643,524,119,1878,957400,94973
575,382,193,2300,659100,95002
10166,7750,2416,2183,935600,95003
1398,1044,354,1686,780500,95004
2945,1921,1024,2011,804800,95005
3534,2818,716,2158,646300,95006
214,170,44,-,594800,95007
19327,9536,9791,2409,1230900,95008
4315,1916,2399,2047,760500,95010
2517,1363,1154,1465,486000,95012
18,18,0,-,-,95013
21646,12881,8765,3404,"2,000,000+",95014
268,133,135,1683,908100,95017
2552,1982,570,2209,657200,95018
2024,592,1432,1144,471700,95019
19669,12941,6728,2124,815900,95020
16566,11146,5420,1707,609800,95023
5355,4048,1307,2548,"2,000,000+",95030
10275,6863,3412,2758,1726700,95032
3753,3054,699,2271,1160400,95033
23749,14982,8767,2760,995200,95035
16888,12342,4546,2019,954600,95037
377,181,196,1442,227500,95039
283,192,91,2007,908700,95041
272,178,94,1214,875000,95043
1421,983,438,1798,726500,95045
1847,1315,532,1934,1092500,95046
14764,5643,9121,2228,1140200,95050
22468,10380,12088,2773,1253100,95051
0,0,0,-,-,95053
8578,3408,5170,2990,1195700,95054
18841,9576,9265,2107,971100,95060
15149,8349,6800,2017,840100,95062
536,171,365,1392,451300,95064
2930,1966,964,2074,931400,95065
5893,4556,1337,2190,920600,95066
11376,9913,1463,3345,"2,000,000+",95070
4175,3142,1033,2139,842800,95073
176,153,23,-,809000,95075
24053,13637,10416,1684,626100,95076
6665,2626,4039,2367,739600,95110
15899,9307,6592,1776,661700,95111
20778,6202,14576,1936,823900,95112
1276,210,1066,2587,872000,95113
13728,5443,8285,1849,687900,95116
10479,3828,6651,2200,1141000,95117
11204,7245,3959,2275,1111900,95118
3388,2541,847,2480,950700,95119
12536,11093,1443,"3,500+",1546400,95120
9832,7305,2527,2513,838900,95121
12058,6066,5992,2134,674500,95122
23930,14559,9371,2703,889800,95123
17553,12767,4786,2806,1259000,95124
21083,12784,8299,2193,1300600,95125
15021,5255,9766,2244,1011900,95126
15939,10517,5422,2255,806400,95127
13898,5966,7932,2143,1054000,95128
13835,8347,5488,2518,1641700,95129
4491,2740,1751,1969,1409500,95130
9736,6084,3652,2808,976300,95131
12115,8726,3389,2798,1072200,95132
8875,5321,3554,1846,869200,95133
13383,1787,11596,3057,379800,95134
7651,6544,1107,3204,1158400,95135
16114,9232,6882,2500,897500,95136
5639,4879,760,2678,1129600,95138
2117,1651,466,3146,904600,95139
60,52,8,-,1166700,95140
12124,9562,2562,3097,998600,95148
2920,148,2772,721,265400,95202
5387,2051,3336,991,268100,95203
11080,6441,4639,1156,286300,95204
10735,4695,6040,1132,225400,95205
17279,9784,7495,1286,291800,95206
18347,7218,11129,1274,318500,95207
13129,9356,3773,1614,367400,95209
11934,5984,5950,1245,259000,95210
0,0,0,-,-,95211
7747,5532,2215,1970,401500,95212
7076,4173,2903,1087,303500,95215
10856,6506,4350,1606,436900,95219
2712,1810,902,1187,642500,95220
69,0,69,1521,-,95221
2238,1749,489,1296,399200,95222
1305,1120,185,1405,360600,95223
74,52,22,-,327800,95224
322,125,197,636,594900,95225
0,0,0,-,-,95226
332,275,57,876,877000,95227
1731,1427,304,1821,350500,95228
226,130,96,1978,591900,95230
709,420,289,1379,341300,95231
29,29,0,-,-,95232
99,99,0,-,385200,95233
1708,1071,637,1435,501400,95236
1522,1226,296,1199,372700,95237
16235,8056,8179,1241,352400,95240
10058,6474,3584,1656,440100,95242
1003,902,101,1075,383800,95245
447,406,41,-,313000,95246
1542,1250,292,1685,357500,95247
16,0,16,-,-,95248
1749,1253,496,1195,332300,95249
250,250,0,-,286400,95251
4814,4138,676,1667,360200,95252
124,30,94,977,-,95253
279,222,57,-,374400,95254
708,570,138,1154,231500,95255
149,101,48,1538,281900,95257
1538,1276,262,1202,479900,95258
12857,7299,5558,1075,288800,95301
291,152,139,1067,592600,95303
4359,2747,1612,2149,692400,95304
58,29,29,-,-,95305
383,334,49,1139,283300,95306
13022,7970,5052,1316,313000,95307
0,0,0,-,-,95309
713,519,194,699,379500,95310
989,857,132,894,252400,95311
63,34,29,1100,215000,95312
424,207,217,1005,494000,95313
3554,2329,1225,1138,273000,95315
2627,1940,687,1157,375000,95316
260,66,194,964,425000,95317
224,161,63,402,241500,95318
576,236,340,891,194700,95319
4585,3046,1539,1416,448000,95320
1809,1596,213,1145,330900,95321
3319,1701,1618,1102,354500,95322
434,282,152,856,451400,95323
2626,1356,1270,1298,313200,95324
35,35,0,-,-,95325
3743,2296,1447,1237,366500,95326
3012,2078,934,1021,271800,95327
989,559,430,1110,306000,95328
1172,934,238,1339,284400,95329
6907,5681,1226,1868,431400,95330
794,538,256,944,274600,95333
4142,2082,2060,1152,246500,95334
73,0,73,-,-,95335
15395,10196,5199,1593,398100,95336
12551,8656,3895,1690,466500,95337
4720,3383,1337,1059,320800,95338
12338,6677,5661,1065,300400,95340
8787,3639,5148,970,232400,95341
332,189,143,811,299500,95345
488,402,86,-,375600,95346
10765,4218,6547,1283,273400,95348
19358,9777,9581,1267,309800,95350
13453,6862,6591,1225,241800,95351
8773,4097,4676,1174,280500,95354
21060,12635,8425,1509,359200,95355
11219,7379,3840,1480,389900,95356
4259,2996,1263,1655,340300,95357
8418,5133,3285,1365,319900,95358
3956,2627,1329,1058,298300,95360
12286,8406,3880,1372,407700,95361
7948,5626,2322,1586,360300,95363
0,0,0,-,-,95364
1106,629,477,845,183900,95365
6649,4619,2030,1514,522100,95366
7489,5048,2441,1287,344800,95367
4262,3248,1014,1732,349000,95368
331,191,140,867,339200,95369
11988,8709,3279,1164,342700,95370
645,559,86,-,317000,95372
540,253,287,1039,357300,95374
61,16,45,-,-,95375
16697,9729,6968,1756,454200,95376
9045,6626,2419,2400,594900,95377
1705,1313,392,642,319000,95379
15286,7014,8272,1117,319900,95380
12894,8155,4739,1449,374600,95382
1870,1427,443,1452,364200,95383
213,115,98,-,-,95385
2934,1921,1013,1317,323200,95386
275,103,172,1085,445100,95387
3740,2255,1485,850,231700,95388
333,43,290,-,699100,95389
5983,4226,1757,2937,634300,95391
13592,7562,6030,1764,541300,95401
16286,8837,7449,1886,588800,95403
15507,8927,6580,1714,710100,95404
9396,5333,4063,2053,648800,95405
12871,6870,6001,1655,506600,95407
11870,7718,4152,2084,665600,95409
412,321,91,-,644700,95410
161,131,30,-,-,95412
433,228,205,1174,542200,95415
95,58,37,-,-,95417
162,127,35,-,601300,95419
85,85,0,-,-,95420
726,522,204,1172,571400,95421
6136,3536,2600,959,156400,95422
1528,1027,501,1124,223600,95423
4585,3111,1474,1288,556700,95425
644,551,93,1800,260400,95426
223,147,76,-,699700,95427
973,619,354,839,301300,95428
70,70,0,-,336200,95429
15,0,15,-,-,95430
0,0,0,-,-,95431
276,183,93,1610,623900,95432
89,14,75,-,-,95435
2644,1818,826,1701,578800,95436
6438,3948,2490,1157,446400,95437
169,140,29,-,742100,95439
701,452,249,1225,952800,95441
1161,843,318,1583,1177600,95442
36,0,36,-,-,95443
219,157,62,-,680000,95444
955,625,330,1534,585200,95445
2336,1600,736,1338,506700,95446
6724,4354,2370,1963,919400,95448
493,246,247,1405,465000,95449
84,54,30,1906,631000,95450
4767,3389,1378,1175,285000,95451
623,484,139,3049,915600,95452
4638,3420,1218,917,342500,95453
924,763,161,597,371700,95454
419,222,197,740,410000,95456
1368,1097,271,799,332800,95457
1359,994,365,1053,234500,95458
313,200,113,-,539800,95459
1070,731,339,1619,566400,95460
1322,982,340,1678,315900,95461
592,412,180,1166,562500,95462
35,35,0,-,462500,95463
921,576,345,1126,127500,95464
603,377,226,1856,957300,95465
310,142,168,1286,583300,95466
2244,1661,583,1848,338300,95467
547,294,253,1109,494100,95468
615,419,196,1542,485000,95469
2096,1585,511,1317,495100,95470
388,255,133,1295,461700,95471
11767,8519,3248,1690,890700,95472
15163,9852,5311,1930,767900,95476
5,0,5,-,-,95480
11329,6333,4996,1220,402700,95482
1199,871,328,1088,299100,95485
35,13,22,-,-,95486
103,68,35,-,-,95488
5578,3030,2548,1072,337600,95490
9771,7424,2347,2076,652800,95492
46,46,0,-,600000,95493
42,36,6,-,634600,95494
583,516,67,1602,943200,95497
9787,4258,5529,991,299400,95501
9567,6827,2740,1160,337600,95503
57,57,0,-,410900,95511
59,59,0,-,-,95514
7259,4836,2423,1032,352700,95519
8351,3160,5191,1177,379000,95521
669,549,120,1199,484900,95524
698,405,293,1210,388200,95525
210,185,25,925,262100,95526
197,144,53,1144,272700,95527
578,464,114,910,383900,95528
7688,5026,2662,1041,236100,95531
1158,699,459,1111,443500,95536
126,64,62,-,-,95537
438,394,44,-,258500,95538
5638,3283,2355,1011,313500,95540
1137,603,534,1161,386700,95542
232,189,43,791,-,95543
84,70,14,-,469700,95545
913,685,228,580,257500,95546
486,397,89,1029,470800,95547
383,301,82,846,200500,95548
393,326,67,1221,536500,95549
64,12,52,993,750000,95550
620,322,298,991,391100,95551
240,161,79,368,246400,95552
359,216,143,1076,-,95553
176,73,103,-,429200,95554
120,52,68,788,325000,95555
271,208,63,500,337600,95556
135,94,41,-,708300,95558
0,0,0,-,-,95559
623,460,163,-,341200,95560
1381,749,632,827,239000,95562
293,198,95,-,398300,95563
201,76,125,1102,333300,95564
274,104,170,1133,284600,95565
790,595,195,614,254000,95567
46,33,13,-,326200,95568
106,103,3,-,401000,95569
1071,754,317,1449,446600,95570
47,47,0,-,-,95571
581,345,236,1469,314200,95573
194,112,82,645,356700,95585
36,36,0,-,-,95587
654,501,153,1004,405300,95589
112,72,40,-,727300,95595
138,90,48,1136,363500,95601
7290,5960,1330,1399,511000,95602
11825,7994,3831,1302,474900,95603
23,10,13,-,-,95604
4924,2053,2871,993,313500,95605
91,83,8,-,893300,95606
94,86,8,-,375600,95607
25840,13635,12205,1320,448700,95608
17254,8805,8449,1478,375700,95610
523,306,217,2198,853100,95612
53,53,0,-,-,95613
1797,1546,251,1883,430400,95614
342,186,156,878,602300,95615
18126,6620,11506,1710,730800,95616
9708,5398,4310,1911,697900,95618
2513,1377,1136,1499,277300,95619
7379,4511,2868,1555,458600,95620
16495,11051,5444,1442,327900,95621
1606,1352,254,1705,443500,95623
20205,15517,4688,1700,473300,95624
119,12,107,1575,-,95625
1934,1549,385,1423,396500,95626
1209,851,358,1219,357900,95627
16594,11938,4656,1620,489000,95628
305,267,38,-,375000,95629
27236,18890,8346,1945,598100,95630
2552,2234,318,579,409400,95631
10076,7485,2591,1316,403000,95632
1266,1115,151,1786,341700,95633
1842,1592,250,1665,323700,95634
369,340,29,-,356200,95635
497,459,38,-,281900,95636
56,24,32,-,611100,95637
828,805,23,-,585700,95638
70,29,41,-,-,95639
3819,2941,878,1085,345100,95640
741,588,153,879,259800,95641
2915,2030,885,1243,348900,95642
467,311,156,587,343700,95645
89,57,32,"3,500+",393200,95646
20372,16544,3828,1927,514000,95648
5467,4636,831,1570,682700,95650
201,172,29,1413,525400,95651
318,0,318,-,-,95652
166,112,54,-,202000,95653
1545,1190,355,1909,433100,95655
2325,2037,288,1145,702600,95658
316,190,126,1221,435700,95659
10831,6520,4311,1346,256000,95660
12829,7946,4883,1733,550300,95661
12767,9437,3330,1593,408300,95662
1092,992,100,1393,713900,95663
395,310,85,1168,420700,95664
1851,1526,325,1298,315400,95665
2441,2183,258,875,288400,95666
14514,11339,3175,1271,434200,95667
196,130,66,2346,480000,95668
982,836,146,1182,459000,95669
21713,12155,9558,1414,375500,95670
39,0,39,1661,-,95671
2084,1876,208,1682,573400,95672
5154,3602,1552,1412,340100,95673
269,217,52,950,456300,95674
157,124,33,-,-,95675
41,7,34,794,-,95676
10223,7113,3110,1830,506800,95677
17322,9703,7619,1782,426500,95678
64,56,8,-,-,95679
0,0,0,-,-,95680
336,271,65,1419,312700,95681
11621,8674,2947,1534,544400,95682
2564,2326,238,2288,550800,95683
1309,1112,197,1333,460700,95684
2214,1535,679,1120,447400,95685
387,207,180,736,311000,95686
22424,14329,8095,1962,459300,95687
13909,9698,4211,1840,563300,95688
562,544,18,-,404400,95689
711,432,279,1124,601900,95690
14086,8679,5407,1301,412100,95691
1721,1120,601,1283,310900,95692
2475,2000,475,1534,657600,95693
3299,2027,1272,1302,474000,95694
14578,7482,7096,1242,402800,95695
105,83,22,-,170300,95697
138,85,53,-,654100,95698
7,7,0,-,-,95699
391,360,31,1667,460400,95701
820,732,88,1223,534900,95703
2546,1953,593,1318,465300,95709
3748,3058,690,1286,422400,95713
157,107,50,1219,343300,95714
21,21,0,-,337500,95715
73,36,37,869,300000,95717
47,47,0,-,365000,95720
0,0,0,-,-,95721
1873,1667,206,1788,547200,95722
3342,2686,656,1028,341300,95726
139,123,16,-,704900,95728
24,24,0,-,-,95735
57,0,57,-,-,95736
4030,3467,563,2538,472200,95742
7945,7163,782,2063,852900,95746
25949,20635,5314,1867,537300,95747
14578,10759,3819,2214,507100,95757
22152,15554,6598,1862,434500,95758
15688,13520,2168,2109,699100,95762
13911,8982,4929,1954,578900,95765
7977,4839,3138,1378,429900,95776
4079,495,3584,1326,510900,95811
6777,616,6161,997,544600,95814
9634,3709,5925,1169,247400,95815
10574,3024,7550,1351,631100,95816
6558,2242,4316,1282,374200,95817
10404,5905,4499,1273,660600,95818
8112,5807,2305,1778,637200,95819
13625,7395,6230,1336,317700,95820
15809,7604,8205,1155,374500,95821
16651,9996,6655,1315,355400,95822
24311,11540,12771,1329,285600,95823
9144,3601,5543,1163,243800,95824
16086,3775,12311,1278,331300,95825
16045,8591,7454,1469,349300,95826
7407,4511,2896,1489,328800,95827
17895,11702,6193,1478,309800,95828
9157,6856,2301,1759,429800,95829
202,189,13,-,821900,95830
18969,10505,8464,1627,485300,95831
3237,1932,1305,1586,319400,95832
15582,7305,8277,1563,349900,95833
11682,5969,5713,1566,415800,95834
14342,9371,4971,1935,452000,95835
106,66,40,2595,1045500,95837
11671,6402,5269,1328,276000,95838
8225,3128,5097,1311,308800,95841
11884,5711,6173,1368,289300,95842
15020,10212,4808,1779,361900,95843
9891,7304,2587,1562,643200,95864
12615,7052,5563,965,269300,95901
357,0,357,2258,-,95903
65,65,0,-,120800,95910
1406,971,435,884,351000,95912
96,54,42,1242,227500,95913
254,198,56,1146,306900,95914
0,0,0,-,-,95915
486,402,84,850,204800,95916
1293,932,361,1446,275000,95917
820,655,165,-,532700,95918
529,499,30,-,273400,95919
102,70,32,585,269400,95920
265,187,78,950,266200,95922
39,39,0,-,736100,95923
105,84,21,-,-,95925
17314,7128,10186,1218,370500,95926
15690,7177,8513,1218,388800,95928
0,0,0,-,-,95929
176,105,71,-,282900,95930
3002,1799,1203,925,285200,95932
60,60,0,-,-,95934
165,87,78,-,-,95935
56,56,0,-,1024200,95936
515,317,198,621,-,95937
1408,986,422,1292,477700,95938
180,67,113,615,138100,95939
119,99,20,-,269500,95941
863,791,72,-,392300,95942
247,123,124,779,570300,95943
64,0,64,-,-,95944
11680,6796,4884,1190,391400,95945
3563,2871,692,1874,443600,95946
689,542,147,719,240100,95947
3821,2169,1652,1000,260600,95948
7914,7127,787,1607,448500,95949
205,120,85,1125,-,95950
814,381,433,770,240300,95951
3244,2076,1168,953,276300,95953
4377,3534,843,1075,194500,95954
507,333,174,1052,283100,95955
196,196,0,-,261500,95956
285,169,116,945,278300,95957
0,0,0,-,-,95958
7577,5768,1809,1424,519400,95959
276,157,119,-,348300,95960
9437,6202,3235,1124,292400,95961
454,360,94,-,297500,95962
5710,3818,1892,1061,278200,95963
7704,4431,3273,951,216400,95965
11923,8824,3099,1005,244400,95966
507,290,217,943,156800,95968
4113,3064,1049,1036,300000,95969
192,99,93,981,450000,95970
2145,1165,980,1226,266100,95971
54,0,54,-,-,95972
15175,9341,5834,1289,402600,95973
51,51,0,-,-,95974
730,600,130,1128,478700,95975
688,592,96,1647,377100,95977
36,11,25,-,-,95978
163,102,61,681,250000,95979
18,18,0,-,-,95981
1115,831,284,1166,292700,95982
174,98,76,869,-,95983
94,73,21,-,-,95984
35,25,10,-,-,95986
1871,1110,761,1197,310300,95987
2805,1585,1220,944,244100,95988
14445,7125,7320,1141,297900,95991
12585,8707,3878,1284,353700,95993
13369,7650,5719,1119,319700,96001
12688,7822,4866,1142,280900,96002
18350,10813,7537,1261,299600,96003
216,185,31,-,162000,96006
9531,6210,3321,970,235900,96007
441,369,72,-,197700,96008
143,102,41,912,277800,96009
14,14,0,-,-,96010
87,55,32,-,115200,96011
1600,1097,503,875,169500,96013
66,24,42,-,-,96014
80,40,40,-,218800,96015
133,87,46,-,166800,96016
84,58,26,625,258300,96017
4050,2664,1386,1091,219700,96019
1155,864,291,777,229200,96020
5379,3332,2047,963,212900,96021
5720,4424,1296,1132,263300,96022
502,375,127,734,120300,96023
319,212,107,1083,278800,96024
959,576,383,832,232200,96025
844,648,196,939,240800,96027
607,445,162,-,286100,96028
59,53,6,-,311500,96029
29,28,1,-,163600,96031
1031,692,339,946,253400,96032
174,146,28,1167,130000,96033
159,118,41,936,305300,96034
1483,1054,429,1111,223500,96035
43,0,43,-,-,96037
259,170,89,827,213900,96038
414,233,181,705,143800,96039
38,38,0,-,-,96040
1095,643,452,627,310100,96041
453,326,127,829,177100,96044
54,21,33,-,-,96046
354,329,25,-,367600,96047
401,346,55,-,330600,96048
245,207,38,810,201200,96050
575,476,99,1141,269100,96051
611,444,167,835,282500,96052
121,101,20,-,124600,96054
1588,1148,440,1198,229300,96055
542,525,17,-,266500,96056
495,367,128,1055,237500,96057
200,120,80,-,226600,96058
182,160,22,-,358000,96059
0,0,0,-,-,96061
410,327,83,1281,325000,96062
76,48,28,-,170700,96063
1799,1365,434,827,199100,96064
151,107,44,-,267700,96065
3655,2277,1378,1223,320300,96067
19,6,13,-,-,96068
459,421,38,1300,327000,96069
10,10,0,-,-,96071
1903,1730,173,2111,451900,96073
33,28,5,-,-,96074
176,104,72,-,-,96075
84,54,30,-,-,96076
0,0,0,-,-,96078
12031,7745,4286,1021,250400,96080
258,198,60,1104,241700,96084
7,7,0,-,159400,96085
114,81,33,923,225000,96086
313,279,34,-,334500,96087
2221,2002,219,964,257200,96088
209,142,67,1080,197700,96090
338,276,62,936,321300,96091
91,60,31,-,275000,96092
1695,1232,463,929,298300,96093
2855,1880,975,814,248600,96094
333,299,34,1125,332200,96096
4165,2742,1423,866,190300,96097
2041,1515,526,756,145900,96101
681,597,84,1233,352200,96103
398,259,139,779,174400,96104
174,168,6,-,-,96105
203,100,103,-,470000,96106
341,222,119,854,245800,96107
54,41,13,-,-,96108
414,372,42,-,186400,96109
13,7,6,-,-,96110
14,14,0,-,-,96111
93,59,34,513,197900,96112
411,241,170,954,-,96113
1311,919,392,1142,295100,96114
67,61,6,-,-,96115
31,31,0,-,-,96116
99,91,8,-,-,96117
569,464,105,825,215000,96118
12,12,0,-,-,96119
326,288,38,950,375300,96120
112,87,25,-,-,96121
1728,1218,510,814,198000,96122
25,19,6,-,231300,96123
111,95,16,-,-,96124
76,76,0,-,268200,96125
66,41,25,-,-,96126
250,239,11,-,353900,96128
158,158,0,-,352000,96129
4967,3289,1678,933,218100,96130
10,4,6,-,-,96132
129,103,26,-,219600,96133
676,496,180,709,130100,96134
60,60,0,-,-,96135
17,17,0,-,-,96136
1471,1164,307,742,236300,96137
592,478,114,1807,721200,96140
257,227,30,-,817300,96141
374,217,157,1396,577700,96142
1467,843,624,1315,542100,96143
1157,862,295,1473,785700,96145
498,234,264,1522,1203900,96146
293,241,52,954,681100,96148
12461,7018,5443,1181,488200,96150
0,0,0,-,-,96155
7193,5640,1553,1822,653600,96161
14364,9812,4552,1819,776400,96701
761,652,109,1463,441900,96703
2925,1849,1076,1605,474800,96704
684,453,231,1375,492200,96705
21944,14757,7187,2524,638900,96706
14993,10825,4168,2221,643600,96707
4013,2400,1613,2032,866100,96708
135,135,0,-,784900,96710
2594,1333,1261,1867,1103300,96712
371,165,206,3173,314700,96713
413,202,211,985,1069000,96714
759,500,259,1325,534200,96716
1339,689,650,2008,731800,96717
434,304,130,1218,488800,96719
17038,11079,5959,1136,365000,96720
925,650,275,1373,935600,96722
1496,900,596,1519,731800,96725
9,9,0,-,-,96726
1511,1190,321,1125,398800,96727
155,117,38,1583,353700,96728
388,310,78,1078,167700,96729
526,344,182,1482,814900,96730
831,546,285,1442,653300,96731
7908,5077,2831,1360,621500,96732
16599,10394,6205,3008,1073400,96734
1740,1365,375,643,168300,96737
2841,1991,850,1725,521100,96738
14272,9449,4823,1497,604600,96740
1950,1376,574,1486,723600,96741
31,0,31,1094,-,96742
4662,3248,1414,1960,613700,96743
17150,13101,4049,2003,838700,96744
6715,4486,2229,1748,640300,96746
284,0,284,896,-,96747
1390,847,543,828,338100,96748
6234,4694,1540,923,323800,96749
1246,781,465,971,498400,96750
44,20,24,-,-,96751
1044,613,431,2066,450400,96752
10853,6656,4197,1886,715000,96753
1198,961,237,1836,813400,96754
1215,1002,213,960,537200,96755
2033,1206,827,1341,719700,96756
241,200,41,1313,358800,96757
85,0,85,-,-,96759
1332,1176,156,1591,277600,96760
7272,4073,3199,1810,778100,96761
1072,414,658,2134,959200,96762
1183,656,527,1049,487200,96763
220,168,52,884,424400,96764
212,95,117,1818,640600,96765
4841,2979,1862,1531,591700,96766
6303,4295,2008,1684,719800,96768
78,0,78,775,-,96769
192,89,103,807,248400,96770
2386,1691,695,1128,212400,96771
990,800,190,1030,311900,96772
80,51,29,985,882800,96773
85,85,0,-,289700,96774
518,357,161,1263,377000,96776
605,446,159,615,176900,96777
5838,4461,1377,1216,207700,96778
877,608,269,2271,825700,96779
250,157,93,803,417000,96780
459,355,104,1350,402200,96781
11909,7951,3958,2064,693500,96782
594,352,242,503,390600,96783
2132,1610,522,1272,271200,96785
13654,3923,9731,2425,583300,96786
18794,14867,3927,2109,725500,96789
3206,2203,1003,1719,951200,96790
2377,1537,840,1973,743100,96791
13426,7995,5431,1615,455900,96792
9722,6857,2865,1531,608400,96793
2278,1742,536,1296,615200,96795
727,322,405,1250,476100,96796
19971,13463,6508,1799,626800,96797
11577,6081,5496,1640,703700,96813
11795,4909,6886,1606,617200,96814
14584,6927,7657,1768,553900,96815
17881,10840,7041,1762,988600,96816
19058,8256,10802,1291,811500,96817
18992,6939,12053,2918,593000,96818
11778,5785,5993,1580,800200,96819
0,0,0,-,-,96820
6600,5556,1044,2603,1147000,96821
18842,10515,8327,1575,786600,96822
10759,8907,1852,3128,898400,96825
14621,4633,9988,1410,452000,96826
0,0,0,-,-,96848
0,0,0,-,-,96850
0,0,0,-,-,96853
0,0,0,-,-,96857
0,0,0,-,-,96858
0,0,0,-,-,96859
0,0,0,-,-,96860
0,0,0,-,-,96863
43,10,33,-,102500,97001
2282,1783,499,1300,405300,97002
10364,5904,4460,1627,368500,97003
1683,1471,212,1572,522900,97004
11355,4288,7067,1310,381900,97005
17945,8695,9250,1624,425500,97006
18399,13820,4579,1627,459200,97007
12367,6619,5748,1422,415600,97008
3127,2684,443,1352,464100,97009
344,344,0,-,400000,97011
8952,6350,2602,1230,403400,97013
668,508,160,1167,300800,97014
9109,5782,3327,1517,398700,97015
2728,2244,484,879,242100,97016
1168,1109,59,667,440000,97017
703,602,101,1158,348000,97018
1151,999,152,1605,498500,97019
399,341,58,1167,223600,97020
593,393,200,1041,285200,97021
1350,1069,281,1330,446200,97022
3983,3432,551,1094,400700,97023
4797,2635,2162,1388,324900,97024
1013,863,150,1302,285900,97026
4870,3109,1761,1484,366000,97027
111,87,24,-,-,97028
118,69,49,-,97600,97029
15399,6765,8634,1375,324000,97030
7364,4999,2365,1183,460800,97031
1690,1235,455,1333,381600,97032
31,9,22,-,-,97033
8272,6312,1960,1847,791100,97034
10931,6976,3955,1766,596400,97035
394,264,130,890,198500,97037
5979,4293,1686,1199,359500,97038
169,101,68,872,179200,97039
614,452,162,1156,334300,97040
947,684,263,947,447700,97041
993,899,94,1593,513500,97042
20489,15335,5154,1419,438400,97045
2839,2236,603,853,291200,97048
879,793,86,1333,362900,97049
105,84,21,725,133300,97050
6262,4167,2095,1091,288900,97051
1433,1337,96,873,398000,97053
622,591,31,-,291200,97054
6841,5528,1313,1251,373400,97055
4529,3448,1081,1493,351500,97056
8,6,2,-,-,97057
8123,5205,2918,858,247500,97058
7042,4960,2082,1315,345300,97060
11112,6468,4644,1488,477100,97062
412,362,50,1750,210600,97063
1304,1096,208,1319,274700,97064
288,236,52,982,161800,97065
882,631,251,1435,316500,97067
11303,9550,1753,1779,597800,97068
10579,5455,5124,1542,471300,97070
10204,6547,3657,1127,250200,97071
8761,5843,2918,1500,366700,97078
16361,11862,4499,1381,383800,97080
11589,7464,4125,1380,543700,97086
4795,4540,255,1734,483100,97089
1398,1061,337,1320,398500,97101
172,172,0,-,549000,97102
6989,4364,2625,985,335100,97103
1791,1552,239,1385,443300,97106
959,742,217,1003,274700,97107
227,196,31,954,310800,97108
195,162,33,1656,441000,97109
595,251,344,975,569100,97110
1340,1061,279,1321,404300,97111
841,630,211,1075,304800,97112
4869,3687,1182,1370,341200,97113
1558,1245,313,1353,338800,97114
1324,1117,207,969,398500,97115
10070,6482,3588,1186,383900,97116
306,272,34,1463,483600,97117
305,193,112,1011,284400,97118
1783,1562,221,1298,464600,97119
544,373,171,1176,328500,97121
125,116,9,-,286100,97122
16404,11256,5148,1396,383500,97123
20796,9921,10875,1716,420600,97124
24,24,0,-,355600,97125
1473,1362,111,1171,278300,97127
14342,9466,4876,1129,335000,97128
365,306,59,1254,482300,97130
1248,1023,225,1090,337100,97131
11376,7829,3547,1425,386500,97132
2100,1755,345,1811,495600,97133
65,55,10,-,394800,97134
538,362,176,1267,422500,97135
956,715,241,963,283700,97136
376,261,115,1138,470900,97137
4971,2650,2321,944,349300,97138
9074,7043,2031,1713,491500,97140
5261,3289,1972,992,280100,97141
72,72,0,-,383300,97144
117,62,55,808,590900,97145
2891,1957,934,1112,331400,97146
208,92,116,819,323100,97147
1097,896,201,1404,451500,97148
245,223,22,-,463200,97149
9138,2717,6421,1496,602400,97201
18265,9407,8858,1387,597400,97202
12660,7345,5315,1337,392300,97203
431,21,410,678,-,97204
5720,1207,4513,1190,554500,97205
21338,14220,7118,1485,400800,97206
0,0,0,-,-,97208
13794,3218,10576,1477,555000,97209
6647,2424,4223,1387,801300,97210
14188,9315,4873,1584,530100,97211
11333,7561,3772,1556,695300,97212
14289,9286,5003,1342,501000,97213
14412,4699,9713,1445,642200,97214
7335,4459,2876,1362,575300,97215
6986,3912,3074,1276,351000,97216
15276,8863,6413,1613,464100,97217
6058,3531,2527,1432,406300,97218
18306,12993,5313,1494,556500,97219
11525,6499,5026,1249,362700,97220
5339,3809,1530,1404,657000,97221
15798,8674,7124,1380,375900,97222
20306,12783,7523,1492,459400,97223
15509,10660,4849,1501,450900,97224
11686,5892,5794,1523,598700,97225
3257,814,2443,1480,540900,97227
26324,18384,7940,1690,600700,97229
15825,9992,5833,1304,350800,97230
1567,1310,257,1504,725100,97231
8245,2189,6056,1410,660000,97232
13833,6762,7071,1207,299500,97233
13284,7561,5723,1308,334800,97236
9239,4291,4948,1535,628100,97239
0,0,0,-,-,97258
13035,7404,5631,1343,337600,97266
12857,9260,3597,1349,390800,97267
19615,8487,11128,1031,232400,97301
16562,10193,6369,1093,328100,97302
14709,9033,5676,1144,302500,97303
13149,8590,4559,1221,353900,97304
14299,7645,6654,1170,248000,97305
13032,8456,4576,1264,331700,97306
0,0,0,-,-,97310
8339,6089,2250,1223,308100,97317
11009,8179,2830,1059,345900,97321
13918,7990,5928,1115,241900,97322
541,345,196,927,230800,97324
2212,1740,472,1233,306600,97325
356,335,21,-,321000,97326
1322,1064,258,1064,282300,97327
18,0,18,-,-,97329
18479,9158,9321,1200,407500,97330
0,0,0,-,-,97331
9974,4499,5475,1214,383400,97333
44,44,0,-,-,97335
22,22,0,-,-,97336
8820,6619,2201,1026,298700,97338
1779,1316,463,996,269700,97341
47,43,4,-,203100,97342
149,109,40,-,342600,97343
653,482,171,1010,204400,97344
230,144,86,1334,300000,97345
338,290,48,1035,235100,97346
548,241,307,397,203800,97347
630,458,172,1115,274700,97348
79,65,14,1500,242500,97350
3336,2052,1284,1322,266200,97351
2063,1562,501,1093,346200,97352
12435,8394,4041,1090,253000,97355
138,123,15,-,360300,97357
1045,979,66,1039,312100,97358
882,698,184,1070,212100,97360
4156,1998,2158,1059,312600,97361
1481,903,578,923,323100,97362
257,147,110,-,377700,97364
4749,2916,1833,1018,300700,97365
873,735,138,1042,359500,97366
4824,3112,1712,1086,291600,97367
1318,976,342,1020,175900,97368
81,60,21,-,275000,97369
3586,2697,889,1154,330900,97370
330,198,132,856,439700,97371
0,0,0,-,-,97373
1936,1560,376,1030,415900,97374
453,445,8,-,422200,97375
573,428,145,838,345400,97376
319,170,149,1169,302400,97377
2974,2063,911,943,261700,97378
845,568,277,934,164600,97380
5799,3815,1984,1186,386500,97381
3828,2355,1473,948,335500,97383
45,45,0,-,-,97384
1443,982,461,1161,376300,97385
5802,4129,1673,1001,222300,97386
373,259,114,970,381500,97388
702,461,241,1399,304400,97389
372,296,76,664,275500,97390
2320,1447,873,933,282500,97391
1953,1678,275,862,399000,97392
2397,1909,488,948,264200,97394
1424,1035,389,993,246700,97396
22239,6799,15440,1079,376600,97401
22307,10961,11346,1083,253500,97402
4491,1920,2571,1079,427000,97403
13352,9550,3802,1252,299800,97404
19432,13730,5702,1261,394600,97405
138,138,0,-,-,97406
6055,3621,2434,1417,407300,97408
253,145,108,781,353200,97410
3437,2394,1043,944,331900,97411
232,211,21,1208,257600,97412
455,283,172,775,370400,97413
58,58,0,-,-,97414
6583,5038,1545,951,321400,97415
370,304,66,892,229500,97416
1048,696,352,834,155400,97417
393,352,41,944,356100,97419
11988,7849,4139,853,228100,97420
2887,2366,521,1041,204200,97423
7396,4948,2448,941,257200,97424
3999,2937,1062,1252,331400,97426
347,221,126,722,309800,97429
169,141,28,725,310000,97430
739,580,159,1226,239100,97431
17,0,17,-,-,97432
293,216,77,1060,279500,97434
984,737,247,880,234200,97435
313,237,76,944,233900,97436
934,782,152,1612,307700,97437
446,379,67,-,343100,97438
7628,5388,2240,1044,297900,97439
155,26,129,953,-,97441
1006,651,355,886,264400,97442
947,638,309,724,300600,97443
2627,1942,685,967,318800,97444
2092,1616,476,1131,269700,97446
233,159,74,-,370900,97447
5817,4240,1577,792,313400,97448
892,680,212,875,220300,97449
273,230,43,-,322600,97450
148,148,0,-,287500,97451
594,511,83,842,235100,97452
342,229,113,908,264100,97453
395,351,44,1143,301000,97454
901,706,195,1235,421500,97455
1188,913,275,900,294800,97456
3949,2895,1054,837,200100,97457
1997,1391,606,723,214000,97458
5900,3916,1984,890,273900,97459
377,351,26,-,414600,97461
1758,1333,425,917,304800,97462
1696,1094,602,849,168800,97463
1030,705,325,813,233900,97465
464,341,123,631,173800,97466
2430,1682,748,694,165600,97467
1014,824,190,791,191100,97469
8396,5182,3214,949,195500,97470
12587,9559,3028,1039,252200,97471
124,104,20,792,281000,97473
152,152,0,-,259800,97476
16180,8094,8086,1014,266300,97477
14831,10296,4535,1136,280500,97478
4491,2870,1621,918,203300,97479
145,105,40,-,214800,97480
375,319,56,-,164800,97481
88,60,28,590,252900,97484
271,257,14,-,352700,97486
3610,3004,606,1053,259300,97487
447,407,40,1330,359100,97488
439,388,51,970,367000,97489
148,118,30,1169,246200,97490
443,430,13,1078,214200,97492
159,133,26,781,344300,97493
33,33,0,-,-,97494
858,709,149,876,331000,97495
2720,1922,798,941,195900,97496
689,516,173,480,254500,97497
921,714,207,958,368300,97498
732,622,110,902,211200,97499
18869,10139,8730,1037,246200,97501
10811,8118,2693,1153,306900,97502
4554,3600,954,970,213000,97503
19779,12162,7617,1197,353100,97504
12200,7471,4729,1170,478900,97520
227,176,51,956,201900,97522
2923,2196,727,926,262600,97523
6006,4411,1595,1212,330200,97524
2081,1667,414,1040,352700,97525
15115,9803,5312,926,294900,97526
14563,10126,4437,1125,328000,97527
3405,2361,1044,1446,456800,97530
99,85,14,-,-,97531
981,858,123,-,320800,97532
358,358,0,-,165100,97534
2123,1265,858,1024,241100,97535
470,359,111,643,257800,97536
2801,2111,690,945,307700,97537
732,666,66,719,263700,97538
1402,1004,398,1178,217400,97539
3689,2108,1581,1108,321400,97540
587,502,85,1116,258300,97541
262,179,83,900,412500,97543
889,708,181,1486,365700,97544
9737,5496,4241,833,220100,97601
12283,8123,4160,865,194800,97603
0,0,0,-,-,97604
27,13,14,-,-,97620
110,109,1,-,457000,97621
162,136,26,598,-,97622
1142,966,176,777,206600,97623
1653,1419,234,969,206300,97624
62,48,14,-,307700,97625
82,60,22,-,125000,97626
182,133,49,-,171300,97627
2048,1414,634,763,159400,97630
533,347,186,863,198800,97632
475,334,141,697,143000,97633
135,122,13,-,172100,97634
75,42,33,-,126800,97635
186,68,118,565,95000,97636
62,49,13,-,168800,97637
170,94,76,825,160700,97638
21,21,0,-,-,97639
54,26,28,-,263600,97640
770,429,341,772,164300,97641
16711,9513,7198,1498,405500,97701
20521,14257,6264,1511,459100,97702
13316,10024,3292,1613,684800,97703
3066,2468,598,1372,411500,97707
0,0,0,-,-,97709
37,19,18,-,275000,97710
26,23,3,-,602300,97711
22,0,22,-,-,97712
1784,1176,608,718,108800,97720
81,54,27,-,275000,97721
10,8,2,-,300000,97722
118,93,25,1607,497700,97730
196,49,147,610,335700,97731
60,39,21,623,-,97732
256,183,73,-,146000,97733
1188,903,285,961,234800,97734
65,26,39,-,1102300,97735
23,8,15,-,212500,97736
200,168,32,-,197700,97737
931,754,177,662,179400,97738
5377,4242,1135,992,255200,97739
4345,2602,1743,863,252900,97741
152,92,60,725,219200,97750
31,17,14,-,-,97751
0,0,0,-,-,97752
1150,947,203,-,556800,97753
8711,6293,2418,969,275200,97754
16570,11474,5096,1259,354900,97756
30,13,17,392,335700,97758
3305,2817,488,1384,531600,97759
3166,2896,270,990,353700,97760
908,546,362,474,104800,97761
7523,4599,2924,827,212200,97801
380,287,93,1083,247900,97810
311,222,89,1167,156000,97812
584,445,139,787,145600,97813
5174,3722,1452,726,189300,97814
6,6,0,-,-,97817
1479,942,537,718,160200,97818
17,10,7,-,95000,97819
462,382,80,710,180700,97820
583,449,134,682,117000,97823
735,599,136,957,311100,97824
135,109,26,706,188400,97825
443,265,178,843,323100,97826
1057,858,199,839,172500,97827
1395,966,429,635,259500,97828
316,249,67,683,156300,97830
289,208,81,725,345200,97833
526,340,186,808,233800,97834
168,137,31,644,190100,97835
877,566,311,642,205900,97836
52,42,10,-,58600,97837
9170,6161,3009,899,222400,97838
125,118,7,-,250000,97839
48,24,24,-,-,97840
190,159,31,1167,257000,97841
56,44,12,-,-,97842
339,241,98,643,185900,97843
1254,1057,197,923,164000,97844
1139,813,326,810,153900,97845
1018,765,253,966,316300,97846
87,64,23,-,343500,97848
6837,4132,2705,883,206200,97850
216,129,87,606,151000,97856
229,189,40,775,279500,97857
89,78,11,-,-,97859
4359,2858,1501,679,172100,97862
150,121,29,675,335700,97864
532,441,91,591,186800,97865
402,332,70,709,120100,97867
660,551,109,940,140000,97868
415,334,81,765,138800,97869
294,213,81,594,211300,97870
108,83,25,672,77200,97873
159,106,53,715,270500,97874
1047,820,227,993,160400,97875
350,292,58,1581,362100,97876
163,157,6,-,-,97877
151,122,29,781,-,97880
2112,1481,631,872,158200,97882
1007,747,260,895,161000,97883
72,59,13,-,227900,97884
571,444,127,740,270000,97885
338,256,82,1030,170600,97886
260,189,71,745,431800,97901
6,5,1,-,-,97902
16,16,0,-,-,97903
120,96,24,425,480600,97904
63,33,30,-,-,97905
89,56,33,821,220000,97906
274,194,80,581,95000,97907
10,4,6,-,-,97908
7,0,7,-,-,97909
179,90,89,636,207700,97910
32,21,11,525,252800,97911
1610,929,681,694,128500,97913
5927,3489,2438,700,161000,97914
14,9,5,-,-,97917
1602,997,605,780,198000,97918
13,6,7,-,350000,97920
11820,9243,2577,1716,398800,98001
14012,6379,7633,1261,303700,98002
18988,8978,10010,1414,343400,98003
18125,6837,11288,2382,1586500,98004
8732,4419,4313,2112,1024600,98005
13782,10938,2844,2522,983800,98006
11770,4068,7702,2033,719400,98007
9233,6776,2457,2153,880800,98008
2280,1925,355,1536,657800,98010
11133,6616,4517,1945,654800,98011
26731,18054,8677,2019,619500,98012
2842,2593,249,1592,635100,98014
3903,3580,323,2335,600300,98019
8762,6445,2317,1738,712400,98020
11809,9320,2489,2097,661500,98021
8697,6716,1981,1320,426700,98022
17896,11336,6560,1666,404900,98023
1976,1772,204,1733,799800,98024
0,0,0,-,-,98025
15357,11256,4101,1609,583700,98026
11294,7942,3352,2027,781700,98027
9266,6445,2821,1704,656200,98028
12362,8038,4324,2470,791100,98029
13134,6622,6512,1647,399600,98030
13716,8931,4785,1654,434800,98031
14195,5941,8254,1546,369300,98032
16773,10755,6018,2045,1011800,98033
20706,12491,8215,1985,673000,98034
15091,9194,5897,1492,553800,98036
10705,6636,4069,1654,529000,98037
12733,10973,1760,1946,544800,98038
1054,859,195,"3,500+","2,000,000+",98039
9758,6607,3151,2244,1504500,98040
16602,13869,2733,1787,456200,98042
8616,4849,3767,1762,452000,98043
5704,4633,1071,1910,611300,98045
2293,1098,1195,1538,330000,98047
0,0,0,-,-,98050
1560,1315,245,1826,474400,98051
30181,15174,15007,2169,871600,98052
8458,7191,1267,2438,907100,98053
9351,4835,4516,1879,431600,98055
14449,8130,6319,1763,602300,98056
5951,1483,4468,1529,419100,98057
15449,10936,4513,1773,463700,98058
14319,10937,3382,1924,650900,98059
5200,4479,721,2393,671000,98065
295,272,23,1021,642000,98068
4579,3800,779,1499,597000,98070
9748,7277,2471,2137,806100,98072
9811,8526,1285,2601,915400,98074
8241,7242,999,2815,1076500,98075
4636,4210,426,2153,895700,98077
15403,8009,7394,1791,471900,98087
17170,12492,4678,1647,447500,98092
10127,1517,8610,2110,751500,98101
15755,3885,11870,1810,850900,98102
25283,11252,14031,1836,848500,98103
8299,865,7434,1434,610900,98104
16760,5614,11146,1597,1062200,98105
11227,6028,5199,1568,536800,98106
14647,6009,8638,1939,790000,98107
8367,4661,3706,1327,580500,98108
18072,4032,14040,2110,818200,98109
9824,7885,1939,1771,852700,98110
10938,6832,4106,1845,1094300,98112
22557,13811,8746,1892,890500,98115
12698,7130,5568,1819,790200,98116
14802,10471,4331,1922,849200,98117
17853,10656,7197,1685,633000,98118
13726,5624,8102,1796,911800,98119
13659,3610,10049,2181,739800,98121
21383,6287,15096,1819,795500,98122
19336,8852,10484,1673,669800,98125
9928,6022,3906,1493,616700,98126
22365,10518,11847,1594,596500,98133
246,76,170,1692,400000,98134
7829,5019,2810,1788,743300,98136
14195,6809,7386,1638,741800,98144
10306,6732,3574,1568,490500,98146
4117,1887,2230,1622,433800,98148
0,0,0,-,-,98154
13790,9846,3944,1759,634900,98155
0,0,0,-,-,98158
157,108,49,-,695700,98164
9131,5873,3258,1542,628600,98166
12220,6800,5420,1473,389400,98168
0,0,0,-,-,98174
7994,6734,1260,1771,837400,98177
9531,6346,3185,1604,494000,98178
10873,4850,6023,1450,354400,98188
0,0,0,-,-,98195
14376,7698,6678,1617,403800,98198
10186,6245,3941,2121,934900,98199
13316,5948,7368,1213,378600,98201
13876,8927,4949,1560,414200,98203
16975,6096,10879,1489,304600,98204
0,0,0,-,-,98207
21887,15142,6745,1681,473600,98208
191,191,0,-,340700,98220
10075,7131,2944,1335,498800,98221
60,45,15,-,602300,98222
16673,13204,3469,1589,414200,98223
102,89,13,1453,423700,98224
21943,9190,12753,1183,454200,98225
18890,11679,7211,1261,418900,98226
13483,9422,4061,1352,427100,98229
7902,5992,1910,1148,340400,98230
1590,1379,211,1803,560600,98232
6532,4145,2387,1312,350900,98233
144,73,71,634,306000,98235
2478,1963,515,1258,531200,98236
1778,1392,386,1245,272300,98237
45,0,45,-,-,98238
3368,2829,539,1101,441500,98239
1199,1055,144,1361,378100,98240
849,567,282,833,264700,98241
145,86,59,1337,916700,98243
1294,1030,264,941,339700,98244
1978,1514,464,1145,568700,98245
2948,1999,949,1031,355500,98247
9069,6867,2202,1180,412900,98248
2051,1735,316,1321,462800,98249
3946,2985,961,1198,566500,98250
1929,1631,298,1449,316500,98251
3879,2897,982,1344,408000,98252
1192,1150,42,-,496800,98253
127,118,9,-,250000,98255
137,113,24,1188,313800,98256
2107,1605,502,968,376900,98257
17359,13789,3570,1805,438300,98258
2784,2212,572,1007,494700,98260
1454,1110,344,1111,548300,98261
486,416,70,829,488700,98262
69,62,7,938,333300,98263
7946,5013,2933,1374,390900,98264
1497,1024,473,1073,208300,98266
133,81,52,-,-,98267
18949,13259,5690,1506,389500,98270
10858,8294,2564,1577,383000,98271
9667,7616,2051,1635,456200,98272
11556,7265,4291,1049,338000,98273
6850,5338,1512,1424,400000,98274
8304,5837,2467,1874,666300,98275
517,430,87,1453,325400,98276
15943,9194,6749,1351,343300,98277
0,0,0,-,-,98278
364,243,121,1639,649600,98279
199,169,30,1453,713900,98280
636,541,95,911,308400,98281
7286,6600,686,1574,455300,98282
179,179,0,-,273200,98283
10158,7424,2734,1253,316400,98284
87,73,14,665,683000,98286
91,58,33,1081,287500,98288
14045,11307,2738,1286,552100,98290
8700,7084,1616,1435,474100,98292
2556,2017,539,1369,312300,98294
1020,647,373,1100,279600,98295
9172,8223,949,2010,636200,98296
42,38,4,-,335700,98297
811,772,39,1278,426500,98303
440,363,77,779,231800,98304
141,129,12,-,-,98305
9048,4629,4419,1240,325000,98310
10021,7240,2781,1537,329400,98311
12812,7978,4834,1351,318200,98312
28,0,28,2156,-,98314
1074,11,1063,1913,-,98315
678,582,96,940,222700,98320
6056,5223,833,1451,423000,98321
242,218,24,1365,324000,98323
712,674,38,-,305800,98325
369,232,137,852,224600,98326
4108,2272,1836,1930,385500,98327
3710,3147,563,1034,388200,98328
4087,3683,404,1521,381600,98329
11,11,0,-,-,98330
2176,1397,779,774,185100,98331
7198,5955,1243,1987,577200,98332
1371,1279,92,1857,774300,98333
10785,8312,2473,1597,579800,98335
257,206,51,-,239300,98336
3530,1669,1861,1092,276300,98337
10802,9167,1635,1529,357000,98338
1426,1104,322,968,329100,98339
1545,1358,187,1709,385000,98340
611,515,96,1294,495200,98342
162,57,105,929,548600,98345
3865,3095,770,1445,472200,98346
2084,1830,254,1050,274100,98349
92,55,37,550,55000,98350
596,485,111,918,437500,98351
17,0,17,-,-,98353
3212,1829,1383,1635,360200,98354
297,221,76,-,265700,98355
911,686,225,1123,185200,98356
517,370,147,551,100900,98357
439,324,115,1172,489800,98358
1868,1530,338,1066,437000,98359
5045,4281,764,1813,351200,98360
316,267,49,-,208500,98361
10731,7012,3719,960,285200,98362
5961,4479,1482,1041,268400,98363
20,0,20,-,-,98364
2432,2155,277,1855,495700,98365
14047,9157,4890,1367,347100,98366
11448,9828,1620,1522,391900,98367
8363,6100,2263,1083,394700,98368
12893,9840,3053,1551,436300,98370
8840,6175,2665,1383,375100,98371
10544,5688,4856,1482,412700,98372
10504,5986,4518,1618,387400,98373
14501,10374,4127,1706,371600,98374
10017,7608,2409,1858,347700,98375
891,786,105,1031,309000,98376
965,742,223,751,188900,98377
1935,1733,202,1860,446900,98380
96,67,29,856,217900,98381
14109,10928,3181,1122,337500,98382
8798,4932,3866,1726,437000,98383
191,187,4,-,334500,98385
16364,12249,4115,1535,313400,98387
2712,1735,977,1255,442500,98388
4575,2536,2039,1614,385500,98390
19173,16527,2646,1805,422400,98391
1370,1016,354,1175,349800,98392
418,350,68,1306,431000,98394
244,186,58,1500,302500,98396
3897,866,3031,1298,413800,98402
4292,1728,2564,1169,552400,98403
12254,7739,4515,1180,282600,98404
10106,5134,4972,1225,341100,98405
9918,6385,3533,1415,421200,98406
9559,6262,3297,1589,462200,98407
8121,5222,2899,1314,286500,98408
11351,4653,6698,1342,270700,98409
0,0,0,-,-,98416
4055,2716,1339,1285,286900,98418
12,0,12,-,-,98421
7903,6139,1764,1822,465000,98422
4395,2048,2347,1569,348000,98424
0,0,0,-,-,98430
4268,35,4233,1884,-,98433
12,0,12,-,-,98438
2128,127,2001,1359,-,98439
2155,1826,329,1488,374100,98443
12964,5860,7104,1264,267000,98444
11689,8481,3208,1453,304300,98445
4489,3348,1141,1697,359400,98446
0,0,0,-,-,98447
3498,1795,1703,1214,394700,98465
11868,6328,5540,1414,421500,98466
6147,3677,2470,1302,430300,98467
11362,6710,4652,1264,348800,98498
13635,4829,8806,1181,308600,98499
18315,10722,7593,1299,381300,98501
14483,8255,6228,1332,397300,98502
17195,9687,7508,1431,288100,98503
0,0,0,-,-,98505
8561,5853,2708,1199,363500,98506
12356,8362,3994,1386,344500,98512
13284,10020,3264,1650,325900,98513
10502,7552,2950,1658,397900,98516
8304,4939,3365,869,186800,98520
1691,1517,174,1082,393400,98524
76,47,29,910,190600,98526
131,125,6,-,140100,98527
4856,3691,1165,964,281200,98528
183,132,51,1078,159000,98530
10499,6404,4095,944,228600,98531
9578,7126,2452,966,300100,98532
255,156,99,744,252900,98533
314,271,43,-,-,98535
0,0,0,-,-,98536
966,764,202,791,228500,98537
164,120,44,1138,324500,98538
65,50,15,950,158900,98539
4076,2913,1163,837,228500,98541
210,160,50,527,346700,98542
16,16,0,-,-,98544
1326,1172,154,1215,329500,98546
692,509,183,1050,156400,98547
1125,1003,122,-,256400,98548
4893,3196,1697,813,160500,98550
85,74,11,-,168200,98552
267,230,37,-,-,98555
0,0,0,-,-,98556
1357,1113,244,819,254600,98557
0,0,0,-,-,98558
0,0,0,-,-,98559
45,45,0,-,276300,98560
43,0,43,-,-,98562
3082,2410,672,1004,226900,98563
1130,953,177,875,167900,98564
93,53,40,975,189100,98565
108,104,4,-,75000,98566
1102,856,246,773,262500,98568
3619,2873,746,1020,266600,98569
1691,1296,395,888,258900,98570
77,0,77,-,-,98571
338,247,91,634,155500,98572
47,42,5,-,225000,98575
1848,1642,206,1255,305700,98576
2813,2385,428,933,194100,98577
5010,4164,846,1115,306400,98579
4267,3559,708,1796,357000,98580
246,246,0,-,144400,98581
78,78,0,-,294700,98582
42,23,19,-,-,98583
13675,10196,3479,1081,266700,98584
325,251,74,-,265200,98585
707,426,281,773,149500,98586
287,216,71,609,84800,98587
716,682,34,-,274000,98588
2922,2291,631,1097,298800,98589
242,216,26,-,428600,98590
1551,1349,202,665,302000,98591
690,654,36,-,270600,98592
475,410,65,930,235900,98593
1189,836,353,756,205700,98595
2525,2005,520,982,269200,98596
9342,7444,1898,1367,313200,98597
1070,863,207,2025,380300,98601
82,82,0,-,-,98602
532,395,137,673,276400,98603
12706,10154,2552,1315,418600,98604
503,324,179,1151,241800,98605
3399,3140,259,1392,511600,98606
11902,9290,2612,1586,488400,98607
0,0,0,-,-,98609
1154,897,257,995,278000,98610
3309,2674,635,1253,281900,98611
1346,1188,158,1125,247200,98612
200,169,31,1313,280200,98613
200,200,0,-,184000,98614
56,56,0,-,371800,98616
459,268,191,1049,273800,98617
257,200,57,870,255000,98619
3360,2209,1151,798,192500,98620
104,101,3,-,194500,98621
22,22,0,-,-,98623
580,413,167,938,265900,98624
2725,2003,722,973,328300,98625
10199,7007,3192,990,261100,98626
126,85,41,800,153800,98628
2929,2515,414,1854,440400,98629
1564,1172,392,740,272500,98631
20667,12053,8614,968,250800,98632
772,595,177,833,392100,98635
631,529,102,970,189500,98638
445,305,140,877,296400,98639
2359,2171,188,929,230600,98640
68,68,0,-,-,98641
8069,6586,1483,1812,480400,98642
147,137,10,-,227400,98643
385,339,46,607,214100,98644
812,767,45,657,355400,98645
142,134,8,-,-,98647
1282,970,312,879,374500,98648
281,238,43,716,273100,98649
485,436,49,957,572800,98650
460,389,71,735,544500,98651
5849,2600,3249,1078,347900,98660
20398,8889,11509,1256,333400,98661
13308,8316,4992,1582,334300,98662
6251,3745,2506,1321,327000,98663
9053,5711,3342,1393,339700,98664
10962,6520,4442,1361,352600,98665
25,25,0,-,262500,98670
8598,6917,1681,1322,410600,98671
2815,2205,610,1133,417200,98672
185,117,68,981,146600,98673
5195,3689,1506,1081,392200,98674
2106,1883,223,1092,418900,98675
22605,15809,6796,1539,340000,98682
13332,7524,5808,1501,392900,98683
12451,6909,5542,1650,349700,98684
11530,9506,2024,1609,427600,98685
7541,5644,1897,1576,424500,98686
16710,9671,7039,1042,323200,98801
11389,7929,3460,1158,336000,98802
45,16,29,-,-,98811
1672,877,795,843,190700,98812
807,454,353,759,139700,98813
338,245,93,950,406200,98814
2648,1924,724,858,385200,98815
2437,1521,916,1134,363600,98816
63,51,12,-,-,98817
100,65,35,716,201500,98819
377,192,185,-,280000,98821
682,537,145,1034,269000,98822
4529,3035,1494,855,180900,98823
46,34,12,-,166700,98824
3266,2373,893,1055,491500,98826
150,34,116,-,-,98827
760,652,108,1531,322100,98828
242,178,64,729,180600,98829
246,161,85,619,160300,98830
1355,855,500,696,369300,98831
62,50,12,-,156800,98832
73,49,24,-,456300,98833
110,107,3,-,313600,98834
258,159,99,-,463100,98836
16166,10085,6081,955,226000,98837
1890,1162,728,803,209900,98840
3416,2419,997,754,193500,98841
789,444,345,926,441300,98843
2110,1677,433,658,204100,98844
104,73,31,806,242600,98845
418,332,86,722,241000,98846
886,657,229,953,345000,98847
3557,2402,1155,870,231600,98848
525,310,215,963,218900,98849
594,419,175,1051,206300,98850
1743,1252,491,726,172500,98851
10,8,2,-,-,98852
59,59,0,-,-,98853
2347,1676,671,730,173200,98855
1057,671,386,777,345400,98856
1203,841,362,541,157800,98857
765,521,244,1052,202000,98858
37,37,0,-,113800,98859
127,107,20,775,147500,98860
1241,913,328,789,404700,98862
10890,5644,5246,833,191500,98901
16394,8450,7944,865,171500,98902
6046,4552,1494,1025,210900,98903
14662,10254,4408,1147,288900,98908
0,0,0,-,-,98921
3209,2509,700,999,443000,98922
410,121,289,785,217400,98923
267,228,39,2000,340800,98925
13441,7197,6244,1082,336400,98926
4484,2488,1996,863,184400,98930
1362,688,674,906,149200,98932
398,274,124,882,166700,98933
518,331,187,1016,224500,98934
1126,743,383,988,157500,98935
2160,1916,244,1421,236500,98936
1855,1274,581,954,256500,98937
761,525,236,983,153600,98938
31,31,0,-,154600,98939
228,185,43,-,441000,98940
332,202,130,1972,369600,98941
7017,4969,2048,1144,277900,98942
360,260,100,1134,301300,98943
6578,4129,2449,813,162900,98944
143,100,43,1063,382800,98946
905,553,352,867,146100,98947
3610,2182,1428,775,165800,98948
0,0,0,-,-,98950
3604,1938,1666,760,152200,98951
529,345,184,611,84200,98952
2184,1637,547,1122,287900,98953
2035,990,1045,1044,192000,99001
1691,1507,184,701,307300,99003
8272,4746,3526,958,281300,99004
3686,3241,445,1144,361200,99005
5100,4341,759,800,278100,99006
164,93,71,690,129300,99008
1668,1492,176,696,300300,99009
814,6,808,1455,-,99011
332,241,91,780,174700,99012
512,254,258,523,184600,99013
31,31,0,-,-,99014
7122,5653,1469,1240,345500,99016
94,88,6,-,91400,99017
117,91,26,-,254300,99018
4375,2881,1494,1366,375200,99019
0,0,0,-,-,99020
3533,3236,297,1104,297000,99021
3064,2512,552,687,267500,99022
277,277,0,-,462000,99023
2090,1960,130,1358,324100,99025
3166,3029,137,920,298500,99026
2399,2247,152,-,280900,99027
545,433,112,666,286200,99029
306,273,33,925,184500,99030
485,399,86,669,285000,99031
317,264,53,842,108800,99032
366,259,107,679,172600,99033
121,56,65,-,161500,99034
631,535,96,1232,454700,99036
5648,3762,1886,1116,305600,99037
65,49,16,545,115800,99039
335,255,80,393,112800,99040
611,534,77,775,267500,99101
267,152,115,929,155000,99102
200,155,45,1292,204200,99103
13,10,3,-,82500,99105
2073,1613,460,763,207100,99109
659,435,224,737,346100,99110
1594,1103,491,820,183600,99111
231,200,31,775,235100,99113
5009,3675,1334,800,223100,99114
510,392,118,700,144200,99115
721,523,198,858,158600,99116
200,166,34,675,200000,99117
349,257,92,819,286100,99118
696,607,89,664,248500,99119
88,67,21,-,416300,99121
1615,1323,292,802,228700,99122
449,381,68,841,223500,99123
117,93,24,767,178100,99124
247,165,82,913,144100,99125
271,253,18,-,153500,99126
128,107,21,700,267400,99128
294,178,116,403,126900,99129
309,237,72,800,168100,99130
80,45,35,-,231700,99131
720,451,269,624,158200,99133
253,186,67,853,154200,99134
167,146,21,675,167800,99135
11,11,0,-,156300,99136
194,122,72,563,207400,99137
406,243,163,459,153800,99138
351,273,78,863,166000,99139
220,164,56,450,150000,99140
2512,1796,716,864,192300,99141
346,303,43,625,115300,99143
9,9,0,-,-,99144
27,27,0,-,-,99146
84,84,0,-,393800,99147
1012,952,60,870,302900,99148
72,64,8,-,60000,99149
111,111,0,-,246000,99150
76,64,12,1042,128800,99151
70,60,10,-,166700,99152
253,143,110,663,169400,99153
12,12,0,-,155000,99154
415,246,169,522,117600,99155
3739,2862,877,767,273000,99156
325,232,93,689,172000,99157
225,169,56,800,154400,99158
587,450,137,882,127300,99159
48,42,6,-,184100,99160
606,524,82,634,228600,99161
12449,3833,8616,897,311100,99163
1225,859,366,740,191100,99166
333,311,22,-,237000,99167
1108,801,307,742,137400,99169
393,312,81,590,155600,99170
402,286,116,822,167000,99171
582,475,107,648,165200,99173
17,10,7,-,95000,99174
96,79,17,850,225000,99176
184,119,65,-,286500,99179
314,241,73,800,269000,99180
927,784,143,741,208800,99181
534,409,125,688,195200,99185
7643,2089,5554,734,169000,99201
7623,3479,4144,924,182900,99202
9138,7026,2112,1173,343800,99203
3928,1239,2689,873,285100,99204
17730,12052,5678,1106,199300,99205
16578,10278,6300,957,282400,99206
12814,6749,6065,939,163200,99207
22536,14593,7943,991,303300,99208
8507,5839,2668,1060,219100,99212
11536,5255,6281,1108,246200,99216
7519,5030,2489,1084,230300,99217
5889,2981,2908,1026,310700,99218
14353,9401,4952,1003,336800,99223
9760,6519,3241,1095,313600,99224
0,0,0,-,-,99251
0,0,0,-,-,99258
25147,17618,7529,995,259200,99301
3445,2918,527,980,233300,99320
118,42,76,-,-,99321
214,196,18,632,-,99322
1339,1147,192,936,246800,99323
3591,2251,1340,929,255900,99324
1300,859,441,871,164400,99326
1673,1234,439,831,211500,99328
68,50,18,1056,260000,99329
275,235,40,-,226000,99330
32,25,7,-,-,99333
56,46,10,738,107100,99335
19474,9856,9618,996,226200,99336
11034,9618,1416,1209,276700,99337
5857,5002,855,1168,379700,99338
238,177,61,816,117700,99341
690,454,236,744,-,99343
5338,3175,2163,829,195500,99344
67,39,28,-,331500,99345
132,111,21,-,171000,99346
1039,789,250,626,165600,99347
520,168,352,806,156300,99348
2148,1167,981,1031,289000,99349
4834,3007,1827,850,231300,99350
13688,9390,4298,1244,345000,99352
5615,4672,943,1358,330300,99353
9836,5911,3925,1137,270200,99354
80,39,41,688,178100,99356
1033,532,501,654,174000,99357
87,54,33,563,134100,99359
491,343,148,1091,315200,99360
723,500,223,731,241000,99361
16124,10388,5736,1065,287600,99362
32,25,7,-,137500,99363
125,79,46,738,85800,99371
155,155,0,-,268100,99401
601,486,115,788,266900,99402
8555,6044,2511,862,224800,99403
7348,2742,4606,1056,341700,99501
9077,6712,2365,1475,352600,99502
5854,1892,3962,1000,241400,99503
15580,10542,5038,1446,262300,99504
1006,0,1006,2242,-,99505
2019,0,2019,1934,-,99506
13213,9208,4005,1484,321400,99507
12970,6425,6545,1230,262800,99508
0,0,0,-,-,99513
7494,5858,1636,1646,342800,99515
7327,6565,762,1238,471600,99516
6610,3971,2639,1271,321400,99517
4172,2491,1681,1456,261600,99518
0,0,0,-,-,99519
0,0,0,-,-,99530
195,136,59,-,523300,99540
68,14,54,-,27500,99546
8,8,0,-,95000,99547
17,12,5,-,175000,99548
24,19,5,-,49000,99549
70,68,2,-,175000,99550
104,74,30,445,27900,99551
51,41,10,-,-,99552
57,35,22,711,91700,99553
238,165,73,778,122900,99554
41,31,10,1094,168800,99555
1189,1026,163,1081,188900,99556
211,135,76,1271,211700,99557
32,23,9,-,34500,99558
2268,976,1292,1544,276400,99559
67,57,10,-,-,99561
134,112,22,-,80500,99563
18,13,5,-,-,99564
11,3,8,-,-,99565
36,18,18,763,-,99566
2783,2424,359,-,363500,99567
182,177,5,-,255500,99568
18,12,6,-,85000,99569
90,36,54,1135,137500,99571
85,78,7,-,367200,99572
299,255,44,788,226000,99573
840,535,305,1334,335200,99574
20,12,8,-,116700,99575
799,465,334,1230,251700,99576
10122,7556,2566,1773,357900,99577
137,107,30,615,59300,99578
8,8,0,-,108300,99579
18,17,1,-,-,99580
272,193,79,940,106500,99581
28,11,17,-,-,99583
46,33,13,-,24600,99585
163,96,67,450,287900,99586
925,573,352,1214,490400,99587
390,299,91,994,227800,99588
24,12,12,-,165000,99589
70,55,15,575,83900,99590
26,24,2,-,72000,99591
94,77,17,683,42100,99602
4346,3247,1099,1140,297600,99603
174,137,37,-,57000,99604
61,61,0,-,233600,99605
89,64,25,713,112500,99606
52,35,17,933,110400,99607
8,8,0,-,112500,99608
75,58,17,638,-,99609
793,647,146,1090,208500,99610
5405,3974,1431,1088,247600,99611
342,206,136,845,109600,99612
160,85,75,1167,239600,99613
114,79,35,308,48300,99614
4190,2201,1989,1492,324900,99615
236,186,50,825,57300,99620
84,60,24,-,51000,99621
97,73,24,519,152900,99622
7213,5850,1363,1285,243800,99623
17,13,4,-,92500,99624
23,10,13,-,-,99625
59,45,14,-,157800,99626
89,66,23,950,78300,99627
159,117,42,550,75400,99628
108,86,22,519,103600,99630
111,63,48,-,271600,99631
195,140,55,671,22400,99632
141,77,64,1167,256900,99633
181,86,95,-,25800,99634
0,0,0,-,-,99635
117,78,39,733,82500,99636
177,127,50,615,79300,99637
5,3,2,-,-,99638
504,446,58,688,212100,99639
34,14,20,1000,212500,99640
147,114,33,-,74500,99641
80,54,26,797,160400,99643
51,33,18,-,168800,99644
10623,8304,2319,1185,280200,99645
9,9,0,-,154200,99647
23,16,7,700,116700,99648
24,17,7,850,91700,99649
104,77,27,-,33800,99650
3,3,0,-,-,99651
1551,1139,412,972,228800,99652
23,10,13,875,625000,99653
15472,11234,4238,1167,281200,99654
210,180,30,575,22500,99655
4,4,0,-,-,99656
19,8,11,-,-,99657
258,180,78,800,91300,99658
55,38,17,-,-,99659
86,54,32,1025,-,99660
397,277,120,1240,180900,99661
109,70,39,-,52700,99662
199,158,41,588,190400,99663
1611,1069,542,968,240100,99664
11,1,10,458,-,99665
30,26,4,-,-,99666
58,58,0,-,216700,99667
25,23,2,-,145800,99668
6669,5077,1592,1097,249600,99669
30,18,12,1083,118800,99670
151,114,37,510,88000,99671
1475,1297,178,1043,241800,99672
593,499,94,789,210200,99674
11,2,9,788,-,99675
664,489,175,786,213400,99676
13,9,4,-,86300,99677
220,154,66,821,76900,99678
61,28,33,863,-,99679
159,114,45,538,71100,99680
52,33,19,920,10700,99681
138,99,39,538,45800,99682
184,172,12,-,137500,99683
169,102,67,1073,109700,99684
674,201,473,1711,412100,99685
1615,1175,440,1250,202400,99686
1100,940,160,1211,199700,99688
216,105,111,1217,168100,99689
29,29,0,-,72500,99690
63,46,17,-,59000,99691
137,0,137,1536,-,99692
124,43,81,913,70800,99693
598,490,108,888,187700,99694
0,0,0,-,-,99695
7199,3161,4038,1183,204900,99701
965,7,958,1907,-,99702
2093,0,2093,2076,-,99703
0,0,0,-,-,99704
7775,5787,1988,1403,236400,99705
10,6,4,-,325000,99706
0,0,0,-,-,99707
11538,7161,4377,1099,261400,99709
4829,4032,797,1256,277400,99712
437,370,67,1620,243400,99714
65,46,19,700,72500,99720
73,46,27,892,100000,99721
69,52,17,-,85000,99722
1425,595,830,1043,196900,99723
43,35,8,-,29800,99724
314,249,65,-,209800,99725
15,8,7,-,65000,99726
124,100,24,1125,74500,99727
78,70,8,-,183300,99729
49,46,3,-,56100,99730
8,1,7,-,-,99732
17,9,8,-,225000,99733
0,0,0,-,-,99734
35,27,8,1000,104200,99736
1347,955,392,1278,215100,99737
67,50,17,600,85000,99738
63,45,18,775,86300,99739
235,178,57,961,103300,99740
196,136,60,1177,122900,99741
114,95,19,810,-,99742
334,296,38,1000,250000,99743
50,42,8,1200,156300,99744
25,12,13,-,-,99745
68,56,12,875,48000,99746
61,52,9,-,102100,99747
69,47,22,625,-,99748
78,67,11,933,111500,99749
157,124,33,836,107900,99750
35,17,18,1031,115600,99751
874,362,512,1463,246400,99752
91,47,44,613,77200,99753
35,32,3,-,80000,99754
44,19,25,-,456300,99755
19,14,5,-,50000,99756
13,13,0,-,-,99757
50,23,27,792,-,99758
45,20,25,1375,107100,99759
245,190,55,1076,97800,99760
94,77,17,644,119300,99761
1322,685,637,1489,270900,99762
97,55,42,606,117500,99763
73,50,23,-,68000,99764
89,80,9,433,-,99765
203,135,68,1089,121900,99766
20,20,0,-,70000,99767
66,55,11,463,75000,99768
181,166,15,850,107100,99769
142,103,39,513,69200,99770
70,60,10,1042,76300,99771
148,95,53,840,103800,99772
43,36,7,-,96700,99773
4,0,4,-,-,99774
152,0,152,1316,-,99775
23,14,9,-,-,99776
70,30,40,738,57500,99777
75,44,31,927,109100,99778
657,497,160,579,176900,99780
35,26,9,-,-,99781
138,94,44,813,92300,99782
75,59,16,-,75000,99783
63,44,19,838,84300,99784
137,103,34,631,73600,99785
77,69,8,-,75700,99786
36,30,6,-,31700,99788
125,63,62,893,103100,99789
17,17,0,-,252800,99790
33,24,9,-,106300,99791
11880,7885,3995,1329,358800,99801
157,89,68,-,144600,99820
1042,481,561,1272,344800,99824
13,13,0,-,337500,99825
195,165,30,1344,257800,99826
802,549,253,800,252200,99827
275,199,76,1137,220500,99829
146,99,47,817,169300,99830
37,31,6,-,119200,99832
1211,832,379,974,246900,99833
3439,2181,1258,1232,367800,99835
19,17,2,-,-,99836
390,242,148,1071,406500,99840
105,96,9,-,245000,99841
0,0,0,-,-,99850
5487,3588,1899,1235,315200,99901
1,1,0,-,-,99903
113,102,11,-,200000,99918
263,200,63,870,162500,99919
822,576,246,880,244000,99921
121,83,38,667,113600,99922
13,13,0,-,-,99923
345,253,92,794,238000,99925
457,368,89,600,155600,99926
11,11,0,-,-,99927
841,541,300,938,231100,99929
