housing_units_occ,homeowner_units_occ,renters_units_occ,med_rent,med_household_price,zip
5341,3740,1601,401,90900,601
12777,9630,3147,459,98300,602
19624,11258,8366,448,129200,603
1948,1463,485,394,104700,606
8781,6392,2389,524,104600,610
523,276,247,432,129700,611
23286,14505,8781,474,107800,612
3150,2123,1027,580,101100,616
8234,6065,2169,581,118800,617
2996,2145,851,565,107900,622
14572,10916,3656,540,117200,623
7344,5134,2210,492,87900,624
11585,8773,2812,578,103500,627
480,278,202,326,98300,631
262,114,148,336,67100,636
7265,5680,1585,454,103100,637
5814,4262,1552,371,93100,638
8854,5308,3546,458,99700,641
12006,9563,2443,664,150100,646
1844,1353,491,336,90100,647
5245,3619,1626,633,100800,650
1412,1022,390,678,118600,652
3627,2466,1161,329,80400,653
6429,4699,1730,413,83600,656
13061,9566,3495,541,121200,659
6084,4294,1790,531,112800,660
14067,8516,5551,512,122500,662
5056,2961,2095,444,102900,664
8259,5691,2568,520,98800,667
9997,6628,3369,483,97300,669
2702,1988,714,299,93200,670
14691,10775,3916,534,116300,674
12956,8193,4763,478,100700,676
5741,4117,1624,572,137200,677
9059,5916,3143,488,103700,678
17577,9774,7803,462,97700,680
12077,5992,6085,418,116900,682
10904,7409,3495,466,97200,683
14312,10006,4306,440,103200,685
9810,6970,2840,561,114100,687
3950,2504,1446,547,96100,688
2063,1370,693,782,138000,690
11968,8145,3823,631,128800,692
20435,15366,5069,572,116200,693
52,52,0,-,-,694
12264,9204,3060,495,98300,698
8993,5917,3076,432,129700,703
2443,1900,543,608,91600,704
8909,6883,2026,519,119000,705
3904,2782,1122,500,101300,707
6246,4821,1425,498,95200,714
780,623,157,609,79400,715
11547,7500,4047,481,121200,716
6678,3324,3354,417,110300,717
8138,5905,2233,511,97700,718
8692,5837,2855,502,100300,719
6514,4385,2129,469,95300,720
6222,4255,1967,486,93700,723
30818,19841,10977,546,134300,725
20011,14246,5765,800,144100,727
13069,10216,2853,489,105900,728
16661,12288,4373,585,115400,729
12950,8727,4223,502,100900,730
3924,3050,874,501,88800,731
4234,3114,1120,497,104600,735
17707,11273,6434,572,134500,736
11898,8312,3586,616,114200,738
12418,8254,4164,539,132900,739
718,374,344,489,96800,740
1338,1107,231,649,92800,741
16232,11809,4423,589,131500,745
7550,5803,1747,463,87900,751
13364,9601,3763,565,112300,754
7182,5730,1452,502,104400,757
2608,1790,818,441,114500,765
7808,6008,1800,487,101600,766
11808,8400,3408,498,94600,767
12770,9775,2995,493,99700,769
12150,9323,2827,478,118500,771
6408,4066,2342,436,98600,772
6800,4744,2056,485,125300,773
447,275,172,458,168500,775
13415,9784,3631,573,112500,777
14840,11430,3410,630,160400,778
4779,4215,564,848,112500,780
5239,2910,2329,474,109900,782
10736,8106,2630,564,111600,783
14239,10029,4210,411,98400,784
86,86,0,-,44400,786
16741,12499,4242,500,115700,791
8964,6072,2892,467,118100,794
14607,10949,3658,537,99600,795
3302,1479,1823,626,378800,901
78,78,0,-,427300,906
8521,5274,3247,933,287700,907
2500,1023,1477,642,171600,909
3724,1798,1926,705,369300,911
2800,1475,1325,639,138800,912
3090,573,2517,238,378400,913
10638,4319,6319,469,93800,915
8211,4172,4039,543,123900,917
7980,3911,4069,530,196700,918
7117,3815,3302,743,152100,920
13998,6582,7416,597,145800,921
10487,4716,5771,494,116200,923
19698,10157,9541,481,138400,924
2763,543,2220,567,150800,925
36983,26973,10010,683,181500,926
6265,3338,2927,569,216600,927
28,0,28,-,-,934
25533,18916,6617,704,137400,949
0,0,0,-,-,950
123,39,84,-,79000,951
3138,1987,1151,508,105900,952
22376,18220,4156,729,144800,953
24889,17522,7367,634,129800,956
15345,11214,4131,654,136000,957
18030,11753,6277,638,147500,959
0,0,0,-,-,960
11572,7936,3636,696,159700,961
7634,4267,3367,553,110600,962
2044,1257,787,524,96400,965
6507,4730,1777,1041,264900,966
1834,1414,420,977,207200,968
15537,11302,4235,924,239000,969
9593,6578,3015,646,142700,971
23447,16715,6732,607,152600,976
8770,5793,2977,976,187000,979
5727,3646,2081,659,137500,982
12773,8309,4464,620,152000,983
12400,8625,3775,559,142900,985
20134,14935,5199,752,146600,987
6611,4813,1798,1278,257700,1001
8782,4257,4525,1476,435200,1002
19,0,19,-,-,1003
1681,1583,98,1394,294900,1005
6446,5445,1001,1211,336400,1007
531,502,29,932,279400,1008
307,183,124,1289,224200,1009
1480,1283,197,927,355400,1010
512,413,99,993,263000,1011
198,151,47,1022,301700,1012
9350,4805,4545,990,231500,1013
13311,8426,4885,1095,236600,1020
1077,771,306,1671,145300,1022
479,389,90,1054,273200,1026
8606,5428,3178,1169,334800,1027
5975,5063,912,1180,320500,1028
241,222,19,-,389500,1029
4966,3801,1165,1124,288100,1030
676,351,325,1121,232300,1031
232,206,26,-,275600,1032
2686,2409,277,853,298900,1033
843,797,46,1886,322100,1034
2323,1728,595,1625,420100,1035
1971,1876,95,-,331400,1036
257,231,26,-,411400,1037
1058,782,276,1352,434800,1038
720,636,84,1517,377300,1039
15112,6272,8840,937,236800,1040
1102,906,196,1173,264300,1050
742,580,162,1221,318600,1053
738,652,86,1400,410200,1054
8502,6293,2209,1192,285000,1056
3473,2902,571,942,296300,1057
7391,3380,4011,1435,420200,1060
4178,3217,961,1083,374100,1062
6,0,6,-,-,1063
69,69,0,-,409200,1066
613,571,42,1361,365200,1068
3848,2868,980,890,231100,1069
261,236,25,972,248300,1070
530,468,62,933,267400,1071
614,547,67,1539,312800,1072
2496,2294,202,1139,373300,1073
180,61,119,1085,256300,1074
7316,5614,1702,1171,311600,1075
3691,3183,508,1243,339000,1077
262,163,99,1117,264900,1079
989,629,360,1237,228300,1080
692,634,58,1429,258100,1081
4843,3439,1404,1014,250000,1082
903,531,372,1048,346900,1083
50,42,8,-,282100,1084
15767,10584,5183,1050,283500,1085
390,227,163,1163,377100,1088
12691,7207,5484,1038,294400,1089
618,364,254,937,283600,1092
69,69,0,-,387900,1093
13,13,0,-,-,1094
5382,4851,531,885,360800,1095
1107,943,164,1357,339400,1096
17,5,12,-,-,1097
467,446,21,533,309500,1098
1496,117,1379,1016,188800,1103
9103,4224,4879,971,187500,1104
5018,566,4452,881,207100,1105
5976,5407,569,1996,409500,1106
4290,1195,3095,858,187000,1107
10505,4760,5745,1128,200700,1108
9623,4127,5496,1075,180100,1109
5724,4448,1276,1241,224200,1118
5173,3801,1372,1092,204400,1119
1102,1036,66,-,233000,1128
2661,2044,617,1288,211900,1129
0,0,0,-,-,1144
3615,1602,2013,1233,181300,1151
19874,12377,7497,1029,221800,1201
4041,2470,1571,896,182700,1220
238,238,0,-,303000,1222
1181,1110,71,1438,317700,1223
56,45,11,-,278400,1224
1547,1371,176,1277,234200,1225
2884,2211,673,887,285800,1226
83,61,22,-,947900,1229
3776,2857,919,1106,448200,1230
1059,850,209,948,225500,1235
619,514,105,-,381300,1236
1042,1004,38,1232,264700,1237
2572,2057,515,1185,313100,1238
2239,1509,730,1101,418600,1240
70,70,0,-,-,1242
72,72,0,-,404500,1243
74,65,9,-,660200,1244
335,330,5,-,520700,1245
6783,4097,2686,849,171400,1247
377,309,68,-,315300,1253
440,424,16,944,516100,1254
355,343,12,1208,288200,1255
305,288,17,-,237500,1256
1011,720,291,1144,461500,1257
81,77,4,-,506000,1258
266,235,31,-,407100,1259
9,9,0,-,-,1260
715,502,213,943,549200,1262
98,74,24,1229,545500,1264
456,385,71,1727,414700,1266
2735,2068,667,1223,405000,1267
398,395,3,-,328200,1270
8225,4573,3652,1013,242100,1301
759,624,135,938,344100,1330
5412,4025,1387,1010,227300,1331
1044,882,162,999,291900,1337
48,44,4,-,-,1338
634,538,96,1125,285800,1339
835,684,151,1083,261400,1340
714,632,82,1433,358100,1341
393,227,166,1819,307600,1342
72,47,25,-,219400,1343
677,528,149,945,233300,1344
203,193,10,-,246500,1346
101,43,58,-,165400,1347
343,274,69,1095,288100,1349
53,46,7,-,150000,1350
1034,835,199,1194,284400,1351
627,509,118,-,302600,1354
412,357,55,1007,329300,1355
1225,1088,137,972,314000,1360
3044,2165,879,686,207900,1364
461,416,45,1223,346000,1366
198,170,28,1000,254100,1367
538,477,61,1066,308800,1368
1741,1194,547,1011,329000,1370
2309,1885,424,1312,391900,1373
1765,748,1017,1551,383900,1375
2289,1173,1116,1065,230100,1376
348,323,25,1188,297600,1378
366,313,53,1682,257200,1379
9,9,0,-,-,1380
16700,9325,7375,1115,261500,1420
2319,2161,158,1779,335100,1430
1241,1185,56,987,328700,1431
3630,2506,1124,1333,397500,1432
278,233,45,-,397800,1434
1275,1030,245,748,291500,1436
133,111,22,-,219700,1438
8939,5175,3764,1041,243700,1440
3700,3255,445,1171,628500,1450
1766,1659,107,1322,730300,1451
1553,1431,122,-,327900,1452
18404,12039,6365,1171,324400,1453
3557,3074,483,1339,591400,1460
4604,3725,879,1602,394100,1462
4339,3600,739,1150,441500,1463
2470,1940,530,989,384200,1464
1658,1455,203,1341,346500,1468
2797,2313,484,1195,363600,1469
3248,2788,460,1597,370200,1473
707,630,77,2589,385100,1474
3588,2699,889,992,274000,1475
6672,5603,1069,1169,340600,1501
1432,1167,265,1668,570300,1503
3874,2925,949,1158,355100,1504
1864,1493,371,1705,498000,1505
1445,1265,180,925,274000,1506
4833,3948,885,1192,398800,1507
6732,3743,2989,1289,329300,1510
871,688,183,982,342800,1515
3160,2680,480,1505,405100,1516
1316,915,401,1261,400700,1518
2637,2006,631,2006,505100,1519
5978,5137,841,1603,413700,1520
1175,1059,116,1212,278000,1521
1140,961,179,964,390800,1522
2981,2458,523,1816,398200,1523
2187,1852,335,952,350500,1524
31,0,31,-,-,1525
5209,3860,1349,1426,375800,1527
1275,1096,179,1180,381900,1529
402,339,63,844,372000,1531
5812,4925,887,1920,548400,1532
2338,1875,463,1125,423500,1534
1871,1303,568,928,289500,1535
3028,2292,736,1158,428200,1536
808,593,215,1133,342000,1537
4071,3382,689,1068,330800,1540
1316,1259,57,906,467900,1541
1104,986,118,1418,347300,1542
3058,2598,460,1054,402300,1543
14424,10602,3822,1841,512000,1545
7030,3081,3949,1142,254700,1550
1908,1208,700,1218,427000,1560
0,0,0,-,-,1561
5084,3302,1782,1077,333400,1562
3461,3075,386,1223,423300,1564
2641,2382,259,1615,365800,1566
2659,2387,272,1138,537800,1568
5336,4323,1013,1374,402300,1569
7311,4313,2998,1034,324800,1570
4277,3020,1257,1127,344900,1571
7962,4850,3112,1937,601900,1581
2827,2239,588,1196,383400,1583
2028,1625,403,1105,286900,1585
4122,2605,1517,1134,360300,1588
3272,2848,424,1416,472700,1590
10105,6163,3942,1487,347600,1602
7885,3947,3938,1243,269000,1603
16811,7087,9724,1413,295100,1604
11683,3508,8175,1201,291000,1605
9018,5938,3080,1432,304200,1606
3677,1492,2185,1322,307500,1607
2253,156,2097,1450,156300,1608
8536,3469,5067,1239,386400,1609
9082,1547,7535,1253,252900,1610
766,621,145,894,299800,1611
1611,1426,185,1159,434700,1612
13157,10230,2927,1858,568100,1701
14683,5102,9581,1632,515300,1702
241,193,48,-,350500,1718
2166,1603,563,1726,653300,1719
8743,6436,2307,1778,704100,1720
7653,5871,1782,2273,532000,1721
5670,3940,1730,2304,829000,1730
460,0,460,3203,-,1731
1882,1781,101,1545,679600,1740
1787,1679,108,1296,940300,1741
6476,4900,1576,2538,1021400,1742
213,155,58,-,633600,1745
5562,4889,673,1615,588000,1746
2171,1713,458,1438,405400,1747
6674,5816,858,2283,704600,1748
8055,5848,2207,1477,458000,1749
16524,9476,7048,1648,439600,1752
4416,3439,977,1516,459700,1754
2054,1885,169,1723,558000,1756
11528,8147,3381,1588,403300,1757
15466,10504,4962,1976,709100,1760
1511,1394,117,2234,898900,1770
3386,3061,325,2139,743100,1772
2125,1671,454,1929,1171300,1773
2613,2208,405,1728,633900,1775
6323,5821,502,2013,892700,1776
5021,4601,420,1469,865600,1778
16121,9483,6638,2131,612500,1801
9990,7390,2600,2325,659400,1803
13361,10880,2481,2037,756600,1810
11489,9223,2266,2104,532600,1821
9910,8143,1767,2010,547800,1824
12209,9820,2389,1624,424200,1826
1135,1089,46,1575,592100,1827
10472,5818,4654,1422,400300,1830
10060,5783,4277,1501,390400,1832
3142,2576,566,2044,566600,1833
2613,2392,221,1576,483700,1834
5444,3982,1462,1441,415400,1835
3107,68,3039,1067,-,1840
16881,5191,11690,1498,372500,1841
10342,3804,6538,1650,368600,1843
19032,14081,4951,1514,439600,1844
11311,7868,3443,2061,621100,1845
5872,3039,2833,1494,345000,1850
11353,4833,6520,1566,398900,1851
14694,6725,7969,1432,366200,1852
10424,3755,6669,1350,331300,1854
2644,2103,541,1179,462900,1860
4117,3014,1103,1691,476400,1862
3611,3042,569,1412,427300,1863
5851,4887,964,2255,664900,1864
9492,7953,1539,1650,713200,1867
11944,9948,1996,2250,507000,1876
4045,3457,588,1822,487800,1879
10874,7774,3100,1742,646400,1880
8606,7598,1008,2477,672200,1886
7925,6800,1125,2293,614500,1887
8066,6717,1349,2192,1149600,1890
1076,75,1001,-,286000,1901
18797,7286,11511,1523,419800,1902
7077,5761,1316,1489,473700,1904
8965,4317,4648,1584,429100,1905
10768,8009,2759,1717,543300,1906
6315,4591,1724,2117,645700,1907
1626,1345,281,1747,647800,1908
7588,5117,2471,1464,435400,1913
16570,9840,6730,1625,564200,1915
2879,2720,159,730,810300,1921
1209,1054,155,-,695800,1922
11147,7814,3333,1862,589600,1923
1370,1110,260,1556,733400,1929
13259,8146,5113,1390,535100,1930
0,0,0,-,-,1937
5610,4052,1558,1435,649100,1938
4752,4072,680,1891,851600,1940
2101,1621,480,1760,970200,1944
8195,6680,1515,1749,857700,1945
3192,2977,215,1493,687900,1949
7591,5846,1745,1426,737200,1950
1292,1135,157,2064,792700,1951
4050,3127,923,1556,436700,1952
22568,14741,7827,1795,508600,1960
339,319,20,-,652000,1965
3282,2257,1025,1725,651200,1966
2376,1913,463,1211,610500,1969
19827,10054,9773,1676,464600,1970
2652,2238,414,1469,650500,1982
2217,1912,305,1107,732700,1983
1325,1156,169,-,805600,1984
1624,1529,95,2143,726300,1985
6270,4969,1301,1635,395800,2019
9649,7307,2342,2124,636800,2021
3107,2473,634,1430,1071800,2025
10427,7346,3081,2006,601700,2026
1887,1777,110,2536,1152400,2030
1536,1250,286,1863,680700,2032
7212,5192,2020,1705,546600,2035
12131,9604,2527,1792,516500,2038
9230,7560,1670,2046,978800,2043
4504,3666,838,1728,563700,2045
101,101,0,-,790600,2047
8880,6476,2404,1605,540100,2048
10304,8272,2032,1389,584500,2050
4463,3861,602,1264,836400,2052
4539,3942,597,1531,546700,2053
3172,2627,545,1781,504100,2054
3291,3138,153,1732,649800,2056
3607,3266,341,1905,736500,2061
13114,6745,6369,1948,588100,2062
7536,6544,992,1483,724900,2066
6386,5685,701,1991,665000,2067
476,452,24,-,484600,2071
10858,8270,2588,1882,448900,2072
7345,5922,1423,1708,623200,2081
5377,4640,737,2119,935200,2090
4436,3786,650,1015,568900,2093
2002,977,1025,2545,1673800,2108
1993,724,1269,3154,1010200,2109
1312,784,528,2939,1162200,2110
3746,1056,2690,1873,951800,2111
4042,580,3462,2316,683300,2113
7719,1661,6058,2698,938600,2114
9845,1316,8529,1992,1000000,2115
11915,4169,7746,2255,1461100,2116
14133,3991,10142,1485,1002700,2118
11823,2825,8998,1182,603900,2119
4584,469,4115,1407,923300,2120
10513,2418,8095,1282,517800,2121
9449,4305,5144,1900,630300,2122
19166,8026,11140,1629,570900,2124
13284,4664,8620,1762,631900,2125
8539,3673,4866,1566,475200,2126
17406,7739,9667,2255,818200,2127
17308,4664,12644,1942,653600,2128
9187,4432,4755,1900,913500,2129
17922,8134,9788,2216,729600,2130
12371,6767,5604,1821,601100,2131
10967,7656,3311,1947,692800,2132
0,0,0,-,-,2133
8058,1138,6920,2211,602300,2134
20713,4580,16133,2154,674500,2135
13591,7264,6327,1588,543300,2136
14480,5631,8849,2641,1053700,2138
15995,5118,10877,2501,1027300,2139
9949,3555,6394,2566,994800,2140
7069,2077,4992,2591,883500,2141
2140,245,1895,"3,500+",1566200,2142
12074,3779,8295,2309,859000,2143
11203,4052,7151,2521,948800,2144
11608,3931,7677,2283,784800,2145
25809,11002,14807,1962,570600,2148
17054,6107,10947,1892,557700,2149
13371,3738,9633,1808,450600,2150
21555,10981,10574,1788,518600,2151
8328,4735,3593,1841,563100,2152
25368,13520,11848,2311,669600,2155
453,0,453,2952,-,2163
28034,11196,16838,1903,513300,2169
8101,4133,3968,1738,625700,2170
8778,4413,4365,2127,599500,2171
12037,7924,4113,1837,732300,2176
9654,6547,3107,1843,609300,2180
14407,11045,3362,1678,596800,2184
9182,7703,1479,1512,838100,2186
6722,4239,2483,1740,481300,2188
6433,4232,2201,1596,429600,2189
8079,5583,2496,1776,507100,2190
3462,2813,649,1742,457400,2191
842,32,810,3413,-,2199
0,0,0,-,-,2203
0,0,0,-,-,2205
3730,876,2854,"3,500+",1136700,2210
8329,716,7613,2308,698200,2215
23345,11603,11742,1465,376800,2301
12144,8415,3729,1391,350900,2302
1770,1428,342,1603,412000,2322
9162,6809,2353,1820,464900,2324
32,0,32,-,-,2325
4695,4193,502,1897,370400,2330
6063,5351,712,1597,787300,2332
5085,4128,957,1354,453700,2333
2966,2824,142,1273,416500,2338
4843,4276,567,1424,646400,2339
4030,3592,438,1784,473500,2341
4587,3632,955,1380,402500,2343
9648,7493,2155,1498,401700,2346
4123,3482,641,1715,503200,2347
49,49,0,-,308300,2350
6237,4897,1340,1419,476600,2351
4572,3382,1190,1716,578500,2356
0,0,0,-,-,2357
6718,5855,863,1724,533500,2359
25217,20092,5125,1815,461500,2360
5483,4733,750,969,505600,2364
0,0,0,-,-,2366
1052,998,54,-,465100,2367
12473,8616,3857,1883,429500,2368
6821,5339,1482,1360,422500,2370
4499,3603,896,2071,439800,2375
2802,2336,466,1940,453900,2379
5701,3968,1733,1606,433800,2382
5589,4912,677,2520,1083500,2420
6796,5327,1469,2968,1086500,2421
9374,5111,4263,2687,1148400,2445
14365,5184,9181,2648,1140600,2446
7928,4721,3207,2497,677700,2451
5507,2865,2642,2229,726100,2452
12636,4910,7726,1991,654700,2453
15,15,0,-,-,2457
4941,3021,1920,2084,971700,2458
6541,5422,1119,2338,1330900,2459
3946,2364,1582,2262,1051100,2460
2676,2055,621,2930,1079000,2461
525,362,163,1533,1217200,2462
1324,841,483,2543,824300,2464
4518,3125,1393,2211,1031400,2465
3023,1639,1384,2014,1094500,2466
6546,4357,2189,2846,1183400,2467
1962,1893,69,-,1659100,2468
15999,8174,7825,2179,722000,2472
11823,6975,4848,2015,833000,2474
7628,4837,2791,1730,847200,2476
10414,6623,3791,2336,1060600,2478
4834,4295,539,2743,1551800,2481
4107,3251,856,2509,1230900,2482
7202,6588,614,2390,1122000,2492
3741,3251,490,2072,1434000,2493
4110,3119,991,2006,989100,2494
5918,4620,1298,1454,438100,2532
465,423,42,-,1009700,2534
783,687,96,1613,1568600,2535
8780,7881,899,1538,457400,2536
2385,2180,205,1231,528700,2537
1638,1132,506,1568,327700,2538
1505,1128,377,1893,1056000,2539
4086,2823,1263,1185,708000,2540
221,0,221,1897,-,2542
448,383,65,1297,865500,2543
76,76,0,-,-,2553
4576,3230,1346,2052,1261600,2554
929,879,50,-,663100,2556
867,630,237,-,760000,2557
994,739,255,1603,368400,2558
1544,1249,295,-,523700,2559
241,189,52,-,445100,2561
1319,1087,232,1663,518900,2562
4079,3582,497,1690,482800,2563
59,59,0,-,1218800,2564
2807,2019,788,1367,880700,2568
4788,3570,1218,1332,407300,2571
913,809,104,2000,1079400,2575
1857,1595,262,1240,316000,2576
24,24,0,-,-,2584
6784,3446,3338,1594,371100,2601
690,633,57,2344,623000,2630
4491,3728,763,1358,590200,2631
4673,3777,896,2213,478300,2632
2332,2042,290,1257,824600,2633
1416,1326,90,1705,572300,2635
165,165,0,-,728900,2637
1429,1175,254,1514,661100,2638
1671,1198,473,1150,409100,2639
154,154,0,-,967600,2641
2724,2539,185,1662,630500,2642
0,0,0,-,-,2643
1513,1333,180,1665,447300,2644
4718,3933,785,1620,557200,2645
1059,905,154,1838,649800,2646
66,46,20,-,570300,2647
3016,2836,180,1897,550700,2648
6768,5560,1208,1676,468600,2649
450,412,38,-,846400,2650
693,563,130,-,749500,2652
3004,2361,643,1152,695800,2653
1544,1413,131,1747,705300,2655
1996,1525,471,1106,772200,2657
507,449,58,1207,650100,2659
2935,2287,648,1484,470000,2660
206,206,0,-,762500,2663
4181,3114,1067,1671,449300,2664
338,299,39,-,578500,2666
1769,1490,279,1289,678200,2667
970,922,48,1211,584600,2668
780,627,153,1521,581800,2670
405,393,12,-,547700,2671
28,28,0,-,-,2672
3870,3054,816,1545,400000,2673
3208,3000,208,1718,491100,2675
1635,1515,120,1603,449400,2702
17993,11852,6141,1359,379200,2703
18,12,6,-,750000,2713
1367,1246,121,1367,467300,2715
1608,1435,173,2081,469000,2717
2502,2176,326,1694,402900,2718
6985,5184,1801,1024,365600,2719
13830,5394,8436,1086,335800,2720
11157,3823,7334,956,332800,2721
7605,2520,5085,987,289400,2723
8289,2786,5503,1062,331600,2724
846,773,73,393,376800,2725
6498,5327,1171,1326,368000,2726
2047,1690,357,1296,556500,2738
2982,2460,522,1475,588000,2739
19467,7482,11985,1002,280000,2740
4070,3553,517,1038,350200,2743
5173,1600,3573,1065,309700,2744
10251,6261,3990,1062,303200,2745
6731,1277,5454,1017,292200,2746
7095,5382,1713,1422,413400,2747
4834,3755,1079,1190,450700,2748
11925,8401,3524,1243,423100,2760
4213,2882,1331,1804,444600,2762
688,516,172,1574,558700,2763
1544,1361,183,1665,434300,2764
6588,5484,1104,1888,448800,2766
5749,4431,1318,1677,466400,2767
4518,4106,412,1189,461600,2769
2064,1836,228,1408,486000,2770
5775,4786,989,1686,433500,2771
6809,5929,880,1279,392800,2777
2192,2129,63,-,454600,2779
21232,12442,8790,1170,352600,2780
6692,5548,1144,1208,446600,2790
242,231,11,-,1008100,2791
348,172,176,877,270000,2802
905,707,198,1329,289900,2804
6053,5383,670,1670,549800,2806
445,347,98,1259,983700,2807
884,618,266,996,279700,2808
8114,5700,2414,1276,426000,2809
414,393,21,-,419600,2812
3428,2961,467,1445,418500,2813
2906,2546,360,1209,362600,2814
50,33,17,-,-,2815
13560,10926,2634,1178,294800,2816
2337,1959,378,1995,447100,2817
8398,6271,2127,1395,512600,2818
1958,1584,374,-,430500,2822
9,9,0,-,-,2823
117,117,0,-,298000,2824
1854,1684,170,952,381200,2825
199,199,0,-,240200,2826
795,752,43,2698,345600,2827
3124,2670,454,1437,381700,2828
21,21,0,-,-,2829
2608,2012,596,892,372100,2830
1353,1211,142,1668,412600,2831
1808,1418,390,1054,402100,2832
266,202,64,393,299000,2833
2499,2139,360,1623,736600,2835
50,50,0,-,272700,2836
1560,1365,195,2658,723000,2837
1269,731,538,1205,303200,2838
648,483,165,1643,311000,2839
10640,5050,5590,1526,622800,2840
5,0,5,-,-,2841
6977,4140,2837,1652,480100,2842
9851,7330,2521,1128,419400,2852
3254,2763,491,1460,375800,2857
125,125,0,-,325000,2858
2330,1734,596,1182,331000,2859
19520,7619,11901,1040,268100,2860
11082,7224,3858,1188,264800,2861
7358,1914,5444,1052,244100,2863
14142,10901,3241,1129,370300,2864
6924,5249,1675,1227,398600,2865
7248,5837,1411,1731,486800,2871
75,75,0,-,410700,2872
87,59,28,-,-,2873
2312,1995,317,1875,575700,2874
93,93,0,-,417000,2875
426,77,349,1830,-,2876
6782,5288,1494,1190,333800,2878
9552,7442,2110,1268,468300,2879
1005,531,474,1419,461400,2881
5507,3709,1798,1655,614000,2882
5006,2955,2051,1138,356300,2885
13185,8673,4512,1290,303600,2886
8602,6761,1841,1180,291100,2888
11377,8893,2484,1216,281800,2889
9873,7269,2604,1289,397100,2891
1984,1798,186,1564,435000,2892
13878,7741,6137,1154,276100,2893
258,258,0,-,325400,2894
17003,6481,10522,1066,241200,2895
4523,3698,825,893,383600,2896
746,723,23,-,380900,2898
5236,1025,4211,1445,359600,2903
13190,6910,6280,1138,280200,2904
9658,4696,4962,1104,296700,2905
12355,6019,6336,1601,576600,2906
10847,3309,7538,1085,270500,2907
14626,7041,7585,1244,273500,2908
15108,5809,9299,1152,251100,2909
8883,6045,2838,1240,275200,2910
6597,4088,2509,1287,299400,2911
15,0,15,-,-,2912
9204,4693,4511,1186,270300,2914
7451,4928,2523,1251,281900,2915
3755,2706,1049,1097,332400,2916
4747,3638,1109,930,364000,2917
37,0,37,-,-,2918
11432,8248,3184,1180,290100,2919
14725,8828,5897,1230,324500,2920
4663,3919,744,1453,463800,2921
4535,4121,414,1361,480500,3031
2004,1810,194,2147,479600,3032
1705,1612,93,2368,431000,3033
1586,1502,84,1206,368200,3034
1736,1703,33,-,451100,3036
1625,1459,166,1442,360100,3037
13180,8840,4340,1381,345200,3038
2841,2435,406,1651,399000,3042
546,530,16,1556,350300,3043
1689,1560,129,2356,353400,3044
5336,4600,736,1524,334900,3045
1061,1018,43,1242,411200,3046
683,588,95,1012,293500,3047
1399,1131,268,1123,254000,3048
3285,3002,283,1709,588900,3049
9550,8156,1394,1407,377900,3051
2974,2588,386,2154,412900,3052
9438,8136,1302,1677,424100,3053
10180,9041,1139,1728,377200,3054
6399,3985,2414,1492,332300,3055
858,768,90,1713,436500,3057
12371,4587,7784,1462,310900,3060
11917,8169,3748,1754,364500,3062
6750,4160,2590,1761,336000,3063
6440,3901,2539,1460,352800,3064
2119,1877,242,1097,376700,3070
1896,1647,249,888,294000,3071
5029,4421,608,1220,457300,3076
4274,3525,749,1419,318100,3077
12258,9458,2800,1453,406600,3079
599,548,51,1579,315900,3082
515,425,90,1125,352800,3084
1730,1368,362,1347,326100,3086
5351,5102,249,3125,609900,3087
1972,121,1851,1542,326500,3101
14214,5259,8955,1437,280800,3102
14826,7257,7569,1240,288200,3103
14549,8141,6408,1338,335700,3104
5076,4010,1066,1527,336800,3106
3968,3195,773,1587,316600,3109
7917,6656,1261,2045,539500,3110
129,111,18,-,363500,3215
822,743,79,1193,306600,3216
966,590,376,1123,174200,3217
600,459,141,1423,262600,3218
2948,2462,486,902,236300,3220
913,821,92,1486,265700,3221
2317,1843,474,1122,242100,3222
1092,996,96,-,224800,3223
914,859,55,-,357500,3224
1240,1141,99,1400,267100,3225
384,330,54,987,356700,3226
716,646,70,1656,383000,3227
2168,1912,256,1160,377700,3229
672,625,47,1222,184100,3230
56,51,5,-,-,3231
86,86,0,-,371400,3233
1844,1640,204,1169,287100,3234
3742,2333,1409,1037,234900,3235
885,821,64,-,316000,3237
43,42,1,-,163200,3238
482,435,47,1172,212900,3240
430,394,36,1163,365000,3241
2397,1545,852,916,272600,3242
346,316,30,945,225700,3243
2996,2752,244,-,230300,3244
906,726,180,1678,344700,3245
6989,4119,2870,1163,250500,3246
3069,2771,298,1028,363700,3249
639,462,177,1103,267500,3251
3249,2508,741,1176,403300,3253
2126,1895,231,1453,450200,3254
742,648,94,482,408300,3255
971,817,154,1013,321000,3256
1630,1476,154,1387,455200,3257
1005,933,72,1740,341900,3258
149,149,0,-,365700,3259
347,330,17,-,293400,3260
1770,1608,162,1172,342600,3261
475,373,102,962,292300,3262
1801,1221,580,999,244400,3263
2395,1336,1059,1139,234000,3264
822,664,158,917,219800,3266
595,572,23,1240,273100,3268
1091,838,253,1138,349400,3269
124,124,0,-,280500,3273
4445,3442,1003,1215,281200,3275
3506,2433,1073,1104,213800,3276
1229,859,370,1085,306000,3278
313,259,54,1014,159200,3279
432,391,41,1213,270100,3280
3505,3305,200,1554,315900,3281
398,352,46,1600,264200,3282
229,207,22,-,310800,3284
1132,914,218,1309,273900,3285
624,488,136,1264,315500,3287
1988,1791,197,1384,376700,3290
34,34,0,-,-,3291
15,15,0,-,435700,3293
13628,7625,6003,1267,310900,3301
6493,4455,2038,1305,253600,3303
2895,2630,265,1404,401900,3304
2291,1972,319,1248,283200,3307
10039,5311,4728,1156,221600,3431
1094,921,173,1085,267900,3440
144,56,88,1106,235300,3441
680,414,266,1121,227500,3442
203,203,0,-,282200,3443
627,522,105,1233,358900,3444
283,242,41,1050,219400,3445
2901,2093,808,1375,240800,3446
1013,957,56,1096,245800,3447
310,285,25,1388,218300,3448
780,666,114,1179,394000,3449
416,386,30,1306,311300,3450
1594,1373,221,1026,153600,3451
2026,1580,446,957,234400,3452
957,623,334,1070,242000,3455
314,279,35,1137,252800,3456
298,266,32,1139,334400,3457
3065,1787,1278,1256,333600,3458
1972,1711,261,1074,291900,3461
626,560,66,-,283900,3462
365,354,11,-,288600,3464
758,525,233,1097,184100,3465
537,464,73,-,226700,3466
885,787,98,1154,307100,3467
1866,1379,487,1072,208400,3470
2758,1451,1307,821,237100,3561
3638,2161,1477,769,93200,3570
1025,801,224,938,243800,3574
0,0,0,-,-,3575
1337,1034,303,763,176400,3576
204,189,15,-,246600,3579
585,488,97,944,429700,3580
1623,1218,405,775,147500,3581
923,706,217,828,110400,3582
491,430,61,877,275000,3583
1446,1143,303,916,184600,3584
1043,811,232,1022,176200,3585
252,237,15,1031,455700,3586
718,590,128,1046,203900,3588
456,389,67,690,148200,3590
518,448,70,895,250600,3592
178,139,39,1214,264800,3593
418,343,75,980,223500,3595
239,169,70,631,93100,3597
1457,1022,435,1007,175000,3598
114,102,12,-,201700,3601
957,716,241,982,220300,3602
1996,1477,519,1106,144300,3603
0,0,0,-,-,3604
304,287,17,-,202000,3605
90,83,7,-,230400,3607
1191,787,404,1132,267800,3608
236,158,78,1153,173500,3609
431,376,55,1292,195000,3740
1548,1289,259,1094,227400,3741
5335,3211,2124,1072,158600,3743
762,737,25,1525,269400,3745
2037,1605,432,1413,294600,3748
307,278,29,-,752300,3750
177,150,27,-,199700,3751
303,250,53,1500,216700,3752
1159,1101,58,-,353200,3753
2766,1814,952,2024,678500,3755
136,117,19,-,248300,3765
4286,2430,1856,1661,311000,3766
625,541,84,1417,622800,3768
158,145,13,-,589300,3770
335,307,28,875,241800,3771
2943,1895,1048,1153,190000,3773
674,587,87,1413,175800,3774
563,443,120,1196,275500,3777
307,223,84,1159,285900,3779
235,235,0,-,-,3780
673,615,58,1652,364400,3781
968,767,201,1498,362600,3782
1813,760,1053,1518,327300,3784
813,482,331,1076,172200,3785
10814,5781,5033,1662,605300,3801
1350,1202,148,577,279500,3809
890,870,20,-,511500,3810
2908,2716,192,1158,459000,3811
506,426,80,-,341700,3812
1727,1399,328,1411,174100,3813
964,711,253,1125,239100,3814
598,534,64,-,301500,3816
288,161,127,1082,313000,3817
1492,1058,434,954,256000,3818
1653,1551,102,1641,353400,3819
14624,7603,7021,1436,368200,3820
688,558,130,1637,456500,3823
3000,1857,1143,1390,448400,3824
3401,3074,327,1673,326400,3825
1197,818,379,952,427800,3826
1159,1071,88,1217,490500,3827
642,642,0,-,321700,3830
158,123,35,840,333900,3832
9115,6635,2480,1479,426800,3833
2918,2031,887,1030,239100,3835
576,543,33,-,339100,3836
690,650,40,-,319600,3837
465,332,133,1475,410600,3838
1577,1031,546,1216,243600,3839
1540,1311,229,2172,564600,3840
2617,2251,366,1277,441100,3841
7304,5537,1767,1635,460200,3842
874,777,97,1680,596000,3844
701,568,133,1393,267500,3845
497,382,115,1699,506000,3846
123,123,0,-,435900,3847
2751,2231,520,1153,409900,3848
491,393,98,1372,332300,3849
90,90,0,-,262500,3850
1553,1341,212,1088,246100,3851
111,111,0,-,301000,3852
394,350,44,1343,497100,3853
430,396,34,2786,1475000,3854
1004,911,93,1388,284400,3855
637,609,28,2071,582900,3856
4203,2282,1921,1573,369900,3857
1789,1635,154,1224,384800,3858
1924,1207,717,1048,317600,3860
1839,1672,167,1147,406300,3861
1990,1748,242,1924,595700,3862
720,687,33,-,262100,3864
3207,2677,530,1524,370300,3865
9392,5891,3501,1173,240100,3867
2573,2011,562,983,229100,3868
1000,798,202,1270,338900,3869
2253,1873,380,1538,854100,3870
193,183,10,-,1608300,3871
1663,1557,106,959,307200,3872
2206,1865,341,1807,374800,3873
3803,2805,998,1371,377700,3874
450,409,41,1389,330800,3875
5284,3440,1844,1330,265200,3878
534,462,72,993,241500,3882
189,116,73,-,279200,3883
1440,1343,97,1713,363700,3884
3047,2764,283,2030,571200,3885
512,368,144,1080,286200,3886
681,647,34,1344,237500,3887
8,0,8,-,-,3890
2806,2184,622,1020,400300,3894
3,3,0,-,-,3897
3444,2912,532,1131,308500,3901
1024,746,278,1842,473600,3902
2747,2332,415,1434,423500,3903
4007,2473,1534,1374,361100,3904
842,754,88,1940,468300,3905
2042,1667,375,1102,341900,3906
582,515,67,1783,649500,3907
2797,2182,615,1219,354200,3908
4566,3732,834,1425,527500,3909
0,0,0,-,-,3910
85,85,0,-,680100,3911
1111,1078,33,1094,283900,4001
3121,2775,346,756,280600,4002
68,49,19,-,383300,4003
10359,5094,5265,1104,321300,4005
38,38,0,-,-,4006
1269,1158,111,1090,291600,4008
2403,1979,424,1002,239500,4009
634,528,106,1510,238200,4010
8695,6378,2317,1231,316200,4011
1835,1614,221,838,254300,4015
306,214,92,2153,474000,4017
38,31,7,-,639700,4019
753,656,97,1086,220500,4020
2346,2102,244,1429,461100,4021
463,412,51,1125,250800,4022
182,146,36,1132,225900,4024
2302,2006,296,1271,261100,4027
855,716,139,1276,230000,4029
840,706,134,1244,285500,4030
3413,2743,670,1548,430500,4032
1487,1172,315,642,232600,4037
6043,4886,1157,1295,395000,4038
3445,2754,691,1385,320000,4039
1442,1305,137,792,231100,4040
610,507,103,1216,210500,4041
1869,1717,152,1045,271800,4042
5136,3909,1227,1217,399000,4043
3200,2567,633,1204,507000,4046
694,558,136,-,239700,4047
1190,1075,115,1096,222400,4048
1509,1400,109,1129,226300,4049
126,111,15,2205,420500,4050
567,481,86,1398,252000,4051
2045,1869,176,1542,230900,4055
42,42,0,-,187500,4056
0,0,0,-,-,4057
973,933,40,-,197800,4061
7507,6363,1144,1206,329200,4062
393,246,147,455,420000,4063
4831,3447,1384,1059,291600,4064
345,198,147,1108,561300,4066
569,476,93,1200,200900,4068
620,547,73,1683,383000,4069
2173,1871,302,1369,297600,4071
8872,6073,2799,1288,345200,4072
7013,4658,2355,1072,241000,4073
9054,7103,1951,1681,463000,4074
1085,1001,84,1230,286100,4076
2128,1782,346,1323,552500,4079
2006,1464,542,1117,225900,4083
2624,2373,251,1267,309800,4084
998,869,129,1564,249900,4085
4181,3188,993,1174,293300,4086
904,818,86,1295,225800,4087
514,468,46,765,224700,4088
4949,4307,642,1180,385200,4090
297,262,35,-,227800,4091
8910,5674,3236,1302,300400,4092
3402,2541,861,1372,281100,4093
676,651,25,975,272700,4095
3349,2567,782,1583,539100,4096
1535,1280,255,1487,447700,4097
10279,2251,8028,1348,575900,4101
8096,4164,3932,1363,407700,4102
13286,7794,5492,1446,384100,4103
4894,4196,698,1973,609100,4105
11883,7419,4464,1601,357900,4106
3847,3389,458,2238,600200,4107
471,399,72,1543,418000,4108
83,83,0,-,576000,4109
672,590,82,1707,865300,4110
10309,6048,4261,926,227300,4210
259,241,18,775,142000,4216
1543,1323,220,764,236600,4217
529,461,68,1056,183500,4219
1197,1111,86,1099,174900,4220
321,265,56,459,180400,4221
1663,1534,129,1051,246100,4222
1143,943,200,589,118700,4224
36,33,3,-,147500,4226
23,23,0,-,58200,4227
114,99,15,1125,188400,4231
0,0,0,-,-,4234
1701,1536,165,1059,235800,4236
118,113,5,-,254200,4237
463,418,45,-,216400,4238
1812,1509,303,707,152800,4239
15611,7725,7886,903,189500,4240
1837,1362,475,908,200000,4250
1901,1460,441,952,213700,4252
798,783,15,-,183600,4253
1412,876,536,813,103700,4254
336,244,92,1313,256500,4255
1109,779,330,1110,212500,4256
1152,879,273,765,96400,4257
1119,1044,75,850,259800,4258
1490,1148,342,978,232900,4259
2092,1749,343,1158,299900,4260
164,146,18,875,-,4261
767,671,96,936,225700,4263
335,272,63,1137,155800,4265
18,18,0,-,-,4267
1955,1407,548,766,183400,4268
2304,1990,314,1083,191700,4270
0,0,0,-,-,4271
2375,2082,293,1073,287100,4274
323,306,17,-,116700,4275
2484,1705,779,566,112900,4276
2917,2628,289,831,169700,4280
2080,1309,771,877,170000,4281
2306,1922,384,1015,242800,4282
510,421,89,854,291000,4284
181,166,15,621,216700,4285
0,0,0,-,-,4286
1361,1284,77,-,242700,4287
702,539,163,756,173800,4289
697,629,68,671,131600,4290
396,381,15,-,141300,4292
1491,1144,347,553,167600,4294
12174,7547,4627,884,176200,4330
0,0,0,-,-,4341
755,643,112,1136,198600,4342
1445,917,528,730,174900,4344
4938,3789,1149,922,182100,4345
782,601,181,870,147500,4346
1359,774,585,835,237300,4347
1269,1083,186,943,212800,4348
600,523,77,958,244800,4349
1523,1440,83,1041,210400,4350
975,819,156,918,263800,4351
670,594,76,868,211000,4352
899,854,45,867,201600,4353
594,557,37,-,239600,4354
991,865,126,1173,266500,4355
1494,1067,427,890,221700,4357
1887,1755,132,979,212700,4358
149,62,87,743,170500,4359
250,226,24,533,191300,4360
1058,932,126,1071,194600,4363
2567,2144,423,1002,239500,4364
18942,10259,8683,951,212000,4401
347,286,61,1011,153300,4406
96,84,12,933,193800,4408
445,392,53,680,167900,4410
630,527,103,1031,180400,4411
4156,2397,1759,970,198500,4412
98,98,0,-,125000,4413
844,756,88,841,116400,4414
117,81,36,833,82600,4415
2363,1857,506,844,196900,4416
215,208,7,-,95300,4417
621,541,80,725,124800,4418
1283,1067,216,1132,219700,4419
316,244,72,992,413300,4421
404,375,29,558,173200,4422
440,365,75,540,111100,4424
2061,1346,715,836,137800,4426
1106,920,186,727,131800,4427
1331,1108,223,1102,192200,4428
2223,2021,202,1113,264000,4429
695,530,165,613,69100,4430
25,17,8,-,-,4431
447,420,27,945,147500,4434
462,429,33,879,153400,4435
534,452,82,741,200000,4438
813,664,149,721,229700,4441
61,61,0,-,203300,4442
970,770,200,454,152100,4443
3597,3084,513,1017,257300,4444
565,483,82,750,108000,4448
494,456,38,1132,136400,4449
541,413,128,1018,141600,4450
141,135,6,-,56300,4451
334,242,92,706,105200,4453
3,3,0,-,-,4454
298,255,43,1025,150400,4455
1141,899,242,1250,234200,4456
2737,2023,714,649,122900,4457
329,287,42,345,72700,4459
578,481,97,709,76700,4460
1218,1080,138,970,160400,4461
2425,2038,387,593,91000,4462
1205,903,302,971,85000,4463
225,190,35,582,122700,4464
3874,2333,1541,888,165200,4468
0,0,0,-,-,4469
260,250,10,-,109400,4471
850,730,120,1090,229700,4472
3290,1580,1710,1058,214600,4473
1575,1408,167,1051,220800,4474
198,158,40,538,85400,4475
501,446,55,985,232200,4476
237,214,23,-,324200,4478
574,430,144,688,112200,4479
254,246,8,950,173200,4481
72,66,6,-,197500,4485
400,365,35,950,84200,4487
501,424,77,785,174300,4488
137,86,51,1242,173300,4489
121,121,0,-,112500,4490
87,82,5,-,100000,4491
42,40,2,-,86000,4492
812,736,76,664,132600,4493
171,153,18,525,96400,4495
1652,1435,217,608,199600,4496
173,148,25,1286,71700,4497
5167,3414,1753,946,281300,4530
261,232,29,875,282500,4535
760,725,35,992,290000,4537
848,633,215,688,362200,4538
631,590,41,-,300000,4539
33,33,0,-,447200,4541
954,589,365,943,289000,4543
551,375,176,-,420100,4544
509,440,69,1279,273200,4547
428,336,92,958,407600,4548
332,307,25,1639,375000,4551
757,596,161,1039,396300,4553
354,284,70,-,486100,4554
741,633,108,952,269900,4555
572,489,83,897,292400,4556
144,133,11,-,406300,4558
943,768,175,967,307300,4562
686,602,84,1261,326600,4563
215,195,20,-,448900,4564
270,171,99,1135,545000,4568
0,0,0,-,-,4570
284,271,13,-,251300,4571
2668,2089,579,-,226000,4572
171,157,14,-,395000,4573
712,636,76,988,175600,4574
108,108,0,-,366700,4575
257,254,3,-,450000,4576
1970,1645,325,957,278300,4578
1217,1104,113,1363,220700,4579
6517,4832,1685,931,213200,4605
520,446,74,588,162200,4606
557,482,75,739,246900,4607
2318,1623,695,990,430000,4609
219,178,41,807,255400,4611
219,185,34,942,334500,4612
43,43,0,-,-,4613
1303,956,347,932,305000,4614
350,309,41,1309,283600,4616
328,303,25,1607,359400,4617
1595,1046,549,698,97800,4619
396,297,99,330,131600,4622
425,345,80,850,141800,4623
92,84,8,-,-,4624
20,18,2,-,380000,4625
214,205,9,1025,145300,4626
862,744,118,1131,263100,4627
226,199,27,330,135200,4628
569,475,94,883,158000,4630
612,485,127,438,120300,4631
844,719,125,990,183000,4634
7,7,0,-,212500,4635
1065,887,178,1003,227600,4640
92,77,15,1125,443800,4642
355,276,79,-,143300,4643
31,25,6,-,687500,4645
45,39,6,-,367900,4646
232,179,53,1053,110200,4648
553,388,165,-,136400,4649
157,144,13,-,277300,4650
761,633,128,303,170300,4652
290,199,91,1297,289800,4653
1315,918,397,667,144900,4654
384,275,109,1121,185100,4655
150,133,17,-,257200,4657
545,435,110,742,194900,4658
499,451,48,1132,483900,4660
195,156,39,1161,565200,4662
552,453,99,1125,192000,4664
553,473,80,889,104300,4666
513,396,117,-,131300,4667
761,569,192,382,114900,4668
68,48,20,-,287500,4669
231,189,42,1292,215600,4671
87,83,4,-,279500,4673
117,91,26,-,301600,4674
50,50,0,-,509600,4675
556,449,107,923,247900,4676
130,98,32,1696,248300,4677
722,436,286,784,362700,4679
512,442,70,630,153000,4680
455,338,117,825,215600,4681
0,0,0,-,-,4683
861,725,136,852,245700,4684
198,181,17,-,303300,4685
83,65,18,842,-,4686
232,198,34,1542,206700,4691
229,195,34,927,167500,4693
987,837,150,794,105700,4694
4059,2883,1176,645,122000,4730
753,521,232,-,108300,4732
148,97,51,714,129100,4733
308,278,30,779,109600,4734
226,190,36,704,98200,4735
4136,3082,1054,634,122000,4736
0,0,0,-,-,4737
331,266,65,575,152500,4739
550,468,82,423,118400,4740
1383,1138,245,918,144800,4742
1992,1500,492,840,132300,4743
389,340,49,744,121000,4745
201,154,47,519,68300,4746
543,448,95,772,118800,4747
797,491,306,740,91700,4750
1624,955,669,535,150100,4756
1114,926,188,572,166800,4757
581,394,187,417,142300,4758
310,269,41,807,116800,4760
180,140,40,800,231300,4761
204,160,44,400,137500,4762
314,223,91,436,119500,4763
12,9,3,-,112500,4764
479,405,74,336,91000,4765
143,127,16,-,118000,4766
203,183,20,1025,196300,4768
4067,2310,1757,812,137100,4769
383,336,47,431,151700,4772
341,310,31,-,120000,4773
327,279,48,825,86500,4774
322,294,28,-,99000,4776
158,136,22,663,97500,4777
167,163,4,-,223000,4779
329,300,29,938,115100,4780
217,198,19,725,165200,4781
208,178,30,900,163000,4783
851,595,256,628,90700,4785
728,550,178,453,97500,4786
154,136,18,875,94300,4787
3371,2153,1218,948,195800,4841
2368,1683,685,1154,432600,4843
674,609,65,1082,261100,4847
344,319,25,-,274500,4848
1657,1455,202,1183,289700,4849
49,49,0,-,325000,4851
44,33,11,917,541700,4852
184,142,42,1042,405700,4853
695,546,149,1286,287200,4854
163,163,0,-,354700,4855
1421,1091,330,1093,366600,4856
578,514,64,1163,276500,4858
360,309,51,-,553000,4859
871,807,64,1543,273400,4860
1276,872,404,905,254500,4861
1670,1470,200,873,225300,4862
500,428,72,967,386300,4863
1662,1545,117,1064,191000,4864
10945,6430,4515,881,168000,4901
908,729,179,954,161600,4910
821,645,176,830,102700,4911
303,283,20,483,107800,4912
4227,3103,1124,913,219900,4915
1320,1215,105,858,290800,4917
0,0,0,-,-,4918
909,679,230,771,96500,4920
695,527,168,930,167000,4921
377,337,40,972,151200,4922
234,222,12,704,148800,4923
865,690,175,892,150700,4924
8,4,4,-,-,4925
0,0,0,-,-,4926
1425,1230,195,966,164600,4927
855,768,87,769,148800,4928
324,231,93,918,133900,4929
1959,1411,548,859,157600,4930
508,428,80,1043,150400,4932
111,92,19,-,189500,4936
2847,2130,717,869,157700,4937
4140,2519,1621,882,186100,4938
385,325,60,746,123400,4939
0,0,0,-,-,4940
707,585,122,790,169800,4941
530,423,107,587,163200,4942
736,581,155,836,132000,4943
37,37,0,-,-,4944
600,533,67,426,143100,4945
814,733,81,896,236000,4947
403,350,53,384,205700,4949
2083,1452,631,976,150500,4950
474,377,97,1038,179100,4951
756,636,120,925,192800,4952
1480,1135,345,796,187800,4953
591,546,45,644,161800,4955
264,231,33,741,142300,4956
1647,1335,312,954,182900,4957
916,814,102,-,151400,4958
375,353,22,-,134800,4961
3133,2651,482,832,222600,4963
73,68,5,-,376900,4964
804,641,163,850,138700,4965
702,590,112,426,131900,4966
1573,1083,490,-,139800,4967
494,435,59,830,168600,4969
766,550,216,711,246600,4970
803,681,122,910,182500,4971
577,516,61,825,254800,4973
1292,823,469,870,195100,4974
26,26,0,-,-,4975
4419,3037,1382,828,147800,4976
427,392,35,741,219900,4978
383,345,38,792,158100,4979
1138,989,149,1170,198400,4981
187,110,77,903,189700,4982
626,582,44,771,138100,4983
264,229,35,839,170100,4984
72,63,9,-,230400,4985
719,583,136,1109,155900,4986
432,403,29,1305,162500,4987
704,483,221,790,172900,4988
1999,1636,363,939,205000,4989
0,0,0,-,-,4992
3950,2729,1221,1114,259500,5001
0,0,0,-,-,5009
71,71,0,-,-,5030
19,19,0,-,-,5031
1132,893,239,1325,233400,5032
1304,936,368,1061,215800,5033
80,26,54,-,266700,5034
368,337,31,1180,174300,5035
522,466,56,1179,306100,5036
370,329,41,1132,287500,5037
588,491,97,918,206700,5038
468,443,25,1313,217600,5039
293,256,37,1321,235200,5040
64,22,42,1354,226700,5041
304,254,50,825,226100,5042
493,415,78,1199,260800,5043
848,701,147,1217,255000,5045
541,477,64,550,201700,5046
1055,894,161,1033,318700,5048
65,33,32,-,241700,5050
546,435,111,1125,238000,5051
144,102,42,1268,-,5052
107,85,22,-,302300,5053
1241,949,292,991,511500,5055
170,123,47,1118,348000,5056
78,58,20,-,222200,5058
255,229,26,-,307000,5059
1973,1413,560,1005,227400,5060
661,492,169,1536,244600,5061
196,176,20,1000,298200,5062
433,335,98,1030,247500,5065
72,60,12,-,289100,5067
1233,931,302,1239,227400,5068
248,226,22,-,239100,5069
193,163,30,1221,399100,5070
79,65,14,-,-,5071
280,260,20,-,359300,5072
12,12,0,-,-,5073
540,493,47,1548,270900,5075
207,185,22,1250,176800,5076
473,405,68,1283,260400,5077
396,343,53,1036,180900,5079
250,173,77,788,174000,5081
100,75,25,825,54800,5083
53,53,0,-,548900,5084
248,211,37,955,181300,5086
395,366,29,-,233800,5088
2165,1505,660,997,212400,5089
1570,1184,386,1169,462600,5091
1890,1159,731,1047,180800,5101
62,40,22,-,264300,5141
238,203,35,1596,236500,5142
1953,1623,330,1066,248300,5143
260,233,27,1097,303800,5146
629,580,49,1182,362000,5148
941,640,301,1041,291200,5149
254,238,16,-,154800,5150
586,571,15,955,241900,5151
166,141,25,1203,410600,5152
296,231,65,1074,290600,5153
258,94,164,1099,250000,5154
336,234,102,936,244200,5155
4011,2800,1211,954,165600,5156
413,394,19,972,196900,5158
299,276,23,2042,511500,5161
6169,3764,2405,998,193000,5201
1473,1294,179,1139,247500,5250
528,494,34,-,426100,5251
194,161,33,1357,206100,5252
292,222,70,838,380000,5253
161,121,40,-,462500,5254
1642,1215,427,745,375700,5255
890,699,191,1306,282400,5257
117,117,0,-,196900,5260
796,732,64,-,171700,5261
693,601,92,834,239800,5262
7519,4676,2843,1036,247600,5301
309,282,27,-,351200,5340
244,156,88,630,291500,5341
217,190,27,992,261800,5342
459,399,60,1282,277500,5343
0,0,0,-,-,5344
759,624,135,1581,250000,5345
2011,1696,315,871,265900,5346
349,279,70,-,210700,5350
108,98,10,-,291700,5351
376,356,20,1167,262500,5352
554,434,120,1192,241700,5353
920,681,239,1043,240800,5354
280,271,9,1188,260800,5355
395,333,62,1288,327700,5356
145,121,24,850,212800,5358
258,212,46,1083,285600,5359
126,92,34,-,287500,5360
345,291,54,838,225800,5361
94,86,8,-,325000,5362
922,692,230,967,269400,5363
13234,3876,9358,1553,434500,5401
8789,5227,3562,1685,383400,5403
3677,1307,2370,1516,326400,5404
0,0,0,-,-,5405
4208,3085,1123,1326,346200,5408
0,0,0,-,-,5439
827,713,114,1198,242200,5440
246,238,8,-,223500,5441
179,165,14,1583,195800,5442
2717,2260,457,1121,303700,5443
626,534,92,1196,306000,5444
1708,1580,128,1515,628800,5445
7006,4951,2055,1283,333800,5446
45,23,22,-,117500,5447
363,338,25,1054,225800,5448
1971,1603,368,935,245800,5450
9575,6489,3086,1453,364500,5452
1986,1618,368,1050,335400,5454
457,378,79,-,323200,5455
401,347,54,1396,428500,5456
608,494,114,859,242600,5457
877,775,102,1144,355700,5458
714,577,137,-,237700,5459
2148,1808,340,1359,402400,5461
802,707,95,988,319600,5462
221,205,16,965,242300,5463
1088,803,285,1197,301800,5464
2223,2083,140,1142,434300,5465
4866,4197,669,1290,316500,5468
387,300,87,-,224500,5471
799,664,135,1250,324900,5472
642,531,111,1676,359900,5473
523,514,9,-,360000,5474
1212,894,318,1133,173500,5476
1939,1533,406,897,390100,5477
6444,4399,2045,1205,276500,5478
0,0,0,-,-,5481
3287,2397,890,1326,467800,5482
673,595,78,1417,220600,5483
0,0,0,-,-,5485
579,512,67,1383,487700,5486
599,547,52,1179,241100,5487
2897,2305,592,1283,256000,5488
1416,1227,189,1277,370900,5489
2323,1784,539,1129,280100,5491
355,293,62,947,230800,5492
633,589,44,1404,349600,5494
4564,3613,951,1736,418800,5495
5687,3823,1864,1159,323300,5602
89,80,9,-,330400,5640
7423,5120,2303,1004,220600,5641
475,401,74,917,225200,5647
219,175,44,1152,322900,5648
141,116,25,-,167900,5649
384,327,57,1167,288800,5650
593,524,69,870,312500,5651
312,233,79,1411,165100,5652
260,211,49,850,214000,5653
613,345,268,1090,204600,5654
1224,1030,194,978,194600,5655
1262,833,429,986,171600,5656
525,465,60,1463,213500,5658
787,704,83,1283,365100,5660
3007,1952,1055,1033,243400,5661
2105,1629,476,913,240300,5663
0,0,0,-,-,5664
15,15,0,-,541700,5666
979,731,248,1140,284000,5667
344,286,58,813,213300,5669
31,0,31,-,-,5670
2468,1906,562,1341,523400,5672
1100,851,249,1125,385600,5673
756,626,130,1288,444300,5674
454,439,15,1100,181300,5675
2063,1389,674,1086,337300,5676
906,784,122,1663,392300,5677
39,39,0,-,135200,5678
1171,1076,95,1659,212500,5679
791,641,150,954,221100,5680
64,58,6,-,203600,5681
505,425,80,1046,255100,5682
9374,5431,3943,865,185500,5701
178,153,25,-,333100,5730
0,0,0,-,-,5731
566,365,201,839,265000,5732
2491,2081,410,963,222900,5733
531,426,105,1157,328700,5734
1350,1176,174,725,186900,5735
226,126,100,977,168500,5736
227,201,26,913,233500,5737
466,425,41,1221,294100,5738
551,462,89,894,270000,5739
256,218,38,895,232100,5742
1538,1202,336,898,175000,5743
229,108,121,850,175000,5744
0,0,0,-,-,5746
145,124,21,1078,192600,5747
213,118,95,940,185400,5748
324,265,59,891,417600,5751
3567,2576,991,1214,366000,5753
320,288,32,1188,223500,5757
269,225,44,1641,226600,5758
793,613,180,1009,200900,5759
371,338,33,1081,277800,5760
442,374,68,1265,288300,5761
212,160,52,993,253000,5762
1257,1083,174,905,209600,5763
1141,879,262,818,203000,5764
697,568,129,1023,175800,5765
216,193,23,-,288900,5766
684,619,65,850,210200,5767
18,7,11,-,-,5768
460,407,53,1540,326100,5769
467,370,97,1102,280200,5770
359,313,46,925,251200,5772
912,716,196,963,235900,5773
416,347,69,1056,191800,5774
244,202,42,897,239700,5775
138,120,18,-,211500,5776
1432,1138,294,951,193800,5777
396,277,119,1025,252900,5778
4004,2632,1372,899,180100,5819
146,144,2,-,188400,5820
357,309,48,1139,204400,5821
860,679,181,797,171800,5822
525,439,86,984,161300,5824
24,10,14,-,187500,5825
330,293,37,1090,227600,5826
176,139,37,925,319400,5827
901,745,156,-,261700,5828
803,590,213,1018,215100,5829
640,542,98,1038,178700,5830
426,403,23,872,285100,5832
17,13,4,-,208300,5833
539,488,51,775,175600,5836
162,138,24,1462,135000,5837
249,220,29,818,226200,5839
23,18,5,-,-,5840
163,140,23,836,383300,5841
219,168,51,1030,179700,5842
1088,801,287,816,160700,5843
532,478,54,914,222700,5845
584,381,203,795,141400,5846
363,316,47,950,146400,5847
63,63,0,-,404500,5850
2491,1994,497,1058,200100,5851
342,301,41,1156,219900,5853
3263,2297,966,877,183400,5855
627,504,123,1021,225400,5857
119,110,9,-,135700,5858
843,751,92,1036,207700,5859
1129,869,260,768,167700,5860
165,140,25,819,231700,5862
304,255,49,1229,154300,5866
243,221,22,681,208300,5867
37,37,0,-,178100,5868
546,449,97,910,214300,5871
411,381,30,-,174800,5872
337,279,58,1654,212500,5873
217,204,13,1050,239200,5874
202,202,0,-,233300,5875
0,0,0,-,-,5901
60,52,8,-,112500,5902
315,284,31,1008,135500,5903
105,73,32,1143,91700,5904
448,420,28,738,233300,5905
500,437,63,1017,154700,5906
68,62,6,-,162500,5907
7729,6414,1315,1608,428500,6001
8984,6046,2938,1620,247900,6002
24067,15635,8432,1229,235700,6010
3206,2936,270,1328,386100,6013
2812,1990,822,1520,286400,6016
1027,526,501,1115,222000,6018
4121,3409,712,1365,385100,6019
19,19,0,-,-,6020
621,578,43,1277,307100,6021
25,25,0,-,-,6022
674,549,125,1348,350000,6023
179,179,0,-,223800,6024
1935,1585,350,1153,325800,6026
519,469,50,1417,319100,6027
6471,4514,1957,1701,341800,6029
609,505,104,1635,435800,6031
7895,5744,2151,1762,382500,6032
12016,9682,2334,1636,384400,6033
3114,2763,351,1157,312400,6035
7547,6165,1382,1388,341100,6037
761,529,232,1464,492800,6039
14840,7835,7005,1291,229600,6040
10060,5604,4456,1650,209000,6042
1917,1732,185,1092,333200,6043
12402,3752,8650,1078,185000,6051
3291,2003,1288,1176,219900,6052
12938,6116,6822,1200,183000,6053
2474,2154,320,1302,340700,6057
770,571,199,1159,387400,6058
56,56,0,-,555600,6059
817,817,0,-,368800,6060
233,173,60,-,165300,6061
8070,5379,2691,1086,240300,6062
1256,1117,139,1323,323700,6063
248,248,0,-,344800,6065
12980,6984,5996,1287,237100,6066
8768,5832,2936,1665,320400,6067
792,544,248,1784,884600,6068
1238,814,424,1690,464300,6069
5669,4484,1185,1881,393800,6070
3498,3111,387,1052,364800,6071
0,0,0,-,-,6072
2145,1983,162,1353,481700,6073
9865,8309,1556,1602,324200,6074
4986,3916,1070,1121,239600,6076
3963,3370,593,1356,413300,6078
0,0,0,-,-,6079
0,0,0,-,-,6080
641,398,243,1224,256900,6081
16394,12393,4001,1447,228600,6082
5325,4957,368,1436,335400,6084
2874,2272,602,1137,370500,6085
2263,1713,550,1413,186800,6088
1545,877,668,2083,346000,6089
358,319,39,-,452400,6090
93,74,19,-,307100,6091
1332,1293,39,1760,450100,6092
1344,1305,39,1557,355200,6093
11217,9152,2065,1551,265200,6095
5417,4327,1090,1303,236200,6096
4778,3013,1765,1118,222600,6098
1696,94,1602,1772,293800,6103
9720,1733,7987,1044,356000,6105
14657,3790,10867,1161,183000,6106
8095,6613,1482,1768,429600,6107
9296,4269,5027,1139,203000,6108
11362,9114,2248,1244,286000,6109
5380,3411,1969,1543,261800,6110
12514,9712,2802,1401,266200,6111
7602,2905,4697,1213,189300,6112
9990,3250,6740,1190,213400,6114
5860,4669,1191,2011,399100,6117
10790,7679,3111,1238,200600,6118
6535,3056,3479,1542,344000,6119
4894,814,4080,1096,156600,6120
6968,2740,4228,1085,171900,6226
1414,1325,89,1140,358000,6231
1158,1036,122,966,366700,6232
2939,2391,548,1108,272300,6234
899,722,177,985,241500,6235
2161,1851,310,862,295600,6237
4931,4445,486,1249,287800,6238
4827,2983,1844,1240,251600,6239
2551,1953,598,1044,260900,6241
477,371,106,914,287800,6242
31,31,0,-,595000,6243
942,840,102,1315,274500,6247
2114,1805,309,1646,344900,6248
2795,2419,376,1264,325600,6249
2441,1915,526,1576,264900,6250
700,598,102,1042,271700,6254
1882,1443,439,961,266100,6255
986,860,126,1560,170800,6256
0,0,0,-,-,6258
1751,1285,466,998,359100,6259
4005,2221,1784,1107,235900,6260
384,333,51,-,185900,6262
57,8,49,1578,-,6263
140,25,115,-,405000,6264
102,60,42,-,200000,6266
3907,1937,1970,1389,325300,6268
121,44,77,2750,-,6269
1531,1416,115,1743,268000,6277
1883,1498,385,1205,297800,6278
2660,1724,936,1161,274000,6279
1562,1106,456,1661,209200,6280
2947,2448,499,1091,342500,6281
473,473,0,-,306700,6282
11125,4572,6553,1178,220300,6320
1196,851,345,1237,261800,6330
2311,1943,368,711,277300,6331
480,275,205,1258,232900,6332
2770,2040,730,1639,417500,6333
925,772,153,1338,274400,6334
2197,1757,440,1492,278600,6335
18,18,0,-,344400,6336
12,12,0,-,350000,6338
3402,2953,449,1239,273400,6339
12780,5705,7075,1423,248000,6340
43,33,10,-,229700,6350
6477,5098,1379,1162,272200,6351
75,52,23,-,-,6353
2022,1442,580,1128,255900,6354
5372,4512,860,1577,398000,6355
4884,3688,1196,1509,358000,6357
2163,1981,182,1203,356300,6359
15786,8805,6981,1163,204600,6360
1742,1618,124,1234,320000,6365
2731,2431,300,1028,277200,6370
3973,3412,561,1731,463900,6371
48,40,8,-,275000,6373
3168,2346,822,1124,231000,6374
1427,1244,183,1132,279700,6375
17,17,0,-,-,6376
960,732,228,1572,254300,6377
2660,1978,682,1546,522200,6378
3902,2690,1212,1163,351100,6379
1325,470,855,1118,173400,6380
3763,2844,919,1225,235200,6382
1122,876,246,1100,306400,6384
6623,5219,1404,1511,299700,6385
139,51,88,857,215000,6387
54,54,0,-,-,6389
19,9,10,-,-,6390
8014,4373,3641,1329,254700,6401
2613,2150,463,1818,293600,6403
13054,8833,4221,1463,363700,6405
425,345,80,994,320500,6409
9802,8604,1198,1234,400000,6410
1559,1123,436,1398,382400,6412
5424,4651,773,1324,333400,6413
94,94,0,-,334700,6414
6334,5115,1219,1276,317400,6415
5920,4544,1376,1391,288600,6416
2035,1333,702,1268,342700,6417
5621,3542,2079,1301,223000,6418
2335,2280,55,898,377600,6419
1651,1452,199,1303,356700,6420
3067,2859,208,1714,390700,6422
2008,1875,133,1597,351900,6423
4687,4128,559,1391,307100,6424
1574,1206,368,1394,690500,6426
8786,7488,1298,1725,462200,6437
1038,817,221,1732,373100,6438
23,23,0,-,598700,6439
2076,1914,162,1147,365700,6441
1010,714,296,1293,407400,6442
6825,6139,686,1997,487900,6443
93,93,0,-,235900,6444
2096,1914,182,1363,366700,6447
14855,9446,5409,1220,196200,6450
10163,5432,4731,1146,206700,6451
1242,1145,97,1208,364700,6455
172,147,25,-,426900,6456
20535,11118,9417,1312,257800,6457
4,0,4,-,-,6459
16392,11834,4558,1778,358600,6460
5559,5036,523,2024,376300,6461
169,73,96,-,-,6467
6114,5684,430,1407,456800,6468
1375,918,457,1188,320400,6469
5397,4748,649,1689,481900,6470
2908,2464,444,1720,349600,6471
2207,1996,211,1229,347500,6472
9705,8033,1672,1445,344500,6473
4660,3930,730,1745,447300,6475
5192,4620,572,1954,447000,6477
4856,4466,390,1230,427500,6478
4111,3472,639,1460,322600,6479
3569,2942,627,1180,289300,6480
600,402,198,"3,500+",283300,6481
4166,3897,269,1803,441000,6482
6465,4857,1608,1330,316100,6483
15774,12379,3395,1539,410400,6484
8020,6911,1109,1757,359600,6488
12632,10578,2054,1397,345600,6489
18439,13743,4696,1243,311200,6492
3369,2700,669,1310,399100,6498
2280,162,2118,1896,413200,6510
21442,4192,17250,1481,291200,6511
12063,8458,3605,1378,255200,6512
15652,6121,9531,1170,217000,6513
10224,6557,3667,1605,233200,6514
6965,2978,3987,1401,267300,6515
20405,10625,9780,1322,247800,6516
6016,3757,2259,1289,298800,6517
6558,4127,2431,1964,290600,6518
5550,1464,4086,1335,213900,6519
1742,1615,127,1605,414500,6524
3180,2855,325,1812,506400,6525
11612,4418,7194,1366,230600,6604
10312,3372,6940,1375,238900,6605
19024,11096,7928,1466,238300,6606
2131,851,1280,1421,167300,6607
3946,1026,2920,1274,190400,6608
8525,4355,4170,1252,212000,6610
11820,10560,1260,2326,470100,6611
2686,2245,441,2459,702200,6612
14099,12641,1458,1768,320600,6614
6722,4642,2080,1465,336200,6615
1879,95,1784,645,264000,6702
11933,5351,6582,1119,157800,6704
11122,4744,6378,1166,153200,6705
5417,2495,2922,1161,148100,6706
11902,6268,5634,1251,179400,6708
3732,1220,2512,1117,188000,6710
3208,2910,298,1676,331100,6712
6042,5247,795,1486,287600,6716
633,418,215,830,335400,6750
1305,988,317,1043,342100,6751
700,620,80,2167,539900,6752
17,17,0,-,-,6753
673,566,107,2074,395200,6754
331,273,58,1911,437500,6755
1149,1012,137,1824,401400,6756
930,650,280,-,355200,6757
15,15,0,-,325000,6758
2351,1966,385,1358,407600,6759
2812,2528,284,-,410600,6762
873,794,79,1132,386000,6763
12285,8108,4177,1238,226300,6770
10407,8432,1975,1442,358800,6776
643,544,99,-,399500,6777
535,516,19,1216,302000,6778
3406,2445,961,1272,256300,6779
834,741,93,1281,275700,6782
964,784,180,1791,683700,6783
1589,1458,131,1895,533400,6784
333,272,61,-,883100,6785
3662,2719,943,1160,227800,6786
2989,2376,613,1045,247900,6787
14671,9399,5272,1086,181100,6790
2083,1947,136,1634,345100,6791
546,336,210,1739,957100,6793
410,274,136,1130,382700,6794
5390,4361,1029,1132,310700,6795
358,310,48,2015,476800,6796
4494,3466,1028,1584,431000,6798
7390,5795,1595,1457,404100,6801
6679,5628,1051,1854,421600,6804
2725,1858,867,2448,1235700,6807
20150,8941,11209,1743,322200,6810
11447,8734,2713,1652,381300,6811
4590,4219,371,1946,416900,6812
7116,6028,1088,3484,1601600,6820
11781,9901,1880,2167,786000,6824
7051,5650,1401,1831,571900,6825
9423,5128,4295,2256,1719600,6830
5197,3886,1311,2422,1523700,6831
7039,5985,1054,3278,1434400,6840
7721,4438,3283,2155,521800,6850
11224,6593,4631,1925,514200,6851
1200,975,225,1672,1342900,6853
11722,5438,6284,1699,428600,6854
3387,1883,1504,1825,495400,6855
2734,2210,524,"3,500+",1566400,6870
9202,7851,1351,2025,757900,6877
2623,2207,416,1929,1704500,6878
9759,8647,1112,2143,1206500,6880
3549,3453,96,"3,500+",927800,6883
1644,1485,159,2947,1062300,6890
3363,2971,392,1211,634300,6896
6210,5511,699,1685,863000,6897
5494,611,4883,2120,453300,6901
28447,11086,17361,2078,482200,6902
4668,4236,432,"3,500+",853100,6903
7988,4737,3251,2315,588500,6905
3456,1707,1749,2112,557600,6906
3427,2229,1198,2023,537600,6907
5394,2801,2593,1722,326700,7001
27198,10654,16544,1474,413100,7002
20573,10583,9990,1702,425100,7003
2951,2410,541,2568,621400,7004
5589,3896,1693,1699,552300,7005
9997,7557,2440,1908,642300,7006
8162,4444,3718,1833,337200,7008
4888,4097,791,1557,583600,7009
10526,5084,5442,1743,520800,7010
13784,6033,7751,1578,383200,7011
5389,2916,2473,1691,423900,7012
11514,8369,3145,1658,450400,7013
1783,1306,477,1773,417600,7014
9164,7192,1972,1952,608700,7016
15026,4609,10417,1284,290300,7017
11276,2780,8496,1404,270900,7018
7024,2969,4055,2580,750200,7020
726,707,19,"3,500+",945500,7021
5823,1895,3928,1517,475600,7022
2808,2438,370,2254,588100,7023
18304,10694,7610,2161,393200,7024
11544,5375,6169,1491,430500,7026
1956,1000,956,1575,469800,7027
2540,2419,121,2042,693100,7028
9377,2146,7231,1934,422100,7029
27879,9589,18290,2648,859300,7030
6634,3116,3518,1656,442700,7031
14703,6933,7770,1557,404000,7032
2802,1844,958,1884,462100,7033
4158,2480,1678,1402,390400,7034
4136,3197,939,1658,408200,7035
15976,9337,6639,1541,355300,7036
10378,9037,1341,2818,709800,7039
8401,6467,1934,1990,638000,7040
2589,1786,803,1933,941800,7041
10925,5592,5333,1956,673900,7042
4284,3585,699,2294,883400,7043
5821,4644,1177,1939,577100,7044
3720,3664,56,2250,649900,7045
1430,1376,54,"3,500+",869800,7046
23959,10296,13663,1630,446200,7047
12306,2740,9566,1410,304300,7050
17344,12464,4880,1729,472300,7052
11963,5958,6005,1646,558400,7054
20182,4446,15736,1341,379800,7055
4994,1720,3274,1454,452200,7057
2208,1441,767,2249,678600,7058
5554,4922,632,2032,862800,7059
15678,6140,9538,1489,339400,7060
4593,2912,1681,1674,348700,7062
4237,2655,1582,1669,345600,7063
1210,1122,88,1307,399100,7064
12079,6655,5424,1646,343200,7065
5902,4526,1376,1734,546800,7066
6220,5558,662,1835,439800,7067
2451,1884,567,3092,614300,7068
2324,2033,291,2302,788800,7069
6755,4211,2544,1700,572300,7070
9055,5227,3828,1705,477100,7071
2586,1543,1043,1493,517200,7072
4258,1444,2814,1712,446900,7073
950,668,282,1111,416400,7074
3851,2432,1419,1764,499700,7075
8823,7352,1471,1790,663700,7076
1084,786,298,1387,360300,7077
4513,3932,581,"3,500+",1566500,7078
5863,3842,2021,2186,769100,7079
8139,6950,1189,1881,417500,7080
6610,4082,2528,2089,552400,7081
1968,1871,97,1848,633300,7082
19742,14742,5000,1879,404400,7083
7862,2719,5143,2314,770600,7086
25610,5048,20562,1415,448000,7087
1145,673,472,1825,333600,7088
10439,8331,2108,2179,889400,7090
2537,2141,396,"3,500+",719000,7092
25581,6895,18686,1595,388200,7093
8607,4369,4238,2154,557800,7094
7812,4187,3625,1973,344200,7095
6288,400,5888,1159,368400,7102
12793,2949,9844,1216,238900,7103
20197,5475,14722,1280,330000,7104
19484,3380,16104,1520,430000,7105
12682,4319,8363,1163,282800,7106
15112,4664,10448,1239,317400,7107
11130,1850,9280,1055,298200,7108
13715,7403,6312,1551,360700,7109
11676,7926,3750,1622,462500,7110
22178,6593,15585,1273,258900,7111
10823,3029,7794,1301,291200,7112
4205,870,3335,625,409300,7114
9545,2157,7388,1414,363800,7201
14985,3694,11291,1407,328600,7202
8223,4391,3832,1367,293300,7203
5100,3069,2031,1455,359400,7204
7248,5066,2182,1596,339700,7205
8839,2350,6489,1457,296300,7206
12119,3238,8881,1309,408700,7208
26529,6595,19934,2792,862800,7302
19122,5494,13628,1500,466000,7304
25628,10968,14660,1523,400600,7305
22582,5292,17290,1522,477600,7306
17132,5748,11384,1591,546600,7307
7122,785,6337,3327,859300,7310
1163,0,1163,"3,500+",-,7311
2271,1817,454,2589,731300,7401
2949,1935,1014,1795,364200,7403
6810,5448,1362,1563,521900,7405
7220,3892,3328,1979,434900,7407
12309,9755,2554,1836,488300,7410
2576,1635,941,1136,236400,7416
3770,3316,454,3043,1135700,7417
900,887,13,-,309600,7418
4057,3138,919,1711,273300,7419
1857,1311,546,1714,332900,7420
2803,2563,240,2192,354300,7421
2149,2066,83,1660,270700,7422
1409,1299,110,1914,949800,7423
10925,7353,3572,1720,449700,7424
9644,7759,1885,2186,565900,7430
2882,1968,914,1750,559200,7432
1030,787,243,2527,455400,7435
4378,3989,389,1536,535900,7436
4346,3920,426,1377,385300,7438
827,767,60,1538,277100,7439
1506,1343,163,921,493800,7440
4227,3301,926,1716,373900,7442
4704,3843,861,3370,484600,7444
5221,4400,821,2134,657400,7446
8703,7228,1475,2349,858300,7450
3652,3298,354,1909,786300,7452
4256,4038,218,2178,417500,7456
1904,1334,570,2568,383000,7457
3924,3441,483,2871,1156400,7458
1329,1215,114,2220,333500,7460
6980,5802,1178,1467,326100,7461
3042,2453,589,1563,240300,7462
3423,3104,319,1964,546200,7463
2420,1972,448,2058,360200,7465
18907,14738,4169,2038,565700,7470
5924,5233,691,1384,338200,7480
5837,5307,530,2175,885400,7481
12172,1648,10524,1353,283300,7501
4561,2526,2035,1418,329700,7502
6291,1814,4477,1525,313500,7503
4163,1492,2671,1441,359900,7504
1552,54,1498,1009,375000,7505
7585,5148,2437,1746,481500,7506
8064,5102,2962,1693,412500,7508
3781,2929,852,1620,470700,7512
3161,1000,2161,1524,344200,7513
6167,1912,4255,1406,271200,7514
7140,1498,5642,1368,209400,7522
4471,1120,3351,1377,353200,7524
19770,7214,12556,1750,353000,7601
3199,2155,1044,1771,429100,7603
4283,3049,1234,1587,488700,7604
3441,2310,1131,1947,619700,7605
918,458,460,1801,447000,7606
3702,2593,1109,1880,470100,7607
27,0,27,1783,-,7608
515,480,35,2750,"2,000,000+",7620
9306,6473,2833,1651,437700,7621
2721,2194,527,2558,774100,7624
3060,2461,599,2075,722000,7626
1690,1437,253,"3,500+",938700,7627
6593,4760,1833,1710,439800,7628
2626,2321,305,2024,610800,7630
11317,6178,5139,1729,453200,7631
1860,1539,321,"3,500+",1231400,7632
1737,1696,41,"3,500+",689900,7640
1069,993,76,-,777400,7641
3416,3102,314,1755,636600,7642
4334,1742,2592,1705,389800,7643
9279,4112,5167,1596,423900,7644
3066,2576,490,2038,673700,7645
6170,3920,2250,1669,480000,7646
1704,1341,363,1697,554300,7647
1964,1667,297,2121,633800,7648
2733,2460,273,1917,692200,7649
7119,2669,4450,1897,671400,7650
8410,6853,1557,2648,684800,7652
3203,2629,574,1887,661300,7656
4028,1859,2169,1782,556000,7657
5070,2775,2295,1598,444600,7660
4369,3414,955,1789,625000,7661
2376,1876,500,1683,455400,7662
5321,3572,1749,1912,440800,7663
13333,10376,2957,1721,479700,7666
5076,3772,1304,3053,951100,7670
9609,7390,2219,2143,655400,7675
3362,3200,162,2057,616800,7676
2120,1878,242,2120,891300,7677
11091,7343,3748,1900,489600,7701
1388,1201,187,"3,500+",698900,7702
0,0,0,-,-,7703
2106,1954,152,"3,500+",898200,7704
637,534,103,1567,921200,7711
17324,8746,8578,1437,504100,7712
3661,2438,1223,1795,572700,7716
868,594,274,1628,1168500,7717
2411,2288,123,1542,460600,7718
9034,6651,2383,1695,589600,7719
1923,878,1045,1678,830400,7720
1466,746,720,1912,337500,7721
3546,3260,286,2475,847000,7722
296,163,133,1345,1382600,7723
9848,6994,2854,1557,438000,7724
16290,14179,2111,1798,568200,7726
2588,2171,417,1436,578000,7727
20738,16046,4692,1768,454400,7728
6370,5796,574,1188,434400,7730
13289,11966,1323,2164,418700,7731
2536,1705,831,1725,398200,7732
6026,5443,583,3115,801100,7733
5101,3079,2022,1558,283200,7734
7895,6095,1800,1328,342000,7735
1490,1332,158,1440,433800,7737
2324,2119,205,871,674300,7738
2248,2162,86,"3,500+",817200,7739
12876,5520,7356,1646,450400,7740
5984,5715,269,2736,609200,7746
13137,10019,3118,1894,438200,7747
10117,8582,1535,1512,523400,7748
1520,1183,337,2097,912700,7750
7231,6548,683,2443,658800,7751
15885,10723,5162,1639,370200,7753
2027,1635,392,2331,592200,7755
1838,942,896,1324,771700,7756
2459,2277,182,-,644200,7757
1641,1306,335,1191,431300,7758
3471,3018,453,1891,1178200,7760
4018,2667,1351,1693,746000,7762
2747,2008,739,1862,611600,7764
8899,4247,4652,1714,342100,7801
1396,1269,127,1807,363600,7803
0,0,0,-,-,7820
3567,3237,330,1622,380300,7821
322,322,0,-,424300,7822
3558,2321,1237,866,292300,7823
3519,3131,388,1479,400800,7825
2171,1917,254,1669,341900,7826
1626,1492,134,1350,277900,7827
5697,3050,2647,1443,386000,7828
2863,2703,160,1614,609800,7830
16,16,0,-,-,7831
1256,1136,120,1676,321100,7832
61,61,0,-,243800,7833
6773,5746,1027,1777,512700,7834
4638,3174,1464,1822,482300,7836
1234,1082,152,1777,363600,7838
12790,9062,3728,1417,353500,7840
0,0,0,-,-,7842
4399,3770,629,1608,286500,7843
46,11,35,1243,-,7844
8,8,0,-,-,7846
701,573,128,2062,325700,7847
1550,1333,217,1407,406000,7848
3308,2963,345,1537,407900,7849
2475,1894,581,1667,351300,7850
160,144,16,-,316000,7851
1578,1315,263,1547,426600,7852
4266,4089,177,1760,561300,7853
1915,1267,648,2299,381600,7856
1894,978,916,1383,332600,7857
10347,8272,2075,1396,319100,7860
1506,1303,203,1341,263600,7863
755,594,161,1943,418100,7865
8381,6982,1399,1600,409900,7866
9086,6834,2252,1739,618400,7869
13,13,0,-,-,7870
7675,6899,776,1800,454900,7871
3124,2835,289,1859,302900,7874
3232,2997,235,2105,467900,7876
311,311,0,-,406600,7878
101,87,14,-,378600,7880
4,4,0,-,-,7881
5892,3932,1960,1252,312700,7882
4580,2956,1624,1878,324600,7885
8727,5919,2808,2146,904500,7901
10400,8709,1691,2262,732900,7920
3845,3003,842,2164,419100,7921
4153,3965,188,-,684600,7922
2630,2333,297,2003,712900,7924
24,11,13,-,-,7926
1713,1018,695,2846,592400,7927
6635,5541,1094,2277,976200,7928
2758,2539,219,1674,738100,7930
1237,1081,156,2625,986000,7931
4476,3094,1382,2891,699000,7932
996,931,65,-,594000,7933
629,520,109,2136,778100,7934
186,186,0,-,763700,7935
3908,3677,231,3033,669000,7936
17,0,17,-,-,7939
5541,3529,2012,2168,845500,7940
3390,3054,336,2833,883100,7945
971,939,32,-,741700,7946
8176,6287,1889,2516,556400,7950
18499,11570,6929,2154,678700,7960
0,0,0,-,-,7961
71,71,0,-,-,7970
4615,3915,700,1974,698100,7974
158,87,71,-,"2,000,000+",7976
213,110,103,1719,1020800,7977
82,82,0,-,-,7979
908,681,227,1736,622700,7980
3726,3324,402,2620,604900,7981
308,254,54,1578,292200,8001
9304,6350,2954,1773,280900,8002
11485,9869,1616,1717,385100,8003
4014,3315,699,1396,244000,8004
10385,9306,1079,1770,315300,8005
201,188,13,-,921900,8006
2528,1435,1093,1146,222100,8007
3421,3129,292,1719,964000,8008
5523,4306,1217,1459,274200,8009
4229,3076,1153,1404,216300,8010
9,9,0,-,-,8011
15487,10448,5039,1461,253800,8012
91,91,0,-,212500,8014
7131,5971,1160,1164,199800,8015
12907,9519,3388,1220,286600,8016
355,310,45,2219,358100,8019
1100,1038,62,-,327400,8020
20321,10106,10215,1194,178800,8021
3636,3473,163,1348,380200,8022
98,70,28,1682,153800,8023
782,711,71,-,264800,8026
1958,1642,316,1320,217600,8027
7921,4955,2966,1465,259300,8028
2307,1681,626,783,201000,8029
4868,3087,1781,1413,158000,8030
4834,2976,1858,1081,199600,8031
64,64,0,-,313600,8032
6466,4850,1616,1377,519600,8033
7861,6273,1588,1644,301400,8034
3184,2457,727,1192,341200,8035
2459,2256,203,1147,388100,8036
9163,7184,1979,1287,280300,8037
157,86,71,1405,159300,8038
5,5,0,-,-,8039
382,369,13,-,475500,8041
19,19,0,-,243800,8042
12002,7729,4273,1664,380400,8043
1146,780,366,1087,209800,8045
10679,8631,2048,1923,218300,8046
4812,3626,1186,1546,395900,8048
2117,1597,520,1157,205400,8049
10697,9378,1319,1686,346700,8050
4406,3406,1000,1653,240200,8051
8680,3978,4702,1452,220300,8052
19097,13819,5278,1826,349700,8053
18904,14449,4455,1872,314800,8054
10534,9249,1285,1552,432900,8055
1698,1642,56,-,401100,8056
7633,6545,1088,1400,588100,8057
2231,1440,791,1234,203800,8059
9658,6984,2674,1458,273900,8060
1337,1314,23,-,334600,8061
5691,5320,371,999,439200,8062
1062,931,131,1168,179700,8063
44,44,0,-,-,8064
3200,2389,811,1637,203100,8065
3416,2236,1180,1152,161900,8066
545,475,70,1609,300400,8067
2711,1642,1069,1148,242600,8068
5229,2941,2288,1175,161000,8069
5121,3973,1148,1183,180800,8070
3825,2777,1048,1336,235800,8071
104,79,25,-,114800,8072
0,0,0,-,-,8073
0,0,0,-,-,8074
11810,7930,3880,1386,269100,8075
7299,6262,1037,1795,331600,8077
3061,2086,975,1316,184800,8078
4168,2381,1787,1033,169100,8079
13882,12133,1749,1676,311900,8080
17361,14359,3002,1459,236800,8081
3843,2977,866,1187,233700,8083
2612,1960,652,1109,219900,8084
7075,5901,1174,1780,329800,8085
3556,2437,1119,1690,237600,8086
10560,8916,1644,1631,289700,8087
9364,8964,400,2093,323900,8088
1398,1310,88,933,230300,8089
3089,2778,311,1156,247200,8090
2266,1527,739,1339,239200,8091
1184,964,220,1159,424800,8092
4304,2356,1948,1236,178800,8093
14910,12504,2406,1376,243600,8094
0,0,0,-,-,8095
13660,10141,3519,1368,233600,8096
1164,1105,59,1328,230300,8097
3373,2515,858,1262,294100,8098
3058,653,2405,1062,83600,8102
4179,1542,2637,1119,89100,8103
8272,2646,5626,1044,79900,8104
8200,3725,4475,1146,105900,8105
3872,2468,1404,1046,279500,8106
5740,2981,2759,1209,238400,8107
8753,5642,3111,1492,326400,8108
8796,6380,2416,1137,210600,8109
6162,4557,1605,1160,175100,8110
4086,2641,1445,1699,224900,8201
816,790,26,1625,1468800,8202
3748,2696,1052,1481,423000,8203
7787,6059,1728,1180,345900,8204
11068,8812,2256,1509,247400,8205
7285,5776,1509,1469,311800,8210
85,85,0,-,984000,8212
5482,3960,1522,1163,246300,8215
0,0,0,-,-,8217
2655,2394,261,1780,338700,8221
1893,1640,253,1565,324600,8223
57,57,0,-,296700,8224
3159,2783,376,1543,252200,8225
5521,3980,1541,1404,664100,8226
2289,2185,104,1801,393000,8230
6438,3216,3222,1127,159100,8232
16186,13503,2683,1519,266500,8234
4,4,0,-,-,8240
434,423,11,-,359800,8241
1754,1296,458,1704,314700,8242
1127,1046,81,1210,903100,8243
4791,2457,2334,1218,251200,8244
0,0,0,-,-,8245
30,30,0,-,-,8246
532,464,68,1625,1622300,8247
64,64,0,-,966200,8248
4573,3879,694,1396,247500,8251
6626,4296,2330,1167,416200,8260
3186,2607,579,1146,292100,8270
14417,8312,6105,1229,190400,8302
516,395,121,1098,109500,8310
549,467,82,1250,199500,8311
3080,2236,844,1180,233500,8312
217,202,15,-,191700,8314
96,60,36,-,138000,8316
569,473,96,-,281600,8317
4372,3607,765,1228,244900,8318
463,455,8,-,280500,8319
0,0,0,-,-,8320
57,57,0,-,170800,8321
3483,3122,361,1509,252900,8322
271,232,39,1063,255300,8323
118,53,65,1193,211000,8324
370,275,95,1660,200900,8326
198,166,32,-,-,8327
577,475,102,-,201700,8328
144,144,0,-,302500,8329
11768,8593,3175,1552,225900,8330
14498,9859,4639,1223,185300,8332
385,300,85,1247,245300,8340
811,365,446,1057,190800,8341
1531,1439,92,2529,311300,8343
1887,1780,107,1427,201200,8344
337,310,27,1313,174200,8345
185,185,0,-,215400,8346
66,58,8,-,219800,8348
845,531,314,1683,139900,8349
156,156,0,-,234200,8350
85,35,50,1889,-,8352
115,90,25,1142,192300,8353
15527,10149,5378,1146,186000,8360
6544,5204,1340,1294,260200,8361
16514,5082,11432,1059,174400,8401
2584,2319,265,1298,572100,8402
495,445,50,2229,981300,8403
4307,2741,1566,1488,319900,8406
2460,2251,209,1543,507800,8501
3827,3164,663,2290,735700,8502
7216,5147,2069,1463,341600,8505
1928,1848,80,2204,618200,8510
329,214,115,1138,334000,8511
4812,3022,1790,1620,605700,8512
2071,1917,154,1425,485900,8514
2333,2217,116,2165,501900,8515
2123,1447,676,1231,266500,8518
10480,7377,3103,1533,339600,8520
1928,1611,317,1809,496500,8525
20767,17973,2794,1673,440600,8527
151,151,0,-,-,8528
3330,2577,753,1705,541200,8530
2346,1730,616,1457,448700,8533
4688,3967,721,1828,545500,8534
1646,1430,216,2219,645700,8535
8395,3720,4675,1849,603100,8536
17578,11247,6331,2060,708700,8540
1139,512,627,2652,686000,8542
13,0,13,-,-,8544
7658,5890,1768,2688,714400,8550
2057,1861,196,2241,543200,8551
295,254,41,1521,587000,8553
1533,1335,198,1495,188400,8554
335,274,61,2540,346500,8555
2643,2297,346,1636,774900,8558
2045,1849,196,2000,560600,8559
1426,1295,131,2231,414800,8560
138,63,75,-,430900,8561
1527,1142,385,1118,230600,8562
460,51,409,1024,-,8608
4607,1442,3165,1129,90700,8609
11672,7759,3913,1412,230000,8610
10738,4231,6507,1283,117300,8611
13813,5487,8326,1084,185400,8618
9470,6516,2954,1600,297700,8619
4265,3462,803,1370,316300,8620
4070,2629,1441,1458,331700,8628
4260,3119,1141,1232,131800,8629
8698,5088,3610,1507,209800,8638
891,2,889,2374,-,8640
1433,27,1406,2404,-,8641
11517,7827,3690,1914,383700,8648
7962,6703,1259,1602,334700,8690
6857,5467,1390,1851,479000,8691
30816,15914,14902,1623,412600,8701
214,178,36,-,632800,8720
8016,6830,1186,1474,334200,8721
3935,3541,394,2067,280800,8722
12891,10183,2708,1531,359100,8723
16199,13294,2905,1758,348300,8724
1846,1731,115,2543,771800,8730
8454,7155,1299,2016,330600,8731
685,624,61,1600,469900,8732
1033,615,418,1559,198200,8733
2597,2414,183,1625,370500,8734
2087,1730,357,1494,805600,8735
5266,4723,543,1590,778000,8736
595,525,70,1946,1422400,8738
743,594,149,1779,323000,8740
1079,1039,40,1156,376800,8741
10303,8182,2121,1836,517000,8742
1540,1304,236,2061,1009800,8750
1877,1136,741,1321,547900,8751
1269,1019,250,1418,747000,8752
24808,20006,4802,1620,357200,8753
10400,8363,2037,1519,352300,8755
18015,15517,2498,1707,232100,8757
3221,2786,435,1536,427300,8758
19956,17412,2544,1290,162000,8759
2669,2242,427,1914,500800,8801
1478,1423,55,2338,414400,8802
1168,885,283,972,403900,8804
5374,2686,2688,1731,376000,8805
13811,11593,2218,1879,542900,8807
2334,1763,571,1558,422800,8809
2804,2462,342,1975,466800,8810
4530,3456,1074,1518,413100,8812
16822,13943,2879,1873,462600,8816
16297,8746,7551,1878,379000,8817
13067,9803,3264,1883,584900,8820
166,166,0,-,472600,8821
11704,9249,2455,1612,493200,8822
3508,2472,1036,2219,264300,8823
4447,3884,563,1966,574300,8824
1916,1474,442,1628,447000,8825
2083,1784,299,1388,418200,8826
1553,1376,177,1167,392000,8827
968,677,291,1869,303000,8828
1436,1108,328,1476,296600,8829
6444,4428,2016,1999,369700,8830
23193,20774,2419,1739,451000,8831
892,147,745,1657,356000,8832
3606,3140,466,1811,536100,8833
4391,3327,1064,1673,301300,8835
1278,1251,27,-,722100,8836
7102,3423,3679,1715,392800,8837
6221,4820,1401,1922,488300,8840
15582,12892,2690,2188,504400,8844
5580,4196,1384,1471,390200,8846
3043,2826,217,1581,375600,8848
3015,2504,511,1715,419100,8850
7073,4765,2308,1799,447900,8852
1963,1608,355,1666,626800,8853
17079,11237,5842,1846,403100,8854
15633,10396,5237,1433,438800,8857
0,0,0,-,-,8858
8790,5192,3598,1547,376900,8859
19610,7185,12425,1556,329600,8861
4438,3073,1365,1870,382900,8863
13261,8911,4350,1226,225600,8865
2035,1904,131,-,564700,8867
3262,1857,1405,1810,435800,8869
7415,4519,2896,1437,377000,8872
21244,14426,6818,1924,410800,8873
8984,5843,3141,1682,447500,8876
9209,5435,3774,1641,355600,8879
1951,1145,806,1598,316600,8880
5555,3624,1931,1615,360800,8882
3202,2677,525,1124,354900,8884
2414,2217,197,1591,402900,8886
581,329,252,1703,244600,8887
4212,3799,413,1827,490500,8889
8,0,8,-,-,8890
15626,3156,12470,1754,289800,8901
15824,9260,6564,1906,377300,8902
6547,2512,4035,1755,420900,8904
14375,3422,10953,2625,535100,10001
36028,6224,29804,1136,784800,10002
24987,8927,16060,2731,1111000,10003
2123,893,1230,"3,500+",1792200,10004
4881,814,4067,"3,500+",1750000,10005
2046,363,1683,"3,500+",1066700,10006
3084,1053,2031,"3,500+","2,000,000+",10007
29670,2835,26835,1832,714100,10009
16050,4628,11422,2899,1093900,10010
28874,10558,18316,2637,1151800,10011
11529,2355,9174,2624,1455300,10012
12753,3759,8994,2113,"2,000,000+",10013
17504,4974,12530,2852,1427900,10014
30162,8224,21938,3048,953300,10016
9155,2799,6356,2854,850100,10017
4704,584,4120,"3,500+",911900,10018
26297,6052,20245,2328,958800,10019
0,0,0,-,-,10020
20568,9179,11389,2754,1572800,10021
18153,8865,9288,2754,1125600,10022
35742,13634,22108,2744,1525300,10023
29472,11294,18178,2760,1743700,10024
41653,13115,28538,1885,1105100,10025
15237,3014,12223,1507,1030400,10026
24387,3249,21138,1523,872800,10027
24440,8713,15727,2550,1572100,10028
33406,2284,31122,1137,735700,10029
13097,1881,11216,1245,710500,10030
22037,2866,19171,1794,629900,10031
22285,2071,20214,1519,593000,10032
20521,3023,17498,1674,702500,10033
15879,1449,14430,1588,491200,10034
14833,1445,13388,1116,661800,10035
18916,1563,17353,2269,1450400,10036
10103,683,9420,1470,-,10037
10646,2859,7787,3082,886400,10038
12177,1814,10363,1158,576900,10039
16541,2442,14099,1623,454000,10040
5039,1045,3994,3082,932000,10044
16113,5236,10877,2792,1522200,10065
3142,1024,2118,3286,1817100,10069
12839,5818,7021,2328,1205100,10075
0,0,0,-,-,10103
0,0,0,-,-,10110
0,0,0,-,-,10111
0,0,0,-,-,10112
0,0,0,-,-,10115
0,0,0,-,-,10119
29328,9084,20244,2434,1365400,10128
0,0,0,-,-,10152
0,0,0,-,-,10153
0,0,0,-,-,10154
896,0,896,"3,500+",-,10162
0,0,0,-,-,10165
0,0,0,-,-,10167
0,0,0,-,-,10168
0,0,0,-,-,10169
0,0,0,-,-,10170
0,0,0,-,-,10171
0,0,0,-,-,10172
0,0,0,-,-,10173
0,0,0,-,-,10174
0,0,0,-,-,10177
0,0,0,-,-,10199
0,0,0,-,-,10271
0,0,0,-,-,10278
75,0,75,"3,500+",-,10279
4293,1345,2948,"3,500+",793600,10280
2635,240,2395,"3,500+","2,000,000+",10282
14400,6635,7765,1643,642300,10301
5945,3329,2616,1701,529600,10302
8675,5534,3141,1399,433600,10303
15553,7756,7797,1365,653100,10304
15780,10380,5400,1517,614700,10305
19872,14392,5480,1579,653300,10306
5217,4216,1001,1449,785200,10307
10472,8287,2185,1668,630000,10308
11792,9431,2361,1983,699200,10309
9145,5338,3807,1660,596200,10310
0,0,0,-,-,10311
21324,17473,3851,1773,665100,10312
31825,23891,7934,1631,649200,10314
20965,2973,17992,1257,243400,10451
28260,933,27327,1323,474400,10452
28456,1338,27118,1362,524600,10453
14737,840,13897,954,782900,10454
16254,1907,14347,1130,344100,10455
32370,2021,30349,1163,403600,10456
26163,1636,24527,1381,265200,10457
29116,1210,27906,1512,476200,10458
17805,2301,15504,1292,570600,10459
21814,2216,19598,1299,576500,10460
18807,5933,12874,1675,626700,10461
29806,6603,23203,1652,398700,10462
29607,10217,19390,1592,349300,10463
1990,1318,672,1794,630700,10464
16168,8911,7257,1680,587400,10465
24622,9810,14812,1474,577600,10466
38433,5256,33177,1482,411000,10467
28228,2147,26081,1508,278200,10468
23337,11950,11387,1634,615600,10469
6351,2329,4022,1581,536400,10470
8924,4997,3927,1680,371400,10471
22114,3685,18429,1392,581100,10472
22795,6448,16347,1120,542600,10473
3808,380,3428,1280,434900,10474
18383,7750,10633,1207,30800,10475
474,454,20,-,795700,10501
1892,1559,333,"3,500+",811800,10502
57,57,0,-,591900,10503
2634,2422,212,2326,1137300,10504
430,279,151,1309,836400,10505
2144,2050,94,3170,1041600,10506
1952,1063,889,1830,626300,10507
7187,5782,1405,1681,407300,10509
3835,3080,755,2146,815200,10510
796,667,129,1577,465200,10511
9276,7841,1435,1421,379300,10512
4159,3834,325,2489,973700,10514
2316,1733,583,1638,597900,10516
154,75,79,1375,569700,10517
339,317,22,-,729200,10518
43,0,43,-,-,10519
5015,3417,1598,1731,648900,10520
3794,2363,1431,2315,714500,10522
3221,1748,1473,2743,480000,10523
1533,1342,191,1922,510400,10524
696,638,58,2311,685700,10526
204,188,16,-,651900,10527
4611,2642,1969,2585,892800,10528
6358,5363,995,2078,459500,10530
1796,1597,199,3090,659700,10532
2416,1920,496,2460,903200,10533
135,54,81,2095,340000,10535
3507,3048,459,3000,832700,10536
944,732,212,2258,304700,10537
6237,5058,1179,2151,1124600,10538
0,0,0,-,-,10540
8833,7664,1169,1926,448300,10541
0,0,0,-,-,10542
7486,4666,2820,1951,729100,10543
0,0,0,-,-,10545
398,358,40,"3,500+",825400,10546
2785,1805,980,1964,475600,10547
1332,1071,261,1448,413000,10548
5952,4595,1357,1752,638000,10549
15636,3875,11761,1367,453000,10550
9431,5701,3730,1686,410600,10552
3655,1836,1819,1635,451600,10553
1738,1504,234,2269,635600,10560
12050,7441,4609,2018,464600,10562
10884,6242,4642,1798,365000,10566
6454,5997,457,2078,489100,10567
4292,3732,560,1814,819000,10570
13602,7503,6099,1991,631200,10573
1777,1657,120,"3,500+",955800,10576
760,736,24,-,1455900,10577
536,536,0,-,620000,10578
2893,2640,253,2090,471900,10579
6297,4588,1709,2466,1762700,10580
14167,11984,2183,2441,1123800,10583
1217,725,492,1597,458200,10588
3469,3027,442,3254,488300,10589
2622,2458,164,2557,659000,10590
9609,4901,4708,1838,646800,10591
1724,1526,198,1842,693600,10594
2309,1613,696,1640,667800,10595
364,187,177,1569,422900,10596
206,206,0,-,964300,10597
10478,9310,1168,2025,564800,10598
5430,2147,3283,2043,367300,10601
7260,4431,2829,1887,494900,10603
3972,2360,1612,1974,743700,10604
7849,5773,2076,2044,746600,10605
6084,2565,3519,2269,635500,10606
2316,1765,551,1953,619100,10607
26991,8008,18983,1622,400300,10701
7940,4387,3553,1550,452700,10703
12255,7759,4496,1812,479000,10704
15085,5493,9592,1589,447700,10705
3359,2655,704,1911,837200,10706
4185,2389,1796,1978,676000,10707
9512,7161,2351,1986,481000,10708
3666,2772,894,1939,833200,10709
10044,7166,2878,1750,511500,10710
15602,6303,9299,1739,525100,10801
4302,3496,806,2203,927000,10803
5086,4824,262,2017,870700,10804
8124,3414,4710,1789,364900,10805
9227,6671,2556,1684,463800,10901
0,0,0,-,-,10910
6,0,6,-,-,10911
1479,1413,66,2308,600600,10913
89,89,0,-,292800,10914
0,0,0,-,-,10915
1401,1272,129,1263,434000,10916
553,469,84,-,382900,10917
4119,3335,784,1574,406600,10918
508,502,6,-,327500,10919
2801,2458,343,2259,498800,10920
1503,1209,294,1767,358800,10921
537,282,255,1458,345900,10922
2803,1898,905,1735,441600,10923
4617,3624,993,1511,394500,10924
1647,1281,366,1467,322700,10925
1529,942,587,1946,304400,10926
3686,1914,1772,1703,324800,10927
2215,1208,1007,1683,277700,10928
3320,3069,251,1904,398700,10930
343,180,163,1851,435800,10931
21,21,0,-,-,10932
130,98,32,-,314300,10933
18375,11515,6860,1515,268100,10940
5376,3381,1995,1540,296900,10941
15293,9531,5762,1557,418600,10950
10867,4542,6325,1633,750900,10952
0,0,0,-,-,10953
9363,6616,2747,2226,464200,10954
9397,8806,591,1823,610300,10956
912,807,105,2190,332900,10958
5822,2991,2831,1998,632000,10960
1659,1461,198,1410,617200,10962
1282,870,412,910,284700,10963
567,535,32,-,713900,10964
5487,4138,1349,1967,515900,10965
1199,731,468,2038,695800,10968
338,331,7,-,374100,10969
4054,2951,1103,1813,413500,10970
799,695,104,1691,374400,10973
1256,1054,202,2306,401400,10974
106,28,78,2132,168400,10975
593,367,226,-,550400,10976
16488,7698,8790,1655,574200,10977
0,0,0,-,-,10979
4776,4182,594,1592,452800,10980
1976,1832,144,2244,578500,10983
1037,990,47,-,480900,10984
30,30,0,-,-,10985
552,491,61,2031,543800,10986
1449,1180,269,1265,655200,10987
234,142,92,1458,248200,10988
3348,2975,373,1924,472300,10989
7919,6178,1741,1319,425000,10990
3254,2724,530,1453,353000,10992
1551,947,604,1528,275500,10993
2242,2194,48,1364,592300,10994
1063,0,1063,3441,-,10996
1106,961,145,1653,427100,10998
8519,7297,1222,2046,684600,11001
12607,10139,2468,2234,535600,11003
5290,3588,1702,1954,647400,11004
1555,1461,94,2211,603900,11005
8278,6930,1348,2082,632100,11010
1793,1564,229,2764,1136900,11020
8151,5708,2443,2096,710500,11021
3011,2554,457,-,1087200,11023
2260,1818,442,2400,1562000,11024
5867,5249,618,2352,1726300,11030
13670,11984,1686,2493,769800,11040
0,0,0,-,-,11042
11603,8004,3599,2450,960000,11050
2558,1202,1356,1752,562000,11096
16488,2351,14137,2556,1011200,11101
12164,1862,10302,2184,798900,11102
15516,2523,12993,2042,998200,11103
11991,2416,9575,1908,678900,11104
15851,4314,11537,2162,1054000,11105
18516,3375,15141,1936,662700,11106
3326,841,2485,"3,500+",544600,11109
32227,11212,21015,3110,1123700,11201
29411,11496,17915,1495,646400,11203
25118,9032,16086,1677,1066800,11204
16861,4897,11964,2107,883100,11205
32698,3629,29069,1434,849400,11206
34831,9925,24906,1476,632600,11207
34321,9513,24808,1506,621500,11208
30179,10920,19259,1801,935000,11209
21652,9404,12248,1695,799700,11210
26822,3976,22846,2267,1138900,11211
32091,4632,27459,1150,565200,11212
26281,4204,22077,1550,1100100,11213
31366,10564,20802,1666,947700,11214
29465,11906,17559,2673,1597400,11215
26311,6658,19653,2048,1360500,11216
18912,5561,13351,2651,1603300,11217
26048,9884,16164,1879,920900,11218
24031,6470,17561,1627,1055800,11219
27907,7685,20222,1641,978800,11220
35245,7467,27778,1937,1082200,11221
19108,3508,15600,2479,1242800,11222
26748,9623,17125,1596,1037900,11223
19486,5838,13648,925,500700,11224
24873,4505,20368,1730,1170800,11225
38458,5427,33031,1672,807000,11226
15474,8700,6774,1732,1122100,11228
30751,14866,15885,1586,809600,11229
31897,9641,22256,1680,859100,11230
16498,5058,11440,2309,1836600,11231
9589,2170,7419,1865,837000,11232
32516,8023,24493,1510,992800,11233
32606,22285,10321,1732,715400,11234
34769,13076,21693,1595,727200,11235
33986,17127,16859,1608,676300,11236
17513,1908,15605,1998,949700,11237
26492,7650,18842,2368,1145100,11238
8367,845,7522,1018,467600,11239
17047,3218,13829,2644,1249000,11249
20980,8015,12965,1707,513300,11354
29690,8671,21019,1625,718600,11355
8391,4275,4116,2034,856500,11356
15508,11685,3823,2184,906800,11357
13179,7854,5325,1939,938200,11358
0,0,0,-,-,11359
8692,6495,2197,2145,679500,11360
10886,6751,4135,2302,870100,11361
7164,5398,1766,2426,669000,11362
2855,2031,824,2334,986000,11363
13822,9690,4132,2268,758300,11364
16361,7838,8523,1708,885800,11365
4640,3174,1466,2022,928200,11366
14647,6927,7720,1711,631500,11367
30123,6617,23506,1884,797200,11368
9736,5477,4259,1888,704400,11369
8140,4012,4128,2044,844700,11370
0,0,0,-,-,11371
25359,8982,16377,1760,428800,11372
32644,9001,23643,1835,659200,11373
19800,7960,11840,1953,481200,11374
33312,17601,15711,2046,559400,11375
33239,10186,23053,1743,645900,11377
12818,6660,6158,1931,815800,11378
13810,8022,5788,1881,863900,11379
37167,11181,25986,1857,834400,11385
6602,5674,928,1650,591400,11411
11753,8768,2985,1554,597500,11412
13512,9886,3626,1970,612700,11413
11401,8799,2602,1978,596300,11414
8588,3613,4975,1863,373500,11415
7485,3691,3794,1840,724200,11416
9377,5321,4056,1847,669800,11417
11681,5739,5942,1775,729400,11418
12908,8089,4819,1868,654700,11419
13836,9940,3896,1969,654700,11420
11840,6164,5676,1903,665300,11421
10019,6916,3103,2115,599100,11422
9946,5768,4178,1662,678700,11423
0,0,0,-,-,11424
6108,4326,1782,2131,653300,11426
8046,5087,2959,1665,678400,11427
6153,4565,1588,1763,645300,11428
8038,5820,2218,1452,609200,11429
0,0,0,-,-,11430
20036,8050,11986,1768,781100,11432
10886,5100,5786,1321,586800,11433
22986,11074,11912,1375,551800,11434
19350,6813,12537,1775,525000,11435
6136,4151,1985,2018,573500,11436
0,0,0,-,-,11439
0,0,0,-,-,11451
8586,5432,3154,2193,596600,11501
2388,2212,176,2649,793600,11507
720,673,47,2942,908800,11509
11222,9941,1281,1876,530000,11510
1773,1138,635,2308,673000,11514
2864,2014,850,2127,801900,11516
4099,3077,1022,2158,563000,11518
14326,9934,4392,1902,445800,11520
9544,8569,975,"3,500+",928600,11530
10965,6311,4654,2296,629700,11542
4326,3888,438,2146,973700,11545
227,160,67,1695,887500,11547
435,362,73,-,655900,11548
0,0,0,-,-,11549
17780,8305,9475,1669,425300,11550
7362,6566,796,2655,577300,11552
7151,5397,1754,2014,448000,11553
11716,10418,1298,2673,594400,11554
0,0,0,-,-,11556
2611,2330,281,2523,692400,11557
3058,2055,1003,2187,578100,11558
2537,1956,581,2012,1082500,11559
2436,1997,439,2161,872900,11560
16004,10188,5816,2362,644000,11561
7661,5756,1905,2029,590700,11563
3128,2983,145,1883,601100,11565
11346,10808,538,2632,656100,11566
1005,940,65,"3,500+","2,000,000+",11568
556,455,101,"3,500+",876200,11569
10810,8288,2522,1709,753300,11570
10315,9438,877,2049,608100,11572
4534,3437,1097,2583,413100,11575
4399,3903,496,2171,1192000,11576
4177,3840,337,1847,933600,11577
1828,1504,324,2233,898700,11579
13176,11058,2118,1943,575600,11580
7011,5792,1219,1960,623700,11581
14766,11623,3143,2331,594500,11590
3440,2875,565,2019,760900,11596
3935,3369,566,2568,915900,11598
21687,6096,15591,1424,632300,11691
8128,2919,5209,1305,591800,11692
5274,2377,2897,1137,458800,11693
7994,4201,3793,1688,810500,11694
1533,1485,48,-,660700,11697
9163,6001,3162,2058,454300,11701
5487,4472,1015,2369,558900,11702
5491,4638,853,2154,448600,11703
13096,9761,3335,2072,444600,11704
3034,2555,479,2208,591600,11705
18997,14318,4679,1845,432600,11706
2656,2311,345,1958,653500,11709
11228,10221,1007,2169,619500,11710
3253,2167,1086,2687,416400,11713
7898,7295,603,2204,559300,11714
1554,1346,208,2200,542400,11715
3457,2783,674,2358,460600,11716
14779,11873,2906,1660,416200,11717
1020,964,56,1938,672200,11718
1110,857,253,1461,521700,11719
8956,7389,1567,2299,438500,11720
2388,2284,104,2950,720000,11721
9864,7354,2510,2120,365800,11722
963,932,31,-,1480400,11724
9083,8363,720,2272,623200,11725
6198,4655,1543,1904,417700,11726
11356,7500,3856,2375,363100,11727
8684,7409,1275,1844,471500,11729
5075,4227,848,2404,542200,11730
10674,9748,926,2084,603200,11731
1520,940,580,2657,735900,11732
6010,5133,877,2369,629400,11733
11114,9008,2106,2089,540700,11735
5639,4621,1018,2662,431800,11738
511,488,23,-,824100,11739
3550,2903,647,1338,631600,11740
9151,7123,2028,2297,471000,11741
4555,3695,860,2145,450900,11742
15183,13559,1624,2252,714300,11743
21462,18289,3173,1995,618400,11746
7501,6698,803,2877,720400,11747
1113,1077,36,1830,422500,11749
5178,4332,846,2311,469300,11751
3076,2653,423,2459,456600,11752
4059,3431,628,2433,928200,11753
6790,5723,1067,1877,566000,11754
4100,3351,749,2136,513400,11755
13886,13085,801,2323,505900,11756
14762,12282,2480,1893,449600,11757
19029,17717,1312,2220,600400,11758
7657,7535,122,-,614500,11762
9579,8606,973,2165,408300,11763
4214,3444,770,1220,548700,11764
235,206,29,3083,"2,000,000+",11765
3839,3750,89,3308,590000,11766
4756,4235,521,2233,597100,11767
7916,7184,732,2319,732300,11768
3360,2795,565,2109,543700,11769
48,40,8,-,516700,11770
3640,2662,978,2000,857700,11771
16983,11884,5099,1977,420300,11772
8202,6491,1711,2165,442500,11776
3561,2609,952,2142,640300,11777
4576,4285,291,1774,380000,11778
13069,9695,3374,1976,433100,11779
5463,4862,601,2198,659900,11780
5522,4130,1392,2227,552700,11782
7101,6808,293,2639,603000,11783
8204,7169,1035,2247,406500,11784
1924,1851,73,2810,487200,11786
11804,10300,1504,2293,622000,11787
5548,4473,1075,2492,617200,11788
2753,2269,484,2726,347900,11789
4488,4002,486,2836,579700,11790
8110,7538,572,2540,877400,11791
3062,2899,163,2896,514700,11792
10348,9851,497,2142,612700,11793
0,0,0,-,-,11794
8176,7917,259,2392,554300,11795
1352,1084,268,2287,513400,11796
3045,2709,336,3205,948500,11797
5004,3717,1287,2100,390400,11798
12823,11072,1751,2539,588700,11801
10338,9610,728,2660,690900,11803
1388,1252,136,-,721300,11804
11406,7872,3534,1864,396200,11901
353,311,42,-,1842500,11930
0,0,0,-,-,11931
402,335,67,-,"2,000,000+",11932
2981,2685,296,2181,398400,11933
2709,2423,286,2118,500400,11934
1208,1085,123,2165,826000,11935
8336,6646,1690,2483,940700,11937
722,649,73,2227,793200,11939
1929,1456,473,2219,563300,11940
869,815,54,-,582600,11941
2267,1979,288,1866,750700,11942
2203,1544,659,1942,720100,11944
6458,4986,1472,2302,652800,11946
69,69,0,-,-,11947
228,228,0,-,792500,11948
4996,4231,765,2216,520100,11949
4689,3824,865,1848,317300,11950
4819,3878,941,2068,296500,11951
2186,2029,157,1349,673300,11952
5660,3901,1759,1902,332200,11953
1580,1328,252,2532,1071700,11954
1452,627,825,2152,421500,11955
145,124,21,2250,1009600,11956
638,595,43,2469,843900,11957
384,230,154,1611,810100,11958
249,184,65,2820,1581300,11959
430,417,13,-,1091400,11960
5625,4958,667,1762,372200,11961
161,142,19,-,"2,000,000+",11962
3556,2980,576,2896,1058900,11963
1228,1087,141,-,934900,11964
347,261,86,-,1058000,11965
8315,7548,767,2208,356300,11967
5314,4445,869,2320,1208100,11968
275,275,0,-,-,11970
2515,2048,467,2157,695100,11971
181,90,91,-,569400,11972
0,0,0,-,-,11973
213,203,10,-,"2,000,000+",11975
1140,1038,102,3142,"2,000,000+",11976
1100,1014,86,2045,945300,11977
1506,1235,271,2285,856000,11978
2217,1586,631,2429,372500,11980
145,133,12,-,284200,12007
166,166,0,-,228800,12008
3169,2543,626,1216,305900,12009
11020,6761,4259,903,149300,12010
1615,1359,256,1263,261200,12015
212,202,10,833,164300,12017
2895,2401,494,1290,288300,12018
6493,5199,1294,1238,350900,12019
14308,10152,4156,1490,283500,12020
359,306,53,1097,182800,12022
848,708,140,1111,247300,12023
52,50,2,-,-,12024
2257,1790,467,883,187700,12025
1608,1312,296,2027,307100,12027
378,296,82,897,197800,12028
496,423,73,1336,337300,12029
70,51,19,704,264600,12031
318,307,11,-,159500,12032
3387,2653,734,1332,262200,12033
205,174,31,-,186300,12035
78,71,7,-,120800,12036
1733,1255,478,1010,300700,12037
19,19,0,-,-,12040
136,115,21,-,192400,12041
134,106,28,-,226300,12042
2789,1877,912,847,163200,12043
186,108,78,1500,137900,12045
265,225,40,-,263900,12046
9684,4751,4933,1210,221500,12047
1472,961,511,885,316200,12051
701,662,39,1339,230900,12052
1622,1421,201,736,254600,12053
6967,5419,1548,1530,309100,12054
749,669,80,1099,293100,12056
727,627,100,1090,211400,12057
492,413,79,865,269600,12058
608,550,58,1117,289600,12059
774,691,83,1923,348800,12060
4037,3101,936,1637,301000,12061
704,538,166,1137,203600,12062
282,282,0,-,244700,12063
123,92,31,1125,99500,12064
18043,12873,5170,1337,335600,12065
776,690,86,1071,192600,12066
596,498,98,1130,327000,12067
875,726,149,764,155700,12068
164,164,0,-,139600,12069
784,571,213,770,140200,12070
99,80,19,725,172900,12071
987,843,144,947,158200,12072
1121,1020,101,1200,249500,12074
1104,928,176,1233,345500,12075
573,528,45,975,191000,12076
2634,2012,622,1245,324300,12077
9563,5855,3708,853,112700,12078
2,2,0,-,-,12082
1212,960,252,880,232100,12083
2204,535,1669,1467,301000,12084
114,12,102,973,-,12085
674,579,95,845,193300,12086
441,406,35,-,234600,12087
2251,1612,639,781,178800,12090
674,480,194,1091,189500,12092
613,538,75,738,148800,12093
864,839,25,-,233600,12094
5312,3609,1703,859,156000,12095
1002,852,150,1182,287700,12106
128,88,40,958,229200,12108
8009,5086,2923,1397,285600,12110
49,49,0,-,602300,12115
574,485,89,974,124200,12116
1264,1052,212,906,179500,12117
7205,4810,2395,997,311900,12118
254,234,20,-,270700,12120
728,708,20,-,231400,12121
1758,1310,448,881,159600,12122
2092,1724,368,899,249800,12123
121,121,0,-,344800,12124
427,328,99,915,238600,12125
140,110,30,-,188200,12130
76,61,15,950,146900,12131
66,66,0,-,335300,12132
1721,1317,404,811,193400,12134
331,304,27,-,410300,12136
748,623,125,-,268000,12137
1243,1125,118,1308,157800,12138
94,87,7,-,235400,12139
580,479,101,797,287100,12140
2202,1592,610,1031,227900,12143
9413,5411,4002,1304,228200,12144
218,212,6,-,246400,12147
1892,1543,349,1163,380000,12148
930,684,246,754,145800,12149
278,274,4,-,185800,12150
384,342,42,1667,280500,12151
303,287,16,-,286300,12153
1202,1074,128,844,239600,12154
694,588,106,1042,140500,12155
278,259,19,-,208500,12156
1798,1550,248,888,196800,12157
2687,1920,767,1569,277500,12158
3702,2787,915,1510,402300,12159
376,304,72,1056,135900,12160
18,10,8,-,-,12161
173,133,40,950,187500,12164
105,93,12,-,366300,12165
583,542,41,-,187500,12166
1034,736,298,796,174200,12167
696,582,114,1103,221900,12168
192,154,38,-,159400,12169
2107,1701,406,1175,252200,12170
63,2,61,1035,-,12172
729,575,154,1119,196800,12173
215,197,18,-,99000,12174
279,244,35,-,144200,12175
160,139,21,-,211800,12176
165,143,22,-,98000,12177
22006,9997,12009,1137,211600,12180
6737,3287,3450,961,180000,12182
1344,369,975,990,151400,12183
2859,2255,604,1081,281400,12184
688,551,137,908,212700,12185
2536,2168,368,1118,305200,12186
294,246,48,771,196300,12187
5011,3509,1502,1103,270700,12188
8731,3417,5314,1047,193200,12189
203,169,34,758,196200,12190
569,501,68,-,208000,12192
773,733,40,-,234300,12193
58,50,8,-,220000,12194
98,67,31,-,-,12195
1310,1158,152,1041,281000,12196
733,673,60,822,146600,12197
2907,2254,653,1154,263300,12198
4632,948,3684,971,131100,12202
13830,6792,7038,1312,247100,12203
4120,1163,2957,1247,240200,12204
11444,8216,3228,1346,251700,12205
6394,1431,4963,1139,118400,12206
1310,35,1275,827,-,12207
10520,4752,5768,1168,243200,12208
4303,2921,1382,1128,184100,12209
5278,1290,3988,1066,153600,12210
4154,3778,376,2392,354400,12211
15,0,15,-,-,12222
0,0,0,-,-,12226
11061,8189,2872,1193,223200,12302
11740,8655,3085,1056,217200,12303
8715,5046,3669,1057,152600,12304
3445,467,2978,938,140000,12305
11109,7882,3227,1156,196800,12306
3145,893,2252,1026,98000,12307
5938,2653,3285,1055,164600,12308
12675,10424,2251,1362,284000,12309
14860,8217,6643,1230,254900,12401
1591,1268,323,1119,311900,12404
235,222,13,-,176800,12405
298,190,108,849,-,12406
43,32,11,-,266700,12407
415,314,101,1415,494500,12409
219,187,32,-,253400,12410
181,165,16,-,245600,12411
248,217,31,-,-,12412
1249,698,551,1320,175600,12413
4277,2878,1399,1066,220900,12414
135,135,0,-,271300,12416
376,372,4,-,-,12417
120,86,34,1554,214300,12418
351,259,92,1324,285200,12419
93,93,0,-,187500,12420
114,114,0,-,321400,12421
185,161,24,-,174300,12422
462,354,108,939,150000,12423
155,140,15,-,208300,12424
133,133,0,-,-,12427
2852,1735,1117,1054,186300,12428
49,0,49,-,-,12429
560,502,58,915,223500,12430
709,632,77,784,207500,12431
279,86,193,1534,305900,12432
265,255,10,-,416700,12433
439,346,93,927,142900,12434
82,82,0,-,266300,12435
241,181,60,-,231200,12436
15,15,0,-,-,12438
128,122,6,-,-,12439
640,569,71,732,373600,12440
66,38,28,-,188000,12441
357,207,150,1111,284700,12442
1577,1443,134,1281,274400,12443
162,155,7,-,418300,12444
2032,1556,476,1188,277400,12446
85,67,18,-,625000,12448
1175,678,497,1434,221500,12449
96,68,28,-,172900,12450
399,313,86,1092,198600,12451
14,11,3,-,-,12452
100,87,13,-,-,12453
152,142,10,-,360000,12454
780,564,216,861,254200,12455
258,228,30,-,153600,12456
571,360,211,1383,-,12457
948,722,226,1686,172200,12458
35,35,0,-,202500,12459
108,97,11,-,-,12460
634,479,155,-,373600,12461
642,463,179,1000,232100,12463
572,442,130,1413,356500,12464
195,175,20,572,362300,12465
842,670,172,1543,259400,12466
550,493,57,520,222100,12468
367,367,0,-,191600,12469
234,223,11,-,192300,12470
268,238,30,-,229300,12471
603,332,271,1020,266900,12472
227,184,43,-,199000,12473
428,360,68,735,187500,12474
212,130,82,-,276300,12475
8078,5520,2558,1218,279800,12477
156,156,0,-,248400,12480
589,545,44,2192,225000,12481
166,121,45,821,166000,12482
41,41,0,-,-,12483
1433,1356,77,-,400300,12484
287,168,119,-,366700,12485
643,513,130,1714,252600,12486
1422,1108,314,1522,275400,12487
92,66,26,-,223200,12489
0,0,0,-,-,12490
832,775,57,-,314000,12491
84,84,0,-,277800,12492
76,59,17,-,-,12493
374,360,14,-,347700,12494
80,54,26,-,342900,12495
503,432,71,784,257700,12496
2415,1742,673,1547,503000,12498
924,460,464,1271,290200,12501
400,356,44,1066,307900,12502
274,230,44,785,454100,12503
0,0,0,-,-,12504
79,32,47,2193,300000,12507
7855,4577,3278,1621,370800,12508
86,86,0,-,412500,12512
94,77,17,-,-,12513
1266,1236,30,-,377500,12514
536,395,141,1089,326300,12515
729,639,90,1060,223100,12516
175,73,102,1063,351200,12517
2300,1478,822,1675,350300,12518
1226,887,339,1373,420300,12520
722,664,58,1542,341900,12521
1829,1246,583,1148,279000,12522
839,658,181,1055,312800,12523
6617,4362,2255,1601,360600,12524
651,416,235,1407,348000,12525
1518,1243,275,965,338300,12526
9,9,0,-,-,12527
5502,3834,1668,1629,306200,12528
1075,785,290,979,354900,12529
44,44,0,-,-,12530
971,855,116,-,396200,12531
8558,7812,746,1570,409900,12533
7524,4519,3005,1186,242800,12534
5525,3707,1818,1171,281700,12538
3075,2679,396,1890,407100,12540
2292,1706,586,1216,323600,12542
1336,683,653,1542,228700,12543
15,15,0,-,-,12544
2159,1380,779,1123,410700,12545
1181,911,270,1298,289700,12546
1323,950,373,1774,363600,12547
383,270,113,1629,305700,12548
3648,2961,687,1536,356000,12549
20141,11217,8924,1396,276800,12550
10121,7197,2924,1488,331100,12553
6351,3761,2590,1544,359400,12561
2248,1864,384,1811,353000,12563
2826,2128,698,1381,402600,12564
559,326,233,921,172000,12565
4238,3306,932,1538,319700,12566
1032,825,207,1460,308600,12567
3879,2669,1210,1823,327500,12569
2295,2018,277,1623,404900,12570
3688,2987,701,1388,372400,12571
4258,3004,1254,1484,449000,12572
153,153,0,-,375700,12574
467,407,60,-,405900,12575
542,464,78,1741,438300,12577
864,725,139,1781,354800,12578
1730,1560,170,976,354700,12580
866,634,232,1333,328600,12581
1556,1385,171,1916,426400,12582
734,505,229,1438,365200,12583
393,342,51,-,505700,12585
4627,3265,1362,1394,304500,12586
5291,4067,1224,1088,321300,12589
14527,10027,4500,1566,351100,12590
450,309,141,736,258100,12592
1684,1306,378,1103,306600,12594
16935,6970,9965,1310,258000,12601
16848,12339,4509,1480,314600,12603
52,0,52,-,-,12604
4726,2027,2699,941,176500,12701
553,470,83,896,258000,12719
48,48,0,-,-,12720
2402,1798,604,1139,295600,12721
0,0,0,-,-,12722
809,640,169,1032,194500,12723
40,34,6,-,300000,12724
81,73,8,-,239700,12725
595,520,75,1280,303200,12726
580,427,153,1404,267400,12729
462,439,23,1063,228100,12732
97,9,88,1585,-,12733
403,292,111,-,172100,12734
78,68,10,-,128600,12736
569,525,44,1063,248700,12737
104,39,65,1292,248200,12738
726,549,177,1156,274000,12740
99,43,56,1138,364300,12741
88,75,13,-,333000,12742
142,131,11,-,309200,12743
5,5,0,-,-,12745
244,209,35,1656,217900,12746
786,497,289,878,279900,12747
778,626,152,1155,230700,12748
143,100,43,1156,-,12749
28,25,3,-,-,12750
393,184,209,1208,114100,12751
167,98,69,926,306700,12752
2634,1129,1505,943,180800,12754
1964,1710,254,953,162300,12758
608,388,220,1082,71400,12759
206,160,46,-,166100,12760
123,77,46,1099,-,12762
305,248,57,1353,171400,12763
835,702,133,902,214500,12764
378,354,24,-,297700,12765
293,247,46,-,356600,12766
74,68,6,-,-,12767
326,285,41,-,368900,12768
170,139,31,-,406900,12769
86,79,7,-,284500,12770
5484,3244,2240,1191,221800,12771
943,787,156,1435,357400,12775
760,668,92,1317,226900,12776
346,340,6,-,310100,12777
205,163,42,-,161200,12778
849,431,418,897,283000,12779
997,702,295,1145,216300,12780
86,86,0,-,418900,12781
639,493,146,1161,187800,12783
0,0,0,-,-,12784
330,330,0,-,220600,12785
274,274,0,-,158900,12786
66,63,3,-,-,12787
845,610,235,905,220800,12788
932,501,431,860,139000,12789
1789,1449,340,1343,183800,12790
230,223,7,-,213500,12791
85,80,5,-,235700,12792
6680,3396,3284,1022,180800,12801
3764,2179,1585,1114,218200,12803
12266,8866,3400,1185,276700,12804
108,105,3,-,282800,12808
1430,1252,178,1037,210900,12809
215,199,16,1063,191900,12810
84,84,0,-,212500,12811
54,54,0,-,356300,12812
635,577,58,1090,239000,12814
552,424,128,944,238300,12815
2009,1639,370,964,189800,12816
921,748,173,786,274100,12817
111,85,26,1071,145200,12819
32,32,0,-,-,12820
122,72,50,-,209500,12821
2396,1825,571,913,171300,12822
166,157,9,-,194800,12823
482,445,37,-,343300,12824
1463,1227,236,972,190400,12827
3875,3112,763,1066,202000,12828
6968,5354,1614,1286,300200,12831
2697,2039,658,763,145100,12832
2137,1873,264,1094,304500,12833
2497,1981,516,1088,226800,12834
1204,997,207,897,218400,12835
266,253,13,980,311500,12836
337,284,53,1066,144400,12837
301,241,60,-,165200,12838
6123,3534,2589,975,157800,12839
67,65,2,-,1004000,12841
316,262,54,713,190300,12842
284,273,11,-,166700,12843
114,114,0,-,-,12844
1994,1544,450,1067,345300,12845
1622,1347,275,863,198800,12846
236,219,17,695,210600,12847
159,107,52,-,-,12849
1041,901,140,1320,264300,12850
132,124,8,950,122000,12851
178,163,15,-,196500,12852
578,447,131,1006,185800,12853
36,36,0,-,-,12854
105,100,5,-,144400,12855
177,100,77,-,234600,12856
326,264,62,875,216300,12857
75,75,0,-,375000,12858
682,585,97,1343,330100,12859
150,138,12,-,221100,12860
218,193,25,950,208300,12861
139,78,61,-,184100,12862
312,247,65,893,270700,12863
3,3,0,-,-,12864
1364,1090,274,1000,156200,12865
17410,10902,6508,1526,399300,12866
749,586,163,686,247300,12870
1694,1231,463,1080,226000,12871
53,53,0,-,-,12872
355,242,113,862,245300,12873
87,66,21,-,400000,12874
271,241,30,850,161200,12878
2042,1343,699,842,160800,12883
241,145,96,959,156500,12884
2073,1532,541,938,145400,12885
103,103,0,-,332400,12886
1625,1166,459,954,137500,12887
14030,7688,6342,937,171100,12901
841,446,395,1401,163400,12903
607,451,156,1004,115200,12910
0,0,0,-,-,12911
717,651,66,739,167200,12912
434,344,90,505,190500,12913
351,254,97,719,87000,12914
34,22,12,-,-,12915
992,601,391,785,97000,12916
455,374,81,828,115800,12917
1112,1030,82,-,195700,12918
1098,815,283,1010,165600,12919
1024,850,174,916,123400,12920
963,796,167,918,187500,12921
17,15,2,-,-,12922
227,183,44,435,77800,12923
80,9,71,1115,-,12924
1006,794,212,791,111500,12926
158,148,10,-,121600,12927
795,670,125,868,145700,12928
395,278,117,914,130900,12929
298,253,45,938,99300,12930
537,415,122,758,150600,12932
14,14,0,-,-,12933
476,339,137,764,97300,12934
638,550,88,829,123400,12935
310,275,35,1298,217600,12936
583,482,101,841,104800,12937
78,55,23,-,220800,12939
704,641,63,1254,196300,12941
278,254,24,1583,438900,12942
122,83,39,1313,225700,12943
1613,1183,430,1079,146900,12944
212,212,0,-,285400,12945
2225,1556,669,950,435800,12946
299,236,63,1104,152700,12950
104,73,31,823,38100,12952
4620,2937,1683,826,119000,12953
183,168,15,719,146000,12955
490,358,132,-,131800,12956
776,434,342,681,107400,12957
733,676,57,-,152700,12958
772,714,58,-,153300,12959
427,410,17,-,134300,12960
86,86,0,-,-,12961
2178,1784,394,1064,171900,12962
34,27,7,-,265600,12964
131,114,17,1057,77500,12965
1217,1022,195,763,114700,12966
487,394,93,846,79200,12967
119,102,17,-,113400,12969
151,99,52,1300,240300,12970
2813,2487,326,986,174800,12972
67,67,0,-,106300,12973
929,693,236,-,143800,12974
125,99,26,1115,185400,12975
99,85,14,-,343800,12976
5,5,0,-,-,12977
81,81,0,-,-,12978
1195,644,551,683,161600,12979
523,454,69,683,92600,12980
897,800,97,905,125200,12981
3458,2051,1407,791,187700,12983
374,331,43,-,175200,12985
2356,1674,682,650,128200,12986
73,63,10,-,191300,12987
459,437,22,-,205700,12989
1621,1248,373,950,168200,12992
740,537,203,883,182800,12993
818,688,130,942,247900,12996
558,446,112,1088,267100,12997
105,105,0,-,29300,12998
37,32,5,-,-,13020
16676,9930,6746,852,165900,13021
0,0,0,-,-,13024
565,437,128,1263,179200,13026
14585,10222,4363,1167,208100,13027
309,294,15,-,153500,13028
3006,2268,738,906,215400,13029
1537,1347,190,727,191400,13030
6840,5215,1625,1159,189300,13031
4957,3933,1024,888,144500,13032
1290,1108,182,1010,154200,13033
796,685,111,925,178800,13034
3034,2546,488,1140,250000,13035
3658,2866,792,920,162200,13036
3629,2780,849,770,191300,13037
6727,5654,1073,1104,215300,13039
1048,799,249,780,119400,13040
4473,4040,433,1325,185100,13041
852,759,93,1272,123300,13042
1172,1111,61,1025,131400,13044
10988,6331,4657,885,152200,13045
37,37,0,-,-,13051
638,517,121,725,140500,13052
1840,1350,490,900,213900,13053
420,359,61,863,188800,13054
6420,4603,1817,943,150300,13057
1156,975,181,923,114100,13060
287,259,28,491,211600,13061
111,80,31,-,257400,13062
880,798,82,847,216000,13063
97,97,0,-,98800,13065
5417,4387,1030,1174,259900,13066
2059,1492,567,994,206300,13068
9862,6593,3269,848,99600,13069
311,241,70,1013,136400,13071
342,285,57,832,99800,13072
2732,2001,731,990,168000,13073
1752,1416,336,1044,127100,13074
938,870,68,-,134800,13076
2947,2366,581,1008,163000,13077
3784,3220,564,1182,263000,13078
1419,1185,234,772,145100,13080
483,424,59,1382,258500,13081
1514,1406,108,548,165400,13082
860,674,186,913,154500,13083
1596,1215,381,1119,192500,13084
68,64,4,-,170700,13087
10472,6070,4402,1031,159500,13088
11996,8184,3812,1207,184400,13090
1025,868,157,1167,159000,13092
945,658,287,858,115300,13101
29,29,0,-,-,13102
123,100,23,1589,16100,13103
6436,5223,1213,1064,284200,13104
2712,2118,594,957,216800,13108
907,832,75,1034,233700,13110
595,491,104,936,133300,13111
598,494,104,1109,157200,13112
26,26,0,-,98000,13113
3013,2358,655,820,144300,13114
91,68,23,1167,97600,13115
1445,1096,349,1063,157100,13116
108,68,40,-,103400,13117
2113,1713,400,810,151100,13118
0,0,0,-,-,13119
897,834,63,950,107000,13120
0,0,0,-,-,13121
468,390,78,919,295800,13122
32,32,0,-,-,13123
46,43,3,-,157500,13124
13759,9084,4675,955,131300,13126
1297,1084,213,720,124000,13131
1636,1503,133,1039,189000,13132
25,25,0,-,126600,13134
2349,1660,689,939,150000,13135
135,113,22,700,104000,13136
52,52,0,-,-,13138
1690,1334,356,951,114100,13140
269,247,22,962,146600,13141
2442,1883,559,819,137200,13142
847,747,100,959,115900,13143
462,386,76,723,89400,13144
708,478,230,812,139500,13145
752,572,180,711,96100,13146
359,301,58,825,139700,13147
4908,3328,1580,866,124400,13148
3270,2673,597,1301,397100,13152
112,104,8,-,229400,13153
11,11,0,-,-,13154
223,180,43,827,95000,13155
982,864,118,-,150000,13156
301,213,88,924,107200,13157
525,382,143,768,154300,13158
2036,1752,284,970,212700,13159
798,612,186,923,163900,13160
206,115,91,949,177500,13162
104,104,0,-,159400,13163
914,854,60,1097,200000,13164
4108,2842,1266,874,113600,13165
2420,1900,520,988,151800,13166
1222,1019,203,1299,150600,13167
3292,265,3027,864,82100,13202
7813,2668,5145,871,135500,13203
8512,2689,5823,968,95500,13204
7223,3295,3928,870,93000,13205
7850,4169,3681,887,119800,13206
5391,3579,1812,1059,102600,13207
9046,4115,4931,949,99700,13208
5933,4204,1729,989,144500,13209
7723,2056,5667,994,172400,13210
2389,1787,602,1122,106100,13211
8924,6731,2193,1013,146700,13212
3097,2229,868,983,207800,13214
5549,4612,937,1127,263600,13215
6309,5328,981,1029,164500,13219
3632,2363,1269,979,188200,13224
5,0,5,-,-,13244
0,0,0,-,-,13290
64,64,0,-,300000,13301
591,495,96,1034,107300,13302
534,466,68,729,143400,13303
753,584,169,1320,243900,13304
91,60,31,-,129200,13305
1684,1399,285,1009,120400,13308
2622,1875,747,751,181500,13309
280,233,47,-,145600,13310
159,140,19,-,229200,13312
235,173,62,680,70200,13313
32,32,0,-,101800,13314
529,446,83,822,192400,13315
2691,2302,389,828,137400,13316
1266,987,279,830,115300,13317
383,370,13,-,157400,13318
311,186,125,807,96500,13319
708,637,71,779,187300,13320
458,277,181,1052,-,13321
392,340,52,1118,201800,13322
4376,2994,1382,1068,217400,13323
734,659,75,853,135700,13324
403,355,48,781,117100,13325
1877,1429,448,1102,321500,13326
810,666,144,753,156700,13327
616,557,59,800,180000,13328
1468,1002,466,794,110000,13329
42,42,0,-,450000,13331
880,741,139,1125,118600,13332
34,13,21,-,162500,13333
433,294,139,746,134100,13334
482,354,128,650,119900,13335
321,197,124,1101,280900,13337
592,539,53,950,148100,13338
2082,1677,405,862,95100,13339
3159,2623,536,852,138500,13340
81,75,6,-,-,13342
678,582,96,726,155700,13343
79,66,13,-,121100,13345
1770,1284,486,982,213900,13346
608,491,117,890,182100,13348
4163,2639,1524,776,117900,13350
2,2,0,-,-,13352
21,19,2,-,153100,13353
1245,1135,110,856,190800,13354
369,324,45,847,168200,13355
4482,3129,1353,709,99500,13357
41,40,1,-,288900,13360
248,203,45,583,161900,13361
902,843,59,1327,178000,13363
98,98,0,-,123400,13364
3193,2462,731,724,126100,13365
3511,2611,900,747,153900,13367
447,397,50,688,110500,13368
541,422,119,1054,98200,13402
1921,1509,412,1110,200700,13403
52,35,17,-,84400,13404
177,171,6,-,149500,13406
1924,1550,374,693,125200,13407
792,655,137,896,156400,13408
818,755,63,854,119900,13409
285,189,96,584,46700,13410
1137,912,225,638,114300,13411
6831,5099,1732,1127,205500,13413
39,39,0,-,154400,13415
862,734,128,724,154600,13416
1655,826,829,807,149200,13417
72,34,38,1672,115600,13418
529,469,60,-,342400,13420
5539,3685,1854,841,136500,13421
920,770,150,1188,178600,13424
756,597,159,804,116700,13425
658,489,169,456,160400,13428
699,573,126,941,178000,13431
626,488,138,686,96300,13433
75,62,13,-,137500,13435
49,37,12,-,305000,13436
125,114,11,-,88900,13437
1283,1077,206,808,170400,13438
1364,1080,284,815,177500,13439
17390,11168,6222,860,140100,13440
146,0,146,884,-,13441
69,50,19,-,-,13450
1858,1417,441,692,98800,13452
318,289,29,784,-,13454
11,8,3,-,-,13455
1459,1256,203,950,228400,13456
23,10,13,-,82500,13457
792,587,205,1050,156400,13459
1632,1308,324,810,117700,13460
1323,970,353,930,192600,13461
522,435,87,1105,64600,13464
104,60,44,713,100000,13468
476,462,14,-,194300,13469
241,202,39,725,145600,13470
1072,935,137,1091,112900,13471
111,111,0,-,295500,13472
418,406,12,960,139900,13473
23,14,9,-,-,13475
1210,791,419,806,161400,13476
556,425,131,685,102100,13477
1299,1146,153,864,183300,13478
1327,966,361,863,152000,13480
25,25,0,-,165400,13482
138,71,67,777,98000,13483
29,29,0,-,-,13484
521,458,63,856,121600,13485
333,283,50,1008,132900,13486
74,63,11,-,77500,13488
200,183,17,765,155700,13489
427,427,0,-,201500,13490
1336,1106,230,748,138500,13491
4779,3747,1032,968,168300,13492
776,660,116,840,105800,13493
97,92,5,-,125000,13494
943,580,363,875,131300,13495
14933,7624,7309,837,128700,13501
13471,7943,5528,919,138700,13502
16574,8314,8260,960,164100,13601
0,0,0,-,-,13602
4626,127,4499,1475,-,13603
1987,1513,474,808,174900,13605
933,834,99,1250,177800,13606
900,537,363,778,165500,13607
688,511,177,796,125200,13608
137,112,25,-,167700,13611
1199,794,405,885,194900,13612
1088,819,269,690,113900,13613
106,66,40,786,79300,13614
274,211,63,771,166900,13615
990,284,706,1144,141800,13616
4181,2248,1933,919,143300,13617
785,695,90,850,179500,13618
4165,2327,1838,1035,151300,13619
802,643,159,950,164200,13620
220,145,75,-,127100,13621
729,666,63,797,223100,13622
30,30,0,-,-,13623
1922,1285,637,934,192600,13624
612,547,65,844,147700,13625
931,763,168,852,166100,13626
96,69,27,963,113400,13628
435,378,57,574,82600,13630
51,51,0,-,-,13632
117,115,2,-,91800,13633
1498,1186,312,744,207100,13634
426,341,85,581,91200,13635
50,39,11,820,157500,13636
1854,494,1360,1295,194200,13637
124,49,75,-,153800,13638
21,21,0,-,43400,13639
156,156,0,-,341500,13640
28,28,0,-,86400,13641
3699,2727,972,826,111300,13642
24,10,14,-,-,13643
0,0,0,-,-,13645
834,654,180,844,122300,13646
67,20,47,1140,-,13647
853,700,153,792,102200,13648
16,16,0,-,-,13649
580,464,116,748,172700,13650
76,76,0,-,330000,13651
628,480,148,923,94600,13652
833,679,154,783,111100,13654
1271,1011,260,976,206800,13655
1040,809,231,443,144700,13656
992,851,141,931,124300,13658
155,146,9,-,116700,13659
617,515,102,836,120600,13660
661,623,38,-,138100,13661
7024,4601,2423,708,114400,13662
141,106,35,1038,159400,13664
308,305,3,-,121900,13665
80,44,36,-,45000,13666
1297,941,356,775,97000,13667
1289,1083,206,837,107000,13668
5810,4357,1453,738,95100,13669
159,144,15,-,57400,13670
166,89,77,894,87000,13672
796,497,299,704,186700,13673
57,57,0,-,-,13674
21,21,0,-,-,13675
5507,3344,2163,784,152000,13676
105,0,105,564,-,13678
413,388,25,1792,185500,13679
423,381,42,439,121100,13680
384,310,74,986,66800,13681
317,272,45,1075,175000,13682
27,0,27,-,-,13683
460,406,54,767,95300,13684
1080,597,483,1386,253800,13685
233,226,7,-,163700,13687
311,247,64,733,77400,13690
1135,858,277,1012,150600,13691
85,80,5,-,289100,13692
139,135,4,-,192700,13693
530,424,106,683,198100,13694
59,56,3,-,197200,13695
82,34,48,-,-,13696
831,722,109,-,127200,13697
0,0,0,-,-,13699
1298,968,330,743,115900,13730
518,455,63,1000,265900,13731
3028,2633,395,1003,168400,13732
2273,1942,331,690,122400,13733
971,921,50,-,135200,13734
736,655,81,1031,141800,13736
16,16,0,-,-,13738
345,284,61,1375,170000,13739
254,232,22,775,314600,13740
1501,1102,399,843,148400,13743
427,374,53,833,112200,13744
962,817,145,747,122300,13746
29,29,0,-,-,13747
1678,1327,351,1331,128700,13748
351,326,25,850,158000,13750
54,54,0,-,144300,13751
324,235,89,944,233000,13752
1821,1292,529,917,194800,13753
1151,918,233,696,125700,13754
398,331,67,719,123300,13755
314,269,45,-,159100,13756
545,507,38,-,172400,13757
19223,12751,6472,869,144300,13760
69,65,4,-,132300,13774
751,627,124,738,178600,13775
182,140,42,1016,147000,13776
156,143,13,-,225000,13777
2319,1708,611,760,160900,13778
324,293,31,-,133300,13780
295,218,77,826,210900,13782
1049,801,248,930,138400,13783
127,85,42,1000,"10,000-",13784
202,197,5,-,147100,13786
1356,1092,264,665,141900,13787
404,327,77,771,213000,13788
8013,4483,3530,937,113500,13790
1501,1194,307,950,127100,13795
465,323,142,950,160900,13796
786,577,209,684,99300,13797
664,568,96,910,121400,13801
540,407,133,-,-,13802
1509,1252,257,926,129200,13803
70,48,22,1054,128100,13804
92,80,12,-,194200,13806
490,391,99,747,145200,13807
542,447,95,669,134300,13808
728,612,116,892,146000,13809
500,422,78,742,212700,13810
1647,1402,245,840,121800,13811
920,734,186,1025,134300,13812
302,293,9,-,182100,13813
6,6,0,-,-,13814
5622,3650,1972,829,120900,13815
7867,4958,2909,985,166600,13820
1244,921,323,824,169000,13825
44,31,13,-,-,13826
5014,3477,1537,890,134100,13827
1988,1662,326,742,96800,13830
180,169,11,-,117000,13832
1486,1153,333,1024,128200,13833
87,46,41,-,159500,13834
538,421,117,800,97500,13835
1590,1036,554,672,99600,13838
497,423,74,775,110100,13839
207,155,52,957,101600,13841
200,182,18,1063,256700,13842
791,703,88,792,161700,13843
235,189,46,957,112500,13844
190,167,23,638,203200,13846
11,11,0,-,-,13847
1874,1554,320,759,112700,13849
9477,7297,2180,1036,171600,13850
2785,1903,882,747,139200,13856
34,25,9,-,-,13859
74,74,0,-,-,13860
269,150,119,-,180900,13861
1500,1132,368,831,130200,13862
208,187,21,-,99400,13863
623,441,182,873,116300,13864
2647,2278,369,751,145600,13865
8493,4729,3764,754,138800,13901
0,0,0,-,-,13902
8112,5201,2911,838,142100,13903
3717,2367,1350,739,111900,13904
11464,5729,5735,925,138700,13905
3950,3052,898,841,198900,14001
4201,3598,603,696,221200,14004
717,598,119,742,155700,14005
3999,3377,622,897,143600,14006
621,479,142,-,183900,14008
2514,1966,548,849,143900,14009
2277,1760,517,773,149400,14011
1094,988,106,573,151200,14012
658,564,94,885,139100,14013
10295,6476,3819,878,137900,14020
616,540,76,700,121900,14024
1596,1435,161,869,228600,14025
280,223,57,1922,188800,14026
30,11,19,-,-,14027
732,675,57,984,150600,14028
19,19,0,-,-,14029
740,616,124,736,186500,14030
4139,3284,855,927,301800,14031
3758,3444,314,1802,429200,14032
685,557,128,947,284900,14033
876,748,128,940,144100,14034
19,19,0,-,-,14035
2279,1781,498,832,163400,14036
379,347,32,-,202000,14037
40,32,8,-,166700,14039
636,606,30,-,219100,14040
64,49,15,797,97500,14041
1852,1420,432,807,99600,14042
11158,7943,3215,1025,172000,14043
2506,2005,501,869,166500,14047
6676,4246,2430,825,91600,14048
7995,6488,1507,1732,354000,14051
7210,6165,1045,925,294000,14052
514,396,118,789,155400,14054
754,664,90,648,148600,14055
93,93,0,-,-,14056
3036,2631,405,877,217300,14057
803,702,101,950,147800,14058
3743,3071,672,1213,312300,14059
189,144,45,-,92500,14060
35,30,5,-,166700,14061
1246,1057,189,914,107900,14062
5138,3372,1766,914,166900,14063
645,605,40,390,110900,14065
460,417,43,707,112900,14066
1710,1597,113,863,162700,14067
2990,2099,891,1347,326700,14068
281,225,56,-,210300,14069
2364,1763,601,735,97800,14070
8907,7029,1878,1204,277900,14072
19800,14037,5763,1073,227900,14075
1814,1530,284,750,235900,14080
1196,986,210,894,114200,14081
196,180,16,-,263100,14082
5,5,0,-,-,14083
2932,2888,44,1446,261700,14085
14852,12264,2588,959,246100,14086
558,489,69,1942,252000,14091
4922,3546,1376,976,231400,14092
21428,15374,6054,787,164600,14094
1232,1001,231,879,124900,14098
746,642,104,1055,106500,14101
562,529,33,-,297700,14102
4389,3036,1353,878,120000,14103
1860,1569,291,701,154100,14105
2114,1755,359,785,133300,14108
0,0,0,-,-,14109
1264,979,285,805,161300,14111
27,13,14,-,-,14112
305,279,26,-,154600,14113
19029,13923,5106,872,187700,14120
1427,1002,425,813,138300,14125
160,137,23,-,171200,14126
12970,9502,3468,1149,301600,14127
459,403,56,782,121100,14129
39,33,6,-,83100,14130
2077,1812,265,828,184500,14131
2468,2002,466,931,212200,14132
37,37,0,-,112500,14134
57,50,7,-,-,14135
2215,1794,421,909,124300,14136
776,541,235,846,107900,14138
739,691,48,700,230300,14139
3289,2363,926,700,180800,14141
418,372,46,1182,161500,14143
509,444,65,762,194000,14145
19202,13739,5463,992,168800,14150
95,95,0,-,135300,14166
726,617,109,697,152800,14167
27,27,0,-,-,14168
71,71,0,-,"10,000-",14169
879,749,130,1009,249600,14170
755,691,64,711,143800,14171
1327,1148,179,670,164600,14172
60,60,0,-,109400,14173
2438,2000,438,1102,230400,14174
5797,1172,4625,917,278300,14201
2103,564,1539,650,485500,14202
1615,13,1602,1084,-,14203
4353,1356,2997,758,147500,14204
9579,5827,3752,832,99200,14206
9968,3548,6420,886,97800,14207
4636,2478,2158,888,99900,14208
4313,1183,3130,978,417000,14209
6942,3299,3643,864,115000,14210
9649,4306,5343,951,72700,14211
5002,2660,2342,826,83200,14212
9649,3383,6266,1003,165500,14213
8401,3799,4602,1067,204700,14214
17139,8130,9009,932,93100,14215
11849,5616,6233,1076,259400,14216
10872,7411,3461,902,178300,14217
8933,5004,3929,815,122800,14218
5227,3761,1466,902,162700,14219
10364,7163,3201,917,160900,14220
23980,17881,6099,1452,279800,14221
6705,2538,4167,1132,402200,14222
10187,8007,2180,899,181800,14223
18002,13837,4165,1049,203200,14224
15836,11431,4405,894,140400,14225
12380,8997,3383,1071,213900,14226
10034,6678,3356,1047,171700,14227
10136,5654,4482,1205,238100,14228
0,0,0,-,-,14260
0,0,0,-,-,14261
5891,2276,3615,734,69200,14301
111,0,111,-,-,14302
2835,1252,1583,843,72800,14303
12661,9428,3233,817,141600,14304
7398,4492,2906,754,95800,14305
4964,3537,1427,806,101200,14411
50,26,24,-,-,14413
2881,2157,724,1090,182400,14414
42,31,11,1354,102200,14415
1397,1232,165,742,158300,14416
474,442,32,835,169800,14418
7239,4429,2810,953,166800,14420
658,574,84,855,142000,14422
2067,1586,481,843,173800,14423
12726,8215,4511,1157,236100,14424
5040,3440,1600,1416,196500,14425
802,623,179,781,100900,14427
3013,2503,510,1086,191900,14428
2059,1715,344,704,147100,14432
1704,1371,333,634,90600,14433
1089,970,119,1093,186600,14435
4005,3247,758,884,118100,14437
121,109,12,913,111100,14441
3454,2046,1408,1115,135500,14445
18380,14209,4171,1192,267200,14450
0,0,0,-,-,14453
3220,1749,1471,998,209400,14454
7995,5076,2919,945,157600,14456
272,260,12,775,181900,14462
141,141,0,-,142100,14463
2676,2355,321,915,140700,14464
653,623,30,664,183100,14466
4403,2969,1434,1085,198500,14467
6966,6096,870,1132,199400,14468
2631,2198,433,842,176200,14469
3276,2718,558,804,134300,14470
1360,1060,300,1071,173400,14471
3474,2634,840,958,293900,14472
134,134,0,-,345700,14475
936,833,103,1016,165400,14476
651,595,56,-,159000,14477
273,204,69,964,278100,14478
45,45,0,-,158100,14479
262,193,69,942,-,14480
727,622,105,875,154700,14481
3614,2747,867,915,151500,14482
1628,1284,344,808,182200,14485
107,84,23,-,157700,14486
2245,1874,371,854,200800,14487
2745,2073,672,933,95800,14489
4192,3517,675,908,203000,14502
662,531,131,1073,101500,14504
2036,1707,329,668,160400,14505
372,322,50,1200,280700,14506
407,375,32,1406,133700,14507
2010,1522,488,793,92400,14510
114,96,18,-,124300,14511
1923,1633,290,838,166500,14512
5743,3916,1827,951,122500,14513
2538,1696,842,1324,189200,14514
89,89,0,-,85600,14515
875,759,116,1215,121500,14516
1184,866,318,806,112200,14517
5271,4427,844,891,198800,14519
1201,961,240,850,134700,14521
4100,3133,967,845,141200,14522
1002,858,144,864,149200,14525
7957,6719,1238,1141,242400,14526
4923,3561,1362,744,172200,14527
17,17,0,-,-,14529
2490,1848,642,750,125400,14530
1633,1351,282,838,151400,14532
783,587,196,864,184500,14533
12514,11252,1262,1611,309300,14534
279,191,88,658,97800,14536
61,49,12,-,130200,14537
63,56,7,-,168200,14539
845,618,227,1124,206700,14541
0,0,0,-,-,14542
1399,1335,64,1045,231700,14543
808,564,244,1144,169100,14544
45,45,0,-,75000,14545
2146,1404,742,1219,167300,14546
1725,1355,370,885,136700,14548
152,152,0,-,102900,14549
558,412,146,643,106200,14550
2321,1853,468,821,114100,14551
650,578,72,-,201000,14555
0,0,0,-,-,14556
41,41,0,-,93400,14557
7322,5906,1416,1104,201000,14559
986,810,176,1097,175600,14560
999,939,60,1205,182300,14561
6529,5203,1326,1366,339500,14564
2541,2409,132,856,170200,14568
2957,1852,1105,828,144900,14569
551,489,62,1345,159100,14571
1884,1551,333,775,106100,14572
23601,16932,6669,1314,238700,14580
102,71,31,650,"10,000-",14585
4639,3695,944,1496,236200,14586
0,0,0,-,-,14588
3033,2476,557,872,169000,14589
2242,1778,464,821,94800,14590
679,582,97,767,141500,14591
58,58,0,-,155000,14592
1850,71,1779,1167,677500,14604
4217,1104,3113,777,80600,14605
10969,6983,3986,984,137300,14606
10688,1928,8760,1072,296800,14607
5732,1252,4480,915,164600,14608
17796,10714,7082,1095,131700,14609
7248,3926,3322,1153,221700,14610
7063,2133,4930,984,73400,14611
15325,10752,4573,1003,177300,14612
5730,1928,3802,929,98700,14613
109,6,103,1588,-,14614
7924,4174,3750,1025,111100,14615
11548,8073,3475,1118,130600,14616
9520,8020,1500,1106,165800,14617
8281,6408,1873,1250,267300,14618
5467,3474,1993,1103,101700,14619
12175,3670,8505,1139,186700,14620
12987,4495,8492,931,76400,14621
5789,4735,1054,1045,145000,14622
8825,4514,4311,1169,157000,14623
15478,12336,3142,1212,162400,14624
4805,4163,642,1319,221400,14625
12943,8788,4155,1109,174200,14626
0,0,0,-,-,14627
0,0,0,-,-,14642
17033,9743,7290,719,90200,14701
2563,1990,573,731,148400,14706
46,33,13,-,47700,14707
56,56,0,-,56700,14708
509,427,82,825,82200,14709
1295,1161,134,542,137700,14710
652,549,103,633,82500,14711
1421,1268,153,785,203300,14712
195,180,15,647,164600,14714
1036,814,222,788,74600,14715
776,518,258,712,96400,14716
306,280,26,675,150000,14717
754,668,86,890,102300,14718
1411,1090,321,672,105200,14719
347,175,172,868,61100,14720
76,60,16,933,130600,14721
66,66,0,-,835000,14722
445,390,55,829,100000,14723
912,770,142,668,157900,14724
648,587,61,1059,96800,14726
2014,1582,432,845,101100,14727
435,351,84,944,177700,14728
361,290,71,789,155500,14729
585,472,113,689,255100,14731
6,6,0,-,-,14732
1403,1046,357,615,95200,14733
944,803,141,700,106200,14735
69,66,3,-,121400,14736
1710,1486,224,775,93100,14737
1363,1227,136,896,132800,14738
1041,890,151,829,65600,14739
424,353,71,1146,102800,14740
776,729,47,-,126800,14741
59,42,17,-,109200,14742
843,623,220,801,94400,14743
442,317,125,875,146300,14744
846,665,181,595,84500,14747
233,179,54,568,86400,14748
1991,1300,691,1046,139100,14750
106,106,0,-,157600,14752
420,336,84,716,67400,14753
256,208,48,525,79700,14754
1137,910,227,683,118400,14755
0,0,0,-,-,14756
1343,1036,307,687,159400,14757
7955,4802,3153,763,95600,14760
820,697,123,727,129900,14767
288,237,51,578,117500,14769
1126,858,268,733,105200,14770
1573,1302,271,635,112700,14772
60,42,18,838,76700,14774
978,785,193,651,96700,14775
192,157,35,796,61700,14777
0,0,0,-,-,14778
2883,1653,1230,719,81300,14779
780,628,152,819,109600,14781
959,780,179,763,96900,14782
58,41,17,-,112500,14783
302,250,52,627,120500,14784
48,29,19,-,-,14785
2309,1680,629,672,97800,14787
29,10,19,-,-,14788
1886,1523,363,759,104700,14801
498,285,213,789,138700,14802
600,495,105,823,135800,14803
543,494,49,970,108600,14804
377,349,28,775,148400,14805
787,616,171,764,83600,14806
1204,1043,161,900,115100,14807
240,218,22,-,76900,14808
1003,758,245,852,96100,14809
5373,3536,1837,707,108400,14810
1285,1118,167,957,118800,14812
831,669,162,650,88700,14813
773,584,189,1423,179500,14814
320,265,55,853,132700,14815
250,231,19,-,102200,14816
1239,829,410,1623,209900,14817
779,735,44,1431,196600,14818
247,196,51,1260,75000,14819
212,178,34,975,122400,14820
1238,1092,146,953,127100,14821
359,328,31,1389,88300,14822
1512,1212,300,657,109300,14823
289,235,54,1367,123400,14824
309,238,71,683,147000,14825
756,652,104,862,93700,14826
16,16,0,-,-,14827
8602,5753,2849,1016,155300,14830
443,422,21,720,92700,14836
1977,1623,354,723,131400,14837
819,746,73,700,126500,14838
252,213,39,784,115300,14839
1227,1057,170,744,198500,14840
326,252,74,-,279300,14841
283,207,76,830,160900,14842
5550,3286,2264,736,93900,14843
9018,6478,2540,1177,171100,14845
333,309,24,817,128000,14846
930,756,174,885,180400,14847
28134,12209,15925,1372,320600,14850
0,0,0,-,-,14853
53,53,0,-,-,14854
305,246,59,638,108300,14855
0,0,0,-,-,14856
493,433,60,817,133200,14858
408,341,67,1054,141100,14859
512,319,193,635,152200,14860
515,418,97,1112,123100,14861
452,419,33,-,137500,14864
1068,788,280,631,129000,14865
2386,1796,590,1113,166700,14867
561,379,182,856,143500,14869
4101,2975,1126,1092,151300,14870
1826,1507,319,1183,169100,14871
233,171,62,722,147900,14872
808,718,90,996,118900,14873
51,42,9,-,96000,14874
226,171,55,675,118800,14877
256,245,11,-,142400,14878
862,742,120,804,101600,14879
671,607,64,840,99900,14880
141,58,83,960,236100,14881
1520,1322,198,1279,268900,14882
1776,1391,385,986,174900,14883
119,103,16,950,123400,14884
230,183,47,850,138700,14885
2848,2262,586,1206,239500,14886
507,439,68,1070,119700,14889
2014,1277,737,700,139300,14891
3322,2196,1126,860,131300,14892
6,6,0,-,-,14893
460,392,68,1219,94200,14894
3888,2918,970,623,87100,14895
283,245,38,628,73800,14897
541,442,99,682,109400,14898
5499,2862,2637,805,88700,14901
2966,1965,1001,898,123900,14903
6357,3878,2479,966,83400,14904
3820,2589,1231,1041,159600,14905
14430,10958,3472,924,170400,15001
5107,3225,1882,869,110200,15003
132,132,0,-,103500,15004
3999,3463,536,685,205600,15005
69,33,36,-,-,15006
126,90,36,-,-,15007
6738,5082,1656,756,236600,15009
11600,8126,3474,760,179000,15010
6998,5308,1690,825,184100,15012
1467,1093,374,718,84600,15014
528,525,3,-,438900,15015
7657,5696,1961,1061,218800,15017
347,323,24,-,68300,15018
678,577,101,768,154200,15019
244,244,0,-,257600,15020
2769,2122,647,793,170500,15021
4219,3027,1192,713,114100,15022
3664,2950,714,1119,190100,15024
6873,5190,1683,1079,201200,15025
1616,1240,376,1105,224300,15026
1104,731,373,761,169900,15027
80,77,3,-,95600,15028
479,277,202,928,90800,15030
209,114,95,882,98500,15031
2306,1203,1103,800,60100,15033
823,421,402,565,92700,15034
1012,679,333,730,80400,15035
4305,3684,621,874,151700,15037
90,51,39,-,82300,15038
3363,2866,497,1428,217300,15042
794,714,80,875,200000,15043
10648,9858,790,1170,348700,15044
1797,1212,585,820,81300,15045
1035,923,112,1048,165300,15046
122,122,0,-,156400,15047
483,395,88,997,122600,15049
919,873,46,1351,218600,15050
224,143,81,1117,134700,15051
1275,1064,211,1011,168600,15052
34,34,0,-,187500,15053
251,185,66,-,114500,15054
648,568,80,971,219300,15055
537,287,250,1094,116700,15056
6322,5592,730,953,307800,15057
1662,943,719,634,94600,15059
378,324,54,716,113700,15060
5298,3599,1699,930,178800,15061
3236,2486,750,633,81400,15062
4799,3688,1111,859,140800,15063
137,60,77,1281,-,15064
4933,3698,1235,735,137300,15065
5513,3538,1975,814,131000,15066
1103,846,257,723,105800,15067
16436,11822,4614,772,154300,15068
4945,3618,1327,1362,236000,15071
44,0,44,-,-,15072
3830,2583,1247,752,126000,15074
20,11,9,-,-,15075
381,247,134,693,120400,15076
97,73,24,950,122300,15077
179,137,42,-,96600,15078
170,120,50,788,123900,15081
94,61,33,-,176500,15082
476,449,27,775,146100,15083
4487,3339,1148,795,103900,15084
3296,2856,440,876,178800,15085
297,195,102,1103,328000,15086
28,18,10,-,-,15087
166,129,37,744,74300,15088
2911,2064,847,673,163800,15089
9334,7375,1959,1639,417000,15090
10597,8048,2549,1153,290800,15101
13460,10797,2663,1150,246600,15102
3673,1628,2045,568,54300,15104
9215,6419,2796,880,181400,15106
17016,12324,4692,1113,243000,15108
2083,929,1154,681,53400,15110
1485,614,871,811,83000,15112
5861,5116,745,970,234000,15116
8377,5112,3265,785,109800,15120
8184,6393,1791,717,120100,15122
0,0,0,-,-,15123
3198,2461,737,752,212100,15126
4425,3342,1083,1161,221000,15129
3973,2822,1151,952,129500,15131
9098,4509,4589,767,60200,15132
2744,2136,608,925,87100,15133
2091,1601,490,893,175700,15135
10173,6498,3675,972,169100,15136
4775,3066,1709,884,101300,15137
3392,2011,1381,995,286600,15139
1379,529,850,744,68000,15140
804,503,301,1620,625000,15142
8639,6812,1827,1457,416400,15143
1886,1267,619,843,137200,15144
2882,1310,1572,810,92700,15145
12373,8803,3570,1134,182700,15146
8027,5289,2738,895,125700,15147
1128,465,663,817,59800,15148
6813,3703,3110,1372,234500,15201
9757,5020,4737,928,183800,15202
5814,2317,3497,1422,254100,15203
3461,2218,1243,985,101400,15204
11200,6351,4849,1147,161900,15205
14601,5928,8673,1220,281500,15206
4752,2984,1768,961,121700,15207
4016,2066,1950,978,206800,15208
5700,4330,1370,961,214400,15209
10860,5983,4877,977,85300,15210
5785,2735,3050,1193,175500,15211
14033,6910,7123,1017,148800,15212
9332,2325,7007,1172,224200,15213
6038,4076,1962,1022,153400,15214
5428,3994,1434,985,292900,15215
10164,6449,3715,1044,171100,15216
11722,6093,5629,1314,403500,15217
6732,3770,2962,1039,185200,15218
5440,1251,4189,875,164500,15219
9074,4957,4117,1184,199700,15220
15044,6502,8542,920,144100,15221
2818,473,2345,1872,472800,15222
3335,2127,1208,978,146300,15223
5634,2140,3494,1155,226300,15224
524,279,245,838,122200,15225
6256,4229,2027,1073,163300,15226
13143,9484,3659,837,156800,15227
7374,5323,2051,1123,347900,15228
6255,4642,1613,1074,221400,15229
6340,1790,4550,1377,445800,15232
1439,624,815,837,282600,15233
6142,4321,1821,973,179400,15234
15521,11356,4165,1020,121900,15235
13619,10464,3155,1071,204800,15236
18326,14499,3827,1218,284900,15237
5532,4274,1258,1174,414100,15238
8274,6986,1288,1146,194500,15239
8262,7010,1252,1688,364800,15241
5715,4977,738,1221,247200,15243
0,0,0,-,-,15260
0,0,0,-,-,15275
0,0,0,-,-,15282
0,0,0,-,-,15290
21432,14626,6806,879,192300,15301
117,97,20,950,114900,15310
481,453,28,-,233900,15311
1559,1267,292,888,192300,15312
170,155,15,925,132900,15313
1400,997,403,492,173300,15314
251,195,56,1022,58000,15315
93,69,24,-,86300,15316
17332,13767,3565,1147,300000,15317
2248,1835,413,670,146600,15320
748,595,153,1614,270200,15321
701,620,81,788,88000,15322
1555,1268,287,638,187700,15323
308,203,105,1008,112500,15324
123,69,54,-,-,15325
552,427,125,920,116100,15327
592,492,100,907,221100,15329
2207,1996,211,1065,313700,15330
305,217,88,938,90800,15331
3876,3398,478,947,178600,15332
645,511,134,283,244600,15333
66,58,8,-,191700,15334
204,175,29,741,180500,15337
613,540,73,792,95000,15338
563,476,87,780,268700,15340
245,161,84,819,123400,15341
2275,1941,334,988,227800,15342
681,599,82,-,146500,15344
571,486,85,982,124300,15345
238,204,34,-,76700,15346
58,47,11,-,169500,15347
34,34,0,-,-,15348
650,488,162,681,191100,15349
214,106,108,679,76400,15350
376,255,121,-,83700,15351
361,315,46,-,141400,15352
32,29,3,-,210700,15353
620,578,42,967,153600,15357
413,279,134,921,104900,15358
58,37,21,859,114400,15359
665,595,70,664,222600,15360
56,56,0,-,-,15361
288,232,56,563,138200,15362
255,159,96,780,163100,15363
318,251,67,725,153800,15364
59,49,10,-,124100,15365
263,116,147,-,247000,15366
3267,3096,171,738,520300,15367
180,131,49,829,57200,15368
4918,3531,1387,682,170400,15370
573,454,119,950,177300,15376
265,222,43,1063,225900,15377
0,0,0,-,-,15378
26,24,2,-,105000,15379
268,226,42,496,96900,15380
13690,9000,4690,728,133100,15401
419,342,77,763,94400,15410
278,240,38,921,216300,15411
96,60,36,-,86500,15412
147,103,44,-,33700,15413
217,181,36,-,254800,15416
3461,2355,1106,737,96500,15417
1271,454,817,756,109500,15419
55,27,28,-,72500,15420
61,61,0,-,223100,15421
181,80,101,893,83000,15422
705,557,148,900,167300,15423
870,700,170,684,121100,15424
8138,5825,2313,681,123900,15425
413,327,86,864,155100,15427
726,616,110,848,113000,15428
181,159,22,-,55000,15429
132,127,5,-,69400,15430
1802,1520,282,734,104700,15431
181,115,66,914,94600,15432
395,350,45,-,129700,15433
123,89,34,850,118800,15434
56,56,0,-,-,15435
1116,706,410,765,113300,15436
811,550,261,1133,194900,15437
890,763,127,690,116100,15438
62,62,0,-,-,15440
932,715,217,1021,96800,15442
134,19,115,-,-,15443
203,150,53,-,130500,15444
1302,1152,150,879,154800,15445
32,32,0,-,-,15446
35,35,0,-,-,15447
90,90,0,-,68300,15448
274,274,0,-,202400,15449
89,89,0,-,152300,15450
347,293,54,606,104600,15451
61,17,44,-,-,15454
174,174,0,-,-,15455
1054,893,161,753,99600,15456
840,613,227,-,137100,15458
605,464,141,735,175000,15459
61,59,2,-,85000,15460
1531,1111,420,630,112800,15461
93,93,0,-,"10,000-",15462
166,122,44,-,45200,15463
634,561,73,857,116400,15464
191,170,21,-,129300,15465
164,138,26,1260,79100,15466
60,52,8,-,51400,15467
1044,811,233,1110,83100,15468
936,771,165,744,121100,15469
272,261,11,-,254800,15470
71,19,52,-,-,15472
1602,1368,234,720,191300,15473
788,542,246,966,111400,15474
488,258,230,816,69200,15475
21,21,0,-,-,15476
386,337,49,789,106600,15477
2588,2105,483,744,141200,15478
912,744,168,938,212500,15479
695,517,178,832,117200,15480
196,113,83,690,-,15482
146,101,45,696,112100,15483
249,249,0,-,-,15484
935,818,117,828,144900,15486
47,47,0,-,-,15488
138,138,0,-,83800,15489
104,86,18,-,102300,15490
36,20,16,-,-,15492
6558,4561,1997,706,149600,15501
62,52,10,-,370000,15502
0,0,0,-,-,15510
113,113,0,-,104200,15520
709,627,82,870,190100,15521
4890,3743,1147,740,189200,15522
2043,1601,442,689,145400,15530
1592,1234,358,643,127200,15531
56,40,16,911,75000,15532
546,393,153,775,172000,15533
378,301,77,675,151500,15534
790,678,112,709,174700,15535
164,134,30,641,227500,15536
3450,2507,943,710,179700,15537
292,258,34,645,155900,15538
107,94,13,-,138600,15539
148,131,17,-,166300,15540
1419,1305,114,699,141800,15541
460,392,68,850,103400,15542
83,83,0,-,116700,15544
1089,879,210,639,115800,15545
209,205,4,-,62200,15546
227,181,46,780,183800,15547
701,552,149,692,146500,15550
224,184,40,675,161800,15551
2134,1690,444,634,125100,15552
1051,854,197,604,169400,15554
41,41,0,-,77500,15555
1371,1121,250,633,120000,15557
681,528,153,792,124600,15558
902,709,193,991,211400,15559
58,52,6,700,92000,15560
46,33,13,-,119800,15561
77,64,13,1104,133300,15562
1136,976,160,577,117600,15563
47,29,18,588,-,15564
8,8,0,-,-,15565
24072,17784,6288,828,198900,15601
1729,1497,232,793,181100,15610
74,57,17,715,135100,15611
193,154,39,-,130400,15612
5210,4379,831,902,171600,15613
115,115,0,-,176200,15615
210,193,17,-,309000,15616
136,114,22,750,150000,15617
1083,895,188,678,115500,15618
145,105,40,-,-,15619
286,228,58,1016,109300,15620
580,515,65,-,228700,15622
298,269,29,-,250400,15623
210,161,49,-,-,15624
55,55,0,-,-,15625
2534,1661,873,749,217700,15626
2686,2172,514,762,136300,15627
173,106,67,1056,158300,15628
321,216,105,954,65700,15629
342,184,158,800,84500,15631
3790,3152,638,1281,260900,15632
229,182,47,-,303500,15633
216,131,85,748,81300,15634
79,17,62,-,-,15635
1487,1262,225,829,339000,15636
669,586,83,1011,223000,15637
48,15,33,-,-,15638
941,528,413,1286,179600,15639
169,139,30,-,114900,15640
227,153,74,763,117000,15641
19264,16256,3008,894,222600,15642
8636,6547,2089,904,150800,15644
71,66,5,-,-,15646
9,0,9,-,-,15647
11268,8142,3126,837,171700,15650
147,105,42,721,138800,15655
4070,3246,824,758,151100,15656
3844,3137,707,837,226400,15658
109,82,27,-,103900,15660
380,305,75,-,153100,15661
343,343,0,-,112000,15662
212,190,22,705,201300,15663
564,523,41,-,178500,15665
7046,5553,1493,773,148500,15666
5386,4993,393,1382,299700,15668
1228,1077,151,928,163200,15670
295,222,73,996,136200,15671
1442,994,448,1006,224200,15672
609,502,107,694,122900,15673
127,117,10,-,142000,15674
485,372,113,963,107300,15675
241,160,81,-,191100,15676
202,167,35,971,176500,15677
225,194,31,688,93900,15678
1303,1141,162,919,162300,15679
133,125,8,-,-,15680
1815,1499,316,906,126400,15681
88,88,0,-,118800,15682
3633,2587,1046,620,146000,15683
199,169,30,950,-,15684
461,457,4,-,207700,15686
538,490,48,485,175000,15687
289,283,6,-,94400,15688
44,36,8,-,-,15689
3963,2503,1460,780,105400,15690
142,142,0,-,232100,15691
377,335,42,-,129900,15692
124,108,16,-,132600,15693
130,130,0,-,137100,15695
112,90,22,1018,107700,15696
1367,819,548,830,144000,15697
300,250,50,-,110900,15698
12845,7451,5394,784,173200,15701
0,0,0,-,-,15705
110,75,35,775,-,15710
123,88,35,924,88300,15711
42,36,6,-,-,15712
46,46,0,-,223800,15713
1981,1497,484,540,92600,15714
221,158,63,798,95200,15715
183,127,56,545,69300,15716
4078,3063,1015,698,144800,15717
109,88,21,935,116900,15720
72,63,9,-,60400,15721
913,840,73,608,128600,15722
12,12,0,-,-,15723
891,778,113,708,107900,15724
542,430,112,494,150800,15725
83,72,11,-,72500,15727
1372,957,415,711,106300,15728
468,377,91,690,100400,15729
61,52,9,-,143400,15730
105,78,27,885,62400,15731
570,486,84,706,136300,15732
38,38,0,-,-,15733
112,101,11,-,-,15734
184,143,41,790,93800,15736
56,43,13,-,56400,15737
72,70,2,-,44400,15738
148,105,43,838,74700,15739
27,20,7,656,107500,15741
366,304,62,688,107400,15742
17,13,4,-,103100,15744
110,107,3,-,48400,15745
67,53,14,-,76300,15746
662,599,63,638,161100,15747
2840,2277,563,739,139200,15748
109,82,27,-,125000,15750
26,23,3,-,74500,15752
178,146,32,806,97100,15753
199,149,50,-,89500,15754
50,36,14,1031,88600,15756
579,496,83,604,93700,15757
1057,834,223,700,152800,15759
28,21,7,-,-,15760
33,20,13,-,45900,15761
360,332,28,692,193500,15762
15,7,8,-,-,15763
57,50,7,-,138900,15764
573,479,94,679,196500,15765
5785,4227,1558,806,125500,15767
80,70,10,-,106800,15770
359,323,36,-,139500,15771
574,437,137,1000,115000,15772
171,165,6,-,78100,15773
1149,975,174,740,147500,15774
270,240,30,-,99100,15775
23,20,3,-,96400,15776
14,14,0,-,-,15777
56,55,1,-,70300,15778
83,72,11,-,177600,15779
31,28,3,-,76700,15780
37,34,3,-,-,15781
22,17,5,-,78500,15783
31,28,3,-,112500,15784
8300,6021,2279,771,153900,15801
50,44,6,-,158300,15821
567,481,86,679,127600,15823
2074,1579,495,813,126600,15824
3907,2832,1075,683,143100,15825
113,113,0,-,75600,15827
122,110,12,-,101900,15828
479,402,77,775,125700,15829
16,4,12,-,-,15831
132,108,24,383,118200,15832
2012,1410,602,660,84300,15834
750,548,202,939,105500,15840
99,86,13,-,48200,15841
1360,1065,295,664,68300,15845
1361,1127,234,921,156300,15846
28,21,7,738,57500,15847
345,304,41,942,117100,15848
557,450,107,947,93800,15849
2773,2116,657,666,110300,15851
2674,2022,652,644,99600,15853
395,358,37,763,150000,15856
5831,4460,1371,725,140800,15857
546,459,87,731,130100,15860
60,53,7,-,98800,15861
67,67,0,-,71700,15863
720,555,165,901,118300,15864
513,337,176,548,84500,15865
55,48,7,775,100000,15866
702,626,76,720,119400,15868
534,494,40,617,88900,15870
1966,784,1182,452,20400,15901
4944,3123,1821,691,58600,15902
6571,4729,1842,862,161300,15904
8613,6509,2104,860,116600,15905
4751,3212,1539,541,53400,15906
2132,1821,311,719,103400,15909
248,220,28,983,180400,15920
144,104,40,-,56000,15921
19,19,0,-,-,15922
582,498,84,642,108300,15923
365,330,35,711,78800,15924
47,36,11,788,75000,15925
999,874,125,825,94500,15926
356,252,104,-,74100,15927
920,843,77,-,205700,15928
34,21,13,-,117000,15929
181,181,0,-,-,15930
3749,3027,722,787,174100,15931
0,0,0,-,-,15934
1018,892,126,699,95500,15935
674,623,51,579,104200,15936
285,265,20,-,85700,15937
919,827,92,717,121100,15938
661,600,61,855,215800,15940
731,672,59,878,164300,15942
1647,1149,498,708,90300,15943
1184,1044,140,639,158100,15944
55,55,0,-,-,15945
2749,2289,460,589,106400,15946
230,167,63,-,95700,15948
264,227,37,1030,74700,15949
269,237,32,-,58900,15951
503,309,194,657,155200,15952
50,50,0,-,-,15953
1192,1005,187,588,76000,15954
954,909,45,780,127500,15955
1190,1026,164,677,70000,15956
146,146,0,-,128700,15957
914,802,112,806,134000,15958
89,77,12,-,69700,15960
370,302,68,792,84100,15961
111,90,21,695,108300,15962
4444,3614,830,706,117400,15963
18256,12146,6110,816,182600,16001
6407,5649,758,776,234300,16002
448,402,46,875,204700,16020
122,84,38,908,116100,16022
1695,1151,544,1176,236600,16023
110,97,13,-,142100,16024
1941,1605,336,684,198200,16025
133,86,47,1345,220000,16027
849,613,236,628,134500,16028
369,290,79,841,129200,16029
113,86,27,725,96000,16030
3135,2441,694,981,308000,16033
797,663,134,910,181900,16034
39,29,10,-,-,16035
126,86,40,836,153600,16036
1878,1619,259,1125,312600,16037
1242,982,260,885,155600,16038
345,294,51,806,162500,16040
804,690,114,873,140200,16041
390,257,133,1023,124400,16045
6841,5589,1252,1641,454200,16046
77,50,27,914,99000,16048
1207,977,230,746,133400,16049
425,347,78,858,118900,16050
1248,1157,91,634,195400,16051
890,804,86,938,206800,16052
1619,1357,262,1288,261700,16053
183,154,29,742,100900,16054
3369,3038,331,1118,279200,16055
1986,1503,483,785,271300,16056
4841,2728,2113,837,224800,16057
3815,3440,375,2178,316000,16059
993,882,111,907,192400,16061
3545,2280,1265,1119,275000,16063
13431,10363,3068,1487,368400,16066
13134,8915,4219,693,108300,16101
2187,1675,512,856,103500,16102
6581,4927,1654,954,167400,16105
153,148,5,-,108300,16110
381,334,47,1200,148200,16111
591,511,80,783,125400,16112
156,132,24,1125,217100,16113
216,190,26,-,157600,16114
1407,1157,250,695,166700,16115
1168,1020,148,691,115800,16116
7253,5680,1573,798,132700,16117
957,776,181,665,151700,16120
1989,1170,819,647,73700,16121
1011,913,98,980,227400,16123
649,542,107,742,150000,16124
7081,4859,2222,744,126900,16125
5201,3768,1433,832,190600,16127
802,661,141,648,142600,16130
381,303,78,738,150200,16131
183,149,34,-,89000,16132
568,522,46,1014,169100,16133
1681,1432,249,757,122900,16134
320,251,69,939,93600,16136
4462,3669,793,619,165900,16137
133,106,27,-,-,16140
665,541,124,775,120500,16141
1925,1485,440,754,207200,16142
894,776,118,700,172600,16143
1187,991,196,731,156300,16145
6159,3348,2811,684,70800,16146
7844,5736,2108,828,173300,16148
3120,2316,804,812,133100,16150
25,16,9,-,65000,16151
926,754,172,800,139300,16153
878,820,58,843,162200,16154
31,0,31,1273,-,16155
1226,1061,165,973,198100,16156
1321,1014,307,630,118600,16157
2177,1724,453,747,157400,16159
461,289,172,773,92900,16160
236,129,107,669,59700,16161
7,7,0,-,-,16172
7024,5228,1796,791,155600,16201
249,216,33,755,113400,16210
27,23,4,-,86300,16211
133,118,15,663,68300,16212
67,51,16,685,72100,16213
3262,1611,1651,797,170900,16214
48,43,5,-,217300,16217
434,381,53,607,152400,16218
43,43,0,-,99400,16220
1065,957,108,571,129500,16222
37,27,10,-,112500,16223
347,291,56,698,159200,16224
3618,2778,840,792,119400,16226
162,143,19,875,88400,16228
2160,1643,517,799,194400,16229
196,149,47,772,89800,16230
1664,1254,410,707,129600,16232
447,397,50,-,147300,16233
582,534,48,918,204600,16235
93,74,19,-,82900,16236
175,140,35,686,161100,16238
634,493,141,795,101200,16239
640,519,121,621,141200,16240
1735,1275,460,651,120900,16242
139,116,23,-,-,16244
129,93,36,595,69600,16245
64,48,16,1056,92900,16246
1296,932,364,659,101100,16248
752,607,145,1000,148600,16249
99,58,41,840,47500,16250
57,22,35,646,93300,16253
1355,1098,257,859,141400,16254
703,522,181,663,124400,16255
414,382,32,872,147700,16256
714,491,223,753,126800,16258
890,734,156,632,133000,16259
138,128,10,-,88600,16260
1250,1078,172,1188,182100,16262
130,107,23,-,115600,16263
6355,4512,1843,772,80600,16301
209,190,19,725,123500,16311
0,0,0,-,-,16312
782,651,131,643,98600,16313
2111,1830,281,756,150900,16314
2119,1719,400,751,154900,16316
574,465,109,1058,118400,16317
451,428,23,650,121800,16319
12,11,1,-,93800,16321
47,47,0,-,74500,16322
6392,4510,1882,711,115400,16323
124,101,23,-,205800,16326
972,858,114,700,136500,16327
104,87,17,775,67900,16328
169,143,26,744,94100,16329
52,40,12,-,142900,16331
27,22,5,-,133300,16332
102,102,0,-,57500,16333
205,149,56,545,204200,16334
11091,6710,4381,867,143600,16335
765,690,75,756,118700,16340
766,703,63,654,103500,16341
976,866,110,682,109900,16342
217,191,26,-,97600,16343
192,103,89,859,50700,16344
1473,1342,131,635,169600,16345
1458,958,500,740,138700,16346
602,479,123,521,93500,16347
842,711,131,678,155900,16350
748,580,168,536,88100,16351
98,69,29,850,92300,16352
1070,892,178,607,123300,16353
4369,3057,1312,600,94600,16354
537,434,103,628,151200,16360
23,17,6,-,-,16361
402,358,44,643,155000,16362
493,425,68,887,164800,16364
7759,5481,2278,750,111800,16365
84,84,0,-,121900,16370
1258,928,330,666,96300,16371
231,151,80,574,89400,16372
1247,1043,204,666,131200,16373
798,679,119,790,114100,16374
1630,1337,293,646,142300,16401
276,259,17,863,109700,16402
2307,1919,388,628,149800,16403
1193,987,206,905,137200,16404
211,200,11,767,130000,16405
1295,1056,239,806,150000,16406
4819,3608,1211,744,119900,16407
666,606,60,809,166300,16410
493,372,121,955,114300,16411
4037,2760,1277,885,221200,16412
3561,3266,295,1243,257100,16415
66,66,0,-,328600,16416
3651,2713,938,631,166700,16417
197,176,21,988,93600,16420
1006,625,381,596,202500,16421
60,60,0,-,134100,16422
1596,1437,159,824,145400,16423
1894,1547,347,804,120400,16424
1430,1161,269,814,192600,16426
84,61,23,600,101000,16427
4937,3695,1242,731,176300,16428
70,60,10,-,212500,16430
1830,1547,283,649,159300,16433
889,749,140,868,139500,16434
679,536,143,815,109800,16435
305,248,57,-,151900,16436
3088,2333,755,756,137300,16438
329,269,60,598,149700,16440
3731,3183,548,879,198900,16441
1147,1000,147,1151,183700,16442
472,440,32,-,141000,16443
0,0,0,-,-,16444
0,0,0,-,-,16475
1092,40,1052,423,-,16501
6768,2274,4494,826,85200,16502
5782,2285,3497,815,52100,16503
6600,4599,2001,952,104200,16504
7612,5839,1773,831,187500,16505
9854,7077,2777,1116,215800,16506
3565,1237,2328,876,71400,16507
6747,4464,2283,783,116900,16508
12086,8386,3700,1035,193000,16509
9882,7762,2120,784,151600,16510
4475,2957,1518,752,158900,16511
0,0,0,-,-,16546
0,0,0,-,-,16550
0,0,0,-,-,16563
13396,9387,4009,797,134700,16601
11800,7901,3899,835,116100,16602
954,854,100,928,154500,16611
665,638,27,563,136100,16613
51,43,8,-,85800,16616
1130,854,276,811,135200,16617
97,94,3,-,112500,16619
152,121,31,1275,114100,16620
247,201,46,750,155400,16621
36,31,5,-,171900,16622
197,182,15,1016,162900,16623
80,75,5,625,123200,16624
1429,1092,337,843,137800,16625
823,724,99,643,87000,16627
1900,1387,513,669,137600,16630
16,16,0,-,220000,16631
96,81,15,-,104000,16633
116,105,11,1000,101400,16634
5065,3913,1152,969,169900,16635
354,335,19,1083,206300,16636
1102,924,178,1030,116600,16637
26,24,2,-,193800,16638
594,561,33,588,122700,16639
335,318,17,1036,105200,16640
995,825,170,816,96000,16641
82,80,2,-,-,16645
915,797,118,592,102700,16646
301,256,45,703,271900,16647
6227,4689,1538,951,213200,16648
691,582,109,723,148300,16650
1510,1211,299,606,95100,16651
5533,3968,1565,785,189300,16652
10,7,3,-,-,16654
537,420,117,738,136000,16655
470,406,64,806,99800,16656
581,524,57,650,189000,16657
70,41,29,636,139600,16659
375,353,22,675,107600,16661
2164,1640,524,863,190600,16662
689,622,67,688,171300,16664
146,111,35,833,203800,16665
1254,1188,66,1090,97800,16666
512,383,129,968,132500,16667
1428,1152,276,486,97700,16668
855,731,124,769,184300,16669
38,38,0,-,125000,16670
166,140,26,788,103600,16671
79,64,15,-,95000,16672
2110,1662,448,855,151200,16673
233,163,70,591,107100,16674
43,42,1,-,49100,16675
122,95,27,-,128800,16677
1034,838,196,599,128700,16678
249,214,35,925,74600,16679
151,139,12,-,87900,16680
97,93,4,-,71500,16682
154,144,10,900,190600,16683
62,53,9,-,120700,16684
102,97,5,-,228100,16685
5262,3818,1444,734,164500,16686
139,128,11,-,210000,16689
149,142,7,-,221400,16691
337,279,58,732,117500,16692
1527,1267,260,650,151200,16693
106,100,6,-,115300,16694
331,284,47,925,160000,16695
0,0,0,-,-,16699
6744,4940,1804,772,98200,16701
503,426,77,739,88800,16720
31,29,2,-,97500,16724
20,20,0,-,-,16725
239,209,30,1417,121400,16726
53,19,34,-,84600,16727
267,217,50,788,104200,16729
18,18,0,-,55000,16730
1080,872,208,633,98700,16731
111,101,10,-,57300,16732
47,34,13,-,81400,16733
94,67,27,950,58500,16734
2580,1984,596,729,85100,16735
475,412,63,800,104500,16738
377,323,54,704,71700,16740
1531,1157,374,760,112200,16743
86,68,18,-,101600,16744
277,274,3,-,101300,16745
480,422,58,695,92200,16746
1053,815,238,713,95900,16748
1548,1266,282,824,112400,16749
268,252,16,830,77900,16750
17017,7445,9572,1170,368700,16801
57,0,57,-,-,16802
10563,4667,5896,1268,386400,16803
410,365,45,867,197200,16820
72,72,0,-,106300,16821
769,661,108,764,174400,16822
11155,8123,3032,952,243700,16823
114,96,18,-,97100,16825
235,181,54,800,184400,16826
1933,1611,322,1127,397700,16827
2017,1752,265,998,276700,16828
255,213,42,770,169200,16829
5774,3616,2158,708,113900,16830
122,112,10,1042,156000,16832
2177,1776,401,607,121800,16833
248,231,17,-,192100,16834
84,67,17,1667,160900,16835
487,443,44,692,108400,16836
62,62,0,-,72900,16837
760,587,173,873,112500,16838
147,143,4,-,132900,16839
144,119,25,-,75300,16840
2354,1977,377,994,211300,16841
175,138,37,-,57500,16843
948,880,68,917,205400,16844
310,292,18,713,140200,16845
114,85,29,-,142800,16847
117,93,24,643,159900,16848
55,55,0,-,182000,16849
521,362,159,-,333100,16851
82,62,20,445,161400,16852
167,112,55,845,150000,16853
352,292,60,839,208800,16854
40,26,14,-,95300,16855
15,15,0,-,-,16856
1626,1375,251,817,155100,16858
224,212,12,-,136000,16859
255,255,0,-,-,16860
154,149,5,-,205800,16861
260,210,50,831,113200,16863
54,47,7,-,35300,16864
662,519,143,640,248100,16865
3580,2453,1127,623,122000,16866
459,459,0,-,302900,16868
2734,2408,326,915,380600,16870
28,21,7,-,86100,16871
395,308,87,833,203100,16872
472,405,67,786,143600,16874
1375,1169,206,897,282800,16875
103,86,17,950,59300,16876
742,649,93,1000,289500,16877
724,640,84,1035,116300,16878
173,131,42,669,-,16879
1036,927,109,966,97900,16881
167,152,15,-,210500,16882
4455,3371,1084,822,202300,16901
27,25,2,-,95000,16910
89,85,4,-,137500,16911
856,631,225,929,138000,16912
902,762,140,831,227300,16914
2320,1792,528,743,159900,16915
554,437,117,830,157200,16917
765,557,208,696,131600,16920
281,252,29,742,165700,16921
770,561,209,803,131600,16922
522,444,78,810,144600,16923
1231,1053,178,796,168900,16925
328,261,67,929,163800,16926
216,189,27,928,140400,16927
570,418,152,794,120400,16928
933,736,197,845,151700,16929
451,374,77,906,212000,16930
300,228,72,-,225000,16932
2599,1666,933,739,189400,16933
454,376,78,888,167000,16935
907,726,181,864,165600,16936
44,44,0,-,250000,16937
363,330,33,695,173300,16938
93,68,25,1034,95300,16939
18,11,7,-,-,16940
25,25,0,-,128100,16941
320,262,58,787,122400,16942
177,142,35,871,175000,16943
1072,882,190,885,151700,16946
1707,1263,444,668,157900,16947
611,488,123,528,150000,16948
1311,1069,242,670,121600,16950
153,122,31,700,177100,17002
4231,3341,890,957,232400,17003
1622,1137,485,709,200200,17004
116,96,20,900,129400,17005
330,250,80,917,140400,17006
2182,1720,462,878,295200,17007
754,563,191,716,118000,17009
97,16,81,-,-,17010
14433,9687,4746,1213,244200,17011
14570,8908,5662,990,209200,17013
55,55,0,-,169400,17014
9604,7991,1613,1085,268400,17015
376,109,267,2386,-,17016
646,537,109,750,162100,17017
1860,1562,298,956,220100,17018
7424,6245,1179,1065,263100,17019
3537,2793,744,818,210300,17020
453,357,96,902,184900,17021
12432,8387,4045,1323,265500,17022
1284,964,320,711,175500,17023
665,589,76,915,274600,17024
7381,5335,2046,1096,231900,17025
1277,1138,139,867,244500,17026
140,138,2,-,253000,17027
1376,1169,207,1112,242600,17028
94,85,9,-,47600,17029
298,128,170,718,212500,17030
3179,2696,483,804,196900,17032
6430,3566,2864,1198,319500,17033
1281,614,667,974,110100,17034
365,315,50,740,196600,17035
9329,6733,2596,1237,306900,17036
294,234,60,974,210800,17037
3352,2592,760,829,232400,17038
14,14,0,-,-,17039
911,736,175,897,229700,17040
71,71,0,-,241700,17041
15744,11156,4588,1042,199300,17042
2905,1634,1271,982,195800,17043
8833,5539,3294,746,117700,17044
1408,1113,295,739,203100,17045
12291,7807,4484,935,167800,17046
920,709,211,692,249800,17047
1459,1028,431,800,140800,17048
1108,781,327,689,187100,17049
16295,12296,3999,1389,331200,17050
1861,1531,330,900,163300,17051
538,466,72,900,123300,17052
2265,1838,427,905,199900,17053
87,68,19,1052,148100,17054
17942,12783,5159,1272,245500,17055
13,8,5,-,-,17056
9903,6732,3171,1074,170800,17057
573,323,250,685,168800,17058
2957,2031,926,728,192600,17059
374,316,58,682,162500,17060
2923,2191,732,785,161400,17061
1471,1292,179,818,207100,17062
1262,1061,201,668,123300,17063
311,287,24,1344,309000,17064
1598,1216,382,887,208900,17065
2010,1347,663,681,107900,17066
6084,4735,1349,1186,212000,17067
1658,1462,196,931,192800,17068
116,76,40,950,175000,17069
7333,5508,1825,965,228800,17070
49,33,16,646,155200,17071
2053,1727,326,1075,236900,17073
2910,2185,725,753,197600,17074
64,49,15,954,68800,17075
37,37,0,-,-,17076
10,0,10,-,-,17077
9048,6239,2809,1211,254700,17078
108,94,14,690,113300,17080
137,137,0,-,148700,17081
1057,804,253,743,192700,17082
1862,1523,339,847,161400,17084
791,577,214,631,166600,17086
924,771,153,854,208700,17087
169,125,44,-,221400,17088
2383,1964,419,734,228500,17090
345,300,45,-,143700,17093
982,754,228,701,170100,17094
312,259,53,963,79700,17097
1054,746,308,773,104500,17098
538,387,151,851,61500,17099
1931,66,1865,947,-,17101
4499,1639,2860,984,166300,17102
4885,1828,3057,897,104100,17103
7591,2768,4823,921,91600,17104
10879,5886,4993,1202,184300,17109
11099,6920,4179,1216,189500,17110
14470,9813,4657,1225,208600,17111
15443,12807,2636,1333,275400,17112
4335,2785,1550,1044,132900,17113
0,0,0,-,-,17120
12224,5872,6352,1050,195300,17201
12187,10066,2121,950,243700,17202
63,59,4,-,205400,17210
173,147,26,428,129700,17211
253,216,37,919,206900,17212
239,202,37,750,167900,17213
595,275,320,779,268200,17214
55,52,3,-,172700,17215
49,44,5,-,187500,17217
276,265,11,-,181900,17219
175,149,26,1075,233500,17220
230,198,32,640,193800,17221
4471,3709,762,1089,221200,17222
160,109,51,639,180400,17223
865,801,64,1107,255500,17224
7993,6671,1322,1006,247000,17225
434,342,92,742,186800,17228
592,491,101,697,161800,17229
18,10,8,-,-,17232
2298,1620,678,753,169200,17233
215,112,103,-,229300,17235
3228,2488,740,970,230000,17236
640,475,165,1171,174800,17237
725,546,179,848,200000,17238
90,73,17,747,204400,17239
1219,1030,189,1144,239100,17240
4294,3320,974,990,200100,17241
498,379,119,731,151800,17243
822,642,180,1026,182900,17244
201,201,0,-,355400,17246
231,41,190,1443,-,17247
121,110,11,-,114600,17249
36,36,0,-,-,17250
13,9,4,-,162500,17251
1319,945,374,1145,199600,17252
157,138,19,655,112100,17253
231,224,7,-,230300,17254
423,382,41,788,156900,17255
10866,7187,3679,1038,203600,17257
441,343,98,599,193300,17260
0,0,0,-,-,17261
308,254,54,757,221100,17262
243,183,60,-,211700,17263
922,802,120,670,159700,17264
133,96,37,635,147100,17265
158,110,48,817,190000,17266
1088,896,192,717,235500,17267
11619,8244,3375,1008,209200,17268
189,115,74,528,193800,17271
1441,1293,148,1174,226300,17301
983,754,229,489,229700,17302
149,100,49,885,168400,17303
968,791,177,1314,227200,17304
217,172,45,984,166200,17306
2263,1774,489,865,221600,17307
717,565,152,1179,223600,17309
75,60,15,1106,142400,17311
4455,2667,1788,1032,212100,17313
2263,1973,290,946,245000,17314
11024,9680,1344,1007,203800,17315
3191,2796,395,951,266200,17316
158,147,11,858,176000,17317
122,53,69,1313,137900,17318
4180,3802,378,957,213100,17319
3118,2708,410,1274,275600,17320
926,830,96,1273,269600,17321
2449,2310,139,1180,232600,17322
47,14,33,862,155600,17323
1638,1327,311,884,208600,17324
10894,8143,2751,968,267100,17325
3070,2279,791,969,280900,17327
1075,1054,21,-,289500,17329
22105,16935,5170,1054,215900,17331
2747,2366,381,1176,260100,17339
4338,3360,978,1105,266700,17340
184,116,68,1264,314000,17342
11,11,0,-,-,17343
1397,807,590,1194,191300,17344
3467,2624,843,1092,196100,17345
2524,2372,152,1385,208400,17347
2913,2647,266,1426,319700,17349
5287,3861,1426,1160,220700,17350
495,417,78,1068,288600,17352
1114,873,241,993,220600,17353
144,64,80,1012,207100,17355
9053,6673,2380,988,216200,17356
2336,2011,325,1000,260400,17360
2459,1844,615,1016,271900,17361
5440,4612,828,1162,245500,17362
3454,2911,543,876,289500,17363
1479,1156,323,1259,181600,17364
1043,907,136,831,268700,17365
2292,1819,473,1155,172100,17366
2569,2088,481,1017,185800,17368
2328,2122,206,1107,212600,17370
161,149,12,1571,173400,17371
1500,1180,320,1084,239000,17372
7336,2435,4901,920,75700,17401
14077,10117,3960,1244,237300,17402
15315,9691,5624,1011,190200,17403
14900,10652,4248,1135,164400,17404
9161,7362,1799,1298,201800,17406
885,710,175,1629,264200,17407
9777,6905,2872,1399,221100,17408
1897,1100,797,1142,230700,17501
999,896,103,781,198800,17502
46,46,0,-,196300,17504
531,326,205,1588,421200,17505
132,82,50,-,293600,17506
100,9,91,-,-,17507
331,303,28,-,275000,17508
1381,969,412,1048,281000,17509
7512,4730,2782,1037,202100,17512
2020,1735,285,1032,284300,17516
5404,4551,853,1063,259500,17517
438,296,142,808,290600,17518
2414,1709,705,1332,329400,17519
2117,1824,293,1319,236500,17520
13555,8854,4701,1095,248800,17522
2068,1540,528,1171,292200,17527
1322,872,450,1272,352900,17529
1242,1102,140,973,306000,17532
20,20,0,-,-,17534
623,442,181,1348,404600,17535
1106,947,159,1054,338700,17536
3119,2657,462,894,266400,17538
3606,2215,1391,1279,281600,17540
17938,13341,4597,1276,300000,17543
9041,7463,1578,1266,255400,17545
3499,2654,845,1044,227700,17547
82,65,17,-,161300,17550
3871,2180,1691,1417,254700,17551
8450,6136,2314,1223,260000,17552
3115,2268,847,1274,236900,17554
2140,1756,384,1437,341800,17555
5321,3860,1461,1219,260800,17557
1794,1450,344,728,238200,17560
1236,867,369,1142,336000,17562
1163,902,261,1276,272200,17563
795,749,46,1132,291300,17565
4240,2992,1248,1259,264600,17566
0,0,0,-,-,17568
2615,2402,213,1087,263400,17569
89,89,0,-,167800,17570
1262,912,350,890,289500,17572
32,32,0,-,-,17576
2500,2035,465,925,262900,17578
2275,1813,462,1165,294800,17579
63,27,36,800,-,17581
625,579,46,681,276900,17582
4525,2743,1782,1837,290200,17584
22564,16464,6100,1415,296800,17601
18286,10447,7839,1200,235300,17602
27036,16721,10315,1191,230800,17603
207,33,174,2674,-,17606
17743,9819,7924,873,164500,17701
4372,3152,1220,966,180600,17702
135,130,5,575,-,17720
658,494,164,852,126100,17721
31,22,9,-,175000,17723
1858,1248,610,743,155700,17724
22,22,0,-,-,17727
1981,1725,256,795,215300,17728
78,70,8,-,88600,17729
47,11,36,-,-,17730
91,81,10,775,450000,17731
2716,2016,700,821,188400,17737
16,14,2,-,225000,17739
4544,3812,732,829,170700,17740
26,15,11,-,151600,17742
1110,936,174,863,173100,17744
7092,4409,2683,843,164900,17745
1051,825,226,922,197200,17747
74,72,2,-,-,17748
104,59,45,828,178100,17749
39,8,31,-,160000,17750
2746,2211,535,850,191400,17751
1869,1462,407,902,164700,17752
5018,3899,1119,926,241700,17754
4289,3372,917,971,202600,17756
418,391,27,850,181900,17758
214,201,13,850,116900,17760
230,200,30,1000,161800,17762
131,95,36,967,98500,17763
1132,776,356,683,83400,17764
441,398,43,918,203800,17765
142,133,9,750,177900,17768
24,24,0,-,400000,17769
1239,1081,158,883,187500,17771
1042,927,115,703,226000,17772
392,321,71,1000,216500,17774
95,94,1,-,165800,17776
2587,1956,631,768,180400,17777
45,38,7,-,185300,17778
63,63,0,-,-,17779
6739,4384,2355,716,136600,17801
673,542,131,833,198900,17810
588,416,172,726,155700,17812
752,594,158,839,174700,17813
1888,1584,304,881,207600,17814
10898,6831,4067,915,197200,17815
2244,1724,520,782,202200,17820
7820,5496,2324,1023,232200,17821
5,5,0,-,-,17822
488,407,81,875,205200,17823
1609,1489,120,576,228100,17824
307,257,50,900,165600,17827
90,74,16,833,135700,17829
808,681,127,675,168500,17830
285,225,60,957,93800,17832
1613,1317,296,766,86600,17834
40,40,0,-,183300,17835
76,54,22,725,191700,17836
6170,4038,2132,881,241100,17837
149,122,27,-,-,17840
1829,1511,318,811,150500,17841
3282,2513,769,809,185000,17842
3901,2720,1181,939,205700,17844
685,546,139,877,197600,17845
1440,1137,303,709,203900,17846
4895,3037,1858,824,173400,17847
271,160,111,709,151000,17850
3040,2200,840,765,62800,17851
1107,895,212,754,209000,17853
312,263,49,943,187500,17855
1361,1211,150,781,179700,17856
3499,2713,786,874,171200,17857
21,21,0,-,235000,17858
1151,1030,121,770,204000,17859
1017,992,25,-,226800,17860
52,45,7,-,185100,17861
180,94,86,954,148100,17862
729,593,136,796,203600,17864
18,18,0,-,161400,17865
3561,2861,700,715,76800,17866
74,70,4,-,161500,17867
461,442,19,-,224600,17868
5069,3694,1375,890,219700,17870
3830,2528,1302,680,81500,17872
819,590,229,895,193800,17876
584,532,52,660,185200,17878
17,0,17,1108,-,17880
599,472,127,748,108800,17881
108,25,83,832,-,17884
96,84,12,-,207100,17885
372,173,199,637,156900,17886
276,276,0,-,-,17887
194,176,18,-,105600,17888
1036,884,152,850,278300,17889
9596,6612,2984,804,113800,17901
121,117,4,-,140100,17920
2472,1997,475,714,128500,17921
1849,1758,91,998,214300,17922
211,136,75,581,68900,17923
149,129,20,1125,98800,17925
565,394,171,833,135200,17929
131,90,41,1031,86200,17930
2068,1724,344,740,109900,17931
97,44,53,-,-,17933
104,100,4,-,29300,17934
708,566,142,770,39800,17935
379,270,109,705,94800,17936
1115,889,226,839,179200,17938
299,242,57,766,201400,17941
14,14,0,-,-,17943
81,75,6,-,101300,17944
184,150,34,-,-,17945
112,93,19,-,-,17946
1644,1042,602,928,34700,17948
98,71,27,-,37500,17949
146,146,0,-,159000,17951
103,97,6,-,58600,17952
141,118,23,625,104500,17953
1863,1003,860,728,75700,17954
136,125,11,-,177200,17957
589,463,126,632,70600,17959
1779,1517,262,910,216800,17960
2702,2048,654,836,214200,17961
3857,3154,703,824,182000,17963
303,249,54,917,202200,17964
869,694,175,820,97000,17965
928,835,93,680,168100,17967
109,92,17,900,150000,17968
1380,1059,321,856,72600,17970
4750,3475,1275,723,148000,17972
122,100,22,-,145800,17974
2349,1844,505,723,45900,17976
214,135,79,858,169300,17978
24,24,0,-,-,17979
1218,942,276,842,125600,17980
945,756,189,768,84600,17981
208,190,18,1104,99200,17982
558,458,100,852,138900,17983
533,456,77,1077,163800,17985
1989,1772,217,1542,252500,18011
14,14,0,-,-,18012
6763,5043,1720,1077,230100,18013
4565,3863,702,1067,251000,18014
11800,5774,6026,1165,216700,18015
16142,10892,5250,1448,290400,18017
13490,7216,6274,1213,204900,18018
7714,6681,1033,1463,325800,18020
261,138,123,824,160700,18030
4215,3140,1075,1724,343800,18031
3941,2859,1082,959,189800,18032
3106,2810,296,1227,395200,18034
8,8,0,-,-,18035
5746,4989,757,1088,354300,18036
3056,2589,467,1152,236900,18037
1407,1339,68,1702,221600,18038
6452,5828,624,1339,326000,18040
2154,1565,589,1194,286600,18041
16351,8989,7362,1233,178600,18042
11785,9303,2482,1697,283800,18045
54,54,0,-,-,18046
7409,5553,1856,1230,271400,18049
1310,1181,129,1116,392500,18051
11650,7329,4321,1362,230400,18052
967,805,162,1188,265200,18053
1716,1351,365,1234,399800,18054
4747,3757,990,1287,260100,18055
421,302,119,1669,31200,18056
3646,3104,542,1307,212000,18058
331,298,33,-,362400,18059
10045,7951,2094,1821,344400,18062
121,77,44,809,182700,18063
10372,7905,2467,1231,331700,18064
162,159,3,-,169300,18065
2142,1837,305,899,282700,18066
7800,5881,1919,1236,242300,18067
3109,2755,354,1861,372500,18069
160,160,0,-,273200,18070
4631,3071,1560,925,184200,18071
2659,1935,724,1361,240800,18072
4030,3473,557,1393,314900,18073
2166,2109,57,873,343500,18074
1281,895,386,1024,235400,18076
947,702,245,1441,367200,18077
2788,2311,477,1141,344700,18078
167,156,11,-,112500,18079
4493,3628,865,836,232300,18080
20,20,0,-,-,18081
224,188,36,1208,251700,18083
344,239,105,1153,231900,18085
235,184,51,-,256800,18086
249,81,168,1207,234200,18087
3210,2837,373,1180,226400,18088
2345,1492,853,1288,241800,18091
1234,1046,188,1396,350800,18092
2224,223,2001,1173,158800,18101
17213,5285,11928,1143,135900,18102
18799,11408,7391,1269,226000,18103
17544,12515,5029,1507,280800,18104
2745,2255,490,1422,336100,18106
7047,3535,3512,1260,166400,18109
0,0,0,-,-,18195
11976,5851,6125,970,123500,18201
5033,3687,1346,889,165900,18202
2956,2643,313,1217,192200,18210
455,403,52,779,270100,18211
10,10,0,-,-,18212
977,899,78,762,179900,18214
527,373,154,1171,116000,18216
929,729,200,864,56300,18218
488,350,138,885,205200,18219
142,132,10,829,47500,18220
225,184,41,-,206200,18221
3550,3112,438,1319,217000,18222
36,36,0,-,-,18223
2655,1777,878,862,106000,18224
0,0,0,-,-,18225
3726,3219,507,870,198800,18229
60,60,0,-,89300,18230
197,162,35,643,113500,18231
1691,790,901,943,45700,18232
292,140,152,-,-,18234
7894,6044,1850,982,209700,18235
1484,1055,429,1020,86600,18237
51,51,0,-,-,18239
1422,917,505,845,123900,18240
208,142,66,1094,102800,18241
181,158,23,-,109800,18242
116,80,36,921,146900,18244
134,134,0,-,112200,18245
62,46,16,-,-,18246
166,146,20,-,110800,18248
1496,1307,189,1051,248100,18249
1297,1049,248,1025,91100,18250
4485,3252,1233,784,148700,18252
306,231,75,1336,91500,18254
1619,1269,350,817,156600,18255
98,92,6,-,158300,18256
9609,6922,2687,1326,228400,18301
5870,5027,843,1510,188200,18302
620,548,72,1275,195200,18321
910,793,117,961,248200,18322
79,31,48,-,-,18323
3660,3162,498,1761,176500,18324
1100,902,198,1279,233100,18325
1228,1063,165,838,231500,18326
311,190,121,1036,256400,18327
3245,2882,363,1121,193200,18328
3061,2664,397,1510,219400,18330
286,236,50,-,288000,18331
931,784,147,1375,222700,18332
0,0,0,-,-,18333
1954,1539,415,1562,213300,18334
469,434,35,-,256500,18335
1738,1070,668,1153,229700,18336
6079,4996,1083,1416,262000,18337
15,0,15,-,-,18340
336,166,170,1091,185600,18342
1671,1417,254,978,266500,18343
1270,843,427,1168,169100,18344
1010,968,42,1077,165200,18346
1561,1303,258,1145,147800,18347
71,53,18,-,-,18349
340,340,0,-,213400,18350
202,79,123,1369,211700,18351
4415,3896,519,1345,240400,18353
399,359,40,-,227100,18354
535,343,192,1713,276900,18355
0,0,0,-,-,18356
78,78,0,-,-,18357
10947,7763,3184,1306,264000,18360
416,267,149,858,171400,18370
228,228,0,-,199200,18371
950,686,264,1684,242300,18372
2748,2033,715,884,213500,18403
988,870,118,528,190700,18405
6220,4084,2136,811,135600,18407
8817,6923,1894,1099,266600,18411
30,30,0,-,-,18413
2227,1924,303,1258,246600,18414
604,569,35,-,317200,18415
399,342,57,739,242600,18417
1772,1393,379,830,203300,18419
51,32,19,-,225000,18420
1880,1492,388,785,168000,18421
2039,1774,265,950,174700,18424
426,370,56,975,180100,18425
1418,1185,233,1215,233400,18426
5292,4384,908,1181,233500,18428
28,26,2,-,193800,18430
5396,3901,1495,931,196600,18431
3010,2485,525,905,190600,18433
1756,1200,556,904,154500,18434
418,390,28,-,281000,18435
4882,4318,564,847,210900,18436
52,39,13,-,222900,18437
723,692,31,-,304500,18438
149,139,10,883,223800,18439
29,29,0,-,937500,18440
186,138,48,779,277800,18441
183,168,15,-,271400,18443
5382,4539,843,1010,242600,18444
944,767,177,873,228300,18445
1349,1106,243,891,186300,18446
4540,3286,1254,961,167100,18447
217,185,32,-,253400,18451
2172,1624,548,894,175100,18452
479,413,66,1250,274100,18453
51,49,2,-,321200,18454
66,53,13,858,184200,18455
120,105,15,925,256800,18456
21,21,0,-,-,18457
1398,1315,83,1196,253500,18458
56,50,6,-,155000,18460
138,119,19,936,167800,18461
226,192,34,1125,166100,18462
94,79,15,-,308900,18463
571,536,35,1539,280000,18464
480,382,98,1031,216900,18465
5698,4447,1251,1690,167700,18466
187,173,14,-,336700,18469
914,791,123,848,217900,18470
214,209,5,-,327600,18471
1548,1153,395,986,229300,18472
199,173,26,1594,-,18473
662,19,643,860,-,18503
8351,5073,3278,927,123400,18504
8498,4696,3802,899,127300,18505
2291,1530,761,925,236500,18507
4671,2150,2521,997,109200,18508
5197,2460,2737,930,162800,18509
5131,2070,3061,958,163500,18510
5571,3611,1960,849,168700,18512
1984,1431,553,1086,161600,18517
3801,2685,1116,851,156300,18518
2408,1522,886,844,153300,18519
137,132,5,1500,326900,18602
8434,6196,2238,742,152200,18603
1295,1103,192,1056,216800,18610
6084,4877,1207,1131,241500,18612
962,762,200,625,174100,18614
724,636,88,1005,214200,18615
319,245,74,631,193800,18616
702,406,296,784,81100,18617
1602,1336,266,1242,200500,18618
63,54,9,2063,157500,18619
1898,1743,155,1118,165200,18621
76,76,0,-,184400,18622
966,727,239,886,155700,18623
261,253,8,-,299200,18624
61,37,24,-,232500,18625
180,167,13,850,265600,18626
0,0,0,-,-,18627
81,81,0,-,121700,18628
834,643,191,1000,191300,18629
1153,893,260,835,217100,18630
494,391,103,961,183600,18631
160,132,28,775,119200,18632
5574,3574,2000,771,97200,18634
1499,1223,276,916,191300,18635
619,528,91,883,124600,18636
7107,4124,2983,826,136300,18640
3042,2052,990,888,122200,18641
1692,1254,438,860,129300,18642
5722,4223,1499,865,154500,18643
3356,2524,832,808,167900,18644
3652,2046,1606,843,90700,18651
2375,2000,375,900,178200,18655
910,842,68,921,189800,18656
4561,3354,1207,900,202400,18657
1390,1265,125,953,180600,18660
2225,1870,355,1164,163100,18661
1069,93,976,763,223100,18701
17021,9652,7369,945,107200,18702
13624,7918,5706,899,145800,18704
6446,4128,2318,923,114900,18705
6769,4518,2251,837,113000,18706
6063,5500,563,784,252500,18707
3941,3250,691,1076,218600,18708
1451,838,613,728,103700,18709
3165,2429,736,839,223600,18801
2710,1574,1136,801,168000,18810
620,551,69,967,234300,18812
71,59,12,833,133900,18814
42,25,17,-,152100,18816
49,49,0,-,202500,18817
542,403,139,817,217200,18818
26,26,0,-,141300,18820
437,327,110,844,166500,18821
1313,995,318,746,145200,18822
58,44,14,-,192900,18823
461,399,62,786,189700,18824
70,66,4,-,243800,18825
636,573,63,986,241200,18826
107,104,3,-,203600,18828
279,226,53,894,181400,18829
258,211,47,867,218100,18830
391,320,71,766,180700,18831
764,630,134,803,140600,18832
824,662,162,863,179100,18833
1285,953,332,950,198500,18834
1058,847,211,955,168900,18837
4387,2871,1516,859,164500,18840
60,50,10,-,156800,18842
159,95,64,-,184700,18843
589,515,74,931,259300,18844
191,161,30,873,200600,18845
273,241,32,1048,228200,18846
2040,1533,507,834,140700,18847
3716,2547,1169,835,167000,18848
802,653,149,937,167600,18850
226,189,37,1044,174500,18851
1731,1349,382,865,200300,18853
624,513,111,844,180100,18854
10891,7814,3077,1731,514600,18901
7957,7327,630,2097,615800,18902
104,73,31,-,"2,000,000+",18912
62,62,0,-,1093800,18913
7578,6474,1104,1970,453000,18914
547,441,106,1761,462300,18915
984,604,380,1277,334700,18917
194,116,78,1943,490500,18920
75,75,0,-,419300,18921
496,427,69,2222,407200,18923
2171,2048,123,2844,627400,18925
135,26,109,-,-,18927
3241,3128,113,1744,582200,18929
944,828,116,1639,480200,18930
148,131,17,-,430700,18932
75,69,6,-,1110300,18933
111,111,0,-,332300,18935
74,74,0,-,-,18936
6180,5339,841,1851,662200,18938
11626,9911,1715,2014,601100,18940
1082,982,100,1108,483800,18942
9913,8075,1838,1318,379600,18944
164,150,14,-,641400,18946
2354,2236,118,2048,574500,18947
48,48,0,-,562500,18950
14354,11624,2730,1304,325900,18951
3716,3654,62,1726,525700,18954
496,402,94,1292,286800,18955
4827,3693,1134,1521,338600,18960
130,112,18,1094,334100,18962
5319,3709,1610,1225,330200,18964
13946,12127,1819,1695,429800,18966
6190,4917,1273,1394,342800,18969
280,181,99,1188,284500,18970
1355,1127,228,1484,447300,18972
17423,13081,4342,1628,375900,18974
8298,6647,1651,1570,471000,18976
1789,1683,106,-,701500,18977
40,26,14,-,1017900,18980
6396,5222,1174,1270,322000,19001
11863,9268,2595,1475,499800,19002
5884,3935,1949,1518,416600,19003
4098,3027,1071,1657,597100,19004
8576,6497,2079,1359,480700,19006
9187,5357,3830,1025,233500,19007
6916,5899,1017,1592,441700,19008
346,253,93,1284,631200,19009
7788,4906,2882,1835,712000,19010
2208,1865,343,1242,286200,19012
13102,4788,8314,995,80100,19013
7672,6530,1142,1311,282900,19014
6794,5167,1627,1157,220000,19015
92,80,12,-,489300,19017
9669,6244,3425,1226,198900,19018
22300,12733,9567,1442,328600,19020
3869,2900,969,1282,241000,19021
1615,656,959,985,123500,19022
7819,4175,3644,1194,110300,19023
2557,2038,519,2523,543900,19025
12847,8620,4227,1237,227000,19026
8026,4971,3055,1373,325400,19027
1760,1141,619,1231,171700,19029
4744,3597,1147,1197,327100,19030
2094,1678,416,1357,484100,19031
2446,1778,668,1392,139000,19032
2838,2231,607,1298,246700,19033
2449,1912,537,1445,595100,19034
1450,1219,231,1755,1266700,19035
4995,3914,1081,1208,178700,19036
11575,9874,1701,1318,368200,19038
7973,5739,2234,1625,349700,19040
2486,1615,871,2159,911400,19041
1185,906,279,1142,246800,19043
6633,3788,2845,1359,356500,19044
7718,5285,2433,1377,417600,19046
12625,9179,3446,1705,417700,19047
12149,7278,4871,1113,170500,19050
243,216,27,-,357100,19052
10582,8797,1785,1379,361600,19053
6446,5169,1277,1390,303100,19054
4897,4054,843,1494,250100,19055
5794,4106,1688,1347,346100,19056
6160,4862,1298,1401,277100,19057
3643,3595,48,-,486800,19060
7999,5024,2975,1153,226500,19061
15180,10361,4819,1626,475000,19063
8696,8098,598,1416,368500,19064
1705,1562,143,3283,825100,19066
20921,16613,4308,1448,444500,19067
2795,2055,740,1183,267800,19070
4317,3104,1213,1846,743900,19072
8411,6529,1882,1761,525400,19073
2341,1585,756,1177,208700,19074
2921,2616,305,1303,398600,19075
2586,1558,1028,1160,220800,19076
4822,3357,1465,1226,233100,19078
3314,1941,1373,1232,139500,19079
3712,3132,580,1404,312600,19081
15854,7434,8420,1162,144400,19082
13362,11824,1538,1325,397800,19083
1805,1739,66,"3,500+",946700,19085
4575,4071,504,1480,389800,19086
12117,8706,3411,1941,674800,19087
7563,5229,2334,1476,310900,19090
1778,1285,493,1131,224700,19094
3282,1729,1553,1762,400800,19095
5923,4514,1409,2039,673300,19096
3847,888,2959,2270,419000,19102
16759,5079,11680,1935,537200,19103
18894,3594,15300,1225,253000,19104
8495,4057,4438,2091,508300,19106
8612,1593,7019,1610,445500,19107
68,58,10,-,363000,19108
0,0,0,-,-,19109
25938,14245,11693,1165,226100,19111
0,0,0,-,-,19112
0,0,0,-,-,19113
13912,9333,4579,1315,262500,19114
14652,9167,5485,1172,299200,19115
13650,7893,5757,1158,299600,19116
4797,2425,2372,1771,641800,19118
12889,8324,4565,1216,322500,19119
24593,15999,8594,1132,133200,19120
15653,5203,10450,1116,217700,19121
8521,3283,5238,1091,320100,19122
9468,3119,6349,1611,491000,19123
24964,15863,9101,1037,133700,19124
11662,6889,4773,1695,340200,19125
6412,3980,2432,1105,182100,19126
2982,1353,1629,1784,299700,19127
18158,10310,7848,1505,304500,19128
5405,2699,2706,1455,290600,19129
16110,6201,9909,1789,474600,19130
18727,8234,10493,1268,156400,19131
14295,7058,7237,1064,62000,19132
9259,3806,5453,906,72200,19133
22091,11934,10157,1145,116500,19134
13436,8223,5213,1130,162900,19135
13281,8119,5162,1123,195300,19136
3207,2653,554,1211,199600,19137
12827,8242,4585,1137,152800,19138
19444,7718,11726,1056,115900,19139
20424,10841,9583,1049,88600,19140
14768,7495,7273,956,128100,19141
11601,5403,6198,1187,100800,19142
26807,12816,13991,1186,135300,19143
20550,7530,13020,1041,201900,19144
19245,11281,7964,1304,266100,19145
18640,9527,9113,1606,439500,19146
19162,10867,8295,1608,509300,19147
20658,13337,7321,1389,269400,19148
19476,10799,8677,1399,176400,19149
9853,7965,1888,1278,212700,19150
13200,8306,4894,1065,166800,19151
13323,7947,5376,1167,247300,19152
5604,2790,2814,1319,177800,19153
12865,9723,3142,1392,257700,19154
2948,2421,527,1817,503800,19301
906,751,155,1309,275200,19310
3506,2903,603,1430,493200,19311
4490,3692,798,1639,773400,19312
36,36,0,-,385700,19316
3932,3393,539,1835,545000,19317
138,138,0,-,530600,19319
19933,14675,5258,1360,283600,19320
2096,1890,206,1107,372300,19330
3066,2010,1056,1737,687300,19333
19493,15588,3905,1590,443600,19335
8620,4608,4012,1912,483100,19341
7826,5630,2196,2265,556300,19342
3019,2593,426,1687,506300,19343
4384,3356,1028,1187,289300,19344
0,0,0,-,-,19345
8938,6334,2604,1417,469400,19348
3828,3500,328,1401,465400,19350
3089,2907,182,1498,425200,19352
11020,7993,3027,1839,627800,19355
133,51,82,1340,156300,19358
2195,1791,404,1134,264900,19362
5939,4191,1748,1198,326000,19363
2670,1994,676,1189,270200,19365
33,24,9,-,-,19367
91,34,57,-,-,19369
745,353,392,2114,271500,19372
665,665,0,-,664200,19373
267,230,37,1081,291300,19374
81,63,18,-,-,19375
21007,15011,5996,1751,496400,19380
20843,14492,6351,1657,511000,19382
131,0,131,-,-,19383
4543,3666,877,1053,364500,19390
16495,7120,9375,1324,210100,19401
19119,13914,5205,1544,333400,19403
2064,1044,1020,1398,301000,19405
12786,6703,6083,1844,374800,19406
7682,6266,1416,2126,522300,19422
5711,5150,561,2373,601400,19425
13257,11678,1579,1759,429700,19426
9287,5027,4260,1832,414000,19428
38,33,5,-,231700,19435
320,85,235,2846,-,19436
271,271,0,-,832600,19437
9290,7468,1822,1665,426100,19438
7411,4939,2472,1353,384900,19440
0,0,0,-,-,19442
4726,3548,1178,1980,465600,19444
23656,15762,7894,1647,387200,19446
756,475,281,1642,242400,19453
11255,8961,2294,1646,413700,19454
115,115,0,-,395800,19456
73,73,0,-,238000,19457
17663,12321,5342,1538,391800,19460
6305,4940,1365,1730,432400,19462
18734,11994,6740,1185,215400,19464
7258,5779,1479,1285,365100,19465
10649,8104,2545,1642,346200,19468
31,31,0,-,387500,19472
6500,5565,935,1513,398600,19473
221,221,0,-,286100,19474
4803,3413,1390,875,344300,19475
27,27,0,-,-,19477
111,111,0,-,-,19490
430,116,314,-,368000,19492
420,318,102,944,221800,19501
442,321,121,1161,219100,19503
2029,1811,218,1124,312800,19504
1448,1170,278,1133,265100,19505
2607,2246,361,1101,282100,19506
1237,1017,220,949,279200,19507
6184,5066,1118,992,227800,19508
3061,2772,289,1254,258800,19510
53,53,0,-,217900,19511
6804,4905,1899,1110,236400,19512
80,23,57,838,225000,19516
5956,5056,900,1360,312600,19518
2486,2100,386,1081,359400,19520
5665,4685,980,1040,244700,19522
0,0,0,-,-,19523
5825,5390,435,1134,361600,19525
4861,3745,1116,1077,191300,19526
1148,996,152,1178,292600,19529
4452,2915,1537,1021,241600,19530
2802,2487,315,933,272100,19533
837,714,123,897,277600,19534
21,0,21,-,-,19535
250,184,66,927,160000,19536
28,20,8,-,285700,19538
1584,1425,159,1088,244400,19539
4385,3665,720,952,275800,19540
1653,1473,180,1255,268600,19541
1913,1679,234,1140,317800,19543
51,51,0,-,186600,19544
267,219,48,-,145900,19545
1949,1615,334,1156,273900,19547
126,94,32,1286,120000,19549
172,117,55,1092,141900,19550
1854,1572,282,849,236500,19551
154,81,73,952,163400,19554
1473,1074,399,1014,211300,19555
120,100,20,1150,145200,19559
3694,3017,677,1375,166400,19560
1307,629,678,1043,205900,19562
64,37,27,-,173100,19564
3392,2703,689,1226,229100,19565
1989,1515,474,1073,220800,19567
12806,4809,7997,903,96600,19601
6750,1986,4764,915,61700,19602
9451,4333,5118,1015,102400,19604
7706,6540,1166,1217,200800,19605
13773,10660,3113,1240,217700,19606
9501,6225,3276,1198,195000,19607
8780,6984,1796,1456,289100,19608
4006,3320,686,1255,201400,19609
6874,4827,2047,1630,298500,19610
4266,2071,2195,1061,152800,19611
16474,12928,3546,1677,329200,19701
21149,12992,8157,1447,311400,19702
6721,3452,3269,1233,254400,19703
702,489,213,1295,226100,19706
6367,5446,921,2171,524400,19707
17067,14428,2639,1456,416600,19709
17,17,0,-,-,19710
19101,12478,6623,1436,354800,19711
11971,7388,4583,1262,246300,19713
0,0,0,-,-,19716
0,0,0,-,-,19717
23077,15706,7371,1229,229300,19720
220,201,19,1181,301300,19730
152,132,20,-,429800,19731
171,171,0,-,660200,19732
72,46,26,-,206300,19733
4397,4033,364,1344,406700,19734
0,0,0,-,-,19735
17,17,0,-,-,19736
7816,2186,5630,1087,166300,19801
10604,5124,5480,1150,178600,19802
8523,7639,884,1524,400200,19803
7479,5596,1883,1175,232200,19804
15951,8837,7114,1200,207000,19805
6109,3128,2981,1289,351300,19806
3532,2407,1125,1530,857700,19807
15231,12022,3209,1299,296900,19808
6273,4462,1811,1345,288800,19809
10465,8216,2249,1373,397900,19810
14447,8021,6426,1326,231100,19901
0,0,0,-,-,19902
14547,9193,5354,1162,268300,19904
1463,1425,38,1391,724000,19930
171,169,2,-,233500,19931
3876,2887,989,915,225300,19933
5096,4227,869,1348,289900,19934
93,52,41,1069,113500,19936
3139,2675,464,1615,301700,19938
3035,2757,278,1203,334600,19939
2282,1814,468,967,219800,19940
1129,833,296,1024,220100,19941
5093,4408,685,1144,262900,19943
290,270,20,575,1078600,19944
3678,3280,398,1322,378100,19945
2064,1685,379,1298,263400,19946
6495,4447,2048,1151,274500,19947
3126,2328,798,1335,253400,19950
821,803,18,-,335900,19951
4030,2907,1123,1144,254700,19952
1805,1420,385,891,243900,19953
636,473,163,1181,280800,19954
89,76,13,-,219800,19955
6056,3959,2097,928,209300,19956
13717,11426,2291,1577,448700,19958
2277,1978,299,1041,233700,19960
4213,3699,514,1133,345400,19962
8909,5739,3170,1121,275200,19963
654,609,45,-,330300,19964
14243,11812,2431,1201,247700,19966
1135,1060,75,2092,428600,19967
5992,5317,675,1337,383700,19968
3590,3284,306,1463,450300,19970
7582,6749,833,1369,486300,19971
10040,7478,2562,1044,241100,19973
4566,4029,537,1452,394000,19975
8899,7055,1844,1365,290400,19977
203,171,32,1438,263700,19979
81,71,10,-,277500,19980
23611,8105,15506,2458,823800,20001
33351,12333,21018,1979,789500,20002
17291,6761,10530,2564,925800,20003
1330,551,779,2771,660500,20004
8508,2422,6086,2132,602100,20005
735,51,684,1898,235400,20006
11826,6609,5217,1961,1181000,20007
16913,6102,10811,2212,905900,20008
28525,9768,18757,2208,723100,20009
14406,5657,8749,1744,817500,20010
27121,14615,12506,1613,697500,20011
6889,4157,2732,1446,791600,20012
6027,4698,1329,1899,1175300,20015
14235,9435,4800,2134,1181100,20016
8411,4956,3455,1739,661200,20017
9012,5104,3908,1253,637900,20018
26731,10620,16111,1160,418400,20019
22777,7386,15391,1205,414900,20020
9585,3294,6291,1962,498500,20024
17611,4067,13544,1232,360300,20032
3731,1644,2087,2284,453200,20036
7124,2530,4594,2309,750500,20037
0,0,0,-,-,20045
6,0,6,-,-,20052
0,0,0,-,-,20057
0,0,0,-,-,20059
0,0,0,-,-,20064
10120,8980,1140,2577,767200,20105
1612,1425,187,1674,448500,20106
14732,6453,8279,1836,373800,20109
15617,11707,3910,1819,406700,20110
11372,7355,4017,1883,436200,20111
9175,8892,283,2300,571400,20112
2896,1971,925,1567,629300,20115
1373,978,395,1483,856100,20117
1300,1090,210,1769,556900,20119
14335,10759,3576,2107,598700,20120
9595,6810,2785,2128,468600,20121
5060,4596,464,2146,851100,20124
181,154,27,-,1190700,20129
107,70,37,1470,389700,20130
5840,5252,588,2178,662100,20132
1360,1164,196,1161,516500,20135
9085,8371,714,2736,557000,20136
710,687,23,-,608100,20137
2556,2327,229,1335,655500,20141
207,189,18,-,728700,20143
581,493,88,1168,685200,20144
24316,16782,7534,2253,635200,20147
19849,15911,3938,2484,803700,20148
6807,5453,1354,2030,628900,20151
11009,9306,1703,2597,667600,20152
12278,10483,1795,2571,593600,20155
1501,1250,251,-,689700,20158
12671,9617,3054,2049,475300,20164
11981,9284,2697,2378,617500,20165
4946,2504,2442,2176,534400,20166
9159,8544,615,2515,652500,20169
13729,9642,4087,2162,599100,20170
18268,10354,7914,2205,731500,20171
11758,8706,3052,1949,658200,20175
16398,12615,3783,1922,650700,20176
2521,2303,218,2160,585900,20180
3195,2864,331,1604,637200,20181
236,41,195,2148,375000,20184
5817,3974,1843,1533,464200,20186
6359,5692,667,1759,554700,20187
10725,5136,5589,2134,562900,20190
11863,8360,3503,1937,582400,20191
5682,4057,1625,2291,742600,20194
838,744,94,-,919900,20197
844,541,303,1398,949600,20198
0,0,0,-,-,20204
0,0,0,-,-,20220
0,0,0,-,-,20230
0,0,0,-,-,20240
0,0,0,-,-,20245
0,0,0,-,-,20250
0,0,0,-,-,20260
0,0,0,-,-,20317
0,0,0,-,-,20319
29,0,29,-,-,20373
0,0,0,-,-,20388
0,0,0,-,-,20390
0,0,0,-,-,20408
0,0,0,-,-,20415
0,0,0,-,-,20418
0,0,0,-,-,20422
0,0,0,-,-,20427
0,0,0,-,-,20431
0,0,0,-,-,20510
0,0,0,-,-,20515
0,0,0,-,-,20520
0,0,0,-,-,20530
0,0,0,-,-,20535
0,0,0,-,-,20540
0,0,0,-,-,20542
0,0,0,-,-,20551
0,0,0,-,-,20560
0,0,0,-,-,20565
0,0,0,-,-,20566
0,0,0,-,-,20591
9854,7838,2016,1990,358000,20601
10487,6868,3619,1755,339700,20602
11202,8830,2372,1946,407700,20603
75,75,0,-,421400,20606
4043,3977,66,3017,477400,20607
240,202,38,-,407100,20608
450,414,36,-,423800,20609
445,427,18,-,384500,20611
78,78,0,-,245300,20612
5157,4854,303,2104,474700,20613
192,192,0,-,509800,20615
2372,2098,274,2181,335700,20616
217,190,27,-,471700,20617
498,417,81,1424,289800,20618
5433,3329,2104,1829,364600,20619
476,387,89,1400,346000,20620
397,383,14,-,440600,20621
1441,1362,79,1534,390100,20622
876,840,36,-,428100,20623
359,336,23,-,451200,20624
487,429,58,-,242900,20625
109,100,9,-,298600,20626
278,258,20,-,432400,20628
437,413,24,-,471300,20629
159,94,65,-,572000,20630
175,161,14,-,491200,20632
2760,1906,854,1505,327800,20634
3605,3184,421,1096,444400,20636
2162,2028,134,2578,517300,20637
4893,4596,297,1211,489300,20639
4022,3083,939,1510,294400,20640
286,271,15,-,427600,20645
7399,6270,1129,1590,431900,20646
5373,4060,1313,1604,449500,20650
10831,5971,4860,1528,318600,20653
103,83,20,-,-,20656
7466,6343,1123,1534,307300,20657
406,332,74,1458,287200,20658
7995,7140,855,1583,371100,20659
0,0,0,-,-,20660
0,0,0,-,-,20661
1007,908,99,1663,357800,20662
1063,795,268,1934,353300,20664
81,68,13,-,-,20667
316,0,316,2000,-,20670
267,200,67,1725,297500,20674
767,708,59,-,421800,20675
1164,1019,145,1633,449200,20676
723,701,22,-,514700,20677
4697,3705,992,1163,397200,20678
223,162,61,-,389100,20680
301,260,41,-,397900,20684
2472,2318,154,1636,384200,20685
0,0,0,-,-,20686
176,119,57,-,-,20687
652,344,308,2868,436800,20688
582,519,63,-,430300,20689
340,284,56,1583,555100,20690
256,256,0,-,397000,20692
319,303,16,-,433700,20693
4131,3455,676,1989,407500,20695
347,0,347,2219,-,20701
8773,5861,2912,1760,418400,20705
13119,9246,3873,1794,383600,20706
14052,7863,6189,1826,386000,20707
10458,3679,6779,1766,421000,20708
3619,750,2869,1608,329000,20710
2401,2244,157,1228,389200,20711
4556,1145,3411,1417,497800,20712
1787,1287,500,1857,340200,20714
8849,8269,580,2475,414900,20715
8794,6355,2439,2070,379600,20716
8270,7764,506,2665,498000,20720
10654,9472,1182,2680,528100,20721
2142,1462,680,1603,367700,20722
12278,8756,3522,1919,493700,20723
7142,4532,2610,2126,369800,20724
4121,3440,681,1865,401500,20732
970,863,107,2406,377800,20733
13246,12200,1046,1981,380500,20735
3263,3065,198,1455,531700,20736
6657,3437,3220,1571,351700,20737
11348,4690,6658,1775,392000,20740
14,0,14,-,-,20742
15158,10131,5027,1505,296000,20743
19689,16074,3615,1727,390200,20744
12022,4867,7155,1478,328400,20745
13029,4445,8584,1696,300600,20746
16158,8058,8100,1569,313100,20747
16235,9007,7228,1503,332300,20748
941,854,87,-,465500,20751
2311,2131,180,2157,573300,20754
2938,7,2931,2331,-,20755
216,216,0,-,623000,20758
1902,1841,61,-,794400,20759
859,9,850,2631,-,20762
946,428,518,1830,414400,20763
1388,1190,198,2197,353500,20764
218,187,31,1411,475000,20765
2190,2105,85,2988,534100,20769
11746,5601,6145,1789,249000,20770
0,0,0,-,-,20771
18885,16604,2281,1981,408200,20772
20593,15748,4845,2109,412600,20774
1133,1068,65,-,584700,20776
1106,1074,32,-,808700,20777
859,835,24,-,600400,20778
441,424,17,-,492500,20779
4467,2523,1944,1625,411500,20781
12479,5777,6702,1744,396600,20782
13763,5781,7982,1647,382700,20783
10391,5871,4520,1710,334800,20784
15481,7831,7650,1726,329000,20785
3967,2523,1444,1887,380600,20794
103,94,9,2750,962800,20812
13770,7225,6545,2190,941500,20814
13258,8684,4574,2351,1205400,20815
6361,5145,1216,2603,1136500,20816
13562,11275,2287,2939,1081500,20817
708,677,31,-,1093600,20818
8470,7414,1056,2179,572800,20832
2615,2463,152,2040,749600,20833
2266,2076,190,1968,599900,20837
97,96,1,-,760400,20838
78,50,28,-,937500,20839
2926,2813,113,2491,665900,20841
657,514,143,1603,670500,20842
20951,11181,9770,2237,665400,20850
5081,3030,2051,1900,466700,20851
21460,8891,12569,2193,636800,20852
9901,8267,1634,1932,572000,20853
16701,15019,1682,3056,1042200,20854
6003,4820,1183,2307,598900,20855
795,660,135,2045,710500,20860
1043,1029,14,-,880700,20861
96,96,0,-,836700,20862
5068,4038,1030,2162,419600,20866
152,133,19,-,652500,20868
8527,7520,1007,2233,592200,20871
4497,3977,520,1741,459000,20872
22390,14556,7834,1866,376100,20874
8733,5640,3093,2051,451100,20876
12600,5489,7111,1838,442300,20877
24222,16820,7402,2068,654500,20878
8985,6413,2572,1832,414700,20879
285,272,13,-,569100,20880
4606,4533,73,-,658800,20882
12196,8371,3825,1810,354400,20886
9,0,9,-,-,20889
0,0,0,-,-,20892
0,0,0,-,-,20894
7146,5833,1313,2054,725100,20895
324,307,17,2679,909300,20896
124,0,124,1025,-,20899
13363,9220,4143,1692,546600,20901
17761,11364,6397,2002,486300,20902
7056,2972,4084,1765,452700,20903
21207,10995,10212,1867,489100,20904
5438,4745,693,1785,617800,20905
25798,17009,8789,1873,423200,20906
21809,7523,14286,1935,670700,20910
9779,4137,5642,1398,646100,20912
10516,6997,3519,1332,251600,21001
834,11,823,1854,-,21005
12664,10343,2321,1490,314900,21009
60,0,60,2711,-,21010
8144,6911,1233,2091,516300,21012
1833,1671,162,1135,555700,21013
14557,11182,3375,1453,383000,21014
11013,9945,1068,1614,410300,21015
2567,1789,778,1711,236400,21017
35,27,8,-,-,21023
1015,876,139,1656,473500,21028
4034,3732,302,3100,882700,21029
10686,4673,6013,1450,413600,21030
18,0,18,-,-,21031
3023,2727,296,2388,605300,21032
1204,1118,86,1442,348000,21034
2909,2787,122,"3,500+",765000,21035
769,736,33,-,804100,21036
7889,6772,1117,2073,482900,21037
9414,6801,2613,1384,215900,21040
14913,12585,2328,2197,650900,21042
17340,11925,5415,1883,579600,21043
18199,10993,7206,1923,514400,21044
15364,10764,4600,1602,420400,21045
6233,3577,2656,2047,436400,21046
4748,4592,156,2287,467400,21047
3599,3338,261,1185,414000,21048
6331,5688,643,1623,416100,21050
41,41,0,-,423300,21051
163,136,27,-,269500,21052
1147,1094,53,1457,413400,21053
5258,4332,926,2333,547100,21054
162,162,0,-,"2,000,000+",21056
1604,1380,224,1620,576100,21057
15408,11514,3894,1532,334800,21060
22070,12653,9417,1557,306500,21061
171,140,31,-,459100,21071
6075,5247,828,1064,343500,21074
12593,8206,4387,1941,413100,21075
8709,5649,3060,2254,472900,21076
56,56,0,-,406700,21077
7991,6089,1902,1194,344100,21078
271,259,12,-,507400,21082
2748,2450,298,1102,431800,21084
6551,5230,1321,1488,323100,21085
2139,1953,186,-,472700,21087
3926,3180,746,1813,371000,21090
15662,12339,3323,1511,451400,21093
4375,3920,455,1283,364400,21102
2026,1924,102,-,659400,21104
16,0,16,-,-,21105
6289,5573,716,1886,527700,21108
1857,1780,77,-,573600,21111
15020,9447,5573,2142,380300,21113
9254,7429,1825,1972,458200,21114
23342,12693,10649,1749,356000,21117
2554,2449,105,1630,527100,21120
22912,19645,3267,1992,402100,21122
5568,4671,897,1680,413800,21128
21,11,10,-,-,21130
2658,2618,40,-,649400,21131
977,967,10,-,495100,21132
12051,8349,3702,1460,284900,21133
13752,10746,3006,1469,375400,21136
1467,1423,44,1879,554000,21140
12846,10661,2185,1845,443200,21144
10154,9142,1012,1492,622000,21146
2570,1868,702,1682,500500,21152
268,259,9,-,1045800,21153
2376,2145,231,1503,393100,21154
1026,827,199,1385,500400,21155
110,110,0,-,461400,21156
14627,10848,3779,1147,375700,21157
8548,6708,1840,1697,358500,21158
995,770,225,1591,355900,21160
2008,1822,186,1309,426300,21161
1430,1268,162,1122,442000,21162
2531,2075,456,1441,557800,21163
10425,1160,9265,1249,251900,21201
10062,2307,7755,1438,268400,21202
8501,4111,4390,1849,524900,21204
5259,1831,3428,1024,67500,21205
20444,11211,9233,1141,197500,21206
19437,11700,7737,1343,238700,21207
15378,10373,5005,1546,286500,21208
11556,6619,4937,1587,393600,21209
5306,3291,2015,1471,479800,21210
8244,4443,3801,1595,262300,21211
12616,8679,3937,1327,343900,21212
11237,6193,5044,1251,121800,21213
8292,6458,1834,1237,233100,21214
21227,11539,9688,1112,173100,21215
11676,5695,5981,1094,131500,21216
14567,4602,9965,1051,163400,21217
18442,8980,9462,1203,220900,21218
3584,3090,494,1416,348900,21219
16232,10839,5393,1561,260400,21220
17103,10212,6891,1210,245900,21221
22394,13970,8424,1321,186100,21222
8593,2864,5729,1051,83400,21223
19358,11839,7519,1740,260200,21224
12760,6628,6132,1104,186000,21225
2518,1628,890,1319,272300,21226
13774,9135,4639,1266,259600,21227
19610,14334,5276,1595,363800,21228
18284,10054,8230,1179,168900,21229
15560,7905,7655,1700,323300,21230
7818,2734,5084,1637,330600,21231
0,0,0,-,-,21233
27598,17915,9683,1455,263100,21234
15481,10568,4913,1529,289400,21236
12073,7755,4318,1396,268400,21237
11687,6583,5104,1245,176300,21239
0,0,0,-,-,21240
14104,6692,7412,1488,255200,21244
0,0,0,-,-,21250
0,0,0,-,-,21251
0,0,0,-,-,21252
0,0,0,-,-,21285
9421,5844,3577,1438,373500,21286
0,0,0,-,-,21287
17881,11284,6597,2019,541200,21401
343,0,343,2639,-,21402
14092,9890,4202,1820,534900,21403
167,167,0,-,966500,21405
7570,6700,870,2029,487000,21409
16525,11386,5139,738,147300,21502
862,708,154,720,287100,21520
634,560,74,1026,128500,21521
58,51,7,-,99700,21523
279,200,79,1051,99600,21524
266,211,55,850,156800,21529
778,638,140,1102,198500,21530
994,806,188,759,181100,21531
5005,3326,1679,763,156900,21532
1544,1176,368,628,192600,21536
300,255,45,715,-,21538
862,562,300,650,100800,21539
31,22,9,688,42000,21540
844,617,227,864,246200,21541
60,19,41,734,-,21542
172,163,9,-,159300,21543
731,578,153,734,107900,21545
5767,4526,1241,677,211900,21550
687,509,178,918,174300,21555
807,664,143,-,132800,21557
0,0,0,-,-,21560
1164,1029,135,623,325400,21561
1245,986,259,495,116200,21562
10211,6808,3403,1180,348700,21601
160,117,43,1707,314100,21607
157,99,58,900,235900,21610
257,251,6,-,507800,21612
7447,4102,3345,958,248900,21613
3678,2907,771,1401,430600,21617
2389,1776,613,1794,438000,21619
5596,3874,1722,1072,302000,21620
189,135,54,-,171700,21622
883,736,147,1138,312100,21623
96,63,33,-,331300,21624
734,619,115,1508,364400,21625
31,31,0,-,180700,21626
16,16,0,-,225000,21627
172,164,8,-,-,21628
3308,2483,825,1151,279500,21629
1033,852,181,1488,241600,21631
2738,1632,1106,893,178800,21632
182,182,0,-,290900,21634
869,680,189,-,330400,21635
342,285,57,980,214800,21636
1953,1607,346,1608,466100,21638
1711,1205,506,1154,245200,21639
491,470,21,1650,261100,21640
61,37,24,864,220800,21641
1988,1707,281,953,176100,21643
18,18,0,-,-,21644
472,326,146,1650,338900,21645
179,167,12,-,545800,21647
76,70,6,-,156700,21648
546,450,96,1688,198100,21649
90,82,8,-,-,21650
1064,880,184,1136,245300,21651
101,95,6,-,503500,21652
60,60,0,-,400000,21653
643,540,103,1216,799100,21654
1838,1493,345,1215,266100,21655
498,446,52,1109,333900,21657
1514,1351,163,1736,465300,21658
417,372,45,788,161400,21659
1519,1055,464,892,292300,21660
1218,886,332,1099,238400,21661
288,234,54,1856,680600,21662
1640,1284,356,980,586600,21663
214,132,82,1183,162500,21664
63,63,0,-,497100,21665
5499,4390,1109,1809,458200,21666
86,70,16,-,288500,21667
714,548,166,1076,331800,21668
91,91,0,-,586500,21669
365,326,39,-,305900,21671
52,52,0,-,77100,21672
1130,890,240,1310,331800,21673
32,32,0,-,112500,21675
221,221,0,-,651100,21676
203,162,41,1427,433300,21677
783,738,45,-,296600,21678
155,146,9,-,-,21679
17403,11532,5871,1519,384700,21701
17437,11154,6283,1659,360800,21702
14741,9828,4913,1769,343900,21703
5720,4565,1155,2298,555200,21704
0,0,0,-,-,21705
1693,1411,282,2614,554400,21710
441,435,6,-,265200,21711
3919,3229,690,1214,337100,21713
105,105,0,-,408600,21714
6,6,0,-,-,21715
2665,2176,489,1039,289500,21716
97,86,11,-,226800,21717
70,50,20,1107,438900,21718
419,390,29,-,235100,21719
2220,1905,315,1036,280200,21722
240,232,8,-,852400,21723
1876,1406,470,925,317500,21727
425,368,57,-,351700,21733
474,293,181,711,232300,21734
710,698,12,-,962200,21737
1131,1094,37,-,837300,21738
24818,13357,11461,986,230400,21740
13246,8871,4375,1195,268300,21742
0,0,0,-,-,21746
1572,1073,499,990,188100,21750
2357,2273,84,-,600600,21754
2024,1783,241,1133,463400,21755
1262,1227,35,1438,339900,21756
1048,795,253,1331,425000,21757
1697,1485,212,1688,338000,21758
80,80,0,-,-,21762
295,237,58,730,206300,21766
502,291,211,772,215100,21767
4264,3754,510,1449,449900,21769
2349,2318,31,-,570000,21770
10570,9809,761,1713,501800,21771
1927,1805,122,1716,456800,21773
5141,4848,293,2503,476200,21774
2355,2047,308,1336,414300,21776
726,721,5,-,397900,21777
373,342,31,-,373100,21778
554,364,190,1179,433300,21779
765,615,150,1121,395000,21780
0,0,0,-,-,21781
1675,1324,351,1110,278800,21782
3571,2799,772,1065,305500,21783
13051,11389,1662,1647,459700,21784
4228,3387,841,853,321400,21787
4648,3754,894,1025,328600,21788
0,0,0,-,-,21790
1879,1530,349,1156,349900,21791
3992,3427,565,1627,389500,21793
773,769,4,-,935900,21794
3774,2563,1211,1077,252000,21795
2962,2688,274,1012,674500,21797
844,650,194,1372,435100,21798
11518,6375,5143,981,261900,21801
15157,7380,7777,1249,213900,21804
81,81,0,-,226600,21810
10578,8569,2009,1351,332000,21811
1198,962,236,967,511400,21813
60,60,0,-,-,21814
1867,1229,638,594,144000,21817
365,337,28,-,176600,21821
1028,717,311,936,178300,21822
117,97,20,-,112300,21824
1977,1185,792,1570,203400,21826
186,174,12,-,202800,21829
1761,1539,222,1146,236300,21830
187,176,11,-,-,21835
1170,1012,158,1193,192500,21837
832,793,39,1547,175200,21838
194,143,51,-,-,21840
421,261,160,1665,311600,21841
5705,4201,1504,1224,364200,21842
1323,1038,285,1047,226100,21849
1504,1293,211,1234,215300,21850
3090,2013,1077,829,164600,21851
3612,1892,1720,971,156800,21853
338,250,88,1193,292700,21856
309,249,60,1185,164100,21861
0,0,0,-,-,21862
1923,1428,495,1028,218600,21863
271,258,13,-,208900,21864
202,202,0,-,216700,21865
66,66,0,-,95900,21866
11,11,0,-,-,21867
337,291,46,1281,175800,21869
776,695,81,880,195200,21871
235,218,17,-,528500,21872
767,589,178,1367,193100,21874
3109,2111,998,1274,214600,21875
0,0,0,-,-,21890
7039,5266,1773,1390,314900,21901
50,0,50,-,-,21902
2093,1550,543,1056,285600,21903
2338,2028,310,1158,298800,21904
3997,3181,816,1172,295000,21911
667,597,70,772,400800,21912
382,238,144,810,223500,21913
367,246,121,1311,282600,21914
1234,1065,169,925,330800,21915
625,580,45,-,322900,21917
1685,1497,188,953,295700,21918
1412,1259,153,1591,360200,21919
329,268,61,-,360300,21920
17107,11772,5335,1393,274800,21921
13,13,0,-,-,21930
18905,13261,5644,1901,654700,22003
14892,12493,2399,2421,618700,22015
6463,5534,929,2247,469400,22025
5992,4107,1885,1706,413000,22026
657,569,88,-,987100,22027
21294,12212,9082,2204,676600,22030
14522,7068,7454,2181,694600,22031
9826,8410,1416,2174,667800,22032
15537,9772,5765,2154,606500,22033
0,0,0,-,-,22035
5619,5475,144,"3,500+",926100,22039
11223,5729,5494,1880,418600,22041
12108,7952,4156,2097,638800,22042
9804,6099,3705,2072,834400,22043
5346,2509,2837,1744,712200,22044
6749,4411,2338,2118,896400,22046
2793,231,2562,3099,633300,22060
5671,5370,301,3272,1199400,22066
11792,8827,2965,2355,570500,22079
10789,9191,1598,3320,1241500,22101
12880,6417,6463,2389,929500,22102
6765,5820,945,2513,914400,22124
467,307,160,1858,465000,22125
1407,74,1333,2124,208300,22134
9450,5968,3482,2465,598200,22150
5573,4853,720,2349,599900,22151
9735,7936,1799,2521,594200,22152
10856,9891,965,2714,609200,22153
3622,2389,1233,1414,479000,22172
9417,6565,2852,2271,878600,22180
5585,4771,814,2537,880900,22181
9800,7049,2751,2656,1035700,22182
24115,14569,9546,1941,392700,22191
20433,15345,5088,1985,433500,22192
24667,19808,4859,1805,394900,22193
19796,6147,13649,2413,749000,22201
15798,3429,12369,2429,786400,22202
13304,4180,9124,2280,803400,22203
22950,9551,13399,1816,613200,22204
6796,5449,1347,1795,989400,22205
10887,4824,6063,2243,549100,22206
12110,9773,2337,2360,1156800,22207
7962,2562,5400,2156,796200,22209
28,0,28,"3,500+",-,22211
1648,1164,484,"3,500+",974200,22213
0,0,0,-,-,22214
6109,3374,2735,2329,965600,22301
8774,4999,3775,2001,560000,22302
7974,3700,4274,1998,495900,22303
23266,9288,13978,1893,460200,22304
7588,2788,4800,1879,719900,22305
11088,5615,5473,1699,550500,22306
4527,3431,1096,1931,716200,22307
4643,4369,274,"3,500+",810100,22308
12581,8171,4410,1686,505600,22309
10857,8526,2331,2350,610100,22310
8268,1583,6685,1855,614200,22311
10363,5405,4958,1975,553900,22312
19174,9102,10072,2292,811700,22314
11613,8722,2891,2350,576100,22315
11245,4305,6940,1462,439400,22401
12068,10177,1891,1740,386200,22405
9657,7432,2225,1757,443900,22406
21715,16521,5194,1704,351200,22407
11852,9055,2797,1711,337400,22408
1396,841,555,877,245900,22427
120,92,28,-,-,22432
98,98,0,-,312500,22433
987,844,143,668,158300,22435
336,311,25,-,198400,22436
243,201,42,-,267900,22437
89,55,34,-,-,22438
4302,3259,1043,1090,241100,22443
202,0,202,1842,-,22448
756,437,319,948,273200,22454
728,621,107,1147,198200,22460
1002,749,253,942,309600,22469
0,0,0,-,-,22472
2209,2076,133,638,256100,22473
148,148,0,-,127100,22476
497,284,213,1055,336700,22480
1696,1170,526,817,326100,22482
9535,7325,2210,1310,372300,22485
342,244,98,954,496000,22488
1764,1536,228,1091,252900,22503
62,50,12,-,167600,22504
5918,5623,295,1405,347100,22508
53,45,8,-,109400,22509
469,433,36,-,393100,22511
916,708,208,1022,248100,22514
1891,1535,356,930,237000,22520
38,38,0,-,220300,22529
1037,956,81,1239,292000,22534
183,147,36,1410,237100,22535
74,74,0,-,159800,22538
865,834,31,-,374800,22539
809,734,75,-,321100,22542
6379,5436,943,1456,252200,22546
59,59,0,-,-,22548
7491,6450,1041,1331,340900,22551
5430,4261,1169,1771,385700,22553
19145,14933,4212,1919,454300,22554
9512,7571,1941,1674,427400,22556
2681,1647,1034,946,215300,22560
1124,950,174,894,278500,22567
2201,1333,868,903,226900,22572
686,646,40,-,310800,22576
1222,1090,132,1147,480000,22578
1993,1635,358,1206,267400,22580
11754,5274,6480,1231,295500,22601
10971,8538,2433,1335,334700,22602
6575,4800,1775,1550,330200,22603
633,600,33,1347,300000,22610
3339,2450,889,1284,543800,22611
951,832,119,1354,467700,22620
266,186,80,-,201100,22623
1030,897,133,1154,351700,22624
1230,1121,109,-,270300,22625
288,246,42,1500,1110700,22627
13238,9655,3583,1142,304500,22630
962,680,282,948,339000,22637
295,248,47,1431,633600,22639
157,73,84,1184,696400,22640
113,90,23,-,231400,22641
1588,1286,302,1584,284200,22642
67,67,0,-,519700,22643
1021,900,121,1267,267100,22644
1722,1303,419,955,346800,22645
19,19,0,-,-,22646
367,362,5,-,222200,22650
573,518,55,-,326500,22652
470,470,0,-,315400,22654
7903,5978,1925,1469,332200,22655
1832,1580,252,2061,350300,22656
4521,3425,1096,966,252600,22657
670,549,121,810,237800,22660
421,333,88,835,377700,22663
3634,2079,1555,1053,259200,22664
12589,8432,4157,1347,354100,22701
426,379,47,-,304400,22709
29,15,14,-,-,22711
3059,2373,686,1357,360500,22712
694,587,107,-,396500,22713
389,322,67,-,404600,22714
663,607,56,-,342900,22715
523,495,28,-,625600,22716
321,262,59,1768,352600,22718
70,62,8,-,-,22719
382,331,51,-,495300,22720
170,170,0,-,215200,22722
27,27,0,-,-,22723
764,700,64,-,457600,22724
6,6,0,-,-,22725
294,227,67,1531,363400,22726
2360,1706,654,927,321900,22727
1145,966,179,915,461600,22728
94,62,32,-,311400,22729
53,46,7,-,364300,22730
87,78,9,-,-,22731
125,98,27,-,385700,22732
565,421,144,-,344000,22733
1221,721,500,1304,332000,22734
754,675,79,1324,318300,22735
221,216,5,-,303800,22736
1139,1104,35,-,354100,22737
428,411,17,-,301400,22738
360,229,131,1159,393300,22740
81,81,0,-,371700,22741
551,464,87,1590,383100,22742
148,124,24,-,-,22743
110,110,0,-,457900,22746
480,310,170,-,504000,22747
119,79,40,-,-,22749
14350,6385,7965,1177,311600,22801
10941,5791,5150,1018,243700,22802
2,0,2,-,-,22807
284,273,11,-,304500,22810
186,129,57,-,189200,22811
3424,2317,1107,1106,315100,22812
3480,2536,944,932,234700,22815
94,75,19,-,251100,22820
2168,1708,460,946,246000,22821
2503,1933,570,947,248900,22824
4394,3406,988,809,221300,22827
757,642,115,1000,194900,22830
255,205,50,931,183500,22831
421,405,16,-,300400,22832
448,380,68,1145,327400,22834
4973,3469,1504,841,225100,22835
1946,1703,243,1534,342700,22840
1196,942,254,1071,307000,22841
2049,1520,529,955,188000,22842
962,784,178,922,228100,22843
2101,1334,767,795,258900,22844
57,57,0,-,-,22845
620,547,73,1341,427700,22846
211,149,62,940,214500,22847
1909,1472,437,939,168700,22849
441,356,85,1296,281000,22850
2015,1352,663,835,180700,22851
1684,1201,483,972,201400,22853
16075,9545,6530,1563,448900,22901
10993,5654,5339,1480,367000,22902
16062,6540,9522,1427,493800,22903
13,0,13,-,-,22904
0,0,0,-,-,22908
7618,5315,2303,1641,403800,22911
1634,1355,279,1205,341600,22920
944,868,76,733,142700,22922
2661,1732,929,1454,355300,22923
90,61,29,1219,-,22931
3352,2691,661,1666,495400,22932
326,326,0,-,439000,22935
2179,1971,208,1580,476900,22936
703,569,134,1085,264800,22937
322,291,31,-,369400,22938
2541,1787,754,1629,303800,22939
329,281,48,-,443500,22940
4190,3080,1110,1134,286100,22942
293,230,63,-,567000,22943
45,45,0,-,377300,22946
2070,1778,292,1690,655400,22947
19,19,0,-,-,22948
548,341,207,-,242000,22949
596,562,34,-,228900,22952
0,0,0,-,-,22957
1036,871,165,1427,479400,22958
677,574,103,861,501600,22959
3825,2379,1446,1020,264600,22960
6487,5946,541,1577,277800,22963
143,107,36,-,434200,22964
891,658,233,931,275900,22967
3748,2926,822,1165,301000,22968
674,512,162,1164,234200,22969
735,555,180,622,285800,22971
117,117,0,-,633000,22972
2499,2000,499,1269,237500,22973
1339,1214,125,1000,299500,22974
45,25,20,-,-,22976
13513,8852,4661,909,249600,22980
28,0,28,-,-,22989
4227,3532,695,1305,224700,23002
407,293,114,692,112300,23004
6847,4963,1884,1228,359500,23005
2815,2555,260,1431,259600,23009
369,334,35,-,343500,23011
1525,1467,58,736,375800,23015
0,0,0,-,-,23021
524,487,37,-,214200,23022
138,87,51,-,232300,23023
3924,3291,633,1082,329300,23024
397,338,59,-,534900,23025
573,503,70,1173,327800,23027
1874,1579,295,825,203900,23030
82,82,0,-,240900,23032
637,575,62,840,398100,23035
732,672,60,1553,344900,23038
522,522,0,-,380000,23039
1815,1272,543,840,161200,23040
740,593,147,971,318800,23043
33,33,0,-,-,23045
778,713,65,-,390400,23047
254,254,0,-,349800,23050
395,159,236,-,144600,23055
84,35,49,-,-,23056
14976,11747,3229,1734,545600,23059
13962,11035,2927,1508,366600,23060
8796,7511,1285,1281,277900,23061
842,507,335,953,260800,23062
1780,1350,430,1102,295500,23063
674,561,113,1208,243400,23065
310,204,106,-,413600,23066
137,137,0,-,412500,23068
1264,1127,137,1421,315200,23069
313,295,18,-,497500,23070
823,760,63,1111,293200,23071
4807,3458,1349,1105,274800,23072
3534,2085,1449,1179,180500,23075
287,272,15,-,547400,23076
186,164,22,-,169800,23079
0,0,0,-,-,23081
889,779,110,790,279500,23083
636,578,58,1316,266100,23084
166,128,38,-,-,23085
1408,1185,223,1038,232200,23086
2354,1918,436,1376,353300,23089
222,134,88,-,226500,23091
347,297,50,-,256300,23092
5424,4057,1367,1005,253800,23093
1086,987,99,1346,414300,23102
2677,2442,235,944,570100,23103
411,402,9,-,249100,23106
28,21,7,-,-,23108
1003,753,250,866,283300,23109
345,270,75,1285,225200,23110
15005,11785,3220,1414,298000,23111
20705,16638,4067,1632,342300,23112
9871,8277,1594,1599,556100,23113
8273,6531,1742,1653,360600,23114
11837,10632,1205,1840,378300,23116
3972,3536,436,1143,276100,23117
42,42,0,-,260000,23119
4961,4766,195,2400,495100,23120
639,412,227,716,128800,23123
1735,1694,41,-,361600,23124
197,174,23,-,262300,23126
163,163,0,-,-,23128
165,142,23,-,647400,23129
34,34,0,-,-,23130
386,332,54,1479,262800,23138
10025,9106,919,1193,344700,23139
2538,2365,173,1093,323100,23140
3010,2733,277,1321,336900,23141
1252,1163,89,1750,420300,23146
0,0,0,-,-,23147
575,470,105,1052,190500,23148
948,657,291,1234,230500,23149
5249,3697,1552,1148,246600,23150
534,461,73,-,296600,23153
570,488,82,1050,173800,23156
0,0,0,-,-,23160
50,0,50,-,-,23161
10,0,10,-,-,23163
3221,2880,341,1206,361000,23168
444,418,26,-,238800,23169
0,0,0,-,-,23173
838,637,201,711,317500,23175
218,193,25,-,233100,23176
379,276,103,897,197300,23177
250,205,45,-,279500,23180
2174,1729,445,1275,247100,23181
19327,13988,5339,1356,388800,23185
17648,12973,4675,1480,394800,23188
2423,2123,300,1198,336300,23192
2990,219,2771,1310,242300,23219
14634,4837,9797,1276,426000,23220
7612,3929,3683,1434,515500,23221
10938,5883,5055,1134,219900,23222
24132,10580,13552,1173,217000,23223
16134,5779,10355,1167,166600,23224
19099,9352,9747,1198,282100,23225
7390,5757,1633,1693,476600,23226
11997,6310,5687,1211,306900,23227
15290,7931,7359,1334,248600,23228
13600,9577,4023,1299,419700,23229
4101,1556,2545,1459,296500,23230
15876,10988,4888,1164,245700,23231
12377,7862,4515,1708,418900,23233
16430,9583,6847,1238,217900,23234
14079,10123,3956,1553,294300,23235
10269,9026,1243,1569,280500,23236
9414,6359,3055,1282,227700,23237
11229,6797,4432,1523,364500,23238
0,0,0,-,-,23250
9,0,9,-,-,23284
8398,3002,5396,1428,262400,23294
0,0,0,-,-,23298
681,395,286,865,250300,23301
0,0,0,-,-,23302
157,112,45,-,212700,23303
0,0,0,-,-,23304
405,199,206,1256,206900,23306
286,197,89,924,164200,23307
663,395,268,986,118800,23308
2300,1399,901,818,304700,23310
3622,2539,1083,1673,376400,23314
753,597,156,1138,283700,23315
28,24,4,-,220800,23316
25243,16020,9223,1573,312300,23320
14034,10688,3346,1383,334500,23321
21763,19145,2618,1700,434600,23322
14373,11615,2758,1576,328200,23323
8688,4826,3862,1132,221400,23324
7383,4810,2573,1380,245800,23325
1822,1223,599,1182,323500,23336
338,140,198,1703,246800,23337
222,163,59,484,423200,23347
1421,808,613,643,165500,23350
157,157,0,-,525600,23354
480,450,30,-,214200,23356
194,111,83,1549,160800,23357
62,62,0,-,-,23358
344,329,15,725,-,23359
0,0,0,-,-,23389
222,222,0,-,133400,23395
9,0,9,-,-,23398
114,62,52,1569,-,23401
487,448,39,-,338800,23405
203,149,54,-,129700,23407
8,8,0,-,-,23408
69,62,7,-,163600,23409
948,584,364,893,189200,23410
358,194,164,576,116700,23413
52,0,52,-,-,23414
1008,581,427,1278,153700,23415
42,17,25,-,-,23416
2019,1370,649,1023,234200,23417
346,260,86,1033,240800,23418
1037,567,470,885,118600,23420
1763,1154,609,746,203200,23421
97,84,13,-,-,23422
159,122,37,-,131000,23423
19,19,0,-,-,23426
114,106,8,920,88600,23427
7303,6099,1204,1098,338400,23430
487,440,47,-,399200,23432
504,490,14,1350,491900,23433
19558,13282,6276,1181,277500,23434
12651,8678,3973,1724,357300,23435
381,371,10,-,450700,23436
1933,1595,338,985,279200,23437
688,612,76,1610,246500,23438
179,174,5,-,127100,23440
0,0,0,-,-,23441
407,299,108,935,123800,23442
21006,10994,10012,1623,537900,23451
22354,13841,8513,1458,296200,23452
12980,8851,4129,1499,296200,23453
22974,15087,7887,1548,370800,23454
21093,12876,8217,1493,374700,23455
20284,18193,2091,1962,425400,23456
1645,1413,232,1199,498300,23457
0,0,0,-,-,23459
0,0,0,-,-,23460
0,0,0,-,-,23461
28125,14314,13811,1580,258500,23462
28454,19924,8530,1616,315400,23464
203,177,26,1750,189600,23480
68,39,29,-,-,23486
2276,1779,497,1055,249400,23487
105,105,0,-,211600,23488
8390,4227,4163,1238,242000,23502
14221,6507,7714,1160,251000,23503
8519,2887,5632,883,243200,23504
12189,4206,7983,1206,315000,23505
3409,1413,1996,1362,503300,23507
6555,3286,3269,1342,379300,23508
5339,3325,2014,1204,226700,23509
4610,979,3631,1423,342700,23510
333,0,333,1895,-,23511
12017,6438,5579,1153,204100,23513
2534,602,1932,1283,357000,23517
12734,7194,5540,1222,263200,23518
2947,937,2010,991,205100,23523
0,0,0,-,-,23551
11650,6296,5354,1161,223800,23601
18089,9419,8670,1351,251800,23602
1456,858,598,1350,246400,23603
786,5,781,1738,-,23604
6269,2511,3758,1112,171400,23605
12224,5868,6356,1228,287300,23606
9314,2679,6635,1052,136900,23607
17090,8698,8392,1216,234100,23608
211,0,211,1880,-,23651
5888,4072,1816,1164,185700,23661
4657,3822,835,1584,406700,23662
5393,2978,2415,1209,171300,23663
4541,3176,1365,1273,256000,23664
1588,28,1560,1809,-,23665
23205,11854,11351,1360,226400,23666
0,0,0,-,-,23667
0,0,0,-,-,23668
16583,9459,7124,1155,238200,23669
0,0,0,-,-,23681
1499,1132,367,944,341100,23690
6,0,6,-,-,23691
7422,6017,1405,1756,378700,23692
8923,6231,2692,1633,439700,23693
1356,1214,142,1762,424900,23696
9586,6213,3373,1247,198800,23701
5008,2346,2662,1198,172400,23702
9959,6896,3063,1337,262800,23703
8123,2901,5222,1211,171900,23704
6280,3483,2797,1069,200400,23707
6,0,6,-,-,23708
0,0,0,-,-,23709
1509,30,1479,1808,-,23801
16347,8221,8126,1080,183600,23803
8655,4988,3667,1166,197000,23805
657,503,154,1303,118400,23821
2615,1773,842,868,215800,23824
447,283,164,883,136900,23827
275,271,4,-,181700,23828
562,438,124,853,236000,23829
674,647,27,-,277900,23830
14346,10612,3734,1499,286100,23831
13393,11499,1894,1810,296200,23832
865,811,54,1049,304700,23833
11077,7817,3260,1149,223100,23834
5290,3914,1376,1578,298100,23836
1632,1206,426,846,193100,23837
6004,5761,243,-,403700,23838
296,231,65,-,221800,23839
606,476,130,1244,192200,23840
1278,1120,158,1319,219400,23841
2579,2261,318,1014,248000,23842
288,252,36,-,116800,23843
216,165,51,1163,-,23844
202,130,72,-,-,23845
278,241,37,686,251700,23846
4963,2837,2126,931,130500,23847
506,488,18,-,203100,23850
5370,3354,2016,930,202300,23851
541,253,288,-,104400,23856
153,70,83,-,-,23857
10983,6398,4585,1050,167000,23860
757,580,177,992,222000,23866
979,658,321,1006,158400,23867
1781,1206,575,755,133100,23868
0,0,0,-,-,23870
965,777,188,994,186000,23872
389,289,100,1019,123100,23874
4839,3439,1400,1209,240600,23875
124,115,9,-,210900,23876
640,610,30,-,216400,23878
278,171,107,1070,-,23879
967,746,221,741,259200,23881
701,538,163,784,134800,23882
769,612,157,1278,246300,23883
0,0,0,-,-,23884
1103,1007,96,792,261400,23885
341,270,71,-,207600,23887
940,631,309,988,171900,23888
260,214,46,938,-,23889
1661,1175,486,966,168600,23890
0,0,0,-,-,23891
202,191,11,-,143500,23893
164,121,43,-,200600,23894
343,194,149,1038,85100,23897
1006,726,280,691,282800,23898
218,190,28,1125,187500,23899
5725,3267,2458,885,218000,23901
0,0,0,-,-,23909
430,310,120,756,141900,23915
1048,859,189,520,157900,23917
1112,947,165,767,231700,23919
1265,993,272,1127,144300,23920
870,672,198,843,207700,23921
862,682,180,594,135100,23922
863,596,267,677,159500,23923
2440,1892,548,726,119400,23924
2080,1614,466,702,227700,23927
2234,1601,633,937,157800,23930
305,260,45,-,303400,23934
2277,1769,508,793,180700,23936
771,505,266,899,84800,23937
86,86,0,-,85000,23938
480,395,85,728,204200,23942
0,0,0,-,-,23943
1422,980,442,869,113400,23944
1489,957,532,592,156400,23947
1505,973,532,814,173400,23950
96,96,0,-,-,23952
934,558,376,686,153500,23954
7,7,0,-,-,23955
1163,948,215,1048,172200,23958
536,429,107,782,140200,23959
734,563,171,661,152100,23960
224,176,48,911,106300,23962
104,88,16,-,-,23963
431,335,96,712,78700,23964
835,627,208,947,193900,23966
483,331,152,705,134600,23967
346,241,105,-,99900,23968
3497,1954,1543,884,158100,23970
1661,1110,551,818,139400,23974
46,0,46,-,-,23976
486,50,436,996,830000,24011
12146,6897,5249,955,160100,24012
2641,1342,1299,919,100500,24013
7475,4990,2485,913,207300,24014
6952,4209,2743,823,238300,24015
4608,942,3666,919,111600,24016
9634,4839,4795,923,128200,24017
16196,11769,4427,1156,299800,24018
11672,9166,2506,1185,218100,24019
0,0,0,-,-,24020
0,0,0,-,-,24022
962,737,225,855,142200,24053
2222,1767,455,772,115600,24054
4989,3607,1382,562,105200,24055
135,122,13,-,169100,24058
410,410,0,-,235400,24059
18731,7961,10770,1217,383700,24060
0,0,0,-,-,24061
1778,1661,117,1100,235500,24064
2744,2336,408,886,225000,24065
2053,1772,281,957,184800,24066
807,593,214,634,184200,24067
653,567,86,1064,121000,24069
569,561,8,-,223600,24070
479,469,10,-,207600,24072
12614,8398,4216,1105,234000,24073
537,438,99,-,156700,24076
540,328,212,661,319400,24077
2918,1624,1294,689,119500,24078
739,561,178,832,184100,24079
235,198,37,-,150000,24082
1473,1252,221,1684,377200,24083
4368,3036,1332,814,182700,24084
1085,1002,83,815,153400,24085
53,48,5,-,156300,24086
1586,1174,412,1056,132900,24087
1719,1336,383,644,121600,24088
1093,901,192,685,85600,24089
1929,1648,281,843,265200,24090
3301,2889,412,813,242300,24091
1201,945,256,690,190900,24092
44,38,6,-,-,24093
1613,1443,170,1063,212400,24095
2572,2126,446,884,260100,24101
613,545,68,534,149900,24102
1320,1274,46,874,290500,24104
145,145,0,-,172200,24105
12645,8457,4188,727,109600,24112
891,681,210,658,168400,24120
4846,4375,471,1125,330900,24121
632,574,58,-,152600,24122
1863,1482,381,676,113500,24124
1516,1203,313,687,165600,24127
671,596,75,680,241300,24128
92,92,0,-,-,24129
32,5,27,-,-,24131
167,122,45,-,139400,24132
968,755,213,646,112600,24133
2214,1672,542,787,154900,24134
1338,1059,279,748,144000,24136
1228,1106,122,997,173500,24137
584,511,73,823,220500,24138
374,286,88,-,-,24139
8655,4981,3674,958,223000,24141
0,0,0,-,-,24142
537,333,204,575,102700,24147
3081,2477,604,726,131100,24148
1463,1215,248,599,173700,24149
273,234,39,-,152600,24150
7451,5308,2143,775,173400,24151
15092,10757,4335,1063,232500,24153
117,85,32,-,154800,24161
916,516,400,913,158100,24162
588,448,140,930,118000,24165
79,52,27,-,108700,24167
39,39,0,-,-,24168
3641,2810,831,605,128600,24171
1071,963,108,472,159300,24174
2940,2615,325,970,266700,24175
559,526,33,-,603900,24176
7996,5774,2222,852,209300,24179
1601,1381,220,671,214700,24184
327,299,28,-,221800,24185
6798,4144,2654,777,149200,24201
5248,4384,864,828,175000,24202
7438,4959,2479,769,185000,24210
4133,3504,629,881,265100,24211
1020,685,335,619,54600,24216
94,80,14,-,82900,24217
3743,2427,1316,746,142100,24219
332,332,0,-,95600,24220
223,221,2,-,115800,24221
2326,1725,601,722,107500,24224
832,496,336,391,89700,24225
662,426,236,646,81000,24226
2478,1855,623,690,89100,24228
2780,2105,675,731,103700,24230
1297,888,409,675,150700,24236
408,325,83,1094,103800,24237
22,22,0,-,-,24239
618,537,81,807,131700,24243
1944,1437,507,324,104100,24244
393,240,153,506,91700,24245
119,24,95,-,-,24246
1103,936,167,669,89700,24248
494,432,62,-,108100,24250
3452,2676,776,624,123900,24251
1186,882,304,600,91200,24256
603,543,60,-,123100,24258
2063,1475,588,608,96600,24260
2450,1687,763,520,93800,24263
307,270,37,-,92100,24265
3479,2639,840,680,116300,24266
164,144,20,-,-,24269
149,138,11,-,194800,24270
1147,949,198,633,146100,24271
223,208,15,-,82400,24272
2428,1473,955,609,95500,24273
1962,1176,786,657,86000,24277
1691,1436,255,646,96200,24279
251,216,35,-,248800,24280
848,627,221,895,123000,24281
198,169,29,-,-,24282
870,608,262,496,100700,24283
815,502,313,759,142700,24290
122,97,25,-,97500,24292
4027,2888,1139,728,114600,24293
5932,3757,2175,784,157200,24301
743,519,224,716,77200,24311
706,439,267,826,121100,24312
196,183,13,-,87000,24313
578,472,106,-,116600,24314
1217,1036,181,691,167600,24315
16,16,0,-,-,24316
1636,1279,357,608,95500,24317
218,205,13,-,72800,24318
2614,1770,844,749,154600,24319
10,10,0,-,-,24322
387,335,52,-,160100,24323
966,828,138,832,190300,24324
593,486,107,632,143800,24325
407,352,55,-,150700,24326
0,0,0,-,-,24327
844,800,44,-,166900,24328
1271,1110,161,652,116100,24330
7232,5602,1630,707,129800,24333
2239,1661,578,787,165400,24340
3464,2600,864,638,136300,24343
646,535,111,570,148800,24347
1691,1186,505,586,140800,24348
562,485,77,-,97300,24350
196,107,89,-,124200,24351
493,367,126,435,130900,24352
6079,3858,2221,687,135500,24354
2520,2145,375,571,191800,24360
1754,1285,469,800,148800,24361
525,491,34,-,114600,24363
167,160,7,-,-,24366
1912,1649,263,749,151000,24368
2395,1790,605,593,91100,24370
287,249,38,1026,-,24374
735,593,142,-,74600,24375
137,137,0,-,180100,24377
443,407,36,682,122200,24378
1288,1101,187,723,196800,24380
1160,888,272,655,145300,24381
6875,4596,2279,651,155900,24382
16345,10358,5987,964,236100,24401
3,3,0,-,-,24411
104,104,0,-,-,24412
149,149,0,-,168800,24413
18,18,0,-,-,24415
3579,2257,1322,993,152600,24416
1403,1134,269,1098,335600,24421
2263,1701,562,536,108700,24422
5804,4762,1042,745,109800,24426
668,394,274,738,162500,24430
934,836,98,-,168800,24431
220,211,9,-,139600,24432
34,23,11,-,211700,24433
760,739,21,-,186100,24435
546,546,0,-,297100,24437
527,406,121,719,153600,24439
1076,923,153,1529,243900,24440
2566,1956,610,957,229300,24441
37,34,3,-,-,24442
1136,768,368,717,168400,24445
187,170,17,-,75200,24448
6092,4007,2085,976,279400,24450
100,50,50,-,-,24457
153,145,8,-,187500,24458
193,139,54,-,290700,24459
580,422,158,635,179400,24460
113,6,107,-,-,24464
550,450,100,879,185500,24465
1143,936,207,661,343900,24467
0,0,0,-,-,24469
683,592,91,-,229200,24471
825,731,94,916,249800,24472
331,311,20,-,381200,24473
155,155,0,-,89300,24474
128,113,15,-,210700,24476
4602,3450,1152,1072,247100,24477
825,779,46,-,342000,24479
1889,1429,460,1051,215000,24482
386,362,24,-,236700,24483
250,231,19,-,168400,24484
143,134,9,-,180000,24485
1176,924,252,1050,276300,24486
161,132,29,-,341100,24487
10224,4568,5656,864,140000,24501
16441,8574,7867,1106,199500,24502
8088,6162,1926,913,293500,24503
3903,2114,1789,973,169600,24504
0,0,0,-,-,24515
2108,1538,570,769,120300,24517
975,842,133,724,126600,24520
4108,3099,1009,831,206900,24521
3950,3026,924,862,171900,24522
8432,6366,2066,864,210800,24523
629,517,112,832,219000,24526
1066,879,187,931,140900,24527
1420,1051,369,765,130700,24528
630,481,149,705,215800,24529
453,376,77,732,146700,24530
3336,2583,753,776,137000,24531
647,513,134,804,118800,24534
88,88,0,-,296800,24536
1911,1566,345,744,151300,24538
174,111,63,734,142600,24539
13345,7911,5434,782,128000,24540
12385,6773,5612,803,124800,24541
1654,1340,314,867,134900,24549
2987,2375,612,755,180000,24550
10379,8448,1931,1059,331100,24551
730,564,166,1063,143400,24553
1528,1278,250,913,138200,24554
934,747,187,772,164800,24555
999,963,36,-,305200,24556
3483,2481,1002,707,125000,24557
2550,1903,647,772,136900,24558
244,195,49,-,240800,24562
2128,1540,588,822,123700,24563
406,347,59,-,124200,24565
554,483,71,1856,107000,24566
336,311,25,-,140300,24569
0,0,0,-,-,24570
923,758,165,786,137600,24571
6555,4859,1696,777,172800,24572
1564,1312,252,869,203300,24574
1965,1474,491,731,118200,24577
270,209,61,-,175500,24578
489,354,135,-,147600,24579
285,220,65,645,116100,24580
0,0,0,-,-,24581
1874,1362,512,1079,149300,24586
3813,2698,1115,706,181600,24588
979,762,217,628,110000,24589
2983,2444,539,1085,240800,24590
5128,3297,1831,709,148400,24592
963,805,158,962,205100,24593
718,613,105,991,150600,24594
63,27,36,-,-,24595
375,308,67,863,150000,24597
475,418,57,1031,129000,24598
326,287,39,-,-,24599
0,0,0,-,-,24601
295,187,108,623,54500,24602
255,255,0,-,101400,24603
80,80,0,-,72900,24604
3533,2716,817,762,134800,24605
90,90,0,-,39800,24606
133,109,24,-,33400,24607
2684,2003,681,761,136100,24609
89,51,38,-,-,24612
248,237,11,-,72300,24613
2823,2281,542,782,102500,24614
773,680,93,-,61300,24620
252,228,24,-,75200,24622
2350,1456,894,769,109700,24630
592,398,194,744,90700,24631
113,109,4,-,150900,24634
133,102,31,-,49300,24635
1348,1056,292,-,137700,24637
1392,967,425,657,104900,24639
2342,1545,797,824,103900,24641
407,393,14,-,66600,24646
759,641,118,2545,84200,24649
2249,1710,539,606,119000,24651
1006,888,118,643,87300,24656
114,37,77,1117,59500,24657
7835,5116,2719,822,97800,24701
635,517,118,880,175300,24712
65,65,0,-,284700,24714
98,94,4,-,175000,24715
80,12,68,-,-,24716
49,49,0,-,88800,24719
51,32,19,-,63800,24724
161,126,35,-,36500,24726
30,30,0,-,81200,24729
21,21,0,-,-,24731
131,131,0,-,206900,24733
279,243,36,710,28300,24736
445,301,144,491,-,24737
0,0,0,-,-,24738
5557,4261,1296,746,121100,24739
6971,4378,2593,767,127600,24740
1250,869,381,797,97300,24747
1302,968,334,788,55100,24801
238,211,27,536,-,24808
207,133,74,-,168300,24811
0,0,0,-,-,24813
140,131,9,-,-,24815
16,16,0,-,-,24816
484,407,77,542,40800,24817
386,279,107,-,61300,24818
506,418,88,-,115700,24822
199,133,66,-,-,24823
50,6,44,-,-,24826
383,365,18,-,166100,24827
267,259,8,-,41200,24828
30,24,6,-,45500,24830
151,151,0,-,48500,24831
367,367,0,-,77900,24834
224,188,36,-,72000,24836
190,160,30,-,24200,24839
13,13,0,-,-,24843
443,393,50,-,47300,24844
190,164,26,-,93600,24845
127,71,56,-,80600,24846
44,44,0,-,-,24847
58,47,11,-,16600,24848
146,146,0,-,133100,24849
0,0,0,-,-,24850
145,125,20,-,82200,24851
316,113,203,560,81000,24853
306,213,93,-,64500,24854
27,23,4,-,-,24855
263,228,35,-,-,24857
93,65,28,-,-,24860
49,16,33,-,-,24861
196,177,19,-,-,24862
223,213,10,-,19700,24866
20,20,0,-,-,24867
508,456,52,629,29400,24868
133,121,12,-,-,24869
629,487,142,634,56800,24870
181,142,39,-,52300,24871
321,219,102,-,-,24872
179,140,39,-,-,24873
852,467,385,-,95300,24874
53,53,0,-,54200,24878
230,194,36,-,-,24879
267,195,72,-,87400,24880
39,39,0,-,-,24881
341,341,0,-,-,24882
37,32,5,-,-,24884
0,0,0,-,-,24887
16,16,0,-,-,24888
479,268,211,691,38500,24892
125,86,39,-,26700,24894
11,11,0,-,-,24895
88,88,0,-,-,24898
4149,2623,1526,884,249200,24901
1622,1318,304,755,117300,24910
227,191,36,740,57200,24915
261,237,24,-,307400,24916
553,369,184,614,134500,24918
105,86,19,-,91000,24920
260,234,26,-,-,24924
273,242,31,-,208900,24925
181,147,34,-,74000,24927
482,385,97,621,116300,24931
161,116,45,-,218800,24934
189,170,19,-,66100,24935
542,441,101,-,168800,24938
379,298,81,648,117200,24941
37,37,0,-,-,24943
150,143,7,-,124300,24944
129,129,0,-,95500,24945
335,298,37,-,164400,24946
612,544,68,-,179300,24951
1164,974,190,617,128000,24954
246,233,13,-,318500,24957
30,30,0,-,-,24962
1336,1127,209,677,121300,24963
489,462,27,-,112700,24966
1844,1430,414,860,106000,24970
106,106,0,-,62200,24974
359,298,61,611,203800,24976
187,126,61,674,89400,24977
239,107,132,-,-,24981
828,701,127,529,184300,24983
63,45,18,-,322400,24984
92,88,4,-,-,24985
2183,1662,521,759,122600,24986
255,255,0,-,120200,24991
27,27,0,-,-,24993
0,0,0,-,-,25002
706,537,169,-,114900,25003
129,129,0,-,146100,25005
172,172,0,-,-,25007
78,61,17,-,91900,25008
327,283,44,-,79800,25009
232,171,61,781,99600,25011
1578,1219,359,890,106800,25015
199,191,8,-,57900,25019
195,146,49,490,92200,25021
52,29,23,-,-,25022
190,131,59,636,83000,25024
34,10,24,-,-,25025
150,150,0,-,69500,25028
104,69,35,-,-,25030
362,187,175,546,91300,25031
695,570,125,492,115000,25033
223,120,103,-,-,25035
70,70,0,-,-,25036
264,226,38,-,64000,25039
209,161,48,-,85200,25040
401,209,192,619,112500,25043
137,117,20,-,151800,25044
1596,1169,427,871,96500,25045
49,49,0,-,-,25047
65,58,7,-,-,25048
160,134,26,-,85400,25049
74,74,0,-,81000,25051
1481,1065,416,818,126300,25053
90,30,60,-,-,25054
62,62,0,-,70600,25057
156,133,23,-,66100,25059
92,61,31,-,-,25060
221,211,10,-,82100,25061
90,90,0,-,84200,25062
627,521,106,-,95300,25063
4497,2738,1759,917,120000,25064
295,222,73,839,92200,25067
750,613,137,910,197700,25070
4517,3429,1088,835,152200,25071
256,93,163,-,29000,25075
31,31,0,-,"10,000-",25076
507,477,30,-,147800,25081
623,600,23,-,242700,25082
149,136,13,-,70000,25083
264,171,93,679,79100,25085
326,267,59,850,99300,25086
113,113,0,-,15600,25088
81,44,37,437,-,25090
70,40,30,-,-,25093
141,139,2,-,40600,25102
150,83,67,-,79300,25103
199,156,43,836,-,25106
196,176,20,-,37300,25107
247,229,18,-,182200,25108
310,310,0,-,166700,25109
182,182,0,-,-,25110
147,142,5,-,78800,25111
0,0,0,-,-,25112
180,166,14,-,-,25113
87,46,41,-,"10,000-",25114
39,39,0,-,54400,25115
192,119,73,-,53700,25118
116,104,12,-,-,25119
329,275,54,-,146900,25121
1166,944,222,684,122200,25123
615,602,13,-,140400,25124
332,272,60,-,-,25125
162,149,13,-,-,25126
1201,879,322,804,95700,25130
125,61,64,-,32700,25132
288,242,46,394,108300,25133
164,164,0,-,54400,25134
692,242,450,613,108500,25136
143,143,0,-,-,25139
407,288,119,-,31500,25140
82,82,0,-,116700,25141
109,109,0,-,-,25142
3654,2569,1085,801,112900,25143
153,153,0,-,67400,25148
51,38,13,-,-,25149
202,202,0,-,58000,25152
307,242,65,-,95900,25154
14,14,0,-,-,25156
1751,1482,269,869,142800,25159
182,152,30,-,27600,25160
167,152,15,-,55600,25161
145,110,35,789,119300,25162
373,335,38,-,115300,25164
296,279,17,-,106900,25165
1103,947,156,1012,151200,25168
188,161,27,-,-,25169
106,51,55,-,65000,25173
155,155,0,-,67300,25174
9595,6804,2791,853,127200,25177
88,88,0,-,107500,25180
513,472,41,417,69700,25181
63,63,0,-,-,25183
0,0,0,-,-,25185
369,199,170,597,-,25186
336,317,19,-,213700,25187
120,75,45,767,82500,25193
46,46,0,-,-,25201
395,342,53,-,142000,25202
70,26,44,-,-,25203
36,25,11,-,-,25204
37,37,0,-,-,25205
86,44,42,-,-,25206
248,134,114,619,59500,25208
200,166,34,-,76300,25209
51,51,0,-,-,25211
2473,2111,362,1014,246200,25213
302,235,67,-,153100,25214
0,0,0,-,-,25231
237,180,57,716,150000,25234
502,364,138,-,112800,25235
499,443,56,1098,166000,25239
704,646,58,-,187200,25241
253,216,37,-,104900,25243
197,174,23,-,79300,25244
319,319,0,-,138400,25245
231,172,59,691,80000,25247
1321,1088,233,675,181000,25248
187,148,39,734,202000,25251
466,401,65,-,168100,25252
857,751,106,-,128700,25253
223,205,18,-,208300,25259
689,543,146,766,90300,25260
59,59,0,-,88300,25261
462,451,11,-,139900,25262
205,129,76,-,159000,25264
685,596,89,451,106400,25265
259,192,67,-,193200,25266
287,234,53,-,-,25267
178,135,43,-,104500,25268
343,263,80,-,-,25270
3521,2275,1246,600,140900,25271
781,681,100,-,157800,25275
3162,2111,1051,628,106900,25276
307,234,73,-,-,25285
526,453,73,489,110700,25286
211,155,56,-,108200,25287
1425,306,1119,568,165300,25301
6597,3822,2775,840,128700,25302
3120,2174,946,928,166400,25303
3480,2315,1165,919,207100,25304
0,0,0,-,-,25305
2891,1990,901,1284,94500,25306
5461,3936,1525,759,137600,25309
4653,2819,1834,824,101500,25311
3741,3244,497,853,124300,25312
5443,4076,1367,891,138100,25313
6556,5339,1217,1100,231000,25314
1426,965,461,856,82900,25315
1720,1234,486,803,121600,25320
2085,1253,832,949,85300,25387
6106,3273,2833,1000,189700,25401
5908,4908,1000,1321,277700,25403
9370,5717,3653,1119,216100,25404
5676,4584,1092,1493,240200,25405
4935,3975,960,749,217000,25411
3144,2445,699,1281,228900,25413
7657,5911,1746,939,330100,25414
4800,4025,775,1092,237500,25419
2039,1555,484,987,258400,25420
10,10,0,-,-,25421
665,648,17,-,136400,25422
5329,4557,772,1282,288400,25425
6371,5814,557,1130,235900,25427
5435,4711,724,1342,220200,25428
2697,2180,517,1307,282700,25430
123,123,0,-,163800,25431
43,20,23,-,-,25432
905,754,151,738,145800,25434
72,53,19,-,-,25437
2668,1787,881,1117,211700,25438
806,741,65,1164,326600,25442
2596,2093,503,1043,377500,25443
127,126,1,-,276500,25444
373,373,0,-,405800,25446
533,460,73,-,101400,25501
287,287,0,-,82300,25502
291,274,17,-,69300,25503
5020,3921,1099,899,160100,25504
111,111,0,-,-,25505
1861,1399,462,721,80800,25506
389,332,57,798,121100,25507
3536,2747,789,673,121300,25508
2057,1723,334,1012,155100,25510
275,226,49,-,124400,25511
519,421,98,640,-,25512
1594,1280,314,923,67700,25514
738,672,66,-,112200,25515
596,456,140,634,61100,25517
748,707,41,-,76900,25520
381,278,103,-,91200,25521
1003,670,333,709,104700,25523
973,871,102,-,83600,25524
8842,7064,1778,945,223400,25526
409,304,105,950,76800,25529
2541,1804,737,827,117700,25530
61,53,8,-,82200,25534
804,729,75,826,219900,25535
715,425,290,695,144400,25537
159,147,12,-,33200,25540
4377,3401,976,928,164000,25541
30,30,0,-,-,25544
1606,1493,113,1022,181100,25545
206,148,58,-,114300,25547
3705,2991,714,625,121000,25550
641,467,174,771,132300,25555
738,570,168,763,77600,25557
755,623,132,-,106600,25559
3296,2515,781,1433,252900,25560
445,424,21,-,212000,25564
322,245,77,-,-,25565
294,187,107,-,96400,25567
1939,1400,539,824,109900,25570
754,640,114,708,111900,25571
193,140,53,829,190000,25573
2098,1262,836,843,93800,25601
285,217,68,552,88800,25606
293,194,99,575,62800,25607
262,212,50,-,180200,25608
384,354,30,-,-,25611
173,146,27,-,-,25612
101,90,11,-,-,25617
801,639,162,694,78200,25621
168,168,0,-,94300,25624
356,331,25,-,87500,25625
184,119,65,949,125400,25628
162,155,7,-,108900,25630
230,185,45,-,11900,25632
503,442,61,538,98800,25634
496,355,141,692,131100,25635
490,328,162,-,59400,25637
188,154,34,-,52300,25638
198,157,41,-,86300,25639
212,160,52,-,-,25644
338,278,60,-,84400,25646
112,63,49,-,-,25647
522,354,168,-,115700,25649
35,35,0,-,-,25650
247,222,25,-,87100,25651
502,406,96,1012,81500,25652
67,67,0,-,94600,25653
81,51,30,-,-,25654
2150,1226,924,518,91900,25661
65,65,0,-,-,25666
156,93,63,1010,82800,25667
345,272,73,-,-,25669
1335,1154,181,736,95000,25670
512,311,201,544,66800,25671
180,150,30,-,73000,25672
822,542,280,718,102000,25674
391,323,68,-,94700,25676
610,403,207,356,102600,25678
206,152,54,-,129100,25685
110,30,80,-,88300,25688
231,170,61,-,105200,25690
506,440,66,334,105300,25692
527,407,120,664,91000,25696
17,17,0,-,-,25699
9774,5761,4013,840,149700,25701
3049,1664,1385,819,78700,25702
2118,432,1686,847,79400,25703
6112,4252,1860,872,113000,25704
8785,5834,2951,894,152700,25705
0,0,0,-,-,25755
12603,8579,4024,837,138700,25801
0,0,0,-,-,25810
0,0,0,-,-,25811
552,410,142,758,67000,25812
2562,2164,398,887,134000,25813
126,126,0,-,180100,25817
147,15,132,834,-,25818
219,193,26,-,278000,25820
221,154,67,-,116800,25823
945,870,75,-,120100,25825
81,81,0,-,50200,25826
750,643,107,-,205600,25827
497,346,151,759,91700,25831
1773,1649,124,754,192200,25832
402,361,41,-,174000,25836
155,155,0,-,197300,25837
227,125,102,-,-,25839
3060,2508,552,881,119400,25840
199,173,26,-,142100,25841
474,335,139,-,280200,25843
290,153,137,744,-,25844
215,129,86,-,-,25845
42,42,0,-,55000,25846
123,27,96,-,-,25848
194,94,100,-,-,25849
0,0,0,-,-,25851
50,28,22,-,-,25853
353,271,82,1056,150200,25854
119,81,38,-,-,25855
14,14,0,-,-,25857
139,139,0,-,224400,25862
44,44,0,-,-,25864
613,551,62,575,159000,25865
110,87,23,-,36200,25866
188,179,9,-,126200,25868
48,48,0,-,-,25870
415,249,166,851,85700,25871
359,359,0,-,132000,25873
211,192,19,-,119600,25875
28,28,0,-,-,25876
414,326,88,-,104700,25878
86,71,15,-,-,25879
2101,1345,756,744,116600,25880
750,650,100,-,84400,25882
4330,3185,1145,800,112100,25901
96,96,0,-,-,25902
235,188,47,-,88100,25904
55,55,0,-,85400,25907
0,0,0,-,-,25908
320,262,58,-,109000,25909
107,107,0,-,-,25911
89,89,0,-,-,25913
95,76,19,-,"10,000-",25915
56,56,0,-,-,25916
647,514,133,-,93100,25917
1823,1635,188,946,148100,25918
87,87,0,-,"10,000-",25920
1354,778,576,734,86000,25921
74,74,0,-,-,25922
162,162,0,-,55700,25928
80,80,0,-,95400,25932
4,0,4,-,-,25936
524,463,61,-,99900,25938
27,27,0,-,-,25942
0,0,0,-,-,25943
2403,1766,637,806,118700,25951
255,203,52,943,67600,25958
1526,1073,453,632,92800,25962
12,12,0,-,107100,25966
610,569,41,-,151400,25969
637,637,0,-,156800,25971
64,64,0,-,52400,25972
966,837,129,629,119800,25976
0,0,0,-,-,25977
188,187,1,-,165200,25978
290,242,48,-,100000,25979
312,254,58,634,33500,25981
728,540,188,595,77300,25984
161,81,80,877,100400,25985
136,136,0,-,139100,25986
121,57,64,-,180700,25989
17528,12090,5438,772,156500,26003
238,187,51,746,55000,26030
715,453,262,729,71900,26031
224,177,47,808,88800,26032
700,616,84,-,137200,26033
2113,1582,531,859,115900,26034
723,694,29,-,100000,26035
147,112,35,-,275000,26036
2728,1988,740,599,116300,26037
1247,1136,111,827,214600,26038
154,102,52,1097,93800,26039
668,480,188,556,85800,26040
6083,4642,1441,806,118200,26041
2401,1786,615,656,120400,26047
599,307,292,701,81000,26050
555,492,63,697,97700,26055
107,107,0,-,84200,26056
31,31,0,-,-,26058
1073,854,219,913,136300,26059
609,520,89,800,164200,26060
9705,6786,2919,699,115500,26062
3433,2806,627,552,116400,26070
204,152,52,883,150000,26074
270,253,17,842,71200,26075
12171,8004,4167,772,97700,26101
7319,5383,1936,699,152700,26104
5205,3903,1302,853,151500,26105
473,439,34,-,186200,26133
274,188,86,605,116700,26134
141,127,14,-,114100,26136
262,233,29,-,158500,26137
83,39,44,-,-,26138
142,138,4,-,70000,26141
919,847,72,900,95000,26142
1552,1280,272,512,102400,26143
343,315,28,-,166600,26146
757,566,191,560,102600,26147
121,107,14,-,66200,26148
755,651,104,650,123800,26149
2336,1820,516,766,179900,26150
234,197,37,-,82400,26151
12,0,12,-,-,26152
3158,2506,652,684,129000,26155
1033,811,222,863,91200,26159
419,403,16,-,121400,26160
201,201,0,-,121900,26161
0,0,0,-,-,26162
3017,2263,754,838,125100,26164
313,290,23,-,114900,26167
324,221,103,-,135400,26169
2267,1932,335,679,118300,26170
1195,1045,150,532,108100,26175
79,53,26,-,-,26178
794,647,147,-,104600,26180
2559,2244,315,787,193200,26181
820,733,87,-,166200,26184
2654,2326,328,884,187600,26187
7841,5866,1975,734,154400,26201
173,173,0,-,114400,26202
188,135,53,-,"10,000-",26203
1186,865,321,554,101500,26205
971,796,175,620,85500,26206
317,265,52,705,71700,26208
33,15,18,-,-,26209
0,0,0,-,-,26210
56,56,0,-,-,26215
66,19,47,-,-,26217
1004,802,202,923,153500,26218
78,33,45,-,-,26222
87,74,13,-,-,26224
0,0,0,-,-,26228
68,59,9,-,-,26230
524,524,0,-,168300,26234
7,7,0,-,-,26236
180,180,0,-,103800,26237
535,535,0,-,113300,26238
5609,3814,1795,754,143300,26241
1655,1278,377,719,102100,26250
1223,848,375,868,134600,26253
23,18,5,-,-,26254
247,226,21,-,-,26257
44,44,0,-,172100,26259
615,498,117,775,194200,26260
1203,945,258,616,59600,26261
118,102,16,-,76000,26263
261,212,49,688,139800,26264
62,62,0,-,-,26266
200,135,65,-,205000,26267
0,0,0,-,-,26268
439,409,30,-,141100,26269
303,270,33,613,88500,26270
172,143,29,644,115600,26271
337,297,40,525,119700,26273
190,139,51,758,73000,26275
259,248,11,-,126900,26276
293,246,47,-,105200,26278
480,369,111,861,92500,26280
113,113,0,-,61600,26282
594,508,86,615,150500,26283
137,119,18,-,94700,26285
1148,893,255,823,119900,26287
1224,917,307,660,84200,26288
6,6,0,-,-,26289
24,24,0,-,-,26291
288,191,97,821,136000,26292
233,172,61,-,190300,26293
238,238,0,-,112300,26294
44,44,0,-,-,26296
41,41,0,-,94600,26298
11647,7768,3879,739,117100,26301
281,276,5,-,78500,26320
98,76,22,-,92700,26321
237,134,103,766,70000,26323
94,75,19,-,-,26325
35,35,0,-,-,26327
6098,4576,1522,1107,245100,26330
488,404,84,730,83800,26335
380,349,31,675,93100,26337
206,165,41,-,98700,26338
42,29,13,-,129800,26339
184,162,22,-,113200,26342
166,140,26,-,-,26343
209,174,35,580,120000,26346
823,711,112,821,203000,26347
139,132,7,-,63800,26348
78,43,35,-,-,26349
986,610,376,716,99300,26351
3958,3294,664,460,117200,26354
10,10,0,-,-,26361
1140,900,240,696,107700,26362
27,27,0,-,-,26366
181,89,92,928,98000,26369
265,222,43,-,430800,26372
683,650,33,904,151300,26374
154,114,40,-,146400,26376
230,201,29,-,120200,26377
1792,1623,169,652,169900,26378
203,182,21,-,103300,26384
1113,1027,86,1070,151200,26385
1029,830,199,684,131000,26386
103,103,0,-,65100,26404
387,358,29,-,151500,26405
963,893,70,-,218100,26408
288,269,19,713,105800,26410
290,202,88,754,156100,26411
177,177,0,-,137500,26412
1002,877,125,763,99600,26415
2858,1952,906,636,132000,26416
219,164,55,-,98200,26419
69,49,20,-,237500,26421
149,127,22,-,86100,26422
68,37,31,-,-,26424
420,358,62,642,84800,26425
2485,2141,344,675,113600,26426
122,81,41,283,149200,26430
2126,1538,588,798,119600,26431
22,22,0,-,-,26435
55,55,0,-,83000,26436
205,168,37,459,90700,26437
62,54,8,-,-,26438
458,410,48,-,157500,26440
115,115,0,-,-,26443
1396,1228,168,786,97500,26444
491,312,179,686,154000,26447
392,374,18,-,86200,26448
187,169,18,670,122300,26451
3921,2558,1363,739,113100,26452
1149,1036,113,366,151500,26456
133,67,66,-,136300,26463
8456,4933,3523,893,201700,26501
16626,5684,10942,931,258400,26505
22,22,0,-,-,26506
15378,11309,4069,971,277700,26508
835,599,236,684,160500,26519
211,211,0,-,-,26520
60,53,7,-,-,26521
72,59,13,-,162500,26524
2083,1842,241,779,186400,26525
462,252,210,765,119900,26534
2304,1702,602,664,158700,26537
1656,1530,126,560,209400,26541
842,671,171,1063,141500,26542
44,44,0,-,-,26543
21,21,0,-,-,26544
90,49,41,-,866800,26546
1087,826,261,765,164700,26547
17597,12501,5096,907,160100,26554
628,567,61,719,155700,26559
45,45,0,-,-,26560
170,139,31,-,79000,26562
97,52,45,-,117500,26563
242,187,55,-,83800,26568
1239,1076,163,573,151900,26570
594,518,76,905,100600,26571
112,62,50,1111,52000,26572
173,138,35,683,86400,26574
331,288,43,471,93300,26575
375,375,0,-,106800,26576
388,361,27,-,-,26581
1608,1395,213,680,102500,26582
222,202,20,-,164000,26585
32,32,0,-,-,26586
93,65,28,-,83700,26587
1239,1024,215,804,161700,26588
251,237,14,-,133500,26590
598,532,66,698,113600,26591
1244,978,266,500,101500,26601
280,195,85,690,125600,26610
45,38,7,-,-,26611
53,42,11,-,-,26615
51,51,0,-,99200,26617
164,145,19,-,117800,26619
331,254,77,672,95500,26621
477,469,8,-,99200,26623
1042,755,287,600,90100,26624
82,58,24,-,-,26627
178,136,42,-,94500,26629
87,87,0,-,-,26631
101,90,11,-,46200,26636
86,76,10,-,-,26638
3840,2905,935,722,153400,26651
118,118,0,-,-,26656
161,161,0,-,100600,26660
198,198,0,-,190900,26662
10,10,0,-,54300,26667
145,145,0,-,116500,26671
95,95,0,-,115400,26676
499,499,0,-,106400,26678
563,462,101,979,142500,26679
181,157,24,-,96900,26680
448,414,34,-,-,26681
143,108,35,-,-,26684
272,235,37,-,49600,26690
260,185,75,-,150200,26691
1872,1647,225,679,212000,26704
252,177,75,-,-,26705
109,87,22,675,73000,26707
890,784,106,727,183700,26710
947,759,188,1267,221300,26711
146,143,3,-,146600,26714
344,195,149,829,130700,26716
398,390,8,-,84800,26717
939,702,237,717,162500,26719
40,40,0,-,-,26720
156,123,33,-,-,26722
4784,3758,1026,637,152700,26726
166,139,27,-,-,26731
290,253,37,-,144400,26739
773,712,61,-,237900,26743
354,204,150,510,52300,26750
2397,1997,400,951,202600,26753
186,153,33,-,166600,26755
2567,1830,737,552,160200,26757
325,246,79,840,75600,26761
510,438,72,-,204100,26763
1783,1388,395,712,113400,26764
155,138,17,-,164800,26767
446,369,77,678,152500,26801
404,315,89,644,160600,26802
191,153,38,488,133900,26804
861,737,124,720,200300,26807
237,200,37,-,244400,26808
225,214,11,-,161700,26810
704,600,104,635,116700,26812
157,157,0,-,135600,26814
209,170,39,656,161200,26815
201,201,0,-,-,26817
428,273,155,619,97000,26818
28,0,28,-,-,26823
859,782,77,-,137100,26833
2510,1753,757,854,145800,26836
25,25,0,-,-,26838
311,280,31,-,168400,26845
2243,1610,633,627,155000,26847
781,650,131,846,184600,26851
324,315,9,-,178100,26852
222,194,28,878,152000,26855
121,85,36,797,-,26865
309,252,57,725,203000,26866
101,73,28,-,116100,26884
85,65,20,-,31900,26886
6341,5601,740,878,286700,27006
757,622,135,788,172500,27007
1240,1160,80,1194,207300,27009
2160,1700,460,713,152500,27011
11710,9454,2256,989,293700,27012
2560,2043,517,770,173500,27013
311,215,96,900,131000,27014
825,760,65,1013,152600,27016
3289,2520,769,683,133700,27017
2945,2458,487,713,193200,27018
1666,1374,292,759,172900,27019
2389,1826,563,732,144300,27020
7188,5287,1901,886,180000,27021
468,352,116,717,122600,27022
5038,4214,824,1034,286800,27023
1040,917,123,613,175400,27024
4797,4029,768,649,136800,27025
1985,1220,765,624,114100,27027
9725,7658,2067,812,185700,27028
15372,10531,4841,685,143300,27030
4741,4366,375,1009,236300,27040
3145,2336,809,732,175400,27041
72,72,0,-,207100,27042
2756,2391,365,774,198600,27043
4173,3247,926,985,169700,27045
1094,867,227,571,165200,27046
444,413,31,-,161100,27047
3440,2905,535,790,141500,27048
1447,1260,187,800,174300,27050
3130,2184,946,1120,181800,27051
4149,3082,1067,784,164300,27052
1437,1249,188,722,184600,27053
957,925,32,-,188800,27054
5472,4146,1326,731,174300,27055
9518,3207,6311,877,192400,27101
16252,8561,7691,1042,201500,27103
13645,8167,5478,1070,312200,27104
14917,7474,7443,809,128000,27105
19583,10397,9186,1006,254900,27106
18581,12968,5613,856,180600,27107
0,0,0,-,-,27109
0,0,0,-,-,27110
16140,10369,5771,1002,168900,27127
51,38,13,-,156300,27201
27,27,0,-,-,27202
8864,3882,4982,792,134300,27203
14042,11258,2784,788,171300,27205
1464,1178,286,636,153100,27207
637,582,55,1000,134100,27208
1347,795,552,765,116700,27209
516,359,157,773,179100,27212
38,38,0,-,-,27213
5045,3527,1518,1107,270200,27214
19726,12099,7627,1026,217500,27215
14329,9217,5112,832,142100,27217
1071,824,247,698,109700,27229
1031,827,204,1064,230600,27231
1118,971,147,837,226800,27233
2025,1667,358,1730,264800,27235
3213,2531,682,797,151400,27239
613,377,236,669,89900,27242
2089,1841,248,867,231100,27243
4921,3682,1239,966,235500,27244
83,46,37,-,-,27247
1358,1040,318,1040,135000,27248
5328,4275,1053,902,199300,27249
666,559,107,934,162900,27252
13238,9060,4178,901,190000,27253
58,58,0,-,-,27256
2535,2111,424,854,182200,27258
36,23,13,-,-,27259
9510,3861,5649,870,102100,27260
9196,5478,3718,989,206700,27262
8453,5799,2654,886,155900,27263
20906,14186,6720,1090,221700,27265
0,0,0,-,-,27268
11468,9001,2467,1198,355700,27278
1250,1074,176,889,280200,27281
6230,4674,1556,1255,251300,27282
1297,1128,169,1120,188100,27283
23410,16644,6766,1011,232800,27284
9879,5945,3934,757,111800,27288
524,479,45,619,174700,27291
16188,10807,5381,807,175400,27292
15597,11616,3981,798,172800,27295
3990,2784,1206,853,174600,27298
1754,1427,327,939,172700,27299
3684,3172,512,1574,197100,27301
13533,9376,4157,1097,245800,27302
707,554,153,1282,116000,27305
2341,1820,521,729,140800,27306
2896,2734,162,-,470000,27310
1395,953,442,575,104900,27311
9871,7954,1917,946,392500,27312
2686,2290,396,862,193700,27313
217,217,0,-,134400,27314
649,521,128,711,121300,27315
2626,1912,714,786,125100,27316
6791,5358,1433,833,150700,27317
15904,11430,4474,758,161500,27320
2491,1935,556,627,102600,27325
1390,1067,323,628,140300,27326
15219,9201,6018,924,188400,27330
12203,8857,3346,1055,199700,27332
22,11,11,-,-,27340
1867,1618,249,734,148000,27341
31,28,3,-,184800,27342
548,482,66,2074,226900,27343
6945,4844,2101,963,180200,27344
2536,1999,537,757,182400,27349
2239,1932,307,838,147800,27350
70,70,0,-,-,27351
989,658,331,734,176200,27355
975,621,354,705,148200,27356
3655,3099,556,734,228300,27357
5480,4866,614,1134,371700,27358
18706,12458,6248,791,161900,27360
5537,4909,628,934,156700,27370
2960,2018,942,603,155400,27371
133,39,94,-,-,27374
3557,3049,508,869,288200,27376
3830,2836,994,1223,257400,27377
1857,1166,691,546,144200,27379
7655,2675,4980,841,121700,27401
7595,3871,3724,964,202300,27403
20083,9560,10523,928,137500,27405
25537,14044,11493,1018,168400,27406
22161,10357,11804,1044,185800,27407
7568,5137,2431,1092,299600,27408
8212,2834,5378,1091,159800,27409
23816,15241,8575,1226,284300,27410
0,0,0,-,-,27411
0,0,0,-,-,27412
12209,8689,3520,1196,298600,27455
8366,6731,1635,925,220700,27501
16789,13600,3189,1707,445600,27502
1365,1188,177,-,314200,27503
6221,4610,1611,914,203000,27504
2866,2058,808,948,168900,27505
10,0,10,-,-,27506
713,548,165,-,162100,27507
831,650,181,717,218300,27508
1281,818,463,1064,180500,27509
6786,1895,4891,1310,379700,27510
13297,9093,4204,1360,373200,27511
19137,12105,7032,1430,432500,27513
9867,5137,4730,1411,592900,27514
16720,11921,4799,1425,468600,27516
11740,7857,3883,1415,539500,27517
8098,5346,2752,1471,546200,27518
22603,15692,6911,1762,564600,27519
16408,12694,3714,1258,245300,27520
2713,1791,922,979,159900,27521
4726,3940,786,1113,219500,27522
6318,4400,1918,1612,496500,27523
4983,3401,1582,978,185400,27524
6031,4921,1110,935,213300,27525
20575,16183,4392,1489,325700,27526
12196,10445,1751,1442,319900,27527
19994,14116,5878,1265,294900,27529
15684,9220,6464,791,164100,27530
11,0,11,-,-,27531
0,0,0,-,-,27533
13670,7133,6537,1079,173800,27534
5904,2112,3792,797,108800,27536
8935,6374,2561,898,139900,27537
8780,7223,1557,1561,455000,27539
14728,12270,2458,1645,442100,27540
1490,1275,215,-,271400,27541
3925,2774,1151,772,154400,27542
1721,1253,468,861,141800,27544
11991,8484,3507,1415,266100,27545
6785,4561,2224,1009,196000,27546
9714,6974,2740,959,165700,27549
818,714,104,1069,180600,27551
570,370,200,770,180800,27553
194,99,95,983,155400,27555
85,69,16,-,-,27556
2828,2000,828,802,162100,27557
1004,780,224,1006,284400,27559
15459,6968,8491,1639,418300,27560
1427,1315,112,-,553200,27562
2206,1331,875,683,86300,27563
9670,6640,3030,875,174300,27565
533,399,134,791,182200,27568
3338,2282,1056,841,171500,27569
0,0,0,-,-,27570
2753,2483,270,-,397200,27571
2776,2598,178,739,240900,27572
4927,2703,2224,768,136500,27573
6037,5159,878,854,164600,27574
7420,5019,2401,869,148500,27576
9546,6427,3119,791,218600,27577
1348,1213,135,937,193300,27581
136,87,49,1050,101400,27582
2809,2540,269,692,220800,27583
81,30,51,-,-,27584
27917,22349,5568,1348,412100,27587
2611,1769,842,750,97800,27589
8844,6883,1961,1076,260500,27591
6230,5509,721,924,312500,27592
0,0,0,-,-,27593
40,40,0,-,-,27594
7121,5950,1171,1053,301400,27596
10200,8040,2160,922,240200,27597
0,0,0,-,-,27599
4442,1131,3311,1393,479300,27601
21281,13007,8274,1416,313200,27603
18231,10137,8094,1301,253300,27604
3839,1210,2629,1509,425200,27605
18732,7028,11704,1266,392800,27606
8927,4162,4765,1388,558400,27607
5089,3838,1251,1391,838600,27608
16583,8216,8367,1271,398400,27609
26475,15680,10795,1233,233200,27610
18700,9915,8785,1435,450500,27612
17923,13095,4828,1374,448500,27613
13137,9390,3747,1426,472400,27614
19176,13764,5412,1409,409900,27615
21481,12413,9068,1418,284900,27616
9457,4221,5236,1548,416600,27617
0,0,0,-,-,27695
0,0,0,-,-,27697
11180,3310,7870,1117,414100,27701
24603,16077,8526,1289,304300,27703
16103,8985,7118,1204,229500,27704
21055,9581,11474,1248,363000,27705
21205,10222,10983,1276,320600,27707
0,0,0,-,-,27708
0,0,0,-,-,27709
9393,8341,1052,1555,292200,27712
24257,14580,9677,1377,336400,27713
6970,3422,3548,823,97100,27801
8579,5284,3295,858,163200,27803
12560,7180,5380,932,168900,27804
1399,1150,249,699,85400,27805
892,726,166,759,88700,27806
2166,1601,565,875,137400,27807
999,863,136,1103,327400,27808
1690,1311,379,714,138100,27809
1718,1264,454,976,169400,27810
1048,687,361,740,111900,27812
275,167,108,838,102200,27813
717,683,34,823,149300,27814
0,0,0,-,-,27815
1296,917,379,962,112600,27816
2951,2267,684,810,163700,27817
514,399,115,737,80800,27818
159,71,88,1080,81200,27819
913,693,220,713,118500,27820
25,25,0,-,-,27821
3256,2699,557,835,140200,27822
2617,1635,982,666,81300,27823
660,408,252,796,75200,27824
34,11,23,856,76400,27825
204,180,24,-,150000,27826
73,73,0,-,46000,27827
3783,2521,1262,872,143300,27828
826,609,217,668,74300,27829
1583,822,761,760,136800,27830
1346,974,372,920,70900,27831
1053,752,301,822,88400,27832
24079,8850,15229,875,146600,27834
2366,1815,551,732,133200,27837
1436,1022,414,852,83200,27839
113,103,10,-,60500,27840
17,0,17,-,-,27841
719,660,59,1458,419800,27842
351,278,73,781,80000,27843
1282,907,375,650,93400,27844
781,464,317,725,86800,27845
1119,774,345,823,97400,27846
436,278,158,1081,58800,27847
513,392,121,942,99200,27849
3032,2525,507,636,160500,27850
2041,1445,596,644,119300,27851
1114,901,213,834,114200,27852
230,178,52,-,78400,27853
2063,1186,877,933,97500,27855
6090,4204,1886,846,171400,27856
573,334,239,519,81500,27857
22988,10019,12969,979,218100,27858
443,346,97,783,95300,27860
43,39,4,-,75000,27861
306,271,35,682,-,27862
4822,3794,1028,874,152600,27863
1874,1203,671,829,108600,27864
869,788,81,1590,161500,27865
246,193,53,-,100500,27866
750,561,189,711,79700,27869
10423,6163,4260,804,115300,27870
1583,1121,462,753,93500,27871
153,96,57,1010,-,27872
143,106,37,706,111900,27873
1713,1150,563,495,84100,27874
134,106,28,-,79200,27875
587,431,156,765,59000,27876
6,6,0,-,-,27877
461,211,250,857,98300,27878
111,92,19,888,125000,27879
1613,1318,295,797,177700,27880
7,7,0,-,23500,27881
2990,2003,987,747,142100,27882
1327,919,408,833,100900,27883
461,380,81,863,-,27884
396,247,149,1293,-,27885
7744,5230,2514,677,115100,27886
637,487,150,732,102000,27888
10813,6798,4015,823,159800,27889
869,422,447,769,84500,27890
1693,1351,342,1031,110800,27891
5843,3839,2004,765,107600,27892
15677,6737,8940,824,135000,27893
8206,6247,1959,1032,185700,27896
537,253,284,788,98100,27897
15439,9919,5520,1039,201700,27909
4504,2939,1565,817,102900,27910
298,241,57,-,261000,27915
378,359,19,-,289600,27916
270,126,144,1034,312500,27917
339,257,82,663,162100,27919
588,466,122,1346,328600,27920
1812,1374,438,1178,268500,27921
371,276,95,723,109500,27922
301,251,50,768,282400,27923
1032,822,210,839,111600,27924
1232,913,319,704,127100,27925
685,528,157,950,225900,27926
630,549,81,1452,541700,27927
809,639,170,726,157000,27928
1181,1093,88,1172,360300,27929
5627,3535,2092,851,174800,27932
589,383,206,836,161700,27935
347,330,17,-,367800,27936
1126,916,210,1129,140600,27937
755,667,88,1076,112100,27938
1145,896,249,1153,260500,27939
290,273,17,-,333600,27941
348,251,97,754,86800,27942
186,95,91,1563,470900,27943
4926,3836,1090,1048,219400,27944
558,491,67,-,165200,27946
456,429,27,-,247200,27947
5412,4111,1301,1442,341800,27948
3296,2743,553,1346,532600,27949
864,796,68,1375,220500,27950
403,256,147,1227,-,27953
2831,2173,658,1236,360000,27954
70,47,23,-,350000,27956
663,431,232,856,115100,27957
4329,3877,452,1564,336000,27958
1595,1287,308,920,427300,27959
358,302,56,-,484800,27960
3029,1941,1088,694,93900,27962
224,224,0,-,245500,27964
148,116,32,-,251300,27965
433,381,52,1606,238200,27966
196,189,7,-,79800,27967
147,88,59,-,360000,27968
133,55,78,-,311300,27969
1268,980,288,1041,92100,27970
87,59,28,-,361100,27972
556,427,129,1122,246400,27973
417,402,15,-,156100,27974
1458,1337,121,-,270800,27976
122,62,60,-,-,27978
343,292,51,590,174700,27979
724,556,168,-,215300,27980
723,556,167,1010,249700,27981
46,46,0,-,-,27982
2794,2033,761,694,88600,27983
123,50,73,1175,112500,27985
436,273,163,839,115800,27986
10542,7090,3452,838,165200,28001
482,426,56,1031,226300,28006
355,258,97,695,95000,28007
424,297,127,861,116000,28009
10614,7617,2997,1199,286900,28012
5276,3393,1883,837,163300,28016
0,0,0,-,-,28017
2074,1750,324,777,134500,28018
0,0,0,-,-,28019
745,589,156,725,130700,28020
5518,4175,1343,838,178800,28021
6183,4877,1306,912,181600,28023
13,13,0,-,-,28024
20123,14533,5590,1128,232800,28025
26806,18690,8116,1327,310000,28027
12845,9252,3593,1498,447400,28031
1407,1061,346,1060,232300,28032
1141,948,193,961,123300,28033
7461,5431,2030,832,201400,28034
7462,6029,1433,1666,506700,28036
10130,8486,1644,989,404700,28037
21,10,11,-,-,28039
2836,2431,405,671,116700,28040
2,2,0,-,-,28041
105,53,52,688,114800,28042
8146,5158,2988,723,150000,28043
13218,7352,5866,976,152800,28052
16811,7993,8818,1085,192800,28054
13451,10847,2604,979,253200,28056
1202,1005,197,918,165600,28071
239,190,49,-,161400,28072
2244,1503,741,809,115800,28073
0,0,0,-,-,28074
6506,5974,532,2035,396400,28075
74,45,29,-,-,28076
147,52,95,683,125000,28077
25550,18678,6872,1607,397800,28078
13623,11347,2276,1752,311500,28079
2928,2558,370,1117,194000,28080
10189,6879,3310,991,216400,28081
9473,5547,3926,1065,177500,28083
10111,7432,2679,825,166800,28086
1032,786,246,-,200700,28088
15,14,1,-,190000,28089
2840,2120,720,614,117200,28090
784,591,193,796,127300,28091
16080,11175,4905,883,202600,28092
2784,2287,497,815,261500,28097
1435,1089,346,1139,152900,28098
469,441,28,1152,324700,28101
33,27,6,-,75000,28102
4024,3313,711,991,209200,28103
11899,11061,838,1652,438400,28104
16718,11550,5168,1474,354400,28105
3028,2652,376,1007,296900,28107
14,14,0,-,-,28108
173,149,24,660,161400,28109
18347,13955,4392,1207,265100,28110
10034,7180,2854,985,234900,28112
2781,2005,776,677,119800,28114
15634,11372,4262,1122,299900,28115
18724,12747,5977,1494,500200,28117
967,651,316,1012,101600,28119
9460,7003,2457,1109,237300,28120
2173,1811,362,1063,239000,28124
959,777,182,1071,234500,28125
2599,2110,489,816,204700,28127
2736,2031,705,795,154600,28128
2284,1957,327,793,230900,28129
974,715,259,918,140300,28133
4907,3141,1766,1535,292100,28134
1387,908,479,839,154300,28135
33,11,22,-,-,28136
1061,895,166,786,212600,28137
3994,2790,1204,948,176000,28138
7728,6202,1526,856,180600,28139
10542,5858,4684,915,191100,28144
12548,10240,2308,807,202800,28146
9070,5808,3262,974,203400,28147
11042,7433,3609,799,158800,28150
9037,6089,2948,798,158400,28152
1176,701,475,1045,136400,28159
1949,895,1054,674,113100,28160
1996,1702,294,797,250400,28163
5987,5025,962,982,227400,28164
3832,3168,664,1221,253000,28166
890,854,36,568,205900,28167
4223,3556,667,835,163000,28168
59,45,14,860,85600,28169
3866,2448,1418,811,106600,28170
19626,17474,2152,1562,501200,28173
2570,1852,718,982,187000,28174
8941,2395,6546,1765,392300,28202
10183,2990,7193,1756,736900,28203
5583,1442,4141,1559,496700,28204
22251,9357,12894,1280,375200,28205
6095,2196,3899,1127,199700,28206
4121,3432,689,1455,1339800,28207
15867,6289,9578,1124,169200,28208
11786,5944,5842,1478,532300,28209
20717,11465,9252,1373,442100,28210
13126,7501,5625,1559,651800,28211
16169,6180,9989,1188,209500,28212
17979,8744,9235,1211,221000,28213
14641,10900,3741,1407,211600,28214
22507,14256,8251,1273,230300,28215
22965,11504,11461,1365,220600,28216
12158,3849,8309,1387,210100,28217
0,0,0,-,-,28223
15659,10998,4661,1387,507300,28226
21652,14718,6934,1356,276100,28227
0,0,0,-,-,28244
20576,6501,14075,1384,269900,28262
30433,19377,11056,1485,263600,28269
12645,9422,3223,1635,481000,28270
17326,9378,7948,1506,274100,28273
0,0,0,-,-,28274
28385,17348,11037,1695,460500,28277
12354,9140,3214,1634,381000,28278
0,0,0,-,-,28280
0,0,0,-,-,28282
7012,2544,4468,860,103300,28301
13911,6138,7773,1058,159100,28303
14536,7995,6541,1153,139500,28304
2831,1643,1188,1005,226700,28305
15893,9884,6009,1065,197200,28306
4342,56,4286,1386,187500,28307
0,0,0,-,-,28308
0,0,0,-,-,28310
14383,7204,7179,1048,174000,28311
7841,5653,2188,911,191200,28312
22529,10127,12402,1139,159000,28314
5556,3807,1749,944,230400,28315
1579,1283,296,772,114000,28318
3023,2185,838,708,90600,28320
1724,1272,452,985,206100,28323
200,99,101,595,80700,28325
8191,5157,3034,1429,224200,28326
7150,5870,1280,1225,275400,28327
9174,5906,3268,740,126800,28328
149,118,31,-,185900,28330
4,4,0,-,-,28331
245,190,55,730,117900,28332
3582,2449,1133,842,93700,28333
8763,6048,2715,794,153900,28334
3638,2386,1252,697,165400,28337
1551,1219,332,582,133400,28338
2609,1892,717,948,135400,28339
3655,2265,1390,707,79400,28340
1134,845,289,666,102800,28341
38,38,0,-,212500,28342
670,404,266,731,64000,28343
1411,1112,299,742,112300,28344
4392,2634,1758,576,94600,28345
358,289,69,754,86100,28347
13103,9491,3612,1085,180500,28348
1473,1154,319,777,118900,28349
108,67,41,-,-,28350
1772,1214,558,704,76900,28351
8350,4680,3670,750,110600,28352
0,0,0,-,-,28355
2117,1608,509,598,203800,28356
1073,824,249,851,97200,28357
12670,7237,5433,783,105200,28358
0,0,0,-,-,28359
4698,3292,1406,721,107000,28360
20,18,2,-,125000,28362
393,237,156,728,96900,28363
4789,3516,1273,705,78900,28364
5743,4096,1647,814,111300,28365
1940,1495,445,926,111800,28366
40,9,31,-,65000,28367
33,28,5,-,-,28368
868,623,245,719,64200,28369
2255,1596,659,981,128700,28371
4122,2485,1637,699,105800,28372
1064,854,210,949,214300,28373
8871,7681,1190,1535,401800,28374
69,56,13,850,94300,28375
15064,10357,4707,1080,189500,28376
3977,2723,1254,624,85400,28377
22,0,22,-,-,28378
9881,6368,3513,776,119200,28379
2434,1880,554,904,112400,28382
2636,2061,575,736,74100,28383
3442,2489,953,790,87200,28384
897,785,112,565,120600,28385
1943,1489,454,682,69200,28386
7279,4377,2902,1151,337600,28387
8999,4355,4644,1086,165000,28390
2125,1600,525,855,163400,28391
803,560,243,903,106500,28392
792,638,154,758,55800,28393
2058,1577,481,1331,223700,28394
888,734,154,1095,202000,28395
949,690,259,575,122800,28396
2510,1417,1093,787,84700,28398
702,435,267,781,149600,28399
10684,3987,6697,1073,219700,28401
18079,6467,11612,1206,297100,28403
14905,8411,6494,1324,295100,28405
13723,11329,2394,1382,360500,28409
15436,11860,3576,1547,327800,28411
18945,11117,7828,1226,308400,28412
1126,810,316,979,198300,28420
631,492,139,674,110500,28421
3232,2838,394,1385,294800,28422
921,806,115,895,116400,28423
33,13,20,700,203600,28424
3987,3020,967,894,186900,28425
3100,2327,773,1271,446300,28428
3502,2952,550,1069,195000,28429
920,645,275,686,95200,28430
2816,1917,899,677,102800,28431
585,495,90,936,108000,28432
1631,1107,524,830,147600,28433
215,163,52,456,83100,28434
706,591,115,535,136600,28435
445,324,121,1074,146900,28436
547,404,143,653,112900,28438
348,248,100,894,95900,28439
1068,715,353,710,96300,28441
518,443,75,725,96100,28442
9426,7837,1589,1346,323700,28443
903,666,237,637,191000,28444
3895,3006,889,1373,288000,28445
371,355,16,-,151400,28447
306,200,106,-,82100,28448
852,624,228,1380,556700,28449
816,665,151,900,255800,28450
17373,14163,3210,1347,286700,28451
163,150,13,-,88300,28452
1340,887,453,629,104300,28453
1128,960,168,1705,164000,28454
901,615,286,710,99300,28455
1508,1262,246,766,153700,28456
4351,3610,741,846,212600,28457
2239,1470,769,724,100000,28458
5095,3903,1192,1364,267300,28460
10108,8554,1554,1366,360800,28461
5099,4245,854,831,195800,28462
2322,1525,797,693,113000,28463
835,457,378,909,167200,28464
3857,3344,513,1262,382500,28465
3995,2972,1023,774,157800,28466
6350,5700,650,1237,255800,28467
2458,2082,376,1251,337600,28468
4150,3575,575,1042,350600,28469
4623,3458,1165,1060,222200,28470
6630,4338,2292,767,125000,28472
1855,1599,256,710,161000,28478
2213,1926,287,1119,242600,28479
1341,1042,299,2013,973800,28480
7709,3656,4053,741,77400,28501
8553,5386,3167,850,117800,28504
724,468,256,936,45800,28508
0,0,0,-,-,28509
691,540,151,1064,269400,28510
237,200,37,-,115400,28511
1734,1394,340,980,473800,28512
4357,3121,1236,669,148500,28513
1040,715,325,582,117000,28515
5166,3395,1771,845,258800,28516
3107,2445,662,859,146400,28518
192,132,60,1080,125000,28519
111,78,33,-,192700,28520
707,574,133,1002,115900,28521
1036,731,305,634,137500,28523
98,83,15,-,183500,28524
1320,1048,272,738,80000,28525
1061,782,279,846,105700,28526
539,399,140,773,213700,28527
249,208,41,-,141700,28528
779,630,149,689,130400,28529
3075,1886,1189,752,112000,28530
437,350,87,1028,264300,28531
7542,4019,3523,1215,182600,28532
0,0,0,-,-,28533
8,8,0,-,-,28537
866,443,423,907,82500,28538
7270,5060,2210,1100,188500,28539
18720,10728,7992,935,187100,28540
84,0,84,2053,-,28542
1863,69,1794,1363,184100,28543
2146,620,1526,1115,120300,28544
18854,10185,8669,1111,191500,28546
1897,0,1897,1400,-,28547
4890,3383,1507,729,118700,28551
75,75,0,-,94500,28552
197,148,49,-,-,28553
66,66,0,-,83200,28554
2199,1631,568,993,138900,28555
390,293,97,-,288400,28556
7622,4876,2746,1071,304500,28557
11524,7553,3971,976,174300,28560
16929,12642,4287,1072,237600,28562
8570,6491,2079,985,215800,28570
1331,1190,141,1145,357900,28571
2523,1647,876,723,96000,28572
814,645,169,635,144800,28573
6877,5001,1876,1099,185900,28574
79,67,12,-,321400,28575
105,77,28,1077,274000,28577
1620,1101,519,803,87000,28578
313,218,95,924,292900,28579
3855,2395,1460,831,117100,28580
60,54,6,-,165800,28581
711,559,152,1313,268900,28582
5717,4507,1210,1189,283500,28584
1516,1187,329,691,105600,28585
2929,2236,693,876,101500,28586
99,92,7,-,-,28587
18,18,0,-,-,28589
10638,8258,2380,968,219200,28590
1751,1479,272,1373,489200,28594
21501,14053,7448,892,223100,28601
11635,7867,3768,823,166900,28602
3150,2383,767,973,296500,28604
1662,1136,526,1104,387600,28605
699,600,99,748,86600,28606
12593,6286,6307,1071,296800,28607
2363,2025,338,1046,213200,28609
4228,3199,1029,877,143500,28610
90,90,0,-,-,28611
4734,3711,1023,774,138100,28612
9256,6793,2463,803,178000,28613
817,599,218,670,168400,28615
24,24,0,-,225000,28616
909,567,342,764,180800,28617
879,658,221,1000,244600,28618
172,85,87,669,156700,28619
4101,2837,1264,801,142200,28621
1075,802,273,588,154200,28622
687,633,54,723,157400,28623
595,505,90,382,123300,28624
15135,11293,3842,932,183400,28625
1371,1273,98,1106,246500,28626
669,500,169,668,139400,28627
16,13,3,-,-,28628
0,0,0,-,-,28629
7949,6186,1763,848,184900,28630
295,212,83,-,188900,28631
1830,1559,271,762,130800,28634
1431,1311,120,854,120300,28635
1841,1384,457,731,148500,28636
681,459,222,723,177800,28637
4525,3308,1217,692,154600,28638
2097,1467,630,671,212800,28640
27,0,27,-,-,28641
2296,1547,749,535,132800,28642
1553,1370,183,1006,136400,28643
588,456,132,-,180200,28644
18683,13618,5065,698,145300,28645
242,185,57,-,387900,28646
430,257,173,574,133800,28649
4778,4020,758,728,180100,28650
2308,1922,386,643,167800,28651
23,23,0,-,-,28652
25,25,0,-,-,28653
1382,1122,260,957,217600,28654
22016,16427,5589,780,156900,28655
3635,2911,724,718,198500,28657
10260,7489,2771,872,168400,28658
8835,5815,3020,732,141100,28659
876,656,220,926,165600,28660
0,0,0,-,-,28662
258,236,22,-,189000,28663
73,73,0,-,342100,28664
1113,897,216,625,150900,28665
11,11,0,-,-,28666
107,36,71,764,117500,28667
79,79,0,-,-,28668
1169,1008,161,696,131100,28669
875,675,200,647,118400,28670
119,82,37,1049,183900,28671
96,96,0,-,158100,28672
2964,2580,384,1188,416900,28673
2948,2266,682,719,172600,28675
1361,1174,187,540,192000,28676
14135,9227,4908,822,186000,28677
2090,1944,146,814,193400,28678
904,784,120,1051,260000,28679
9548,7761,1787,721,166500,28681
570,453,117,1239,549100,28682
576,411,165,766,134500,28683
783,723,60,844,263800,28684
724,544,180,711,129500,28685
778,584,194,918,138400,28689
4165,3326,839,638,163400,28690
2039,1532,507,1178,257200,28692
643,574,69,944,161500,28693
3154,2531,623,722,204600,28694
5687,3721,1966,724,183800,28697
1057,938,119,677,195600,28698
1550,1313,237,987,283800,28701
183,155,28,-,276800,28702
8205,4804,3401,1275,324500,28704
2830,2306,524,853,200900,28705
245,185,60,-,177500,28707
132,126,6,-,242000,28708
1005,723,282,1133,328100,28709
0,0,0,-,-,28710
5462,3729,1733,1277,320900,28711
8935,6380,2555,876,327800,28712
3558,2682,876,685,206700,28713
6947,5369,1578,760,198800,28714
10315,7635,2680,1175,270100,28715
7339,5399,1940,890,202700,28716
686,598,88,1298,349600,28717
270,232,38,-,226600,28718
2869,2035,834,584,129500,28719
75,52,23,1358,333300,28720
4378,3200,1178,895,215400,28721
2687,1833,854,1039,251100,28722
3620,1433,2187,835,304000,28723
48,17,31,935,-,28725
1345,787,558,884,172000,28726
1474,1234,240,1641,300800,28729
2968,2630,338,830,304700,28730
3578,2881,697,920,309200,28731
7006,5775,1231,1143,317900,28732
36,32,4,-,271100,28733
13423,9974,3449,821,184200,28734
137,137,0,-,353900,28735
425,389,36,891,346000,28736
9441,7485,1956,939,330100,28739
804,670,134,963,192900,28740
2297,1608,689,787,509400,28741
1259,1097,162,946,297300,28742
994,741,253,549,153200,28743
179,158,21,-,365300,28745
1290,1091,199,1066,413400,28746
894,801,93,768,226400,28747
4479,3281,1198,964,265600,28748
37,37,0,-,-,28749
1733,1493,240,974,263700,28751
12121,8686,3435,714,152600,28752
4012,3232,780,730,212700,28753
3569,2679,890,807,278900,28754
0,0,0,-,-,28755
1596,1276,320,600,222500,28756
18,0,18,-,-,28757
0,0,0,-,-,28758
2909,2486,423,1186,351000,28759
3072,2501,571,578,166700,28761
2974,2097,877,735,147600,28762
1101,839,262,843,243900,28763
423,347,76,945,283800,28766
2748,2344,404,789,278600,28768
0,0,0,-,-,28770
3045,2439,606,605,129800,28771
502,320,182,848,227800,28772
1173,1005,168,1138,278100,28773
673,561,112,1644,593500,28774
209,149,60,-,442300,28775
3769,2973,796,623,189700,28777
3830,3059,771,990,227700,28778
8214,5339,2875,745,224600,28779
509,409,100,634,244200,28781
3151,2430,721,1272,279800,28782
487,293,194,908,258000,28783
3248,2669,579,1009,263800,28785
9605,6889,2716,1020,240000,28786
8822,6725,2097,1125,354400,28787
63,44,19,1352,331300,28788
2559,1573,986,1015,234000,28789
1326,1206,120,1233,371100,28790
6633,5253,1380,1084,326800,28791
15685,9613,6072,1035,232400,28792
6337,2291,4046,1001,448700,28801
13904,7407,6497,1387,374700,28803
9182,6351,2831,1335,477200,28804
8639,5481,3158,1149,332600,28805
16838,9658,7180,1196,304000,28806
2504,1895,609,913,155800,28901
373,325,48,-,218100,28902
4416,3504,912,793,255100,28904
1237,991,246,734,192400,28905
8913,7365,1548,813,201100,28906
207,189,18,-,284900,28909
694,482,212,692,123900,29001
2184,1656,528,780,93000,29003
3685,2908,777,777,146000,29006
906,754,152,1076,100200,29009
4376,2965,1411,772,100900,29010
567,522,45,-,157500,29014
548,474,74,702,92400,29015
11138,9233,1905,1257,313400,29016
1262,962,300,677,112500,29018
9241,7058,2183,810,178200,29020
762,690,72,594,151400,29030
654,481,173,935,93500,29031
1863,1520,343,820,95900,29032
6319,3734,2585,1224,146600,29033
9874,9114,760,1708,363200,29036
335,295,40,-,139000,29037
1123,781,342,671,110900,29038
1458,1098,360,1021,58100,29039
3366,2424,942,972,149200,29040
1243,796,447,782,94900,29042
1928,1582,346,692,115400,29044
10970,9040,1930,1141,222100,29045
64,64,0,-,-,29046
1591,1293,298,698,122100,29047
1839,1427,412,743,89100,29048
137,127,10,-,129700,29051
761,714,47,-,71100,29052
7855,5577,2278,900,101300,29053
3760,3422,338,933,232900,29054
1583,1368,215,730,80000,29055
900,651,249,648,52300,29056
1878,1388,490,778,168800,29058
1979,1485,494,692,104000,29059
4831,3501,1330,1278,153700,29061
10,10,0,-,-,29062
14095,11454,2641,1450,218500,29063
311,266,45,-,86600,29065
3758,2814,944,781,108000,29067
1792,1384,408,769,108300,29069
6190,4971,1219,903,156000,29070
24912,20780,4132,1227,278900,29072
18911,15458,3453,987,178300,29073
120,112,8,-,316700,29074
1309,1230,79,772,219700,29075
5944,5208,736,788,172300,29078
14,14,0,-,-,29079
1011,849,162,565,100900,29080
560,449,111,666,99000,29081
181,174,7,-,106300,29082
962,809,153,850,82000,29101
6423,4595,1828,642,155600,29102
509,435,74,675,87000,29104
372,334,38,889,75000,29105
1123,802,321,785,46700,29107
7436,4788,2648,849,114700,29108
542,467,75,825,121700,29111
1542,1216,326,796,81100,29112
644,536,108,848,87800,29113
549,471,78,750,95400,29114
10536,5235,5301,743,93600,29115
0,0,0,-,-,29117
6072,3935,2137,937,163000,29118
32,18,14,-,-,29122
2789,2225,564,831,123500,29123
1081,825,256,765,93400,29125
895,818,77,947,175800,29126
3934,3108,826,943,230400,29127
1533,1177,356,975,97100,29128
1621,1330,291,890,109500,29129
2814,2303,511,838,223500,29130
330,249,81,690,110000,29133
3394,2616,778,963,126200,29135
1009,770,239,656,116500,29137
3685,2652,1033,688,85900,29138
1899,1603,296,962,154600,29142
356,305,51,-,29300,29145
489,358,131,703,77100,29146
2346,1763,583,657,134600,29148
15404,8972,6432,892,140700,29150
730,16,714,1221,-,29152
6073,4660,1413,910,116300,29153
11412,8167,3245,1087,165500,29154
2984,2446,538,875,104100,29160
4374,3221,1153,869,119000,29161
847,644,203,673,131800,29162
453,347,106,638,53800,29163
1912,1517,395,723,152700,29164
262,207,55,654,131400,29166
1379,831,548,1007,91400,29168
10644,5672,4972,996,181600,29169
8707,7124,1583,986,172200,29170
3880,3044,836,1049,162100,29172
135,106,29,-,106300,29175
0,0,0,-,-,29177
1459,1191,268,733,68000,29178
5076,3561,1515,839,111500,29180
9236,2570,6666,1169,234500,29201
16252,7711,8541,1000,112800,29203
7305,4496,2809,932,165400,29204
10736,5680,5056,1026,305400,29205
8121,5211,2910,1293,301100,29206
8,8,0,-,-,29207
0,0,0,-,-,29208
14518,8388,6130,1202,173600,29209
17180,6168,11012,1045,163000,29210
12344,8474,3870,1259,208500,29212
22138,12379,9759,1188,173400,29223
0,0,0,-,-,29225
18536,12910,5626,1581,200800,29229
13355,7938,5417,1066,187000,29301
7231,5212,2019,960,231600,29302
9370,4593,4777,919,135800,29303
6978,3285,3693,868,142600,29306
8036,5390,2646,948,185900,29307
11567,9446,2121,996,196500,29316
160,49,111,1566,-,29320
1222,926,296,649,66400,29321
3799,3194,605,836,218200,29322
5732,4449,1283,825,169200,29323
32,32,0,-,-,29324
4906,3278,1628,843,155100,29325
48,42,6,-,-,29329
3355,2589,766,839,137400,29330
25,25,0,-,-,29331
1198,1007,191,860,99000,29332
99,34,65,-,-,29333
6140,4488,1652,1164,246300,29334
2006,1611,395,442,113600,29335
79,0,79,-,-,29338
7835,5711,2124,777,98900,29340
7639,5082,2557,868,160700,29341
90,67,23,1385,94600,29346
13161,11591,1570,922,219100,29349
576,394,182,574,77100,29351
1527,1215,312,544,110600,29353
347,307,40,483,98800,29355
3939,3190,749,612,254200,29356
8137,5423,2714,787,142000,29360
269,217,52,788,22400,29364
5117,4490,627,1201,216500,29365
102,52,50,-,-,29368
6060,5383,677,1258,215600,29369
259,206,53,-,-,29370
1648,1350,298,780,96400,29372
87,69,18,-,50400,29373
1198,1088,110,871,164000,29374
50,29,21,931,247700,29375
3296,2792,504,923,207200,29376
206,14,192,667,-,29377
101,35,66,536,-,29378
7744,4995,2749,783,96600,29379
1670,1388,282,671,120000,29384
2911,2039,872,961,205300,29385
6479,5134,1345,841,206600,29388
4086,2316,1770,1868,1167600,29401
10047,3712,6335,1590,615300,29403
567,0,567,1644,-,29404
11165,5143,6022,1126,221100,29405
12547,5340,7207,1250,206100,29406
16707,9487,7220,1293,396400,29407
39,6,33,-,-,29409
7360,5000,2360,1290,318800,29410
16787,12110,4677,1689,427000,29412
19256,11834,7422,1478,347200,29414
10425,5903,4522,1207,214100,29418
8683,5394,3289,1373,269900,29420
63,0,63,-,-,29424
0,0,0,-,-,29425
779,656,123,1250,185500,29426
1733,1616,117,2422,423200,29429
2624,2039,585,1006,190000,29431
1024,659,365,548,149000,29432
285,235,50,-,95300,29434
1646,1484,162,850,147100,29435
1780,1559,221,-,138200,29436
907,835,72,586,165700,29437
1333,1148,185,1171,453700,29438
549,418,131,2172,637500,29439
10081,8145,1936,873,148600,29440
21653,15153,6500,1402,231900,29445
424,300,124,-,52700,29446
1018,778,240,981,165600,29448
2857,2534,323,877,298100,29449
1257,1173,84,1560,187600,29450
1964,1770,194,3103,1073400,29451
118,83,35,-,90200,29452
564,367,197,831,261700,29453
11122,9637,1485,1410,456800,29455
13755,8889,4866,1386,228000,29456
872,753,119,1700,278400,29458
15492,12769,2723,1136,253800,29461
23520,15342,8178,1859,617700,29464
16071,13363,2708,2034,597800,29466
962,612,350,495,101700,29468
338,338,0,-,324300,29469
1940,1630,310,976,247600,29470
490,324,166,941,109600,29471
3247,2755,492,948,168100,29472
825,554,271,789,124500,29474
1022,871,151,858,78400,29475
3072,2329,743,881,81600,29477
2508,1790,718,811,95600,29479
566,447,119,975,93200,29481
846,713,133,2321,"2,000,000+",29482
20921,16631,4290,1136,278100,29483
21404,15204,6200,1367,291600,29485
16235,12525,3710,1460,289100,29486
1021,936,85,1404,328100,29487
8715,5775,2940,795,130400,29488
8661,5287,3374,1819,651900,29492
80,62,18,-,88600,29493
18530,11427,7103,922,209200,29501
9697,6864,2833,1104,164500,29505
7086,3633,3453,753,104400,29506
3944,2832,1112,793,103000,29510
2117,1784,333,921,201500,29511
6161,3873,2288,693,82300,29512
232,164,68,854,57500,29516
370,257,113,861,110900,29518
111,51,60,-,155100,29519
5153,3436,1717,842,99500,29520
732,523,209,479,53800,29525
17196,13091,4105,937,200400,29526
9995,7333,2662,924,178300,29527
952,671,281,635,115900,29530
8012,4857,3155,805,112500,29532
5955,3196,2759,681,91300,29536
1902,1580,322,784,62900,29540
3524,2859,665,964,162400,29541
141,93,48,-,-,29543
2466,1870,596,878,174800,29544
602,373,229,701,106800,29545
1013,687,326,642,107500,29546
870,520,350,779,88500,29547
11516,8372,3144,789,148900,29550
3417,2458,959,848,95900,29554
2052,1458,594,639,106100,29555
4719,3345,1374,717,89600,29556
5081,2998,2083,692,98600,29560
826,531,295,529,97100,29563
475,404,71,634,77100,29564
2458,1594,864,785,68200,29565
9226,7259,1967,1202,244200,29566
182,100,82,490,51300,29567
6420,5385,1035,1211,215700,29568
6288,4234,2054,774,189500,29569
1360,669,691,578,72300,29570
5184,2852,2332,622,99800,29571
5430,4200,1230,1124,331400,29572
3980,2379,1601,673,73900,29574
8439,6472,1967,1236,256500,29575
15504,13461,2043,1371,284900,29576
15354,9165,6189,1092,247400,29577
18768,13348,5420,1322,285400,29579
390,289,101,-,93300,29580
1540,1204,336,752,108900,29581
9141,7494,1647,1255,339600,29582
1840,1284,556,548,102600,29583
1004,848,156,891,65000,29584
7495,6432,1063,1419,403100,29585
19194,14856,4338,1148,223700,29588
57,0,57,-,-,29589
933,788,145,816,58100,29590
1771,1253,518,693,71000,29591
301,193,108,1293,54700,29592
751,525,226,920,91900,29593
78,29,49,-,125900,29594
883,710,173,868,68900,29596
6769,2195,4574,1309,493700,29601
15463,10208,5255,982,209200,29605
19853,9368,10485,1244,283200,29607
13111,8272,4839,979,272000,29609
12900,7071,5829,980,146200,29611
0,0,0,-,-,29613
4,0,4,-,-,29614
18166,9539,8627,1144,314000,29615
10839,7176,3663,975,187800,29617
5012,3714,1298,821,153200,29620
17067,12776,4291,950,239900,29621
6070,3027,3043,714,75900,29624
12106,8458,3648,932,183300,29625
5623,4414,1209,912,146200,29626
6391,5121,1270,858,126500,29627
1045,599,446,486,81000,29628
6610,2957,3653,884,193300,29630
6391,2663,3728,1003,346100,29631
33,0,33,754,-,29634
446,416,30,-,184700,29635
1467,1163,304,835,128200,29638
406,279,127,932,210300,29639
12565,9190,3375,918,175000,29640
13556,11384,2172,912,246300,29642
1164,1068,96,779,278300,29643
8500,6101,2399,1010,193800,29644
4278,3475,803,866,147800,29645
11088,6841,4247,810,120600,29646
10719,6515,4204,887,186800,29649
14838,11334,3504,1300,304400,29650
20383,16720,3663,961,238300,29651
1674,1460,214,1064,107000,29653
3590,2899,691,855,115500,29654
3122,2682,440,660,107400,29655
6177,5114,1063,875,152100,29657
137,137,0,-,93700,29658
70,42,28,460,-,29659
2630,2202,428,808,167700,29661
6172,4275,1897,1273,214700,29662
832,618,214,938,201500,29664
152,152,0,-,135300,29665
2512,2021,491,810,143900,29666
69,56,13,775,142900,29667
5028,4127,901,826,177700,29669
4364,3057,1307,1018,204200,29670
7195,5747,1448,866,183800,29671
5204,4236,968,956,368000,29672
11593,8619,2974,962,199500,29673
2640,2529,111,-,367400,29676
10103,6309,3794,936,182900,29678
12748,9798,2950,1332,256300,29680
23428,20290,3138,1467,293900,29681
1691,1606,85,648,156700,29682
118,106,12,-,128800,29683
2055,1736,319,879,148100,29684
843,827,16,-,569300,29685
316,238,78,790,206700,29686
16736,12849,3887,1101,221800,29687
1797,1490,307,792,294100,29689
9235,7541,1694,931,243700,29690
4720,3561,1159,708,162000,29691
1850,1278,572,700,87900,29692
5875,4469,1406,814,152900,29693
2045,1775,270,730,196200,29696
5729,4155,1574,904,165500,29697
3406,2483,923,678,114000,29702
1304,1184,120,870,221300,29704
7807,5797,2010,761,139100,29706
13187,12118,1069,1349,394400,29707
15587,11883,3704,1476,439600,29708
2374,1799,575,790,94000,29709
14550,11508,3042,1273,291000,29710
811,705,106,928,159400,29712
1264,990,274,1191,160100,29714
15039,11914,3125,1432,375100,29715
614,431,183,940,144900,29717
1455,1172,283,529,111500,29718
20097,15367,4730,820,194000,29720
18,0,18,-,-,29724
794,625,169,901,236500,29726
834,584,250,551,69500,29727
3681,2335,1346,801,100800,29728
862,714,148,991,95000,29729
23717,13329,10388,1161,205800,29730
23162,16763,6399,1189,268800,29732
0,0,0,-,-,29733
765,670,95,690,95400,29741
1065,918,147,1054,169200,29742
666,593,73,-,233500,29743
12766,10194,2572,852,214600,29745
11530,7295,4235,1060,145900,29801
15916,13415,2501,1024,251400,29803
2079,1866,213,790,193700,29805
876,606,270,740,115300,29809
1738,1206,532,676,61500,29810
4242,3156,1086,686,98400,29812
307,166,141,755,73900,29816
1627,1047,580,882,81900,29817
537,438,99,778,74500,29819
376,351,25,-,184200,29821
2592,1903,689,745,121200,29824
93,85,8,-,-,29826
1266,805,461,775,62000,29827
256,122,134,701,56700,29828
4186,3087,1099,952,209400,29829
1917,1571,346,631,141800,29831
2205,1367,838,713,107500,29832
257,131,126,1078,24700,29834
2811,2353,458,686,154500,29835
133,112,21,-,-,29836
242,222,20,638,325000,29838
195,195,0,-,82000,29840
14167,9520,4647,966,175100,29841
3103,2406,697,851,108400,29842
417,355,62,819,85000,29843
61,47,14,750,168800,29844
539,405,134,896,66400,29845
1685,1287,398,831,111500,29847
338,319,19,-,109900,29848
104,43,61,858,56600,29849
3142,2279,863,1072,127500,29851
2706,1909,797,732,102000,29853
1033,954,79,836,122000,29856
6706,5738,968,1088,238500,29860
0,0,0,-,-,29899
5840,3771,2069,1114,306000,29902
0,0,0,-,-,29904
0,0,0,-,-,29905
9321,4424,4897,1315,217500,29906
5583,4775,808,1692,372900,29907
11553,10782,771,2031,378200,29909
18101,13784,4317,1786,383200,29910
566,366,200,1022,98100,29911
0,0,0,-,-,29912
340,333,7,-,290400,29915
719,575,144,-,89800,29916
1593,1271,322,691,85900,29918
4323,3814,509,979,288500,29920
156,117,39,-,81000,29921
328,319,9,-,56700,29922
80,65,15,633,-,29923
1972,1441,531,742,138200,29924
10732,8486,2246,1530,531200,29926
3964,2755,1209,1403,271900,29927
7642,6537,1105,1753,713700,29928
404,355,49,-,82200,29929
84,60,24,1083,96200,29932
172,133,39,790,227000,29934
2082,646,1436,1326,246700,29935
5062,3317,1745,1108,170300,29936
49,48,1,-,91400,29939
1576,1330,246,-,113200,29940
85,77,8,-,1822900,29941
174,174,0,-,187500,29943
1586,1132,454,761,78100,29944
2047,1525,522,824,97900,29945
2867,1653,1214,973,476400,30002
24289,18355,5934,1745,530400,30004
13685,9736,3949,1796,547600,30005
11832,6886,4946,1302,241000,30008
8250,5127,3123,1964,568500,30009
6603,5320,1283,1896,255600,30011
11576,6491,5085,1119,170100,30012
9692,5812,3880,1349,240700,30013
15323,9736,5587,1160,232800,30014
19930,15590,4340,1527,188600,30016
7629,6224,1405,1883,360200,30017
36,23,13,756,255800,30018
15068,12918,2150,1832,350400,30019
6767,1538,5229,1170,222200,30021
23386,17379,6007,1843,531500,30022
28222,22611,5611,1854,445100,30024
3975,3480,495,1046,262300,30025
10969,9684,1285,1783,381800,30028
12642,7668,4974,1560,590900,30030
15879,8613,7266,1238,220800,30032
12961,8427,4534,1594,401000,30033
16447,11553,4894,1250,194500,30034
7314,3849,3465,1396,172200,30035
14208,8343,5865,1390,203700,30038
16108,13076,3032,1742,243400,30039
26179,21961,4218,1711,430000,30040
25025,21679,3346,1719,468800,30041
28409,20025,8384,1644,309900,30043
30389,18841,11548,1624,268100,30044
13800,11737,2063,2212,288300,30045
13627,7055,6572,1359,269700,30046
21500,16345,5155,1552,290800,30047
24624,19779,4845,1616,283600,30052
4297,3556,741,1210,238200,30054
1410,1280,130,1179,277700,30055
821,691,130,904,252600,30056
21490,12764,8726,1402,187600,30058
13594,6264,7330,1264,257400,30060
23306,18827,4479,1695,427500,30062
18351,15283,3068,1479,386700,30064
22450,17149,5301,1675,351200,30066
19293,8029,11264,1484,399800,30067
12828,11093,1735,1542,510700,30068
22,22,0,-,112500,30070
8649,4491,4158,1457,288200,30071
368,213,155,1264,276900,30072
21492,17999,3493,1779,527300,30075
16941,10925,6016,1542,427400,30076
13124,10766,2358,1577,279700,30078
1358,664,694,1032,263800,30079
24458,11945,12513,1513,380900,30080
10850,7628,3222,1654,353500,30082
20349,10428,9921,1290,186600,30083
15027,10089,4938,1488,308600,30084
13147,11075,2072,1685,272200,30087
10454,5895,4559,1320,176600,30088
0,0,0,-,-,30090
15705,7202,8503,1479,448000,30092
18891,5314,13577,1418,205400,30093
11935,9131,2804,1467,238500,30094
27352,11597,15755,1615,300500,30096
17011,12035,4976,1749,517000,30097
20745,16530,4215,1553,355000,30101
15061,11255,3806,1334,262100,30102
4994,4079,915,1110,198400,30103
1702,1199,503,910,140500,30104
923,699,224,671,227000,30105
9103,5028,4075,1358,221000,30106
6109,5359,750,1064,343800,30107
2873,2060,813,761,153100,30108
5279,3893,1386,844,217800,30110
0,0,0,-,-,30111
2150,1742,408,891,154400,30113
21100,14386,6714,1480,373300,30114
17555,14742,2813,1537,395500,30115
8761,6282,2479,1068,191300,30116
13522,6857,6665,982,216800,30117
21,0,21,-,-,30118
14608,10733,3875,1060,246500,30120
9584,6067,3517,1129,239400,30121
10603,4978,5625,1339,190900,30122
1088,733,355,949,189100,30124
8650,5631,3019,793,147400,30125
15875,12061,3814,1380,321500,30126
24166,20033,4133,1713,285300,30127
16782,13355,3427,1251,291900,30132
14966,9886,5080,1217,204800,30134
22351,16909,5442,1421,243900,30135
700,503,197,1143,174000,30137
1736,1313,423,1023,145400,30139
8230,6070,2160,1489,224300,30141
9905,7907,1998,973,298200,30143
21900,13099,8801,1642,265000,30144
3234,2912,322,952,198900,30145
1674,1188,486,863,116800,30147
376,354,22,-,-,30148
22,0,22,-,-,30149
16075,12733,3342,1600,361400,30152
6169,3864,2305,932,171000,30153
17225,14282,2943,1397,226900,30157
12846,7891,4955,936,169200,30161
15296,9104,6192,855,188400,30165
8905,4443,4462,1289,193400,30168
1156,951,205,914,191700,30170
939,819,120,1293,319200,30171
2713,1851,862,1050,134900,30173
2263,1892,371,982,252000,30175
2945,2027,918,816,158600,30176
575,527,48,569,201500,30177
1398,1156,242,1002,309000,30178
6234,5432,802,1093,190300,30179
14268,10736,3532,1334,228500,30180
1378,1031,347,850,170900,30182
2332,1948,384,1146,363000,30183
2361,2028,333,809,278600,30184
1528,1280,248,747,151900,30185
2945,2610,335,893,235100,30187
24707,19732,4975,1673,363000,30188
15214,11355,3859,1701,337900,30189
5131,3751,1380,886,163800,30204
1204,1125,79,1009,424500,30205
1175,1042,133,929,223600,30206
16132,9748,6384,1583,251800,30213
11692,9459,2233,1547,304700,30214
13074,11211,1863,1699,347000,30215
908,732,176,953,209000,30216
3525,2516,1009,773,145200,30217
549,434,115,1411,160400,30218
1830,1525,305,1287,190400,30220
1871,1130,741,799,123100,30222
14645,9052,5593,990,175400,30223
10855,7517,3338,1114,190400,30224
16380,12263,4117,1501,230800,30228
24,24,0,-,191700,30229
3681,2219,1462,970,156300,30230
8328,6025,2303,920,198900,30233
879,795,84,1363,178700,30234
17534,9651,7883,1207,197300,30236
13660,8066,5594,1338,174900,30238
11006,6803,4203,941,200600,30240
9201,4808,4393,1001,149900,30241
10065,8207,1858,1359,228000,30248
0,0,0,-,-,30250
842,596,246,901,178300,30251
15686,13763,1923,1717,296100,30252
20382,12867,7515,1437,247500,30253
874,770,104,746,168600,30256
1418,1183,235,890,198700,30257
971,764,207,1133,216100,30258
1410,1241,169,1277,342300,30259
8920,4150,4770,1257,164900,30260
22003,14660,7343,1232,249000,30263
14146,10482,3664,1648,300500,30265
3977,2798,1179,1186,224700,30268
14885,11126,3759,1835,434300,30269
0,0,0,-,-,30272
5975,4542,1433,1198,161200,30273
13087,6054,7033,1181,133000,30274
126,69,57,-,-,30275
6469,5893,576,1233,330200,30276
8013,7362,651,1246,335200,30277
26844,16195,10649,1334,209800,30281
2,0,2,-,-,30284
249,224,25,-,163100,30285
9071,5639,3432,779,137200,30286
2961,2270,691,999,198900,30288
23,23,0,-,441700,30289
3275,2962,313,1044,361400,30290
10389,4139,6250,1207,170100,30291
2147,1730,417,876,232500,30292
816,705,111,875,96400,30293
15055,11511,3544,1506,208600,30294
1600,1194,406,895,232200,30295
9881,6803,3078,1432,163700,30296
10234,3681,6553,1080,98200,30297
1148,343,805,1483,217100,30303
14504,7701,6803,1758,676800,30305
11911,6858,5053,1760,747400,30306
9574,5635,3939,1858,669100,30307
14581,4896,9685,1737,388700,30308
18020,8605,9415,1985,397900,30309
11823,5699,6124,1072,266200,30310
14984,6773,8211,1026,220400,30311
14120,5064,9056,1536,452900,30312
3466,1358,2108,1501,316000,30313
7684,2960,4724,1010,159600,30314
13151,5109,8042,926,240100,30315
15202,9420,5782,1476,367100,30316
6409,4434,1975,1489,481300,30317
25382,9727,15655,1610,360100,30318
20309,11587,8722,1782,660800,30319
0,0,0,-,-,30322
16564,6126,10438,1665,496000,30324
5354,1830,3524,2064,464300,30326
9659,7512,2147,1812,990200,30327
18311,10416,7895,1791,517100,30328
10999,2935,8064,1673,448100,30329
25351,12943,12408,1211,235000,30331
0,0,0,-,-,30332
0,0,0,-,-,30334
213,77,136,1180,247000,30336
5031,1462,3569,1032,281800,30337
16204,10287,5917,1713,558400,30338
18552,5937,12615,1737,421500,30339
10956,4951,6005,1420,287600,30340
13869,6540,7329,1617,421000,30341
14872,7662,7210,1745,771800,30342
14954,6260,8694,1241,215300,30344
10310,5378,4932,1688,484000,30345
3059,332,2727,1803,445600,30346
30922,17783,13139,1210,199000,30349
18395,7971,10424,1514,517500,30350
6441,2971,3470,1154,192900,30354
5454,3239,2215,1498,375800,30360
2040,1197,843,1785,357900,30363
5048,2499,2549,737,85200,30401
667,497,170,743,118400,30410
1063,742,321,416,74000,30411
66,66,0,-,133900,30412
585,444,141,830,112800,30413
19,7,12,-,-,30414
2328,1756,572,929,170300,30415
4086,2586,1500,696,133300,30417
734,411,323,730,139200,30420
1067,837,230,577,89700,30421
14,14,0,-,112500,30423
565,500,65,578,117800,30425
365,342,23,-,-,30426
3726,2684,1042,635,148300,30427
521,331,190,361,85600,30428
42,8,34,1093,80000,30429
1998,1267,731,703,89000,30434
4217,2790,1427,664,91900,30436
3887,2367,1520,671,137100,30439
768,507,261,679,79800,30441
3327,2661,666,672,82400,30442
961,644,317,589,88900,30445
608,483,125,814,137900,30446
4,4,0,-,85000,30448
12,5,7,-,-,30449
805,532,273,974,94300,30450
7,7,0,-,-,30451
553,385,168,980,130400,30452
2461,1606,855,631,93800,30453
130,77,53,-,76200,30454
275,218,57,792,102800,30455
993,832,161,710,87500,30456
1846,1094,752,601,92300,30457
17022,6310,10712,901,173900,30458
0,0,0,-,-,30460
6785,4465,2320,1034,210600,30461
50,17,33,814,-,30464
3918,2861,1057,627,99400,30467
483,339,144,824,127000,30470
1531,987,544,625,67400,30471
1012,837,175,688,92200,30473
6074,3823,2251,698,136800,30474
1019,730,289,549,70800,30477
11160,4622,6538,1101,223200,30501
9039,5014,4025,1191,283800,30504
16009,13259,2750,1315,327700,30506
8685,6306,2379,1035,218000,30507
2481,1645,836,701,166500,30510
1197,870,327,1026,244200,30511
10072,8132,1940,775,251700,30512
5411,3651,1760,723,272400,30513
730,494,236,807,160500,30516
6093,5212,881,1729,340700,30517
17687,13658,4029,1507,328000,30518
17743,13919,3824,1781,342800,30519
1554,1223,331,616,112500,30520
1773,1310,463,779,166300,30521
291,232,59,609,228900,30522
4931,4209,722,749,240900,30523
3071,2347,724,860,246300,30525
1468,1307,161,925,270700,30527
8541,6285,2256,956,226800,30528
4160,2560,1600,1002,221100,30529
2752,1905,847,943,191200,30530
3921,2677,1244,887,165700,30531
9677,7224,2453,1056,248700,30533
11451,9259,2192,1364,296700,30534
3004,2109,895,940,187900,30535
3593,2782,811,979,268800,30536
722,518,204,1340,266400,30537
1403,1251,152,714,142300,30538
83,54,29,-,-,30539
8356,6211,2145,829,257800,30540
686,627,59,-,241500,30541
12986,10504,2482,1383,308400,30542
1717,1366,351,1220,217200,30543
395,296,99,729,298300,30545
3739,2899,840,875,283300,30546
1173,788,385,948,263600,30547
7894,6955,939,1169,390800,30548
9787,8369,1418,917,294400,30549
663,582,81,1019,224400,30552
3355,2468,887,724,167500,30553
3125,2344,781,964,220500,30554
1216,975,241,800,136500,30555
1978,1634,344,856,119500,30557
1782,1458,324,926,164100,30558
2146,1911,235,857,272800,30559
1872,1646,226,1356,264300,30560
280,171,109,771,151900,30562
2006,1673,333,761,181200,30563
1890,1560,330,903,269800,30564
1750,1307,443,993,194900,30565
3178,2064,1114,1198,228700,30566
1398,1161,237,1037,277300,30567
905,695,210,874,192600,30568
1479,1290,189,942,261200,30571
487,419,68,969,284600,30572
111,60,51,-,-,30573
516,408,108,591,264800,30575
1124,868,256,2083,240500,30576
8310,5872,2438,807,155000,30577
23,23,0,-,-,30581
1954,1637,317,708,265800,30582
0,0,0,-,-,30597
13,0,13,-,-,30598
10116,3975,6141,1084,183100,30601
0,0,0,-,-,30602
17651,6071,11580,987,237200,30605
21193,9198,11995,1096,307700,30606
4151,2530,1621,927,220200,30607
0,0,0,-,-,30609
651,542,109,831,200000,30619
4810,3948,862,1513,247400,30620
2030,1785,245,1096,397300,30621
4200,3363,837,1645,353700,30622
34,31,3,-,411500,30623
1377,1024,353,742,84700,30624
1085,994,91,857,242400,30625
851,663,188,-,200100,30627
1995,1686,309,922,203800,30628
1725,1194,531,823,154800,30629
835,508,327,733,162600,30630
657,491,166,760,66900,30631
2908,2295,613,744,161300,30633
730,495,235,1026,138300,30634
6313,4454,1859,835,107600,30635
8,8,0,-,-,30639
673,615,58,948,295000,30641
6032,4899,1133,816,377500,30642
6576,4873,1703,784,209800,30643
3260,2305,955,914,179500,30646
1037,872,165,791,142800,30648
5227,3644,1583,1018,293800,30650
9697,6321,3376,1061,249100,30655
5980,4915,1065,1297,284500,30656
351,252,99,465,117900,30660
3131,2268,863,724,146200,30662
1088,843,245,996,262100,30663
6,6,0,-,-,30664
92,62,30,535,-,30665
3394,2788,606,1127,266500,30666
360,328,32,-,169900,30667
916,594,322,836,108600,30668
1028,676,352,852,93600,30669
2859,1937,922,737,91900,30673
7047,5996,1051,1442,368100,30677
454,383,71,913,89900,30678
16289,12614,3675,1132,222100,30680
3006,2176,830,872,207300,30683
14965,10026,4939,813,185600,30701
12202,9049,3153,789,161400,30705
6650,5417,1233,879,169500,30707
151,139,12,-,88400,30708
2550,2074,476,930,183100,30710
1430,1082,348,602,114500,30711
9256,5239,4017,911,218800,30720
18475,12151,6324,826,155400,30721
11,5,6,-,-,30724
1684,1474,210,793,197000,30725
0,0,0,-,-,30726
7227,4838,2389,773,121000,30728
627,542,85,897,86700,30730
1096,757,339,825,133900,30731
885,713,172,720,128700,30733
1160,893,267,1281,194400,30734
2067,1656,411,1040,136000,30735
15923,13422,2501,921,217800,30736
1366,1235,131,1517,181700,30738
2368,1981,387,1022,197400,30739
2921,2648,273,880,208500,30740
11858,8163,3695,939,133600,30741
3412,1286,2126,881,167800,30742
470,470,0,-,206800,30746
5927,3907,2020,667,89600,30747
1316,1056,260,949,327100,30750
16,16,0,-,-,30751
3528,2659,869,859,154600,30752
2381,1720,661,722,83300,30753
3833,2770,1063,782,166400,30755
13,9,4,-,-,30756
807,538,269,692,128500,30757
2137,1786,351,966,259300,30802
328,303,25,840,87500,30803
846,688,158,854,113300,30805
78,69,9,-,-,30807
1557,1070,487,743,136300,30808
16043,14030,2013,1585,317800,30809
721,465,256,763,121000,30810
0,0,0,-,-,30812
14454,10662,3792,1400,245100,30813
3433,2760,673,751,198600,30814
14148,10158,3990,1109,137000,30815
906,780,126,751,95700,30816
2964,2199,765,730,165200,30817
197,95,102,-,134800,30818
379,296,83,-,73400,30820
368,257,111,-,58200,30821
0,0,0,-,-,30822
595,367,228,702,105100,30823
6601,4314,2287,845,144100,30824
1378,1021,357,685,93000,30828
4832,3073,1759,826,145800,30830
1330,826,504,693,115800,30833
7028,1772,5256,750,83900,30901
9876,4321,5555,889,163000,30904
893,0,893,1566,-,30905
20965,11561,9404,983,103900,30906
17874,12366,5508,1163,209700,30907
17703,8606,9097,1104,220200,30909
0,0,0,-,-,30912
839,551,288,594,72500,31001
1037,746,291,568,108900,31002
55,55,0,-,159400,31003
0,0,0,-,-,31004
7333,5651,1682,1232,246300,31005
1603,870,733,740,89900,31006
315,234,81,635,77600,31007
7813,6508,1305,1074,180800,31008
508,358,150,497,85400,31009
231,182,49,675,-,31011
366,270,96,407,121400,31012
4404,3345,1059,748,112600,31014
7533,3957,3576,734,113200,31015
740,647,93,499,182700,31016
631,542,89,811,87100,31017
553,416,137,825,39000,31018
966,779,187,781,150500,31019
644,573,71,826,90900,31020
10137,5904,4233,686,167900,31021
724,573,151,697,153900,31022
5101,3333,1768,706,114000,31023
9240,7262,1978,936,189200,31024
482,474,8,-,263000,31025
3930,2484,1446,828,93500,31027
2119,1451,668,1158,229000,31028
6271,4879,1392,867,187500,31029
6045,3729,2316,736,117500,31030
2536,2051,485,587,117500,31031
5210,4259,951,837,178600,31032
867,725,142,922,112200,31033
36,0,36,-,-,31034
416,327,89,819,114900,31035
3399,2215,1184,832,130900,31036
785,649,136,818,90100,31037
336,252,84,-,109100,31038
0,0,0,-,-,31039
273,142,131,705,51500,31041
580,491,89,905,83000,31042
960,809,151,705,83900,31044
34,11,23,-,-,31045
1334,1235,99,-,194200,31046
6193,5384,809,1441,253200,31047
620,480,140,685,50000,31049
511,393,118,-,328300,31050
40,23,17,572,104700,31051
3112,2806,306,939,194800,31052
456,407,49,777,109100,31054
1317,967,350,622,92200,31055
588,357,231,438,89400,31057
722,487,235,-,88100,31058
626,489,137,725,66000,31060
15071,9253,5818,833,157500,31061
0,0,0,-,-,31062
1743,1132,611,714,87800,31063
3637,2867,770,1030,178800,31064
433,350,83,845,180900,31065
356,289,67,-,191800,31066
92,80,12,-,186100,31067
1187,730,457,590,66300,31068
8663,6312,2351,927,186100,31069
336,280,56,546,86900,31070
379,324,55,617,53700,31071
394,334,60,621,98200,31072
925,754,171,886,86300,31075
1134,898,236,746,82500,31076
299,247,52,567,79900,31077
1192,728,464,644,109800,31078
1068,787,281,593,67900,31079
20,20,0,-,75000,31081
4022,2624,1398,749,124100,31082
64,43,21,-,77500,31083
0,0,0,-,-,31084
389,375,14,1078,102800,31085
2896,2204,692,576,93600,31087
21189,13141,8048,1166,171500,31088
1514,944,570,818,96000,31089
389,291,98,818,84000,31090
1157,909,248,705,92600,31091
1962,1205,757,752,110200,31092
11134,6083,5051,899,117500,31093
411,372,39,-,164600,31094
2513,1834,679,585,86200,31096
456,400,56,638,159400,31097
946,15,931,1335,165600,31098
3585,726,2859,798,177800,31201
12337,5818,6519,861,111100,31204
8745,3513,5232,854,81100,31206
0,0,0,-,-,31207
13778,7562,6216,1172,238200,31210
6129,3460,2669,848,139900,31211
0,0,0,-,-,31213
6349,5334,1015,1106,173300,31216
6420,4428,1992,803,91300,31217
5980,3769,2211,1240,174800,31220
1714,679,1035,792,139000,31301
3031,2178,853,884,172500,31302
984,831,153,811,175100,31303
2255,1705,550,748,141000,31305
496,434,62,-,269300,31307
3138,2633,505,1065,134500,31308
248,217,31,-,79000,31309
7571,6428,1143,1343,229900,31312
15355,7241,8114,1128,156100,31313
0,0,0,-,-,31314
2390,4,2386,1437,-,31315
4071,2775,1296,899,169800,31316
177,152,25,-,261600,31318
3561,2735,826,1038,193900,31320
2766,2115,651,951,143800,31321
11203,6858,4345,1552,267400,31322
642,527,115,963,95500,31323
11313,8587,2726,1604,330700,31324
8818,6384,2434,1120,228900,31326
26,26,0,-,-,31327
1577,1427,150,1227,567400,31328
3218,2302,916,1089,198900,31329
2466,2159,307,796,177300,31331
134,0,134,744,-,31333
8786,3004,5782,1283,470700,31401
13043,6074,6969,1163,168400,31404
14707,8041,6666,1332,265400,31405
13770,8290,5480,1271,239400,31406
8006,4567,3439,1486,215000,31407
3827,1393,2434,1009,150400,31408
0,0,0,-,-,31409
9736,7526,2210,1594,332500,31410
4531,4189,342,2235,686500,31411
4179,1598,2581,928,119900,31415
22438,12563,9875,1252,220200,31419
11,11,0,-,-,31421
5548,2797,2751,750,87500,31501
7455,5161,2294,787,105400,31503
3205,2254,951,686,94500,31510
832,643,189,538,121400,31512
6024,4235,1789,679,86100,31513
5931,4605,1326,780,115700,31516
253,212,41,533,206500,31518
1376,1001,375,628,159500,31519
8958,3995,4963,881,121300,31520
7928,6626,1302,1509,456400,31522
5329,4652,677,1056,242100,31523
0,0,0,-,-,31524
11096,6881,4215,1118,183200,31525
561,452,109,1450,518400,31527
230,165,65,-,80900,31532
6139,3349,2790,674,127700,31533
4355,3190,1165,816,114000,31535
3368,2414,954,684,112900,31537
5164,3528,1636,622,105600,31539
914,671,243,499,112300,31542
1637,1406,231,753,79300,31543
146,121,25,-,85000,31544
5742,3606,2136,794,140400,31545
2718,1764,954,822,151300,31546
0,0,0,-,-,31547
8530,5735,2795,1070,205500,31548
501,340,161,471,83000,31549
357,345,12,-,102400,31550
364,306,58,777,185300,31551
288,242,46,-,-,31552
1870,1294,576,725,96300,31553
1928,1470,458,724,75900,31554
1161,798,363,1047,94600,31555
30,23,7,-,-,31556
1299,1001,298,732,96300,31557
8667,4885,3782,1203,234500,31558
981,701,280,679,95900,31560
119,119,0,-,-,31561
708,608,100,971,87300,31562
526,447,79,910,113700,31563
0,0,0,-,-,31564
988,799,189,1016,207800,31565
1367,971,396,543,83700,31566
461,347,114,475,156400,31567
250,214,36,-,215200,31568
1874,1553,321,830,192400,31569
0,0,0,-,-,31599
12005,5230,6775,822,91400,31601
13475,6312,7163,976,174000,31602
8982,5775,3207,1159,197400,31605
1383,1086,297,795,123100,31606
4133,2661,1472,884,131800,31620
768,566,202,759,94100,31622
39,25,14,-,73000,31623
538,365,173,692,64800,31624
360,214,146,-,218500,31625
1305,877,428,936,169100,31626
90,61,29,1179,69200,31627
298,241,57,-,89300,31629
209,187,22,775,75500,31630
285,217,68,620,72200,31631
5098,4015,1083,1130,238600,31632
1868,1305,563,531,73300,31634
2556,1600,956,798,166400,31635
3962,2429,1533,864,188400,31636
1127,868,259,689,93100,31637
370,274,96,723,153800,31638
3834,2659,1175,633,121900,31639
614,505,109,1067,139300,31641
1592,1105,487,629,79700,31642
3555,2252,1303,785,108800,31643
1693,1070,623,834,123300,31645
985,520,465,908,86700,31647
348,249,99,1069,78300,31648
312,217,95,1023,114700,31649
1260,815,445,543,95200,31650
0,0,0,-,-,31698
0,0,0,-,-,31699
7058,2536,4522,768,100200,31701
0,0,0,-,-,31704
10295,5024,5271,846,88600,31705
11421,5078,6343,928,122400,31707
5973,2738,3235,838,135200,31709
329,212,117,594,91000,31711
404,342,62,793,40600,31712
2340,1571,769,614,87000,31714
1176,985,191,698,130600,31716
2716,1684,1032,715,98900,31719
150,127,23,721,58300,31720
7715,5355,2360,1087,197900,31721
241,187,54,683,77300,31722
0,0,0,-,-,31727
3377,1914,1463,743,94500,31730
555,466,89,853,140000,31733
288,221,67,-,212500,31735
1150,739,411,768,139700,31738
102,92,10,-,-,31743
1275,827,448,691,109000,31744
68,39,29,796,-,31747
976,630,346,778,91500,31749
7392,4272,3120,691,106500,31750
15,6,9,-,-,31753
596,586,10,-,119600,31756
4155,3213,942,1095,193900,31757
9971,7193,2778,1150,204500,31763
738,685,53,541,204200,31764
962,682,280,-,116500,31765
8148,4944,3204,697,119000,31768
2136,1470,666,821,81600,31771
215,215,0,-,172000,31772
1726,1314,412,926,192200,31773
2370,1556,814,739,87500,31774
1030,866,164,680,73600,31775
1082,848,234,758,96500,31778
2958,1893,1065,710,110500,31779
647,510,137,-,137900,31780
766,498,268,982,91100,31781
588,463,125,575,113900,31783
340,227,113,724,-,31784
547,436,111,887,195500,31787
3702,2327,1375,803,144700,31788
567,377,190,1093,98100,31789
630,517,113,680,81500,31790
4372,3010,1362,773,98100,31791
9498,4958,4540,993,185200,31792
3362,2599,763,686,183800,31793
10472,5719,4753,773,123000,31794
665,501,164,891,95000,31795
439,336,103,763,158800,31796
539,478,61,-,61400,31798
1159,1095,64,692,154800,31801
1824,1234,590,651,108900,31803
2043,1899,144,1065,283600,31804
942,648,294,839,129700,31805
1522,1130,392,775,156300,31806
861,784,77,-,283200,31807
2873,2763,110,1208,267900,31808
81,71,10,-,66400,31810
1995,1739,256,956,270000,31811
193,147,46,539,106900,31812
0,0,0,-,-,31814
754,564,190,-,39100,31815
2241,1271,970,1024,114200,31816
4671,4228,443,1521,330600,31820
48,38,10,-,242300,31821
2038,1578,460,806,190800,31822
320,270,50,-,180100,31823
477,388,89,397,54500,31824
1178,675,503,608,109700,31825
850,575,275,725,208100,31826
889,680,209,967,88800,31827
585,531,54,2139,352900,31829
928,693,235,722,138000,31830
1306,1160,146,717,216500,31831
58,58,0,-,115000,31832
2522,1861,661,760,138800,31833
376,343,33,-,100800,31836
3218,946,2272,827,163100,31901
7781,2181,5600,841,74200,31903
13933,7113,6820,985,207700,31904
3239,18,3221,1585,-,31905
8612,4048,4564,850,148200,31906
23448,12866,10582,1071,133700,31907
16017,8093,7924,1208,189200,31909
11291,9616,1675,1909,355200,32003
2554,2051,503,822,142300,32008
1413,1223,190,908,196300,32009
5681,4723,958,892,217800,32011
14,14,0,-,-,32013
7747,6679,1068,954,179600,32024
8229,4648,3581,944,165100,32025
0,0,0,-,-,32026
2027,1813,214,1610,271800,32033
17262,14797,2465,1209,427700,32034
3934,3406,528,825,157200,32038
2841,2442,399,1015,173500,32040
11697,9445,2252,1270,263200,32043
749,464,285,1089,80900,32044
3717,2785,932,808,213500,32046
2210,1595,615,694,106000,32052
1358,1075,283,852,94600,32053
3662,2660,1002,765,154800,32054
6305,4061,2244,871,155400,32055
1397,1091,306,945,161400,32058
1068,755,313,842,90700,32059
7820,6314,1506,685,137600,32060
19,5,14,-,-,32061
636,492,144,-,186400,32062
4759,3658,1101,998,207000,32063
2835,1382,1453,834,156300,32064
13601,10391,3210,1556,259800,32065
2026,1626,400,855,119800,32066
20307,16032,4275,1303,233100,32068
1295,1100,195,525,139300,32071
22,22,0,-,-,32072
16087,10121,5966,1322,234300,32073
180,0,180,1689,-,32079
10086,8203,1883,1448,456200,32080
8250,7122,1128,"3,500+",518000,32081
12160,10035,2125,1739,676300,32082
541,354,187,950,119600,32083
13780,9369,4411,1267,266800,32084
13441,10211,3230,1417,300600,32086
1303,993,310,783,206900,32087
5714,3539,2175,849,130700,32091
15283,13526,1757,1976,417800,32092
1074,834,240,866,118600,32094
5791,5246,545,1281,461900,32095
1169,971,198,715,101300,32096
8210,6466,1744,1585,266400,32097
1086,947,139,975,152700,32102
3478,2408,1070,1048,171800,32110
2861,2058,803,787,121500,32112
2238,1843,395,-,134200,32113
14562,4739,9823,1139,157800,32114
12440,6293,6147,1308,158200,32117
9885,6090,3795,1172,305800,32118
10750,6663,4087,1276,189900,32119
2726,2375,351,1596,348400,32124
12874,9967,2907,1253,276200,32127
9297,7550,1747,1532,345400,32128
10688,7529,3159,1363,226500,32129
1888,1573,315,1498,238400,32130
1732,1360,372,957,217600,32131
3776,3145,631,1100,210700,32132
305,305,0,-,582400,32133
3202,2875,327,664,108300,32134
3900,3310,590,1362,392300,32136
19504,16701,2803,1679,324700,32137
284,267,17,-,143400,32139
623,511,112,1076,87000,32140
8396,7618,778,1355,223900,32141
2108,1687,421,1038,195400,32145
686,610,76,-,91700,32147
4333,3609,724,753,83800,32148
350,272,78,953,122900,32157
16184,13242,2942,1285,251600,32159
30880,28894,1986,1682,330200,32162
15051,14334,717,2102,428100,32163
19649,14327,5322,1589,275000,32164
13727,10356,3371,1541,283800,32168
5813,4900,913,1589,444900,32169
23205,18583,4622,1185,288800,32174
6880,5443,1437,1391,328100,32176
10440,6646,3794,840,150700,32177
3858,3195,663,953,147900,32179
1369,1039,330,882,212500,32180
1148,720,428,776,93300,32181
15,15,0,-,-,32182
695,614,81,-,119000,32187
2394,1504,890,735,112300,32189
528,486,42,-,-,32190
0,0,0,-,-,32192
616,516,100,937,256500,32193
1169,1108,61,-,184700,32195
2204,239,1965,935,230200,32202
0,0,0,-,-,32203
4359,1120,3239,1174,346400,32204
14491,7848,6643,1097,243200,32205
7027,3206,3821,834,123600,32206
15907,8145,7762,1082,229800,32207
13531,7480,6051,1125,124600,32208
14492,6775,7717,956,82100,32209
26800,14180,12620,1142,185600,32210
13533,7306,6227,1090,185200,32211
222,2,220,1845,-,32212
0,0,0,-,-,32214
17684,8390,9294,1228,226600,32216
8820,4965,3855,1063,272600,32217
24313,15485,8828,1364,235500,32218
4945,4237,708,1017,193700,32219
4590,3913,677,1167,189500,32220
10732,8248,2484,1554,223700,32221
6327,4512,1815,1635,277300,32222
10348,8400,1948,1444,358400,32223
15579,8595,6984,1557,383200,32224
21391,14458,6933,1500,296100,32225
6618,6027,591,2069,310600,32226
561,0,561,1818,-,32227
0,0,0,-,-,32228
9802,5769,4033,1462,384700,32233
3055,2527,528,912,205000,32234
24400,13581,10819,1321,201100,32244
23275,13069,10206,1552,265200,32246
12654,8547,4107,1753,474800,32250
5265,2705,2560,1016,76700,32254
24284,9292,14992,1446,323300,32256
17305,10629,6676,1323,282300,32257
15436,9918,5518,1816,311700,32258
20520,18014,2506,2198,440400,32259
3020,2114,906,1459,559300,32266
12792,6137,6655,1194,233300,32277
14465,4191,10274,1137,189700,32301
21661,10779,10882,1190,192300,32303
18685,2545,16140,1070,139200,32304
7513,4555,2958,918,139100,32305
0,0,0,-,-,32306
0,0,0,-,-,32307
11014,5762,5252,1273,279800,32308
13023,10310,2713,1228,325400,32309
5793,2795,2998,949,105100,32310
8913,5686,3227,1449,268400,32311
12408,10426,1982,1438,377800,32312
0,0,0,-,-,32313
5280,4848,432,1373,334400,32317
1652,1210,442,1404,225400,32320
1774,1396,378,887,117200,32321
1186,972,214,1113,202200,32322
61,33,28,-,-,32323
1647,1164,483,693,72300,32324
10507,8503,2004,1007,199000,32327
1578,1352,226,852,253300,32328
283,107,176,800,138300,32330
1767,1504,263,868,79800,32331
487,196,291,671,79000,32332
4677,3843,834,904,200700,32333
612,516,96,868,109900,32334
521,408,113,1012,73800,32336
32,32,0,-,-,32337
3675,2432,1243,825,105200,32340
1103,978,125,1097,183400,32343
4771,3547,1224,710,174500,32344
938,802,136,1489,225400,32346
2589,1903,686,810,106900,32347
3973,3003,970,961,88100,32348
690,552,138,-,80000,32350
5537,3699,1838,758,110800,32351
2151,1741,410,1020,134300,32352
148,114,34,1022,210000,32355
75,75,0,-,-,32356
623,541,82,1551,220700,32358
538,508,30,-,84700,32359
61,61,0,-,86400,32360
162,128,34,911,110900,32361
0,0,0,-,-,32399
8613,4880,3733,1055,172200,32401
133,0,133,1712,-,32403
15041,10813,4228,1259,211100,32404
12043,7571,4472,1320,232400,32405
6459,3789,2670,1750,334000,32407
8949,6277,2672,1295,318200,32408
3835,3421,414,1255,173800,32409
242,185,57,1434,308300,32410
7164,5218,1946,1460,348600,32413
1275,1180,95,632,115700,32420
1310,1074,236,755,110800,32421
475,454,21,642,169700,32423
2252,1612,640,582,123100,32424
4978,3688,1290,812,100900,32425
269,253,16,950,86000,32426
466,238,228,874,95600,32427
6165,4860,1305,915,141000,32428
313,266,47,-,114900,32430
1852,1465,387,759,113000,32431
0,0,0,-,-,32432
6833,5065,1768,983,111300,32433
2595,2097,498,823,168800,32435
311,239,72,800,-,32437
1856,1559,297,818,119600,32438
5661,4517,1144,1454,311700,32439
2300,1520,780,766,95300,32440
1442,996,446,729,122600,32442
1004,831,173,736,115200,32443
8027,5747,2280,1436,270100,32444
457,275,182,724,99700,32445
3824,2752,1072,827,138600,32446
3255,2230,1025,750,99200,32448
351,266,85,-,-,32449
1728,1371,357,679,99600,32455
3551,2788,763,1293,289000,32456
8638,6846,1792,1932,499900,32459
1628,1248,380,750,104700,32460
1152,971,181,2392,844300,32461
1291,1030,261,747,122400,32462
69,34,35,743,-,32463
1457,1338,119,792,122400,32464
2426,1908,518,854,113500,32465
2187,1675,512,1090,158300,32466
4647,2192,2455,906,253500,32501
1883,979,904,1173,233900,32502
13196,8813,4383,1141,236800,32503
9590,5824,3766,1194,229300,32504
10858,5229,5629,1035,100900,32505
14547,8724,5823,1180,177400,32506
13620,8653,4967,1166,240600,32507
533,0,533,1721,-,32508
0,0,0,-,-,32509
0,0,0,-,-,32511
0,0,0,-,-,32512
17638,8548,9090,1271,203300,32514
16120,12592,3528,1298,202100,32526
8,8,0,-,-,32530
2983,2531,452,874,266900,32531
10796,9196,1600,998,237300,32533
6928,4130,2798,1213,164900,32534
1667,1105,562,814,88000,32535
8786,6102,2684,1285,251000,32536
11076,8597,2479,1210,241300,32539
8442,5560,2882,1830,476400,32541
911,0,911,1839,-,32542
533,0,533,1781,-,32544
14883,8429,6454,1279,272100,32547
10239,5984,4255,1225,270500,32548
4236,3077,1159,2108,557700,32550
4111,3272,839,1609,526300,32561
11030,9010,2020,1600,340400,32563
900,741,159,885,119300,32564
2082,1645,437,1032,182000,32565
15663,12416,3247,1695,327700,32566
1705,1470,235,-,212600,32567
1347,1171,176,1041,201800,32568
5106,3546,1560,1371,272800,32569
13957,9225,4732,1201,220100,32570
13914,11707,2207,1133,246800,32571
1724,1529,195,903,190400,32577
13065,9957,3108,1682,386300,32578
4483,3197,1286,1449,389100,32579
1630,1005,625,1213,328300,32580
9979,8245,1734,1265,219100,32583
9015,2175,6840,1031,231800,32601
2043,168,1875,1138,284100,32603
10758,8068,2690,1382,247600,32605
10266,4850,5416,1576,294900,32606
13077,4589,8488,1178,276400,32607
22032,8920,13112,1285,321200,32608
7486,4083,3403,1046,155000,32609
0,0,0,-,-,32610
0,0,0,-,-,32612
5993,4549,1444,1100,274300,32615
71,0,71,-,-,32616
1473,1239,234,818,185400,32617
3441,2832,609,950,175800,32618
2023,1712,311,615,146300,32619
2238,1819,419,721,124100,32621
624,372,252,678,214900,32622
725,579,146,872,241900,32625
3528,2608,920,828,142300,32626
1602,1263,339,814,91200,32628
172,172,0,-,163400,32631
8,8,0,-,-,32634
119,119,0,-,-,32639
4148,3493,655,1012,151700,32640
5406,3158,2248,955,121800,32641
4122,3460,662,1237,218000,32643
100,100,0,-,187500,32648
6344,5198,1146,1081,251900,32653
5350,4351,999,973,180100,32656
60,52,8,-,77400,32658
137,102,35,-,266700,32664
2681,2349,332,629,175300,32666
1816,1370,446,1023,256800,32667
2175,1846,329,629,188200,32668
5857,5162,695,1341,283800,32669
4199,3491,708,796,92800,32680
83,72,11,-,-,32681
111,59,52,-,-,32683
2238,1459,779,762,309800,32686
63,63,0,-,168800,32692
4221,3502,719,882,160800,32693
1064,704,360,672,115200,32694
5485,4351,1134,792,186900,32696
71,25,46,990,93600,32697
11206,5560,5646,1415,253200,32701
1235,686,549,"3,500+",79400,32702
20148,13418,6730,1410,276900,32703
16207,10914,5293,1426,276800,32707
19430,14220,5210,1596,318200,32708
633,524,109,-,332300,32709
15927,13172,2755,1841,361100,32712
8894,7539,1355,1461,281700,32713
15747,7575,8172,1528,265600,32714
12592,8542,4050,1107,262400,32720
0,0,0,-,-,32723
16443,12021,4422,1194,260000,32724
18290,14465,3825,1448,230400,32725
9506,6542,2964,909,210500,32726
2883,1136,1747,1330,256700,32730
1774,1695,79,-,457300,32732
2213,1813,400,1396,231000,32735
4186,3796,390,1160,337300,32736
15887,13052,2835,1393,227000,32738
1224,1073,151,1110,290600,32744
18575,12026,6549,1780,378100,32746
9610,7255,2355,1563,318100,32750
9792,6067,3725,1629,402700,32751
4432,4092,340,1016,231900,32754
12777,9561,3216,1386,313800,32757
1031,868,163,1040,254000,32759
10443,6484,3959,1366,207500,32763
1053,971,82,-,307300,32764
21886,15860,6026,1832,384900,32765
5059,4478,581,1972,473100,32766
1061,914,147,1059,114000,32767
0,0,0,-,-,32768
21732,13286,8446,1441,308100,32771
12310,7118,5192,1407,228300,32773
0,0,0,-,-,32775
4324,3850,474,898,359700,32776
10820,8353,2467,1203,209600,32778
11108,8922,2186,1787,418200,32779
16185,11602,4583,1163,223300,32780
4284,3476,808,855,207900,32784
11413,7454,3959,1623,625700,32789
21924,10268,11656,1470,318300,32792
8447,6957,1490,1111,210000,32796
1274,1208,66,985,150900,32798
9246,2638,6608,1629,394500,32801
10563,5530,5033,1719,379700,32803
8855,5838,3017,1586,484200,32804
6846,3262,3584,969,220000,32805
11430,7326,4104,1412,394100,32806
12760,6231,6529,1376,221800,32807
19816,8256,11560,1311,193300,32808
9352,5149,4203,1216,243300,32809
13560,6936,6624,1460,240700,32810
13958,4286,9672,1371,164300,32811
13958,8118,5840,1390,315900,32812
4156,1480,2676,2168,723600,32814
0,0,0,-,-,32816
11611,6785,4826,1610,292300,32817
17803,9956,7847,1367,250600,32818
10445,6171,4274,1777,421300,32819
3190,2582,608,1647,365200,32820
8654,2932,5722,1686,274600,32821
23943,10044,13899,1507,205300,32822
15895,11935,3960,1716,313600,32824
20263,13380,6883,1652,298100,32825
9314,4524,4790,1399,221700,32826
5827,3889,1938,2091,516500,32827
23957,15036,8921,1766,370700,32828
6317,4576,1741,1821,316800,32829
25,25,0,-,110400,32830
24,14,10,-,-,32831
10788,7469,3319,2097,398900,32832
3516,2747,769,1344,348500,32833
17642,7746,9896,1662,304000,32835
8436,5178,3258,1897,602400,32836
15780,9534,6246,1782,334300,32837
17422,4602,12820,1323,214300,32839
0,0,0,-,-,32899
11148,5484,5664,1209,222900,32901
6090,5118,972,1618,454900,32903
13516,10816,2700,1619,306400,32904
10492,6053,4439,1249,180700,32905
16352,14155,2197,1481,230300,32907
4608,4159,449,1681,228200,32908
12321,10154,2167,1383,239100,32909
5765,3547,2218,1050,322500,32920
6574,3418,3156,975,147000,32922
516,0,516,1809,-,32925
9436,7497,1939,1201,230600,32926
10267,9143,1124,1229,233100,32927
7422,5568,1854,1437,436200,32931
7438,6634,804,1716,362200,32934
17764,10572,7192,1309,221700,32935
11335,9100,2235,1611,391600,32937
19248,16262,2986,1796,395000,32940
1600,1186,414,864,153400,32948
987,952,35,-,437700,32949
1885,1744,141,1830,410200,32950
5751,4913,838,1493,453900,32951
8287,7085,1202,1221,376300,32952
9655,7200,2455,1165,356100,32953
15799,12233,3566,1452,305800,32955
12749,10651,2098,1249,254500,32958
0,0,0,-,-,32959
9756,5819,3937,1103,233200,32960
9734,8084,1650,1116,207600,32962
7672,7289,383,1765,818500,32963
9192,7059,2133,1328,251100,32966
9497,7449,2048,1212,350100,32967
5483,5153,330,1597,343300,32968
52,14,38,-,-,32970
5089,4804,285,1298,144300,32976
172,111,61,1932,622300,33001
7391,3205,4186,1558,278100,33004
20753,11252,9501,1448,237100,33009
15709,4799,10910,1240,324400,33010
25048,12205,12843,1470,313600,33012
9356,5673,3683,1457,362700,33013
14420,6554,7866,1574,371000,33014
23157,12221,10936,1720,358400,33015
15621,7760,7861,1652,273100,33016
16961,12555,4406,1850,379200,33018
6331,4783,1548,1752,607400,33019
20012,6455,13557,1358,278100,33020
19302,12560,6742,1618,365400,33021
0,0,0,-,-,33022
21052,13761,7291,1531,315100,33023
24650,15948,8702,1600,338200,33024
27473,12856,14617,1786,311300,33025
12108,9760,2348,1829,361500,33026
24914,19624,5290,1705,371200,33027
8792,6760,2032,2291,486000,33028
13443,12181,1262,2405,500100,33029
10582,4036,6546,1237,342900,33030
2419,2177,242,1471,441700,33031
17014,10075,6939,1520,340000,33032
19948,11177,8771,1571,332300,33033
5930,1825,4105,1273,195700,33034
5474,2850,2624,1781,248900,33035
1681,1344,337,2033,916900,33036
5613,4415,1198,1848,632000,33037
0,0,0,-,-,33039
14911,7112,7799,2044,766700,33040
3023,2386,637,2193,703100,33042
1918,1588,330,2013,460000,33043
4256,2316,1940,1498,668700,33050
367,268,99,1797,828800,33051
10281,4939,5342,1244,267300,33054
11898,8916,2982,1546,307100,33055
11593,7522,4071,1560,288000,33056
14079,7061,7018,1337,324500,33060
13541,9267,4274,1754,465000,33062
25161,18566,6595,1642,246900,33063
22837,14284,8553,1607,274000,33064
20071,9417,10654,1740,373400,33065
8420,7090,1330,1632,184000,33066
8227,6279,1948,1896,588200,33067
18532,11374,7158,1806,248500,33068
11719,5447,6272,1589,231100,33069
2443,1847,596,1746,674400,33070
13301,8662,4639,1899,470800,33071
11669,6551,5118,2017,410100,33073
13069,11187,1882,3032,676100,33076
0,0,0,-,-,33101
328,307,21,-,"2,000,000+",33109
816,76,740,2370,1335900,33122
21227,5080,16147,1238,339300,33125
18073,7104,10969,1546,287100,33126
9661,2819,6842,1283,346000,33127
3907,123,3784,1191,292400,33128
7267,3393,3874,2153,526800,33129
16915,2120,14795,1553,436000,33130
12552,4132,8420,2649,599100,33131
8969,2226,6743,2373,535900,33132
14479,7487,6992,1824,825100,33133
16251,8937,7314,1719,637300,33134
14513,3050,11463,1221,367100,33135
6894,834,6060,1177,290500,33136
11498,3020,8478,2142,462200,33137
12701,6193,6508,1390,604300,33138
20113,6338,13775,1680,476000,33139
8579,4878,3701,1912,837700,33140
16685,5675,11010,1634,419900,33141
20178,5729,14449,1189,277600,33142
13337,7356,5981,1709,711800,33143
9296,5195,4101,1611,410200,33144
11809,5921,5888,1694,480100,33145
5357,3500,1857,2571,1119100,33146
14613,7389,7224,1279,234100,33147
4676,3043,1633,"3,500+",1321200,33149
10910,2995,7915,1094,317200,33150
5666,3337,2329,2080,716600,33154
14905,10072,4833,1889,464900,33155
11862,8607,3255,1918,972000,33156
21103,13824,7279,1414,433200,33157
2166,2058,108,3321,890100,33158
19954,11664,8290,1856,324100,33160
17162,6995,10167,1394,355300,33161
14978,7640,7338,1417,310700,33162
17306,12508,4798,1704,440700,33165
9834,4820,5014,1655,466500,33166
6639,3963,2676,1337,292300,33167
6486,4892,1594,1485,293800,33168
13254,6892,6362,1480,321100,33169
4433,2706,1727,1525,381000,33170
14485,6631,7854,1826,235800,33172
11749,8071,3678,1840,417500,33173
11050,5579,5471,1667,357400,33174
17115,13043,4072,1844,421400,33175
18847,11835,7012,1605,541600,33176
16240,12196,4044,1961,362100,33177
19718,9573,10145,2466,464100,33178
18433,10437,7996,1627,239900,33179
14456,9314,5142,2323,448300,33180
8384,3444,4940,1530,296800,33181
4240,3508,732,2264,439900,33182
12349,8144,4205,1778,346600,33183
6548,4572,1976,1976,364200,33184
8974,7262,1712,2642,459800,33185
23284,15675,7609,1961,391500,33186
5656,4953,703,2269,467900,33187
8431,4972,3459,1496,357200,33189
5373,2450,2923,1663,339000,33190
15643,9277,6366,1697,384600,33193
1962,1576,386,2363,439500,33194
16980,11447,5533,2011,428400,33196
10017,3781,6236,2252,701800,33301
9566,3909,5657,1577,543500,33304
6726,4625,2101,1656,479000,33305
1647,1187,460,1201,466200,33306
15678,10807,4871,1759,489800,33308
13810,7841,5969,1724,273600,33309
24694,11390,13304,1297,246600,33311
18849,11838,7011,1524,361800,33312
21950,9388,12562,1479,220400,33313
10687,3757,6930,1844,285400,33314
5832,3241,2591,1676,416900,33315
5884,3355,2529,1776,736400,33316
12755,9554,3201,1839,406200,33317
20966,13754,7212,1512,210500,33319
21766,16192,5574,1756,236800,33321
18730,15440,3290,1931,238500,33322
8334,6095,2239,2363,417700,33323
19860,11217,8643,1993,313500,33324
10487,7981,2506,1923,380000,33325
10800,7589,3211,2250,474100,33326
6584,5107,1477,2942,674200,33327
10261,8257,2004,1982,476100,33328
4446,4219,227,2600,646000,33330
7630,6478,1152,2838,620200,33331
3461,3019,442,3247,784500,33332
12877,7291,5586,1450,404600,33334
12891,7454,5437,1748,311500,33351
0,0,0,-,-,33388
14332,5189,9143,1679,354900,33401
5117,2327,2790,1337,299100,33403
11674,6482,5192,1408,257100,33404
8341,5021,3320,1274,346400,33405
8587,5618,2969,1530,285900,33406
12343,5714,6629,1449,253800,33407
9707,7568,2139,1757,472900,33408
11753,5273,6480,1557,245900,33409
15222,10801,4421,1885,426200,33410
27200,20563,6637,1792,363900,33411
5513,4705,808,1893,482200,33412
5517,3544,1973,1942,344700,33413
19761,14805,4956,2161,473300,33414
18334,10392,7942,1467,204000,33415
16131,9277,6854,1419,140700,33417
18339,14216,4123,2197,538900,33418
10302,6412,3890,1854,275400,33426
15922,10859,5063,2108,389700,33428
6273,2235,4038,772,133500,33430
7462,5266,2196,2115,496000,33431
10877,6233,4644,2076,822200,33432
20017,14069,5948,2198,382700,33433
10683,8321,2362,1448,329100,33434
14535,8815,5720,1750,273600,33435
19472,14646,4826,1790,309900,33436
18288,15816,2472,1780,362500,33437
196,139,57,-,87100,33438
6978,4892,2086,849,136400,33440
12499,6706,5793,1406,335600,33441
15439,10329,5110,1845,202400,33442
8822,4740,4082,1627,378300,33444
13660,9640,4020,1826,261600,33445
14150,12643,1507,1564,352700,33446
3164,2947,217,3059,584600,33449
9411,7946,1465,1196,365000,33455
21091,15734,5357,1945,487400,33458
12767,5488,7279,1324,292500,33460
15820,7757,8063,1466,229600,33461
12602,8143,4459,1590,287000,33462
20462,14547,5915,1646,284700,33463
21865,18787,3078,1760,376700,33467
6876,6057,819,1788,471400,33469
10002,9237,765,2520,464100,33470
2492,1777,715,781,85000,33471
8106,7692,414,1914,374500,33472
4160,4070,90,-,662400,33473
2069,801,1268,702,115400,33476
6517,5544,973,2389,551500,33477
5040,4875,165,1921,578400,33478
6364,5385,979,1758,1173700,33480
6512,4525,1987,2316,703700,33483
14463,11745,2718,1627,198300,33484
8955,6402,2553,2049,578500,33486
10172,7397,2775,2142,520500,33487
733,430,303,1058,117300,33493
10306,8509,1797,2430,448100,33496
5543,4997,546,"3,500+",519900,33498
104,85,19,-,388300,33503
11482,7144,4338,1270,251900,33510
22550,12333,10217,1582,284400,33511
4250,3357,893,999,191300,33513
808,508,300,907,172700,33514
259,203,56,885,106500,33521
6683,5144,1539,891,207300,33523
7369,5592,1777,918,216800,33525
5293,3886,1407,839,288500,33527
9,9,0,-,-,33530
5689,3751,1938,1292,241800,33534
2528,1910,618,949,160600,33538
4504,3737,767,996,114100,33540
10077,8695,1382,1186,102200,33541
10668,7447,3221,1016,119700,33542
12306,10452,1854,1898,322600,33543
9606,6798,2808,1840,362100,33544
7897,6199,1698,1971,315800,33545
9337,7502,1835,2155,435400,33547
2766,2369,397,1814,458500,33548
7314,5679,1635,1351,295200,33549
0,0,0,-,-,33550
10546,9094,1452,1530,531600,33556
10638,7955,2683,1310,442800,33558
6659,4009,2650,1372,295300,33559
9808,5719,4089,1161,179800,33563
6281,5357,924,1075,214500,33565
7825,5515,2310,1234,271600,33566
3877,3133,744,1232,251200,33567
9504,7987,1517,1729,302700,33569
11058,8204,2854,1143,222100,33570
9120,7605,1515,1935,381100,33572
14479,11844,2635,1846,239100,33573
0,0,0,-,-,33574
2770,2552,218,933,292600,33576
22572,12989,9583,1625,267800,33578
13456,10277,3179,2050,307800,33579
9985,7396,2589,1309,256500,33584
461,343,118,970,240700,33585
4064,2749,1315,1053,185100,33592
13126,10278,2848,1650,270600,33594
9982,8184,1798,2215,360300,33596
3457,2958,499,904,172300,33597
8355,7051,1304,1164,328800,33598
9754,3142,6612,2010,464000,33602
8428,5032,3396,1205,293200,33603
15621,8966,6655,1206,241100,33604
7255,2688,4567,1075,214100,33605
9110,3905,5205,1770,740100,33606
11163,4596,6567,1678,251600,33607
8462,5357,3105,1654,477600,33609
16487,8044,8443,1217,188200,33610
16728,9117,7611,1471,393300,33611
18908,6778,12130,1159,225000,33612
16138,4931,11207,1107,214700,33613
18644,7828,10816,1232,259400,33614
18681,10244,8437,1446,262100,33615
6270,3100,3170,1638,329300,33616
19942,8365,11577,1251,243000,33617
12184,8215,3969,1289,355200,33618
14141,7401,6740,1426,178600,33619
0,0,0,-,-,33620
475,0,475,2432,-,33621
15656,10269,5387,1553,319000,33624
11369,7666,3703,1631,322500,33625
11799,7985,3814,1937,450800,33626
10275,8163,2112,1663,726300,33629
7984,4466,3518,1625,268100,33634
7547,4750,2797,1693,261300,33635
7572,3375,4197,1390,207900,33637
25717,15433,10284,1676,394800,33647
9613,3713,5900,1360,499900,33701
14135,9227,4908,1226,266700,33702
11011,8719,2292,1539,373600,33703
7829,5441,2388,1242,581700,33704
11400,6776,4624,1346,272800,33705
8193,6205,1988,1480,573000,33706
12745,8982,3763,1367,305300,33707
7977,5966,2011,1758,443700,33708
10850,8217,2633,1236,178300,33709
14261,11431,2830,1417,267900,33710
6284,4287,1997,1601,234200,33711
9436,5508,3928,1301,253600,33712
14341,9989,4352,1302,245500,33713
8241,5288,2953,1170,153400,33714
3865,3502,363,2746,461900,33715
10056,1868,8188,1656,148000,33716
0,0,0,-,-,33744
10562,5907,4655,1122,262800,33755
13241,7983,5258,1235,284800,33756
7598,3985,3613,1699,272300,33759
7543,3506,4037,1313,194100,33760
8576,6781,1795,1614,249100,33761
2623,2038,585,1638,294700,33762
9970,7110,2860,1272,182000,33763
12469,8579,3890,1457,274300,33764
6246,3446,2800,1438,271800,33765
3990,3276,714,1771,648300,33767
11410,6906,4504,1289,221700,33770
13248,8067,5181,1302,134500,33771
9988,7215,2773,1422,288200,33772
6829,5098,1731,1314,252300,33773
8277,6547,1730,1280,291900,33774
5042,4579,463,1972,387000,33776
7335,6203,1132,1645,271600,33777
6421,5297,1124,1488,244300,33778
10300,6696,3604,1090,228500,33781
9387,7062,2325,1571,228900,33782
2423,1870,553,1491,645400,33785
708,657,51,2933,987000,33786
11696,5667,6029,1024,123300,33801
12370,7610,4760,1238,215600,33803
9707,4501,5206,1118,150600,33805
11397,7449,3948,1391,221800,33809
19229,14600,4629,1371,217000,33810
9353,7287,2066,1185,260900,33811
4741,3659,1082,1440,286100,33812
13560,10685,2875,1560,301600,33813
5738,3237,2501,996,29700,33815
12752,9021,3731,955,207600,33823
10047,7362,2685,865,123600,33825
881,766,115,1588,221400,33827
10499,6947,3552,980,192200,33830
1544,999,545,947,104200,33834
28,0,28,-,-,33835
13314,11096,2218,1642,271300,33837
1556,1112,444,1167,200800,33838
1146,871,275,1283,172000,33839
0,0,0,-,-,33840
3141,2256,885,816,133800,33841
4004,3363,641,832,94700,33843
15616,10896,4720,1150,191600,33844
125,77,48,753,153900,33847
148,66,82,1152,-,33848
221,168,53,-,216700,33849
3378,2367,1011,1114,188800,33850
283,255,28,-,174000,33851
9361,7515,1846,1033,172700,33852
4719,2573,2146,949,177200,33853
241,111,130,672,83200,33854
41,41,0,-,276000,33855
219,6,213,609,-,33856
595,504,91,-,138200,33857
128,19,109,-,-,33858
4441,3441,1000,1104,181100,33859
8565,5815,2750,1137,189400,33860
276,117,159,-,-,33865
40,40,0,-,163500,33867
4210,3715,495,1051,190800,33868
11070,7703,3367,891,133800,33870
5981,5407,574,1070,165800,33872
4880,3144,1736,911,120200,33873
4681,3898,783,913,198600,33875
2523,2207,316,887,152500,33876
211,211,0,-,188800,33877
15169,9937,5232,1038,178400,33880
14359,10152,4207,1085,157400,33881
13554,10365,3189,1374,245300,33884
1469,1166,303,856,129300,33890
7503,3452,4051,1823,277800,33896
9688,6673,3015,1764,246700,33897
6884,5678,1206,1095,147500,33898
9551,4141,5410,1195,274300,33901
11482,9380,2102,1096,117200,33903
14612,11161,3451,1520,301700,33904
14053,8941,5112,1458,221200,33905
11244,4745,6499,1360,213800,33907
20062,14156,5906,1729,300200,33908
12681,9228,3453,1653,260800,33909
8637,7361,1276,1695,335200,33912
10612,9545,1067,1847,380700,33913
17707,14325,3382,1590,369400,33914
10054,3403,6651,1219,209400,33916
14385,11978,2407,1140,155500,33917
14231,10996,3235,1470,265200,33919
2683,2507,176,986,319300,33920
362,362,0,-,"2,000,000+",33921
1784,1519,265,1120,278100,33922
40,40,0,-,-,33924
13675,11470,2205,1928,378800,33928
264,214,50,-,-,33930
4825,4359,466,1453,426000,33931
7437,5358,2079,912,159200,33935
9756,6382,3374,1152,182700,33936
95,95,0,-,75200,33944
1315,1198,117,785,565500,33946
4912,3953,959,1265,312700,33947
7839,6758,1081,1265,249500,33948
12055,9959,2096,1153,372900,33950
14697,11143,3554,1161,201500,33952
2976,2887,89,1568,292100,33953
4183,3268,915,1580,289400,33954
4894,4523,371,1531,302600,33955
1773,1648,125,2191,251600,33956
3491,3133,358,1003,844500,33957
310,270,40,1083,205000,33960
33,0,33,1365,-,33965
5130,3407,1723,1557,326900,33966
9734,6963,2771,1634,293300,33967
8176,6523,1653,1566,240900,33971
4617,3644,973,1434,260000,33972
3992,895,3097,1342,289300,33973
5277,3539,1738,1595,237600,33974
4977,3606,1371,1633,234600,33976
6062,4570,1492,1151,201500,33980
6121,5464,657,1385,319400,33981
4262,3685,577,993,246200,33982
7201,5857,1344,1190,291300,33983
13125,9468,3657,1498,289100,33990
9452,7508,1944,1735,317800,33991
10411,8810,1601,1859,289900,33993
0,0,0,-,-,34101
5385,4013,1372,1306,1207200,34102
5390,4548,842,1823,876500,34103
11060,7584,3476,1531,312200,34104
7721,5106,2615,1896,496900,34105
8412,7198,1214,1843,903100,34108
11765,8204,3561,1766,531600,34109
12641,9252,3389,1945,472800,34110
12975,9921,3054,1373,271200,34112
10424,7399,3025,1723,399700,34113
9360,7834,1526,1767,383700,34114
10832,6066,4766,1483,344100,34116
5433,4650,783,1488,379500,34117
14047,11658,2389,1641,599800,34119
13401,11619,1782,2022,408600,34120
8305,6752,1553,1736,605800,34134
19810,15648,4162,1662,380600,34135
115,115,0,-,162300,34137
364,315,49,-,213000,34138
72,68,4,-,394100,34139
53,26,27,-,-,34140
4,4,0,-,-,34141
8577,3975,4602,926,246600,34142
8276,7487,789,1870,808800,34145
1801,1712,89,1820,587700,34201
10395,8123,2272,1941,550300,34202
16637,12218,4419,1243,276600,34203
12978,7750,5228,1192,215000,34205
14675,9358,5317,1168,116100,34207
13815,7977,5838,1352,259500,34208
14797,11691,3106,1595,323300,34209
7701,4857,2844,1336,263300,34210
6209,5292,917,1851,535600,34211
8892,7452,1440,1764,441800,34212
322,300,22,-,796900,34215
558,536,22,-,1108600,34216
1962,1650,312,1770,607300,34217
10390,9399,991,1901,376200,34219
19085,15010,4075,1365,271200,34221
6060,4803,1257,1388,166400,34222
9930,8482,1448,1256,340600,34223
7688,6148,1540,1143,229200,34224
4171,3909,262,2469,909700,34228
3548,3196,352,2200,620800,34229
15180,9962,5218,1483,337400,34231
14870,10254,4616,1697,296300,34232
8403,6078,2325,1652,321100,34233
8828,5318,3510,1321,196000,34234
7045,5157,1888,1619,301500,34235
7608,4446,3162,1852,867000,34236
7227,3182,4045,1409,224500,34237
11100,8355,2745,1833,479400,34238
6871,5107,1764,1523,376900,34239
5629,4941,688,2014,531900,34240
5957,5197,760,1854,461600,34241
4053,3538,515,2169,877400,34242
13411,10453,2958,1826,365300,34243
233,233,0,-,729200,34250
2204,2000,204,951,457700,34251
9972,6636,3336,857,131500,34266
29,29,0,-,-,34267
96,92,4,-,-,34268
2243,2027,216,1039,168200,34269
10329,8876,1453,1641,375000,34275
10360,8229,2131,1363,280000,34285
7783,6236,1547,1734,273600,34286
11330,8711,2619,1235,209200,34287
5400,4370,1030,1515,266200,34288
1491,874,617,1644,302300,34289
3060,2688,372,1719,295800,34291
8215,6511,1704,1912,389800,34292
22049,19449,2600,1678,335700,34293
6953,4854,2099,873,160800,34420
4099,3128,971,813,218800,34428
4248,3570,678,940,193500,34429
3870,3282,588,835,161300,34431
5694,5019,675,941,189400,34432
3149,2894,255,1351,202100,34433
3682,3238,444,1213,181400,34434
3657,3130,527,611,174600,34436
7843,6841,1002,848,257800,34442
0,0,0,-,-,34445
8336,7811,525,883,201600,34446
4661,3949,712,903,124600,34448
1521,1126,395,755,125000,34449
5004,4003,1001,942,177200,34450
5452,4552,900,1080,172600,34452
4405,3816,589,983,156100,34453
4645,4097,548,997,256300,34461
8163,6519,1644,1107,195600,34465
8807,5010,3797,1065,152300,34470
10884,6576,4308,1126,259000,34471
12240,9477,2763,1132,168900,34472
7953,6519,1434,1272,207500,34473
7823,3543,4280,1400,168700,34474
4615,2063,2552,849,157400,34475
11346,10355,991,1247,234700,34476
5389,3671,1718,1189,176000,34479
8629,6483,2146,1059,237100,34480
12644,11536,1108,1158,186800,34481
7871,6613,1258,861,216200,34482
2478,1524,954,-,355700,34484
0,0,0,-,-,34487
4967,3551,1416,1012,82300,34488
13941,12005,1936,1037,219400,34491
302,246,56,977,247700,34498
10305,7281,3024,999,120400,34601
3198,2855,343,1103,235300,34602
4463,3946,517,1065,244000,34604
12416,9486,2930,1128,201800,34606
3876,3177,699,1241,304400,34607
14256,10929,3327,1169,208000,34608
16734,13638,3096,1358,244700,34609
5820,4562,1258,1178,229200,34610
8480,7396,1084,1133,154100,34613
2970,2839,131,-,246700,34614
3242,3003,239,1531,360200,34637
10838,8752,2086,2054,341700,34638
10470,8534,1936,1700,327400,34639
11394,7035,4359,1133,169300,34652
15409,10030,5379,1176,157800,34653
8943,7009,1934,1404,222900,34654
18505,14509,3996,1524,321700,34655
153,83,70,-,180100,34661
15065,11388,3677,1135,185800,34667
20909,12925,7984,1186,142800,34668
5713,4876,837,1178,202100,34669
8789,6799,1990,1348,327100,34677
62,34,28,-,-,34679
452,407,45,-,528300,34681
13792,10935,2857,1442,372900,34683
12988,9356,3632,1677,258300,34684
7499,5634,1865,1665,444800,34685
3408,3116,292,1408,461000,34688
12099,9638,2461,1048,284300,34689
5419,3344,2075,1161,116900,34690
9148,5771,3377,1182,149100,34691
7255,6072,1183,1644,356200,34695
18011,13206,4805,1385,289300,34698
1131,916,215,1004,213800,34705
24526,18775,5751,1737,333600,34711
8755,4352,4403,1517,291200,34714
7816,5901,1915,1828,371300,34715
18,18,0,-,-,34729
4866,4009,857,1103,163700,34731
1296,1105,191,1974,331400,34734
9402,8393,1009,1534,303800,34736
1733,1552,181,1715,322600,34737
361,247,114,-,174300,34739
17453,5934,11519,1451,250500,34741
11942,8571,3371,1606,251500,34743
19315,13090,6225,1297,291800,34744
16338,11836,4502,1643,296600,34746
9430,5050,4380,1710,418600,34747
20021,14642,5379,1077,203900,34748
2069,1516,553,1227,234100,34753
1391,1085,306,1436,463400,34756
11574,9052,2522,1607,243300,34758
13627,10469,3158,1484,251700,34759
310,264,46,1550,311100,34760
14026,9937,4089,1720,318700,34761
130,130,0,-,-,34762
9250,6329,2921,1245,248700,34769
8286,6922,1364,1644,399400,34771
9661,7807,1854,1836,320800,34772
1384,1205,179,2030,297900,34773
5831,3677,2154,1080,139700,34785
15251,10775,4476,2238,578400,34786
28229,20346,7883,1783,440500,34787
9313,7638,1675,1327,154300,34788
618,618,0,-,478300,34797
1644,1537,107,686,250800,34945
2575,1534,1041,895,107800,34946
4136,1766,2370,1019,181100,34947
4441,3493,948,1313,381000,34949
6725,2458,4267,1041,146800,34950
7136,6036,1100,1141,199400,34951
17495,12434,5061,1458,221400,34952
25550,22046,3504,1783,294200,34953
2402,1753,649,819,119100,34956
10779,8126,2653,1448,347100,34957
6035,4082,1953,1005,165400,34972
10225,8158,2067,942,150000,34974
1844,1037,807,1288,340800,34981
10833,8001,2832,1162,212000,34982
16114,13634,2480,1641,266300,34983
6452,5425,1027,1798,287300,34984
11871,9954,1917,1655,348600,34986
6360,5128,1232,1882,351700,34987
12144,10818,1326,1763,517100,34990
7762,4823,2939,1373,223900,34994
5620,4768,852,1283,394900,34996
18841,15572,3269,1374,317300,34997
4573,3486,1087,1254,205300,35004
2927,2455,472,1036,126000,35005
1232,1140,92,803,111400,35006
10062,8393,1669,1181,215500,35007
8149,5762,2387,650,120000,35010
23,9,14,-,-,35013
1483,1356,127,-,107900,35014
6712,4965,1747,718,172600,35016
949,738,211,698,120700,35019
10049,5502,4547,828,87000,35020
9188,7479,1709,999,227400,35022
8600,6775,1825,1138,143000,35023
2613,1976,637,682,131600,35031
17,13,4,-,69000,35032
1307,1178,129,1042,136400,35033
1422,1002,420,834,125000,35034
451,329,122,-,-,35035
69,11,58,-,-,35036
6876,5506,1370,1487,183700,35040
2204,1734,470,470,128300,35042
4631,4153,478,1348,301200,35043
3494,2350,1144,789,107000,35044
5704,3870,1834,888,179500,35045
1910,1537,373,693,136300,35046
1552,1105,447,924,169100,35049
3292,2608,684,830,230000,35051
24,0,24,-,-,35052
1146,1098,48,932,231800,35053
1742,1559,183,1311,259000,35054
9406,6149,3257,851,185300,35055
5213,4316,897,856,174700,35057
3973,2960,1013,874,170100,35058
156,156,0,-,109000,35060
417,256,161,1219,172000,35061
3235,2666,569,725,177700,35062
1264,1112,152,888,85300,35063
3792,2139,1653,998,116500,35064
3564,2642,922,1104,182900,35068
47,47,0,-,132300,35070
6836,5231,1605,1161,228100,35071
1710,1363,347,593,99700,35072
1277,863,414,811,110300,35073
59,0,59,-,-,35074
5422,3889,1533,821,144000,35077
833,693,140,778,190500,35078
3217,2935,282,893,173500,35079
6656,6065,591,1483,256100,35080
0,0,0,-,-,35082
1397,1180,217,873,148100,35083
3327,2738,589,846,113900,35085
1102,976,126,903,151600,35087
681,594,87,743,93700,35089
1222,1149,73,1042,263900,35091
5834,4549,1285,967,202100,35094
3148,2765,383,1002,169600,35096
780,716,64,1026,124700,35097
481,307,174,739,106700,35098
7089,6535,554,1241,244600,35111
0,0,0,-,-,35112
2921,2572,349,1220,260600,35114
5764,4133,1631,845,155700,35115
1953,1787,166,1049,206300,35116
2288,2187,101,1152,195400,35117
1021,816,205,924,143100,35118
0,0,0,-,-,35119
6289,5257,1032,909,180900,35120
6203,4371,1832,703,149400,35121
9286,7822,1464,1354,263700,35124
4017,2707,1310,1009,173800,35125
7606,6757,849,1095,174600,35126
3553,2744,809,1183,173100,35127
4009,3302,707,1172,219600,35128
1394,1133,261,535,108300,35130
1406,1144,262,746,94600,35131
1175,1064,111,796,165000,35133
775,603,172,1130,251000,35135
788,663,125,365,125800,35136
1296,1099,197,766,218500,35143
4190,3635,555,679,245400,35146
2274,2035,239,1594,277200,35147
979,683,296,638,129900,35148
77,77,0,-,-,35149
7233,4207,3026,707,138300,35150
2914,2562,352,960,146300,35151
10398,6759,3639,707,124300,35160
1332,1036,296,-,177100,35171
1069,794,275,799,97500,35172
11027,9909,1118,1200,311000,35173
2077,1748,329,856,164100,35175
357,244,113,817,104300,35176
1176,969,207,821,134700,35178
3042,2633,409,800,168300,35179
4960,4163,797,860,183300,35180
23,23,0,-,-,35181
365,297,68,-,117000,35183
1963,1516,447,829,105200,35184
0,0,0,-,-,35185
1994,1669,325,1055,272000,35186
775,682,93,916,180300,35188
1542,381,1161,729,284800,35203
4140,1774,2366,718,80000,35204
9309,2857,6452,978,268900,35205
6464,3091,3373,966,110700,35206
3152,1753,1399,743,71700,35207
5851,3608,2243,938,86100,35208
12520,6455,6065,1186,436100,35209
5919,4262,1657,1094,205400,35210
11127,4630,6497,969,89100,35211
4205,1779,2426,688,183000,35212
6328,4902,1426,1687,664500,35213
7007,4669,2338,874,144400,35214
16989,9338,7651,1031,134700,35215
15547,8620,6927,1257,353600,35216
5213,2460,2753,874,106200,35217
2586,1070,1516,883,74700,35218
1399,887,512,968,71400,35221
3640,2111,1529,948,367300,35222
4361,3878,483,1746,697200,35223
1978,1093,885,977,78500,35224
14378,11561,2817,1455,366300,35226
3688,2255,1433,978,79900,35228
0,0,0,-,-,35229
1880,210,1670,1548,322600,35233
1713,938,775,723,67400,35234
8058,5194,2864,1171,145300,35235
23290,17107,6183,1368,433800,35242
8927,5094,3833,1478,458000,35243
14198,9912,4286,1381,357000,35244
0,0,0,-,-,35249
0,0,0,-,-,35254
12671,4144,8527,885,132400,35401
8343,4073,4270,974,182400,35404
19758,10558,9200,1030,214200,35405
7625,5792,1833,1320,438500,35406
332,317,15,-,73500,35441
1666,900,766,601,113000,35442
513,410,103,441,53700,35443
1574,1258,316,856,163000,35444
738,617,121,783,-,35446
1279,975,304,596,137500,35447
1547,1355,192,1259,171300,35452
4348,3660,688,881,164400,35453
1707,1152,555,969,169300,35456
51,51,0,-,-,35457
228,184,44,-,-,35458
347,269,78,717,-,35459
414,366,48,-,118200,35460
856,822,34,1138,178000,35461
1765,1229,536,726,99000,35462
699,637,62,-,196500,35463
166,63,103,491,-,35464
2046,1748,298,647,110100,35466
126,102,24,-,57600,35469
1482,886,596,811,144200,35470
8060,5109,2951,893,232500,35473
2578,2267,311,857,171800,35474
6697,6217,480,832,279000,35475
3112,1121,1991,920,178200,35476
32,32,0,-,-,35477
490,472,18,-,229200,35480
1319,856,463,436,93600,35481
0,0,0,-,-,35487
1652,1359,293,876,165800,35490
0,0,0,-,-,35491
3471,2171,1300,680,164100,35501
3901,3248,653,711,150200,35503
4961,3866,1095,766,174400,35504
894,729,165,608,106200,35540
1555,1266,289,856,164300,35541
373,354,19,-,87900,35542
490,352,138,609,102400,35543
407,295,112,843,-,35544
45,32,13,-,120000,35545
1369,1156,213,578,118700,35546
792,622,170,402,81400,35548
1359,1064,295,534,59600,35549
1974,1569,405,448,89000,35550
413,354,59,383,83800,35552
1823,1435,388,539,80900,35553
490,394,96,643,68500,35554
3698,2520,1178,609,125600,35555
18,7,11,-,-,35559
1378,1040,338,548,101700,35563
856,643,213,561,106400,35564
4228,3120,1108,671,86500,35565
4035,2723,1312,571,113700,35570
281,248,33,575,86700,35571
652,634,18,-,312200,35572
6,6,0,-,-,35573
559,486,73,538,139400,35574
440,360,80,767,76700,35575
1223,1063,160,520,111900,35576
2,2,0,-,-,35577
2006,1741,265,1004,97500,35578
1383,1157,226,544,102100,35579
1364,1199,165,685,102400,35580
1935,1486,449,676,109700,35581
1927,1270,657,489,102700,35582
97,64,33,-,51300,35584
521,461,60,-,209500,35585
1280,977,303,498,88300,35586
314,238,76,778,-,35587
1686,1069,617,487,120400,35592
595,540,55,646,99600,35593
2696,2038,658,669,150500,35594
13307,7913,5394,804,135100,35601
13731,10016,3715,790,218800,35603
673,589,84,-,125700,35610
11707,7087,4620,747,169600,35611
8256,7192,1064,1044,271100,35613
2467,1900,567,955,170900,35614
0,0,0,-,-,35615
1448,1027,421,771,92300,35616
830,613,217,555,100200,35618
1780,1501,279,970,150100,35619
4190,3611,579,959,175700,35620
1052,983,69,1054,155200,35621
2450,1869,581,846,144400,35622
14590,6289,8301,757,148700,35630
0,0,0,-,-,35632
8267,6817,1450,819,163200,35633
4236,3405,831,827,252200,35634
10194,8203,1991,788,176900,35640
1559,1384,175,725,111100,35643
5042,4216,826,874,211200,35645
1719,1451,268,661,109900,35646
334,320,14,743,184000,35647
1178,975,203,648,143700,35648
36,36,0,-,-,35649
5201,4157,1044,621,143200,35650
461,400,61,-,220600,35651
3751,3059,692,786,165600,35652
3559,2576,983,676,107400,35653
3111,2149,962,589,149600,35654
4380,2579,1801,765,122100,35660
7667,5885,1782,950,176600,35661
2531,1926,605,722,152600,35670
537,500,37,637,96100,35671
2146,1648,498,636,121400,35672
2737,2144,593,719,176600,35673
7621,5268,2353,765,154100,35674
684,619,65,688,167200,35677
2100,1727,373,778,194300,35739
1536,1000,536,391,108400,35740
1993,1576,417,1090,282200,35741
746,562,184,746,139600,35744
61,48,13,-,-,35745
339,329,10,-,117100,35746
2452,2056,396,778,208300,35747
2924,2514,410,813,320500,35748
9618,8619,999,1202,246000,35749
5405,4231,1174,993,173800,35750
70,70,0,-,227500,35751
994,691,303,904,85700,35752
2199,1875,324,750,205700,35754
207,139,68,735,270800,35755
8412,6776,1636,1534,321000,35756
6451,5341,1110,1336,266800,35757
19584,13743,5841,1219,294100,35758
4360,4100,260,1116,241300,35759
1722,1421,301,889,163300,35760
4847,4007,840,978,196300,35761
7072,6481,591,2000,346700,35763
234,208,26,-,78800,35764
1713,1442,271,675,148200,35765
85,51,34,-,84700,35766
4657,3176,1481,724,120800,35768
4066,3344,722,762,177400,35769
1194,960,234,676,91400,35771
1890,1366,524,763,123200,35772
5315,4519,796,1050,172500,35773
45,45,0,-,96900,35774
224,218,6,-,91800,35775
1405,1173,232,579,120500,35776
10321,6943,3378,1109,367300,35801
11361,6062,5299,1038,289600,35802
12080,9767,2313,1073,234900,35803
9105,2881,6224,752,93300,35805
13203,6525,6678,1178,286600,35806
385,13,372,1677,-,35808
11881,7714,4167,1053,113500,35810
11084,8570,2514,941,229500,35811
6834,1941,4893,832,107100,35816
4401,2252,2149,1218,348800,35824
0,0,0,-,-,35896
7166,4552,2614,768,167200,35901
6777,4352,2425,787,145900,35903
5015,3722,1293,727,94700,35904
2269,1918,351,774,166400,35905
4009,2586,1423,959,188500,35906
3060,2773,287,1105,187600,35907
7103,4948,2155,839,139500,35950
4682,3485,1197,689,145000,35951
3379,2660,719,681,123400,35952
2572,2134,438,1006,189100,35953
4919,4033,886,641,124700,35954
2994,2437,557,786,159500,35956
5912,3988,1924,653,119800,35957
1169,977,192,770,149000,35958
1877,1450,427,696,186000,35959
3693,2829,864,703,171200,35960
2048,1469,579,611,85000,35961
2834,2186,648,801,152700,35962
571,415,156,563,129500,35963
1310,1055,255,701,132300,35966
6720,4666,2054,675,141100,35967
1653,1268,385,693,114400,35968
1806,1240,566,729,111700,35971
541,489,52,-,88500,35972
1081,895,186,1000,106300,35973
614,426,188,682,148500,35974
522,475,47,719,165800,35975
6609,5123,1486,733,235800,35976
1952,1477,475,816,128200,35978
319,319,0,-,134400,35979
2006,1630,376,785,156900,35980
602,480,122,840,105700,35981
1356,1166,190,710,134300,35983
778,608,170,785,143400,35984
3077,2486,591,646,192400,35986
969,826,143,-,123600,35987
730,497,233,624,103100,35988
1237,1055,182,669,97200,35989
0,0,0,-,-,35990
1007,829,178,425,103800,36003
610,511,99,925,109000,36005
782,727,55,1014,193800,36006
0,0,0,-,-,36008
903,667,236,602,98600,36009
2091,1427,664,659,112000,36010
139,139,0,-,372500,36013
1232,870,362,633,65000,36016
768,476,292,403,73300,36017
414,337,77,930,154500,36020
5555,4778,777,956,211300,36022
2385,1908,477,760,218700,36024
1535,1151,384,1052,185600,36025
585,541,44,1045,293800,36026
5944,3723,2221,638,118300,36027
640,391,249,575,120200,36028
308,247,61,-,-,36029
105,83,22,-,-,36030
12,12,0,-,-,36031
921,670,251,430,70000,36032
1446,1137,309,628,88900,36033
240,218,22,786,81400,36034
808,685,123,947,114200,36035
720,575,145,909,159400,36036
4873,3236,1637,733,95800,36037
100,24,76,-,-,36038
103,54,49,-,-,36039
1416,956,460,771,71900,36040
565,491,74,672,107700,36041
443,408,35,-,97800,36042
1316,1080,236,968,228300,36043
522,473,49,-,102000,36046
339,324,15,-,-,36047
583,412,171,760,83700,36048
1806,1317,489,587,114800,36049
1066,926,140,966,91000,36051
334,317,17,-,625000,36052
882,671,211,585,103000,36053
5950,4137,1813,976,155200,36054
0,0,0,-,-,36057
4364,3808,556,1444,359500,36064
8731,5430,3301,1298,204300,36066
10115,7803,2312,924,172500,36067
950,732,218,813,97400,36069
198,164,34,679,97400,36071
649,538,111,929,96600,36075
5220,3658,1562,837,167000,36078
3536,2743,793,888,142400,36079
838,630,208,974,250000,36080
5557,2614,2943,740,175900,36081
0,0,0,-,-,36082
3527,1970,1557,662,87900,36083
1172,591,581,766,97200,36088
2525,1533,992,625,88900,36089
1554,1181,373,783,128200,36091
8007,6274,1733,974,178600,36092
4086,3849,237,897,298500,36093
0,0,0,-,-,36101
3825,986,2839,753,110400,36104
4293,2619,1674,914,83200,36105
6370,3558,2812,1068,182200,36106
2968,1104,1864,876,71400,36107
6299,3979,2320,712,68300,36108
10068,6506,3562,1047,129000,36109
4031,2102,1929,970,74600,36110
4899,2920,1979,1024,145300,36111
7,0,7,1125,-,36112
255,0,255,1833,-,36113
0,0,0,-,-,36114
228,0,228,1427,-,36115
17362,8149,9213,1041,131300,36116
21737,13151,8586,1150,211800,36117
0,0,0,-,-,36130
7068,4359,2709,700,72700,36201
7306,5382,1924,891,158600,36203
478,218,260,816,255700,36205
4133,2715,1418,786,122200,36206
8008,6091,1917,942,184700,36207
1528,1273,255,1075,169000,36250
2077,1570,507,417,136700,36251
379,345,34,-,126800,36255
588,524,64,629,139500,36256
690,627,63,-,100600,36258
1411,1136,275,675,158200,36260
589,530,59,883,96600,36262
172,135,37,-,117300,36263
3124,2291,833,772,148800,36264
8470,5409,3061,761,159000,36265
2419,1817,602,605,168500,36266
16,16,0,-,-,36267
2305,2077,228,743,100700,36268
572,401,171,909,125400,36269
2228,2029,199,739,148700,36271
5043,3921,1122,704,111200,36272
1279,1081,198,-,137100,36273
4162,3177,985,671,102600,36274
948,723,225,633,105100,36276
1828,1476,352,899,131300,36277
1871,1564,307,654,241300,36278
979,854,125,1146,156100,36279
1551,1302,249,833,215100,36280
15172,9094,6078,835,146800,36301
11808,7204,4604,814,166400,36303
6603,4536,2067,1068,226000,36305
2594,1929,665,588,116000,36310
1052,832,220,714,111400,36311
2290,1715,575,779,144700,36312
122,80,42,-,-,36313
211,180,31,568,58200,36314
794,712,82,900,164000,36316
281,276,5,-,105000,36317
526,463,63,719,116000,36318
887,723,164,768,144000,36319
1363,1063,300,480,115300,36320
799,624,175,783,158200,36321
3795,2312,1483,739,111700,36322
3150,2534,616,664,93300,36323
14498,9229,5269,971,190000,36330
2175,1482,693,657,123100,36340
549,414,135,879,97100,36343
2143,1594,549,738,146400,36344
3223,2700,523,728,161800,36345
510,461,49,696,122900,36346
2971,1729,1242,769,157500,36350
1467,1212,255,689,135200,36351
1937,1635,302,769,177500,36352
644,562,82,830,97500,36353
7763,5039,2724,739,131900,36360
1465,12,1453,1347,-,36362
360,335,25,567,90400,36370
203,147,56,767,118900,36371
171,130,41,-,-,36373
235,183,52,856,96500,36374
2771,2153,618,789,120000,36375
890,715,175,814,95200,36376
2834,2039,795,721,101000,36401
3850,2849,1001,652,150800,36420
3636,2776,860,723,147700,36421
287,205,82,-,-,36425
5455,3871,1584,670,122800,36426
721,584,137,756,55300,36432
194,152,42,-,110700,36435
218,167,51,-,134200,36436
39,30,9,-,-,36439
1298,897,401,695,124000,36441
1222,830,392,714,112000,36442
216,199,17,-,85500,36444
1830,1512,318,754,99100,36445
117,81,36,-,109800,36446
1613,1282,331,757,123600,36451
973,794,179,669,91400,36453
28,28,0,-,77800,36454
143,80,63,668,75000,36455
632,521,111,545,78700,36456
3671,2313,1358,663,118100,36460
3978,3026,952,673,112200,36467
0,0,0,-,-,36470
301,157,144,721,61100,36471
69,47,22,-,129200,36473
972,838,134,711,94600,36474
753,604,149,717,109900,36475
18,4,14,-,-,36476
1706,1282,424,622,101500,36477
585,525,60,-,155500,36480
71,63,8,-,-,36481
330,272,58,-,113000,36482
247,209,38,-,138500,36483
6230,3975,2255,643,131400,36502
0,0,0,-,-,36503
387,334,53,-,161500,36505
7409,5679,1730,857,150000,36507
550,387,163,716,83500,36509
320,320,0,-,-,36511
10,10,0,-,-,36512
148,148,0,-,113000,36513
839,703,136,646,168000,36518
2001,1825,176,899,158900,36521
2506,1749,757,740,155400,36522
1047,803,244,974,168000,36523
418,329,89,646,79900,36524
703,554,149,942,168400,36525
12645,9305,3340,1325,280000,36526
6715,5025,1690,1456,327100,36527
816,787,29,1268,355200,36528
62,57,5,-,-,36529
2903,2292,611,939,236700,36530
14309,11982,2327,1414,384500,36532
15934,12353,3581,976,237900,36535
185,86,99,-,82200,36538
177,169,8,-,126400,36539
308,256,52,-,-,36540
5422,4725,697,952,145400,36541
7762,5371,2391,1182,323900,36542
5,5,0,-,-,36543
4314,3188,1126,781,129800,36544
3116,2224,892,643,134100,36545
0,0,0,-,-,36547
387,339,48,-,169300,36548
2552,2235,317,864,165700,36549
170,148,22,-,-,36550
3728,3043,685,1186,209300,36551
1068,986,82,600,155600,36553
484,440,44,1136,337500,36555
19,19,0,-,-,36556
1488,1325,163,701,119000,36558
128,128,0,-,631300,36559
1033,833,200,805,84900,36560
4150,2943,1207,1260,482800,36561
570,457,113,-,114400,36562
0,0,0,-,-,36564
5337,4078,1259,980,192800,36567
36,16,20,-,-,36568
262,253,9,-,108200,36569
6564,4951,1613,974,187600,36571
2414,1977,437,1233,178600,36572
579,461,118,1102,190100,36574
7455,6182,1273,998,181400,36575
1746,1390,356,984,236000,36576
476,476,0,-,198600,36578
515,472,43,691,198300,36579
2311,2016,295,906,205700,36580
145,104,41,-,-,36581
9262,7098,2164,854,161500,36582
204,192,12,-,167100,36583
375,347,28,-,-,36584
261,237,24,-,71400,36585
4069,3266,803,924,146900,36587
643,139,504,463,241000,36602
2997,956,2041,747,117400,36603
3841,2254,1587,868,211700,36604
9752,4855,4897,995,95100,36605
8144,4099,4045,923,140800,36606
2514,1398,1116,885,111200,36607
15625,8218,7407,992,205800,36608
11350,4787,6563,991,179300,36609
3800,1730,2070,674,52800,36610
2379,1134,1245,871,89300,36611
1369,807,562,733,75500,36612
4002,2980,1022,1152,142100,36613
0,0,0,-,-,36615
4960,2287,2673,1062,76600,36617
6762,4869,1893,1055,141600,36618
5646,3919,1727,1031,157300,36619
0,0,0,-,-,36652
4,4,0,-,-,36663
56,0,56,608,-,36688
7654,5226,2428,1035,188100,36693
19596,13052,6544,1166,222700,36695
8222,4898,3324,807,108400,36701
4503,2654,1849,666,61300,36703
260,240,20,-,112800,36720
70,46,24,-,54800,36722
117,104,13,-,-,36723
1653,1278,375,828,92200,36726
115,115,0,-,"10,000-",36727
201,178,23,-,47900,36728
3324,1923,1401,681,184600,36732
354,313,41,1083,67900,36736
263,141,122,726,77000,36738
421,304,117,702,60000,36740
0,0,0,-,-,36741
998,820,178,660,84000,36742
2359,1600,759,665,124800,36744
1020,662,358,729,93000,36748
260,166,94,-,-,36749
974,838,136,954,153900,36750
131,111,20,-,23000,36751
548,508,40,-,137300,36752
0,0,0,-,-,36753
99,89,10,-,-,36754
1746,1175,571,573,90700,36756
608,543,65,760,85600,36758
686,542,144,1574,58400,36759
374,278,96,785,51100,36761
59,57,2,-,-,36763
0,0,0,-,-,36764
442,402,40,-,76300,36765
13,8,5,-,145000,36766
424,332,92,346,82000,36767
361,252,109,935,-,36768
783,621,162,-,76000,36769
95,74,21,-,-,36773
547,372,175,1117,97700,36775
582,459,123,-,62200,36776
785,706,79,781,86700,36782
272,181,91,488,74200,36783
2194,1407,787,697,137100,36784
363,291,72,1295,101900,36785
934,621,313,510,64900,36786
224,145,79,240,155700,36790
307,239,68,-,-,36792
226,151,75,-,153400,36793
9578,6084,3494,872,193800,36801
7044,5654,1390,738,138000,36804
19684,10923,8761,1004,322100,36830
10928,5113,5815,957,216000,36832
0,0,0,-,-,36849
1108,912,196,589,63400,36850
0,0,0,-,-,36851
793,633,160,1070,184900,36852
3398,2664,734,849,233000,36853
6074,4198,1876,990,130500,36854
609,544,65,973,157100,36855
2804,2584,220,1597,224600,36856
204,182,22,-,146200,36858
715,544,171,638,77600,36860
1098,1014,84,702,238900,36861
2329,1782,547,599,139400,36862
4458,3177,1281,724,105300,36863
17,5,12,-,-,36865
1551,1165,386,550,96800,36866
8993,4121,4872,938,175900,36867
9194,5507,3687,910,119800,36869
7259,5970,1289,893,174100,36870
417,373,44,816,115500,36871
3929,3539,390,914,170100,36874
1432,1150,282,701,186000,36875
4099,3240,859,1043,189900,36877
986,840,146,707,288500,36879
39,39,0,-,-,36901
1680,1322,358,658,121300,36904
795,685,110,1271,87900,36907
746,611,135,780,89600,36908
6,6,0,-,-,36910
598,525,73,1227,65100,36912
25,25,0,-,-,36913
280,213,67,-,114800,36915
296,233,63,328,81100,36916
708,555,153,454,79700,36919
524,461,63,475,154700,36921
224,224,0,-,111000,36922
1397,858,539,545,49400,36925
1748,1654,94,963,337300,37010
961,701,260,650,190800,37012
36255,20336,15919,1359,270300,37013
1307,1307,0,-,681100,37014
7347,5876,1471,1199,236400,37015
390,325,65,1137,164300,37016
821,635,186,1155,159300,37018
310,225,85,859,194600,37019
1890,1750,140,1345,245900,37020
2206,1941,265,1228,213600,37022
501,379,122,994,159900,37023
2172,2042,130,809,222600,37025
994,832,162,604,180900,37026
22708,18786,3922,1925,762300,37027
242,201,41,-,121500,37028
2420,2248,172,764,320300,37029
3156,2215,941,851,196200,37030
1677,1478,199,992,277200,37031
2016,1674,342,742,239000,37032
3113,2252,861,814,174400,37033
2876,2441,435,1178,269000,37034
1479,1336,143,1130,207100,37035
2128,1916,212,849,248400,37036
2864,2574,290,1704,326600,37037
22195,12936,9259,1052,223900,37040
31107,18267,12840,1123,190500,37042
19869,14130,5739,1142,296400,37043
2458,2297,161,1902,765600,37046
871,713,158,863,192100,37047
2404,2146,258,963,343900,37048
1397,1174,223,1037,301700,37049
628,523,105,733,141200,37050
1472,1200,272,835,216400,37051
925,897,28,-,195700,37052
10846,8030,2816,983,230600,37055
255,101,154,877,200600,37057
2868,2332,536,697,189500,37058
553,389,164,1044,201700,37059
975,880,95,1350,368700,37060
1727,1295,432,663,171600,37061
4951,4081,870,1296,311200,37062
23199,18164,5035,1686,593000,37064
23351,15584,7767,1258,343200,37066
13057,6821,6236,1821,627200,37067
6811,6024,787,2158,662600,37069
13159,9021,4138,1296,298600,37072
5103,4259,844,1073,303800,37073
3125,2346,779,737,211300,37074
27531,20327,7204,1405,370500,37075
17136,9624,7512,1356,302700,37076
201,142,59,1402,231600,37078
941,765,176,723,134000,37079
3028,2501,527,1002,294000,37080
2129,1697,432,1122,325500,37082
5878,4320,1558,816,200600,37083
1878,1823,55,-,360000,37085
12449,8812,3637,1603,242000,37086
19657,13946,5711,1097,331600,37087
6590,4509,2081,1295,327600,37090
8889,6488,2401,868,206600,37091
938,670,268,924,170200,37095
2084,1593,491,685,121800,37096
756,581,175,811,132600,37097
2061,1441,620,764,145800,37098
2179,1814,365,732,185900,37101
12956,9082,3874,727,153200,37110
17954,7686,10268,1182,246600,37115
494,494,0,-,385200,37118
23409,19298,4111,1732,402800,37122
6988,5300,1688,1199,299900,37127
26411,17511,8900,1431,329400,37128
21677,14880,6797,1435,322300,37129
23323,11071,12252,1104,301500,37130
0,0,0,-,-,37132
937,747,190,831,130700,37134
7240,6819,421,2505,567000,37135
1117,996,121,911,140200,37137
9485,7494,1991,1335,329600,37138
60,60,0,-,261100,37140
556,474,82,982,229200,37141
636,561,75,626,180400,37142
1517,1295,222,1171,306000,37143
1417,1250,167,627,191700,37144
1041,901,140,698,158100,37145
2923,2486,437,1299,326900,37146
9191,6734,2457,975,251000,37148
911,835,76,1010,275400,37149
1563,1068,495,718,136100,37150
198,155,43,-,251300,37151
1883,1607,276,1091,363400,37153
13127,8310,4817,873,212200,37160
21,14,7,-,97500,37165
5823,3779,2044,739,169900,37166
21855,13401,8454,1278,289100,37167
428,364,64,-,129800,37171
11574,7864,3710,1053,253300,37172
17221,12904,4317,1663,387100,37174
375,310,65,-,99400,37175
800,729,71,825,118100,37178
5570,4757,813,2040,458000,37179
1452,1193,259,658,256600,37180
620,530,90,714,171600,37181
1270,1160,110,867,216000,37183
2651,2182,469,890,231300,37184
3493,2675,818,821,178100,37185
3801,2625,1176,951,182800,37186
3009,2339,670,944,257700,37187
6429,5026,1403,1289,284300,37188
1567,1309,258,1253,323100,37189
3451,2505,946,687,222000,37190
1469,1320,149,918,221500,37191
885,433,452,1850,415600,37201
11834,2270,9564,1738,441700,37203
6935,3858,3077,1691,770500,37204
11955,8228,3727,1775,821900,37205
12862,6409,6453,1434,481500,37206
16034,9074,6960,1163,292700,37207
8670,2782,5888,1329,370900,37208
18570,8442,10128,1503,453500,37209
7344,2007,5337,1115,295200,37210
30135,14759,15376,1310,337000,37211
6938,2931,4007,1396,836500,37212
13,0,13,-,-,37213
14475,8852,5623,1462,289000,37214
10260,7672,2588,1744,851800,37215
8597,6131,2466,1455,375900,37216
12468,5808,6660,1234,247700,37217
5945,4137,1808,1256,260800,37218
1158,276,882,1969,342300,37219
2410,2185,225,1558,667800,37220
18787,13505,5282,1668,393500,37221
1492,12,1480,1319,-,37228
0,0,0,-,-,37232
0,0,0,-,-,37238
421,366,55,825,114500,37301
1945,1393,552,1012,356800,37302
10152,6879,3273,807,182700,37303
279,278,1,-,80600,37305
978,868,110,-,196600,37306
1950,1548,402,688,147700,37307
1022,861,161,691,213500,37308
922,691,231,940,149700,37309
1514,1242,272,822,211900,37310
10971,5139,5832,845,182700,37311
14104,9965,4139,1065,250300,37312
562,519,43,620,156000,37313
0,0,0,-,-,37315
0,0,0,-,-,37316
1158,920,238,571,112000,37317
794,473,321,706,108100,37318
7557,5308,2249,775,152000,37321
3476,2518,958,827,160900,37322
11971,9449,2522,905,189900,37323
2210,1298,912,820,183600,37324
724,616,108,706,153400,37325
246,93,153,526,119200,37326
4470,3387,1083,788,179000,37327
606,533,73,810,160100,37328
2518,2089,429,734,153800,37329
2817,2350,467,1077,183300,37330
2913,2221,692,871,149500,37331
892,796,96,1453,130600,37332
211,154,57,-,-,37333
9422,6693,2729,763,190600,37334
1149,1033,116,655,158400,37335
1875,1725,150,951,191500,37336
387,360,27,-,142600,37337
1123,872,251,822,126700,37338
524,471,53,825,127700,37339
124,124,0,-,-,37340
5597,4500,1097,1065,227000,37341
1540,1258,282,811,178000,37342
17465,13501,3964,1116,244600,37343
989,793,196,1091,148700,37345
3582,2920,662,731,132500,37347
400,303,97,-,350000,37348
801,743,58,1446,710600,37350
238,225,13,-,139500,37351
1258,1001,257,680,240700,37352
1980,1600,380,921,211300,37353
6892,5065,1827,711,176900,37354
10912,7725,3187,871,224200,37355
968,678,290,702,257400,37356
2054,1627,427,763,150800,37357
433,373,60,905,213700,37359
688,502,186,747,234000,37360
913,710,203,816,119600,37361
1397,1183,214,751,106200,37362
15432,11803,3629,1400,318500,37363
606,560,46,522,97800,37365
399,335,64,961,126000,37366
3785,2971,814,743,161600,37367
214,190,24,-,114500,37369
1880,1591,289,850,198400,37370
1135,955,180,996,271900,37373
627,560,67,835,234100,37374
1089,909,180,1334,306400,37375
177,61,116,-,84100,37376
6256,5377,879,1302,438200,37377
10888,9054,1834,936,243100,37379
2450,1695,755,834,159100,37380
4146,3255,891,770,170900,37381
0,0,0,-,-,37383
3079,2596,483,558,168500,37385
1573,1314,259,531,122900,37387
11138,7611,3527,814,196700,37388
613,497,116,896,172800,37391
44,44,0,-,210000,37394
91,91,0,-,113900,37396
4078,2987,1091,804,145900,37397
6207,4716,1491,783,198600,37398
2511,121,2390,662,414500,37402
1651,419,1232,1169,434500,37403
5112,2732,2380,909,219000,37404
8665,4075,4590,1198,374400,37405
5091,2496,2595,893,140700,37406
2899,1102,1797,834,86600,37407
1325,454,871,1229,422800,37408
1544,963,581,1108,225300,37409
1462,323,1139,787,69900,37410
7948,4730,3218,988,176400,37411
9461,5756,3705,1035,164300,37412
10943,6795,4148,1132,234200,37415
6354,3720,2634,982,186700,37416
2621,2119,502,965,279800,37419
21746,12837,8909,1224,265000,37421
0,0,0,-,-,37450
16625,9043,7582,861,179500,37601
16960,8220,8740,870,209300,37604
0,0,0,-,-,37614
9299,7098,2201,945,245200,37615
2080,1601,479,741,169900,37616
5694,4754,940,814,200000,37617
5484,4266,1218,879,161300,37618
16277,11640,4637,773,159400,37620
1591,1287,304,759,118700,37640
3693,2899,794,664,165200,37641
6028,4833,1195,857,164200,37642
14271,10240,4031,721,145200,37643
2119,1829,290,744,171200,37645
5371,4058,1313,626,138500,37650
1504,1385,119,892,209400,37656
391,326,65,681,210900,37657
1549,1293,256,599,131500,37658
11512,9320,2192,1018,223100,37659
17518,11095,6423,778,162600,37660
6023,5112,911,858,207200,37663
12618,8904,3714,752,188400,37664
2199,1461,738,679,101000,37665
217,161,56,-,342000,37680
2477,2131,346,793,163300,37681
42,42,0,-,-,37682
4835,3725,1110,597,154700,37683
3253,2558,695,1074,235500,37686
1681,1475,206,-,135400,37687
489,432,57,-,124100,37688
1885,1592,293,923,182700,37690
288,127,161,-,293000,37691
2157,1461,696,917,180900,37692
868,771,97,751,146900,37694
3653,2496,1157,1124,220700,37701
1824,1525,299,1310,242400,37705
2635,1932,703,588,145200,37708
1480,1038,442,853,204300,37709
422,391,31,731,83400,37710
2047,1768,279,748,115700,37711
487,389,98,825,128600,37713
1675,1283,392,788,171800,37714
358,310,48,518,126300,37715
10361,7622,2739,880,200900,37716
10,10,0,-,-,37719
5572,4670,902,936,195700,37721
2861,2195,666,770,156900,37722
601,507,94,640,124900,37723
1291,638,653,743,137300,37724
6707,5305,1402,856,204300,37725
670,589,81,499,116400,37726
792,704,88,905,138400,37727
521,432,89,-,77300,37729
13,13,0,-,126800,37730
243,222,21,-,-,37731
15,15,0,-,-,37732
0,0,0,-,-,37733
2550,2137,413,1010,255200,37737
1989,1412,577,1015,261700,37738
2529,2314,215,868,239500,37742
9474,7188,2286,693,169600,37743
8212,5828,2384,680,179300,37745
7047,5299,1748,747,160800,37748
2429,1690,739,772,155000,37752
359,237,122,621,84500,37753
1466,1271,195,1053,151100,37754
1043,762,281,629,118000,37755
1335,840,495,579,93800,37756
4122,2947,1175,705,169700,37757
4982,3046,1936,793,213200,37760
1139,619,520,417,121500,37762
6690,5360,1330,821,223900,37763
4099,3128,971,1094,226700,37764
236,227,9,-,110800,37765
7554,4672,2882,729,133600,37766
2379,1677,702,655,176100,37769
1254,1120,134,655,128800,37770
6669,4675,1994,912,214700,37771
5618,4738,880,1331,330000,37772
8779,7696,1083,885,283800,37774
5332,3531,1801,790,272700,37777
1280,1110,170,749,144500,37779
11077,7824,3253,962,232500,37801
13321,10875,2446,1005,280800,37803
9785,7381,2404,1069,204500,37804
1270,881,389,766,159200,37806
4158,3220,938,865,164000,37807
812,456,356,708,150300,37809
702,558,144,-,133600,37810
1712,1489,223,663,140300,37811
6647,4367,2280,749,138900,37813
13883,8751,5132,820,171000,37814
2053,1599,454,740,121700,37818
232,143,89,571,105300,37819
2847,2344,503,803,176400,37820
8777,5823,2954,763,124300,37821
3748,2706,1042,670,135500,37825
1721,1446,275,877,174600,37826
748,612,136,994,297400,37828
636,542,94,943,141900,37829
13298,8497,4801,1036,212600,37830
3927,3021,906,770,181300,37840
3791,2625,1166,691,131900,37841
1911,1494,417,798,169800,37843
151,115,36,-,149600,37845
1582,1246,336,789,183300,37846
1123,894,229,656,109600,37847
60,60,0,-,158800,37848
10841,8732,2109,921,234600,37849
0,0,0,-,-,37851
1125,930,195,728,114000,37852
1362,949,413,768,231000,37853
4751,3365,1386,743,130000,37854
8025,6113,1912,674,146200,37857
1531,1136,395,694,155600,37860
3411,2751,660,579,158200,37861
8914,5575,3339,937,248700,37862
2414,1173,1241,850,221600,37863
9198,7677,1521,1150,250100,37865
811,764,47,705,239700,37866
2010,1415,595,570,121400,37869
1615,1306,309,660,126300,37870
3522,2703,819,842,178700,37871
696,573,123,900,115200,37872
1711,1365,346,732,135500,37873
6717,4274,2443,622,153000,37874
12910,9909,3001,966,243200,37876
3400,2822,578,925,191600,37877
288,215,73,-,255100,37878
4822,3656,1166,721,123500,37879
1533,1292,241,754,216100,37880
742,614,128,824,125400,37881
1285,1045,240,968,264700,37882
2649,2024,625,834,265000,37885
1534,1238,296,994,196200,37886
1795,1380,415,703,134100,37887
1272,1057,215,-,117400,37888
3046,2398,648,743,174200,37890
1503,1281,222,744,150800,37891
816,636,180,645,102900,37892
1546,301,1245,1190,493900,37902
7757,3508,4249,1081,244500,37909
9900,5072,4828,1003,162500,37912
8866,5950,2916,1001,177500,37914
2958,738,2220,439,213000,37915
3102,91,3011,1102,244400,37916
12241,5878,6363,1016,165400,37917
18629,12669,5960,1026,213500,37918
13854,7597,6257,1154,416100,37919
17788,10396,7392,994,200500,37920
11256,6947,4309,1083,172300,37921
14282,12031,2251,1549,419900,37922
13038,8007,5031,1189,266300,37923
5453,4083,1370,971,200400,37924
0,0,0,-,-,37929
12076,8446,3630,1332,287100,37931
7962,5736,2226,1409,356900,37932
10392,8984,1408,1585,429100,37934
6865,6169,696,1023,247100,37938
1686,1072,614,744,121200,38001
14914,12480,2434,1505,333300,38002
4326,3713,613,1335,246200,38004
2014,1303,711,942,155900,38006
0,0,0,-,-,38007
3679,2474,1205,879,118700,38008
3634,2749,885,1031,194400,38011
5345,2841,2504,715,119000,38012
954,795,159,854,168000,38015
18625,10879,7746,1351,232200,38016
19612,15667,3945,1437,416700,38017
13990,8811,5179,1512,228600,38018
5898,3706,2192,869,179900,38019
5,5,0,-,-,38021
1967,1564,403,1145,217100,38023
10378,6316,4062,725,157400,38024
2923,2793,130,1305,438100,38028
19,19,0,-,-,38029
95,54,41,532,143200,38030
1302,1071,231,711,129200,38034
45,28,17,838,150000,38036
620,423,197,638,98500,38037
592,445,147,780,111500,38039
2084,1174,910,721,97800,38040
1027,676,351,657,87400,38041
307,234,73,977,138600,38042
241,195,46,-,127100,38044
7,7,0,-,350000,38046
40,0,40,-,-,38047
1526,1060,466,1008,134100,38049
225,150,75,835,84000,38050
1603,1253,350,688,119900,38052
9680,6486,3194,1080,179100,38053
0,0,0,-,-,38054
1468,1155,313,781,287000,38057
3472,2842,630,1078,196900,38058
3267,2230,1037,776,143200,38059
4575,4009,566,992,267700,38060
326,247,79,-,131700,38061
5930,3741,2189,675,118900,38063
1366,1225,141,775,284000,38066
727,604,123,669,121500,38067
3859,2804,1055,824,229800,38068
1209,881,328,733,119400,38069
61,61,0,-,157700,38070
1509,1006,503,827,112900,38075
314,276,38,969,201400,38076
0,0,0,-,-,38077
1285,607,678,399,127100,38079
895,422,473,538,90000,38080
7618,2628,4990,1499,375000,38103
12768,4790,7978,1002,288900,38104
3232,323,2909,889,77000,38105
9408,3562,5846,881,62800,38106
6441,2426,4015,943,110100,38107
6560,2744,3816,808,58800,38108
16718,9234,7484,959,72200,38109
17569,8237,9332,1002,149300,38111
6499,3368,3131,897,179100,38112
0,0,0,-,-,38113
10025,4488,5537,854,68500,38114
16236,3697,12539,1041,117400,38115
15239,6932,8307,954,115400,38116
11501,8979,2522,1249,263100,38117
13157,5053,8104,1081,90400,38118
9778,5837,3941,1252,255000,38119
6234,4624,1610,1475,424800,38120
9001,4813,4188,1085,94200,38122
15420,8577,6843,1310,205800,38125
2570,311,2259,754,63500,38126
13984,6310,7674,1037,76600,38127
15818,6610,9208,1069,111100,38128
0,0,0,-,-,38131
0,0,0,-,-,38132
7840,5499,2341,1349,214600,38133
14625,7138,7487,1106,167800,38134
10806,8826,1980,1517,234000,38135
10069,8202,1867,1633,366300,38138
5826,5655,171,2042,495000,38139
7943,5419,2524,1355,136000,38141
0,0,0,-,-,38152
3687,2599,1088,645,153400,38201
812,705,107,702,90800,38220
1313,994,319,645,104300,38221
916,793,123,726,159900,38222
304,251,53,617,146300,38224
2324,1568,756,755,105300,38225
101,101,0,-,83400,38226
1012,775,237,652,106000,38229
1651,1319,332,694,91700,38230
718,554,164,706,86700,38231
873,659,214,643,84400,38232
1093,810,283,666,84300,38233
85,57,28,825,86300,38235
412,308,104,-,104800,38236
6007,3332,2675,745,171000,38237
828,566,262,850,96500,38240
329,253,76,539,108800,38241
7888,5523,2365,737,148500,38242
1295,1116,179,649,117400,38251
350,242,108,1034,203200,38253
0,0,0,-,-,38254
1035,726,309,617,98400,38255
1480,1231,249,949,148000,38256
1853,1293,560,752,112900,38257
584,432,152,717,92800,38258
280,226,54,742,84700,38259
1556,1216,340,758,110900,38260
6550,3910,2640,726,136900,38261
13366,6545,6821,900,109700,38301
20728,13436,7292,1118,203500,38305
2347,1807,540,729,128900,38310
406,368,38,-,168200,38311
1449,1380,69,-,168200,38313
1485,1308,177,734,116900,38315
1170,960,210,660,116700,38316
1099,862,237,695,108800,38317
180,155,25,-,109500,38318
4399,3109,1290,798,115600,38320
1151,901,250,656,102900,38321
1369,1208,161,923,163000,38326
228,204,24,768,138600,38327
354,335,19,-,135000,38328
1162,945,217,765,126400,38329
1508,1020,488,761,107800,38330
498,453,45,584,134500,38332
113,82,31,-,94200,38333
668,602,66,623,131600,38334
513,393,120,886,139600,38337
29,18,11,1021,134400,38338
209,121,88,720,115700,38339
4067,2952,1115,718,129400,38340
1009,897,112,668,112800,38341
591,427,164,561,100100,38342
6551,4253,2298,763,134600,38343
3224,2332,892,879,128200,38344
518,381,137,876,159400,38345
138,129,9,-,163400,38347
358,290,68,687,95700,38348
6848,4574,2274,759,147400,38351
301,178,123,-,184900,38352
3023,2405,618,1005,239500,38355
1139,834,305,644,159200,38356
1188,1015,173,834,144000,38357
4582,2910,1672,723,140400,38358
137,121,16,-,102900,38359
453,413,40,-,138800,38361
433,287,146,1180,139200,38362
2089,1520,569,701,113300,38363
0,0,0,-,-,38365
969,854,115,-,118500,38366
1084,870,214,733,131100,38367
824,633,191,565,156100,38368
699,571,128,677,89800,38369
408,342,66,741,105600,38370
432,351,81,755,110600,38371
6866,4830,2036,724,146500,38372
838,608,230,629,119200,38374
3297,2544,753,662,116000,38375
129,79,50,-,77200,38376
553,406,147,915,144600,38379
173,160,13,-,144200,38380
603,437,166,806,101600,38381
3521,2127,1394,691,111700,38382
190,160,30,-,137500,38387
496,414,82,624,128300,38388
18,17,1,-,76900,38389
418,366,52,827,104800,38390
552,423,129,1063,101300,38391
271,239,32,-,-,38392
25448,18445,7003,1060,260900,38401
717,525,192,742,118900,38425
1238,1031,207,906,161400,38449
1162,911,251,586,79900,38450
1614,1380,234,916,212600,38451
341,316,25,-,135000,38452
134,91,43,-,368200,38453
413,340,73,-,117000,38454
48,47,1,-,138800,38455
1408,1256,152,544,206500,38456
205,153,52,-,158100,38457
165,141,24,-,266800,38459
708,669,39,703,179600,38460
484,422,62,1328,272700,38461
4137,3279,858,822,130900,38462
1105,1039,66,577,146000,38463
9287,6518,2769,731,153100,38464
1973,1559,414,908,166200,38468
1649,1442,207,663,139500,38469
92,71,21,-,164800,38471
886,752,134,679,197900,38472
360,258,102,968,219000,38473
3195,2299,896,685,209100,38474
251,214,37,-,119900,38475
300,276,24,-,225000,38476
1055,903,152,825,142400,38477
7020,4677,2343,808,172600,38478
380,303,77,576,115400,38481
681,642,39,-,323800,38482
2187,1616,571,707,168100,38483
2459,1859,600,599,122700,38485
511,348,163,-,113200,38486
331,295,36,-,303800,38487
896,773,123,788,260200,38488
17269,8669,8600,828,221200,38501
0,0,0,-,-,38503
252,252,0,-,-,38504
0,0,0,-,-,38505
12343,8822,3521,921,228000,38506
744,608,136,1029,206000,38541
0,0,0,-,-,38542
164,136,28,-,220000,38543
2695,2214,481,783,196800,38544
626,483,143,772,93900,38545
713,693,20,-,210400,38547
428,402,26,822,211200,38548
1724,1338,386,714,139200,38549
0,0,0,-,-,38550
1665,1188,477,530,122300,38551
85,67,18,564,237500,38552
1054,803,251,885,170600,38553
368,265,103,-,126600,38554
9222,5828,3394,758,203700,38555
5193,3814,1379,602,128400,38556
4804,4258,546,1250,283000,38558
534,433,101,853,140300,38559
432,306,126,828,177600,38560
2551,2089,462,733,127700,38562
945,681,264,764,222300,38563
244,176,68,-,159100,38564
375,354,21,-,177300,38565
353,241,112,580,259600,38567
735,652,83,-,170500,38568
128,104,24,-,300000,38569
4046,3170,876,779,141200,38570
5829,4871,958,814,173600,38571
4882,4454,428,833,171000,38572
795,673,122,837,157100,38573
3291,2487,804,753,165200,38574
365,301,64,-,140000,38575
532,443,89,905,108600,38577
92,68,24,675,143100,38578
505,436,69,879,154800,38579
549,466,83,629,197000,38580
1663,1309,354,814,119200,38581
750,711,39,573,239700,38582
9913,7461,2452,843,172000,38583
1737,1325,412,658,126200,38585
513,451,62,1526,133500,38587
406,315,91,611,120400,38588
109,105,4,-,-,38589
763,650,113,825,224600,38601
1194,1077,117,790,113800,38603
5700,4228,1472,884,154000,38606
933,704,229,844,88100,38610
6271,4868,1403,1074,174900,38611
6422,3313,3109,745,86500,38614
342,137,205,243,62800,38617
4591,3584,1007,874,142300,38618
2120,1292,828,606,79000,38619
1090,961,129,855,99300,38620
674,359,315,779,87700,38621
261,164,97,413,48500,38622
91,46,45,-,27500,38623
612,355,257,845,90300,38625
467,412,55,-,304900,38626
604,588,16,-,150400,38627
625,554,71,700,132900,38629
510,266,244,456,71500,38631
10765,9320,1445,1045,267900,38632
1046,752,294,688,90000,38633
5287,4032,1255,850,149400,38635
9998,5882,4116,1251,146300,38637
195,111,84,514,44200,38639
791,748,43,-,169700,38641
771,603,168,618,117900,38642
685,287,398,575,53600,38643
14,12,2,-,-,38644
410,226,184,587,95000,38645
1091,758,333,741,86200,38646
341,214,127,-,80000,38647
1610,1186,424,903,164200,38650
2999,2785,214,-,267400,38651
5960,4191,1769,860,146600,38652
20647,17312,3335,1486,261900,38654
16455,10049,6406,1099,251200,38655
925,782,143,970,110000,38658
863,698,165,903,82600,38659
694,668,26,-,183800,38661
4643,3397,1246,673,131200,38663
1175,131,1044,953,164500,38664
1114,722,392,884,142800,38665
2398,1529,869,740,82900,38666
4866,3488,1378,873,198700,38668
457,349,108,755,46800,38670
14155,8601,5554,1207,157400,38671
5307,4989,318,2112,268300,38672
463,459,4,1125,267300,38673
500,457,43,-,62800,38674
1995,1026,969,838,148700,38676
0,0,0,-,-,38677
2527,1582,945,1104,173900,38680
1511,1066,445,621,98600,38683
562,500,62,-,203800,38685
8670,4811,3859,743,107700,38701
4333,2267,2066,892,78000,38703
281,225,56,-,57500,38720
378,241,137,657,79600,38721
103,57,46,421,68300,38722
21,21,0,-,-,38723
337,240,97,677,66500,38725
156,124,32,750,82300,38726
623,341,282,749,113400,38730
9,0,9,-,-,38731
6197,3757,2440,794,159900,38732
0,0,0,-,-,38733
120,112,8,725,129700,38736
1161,563,598,609,77000,38737
27,10,17,-,-,38738
145,128,17,794,-,38740
227,181,46,-,88600,38744
38,8,30,-,-,38745
202,108,94,-,84500,38746
1020,623,397,672,81100,38748
3840,2110,1730,754,115200,38751
522,320,202,743,138300,38753
528,350,178,665,99100,38754
2633,1842,791,634,103900,38756
535,395,140,631,133000,38759
326,224,102,588,75000,38760
591,372,219,693,61300,38761
844,370,474,653,80000,38762
141,113,28,385,132000,38764
42,4,38,-,-,38765
37,37,0,-,-,38767
26,17,9,-,-,38768
771,402,369,340,80000,38769
775,373,402,590,91800,38771
34,34,0,-,187500,38772
1204,774,430,760,88100,38773
775,445,330,638,84800,38774
0,0,0,-,-,38776
576,272,304,391,86600,38778
79,20,59,326,125000,38781
11748,7374,4374,919,168200,38801
6703,4209,2494,855,183400,38804
4992,3759,1233,751,153300,38821
3150,2539,611,676,96900,38824
2268,1422,846,955,213000,38826
1568,934,634,728,137800,38827
1524,1137,387,800,115100,38828
6687,5110,1577,657,118200,38829
885,608,277,543,128300,38833
11238,6986,4252,699,134100,38834
406,406,0,-,-,38838
17,10,7,-,-,38839
1331,1028,303,764,107600,38841
4221,3226,995,784,132500,38843
112,112,0,-,-,38844
806,699,107,628,110200,38846
1540,1210,330,611,68000,38847
347,347,0,-,115200,38848
1836,1472,364,835,157200,38849
1056,857,199,619,76300,38850
3773,2572,1201,754,98300,38851
3942,3035,907,538,129200,38852
2059,1650,409,763,125700,38855
617,555,62,858,102600,38856
1400,1168,232,659,179100,38857
2236,1547,689,813,99800,38858
221,215,6,-,88400,38859
2237,1469,768,601,94400,38860
935,729,206,822,113700,38862
6932,4830,2102,814,139600,38863
651,573,78,-,135900,38864
1887,1560,327,822,87500,38865
4649,3838,811,835,208500,38866
1996,1479,517,747,112200,38868
122,68,54,725,218200,38869
1027,894,133,810,98100,38870
828,701,127,796,126400,38871
1230,1021,209,560,106400,38873
482,430,52,710,93800,38876
1048,835,213,603,71800,38878
42,42,0,-,68200,38879
7331,4812,2519,767,142000,38901
173,154,19,-,153300,38913
274,207,67,743,66500,38914
1660,1140,520,568,94300,38915
1845,1197,648,631,71700,38916
1243,946,297,855,102100,38917
312,249,63,-,60400,38920
1709,1058,651,631,101500,38921
1241,963,278,580,84100,38922
352,311,41,-,128600,38923
171,122,49,936,61900,38924
735,633,102,738,94300,38925
488,420,68,784,80900,38927
109,21,88,708,-,38928
731,556,175,804,97400,38929
8338,4786,3552,667,101300,38930
588,503,85,-,106900,38940
1176,493,683,711,83500,38941
218,207,11,-,34400,38943
77,34,43,781,90600,38944
67,44,23,775,-,38946
20,20,0,-,245000,38947
947,588,359,878,67200,38948
156,156,0,-,183300,38949
187,187,0,-,64800,38950
359,277,82,942,57300,38951
154,109,45,-,130600,38952
135,135,0,-,89700,38953
344,255,89,-,64500,38954
218,77,141,1030,145800,38957
232,188,44,-,101800,38961
0,0,0,-,-,38962
947,523,424,826,80300,38963
20,8,12,-,-,38964
3483,2544,939,782,109200,38965
250,122,128,593,80300,38966
2614,1580,1034,648,112900,38967
2039,1129,910,672,75900,39038
1131,959,172,826,147300,39039
1302,826,476,930,155300,39040
1393,1046,347,613,152500,39041
14205,11836,2369,1056,230100,39042
1097,1037,60,1316,125300,39044
632,566,66,893,-,39045
11291,6991,4300,815,197900,39046
15317,13060,2257,1514,247200,39047
5472,4261,1211,743,97400,39051
102,69,33,1113,-,39054
10226,7158,3068,1179,204800,39056
870,812,58,-,121000,39057
0,0,0,-,-,39058
4476,3560,916,715,97700,39059
0,0,0,-,-,39061
174,134,40,598,87100,39062
1113,709,404,538,56900,39063
1910,1581,329,825,140300,39066
376,322,54,638,86400,39067
1536,976,560,423,72000,39069
2544,1862,682,546,255300,39071
7871,6608,1263,985,171100,39073
4954,3439,1515,671,77100,39074
287,192,95,282,120300,39078
356,129,227,362,94600,39079
388,344,44,-,93200,39082
3074,2110,964,560,86300,39083
492,330,162,-,34600,39086
11,11,0,-,-,39088
4569,3123,1446,700,113400,39090
1220,1045,175,558,47600,39092
1578,1335,243,841,96200,39094
2262,1527,735,636,92600,39095
539,414,125,-,93000,39096
173,84,89,832,55500,39097
680,569,111,743,58500,39108
16745,15676,1069,2014,317200,39110
3195,2402,793,802,113100,39111
125,33,92,273,92900,39113
3668,3054,614,829,110800,39114
43,43,0,-,55800,39115
929,833,96,904,123700,39116
3257,2464,793,830,93200,39117
2067,1707,360,689,95900,39119
11753,7668,4085,695,99000,39120
922,813,109,892,104300,39140
263,226,37,-,81300,39144
2124,1822,302,895,131300,39145
1091,808,283,571,67500,39146
0,0,0,-,-,39148
530,450,80,-,92500,39149
1801,1372,429,546,79100,39150
377,354,23,-,-,39152
1006,832,174,584,108300,39153
3267,2845,422,1009,214100,39154
302,279,23,-,54800,39156
10559,5140,5419,1186,241100,39157
988,571,417,584,91300,39159
900,790,110,546,89400,39160
66,65,1,-,163200,39162
200,145,55,379,118200,39166
0,0,0,-,-,39167
2402,1948,454,683,94300,39168
1021,506,515,608,52600,39169
3625,3278,347,879,210800,39170
0,0,0,-,-,39173
61,0,61,-,-,39174
1460,1194,266,900,96300,39175
1071,872,199,353,87300,39176
46,34,12,-,138200,39177
457,329,128,945,-,39179
11493,8196,3297,899,140300,39180
5028,3599,1429,839,163500,39183
1240,916,324,728,86600,39189
2623,2153,470,792,105900,39191
501,441,60,-,76100,39192
17,0,17,-,-,39193
5788,2874,2914,812,96700,39194
581,15,566,1342,-,39201
3452,1053,2399,870,203900,39202
1914,588,1326,710,54900,39203
5789,1966,3823,853,65700,39204
9860,4722,5138,1032,117100,39206
12295,7759,4536,1099,157600,39208
10018,4665,5353,928,69700,39209
0,0,0,-,-,39210
9924,6322,3602,1179,190300,39211
11048,7049,3999,1101,102200,39212
8320,3871,4449,742,68000,39213
1570,634,936,1116,243400,39216
50,0,50,-,-,39217
2854,1894,960,1065,122800,39218
3775,1878,1897,1400,248900,39232
0,0,0,-,-,39269
5302,3890,1412,1334,161200,39272
9113,5394,3719,860,103200,39301
8350,5633,2717,1043,186700,39305
6010,3006,3004,752,77800,39307
0,0,0,-,-,39309
590,500,90,-,-,39320
662,543,119,-,56000,39322
594,515,79,1107,79700,39323
0,0,0,-,-,39324
2093,1891,202,928,164800,39325
110,110,0,-,-,39326
1560,1156,404,738,141700,39327
1781,1311,470,362,87200,39328
1140,1026,114,866,126800,39330
635,509,126,799,121000,39332
864,668,196,1060,166500,39335
401,348,53,-,56800,39336
688,569,119,1051,85700,39337
1283,1187,96,613,98700,39338
5770,4019,1751,598,118300,39339
2294,1658,636,582,90400,39341
692,333,359,1030,180300,39342
2185,1573,612,547,89200,39345
960,751,209,760,93600,39346
538,446,92,405,169300,39347
102,102,0,-,-,39348
8198,5920,2278,738,93100,39350
202,157,45,-,86900,39352
739,617,122,835,96600,39354
2691,2259,432,861,106300,39355
240,201,39,-,-,39356
281,167,114,506,59100,39358
94,49,45,733,114600,39359
1279,1180,99,700,50800,39360
619,575,44,434,74500,39361
1293,990,303,-,90400,39362
508,344,164,727,56100,39363
1339,1046,293,927,150800,39364
2955,2231,724,600,95700,39365
435,410,25,-,75900,39366
5502,4812,690,724,95300,39367
17224,7004,10220,889,115300,39401
17250,10204,7046,1126,236100,39402
0,0,0,-,-,39406
1058,983,75,810,92400,39421
1907,1571,336,649,84700,39422
1167,1036,131,345,119300,39423
813,757,56,778,206900,39425
6843,5996,847,971,198900,39426
479,445,34,619,90500,39427
3419,2443,976,743,81200,39428
6111,4777,1334,494,110300,39429
4346,3375,971,772,164600,39437
1776,1552,224,860,110600,39439
7605,4583,3022,799,111400,39440
8383,6759,1624,783,123300,39443
1363,907,456,740,108200,39451
10490,8636,1854,800,153300,39452
3373,2819,554,672,98300,39455
223,216,7,694,136400,39456
1379,1091,288,373,106200,39459
254,159,95,-,-,39461
443,327,116,675,190800,39462
998,863,135,734,111600,39464
8123,6312,1811,886,156100,39465
10826,7927,2899,878,157400,39466
4357,3764,593,902,164000,39470
2387,1766,621,650,84900,39474
5388,4102,1286,964,167800,39475
2330,1933,397,725,124900,39476
249,223,26,764,98200,39477
816,700,116,-,118300,39478
2197,1723,474,543,82800,39479
826,726,100,788,154300,39480
557,433,124,949,174800,39481
4206,3673,533,865,174300,39482
2038,1620,418,801,87400,39483
9099,3383,5716,887,98500,39501
19852,13244,6608,1068,179000,39503
7496,3836,3660,1048,212100,39507
6712,5034,1678,981,200600,39520
4087,3660,427,1369,220900,39525
0,0,0,-,-,39529
3756,1762,1994,791,151500,39530
7810,3124,4686,1031,189400,39531
13681,8423,5258,1054,217600,39532
0,0,0,-,-,39534
5068,2872,2196,1102,168800,39540
6741,4919,1822,924,143400,39553
2719,2438,281,1080,145000,39556
7301,4833,2468,1130,192800,39560
603,560,43,-,166700,39561
6741,5660,1081,925,138700,39562
4615,3461,1154,1029,104700,39563
16953,12073,4880,1199,202700,39564
7101,6158,943,1062,195800,39565
3908,2522,1386,923,133500,39567
5344,4435,909,1012,214800,39571
559,559,0,-,114100,39572
3358,2956,402,649,190300,39573
4649,3999,650,1063,184400,39574
2730,1774,956,909,206900,39576
3899,2672,1227,780,129800,39577
4694,1879,2815,845,126600,39581
0,0,0,-,-,39595
8869,6344,2525,714,123400,39601
2544,2058,486,734,134900,39629
438,224,214,650,71000,39630
1675,1269,406,496,58300,39631
313,244,69,613,46600,39633
45,0,45,-,-,39635
1367,1025,342,628,102300,39638
1899,1598,301,820,114100,39641
406,330,76,-,107300,39643
2168,1732,436,758,78800,39645
215,204,11,-,200000,39647
7960,4337,3623,836,109400,39648
3253,2581,672,769,83200,39652
1048,756,292,-,102500,39653
1931,1424,507,734,114100,39654
256,213,43,-,139500,39656
673,527,146,659,92900,39657
945,786,159,1065,82600,39661
521,502,19,-,88800,39662
967,766,201,783,95800,39663
821,666,155,806,101300,39664
440,353,87,-,56600,39665
3746,3008,738,783,159700,39666
4281,3471,810,668,121300,39667
424,392,32,-,93900,39668
1838,1702,136,-,84700,39669
5320,2539,2781,802,135500,39701
8473,5519,2954,860,134800,39702
5186,3155,2031,1074,220800,39705
4117,2890,1227,682,87900,39730
1509,967,542,759,134100,39735
162,95,67,386,108100,39736
132,79,53,-,163500,39737
795,538,257,703,72100,39739
2027,1534,493,699,157700,39740
622,476,146,596,90900,39741
784,719,65,757,80800,39743
2438,1908,530,612,96800,39744
349,251,98,-,122300,39745
1199,953,246,765,106900,39746
720,553,167,627,91900,39747
1411,1054,357,492,106300,39750
599,487,112,601,92600,39751
964,799,165,603,112700,39752
0,0,0,-,-,39753
293,221,72,-,98100,39755
555,537,18,-,82400,39756
19508,8826,10682,890,225500,39759
0,0,0,-,-,39762
1178,885,293,1002,140600,39766
309,253,56,-,-,39767
647,472,175,741,168900,39769
53,44,9,-,95000,39771
876,772,104,536,87900,39772
6069,3934,2135,736,123900,39773
504,348,156,857,81400,39776
803,533,270,721,99900,39813
527,386,141,884,66200,39815
3774,2218,1556,788,149600,39817
4475,2493,1982,796,157400,39819
3170,2073,1097,834,135400,39823
210,177,33,577,55800,39824
722,506,216,974,136100,39825
275,202,73,575,85000,39826
1894,1181,713,862,158900,39827
5285,3169,2116,788,136700,39828
3,3,0,-,-,39832
721,589,132,753,94100,39834
171,108,63,-,-,39836
2576,1736,840,666,117000,39837
1916,826,1090,536,73900,39840
303,268,35,439,81800,39841
2733,1474,1259,711,93800,39842
3302,2341,961,825,109700,39845
563,382,181,694,68800,39846
805,476,329,378,76700,39851
1026,864,162,740,86500,39854
346,317,29,671,110900,39859
434,325,109,752,96700,39861
386,304,82,752,94000,39862
170,115,55,-,84800,39866
116,93,23,-,108200,39867
720,495,225,582,128600,39870
178,142,36,808,85000,39877
9,8,1,-,-,39885
443,264,179,643,94500,39886
1427,1098,329,675,122200,39897
692,579,113,1088,269800,40003
12276,8778,3498,924,197200,40004
1871,1527,344,645,149700,40006
18,18,0,-,-,40007
1480,1198,282,941,203100,40008
578,523,55,635,72000,40009
158,133,25,-,448500,40010
935,746,189,849,142800,40011
228,162,66,932,-,40012
2372,2255,117,922,238200,40013
7588,6707,881,1152,368600,40014
1481,951,530,776,174900,40019
126,114,12,550,-,40020
279,253,26,-,391700,40022
2263,2174,89,1051,418600,40023
220,208,12,-,1122200,40025
1988,1858,130,-,405100,40026
7949,6257,1692,1076,293400,40031
4876,3256,1620,696,145800,40033
98,91,7,-,65600,40036
1117,1017,100,682,183900,40037
258,188,70,1125,79500,40040
297,57,240,1071,447600,40041
1282,1120,162,862,151000,40045
482,453,29,-,212700,40046
8539,7570,969,857,237100,40047
0,0,0,-,-,40049
754,569,185,728,129400,40050
1685,1348,337,786,168400,40051
189,167,22,-,105300,40052
803,663,140,1107,215500,40055
1210,1133,77,1272,282300,40056
1515,1159,356,1096,159200,40057
27,27,0,-,110600,40058
8082,7252,830,1857,511400,40059
519,415,104,566,153400,40060
0,0,0,-,-,40061
33,9,24,1269,-,40062
0,0,0,-,-,40063
11983,8141,3842,944,234300,40065
2315,1919,396,817,300800,40067
966,772,194,1061,254500,40068
3131,2487,644,718,168000,40069
138,79,59,884,-,40070
5689,4829,860,912,285500,40071
387,327,60,688,137900,40075
1058,824,234,1023,199400,40076
258,174,84,854,199300,40077
973,775,198,1029,131900,40078
368,348,20,-,97300,40104
830,684,146,719,205800,40107
4454,3523,931,790,209600,40108
832,796,36,-,222000,40109
181,95,86,-,171500,40110
689,509,180,325,96700,40111
221,194,27,-,-,40115
813,699,114,1106,183900,40117
4079,2706,1373,1042,138500,40118
776,720,56,-,123900,40119
2288,15,2273,1178,-,40121
295,245,50,909,53200,40140
834,609,225,951,149500,40142
2315,1727,588,711,141700,40143
534,534,0,-,179000,40144
236,191,45,-,96900,40145
1397,1096,301,763,117900,40146
1866,1498,368,832,153300,40150
316,316,0,-,167700,40152
477,248,229,842,67600,40155
367,329,38,-,230800,40157
9113,4814,4299,855,150000,40160
79,50,29,-,235300,40161
1997,1882,115,1045,216700,40162
14305,11442,2863,919,223500,40165
197,177,20,-,287500,40170
106,63,43,-,81400,40171
5554,4326,1228,1217,191900,40175
324,270,54,-,87400,40176
667,494,173,630,119400,40177
225,225,0,-,125800,40178
3147,293,2854,676,334400,40202
9162,2066,7096,777,158000,40203
7678,3804,3874,1173,289100,40204
10529,7883,2646,1071,342000,40205
10522,5554,4968,1062,263000,40206
13715,9571,4144,1201,385700,40207
5130,1451,3679,871,124300,40208
266,143,123,875,129900,40209
5682,2111,3571,829,88200,40210
9028,3527,5501,896,91100,40211
6554,3319,3235,816,82600,40212
7084,4567,2517,940,164000,40213
18417,10131,8286,922,169700,40214
7823,3321,4502,920,97500,40215
17418,11157,6261,852,145200,40216
6198,3731,2467,1146,208300,40217
13673,6851,6822,995,175100,40218
15815,8335,7480,915,167700,40219
15469,9754,5715,1178,231700,40220
0,0,0,-,-,40221
10165,5650,4515,1239,326600,40222
10195,7436,2759,1369,327100,40223
7182,5674,1508,1343,210500,40228
14888,10810,4078,1251,179800,40229
0,0,0,-,-,40231
13146,9329,3817,1389,334400,40241
4842,3335,1507,1212,277000,40242
5445,3657,1788,1317,288100,40243
14304,11191,3113,1441,418000,40245
10487,7269,3218,1051,157800,40258
14616,10674,3942,1165,163400,40272
6,0,6,-,-,40280
16149,12502,3647,1099,238600,40291
16680,12608,4072,1211,259400,40299
220,170,50,825,97800,40310
2635,1867,768,663,118500,40311
2350,1550,800,687,125900,40312
1006,664,342,943,98600,40313
143,112,31,-,108600,40316
1231,881,350,635,115800,40322
19091,13618,5473,1098,239700,40324
406,357,49,628,83000,40328
8369,6169,2200,717,179400,40330
21,21,0,-,-,40334
5091,3731,1360,656,104700,40336
1834,1465,369,814,96100,40337
41,35,6,-,110400,40339
8996,7082,1914,841,197400,40342
235,188,47,702,96900,40346
1373,1035,338,885,328400,40347
342,140,202,651,129500,40348
58,58,0,-,-,40350
8216,5010,3206,739,153800,40351
8789,5537,3252,770,158100,40353
125,53,72,-,-,40355
16516,11533,4983,987,225800,40356
47,4,43,820,-,40357
373,308,65,-,138900,40358
2571,2177,394,598,151700,40359
2778,1781,997,558,104000,40360
7168,4651,2517,785,192500,40361
16,16,0,-,-,40363
1061,896,165,1131,258900,40370
1134,957,177,667,85800,40371
826,690,136,630,204900,40372
758,607,151,613,95600,40374
23,23,0,-,-,40376
1581,1384,197,1045,201500,40379
2315,1629,686,701,122100,40380
9464,6786,2678,939,264800,40383
887,698,189,536,158200,40385
708,549,159,567,98200,40387
2412,1467,945,870,220000,40390
14621,10467,4154,859,182700,40391
852,673,179,843,85300,40402
9966,6798,3168,785,175000,40403
0,0,0,-,-,40404
1416,931,485,679,106000,40409
1613,1217,396,583,118800,40419
9502,6112,3390,770,197900,40422
0,0,0,-,-,40434
1914,1596,318,664,114100,40437
1041,903,138,705,123300,40440
331,327,4,-,117500,40442
5392,4376,1016,830,173800,40444
314,263,51,333,82000,40445
3288,2514,774,585,98800,40447
0,0,0,-,-,40448
3583,2669,914,697,115700,40456
401,360,41,-,63800,40460
927,728,199,858,157300,40461
421,359,62,-,110100,40464
807,662,145,896,136100,40468
627,486,141,773,84500,40472
25702,15054,10648,839,215200,40475
96,80,16,-,108300,40481
5069,3875,1194,672,142100,40484
961,835,126,-,109500,40486
1553,1414,139,760,102700,40489
13121,7690,5431,1047,453400,40502
12524,7920,4604,1071,259700,40503
11930,3878,8052,859,195700,40504
11035,6750,4285,933,153100,40505
1370,413,957,786,346600,40507
10401,2863,7538,892,148800,40508
18504,11494,7010,1235,317500,40509
439,343,96,738,716300,40510
13338,8430,4908,1152,215100,40511
4426,3331,1095,1364,421300,40513
6420,4653,1767,1441,273700,40514
14965,9154,5811,1176,287600,40515
1058,903,155,1071,214400,40516
16894,6364,10530,1048,171100,40517
0,0,0,-,-,40526
0,0,0,-,-,40536
22691,14412,8279,901,185000,40601
11411,7733,3678,703,153200,40701
2189,1825,364,811,91100,40729
1204,967,237,614,105800,40734
599,511,88,764,134900,40737
1321,743,578,736,119000,40740
9204,6400,2804,784,158900,40741
6994,5069,1925,794,150500,40744
849,755,94,664,84300,40759
200,155,45,826,52600,40763
6158,3920,2238,690,81800,40769
619,232,387,-,84200,40771
0,0,0,-,-,40801
22,22,0,-,-,40803
755,520,235,658,121800,40806
232,201,31,644,55600,40807
2,2,0,-,-,40808
528,433,95,489,60300,40810
122,67,55,493,93500,40813
304,208,96,-,63500,40815
0,0,0,-,-,40816
49,49,0,-,-,40818
394,357,37,-,87700,40819
128,128,0,-,37000,40820
1418,821,597,532,68900,40823
280,130,150,682,43700,40824
204,166,38,-,65000,40826
300,240,60,-,85500,40827
1616,1238,378,826,56200,40828
24,11,13,-,-,40829
97,97,0,-,52400,40830
2055,1077,978,509,112900,40831
139,139,0,-,71300,40840
24,24,0,-,17900,40843
39,39,0,-,-,40844
248,180,68,826,-,40845
35,18,17,-,-,40847
10,4,6,-,-,40849
435,235,200,599,68800,40854
336,225,111,597,52600,40855
306,236,70,-,51900,40856
68,68,0,-,-,40858
228,165,63,638,76100,40862
227,183,44,-,72500,40863
141,129,12,-,67100,40865
328,244,84,-,92200,40868
240,211,29,652,113000,40870
900,727,173,753,92000,40873
65,50,15,-,72200,40874
220,170,50,633,106500,40902
292,237,55,-,55200,40903
4608,2664,1944,669,121000,40906
123,59,64,-,34200,40913
247,139,108,-,55800,40914
275,121,154,-,-,40915
73,45,28,850,-,40921
221,177,44,-,99300,40923
275,222,53,621,63800,40927
779,473,306,687,-,40935
51,51,0,-,-,40939
149,126,23,-,81000,40940
60,27,33,-,-,40941
251,185,66,-,-,40943
15,9,6,-,-,40946
138,112,26,-,77500,40949
153,102,51,-,-,40953
192,145,47,-,-,40958
6147,4665,1482,644,79900,40962
23,0,23,598,-,40964
4906,2829,2077,611,82700,40965
537,411,126,585,53700,40972
3187,2113,1074,588,71900,40977
0,0,0,-,-,40979
0,0,0,-,-,40981
100,80,20,-,-,40982
72,47,25,-,-,40983
130,130,0,-,65600,40988
22,22,0,-,-,40995
143,90,53,532,47300,40997
7105,6293,812,1026,250300,41001
1035,769,266,644,114800,41002
948,764,184,667,148800,41003
1332,1114,218,779,105900,41004
8666,7093,1573,1282,230200,41005
1429,1070,359,834,172800,41006
1634,1575,59,1156,285800,41007
2813,1734,1079,803,136400,41008
1251,1073,178,880,160800,41010
12584,5662,6922,906,245100,41011
3061,1614,1447,898,130400,41014
8253,6008,2245,865,162900,41015
2607,1937,670,912,153100,41016
15967,12177,3790,941,254800,41017
11292,7313,3979,1038,162200,41018
2016,1467,549,872,252000,41030
6419,4479,1940,704,177200,41031
622,586,36,691,229500,41033
430,385,45,666,76800,41034
4371,3079,1292,827,172300,41035
1045,842,203,796,114700,41039
2866,2015,851,885,123000,41040
2961,1971,990,652,104300,41041
22447,14521,7926,1157,192400,41042
556,486,70,780,173500,41043
446,347,99,1008,143100,41044
503,377,126,854,157300,41045
513,398,115,1058,162500,41046
5319,4659,660,1337,288200,41048
864,744,120,771,124100,41049
11123,9520,1603,1209,223900,41051
117,97,20,-,139200,41052
713,603,110,-,192900,41055
5493,3539,1954,698,153000,41056
1264,1060,204,678,192300,41059
1033,934,99,609,178900,41063
754,574,180,658,154400,41064
9543,5074,4469,931,171100,41071
2716,1749,967,952,176100,41073
2531,1621,910,937,131400,41074
6583,4757,1826,1029,271900,41075
6929,5263,1666,1043,193800,41076
610,589,21,-,211900,41080
563,487,76,939,126400,41083
349,228,121,722,104900,41085
825,665,160,848,123400,41086
7865,7273,592,1609,336300,41091
1128,976,152,931,206700,41092
1008,826,182,827,90300,41093
5020,4022,998,1083,246600,41094
1394,769,625,739,143000,41095
2489,1881,608,799,167900,41097
538,460,78,913,64900,41098
7563,4593,2970,828,114700,41101
7623,5597,2026,806,157600,41102
682,643,39,-,132100,41121
425,279,146,710,56400,41124
3638,2865,773,663,142500,41129
180,128,52,-,83300,41132
122,89,33,-,85900,41135
3354,2592,762,917,107000,41139
837,675,162,953,64000,41141
31,31,0,-,-,41142
4784,3665,1119,648,137500,41143
3666,3014,652,820,127500,41144
186,169,17,-,-,41146
115,95,20,-,159500,41149
168,133,35,625,-,41159
4657,3902,755,582,100200,41164
334,304,30,-,82000,41166
1162,988,174,855,135800,41168
2383,1779,604,777,171400,41169
1367,983,384,627,94300,41171
347,321,26,-,127900,41174
2228,1637,591,705,112100,41175
2599,2021,578,595,84900,41179
345,277,68,493,76300,41180
51,51,0,-,-,41181
761,487,274,865,114200,41183
792,609,183,884,96600,41189
105,59,46,-,-,41201
214,214,0,-,51300,41203
285,216,69,-,125000,41204
158,24,134,-,140000,41214
555,452,103,-,124300,41216
700,530,170,775,111300,41219
1062,915,147,915,151700,41222
1521,1282,239,680,99200,41224
100,49,51,-,126900,41226
4449,3373,1076,795,105800,41230
464,416,48,-,110000,41231
220,122,98,543,78500,41232
194,177,17,-,-,41234
265,151,114,863,130200,41238
2552,1349,1203,715,149300,41240
411,345,66,-,72000,41250
223,174,49,-,-,41254
248,178,70,-,56000,41255
778,641,137,876,201600,41256
252,130,122,764,151000,41257
279,213,66,-,-,41260
388,310,78,-,-,41262
93,64,29,-,113900,41263
212,195,17,-,107300,41264
442,358,84,721,163200,41265
369,165,204,-,95600,41267
401,387,14,-,135500,41268
77,41,36,-,126300,41271
252,116,136,621,118100,41274
2163,1464,699,455,68200,41301
0,0,0,-,-,41310
2309,1507,802,567,79400,41311
1509,990,519,-,77300,41314
235,206,29,-,31100,41317
390,356,34,-,75000,41332
4270,3103,1167,499,64400,41339
465,307,158,463,-,41348
10,10,0,-,-,41351
223,210,13,-,68100,41352
162,121,41,-,-,41360
51,51,0,-,"10,000-",41364
257,174,83,-,48600,41365
22,7,15,-,-,41366
144,144,0,-,-,41367
246,202,44,-,54600,41385
7,7,0,-,-,41386
40,40,0,-,170800,41390
72,72,0,-,-,41397
208,178,30,-,57800,41408
131,121,10,-,-,41421
487,424,63,1262,68700,41425
165,132,33,-,72600,41464
4159,3143,1016,625,84500,41465
3336,2459,877,664,98700,41472
9727,5931,3796,850,139600,41501
166,117,49,-,171800,41503
235,229,6,-,107500,41512
201,153,48,-,80400,41513
1158,897,261,639,85100,41514
25,25,0,-,-,41517
292,229,63,-,93700,41519
1992,1555,437,768,89400,41522
128,120,8,-,63100,41524
25,0,25,-,-,41526
293,287,6,-,160400,41527
105,85,20,-,72400,41528
376,273,103,591,94100,41531
96,90,6,-,-,41534
283,206,77,505,-,41535
1561,1108,453,536,69500,41537
143,116,27,-,152900,41538
677,569,108,700,60600,41539
83,49,34,-,126300,41540
245,155,90,-,-,41543
208,159,49,-,61300,41544
242,224,18,-,79300,41547
366,280,86,602,-,41548
737,716,21,-,95000,41553
324,324,0,-,96700,41554
377,356,21,-,57500,41555
835,756,79,883,152000,41557
332,219,113,658,94700,41558
161,150,11,-,158800,41559
99,82,17,-,148800,41560
917,668,249,-,84500,41562
118,110,8,-,119200,41563
245,240,5,-,77300,41564
176,115,61,-,94700,41566
26,18,8,-,-,41567
409,409,0,-,-,41568
187,169,18,-,-,41571
1408,1262,146,821,87300,41572
303,202,101,763,86900,41601
283,274,9,-,104200,41602
651,366,285,876,108800,41603
152,143,9,-,61000,41604
333,285,48,-,92600,41605
219,180,39,-,-,41606
133,133,0,-,-,41607
128,105,23,-,37300,41612
209,165,44,-,178500,41615
233,168,65,953,-,41616
181,110,71,1028,-,41619
73,52,21,-,-,41621
69,58,11,-,87300,41622
426,284,142,631,92200,41630
346,262,84,-,-,41631
207,126,81,-,79000,41632
1281,962,319,908,69900,41635
349,276,73,771,63600,41636
449,308,141,791,84400,41640
329,178,151,772,125600,41642
66,43,23,-,"10,000-",41643
371,295,76,831,97700,41645
466,436,30,-,66200,41647
951,662,289,519,79700,41649
184,109,75,-,80200,41650
60,10,50,835,-,41651
4486,2963,1523,710,119200,41653
455,214,241,-,68200,41655
315,269,46,-,-,41659
111,111,0,-,-,41660
96,25,71,-,81100,41663
219,161,58,585,-,41666
156,156,0,-,-,41667
274,196,78,540,46700,41669
6169,4159,2010,746,107500,41701
174,145,29,-,-,41712
0,0,0,-,-,41713
154,145,9,-,95300,41714
650,498,152,783,45300,41719
267,204,63,-,43000,41721
536,437,99,732,123100,41722
404,273,131,-,61100,41723
135,125,10,-,-,41725
615,559,56,581,68800,41727
10,10,0,-,-,41729
349,270,79,-,50500,41731
53,26,27,-,68900,41735
21,21,0,-,-,41739
271,236,35,-,137800,41740
159,128,31,-,-,41745
237,218,19,-,49500,41746
927,829,98,-,85600,41749
111,100,11,-,-,41751
246,237,9,-,-,41754
233,167,66,-,-,41759
175,175,0,-,98000,41760
88,10,78,-,-,41762
211,195,16,-,23100,41763
216,197,19,-,-,41764
186,186,0,-,92600,41766
161,133,28,-,-,41772
551,400,151,444,37000,41773
1028,900,128,-,68200,41774
107,107,0,-,-,41775
487,440,47,-,68900,41776
407,361,46,-,74600,41777
95,95,0,-,-,41778
310,281,29,-,53200,41804
105,58,47,-,-,41810
125,90,35,-,71900,41812
299,139,160,-,81400,41815
217,158,59,-,-,41817
130,115,15,-,63400,41819
82,82,0,-,104500,41821
799,564,235,569,78200,41822
411,292,119,-,95900,41824
93,93,0,-,-,41825
285,253,32,-,58900,41826
206,172,34,615,63800,41828
451,372,79,619,131900,41831
183,135,48,-,84600,41832
54,43,11,-,-,41833
150,55,95,-,-,41834
261,211,50,-,56900,41835
376,245,131,928,49900,41836
303,285,18,-,70500,41837
321,189,132,-,61900,41838
176,142,34,823,91300,41839
382,306,76,621,44400,41840
155,155,0,-,-,41843
491,236,255,530,60700,41844
162,162,0,-,-,41845
91,69,22,-,-,41847
0,0,0,-,-,41848
55,49,6,-,52100,41849
315,290,25,-,-,41855
2976,2083,893,622,102000,41858
114,101,13,491,52700,41859
147,125,22,-,33900,41861
375,275,100,587,58100,41862
12861,7973,4888,898,203900,42001
11312,7621,3691,730,153900,42003
835,816,19,681,155000,42020
562,420,142,782,87800,42021
34,34,0,-,-,42022
892,660,232,702,89700,42023
493,371,122,555,138100,42024
7839,6723,1116,750,160700,42025
774,644,130,983,166800,42027
218,200,18,-,81500,42028
2513,1724,789,744,141100,42029
1282,949,333,717,118800,42031
80,75,5,-,60600,42032
322,271,51,789,87800,42035
558,516,42,-,121000,42036
14,14,0,-,-,42037
2106,1621,485,711,168100,42038
604,448,156,530,157400,42039
364,336,28,-,116900,42040
1705,1122,583,644,89100,42041
1512,1362,150,813,225600,42044
799,592,207,804,95700,42045
64,6,58,-,-,42047
910,694,216,585,117500,42048
578,433,145,696,177500,42049
1104,767,337,552,77700,42050
871,769,102,920,148900,42051
1921,1535,386,857,146600,42053
535,369,166,1078,139800,42054
991,896,95,633,161000,42055
600,485,115,-,88400,42056
834,717,117,1118,107600,42058
8,8,0,-,-,42060
79,79,0,-,-,42061
3113,2445,668,675,106900,42064
9303,6507,2796,653,132700,42066
398,341,57,-,169800,42069
11738,6998,4740,777,177700,42071
467,325,142,-,89700,42076
703,592,111,644,85800,42078
536,440,96,764,204500,42079
834,723,111,950,144000,42081
816,790,26,-,150000,42082
206,181,25,-,-,42083
258,248,10,-,99700,42085
1521,1295,226,912,168600,42086
911,789,122,705,94700,42087
874,665,209,636,111500,42088
22699,10540,12159,894,170300,42101
9516,5807,3709,1051,281800,42103
16203,10138,6065,964,264500,42104
895,728,167,624,171000,42120
1907,1771,136,-,249400,42122
514,420,94,-,112500,42123
34,34,0,-,84100,42124
2914,1509,1405,673,154200,42127
2929,2152,777,606,91800,42129
65,65,0,-,190200,42130
50,50,0,-,271400,42131
535,350,185,696,125000,42133
7262,4694,2568,960,173800,42134
513,384,129,597,75900,42140
12542,8610,3932,795,157600,42141
92,92,0,-,147000,42151
32,27,5,-,118300,42153
222,222,0,-,79800,42154
149,149,0,-,187800,42156
154,120,34,572,124000,42157
690,442,248,1103,250000,42159
666,439,227,770,178300,42160
23,0,23,-,-,42163
6478,4919,1559,847,159000,42164
862,680,182,652,104300,42166
3400,2383,1017,617,122200,42167
538,404,134,1083,279500,42170
2612,2102,510,836,198500,42171
779,548,231,477,116200,42202
281,190,91,-,205200,42204
2155,1733,422,712,129100,42206
426,306,120,667,107000,42207
1803,1430,373,592,97600,42210
5350,4161,1189,630,178200,42211
229,206,23,-,161200,42214
602,530,72,891,170200,42215
1306,1070,236,773,122000,42217
2373,1872,501,775,121000,42220
4305,20,4285,1434,-,42223
265,236,29,-,163900,42232
919,544,375,800,130100,42234
260,211,49,842,111400,42236
16360,8750,7610,859,140300,42240
40,40,0,-,"10,000-",42252
101,79,22,-,98300,42254
1956,1636,320,637,114300,42256
412,358,54,886,121900,42259
3591,2469,1122,653,106400,42261
3513,1492,2021,1067,137900,42262
328,306,22,-,-,42265
927,685,242,934,196200,42266
251,217,34,540,-,42273
1100,924,176,578,173500,42274
318,251,67,840,155500,42275
6152,4281,1871,703,139700,42276
142,142,0,-,108000,42280
206,199,7,-,119300,42285
497,353,144,859,173500,42286
18549,11717,6832,872,168300,42301
16645,10948,5697,921,165600,42303
3390,2426,964,770,120100,42320
168,168,0,-,87900,42321
0,0,0,-,-,42322
232,162,70,935,153800,42323
511,449,62,494,102000,42324
674,505,169,667,99800,42325
138,118,20,-,137500,42326
1680,1379,301,610,142900,42327
419,336,83,873,91500,42328
3616,2869,747,630,137700,42330
62,35,27,-,-,42332
293,247,46,675,70400,42333
656,579,77,1139,69000,42337
22,22,0,-,-,42338
343,312,31,513,143300,42339
579,490,89,727,102400,42343
354,320,34,-,74600,42344
4431,3644,787,694,125900,42345
2166,1631,535,647,122000,42347
1951,1664,287,675,129300,42348
608,511,97,739,81100,42349
517,438,79,910,141700,42350
1669,1214,455,797,124100,42351
695,505,190,409,114000,42352
82,74,8,-,76000,42354
593,418,175,736,115800,42355
0,0,0,-,-,42356
263,235,28,-,108100,42361
1922,1799,123,916,213900,42366
345,296,49,718,101800,42367
456,442,14,-,118800,42368
85,80,5,-,84000,42369
34,34,0,-,-,42370
149,142,7,-,210400,42371
712,591,121,598,104900,42372
42,37,5,-,105200,42374
2452,2174,278,903,178400,42376
1270,1140,130,775,180300,42378
860,701,159,-,86500,42404
958,779,179,739,168500,42406
2522,1869,653,596,81200,42408
815,629,186,629,129700,42409
438,292,146,813,60000,42410
779,672,107,747,88000,42411
1059,931,128,865,175400,42413
15778,9612,6166,771,155100,42420
10797,7005,3792,844,143100,42431
560,385,175,-,118100,42436
2678,1841,837,744,136900,42437
409,302,107,776,84000,42440
700,578,122,595,122100,42441
1108,856,252,760,109300,42442
0,0,0,-,-,42444
4307,2992,1315,701,102100,42445
1673,1173,500,605,66100,42450
190,121,69,-,79600,42451
934,826,108,904,159900,42452
205,160,45,780,80800,42453
1061,585,476,906,99400,42455
643,550,93,965,147500,42456
406,406,0,-,154200,42458
1559,1210,349,598,89700,42459
524,370,154,597,76200,42461
440,383,57,1069,158200,42462
65,53,12,738,66800,42463
800,706,94,-,105500,42464
6528,4261,2267,757,117700,42501
10262,6919,3343,845,179100,42503
191,182,9,-,150000,42516
1098,869,229,794,124800,42518
1237,965,272,774,96500,42519
681,563,118,666,119600,42528
367,209,158,761,99600,42533
3849,2680,1169,603,123800,42539
121,121,0,-,-,42541
2335,2126,209,670,140300,42544
2271,1820,451,805,130600,42553
316,263,53,671,172300,42565
114,109,5,-,154500,42566
2206,1925,281,902,93700,42567
3643,2651,992,607,90800,42602
234,205,29,516,75000,42603
2329,1757,572,557,150600,42629
0,0,0,-,-,42631
7386,5353,2033,677,114700,42633
558,492,66,-,55200,42634
1549,939,610,437,103300,42635
55,55,0,-,-,42638
4746,3466,1280,634,115400,42642
1262,897,365,756,57600,42647
696,503,193,679,100900,42649
1256,890,366,614,111900,42653
21531,13288,8243,882,214500,42701
690,571,119,725,124400,42712
704,511,193,614,103400,42713
92,57,35,-,174300,42715
632,510,122,770,198800,42716
2520,1910,610,516,128500,42717
9957,6782,3175,702,157400,42718
1327,1067,260,617,118700,42721
152,126,26,-,184500,42722
1921,1604,317,794,180200,42724
1823,1421,402,750,187200,42726
5856,4395,1461,718,128800,42728
622,574,48,713,121900,42729
697,480,217,933,123000,42732
567,436,131,-,138900,42733
891,637,254,749,169200,42740
146,127,19,-,111500,42741
25,25,0,-,-,42742
3532,2569,963,619,96300,42743
850,696,154,582,100800,42746
3480,2609,871,839,165800,42748
2030,1410,620,649,105100,42749
313,283,30,775,106300,42753
5950,4475,1475,624,147200,42754
1170,979,191,774,126100,42757
18,18,0,-,-,42758
7,7,0,-,-,42759
70,50,20,-,172500,42762
188,149,39,-,163300,42764
2338,1590,748,660,124000,42765
672,552,120,714,172300,42776
350,273,77,493,79000,42782
1290,901,389,831,130000,42784
124,109,15,-,216000,42788
1028,940,88,1195,296100,43001
424,321,103,-,296600,43002
1296,960,336,973,202800,43003
11052,9011,2041,1298,270200,43004
140,77,63,-,-,43005
226,165,61,858,109600,43006
38,30,8,-,154200,43007
1057,767,290,829,126800,43008
729,657,72,1160,216400,43009
117,104,13,988,124000,43010
2430,2110,320,813,259100,43011
470,410,60,1038,346600,43013
1166,949,217,610,187000,43014
21855,15277,6578,1152,279900,43015
18528,10354,8174,1427,385700,43016
16055,10631,5424,1518,451500,43017
37,29,8,-,-,43018
3438,2918,520,892,186700,43019
4792,4511,281,1170,483200,43021
824,578,246,1060,272100,43022
4826,4142,684,1044,392700,43023
2138,1644,494,796,238000,43025
24837,17075,7762,1330,299300,43026
62,0,62,-,-,43027
2821,2474,347,1208,209000,43028
171,108,63,493,265500,43029
76,76,0,-,660700,43030
5293,4209,1084,1021,320800,43031
0,0,0,-,-,43032
168,129,39,1088,143800,43033
11673,8877,2796,1442,402800,43035
135,76,59,867,121600,43036
60,39,21,639,-,43037
13432,10379,3053,1138,256500,43040
2025,1527,498,850,196200,43044
609,538,71,1111,198200,43045
1385,1069,316,1047,258400,43046
4,4,0,-,-,43047
12368,8125,4243,867,180200,43050
11030,7392,3638,1672,444500,43054
24736,14844,9892,879,170000,43055
6648,5284,1364,1026,198000,43056
1053,799,254,938,163900,43060
1549,1484,65,969,356900,43061
11257,9189,2068,1211,258100,43062
5876,4894,982,1297,380000,43064
16208,14665,1543,1500,428900,43065
531,509,22,-,279700,43066
443,400,43,860,240300,43067
23521,13874,9647,1156,209400,43068
15,15,0,-,-,43070
814,763,51,850,195900,43071
2240,1860,380,795,161500,43072
5710,4600,1110,1498,357100,43074
3498,3023,475,929,257200,43076
80,50,30,1063,166700,43077
8299,6087,2212,851,158200,43078
1860,1237,623,927,228500,43080
26826,16386,10440,1375,277900,43081
11958,10382,1576,1530,404400,43082
223,195,28,792,200500,43084
10438,7602,2836,1349,339200,43085
161,89,72,843,111200,43101
1551,1300,251,893,213900,43102
4285,3188,1097,946,225800,43103
3441,2759,682,829,281000,43105
573,375,198,929,100700,43106
1217,994,223,846,200000,43107
76,30,46,1131,225000,43109
15940,9788,6152,1152,251300,43110
52,22,30,-,-,43111
1535,1370,165,675,304700,43112
9805,6426,3379,888,201200,43113
565,447,118,1055,121000,43115
765,744,21,1375,327600,43116
8,8,0,-,-,43117
10936,8461,2475,1280,216100,43119
26331,19343,6988,1202,241200,43123
5575,3281,2294,1179,201200,43125
167,108,59,1156,162500,43126
85,69,16,-,82200,43127
857,530,327,690,144600,43128
24526,16568,7958,966,197800,43130
1675,1509,166,576,178600,43135
783,691,92,1219,280600,43136
981,815,166,1258,177500,43137
7586,5687,1899,764,159400,43138
7799,5802,1997,850,199200,43140
47,32,15,840,94000,43142
2243,1653,590,935,185000,43143
167,116,51,723,74700,43144
751,555,196,859,173400,43145
3635,3260,375,796,276800,43146
15244,12963,2281,1488,286800,43147
713,555,158,874,177200,43148
951,866,85,1013,213400,43149
950,810,140,738,251300,43150
94,62,32,940,113600,43151
390,357,33,-,159500,43152
371,266,105,1102,161400,43153
1144,1057,87,1030,216200,43154
1002,811,191,635,194200,43155
89,70,19,744,118500,43156
184,129,55,971,146100,43157
129,74,55,1035,179300,43158
9106,5665,3441,764,148500,43160
2665,2158,507,888,176400,43162
836,611,225,1016,165200,43164
14707,2665,12042,1235,406700,43201
9438,2930,6508,1117,302900,43202
3994,1278,2716,928,249600,43203
17588,9152,8436,1112,154600,43204
5582,2013,3569,951,284500,43205
11260,5334,5926,1264,268200,43206
18933,11467,7466,1035,136400,43207
12040,6874,5166,1042,343100,43209
85,0,85,695,-,43210
8606,3104,5502,1008,75900,43211
12234,3988,8246,1329,479900,43212
15954,6622,9332,1046,171900,43213
13096,8298,4798,1161,350200,43214
10740,2258,8482,1435,484800,43215
718,71,647,1053,43000,43217
0,0,0,-,-,43218
11903,5032,6871,1105,160300,43219
13319,6490,6829,1174,444300,43220
14785,10009,4776,1379,391800,43221
1645,523,1122,630,99300,43222
9188,4395,4793,960,103800,43223
17741,9135,8606,969,140000,43224
10167,5219,4948,985,118900,43227
23658,10989,12669,1087,184300,43228
21734,8764,12970,1026,187500,43229
24594,14547,10047,1312,261000,43230
8670,4394,4276,1103,208700,43231
18706,7577,11129,988,136300,43232
19863,10442,9421,1350,302000,43235
3386,911,2475,1471,263200,43240
20062,12849,7213,843,129100,43302
1131,967,164,928,142400,43310
8296,5625,2671,803,159500,43311
1025,824,201,739,158300,43314
2668,2075,593,911,156000,43315
2498,1745,753,763,159400,43316
64,38,26,1000,120000,43317
1709,1475,234,949,177400,43318
445,417,28,-,279900,43319
580,531,49,850,122300,43320
129,100,29,800,137500,43321
149,119,30,875,113600,43322
303,262,41,783,154000,43323
1128,1006,122,869,215100,43324
20,10,10,-,-,43325
5276,4017,1259,716,122800,43326
24,15,9,575,78800,43330
2048,1739,309,898,145600,43331
724,613,111,638,116000,43332
301,275,26,-,109200,43333
2430,2037,393,892,237100,43334
0,0,0,-,-,43336
361,296,65,1227,134100,43337
3841,3061,780,808,193300,43338
642,435,207,888,158400,43340
417,376,41,681,156300,43341
1408,1173,235,989,169900,43342
658,517,141,718,147300,43343
2357,1919,438,825,208400,43344
312,296,16,1089,171900,43345
36,25,11,-,-,43346
435,362,73,970,142300,43347
873,542,331,721,135300,43348
77,61,16,1143,-,43350
4387,3216,1171,734,160500,43351
474,360,114,592,261100,43356
1698,1314,384,636,199100,43357
1011,803,208,1074,170400,43358
222,152,70,679,125000,43359
673,548,125,918,224500,43360
13996,6145,7851,825,221800,43402
0,0,0,-,-,43403
702,553,149,624,141300,43406
184,174,10,-,161500,43407
103,85,18,569,117600,43408
4063,3192,871,700,143400,43410
1528,1359,169,983,204700,43412
372,315,57,1068,125300,43413
93,93,0,-,-,43414
1201,993,208,625,162000,43416
12163,8481,3682,766,135000,43420
1919,1679,240,811,145800,43430
1813,1543,270,638,149100,43431
446,428,18,-,175500,43432
23,23,0,-,-,43433
25,19,6,917,93000,43434
409,341,68,789,165400,43435
0,0,0,-,-,43436
178,122,56,909,130000,43437
117,111,6,-,295400,43438
33,33,0,-,-,43439
2184,1852,332,886,252800,43440
355,294,61,719,158500,43442
591,504,87,860,181500,43443
415,415,0,-,171100,43445
32,31,1,-,262500,43446
1179,986,193,981,189400,43447
3547,2826,721,829,174100,43449
1539,1052,487,1185,218200,43450
457,268,189,859,165700,43451
6879,5364,1515,858,177500,43452
192,183,9,-,379600,43456
511,436,75,798,153100,43457
139,108,31,735,95000,43458
2649,1851,798,802,164300,43460
426,369,57,900,150500,43462
239,153,86,729,79600,43463
844,588,256,1035,115800,43464
2274,1769,505,834,135000,43465
906,718,188,1090,165900,43466
49,37,12,-,71700,43467
191,179,12,-,184900,43468
1185,956,229,591,174100,43469
338,285,53,720,124400,43501
2609,2109,500,765,172800,43502
400,349,51,-,202000,43504
34,22,12,-,137500,43505
6521,4692,1829,786,144700,43506
34,34,0,-,193800,43510
427,366,61,-,206400,43511
11604,8844,2760,830,148700,43512
3069,2604,465,799,161300,43515
1036,818,218,913,141900,43516
1458,1163,295,758,121900,43517
1136,1002,134,939,134600,43518
144,108,36,-,112500,43519
8,8,0,-,-,43520
1151,818,333,750,119900,43521
1590,1342,248,1026,193600,43522
29,29,0,-,-,43523
467,372,95,820,161500,43524
450,399,51,958,234400,43525
2103,1593,510,749,135700,43526
907,801,106,772,120200,43527
6536,4934,1602,1021,236600,43528
115,95,20,950,73200,43529
0,0,0,-,-,43530
70,70,0,-,39500,43531
1359,1165,194,877,187300,43532
582,471,111,840,169400,43533
610,505,105,694,144100,43534
276,203,73,1193,161300,43535
118,118,0,-,123400,43536
12566,8697,3869,962,218300,43537
571,487,84,990,159000,43540
61,54,7,-,70000,43541
1563,1482,81,-,369400,43542
3251,2511,740,739,122000,43543
5897,4453,1444,884,163900,43545
129,129,0,-,215400,43547
352,334,18,669,147800,43548
519,497,22,770,169500,43549
18199,11792,6407,1120,263000,43551
156,136,20,923,145000,43553
922,600,322,717,140700,43554
136,69,67,544,144600,43555
634,530,104,697,166900,43556
1011,859,152,877,119500,43557
5555,4844,711,868,169900,43558
12560,10347,2213,993,248300,43560
158,113,45,1015,145400,43565
3245,2788,457,1440,262700,43566
5011,3995,1016,762,157200,43567
1138,868,270,762,144600,43569
1139,794,345,764,116800,43570
2791,2286,505,829,251600,43571
4974,840,4134,478,50400,43604
9954,4712,5242,827,43700,43605
9880,5450,4430,927,148300,43606
9103,4433,4670,866,72900,43607
5331,2716,2615,817,39300,43608
8722,4012,4710,925,56600,43609
1710,1052,658,877,65600,43610
7959,5537,2422,768,108100,43611
11807,6075,5732,962,86600,43612
13344,8703,4641,908,119700,43613
13866,7869,5997,857,151800,43614
18567,10324,8243,937,117800,43615
8428,6343,2085,836,174200,43616
3100,2806,294,1043,252600,43617
3203,2478,725,844,161700,43619
2410,763,1647,619,114300,43620
9150,5986,3164,893,159500,43623
23307,14782,8525,782,150500,43701
11,9,2,-,-,43711
2492,1957,535,494,123900,43713
894,705,189,781,115500,43716
52,38,14,683,70600,43717
1072,877,195,986,203100,43718
1017,810,207,731,166800,43719
480,466,14,-,153000,43720
116,84,32,-,62800,43721
151,84,67,-,104000,43722
1906,1148,758,696,106200,43723
2688,1904,784,687,127600,43724
8353,5616,2737,782,149500,43725
489,416,73,-,151700,43727
481,408,73,938,138500,43728
924,759,165,649,150300,43730
1904,1367,537,714,97800,43731
621,550,71,649,133300,43732
12,12,0,-,-,43733
610,553,57,630,203800,43734
108,8,100,-,-,43735
4,4,0,-,-,43736
44,40,4,-,95300,43738
831,768,63,865,280500,43739
95,59,36,806,125900,43740
347,331,16,-,159300,43746
549,439,110,835,136400,43747
1118,910,208,756,186800,43748
1028,949,79,625,121900,43749
42,42,0,-,82500,43750
479,406,73,496,129800,43754
659,540,119,895,133300,43755
2215,1587,628,707,121700,43756
1180,922,258,820,130300,43758
87,60,27,841,-,43759
489,406,83,-,164400,43760
18,18,0,-,-,43761
1801,1358,443,748,197100,43762
3056,2018,1038,701,124200,43764
512,326,186,733,75000,43766
520,515,5,838,149200,43767
173,86,87,1357,125000,43768
909,648,261,770,137200,43771
749,574,175,740,127800,43772
998,803,195,891,110700,43773
1906,1360,546,659,112700,43777
574,546,28,-,198600,43778
200,187,13,-,164700,43779
990,859,131,1024,168400,43780
187,160,27,-,81700,43782
1838,1570,268,776,188500,43783
31,23,8,-,134400,43786
1064,859,205,743,108300,43787
333,317,16,900,142800,43788
33,11,22,-,-,43791
2081,1484,597,539,124200,43793
352,321,31,850,142400,43802
1000,683,317,854,187200,43804
53,45,8,-,-,43805
284,218,66,928,103000,43811
7945,5029,2916,665,117900,43812
1645,1279,366,882,152200,43821
1911,1532,379,725,163000,43822
1354,1190,164,673,183600,43824
2208,1839,369,931,199100,43830
3086,2206,880,789,125700,43832
57,52,5,-,87700,43836
694,607,87,894,112000,43837
412,361,51,734,140200,43840
142,142,0,-,126800,43842
359,316,43,-,200600,43843
1572,1374,198,643,130400,43844
1903,1475,428,726,114200,43845
840,642,198,819,106000,43901
31,31,0,-,-,43902
837,675,162,831,130300,43903
228,209,19,-,-,43905
3164,2254,910,720,105200,43906
2073,1510,563,672,108700,43907
386,308,78,720,81400,43908
25,11,14,-,-,43909
1412,1202,210,-,153400,43910
2638,1952,686,611,104200,43912
450,240,210,568,56400,43913
9,0,9,-,-,43914
553,490,63,673,124300,43915
1198,1050,148,765,110100,43917
8802,6027,2775,687,101800,43920
51,51,0,-,92900,43925
110,65,45,702,62500,43926
33,33,0,-,47500,43928
423,407,16,-,118400,43930
107,107,0,-,175400,43931
369,279,90,921,134900,43932
873,827,46,-,151600,43933
40,33,7,-,108800,43934
3529,2104,1425,765,94600,43935
2281,1699,582,789,92900,43938
140,127,13,731,110800,43939
161,140,21,-,-,43940
903,667,236,425,119900,43942
1361,1207,154,678,110300,43943
1012,760,252,881,145600,43944
1190,889,301,778,122400,43945
722,583,139,906,124300,43946
2061,1613,448,759,127300,43947
244,216,28,1000,90400,43948
5574,4290,1284,885,206300,43950
20,9,11,-,-,43951
7080,3921,3159,694,119700,43952
5007,3507,1500,826,128600,43953
114,94,20,679,54000,43961
38,26,12,592,153100,43962
617,348,269,747,98100,43963
4004,3190,814,677,118300,43964
60,60,0,-,126200,43967
2611,1977,634,656,91900,43968
424,264,160,638,100000,43971
85,68,17,-,95200,43972
863,740,123,740,174000,43973
39,33,6,-,65000,43974
634,495,139,843,121100,43976
819,601,218,807,107600,43977
106,86,20,485,89300,43981
142,90,52,-,192900,43983
87,72,15,-,-,43985
723,599,124,736,116300,43986
899,700,199,559,118300,43988
8069,6964,1105,900,200700,44001
1573,1247,326,800,109600,44003
13153,8596,4557,796,113400,44004
555,477,78,785,210600,44010
9129,7950,1179,1364,364600,44011
10424,8601,1823,1274,318800,44012
7123,5118,2005,997,175500,44017
2166,1631,535,929,218100,44021
6736,6084,652,1234,445300,44022
7173,6446,727,2178,392000,44023
8934,7781,1153,1037,282700,44024
4249,3873,376,859,288100,44026
3680,3393,287,1486,283500,44028
6197,4818,1379,743,121600,44030
495,477,18,-,169700,44032
26964,16548,10416,851,136600,44035
13589,12179,1410,996,232300,44039
1119,1053,66,2513,496300,44040
5915,4149,1766,841,161900,44041
4287,3757,530,942,218900,44044
293,258,35,850,146000,44045
724,636,88,963,190900,44046
3797,2834,963,906,171600,44047
883,744,139,742,126300,44048
76,57,19,807,116900,44049
2561,2263,298,972,226200,44050
11602,6152,5450,840,98300,44052
8771,5554,3217,822,181400,44053
5531,4377,1154,1062,165300,44054
8173,4115,4058,820,88200,44055
4733,4220,513,1705,268600,44056
7712,6345,1367,1042,162300,44057
25555,20499,5056,1111,214200,44060
4322,3405,917,796,207100,44062
649,599,50,1108,220900,44064
1665,1540,125,862,278800,44065
8564,7449,1115,1177,225300,44067
61,61,0,-,91000,44068
13140,10146,2994,1046,191400,44070
2022,1614,408,1184,299100,44072
3775,2314,1461,983,205100,44074
1745,1314,431,803,148300,44076
23261,17147,6114,961,208600,44077
60,60,0,-,111500,44080
2496,2280,216,796,226800,44081
526,439,87,1023,106400,44082
1529,1323,206,913,195900,44084
1292,1171,121,1063,162700,44085
983,903,80,975,244700,44086
8988,6798,2190,1210,273100,44087
6742,5412,1330,1073,181300,44089
4129,3270,859,798,224100,44090
7864,5128,2736,1025,156100,44092
493,351,142,597,193900,44093
17340,11344,5996,1092,234200,44094
14672,11099,3573,949,153000,44095
529,482,47,-,176500,44099
0,0,0,-,-,44101
19287,6421,12866,871,93100,44102
7038,2364,4674,668,54800,44103
8332,2162,6170,600,52300,44104
14651,6487,8164,848,53400,44105
10929,2966,7963,960,232200,44106
26494,11597,14897,940,221000,44107
8888,4328,4560,873,62900,44108
16674,8014,8660,809,102200,44109
9055,3241,5814,793,59700,44110
17468,9700,7768,894,116300,44111
8276,3202,5074,757,75800,44112
10330,2633,7697,1241,282800,44113
3882,259,3623,1271,100300,44114
4957,375,4582,770,138100,44115
9716,6830,2886,1120,304000,44116
4729,1792,2937,825,130300,44117
16460,10128,6332,1153,190200,44118
6100,2993,3107,948,99300,44119
16711,7938,8773,890,101000,44120
13440,9555,3885,1069,118800,44121
15457,9648,5809,1486,299300,44122
8430,3813,4617,982,95500,44123
18988,11902,7086,1115,195200,44124
11857,7198,4659,1072,97600,44125
7704,5377,2327,946,214100,44126
1789,760,1029,659,41800,44127
12776,6150,6626,934,81200,44128
12136,8575,3561,957,140800,44129
22920,14471,8449,978,167800,44130
8444,8008,436,1375,239000,44131
6499,2798,3701,953,98600,44132
13547,9494,4053,1016,263300,44133
16415,12488,3927,1070,142500,44134
11299,6699,4600,834,108000,44135
10590,7748,2842,1196,249000,44136
10231,6472,3759,1208,86000,44137
9508,7258,2250,1171,219800,44138
9023,7671,1352,1340,364800,44139
6086,5600,486,1125,313600,44140
5615,4726,889,1438,353500,44141
7809,6264,1545,1038,147100,44142
10964,7994,2970,876,237000,44143
9268,5243,4025,897,125700,44144
14537,10482,4055,1387,310600,44145
14424,7839,6585,949,125500,44146
8396,6987,1409,1038,278200,44147
8241,7807,434,1127,273400,44149
2509,2100,409,1058,208900,44201
8732,7388,1344,1683,344200,44202
16637,11646,4991,811,134900,44203
18407,13954,4453,1112,229100,44212
768,644,124,686,201700,44214
1014,836,178,993,186900,44215
3612,3357,255,860,187700,44216
1363,1222,141,841,156900,44217
13617,7783,5834,981,144000,44221
8453,6221,2232,962,190200,44223
15619,10860,4759,1126,233400,44224
3480,2962,518,746,192400,44230
3098,2490,608,837,190600,44231
0,0,0,-,-,44232
2933,2824,109,926,383600,44233
1326,1111,215,865,214600,44234
500,389,111,955,270300,44235
9329,8342,987,2084,410200,44236
16793,8833,7960,923,206100,44240
7416,5131,2285,1245,172000,44241
0,0,0,-,-,44243
648,449,199,923,103300,44250
437,400,37,1631,336300,44251
1279,1187,92,-,240700,44253
2045,1620,425,879,178100,44254
2607,2157,450,866,172900,44255
25388,20814,4574,1085,273700,44256
5184,4446,738,954,173500,44260
2143,1686,457,-,203100,44262
1238,1090,148,1081,351700,44264
13904,9748,4156,917,153000,44266
3221,2335,886,752,155500,44270
2187,1785,402,906,218300,44272
2730,2436,294,930,223300,44273
107,39,68,-,-,44274
1184,1020,164,1118,225700,44275
597,485,112,765,214400,44276
7423,6292,1131,964,209000,44278
2064,1736,328,1754,325700,44280
13527,9836,3691,974,243100,44281
43,40,3,-,220000,44285
2618,2424,194,1310,351400,44286
2990,2563,427,737,159300,44287
1195,849,346,960,151100,44288
6031,3626,2405,988,93200,44301
2584,1163,1421,716,106300,44302
3928,1972,1956,864,198400,44303
1283,80,1203,885,56700,44304
9325,5085,4240,931,84000,44305
9055,4082,4973,898,77500,44306
2919,963,1956,806,74100,44307
417,14,403,708,450000,44308
10137,4024,6113,871,89600,44310
2814,420,2394,734,49100,44311
13465,10225,3240,960,130100,44312
13085,7680,5405,986,204300,44313
7729,4153,3576,885,78600,44314
9530,7006,2524,1020,180300,44319
8570,4454,4116,862,94000,44320
6378,4965,1413,1332,308000,44321
0,0,0,-,-,44325
7790,6588,1202,1015,327200,44333
1044,915,129,684,223800,44401
1093,970,123,597,153100,44402
1789,1565,224,645,140600,44403
528,490,38,608,156200,44404
3224,2150,1074,709,75900,44405
8668,7573,1095,779,247100,44406
4630,3219,1411,664,190800,44408
7380,5976,1404,719,168400,44410
753,707,46,1058,162000,44411
1090,979,111,789,226000,44412
2945,2169,776,769,114600,44413
0,0,0,-,-,44415
586,565,21,-,146900,44417
530,512,18,-,177200,44418
6236,4385,1851,752,106600,44420
878,633,245,971,164500,44423
32,26,6,-,-,44424
5857,4771,1086,775,120200,44425
662,587,75,822,109100,44427
1360,1036,324,740,138100,44428
985,788,197,825,152000,44429
1192,947,245,647,126400,44430
1848,1587,261,803,139100,44431
4328,3175,1153,729,116500,44432
1443,1212,231,631,130900,44436
1660,1444,216,760,125700,44437
2375,1647,728,747,76700,44438
166,120,46,765,165600,44439
2090,1671,419,689,154100,44440
715,683,32,684,184400,44441
1599,1433,166,640,177500,44442
790,655,135,796,206200,44443
4300,3090,1210,700,117800,44444
1187,938,249,835,166600,44445
9286,5463,3823,751,99200,44446
612,507,105,721,149200,44449
690,550,140,823,165300,44450
1199,952,247,682,197600,44451
1197,999,198,-,217900,44452
308,285,23,-,166200,44454
626,558,68,628,132900,44455
10623,7588,3035,761,142900,44460
1611,1453,158,563,142300,44470
4546,3113,1433,830,89800,44471
1717,1317,400,941,162000,44473
3850,3258,592,681,153000,44481
11398,7328,4070,765,93700,44483
8805,6471,2334,856,153900,44484
6860,3569,3291,748,64500,44485
311,181,130,761,93400,44490
1124,1031,93,789,191100,44491
42,29,13,-,-,44493
3478,1798,1680,869,33400,44502
471,0,471,360,-,44503
2007,876,1131,715,72900,44504
6690,3592,3098,647,89400,44505
1280,605,675,654,21200,44506
1845,882,963,751,27400,44507
5062,3106,1956,715,52900,44509
885,396,489,534,51100,44510
8840,6713,2127,748,100400,44511
14647,9474,5173,765,145100,44512
9784,8212,1572,855,181000,44514
12847,8271,4576,752,132700,44515
0,0,0,-,-,44555
13061,8020,5041,779,137200,44601
2411,1933,478,665,227000,44606
20,20,0,-,-,44607
954,591,363,1119,133200,44608
1460,1229,231,701,143800,44609
130,70,60,-,276000,44610
844,765,79,-,202800,44611
2187,1515,672,748,233800,44612
790,541,249,860,125900,44613
5554,4434,1120,882,185000,44614
4074,3322,752,700,159600,44615
2636,2028,608,783,207500,44618
69,69,0,-,-,44619
732,619,113,835,185100,44620
1859,1204,655,813,125200,44621
7448,5065,2383,945,183600,44622
1742,1491,251,597,252900,44624
429,357,72,629,168800,44625
1196,1036,160,950,153400,44626
1800,1462,338,781,346400,44627
425,338,87,783,133900,44628
1057,825,232,839,128500,44629
43,43,0,-,-,44630
3818,3125,693,897,240100,44632
702,497,205,764,191800,44633
867,710,157,685,136500,44634
970,769,201,790,154200,44637
371,280,91,-,178700,44638
108,93,15,-,68900,44639
63,53,10,1125,82800,44640
7816,5811,2005,826,185100,44641
1423,1080,343,849,153500,44643
2172,1378,794,752,162200,44644
1039,894,145,900,221100,44645
19369,12768,6601,819,167700,44646
7807,5899,1908,919,130100,44647
361,342,19,-,173400,44651
199,110,89,839,229200,44652
274,223,51,964,102700,44653
6331,4832,1499,731,278800,44654
1109,872,237,701,198000,44656
4090,2868,1222,763,149500,44657
50,35,15,910,155400,44659
49,39,10,-,-,44660
128,95,33,783,95600,44661
3923,3184,739,793,162800,44662
11307,7661,3646,826,165300,44663
73,73,0,-,126700,44665
1005,945,60,834,187100,44666
5072,3610,1462,833,177800,44667
625,485,140,786,191100,44669
81,81,0,-,103000,44670
20,20,0,-,-,44671
2248,1171,1077,1085,87400,44672
905,656,249,1072,128600,44675
1971,1599,372,752,157600,44676
1065,848,217,855,173200,44677
89,89,0,-,112200,44678
1690,1199,491,799,181800,44680
2689,2111,578,838,289600,44681
430,297,133,831,141300,44682
2959,1804,1155,823,103400,44683
11057,9216,1841,1159,242600,44685
100,52,48,1417,323500,44687
1276,955,321,798,147400,44688
144,103,41,880,96800,44689
67,37,30,-,-,44690
18276,12895,5381,860,199600,44691
14,9,5,-,-,44693
511,421,90,475,119800,44695
133,129,4,-,319000,44697
331,261,70,-,119200,44699
577,3,574,348,-,44702
3821,1218,2603,792,75200,44703
1520,770,750,774,64900,44704
7242,3878,3364,828,71300,44705
7003,5043,1960,869,126300,44706
3474,1710,1764,586,101300,44707
10873,7729,3144,910,151200,44708
8604,4753,3851,793,143900,44709
3704,2210,1494,868,90700,44710
4269,2624,1645,841,129000,44714
5636,3921,1715,851,257000,44718
16933,12096,4837,933,221000,44720
5393,4751,642,849,202000,44721
2553,1958,595,828,143700,44730
357,338,19,792,158100,44802
547,518,29,792,185300,44804
12194,8762,3432,817,156200,44805
961,851,110,542,110000,44807
50,24,26,-,-,44809
5244,3816,1428,765,146500,44811
3021,2438,583,798,198500,44813
935,757,178,868,234600,44814
315,254,61,766,92300,44815
488,417,71,920,156500,44817
901,762,139,701,132000,44818
7410,5268,2142,721,128600,44820
1055,802,253,859,191200,44822
1501,1316,185,705,169900,44824
58,50,8,800,69400,44825
545,472,73,933,146600,44826
3053,2335,718,716,109700,44827
81,19,62,1035,-,44828
7215,5232,1983,734,105600,44830
7241,4593,2648,782,116000,44833
948,815,133,871,128800,44836
1586,1278,308,783,148200,44837
91,73,18,800,136500,44838
5781,4668,1113,831,222400,44839
1129,1006,123,928,206100,44840
251,201,50,735,92900,44841
2115,1603,512,648,173200,44842
1159,1049,110,712,168800,44843
297,278,19,-,124600,44844
1321,1106,215,1017,194500,44846
1424,1160,264,994,155900,44847
845,695,150,917,123900,44849
77,77,0,-,-,44850
2013,1548,465,830,148300,44851
534,442,92,563,175000,44853
704,563,141,887,125800,44854
438,369,69,945,155200,44855
93,84,9,725,105000,44856
9670,6771,2899,773,165200,44857
785,785,0,-,180000,44859
58,43,15,-,69000,44861
1263,1048,215,833,130600,44864
1145,840,305,834,132900,44865
784,727,57,682,207200,44866
945,687,258,1008,142100,44867
17198,10725,6473,873,137500,44870
131,93,38,764,129200,44874
5541,4087,1454,726,138700,44875
979,769,210,930,152600,44878
1205,1140,65,-,218300,44880
52,43,9,-,150800,44881
1054,832,222,755,142400,44882
11844,8158,3686,799,140100,44883
351,302,49,1064,108200,44887
2527,2138,389,948,211000,44889
4084,2927,1157,817,131900,44890
0,0,0,-,-,44901
1901,661,1240,776,75600,44902
10130,7174,2956,784,163100,44903
5635,4197,1438,734,181200,44904
5099,3825,1274,840,105800,44905
7740,4714,3026,780,118800,44906
7215,3910,3305,749,115600,44907
306,126,180,774,112100,45001
5109,3914,1195,987,266200,45002
270,206,64,793,163000,45003
12568,9117,3451,953,180100,45005
26528,19708,6820,965,255400,45011
20247,14448,5799,965,194900,45013
18826,11809,7017,1095,194900,45014
4850,2748,2102,1066,104600,45015
8310,6898,1412,1099,217000,45030
256,194,62,891,138900,45032
183,154,29,-,67500,45033
435,435,0,-,286200,45034
13741,9984,3757,1022,292000,45036
11179,9630,1549,1486,279000,45039
20558,15735,4823,1643,379300,45040
136,136,0,-,-,45041
11587,8122,3465,929,172700,45042
20213,12718,7495,945,211000,45044
4240,3247,993,1467,249500,45050
49,0,49,925,-,45051
1643,1435,208,959,266300,45052
1213,1169,44,-,284500,45053
1107,1025,82,-,245800,45054
63,53,10,-,-,45055
8327,4181,4146,994,235100,45056
298,276,22,1000,136400,45062
1154,1069,85,-,209700,45064
2214,1693,521,1202,195400,45065
9326,8319,1007,1361,329000,45066
5095,3719,1376,1306,192000,45067
4603,3810,793,1233,300300,45068
20626,16033,4593,1495,294700,45069
53,43,10,1188,81700,45070
822,439,383,536,112900,45101
9591,7006,2585,848,200200,45102
14261,9762,4499,978,218700,45103
63,0,63,-,-,45105
4281,3268,1013,711,182900,45106
3599,2476,1123,893,169800,45107
156,144,12,-,212500,45111
9,8,1,-,150000,45112
1599,1464,135,1039,256500,45113
114,86,28,-,98700,45115
1385,1158,227,1014,193500,45118
15,0,15,-,-,45119
1122,723,399,737,184800,45120
3702,2656,1046,701,136800,45121
4162,3513,649,1124,190500,45122
3281,2115,1166,728,133200,45123
1471,1220,251,911,181000,45130
86,44,42,682,102800,45131
67,51,16,830,91400,45132
9120,6513,2607,724,155600,45133
1982,1539,443,812,163200,45135
20992,16659,4333,1300,315400,45140
1595,1259,336,775,152000,45142
1586,1038,548,649,97600,45144
410,342,68,1023,150000,45146
38,12,26,-,-,45147
682,561,121,1010,163000,45148
13722,10161,3561,1025,241800,45150
4461,4016,445,970,297900,45152
823,715,108,1255,190500,45153
3178,2271,907,810,169700,45154
149,114,35,740,78100,45155
15,15,0,-,-,45156
3728,3209,519,812,231800,45157
296,242,54,858,193200,45158
1328,1069,259,872,154500,45159
307,87,220,-,151600,45160
986,896,90,1196,201600,45162
108,88,20,750,88800,45164
33,0,33,-,-,45166
1363,957,406,667,158500,45167
502,406,96,781,135500,45168
1781,1245,536,690,124100,45169
2244,1855,389,927,166600,45171
84,80,4,-,131900,45172
699,674,25,1750,582100,45174
3836,2832,1004,852,179800,45176
9001,6233,2768,850,190200,45177
9436,2252,7184,1412,432600,45202
1187,421,766,770,284700,45203
2828,1286,1542,730,90700,45204
7047,2847,4200,819,90900,45205
6156,2199,3957,794,251600,45206
2347,1411,936,895,129800,45207
8365,5320,3045,1275,483100,45208
6111,2406,3705,1171,355100,45209
15304,7762,7542,847,138100,45211
9851,4657,5194,868,204000,45212
5623,3209,2414,893,243300,45213
4071,923,3148,690,86700,45214
12854,7243,5611,959,186600,45215
3439,1829,1610,885,102300,45216
2617,1781,836,870,142300,45217
1554,959,595,958,157300,45218
6914,1015,5899,1117,206100,45219
6672,1844,4828,872,355100,45220
5744,2575,3169,831,201400,45223
9200,5581,3619,835,146200,45224
3967,554,3413,549,94800,45225
3044,1852,1192,1136,387900,45226
8686,4706,3980,1166,226000,45227
6417,1877,4540,809,249700,45229
11611,8695,2916,917,222200,45230
17160,12121,5039,1078,150400,45231
3366,609,2757,556,111900,45232
5612,4627,985,893,243800,45233
11372,7317,4055,1075,200500,45236
10054,4767,5287,857,142300,45237
19880,11636,8244,860,156700,45238
11940,7070,4870,970,141400,45239
10955,6669,4286,1166,164600,45240
10258,7542,2716,1124,280900,45241
9018,6976,2042,1699,384000,45242
6066,5494,572,1848,588700,45243
10649,8692,1957,1007,326900,45244
8585,5386,3199,1072,234500,45245
5599,3187,2412,1173,173600,45246
9641,7701,1940,984,254300,45247
9586,8374,1212,1049,190500,45248
5387,3617,1770,1410,458000,45249
8251,6281,1970,1147,158600,45251
2028,1873,155,1017,271500,45252
9517,6387,3130,1219,263700,45255
0,0,0,-,-,45267
98,98,0,-,121400,45301
1602,1323,279,1087,206300,45302
933,700,233,685,119700,45303
2935,2276,659,805,177200,45304
4559,3645,914,1109,269600,45305
818,666,152,901,196700,45306
116,63,53,775,103400,45307
1689,1364,325,878,158100,45308
4630,3469,1161,907,181500,45309
103,94,9,-,170000,45310
2314,1914,400,746,161200,45311
414,359,55,1057,198900,45312
1379,1027,352,887,243900,45314
1912,1586,326,971,189500,45315
57,41,16,843,187500,45316
415,361,54,-,187200,45317
2227,1706,521,719,165100,45318
133,92,41,788,125000,45319
6500,5010,1490,812,160800,45320
474,397,77,978,126000,45321
9106,6816,2290,1015,159200,45322
2139,1734,405,846,169100,45323
18044,9078,8966,955,161900,45324
1021,967,54,1031,207800,45325
452,359,93,1125,142600,45326
3463,2979,484,666,176500,45327
175,110,65,950,103300,45328
263,223,40,859,116800,45330
9589,6248,3341,687,150500,45331
220,183,37,-,97500,45332
491,453,38,-,197800,45333
805,524,281,850,153500,45334
2820,2329,491,745,164500,45335
36,31,5,-,139100,45336
620,539,81,1050,221600,45337
1886,1465,421,866,166000,45338
452,370,82,850,183300,45339
169,166,3,-,202500,45340
1726,1456,270,791,98700,45341
14743,9067,5676,1170,188000,45342
6759,5354,1405,799,148300,45344
2539,1936,603,854,134000,45345
875,656,219,858,151700,45346
1761,1408,353,688,132000,45347
285,233,52,1022,198300,45348
107,91,16,1306,118800,45349
19,17,2,-,137500,45350
117,94,23,788,197200,45351
89,56,33,730,66700,45352
35,29,6,-,-,45353
270,188,82,-,122300,45354
10461,7142,3319,891,130300,45356
133,106,27,817,135500,45358
684,554,130,706,171700,45359
188,159,29,850,77300,45360
121,91,30,1286,117900,45361
438,385,53,627,188600,45362
709,602,107,869,248000,45363
11655,8030,3625,859,160600,45365
1887,1398,489,669,137100,45368
1655,1470,185,857,190900,45369
943,811,132,945,323000,45370
9164,6826,2338,1040,247500,45371
133,106,27,950,99000,45372
14928,10732,4196,887,212400,45373
6199,3886,2313,822,173400,45377
195,170,25,925,107000,45378
2210,1727,483,699,204400,45380
2280,1847,433,726,174700,45381
428,324,104,915,136400,45382
2827,2117,710,829,140100,45383
243,199,44,-,210800,45384
15580,10892,4688,876,186300,45385
2552,1848,704,830,273700,45387
239,220,19,-,300000,45388
229,182,47,897,99500,45389
1262,901,361,741,95300,45390
4817,1685,3132,896,109900,45402
6090,2422,3668,676,67300,45403
4104,1720,2384,884,68200,45404
8763,3019,5744,789,63900,45405
8862,4275,4587,847,75200,45406
3021,2087,934,1063,210700,45409
7124,3520,3604,906,85300,45410
9595,6410,3185,828,153100,45414
5488,3527,1961,895,160400,45415
2034,1275,759,1120,78800,45416
11592,6394,5198,801,66300,45417
7201,4766,2435,897,221000,45419
11575,7190,4385,899,107500,45420
0,0,0,-,-,45423
20313,15188,5125,1021,157500,45424
6466,3422,3044,883,99200,45426
0,0,0,-,-,45428
12244,8495,3749,985,204900,45429
2993,2470,523,1170,233500,45430
11844,6297,5547,1240,181700,45431
6468,4928,1540,849,165300,45432
410,3,407,1392,-,45433
4693,4390,303,1132,288900,45434
0,0,0,-,-,45435
4878,2544,2334,948,107500,45439
9388,5896,3492,1070,229700,45440
8429,5307,3122,967,135300,45449
15104,11498,3606,1172,314400,45458
13068,9009,4059,1127,252300,45459
5,0,5,-,-,45469
0,0,0,-,-,45501
6824,5981,843,946,210800,45502
14174,8428,5746,850,140900,45503
6193,4494,1699,863,151500,45504
7966,4087,3879,772,84200,45505
5552,3157,2395,776,96400,45506
21686,14927,6759,841,155600,45601
1848,1492,356,738,133700,45612
1026,818,208,690,152000,45613
1740,1463,277,643,118700,45614
627,498,129,664,156200,45616
0,0,0,-,-,45617
0,0,0,-,-,45618
2968,2352,616,844,139100,45619
277,228,49,743,157500,45620
163,121,42,765,54400,45621
208,192,16,-,-,45622
1225,1054,171,937,133100,45623
0,0,0,-,-,45624
2044,1604,440,825,164800,45628
1113,951,162,664,144200,45629
148,114,34,-,19100,45630
5699,3937,1762,812,139500,45631
642,454,188,691,100000,45634
70,40,30,-,166100,45636
7850,5338,2512,773,114000,45638
6298,4579,1719,749,151900,45640
0,0,0,-,-,45642
1850,1140,710,725,188900,45644
983,901,82,923,56300,45645
206,195,11,-,106900,45646
1220,996,224,544,179300,45647
4063,3125,938,837,131700,45648
173,162,11,-,80500,45650
1912,1300,612,641,123300,45651
1392,1167,225,795,122200,45652
1203,885,318,620,130100,45653
350,248,102,973,257500,45654
2397,1988,409,719,101100,45656
654,577,77,-,100700,45657
877,858,19,-,118700,45658
1064,846,218,892,91300,45659
2774,1927,847,725,133900,45660
2776,1642,1134,693,117700,45661
10797,5666,5131,707,94200,45662
2728,1910,818,669,109000,45663
4167,3189,978,865,169100,45669
130,124,6,525,53900,45671
465,402,63,-,77900,45672
165,88,77,-,112800,45673
185,52,133,488,182500,45674
19,19,0,-,-,45677
457,352,105,1003,88300,45678
1167,833,334,798,154800,45679
4642,3103,1539,747,135900,45680
604,488,116,659,152500,45681
928,706,222,685,126600,45682
602,510,92,943,99200,45684
399,292,107,767,110300,45685
1300,982,318,877,146500,45686
103,70,33,-,110400,45688
5490,3699,1791,892,140700,45690
3322,2374,948,737,115000,45692
3170,2343,827,560,155600,45693
4714,3611,1103,832,190100,45694
405,283,122,-,101800,45695
322,251,71,-,151400,45696
1884,1535,349,679,165100,45697
202,200,2,-,118800,45698
0,0,0,-,-,45699
11126,5690,5436,978,206100,45701
2078,1616,462,803,161600,45710
430,340,90,955,162100,45711
4134,2831,1303,800,154400,45714
878,568,310,613,142400,45715
165,132,33,593,110000,45716
381,210,171,839,65800,45719
0,0,0,-,-,45720
11,11,0,-,-,45721
1427,1191,236,685,138600,45723
878,695,183,1008,145600,45724
158,143,15,775,115700,45727
711,711,0,-,200900,45729
1838,1383,455,680,81300,45732
179,147,32,-,-,45734
774,711,63,-,159900,45735
0,0,0,-,-,45739
160,136,24,-,73300,45740
270,256,14,-,90800,45741
1225,1099,126,1130,156000,45742
508,378,130,679,154300,45743
940,870,70,864,166000,45744
455,314,141,1131,87300,45745
138,109,29,1068,91700,45746
11252,7752,3500,802,170100,45750
1610,1101,509,630,78300,45760
674,583,91,834,96700,45761
2751,1617,1134,709,110800,45764
441,340,101,-,105600,45766
991,664,327,558,139600,45767
637,543,94,962,173900,45768
2162,1598,564,718,108000,45769
305,228,77,-,88100,45770
1435,976,459,690,122800,45771
567,455,112,559,135800,45772
110,90,20,-,188700,45773
765,748,17,-,111200,45775
266,220,46,572,160100,45776
349,253,96,1149,122300,45778
304,238,66,638,116800,45779
1589,858,731,922,225900,45780
134,87,47,796,42800,45782
131,75,56,-,283800,45783
1314,1121,193,645,184400,45784
1172,1021,151,882,170800,45786
297,275,22,-,161900,45788
56,51,5,-,-,45789
8111,4486,3625,813,99300,45801
6016,3345,2671,781,90500,45804
9844,6022,3822,899,146000,45805
4578,3584,994,922,168800,45806
4881,3973,908,918,176800,45807
133,111,22,920,93500,45808
37,30,7,-,100000,45809
2572,1747,825,851,139500,45810
697,522,175,575,122600,45812
1405,1144,261,675,134900,45813
1171,986,185,674,186000,45814
30,30,0,-,-,45815
159,136,23,597,108800,45816
2457,2091,366,836,185200,45817
100,66,34,1063,88200,45819
246,201,45,788,99200,45820
355,331,24,704,124500,45821
8150,5878,2272,788,171600,45822
119,102,17,625,255600,45826
847,811,36,803,178500,45827
2321,1890,431,636,217100,45828
2185,1954,231,836,154400,45830
1392,1236,156,702,155700,45831
1210,999,211,750,149400,45832
4532,3478,1054,832,149500,45833
181,167,14,-,112500,45835
604,475,129,765,106500,45836
44,43,1,-,98200,45838
23209,14589,8620,888,186700,45840
422,345,77,675,169700,45841
1449,1112,337,851,145300,45843
1155,1038,117,724,202800,45844
1199,1049,150,735,265100,45845
1606,1449,157,669,234600,45846
47,40,7,-,200000,45848
366,281,85,666,98000,45849
1308,1152,156,917,160400,45850
248,209,39,875,151000,45851
601,469,132,843,200400,45853
149,104,45,908,106300,45854
49,36,13,1319,97500,45855
1903,1596,307,913,152500,45856
1048,807,241,913,146500,45858
167,138,29,788,66700,45859
793,627,166,693,288200,45860
133,125,8,-,67700,45861
622,526,96,663,118500,45862
508,466,42,751,99500,45863
70,67,3,-,117500,45864
2013,1756,257,814,250800,45865
55,52,3,-,102500,45866
466,411,55,861,165200,45867
251,226,25,1119,136300,45868
1798,1528,270,743,217400,45869
112,112,0,-,111100,45870
741,567,174,842,179800,45871
1807,1327,480,804,114700,45872
853,687,166,584,140600,45873
861,757,104,888,119800,45874
4030,3418,612,771,200500,45875
429,377,52,926,211500,45876
948,766,182,843,159400,45877
2610,2006,604,746,116000,45879
978,806,172,814,121300,45880
574,511,63,975,124400,45881
1101,944,157,565,135100,45882
1100,1009,91,720,288900,45883
48,36,12,-,109400,45884
5522,4230,1292,831,152000,45885
185,153,32,633,-,45886
1759,1333,426,740,176700,45887
168,131,37,-,88700,45888
596,574,22,-,236600,45889
319,267,52,863,152700,45890
6264,4728,1536,756,129200,45891
118,118,0,-,96300,45893
277,250,27,831,151200,45894
7259,5568,1691,822,163000,45895
692,552,140,653,124300,45896
24,24,0,-,-,45897
350,310,40,767,92900,45898
78,60,18,667,80000,45899
3963,3024,939,819,121500,46001
6874,5513,1361,1047,156400,46011
8720,5893,2827,938,137700,46012
7946,5209,2737,844,118000,46013
6927,2875,4052,828,62500,46016
2503,2006,497,915,134300,46017
1101,813,288,963,221500,46030
833,685,148,1096,139200,46031
20390,13621,6769,1472,434000,46032
14413,12399,2014,1499,430500,46033
3070,2540,530,1131,254200,46034
468,376,92,788,126400,46035
4569,3285,1284,789,101100,46036
16643,13722,2921,1495,373200,46037
16468,11526,4942,1456,272500,46038
222,215,7,-,109800,46039
5739,4884,855,1218,415000,46040
8941,6166,2775,809,135600,46041
1088,903,185,829,140500,46044
56,56,0,-,275500,46045
19,8,11,-,-,46047
743,593,150,1266,135200,46048
445,393,52,768,139700,46049
717,604,113,968,164300,46050
1186,899,287,1083,166900,46051
9394,7102,2292,882,195200,46052
5249,4487,762,1580,295800,46055
817,737,80,1047,206300,46056
382,321,61,943,174400,46057
830,736,94,963,146900,46058
17199,11813,5386,1184,271500,46060
13304,10749,2555,1305,317300,46062
138,90,48,821,80700,46063
5635,4777,858,1068,232300,46064
1124,882,242,1012,173700,46065
1027,959,68,788,159800,46068
2969,2377,592,863,222900,46069
823,683,140,871,111800,46070
1273,1066,207,948,209300,46071
3563,2668,895,840,150900,46072
15418,12728,2690,1433,373300,46074
2825,2195,630,1614,297100,46075
709,585,124,890,97100,46076
12259,10403,1856,1586,489100,46077
169,135,34,1100,138800,46102
122,99,23,1058,141300,46103
481,458,23,-,162500,46104
681,544,137,896,207200,46105
3313,2742,571,1464,377400,46106
5310,3375,1935,984,142800,46107
249,249,0,-,218100,46110
176,142,34,702,141700,46111
14932,11841,3091,1303,269500,46112
6113,4884,1229,1375,193100,46113
613,415,198,654,167500,46115
247,163,84,-,225000,46117
1865,1526,339,859,233700,46118
2644,1914,730,774,159800,46120
1829,1640,189,1178,227800,46121
6000,4723,1277,1074,246300,46122
15514,12006,3508,1362,271600,46123
2935,2021,914,767,154400,46124
15,15,0,-,-,46125
1744,1413,331,746,216400,46126
115,46,69,-,165400,46127
994,906,88,1061,182700,46128
784,751,33,1188,257100,46130
12065,8902,3163,1034,209700,46131
448,391,57,754,138500,46133
6644,4322,2322,876,170400,46135
16900,12535,4365,1026,209200,46140
13658,9449,4209,1049,243000,46142
22200,15970,6230,1367,270100,46143
133,123,10,-,141300,46144
63,18,45,-,-,46146
1035,874,161,886,201800,46147
1920,1451,469,857,161800,46148
784,697,87,1121,239300,46149
320,243,77,-,162800,46150
12012,9640,2372,910,201600,46151
15,0,15,-,-,46154
9,0,9,-,-,46155
481,395,86,795,121700,46156
1332,1159,173,789,184100,46157
9340,7622,1718,990,219300,46158
2389,2100,289,820,209400,46160
864,656,208,1066,174400,46161
136,136,0,-,710000,46162
5189,4835,354,1379,289100,46163
1629,1554,75,853,230200,46164
713,629,84,1185,229100,46165
932,790,142,883,147300,46166
2657,2559,98,1071,285400,46167
14036,9427,4609,1218,254200,46168
0,0,0,-,-,46170
771,739,32,-,219500,46171
923,762,161,1024,119900,46172
4197,2818,1379,806,139400,46173
229,208,21,806,153400,46175
11717,7654,4063,917,156300,46176
355,341,14,-,155200,46180
1927,1738,189,1161,280400,46181
622,555,67,1423,176300,46182
39,39,0,-,-,46183
4544,3960,584,1669,186100,46184
803,752,51,646,240800,46186
13488,6076,7412,895,112200,46201
10500,3130,7370,1178,359600,46202
14534,8393,6141,978,131900,46203
5571,1086,4485,1629,360000,46204
12116,6382,5734,1025,251100,46205
0,0,0,-,-,46206
9190,4793,4397,989,160400,46208
10237,4868,5369,991,165100,46214
1353,355,998,1220,215900,46216
13596,11062,2534,1286,198000,46217
12824,5953,6871,984,81500,46218
15736,9235,6501,932,151300,46219
16861,10808,6053,1239,301700,46220
10463,6274,4189,1109,156200,46221
13103,5915,7188,979,89700,46222
15349,5671,9678,962,143900,46224
2214,1162,1052,946,108800,46225
19153,8439,10714,1010,129600,46226
23329,10392,12937,939,179200,46227
5731,4645,1086,1171,219300,46228
11291,6896,4395,959,160900,46229
3714,2886,828,1407,176500,46231
10123,8309,1814,1491,201000,46234
12483,6345,6138,878,158500,46235
10027,8778,1249,1625,259300,46236
16987,11676,5311,1159,196300,46237
11454,9494,1960,1282,229900,46239
10148,4591,5557,1163,295900,46240
11527,6493,5034,1059,93700,46241
8875,3691,5184,1231,276800,46250
16633,7583,9050,1008,157700,46254
9654,6947,2707,1089,256600,46256
4834,4642,192,1134,295800,46259
14780,7218,7562,1016,247400,46260
11167,5371,5796,1148,188800,46268
3221,3030,191,1603,395400,46278
3570,2200,1370,1526,268500,46280
45,45,0,-,716300,46290
294,284,10,1375,505100,46301
31,31,0,-,218800,46302
6184,5105,1079,1176,247000,46303
11044,8512,2532,1121,255700,46304
25234,22217,3017,1187,277200,46307
5314,4578,736,965,197500,46310
8582,7663,919,1171,282000,46311
10147,4447,5700,779,84900,46312
7125,5255,1870,1096,177300,46319
5329,2274,3055,832,97500,46320
9296,8044,1252,1230,282200,46321
10063,7945,2118,1216,197700,46322
8210,5455,2755,1147,132900,46323
8677,5982,2695,1061,132800,46324
3757,2283,1474,1063,107400,46327
551,455,96,779,152500,46340
3743,3316,427,893,216500,46341
12777,9727,3050,1125,178000,46342
48,31,17,1018,179700,46345
519,298,221,865,86300,46346
1770,1539,231,1012,227000,46347
430,347,83,1087,150500,46348
1108,900,208,902,191400,46349
17851,13504,4347,864,182000,46350
6698,5791,907,1210,246000,46356
17950,12333,5617,842,144500,46360
320,261,59,-,202700,46365
2059,1759,300,778,146600,46366
15878,11651,4227,1076,192500,46368
1149,947,202,1041,227600,46371
6481,6299,182,897,351700,46373
403,297,106,730,188300,46374
9460,7679,1781,1188,284500,46375
74,58,16,975,111100,46376
34,16,18,-,-,46377
167,167,0,-,146800,46379
216,191,25,-,187500,46381
750,750,0,-,167300,46382
17004,10738,6266,1086,241800,46383
15424,13546,1878,1161,285100,46385
1190,1072,118,1163,179400,46390
2213,1836,377,1098,215800,46391
2837,2424,413,890,220100,46392
90,73,17,-,191300,46393
4955,3271,1684,917,153800,46394
2312,973,1339,847,69400,46402
4861,2377,2484,932,150500,46403
6343,3147,3196,969,86500,46404
4192,2923,1269,1142,104100,46405
3289,1612,1677,959,66300,46406
4127,1856,2271,780,53000,46407
5953,3652,2301,949,90300,46408
2605,1173,1432,1122,69500,46409
16577,10376,6201,1206,176000,46410
1375,995,380,837,124900,46501
0,0,0,-,-,46502
1134,931,203,790,160500,46504
3610,2725,885,894,220300,46506
3158,2664,494,1000,223800,46507
102,91,11,794,100700,46508
1247,1181,66,859,174900,46510
1680,1327,353,823,213500,46511
0,0,0,-,-,46513
16144,11820,4324,1017,167600,46514
11706,7158,4548,879,135100,46516
9295,5582,3713,845,157000,46517
779,716,63,812,197700,46524
11714,8230,3484,1013,180900,46526
7823,6138,1685,966,228300,46528
11450,9850,1600,1452,295000,46530
604,561,43,1090,141400,46531
464,398,66,808,113900,46532
4165,3328,837,614,153300,46534
1228,1000,228,857,202600,46536
246,219,27,640,123600,46537
1614,1339,275,985,252900,46538
1015,811,204,851,136000,46539
4050,3549,501,1048,300400,46540
1638,1419,219,910,162100,46542
878,775,103,935,294300,46543
13066,8613,4453,954,138600,46544
12166,5662,6504,944,160600,46545
4233,2968,1265,826,212100,46550
2530,2059,471,733,196200,46552
1149,1023,126,902,230900,46553
1659,1497,162,770,171900,46554
1138,921,217,985,188400,46555
233,10,223,725,-,46556
5424,4674,750,1105,194100,46561
2057,1627,430,833,169400,46562
8657,6496,2161,908,167000,46563
2425,2053,372,756,273300,46565
4013,3144,869,940,216100,46567
404,341,63,688,179200,46570
1689,1361,328,904,286700,46571
46,41,5,-,-,46572
1258,1133,125,1117,198100,46573
3133,2710,423,814,158500,46574
8351,6160,2191,917,165700,46580
5743,3719,2024,1032,219800,46582
1685,1090,595,1000,211100,46590
12,12,0,-,-,46595
2068,401,1667,707,113800,46601
3934,2247,1687,951,63400,46613
12298,9454,2844,852,158700,46614
6295,3896,2399,896,120100,46615
2410,1379,1031,989,109100,46616
4466,2798,1668,1372,203000,46617
7910,5858,2052,897,96300,46619
32,8,24,2188,-,46624
10794,7234,3560,989,152000,46628
2691,2038,653,829,168600,46635
7352,4934,2418,1140,178400,46637
3059,2507,552,826,183400,46701
887,804,83,923,120400,46702
7474,5550,1924,876,196300,46703
29,29,0,-,74100,46704
697,567,130,547,127800,46705
7925,6294,1631,782,172100,46706
1679,1454,225,683,189300,46710
2544,2040,504,768,168600,46711
5998,4333,1665,706,152300,46714
1816,1473,343,764,121800,46721
3116,2647,469,782,186500,46723
9768,7869,1899,912,196500,46725
412,404,8,930,232100,46730
233,191,42,1261,234500,46731
1030,716,314,992,142300,46732
7568,6118,1450,773,157000,46733
2933,2611,322,1152,173000,46737
3351,2805,546,827,139800,46738
1239,1051,188,650,165900,46740
1318,1186,132,1167,282600,46741
1334,1044,290,875,231500,46742
1015,864,151,969,175400,46743
670,652,18,-,208400,46745
1367,1028,339,863,158400,46746
934,862,72,917,159200,46747
2206,2009,197,1488,233700,46748
10875,7975,2900,788,127500,46750
6160,4229,1931,669,144300,46755
162,162,0,-,180600,46759
465,358,107,872,147000,46760
3882,3101,781,715,195800,46761
610,578,32,-,190500,46763
455,409,46,983,217400,46764
1987,1906,81,1107,247000,46765
168,166,2,-,124400,46766
2812,2074,738,836,185800,46767
1114,953,161,775,162200,46770
53,23,30,-,-,46771
874,803,71,750,216100,46772
1251,1027,224,799,158800,46773
6976,5499,1477,932,158000,46774
658,509,149,809,177100,46776
2702,2107,595,902,167600,46777
60,60,0,-,76800,46778
883,827,56,835,168900,46779
341,311,30,532,151200,46781
3006,2741,265,902,241300,46783
850,748,102,798,186800,46784
573,510,63,693,189900,46785
25,25,0,-,-,46786
1387,1178,209,800,145400,46787
1180,1130,50,-,225800,46788
108,43,65,-,-,46789
399,383,16,944,277800,46791
1509,1096,413,860,138600,46792
1692,1398,294,777,165400,46793
461,411,50,-,162100,46794
2593,2187,406,858,227300,46795
49,49,0,-,-,46796
1252,1150,102,983,193400,46797
430,336,94,1047,160200,46798
183,143,40,735,135500,46799
4975,1770,3205,794,108800,46802
3920,1831,2089,816,71100,46803
12713,8693,4020,1051,222500,46804
9771,5463,4308,796,121300,46805
8720,4709,4011,887,64000,46806
6130,3657,2473,902,121400,46807
8598,5521,3077,852,112900,46808
3943,2546,1397,772,109000,46809
5511,5072,439,1526,343200,46814
10359,7681,2678,931,168800,46815
7270,4197,3073,805,112700,46816
7993,6843,1150,1165,200600,46818
4147,2812,1335,907,139200,46819
12560,7391,5169,1020,179500,46825
14947,10984,3963,1059,176100,46835
10288,8894,1394,1377,285400,46845
16262,11885,4377,806,119000,46901
15803,10457,5346,870,148200,46902
1210,958,252,850,125700,46910
605,568,37,1364,183100,46911
468,443,25,-,162300,46913
998,812,186,543,151700,46914
326,264,62,688,130300,46915
749,657,92,663,126300,46917
683,576,107,647,105700,46919
424,412,12,-,238500,46920
0,0,0,-,-,46922
3034,2277,757,885,150600,46923
515,469,46,700,120700,46926
2055,1682,373,751,115200,46928
1396,982,414,708,132900,46929
87,55,32,575,75400,46930
106,71,35,735,104600,46931
1367,1027,340,641,148600,46932
2707,2073,634,793,116200,46933
2222,1919,303,814,191200,46936
9,9,0,-,-,46937
1170,931,239,924,86400,46938
784,716,68,704,104900,46939
1083,903,180,925,111000,46940
332,303,29,850,132100,46941
63,50,13,-,123700,46943
0,0,0,-,-,46945
41,20,21,-,-,46946
11062,8063,2999,759,102000,46947
231,226,5,-,114600,46950
707,634,73,1030,133300,46951
7987,5538,2449,746,117600,46952
8610,5567,3043,801,86300,46953
182,140,42,880,74000,46957
291,271,20,-,96500,46958
194,93,101,495,-,46959
464,380,84,582,126000,46960
21,21,0,-,-,46961
3152,2546,606,861,149800,46962
0,0,0,-,-,46965
47,38,9,-,62500,46967
63,63,0,-,65300,46968
8636,6181,2455,802,103400,46970
0,0,0,-,-,46971
709,504,205,834,143500,46974
5433,4202,1231,778,160300,46975
895,739,156,823,112000,46978
1762,1649,113,913,189600,46979
36,9,27,-,-,46980
1119,956,163,907,163200,46982
11,11,0,-,-,46984
443,367,76,860,96300,46985
728,654,74,688,134000,46986
431,361,70,1000,130100,46987
365,225,140,942,111100,46988
1388,1152,236,720,172000,46989
196,196,0,-,140000,46990
852,673,179,937,96400,46991
7110,5576,1534,645,132700,46992
957,817,140,563,135900,46994
2564,1934,630,685,136100,46996
76,35,41,-,-,46998
4202,3393,809,899,181200,47001
508,385,123,764,140800,47003
4630,3614,1016,684,226800,47006
65,65,0,-,211300,47010
413,413,0,-,189700,47011
4329,3222,1107,729,204200,47012
366,328,38,675,208200,47016
211,190,21,-,171900,47017
1770,1408,362,885,181000,47018
437,331,106,-,123400,47020
0,0,0,-,-,47021
1190,1159,31,-,271700,47022
872,726,146,970,159900,47023
1139,877,262,856,110300,47024
9063,7309,1754,818,211000,47025
608,558,50,-,158900,47030
2022,1526,496,898,181700,47031
1252,1185,67,1125,197000,47032
0,0,0,-,-,47033
74,47,27,950,109400,47034
109,109,0,-,92600,47035
392,339,53,836,344200,47036
1656,1212,444,775,165200,47037
394,346,48,555,123600,47038
2256,1703,553,792,165200,47040
2209,1920,289,930,243500,47041
1567,1251,316,580,163300,47042
1942,1355,587,689,171000,47043
2595,2270,325,891,264200,47060
2749,1990,759,758,120300,47102
8,8,0,-,-,47104
1626,1324,302,876,209000,47106
849,746,103,573,115300,47108
259,259,0,-,112500,47110
6553,5603,950,748,240000,47111
6374,5033,1341,857,221400,47112
156,123,33,883,230700,47114
1112,920,192,559,204100,47115
161,132,29,-,93300,47116
1618,1374,244,823,199600,47117
1445,1244,201,494,107900,47118
4188,3951,237,1163,313800,47119
271,234,37,-,232700,47120
3985,3565,420,898,246500,47122
44,31,13,-,-,47123
1795,1753,42,1242,277700,47124
602,516,86,911,106600,47125
1538,1356,182,908,240800,47126
8306,4731,3575,974,149900,47129
20013,14216,5797,1027,184100,47130
321,306,15,-,222600,47135
1592,1498,94,1026,229800,47136
543,449,94,583,109200,47137
1926,1720,206,1193,166200,47138
1032,724,308,630,107000,47140
654,557,97,893,157600,47141
311,293,18,618,165000,47142
1273,1159,114,1839,235500,47143
880,668,212,942,132100,47145
522,453,69,1458,196500,47147
20090,12852,7238,941,178000,47150
26,19,7,850,110400,47160
1239,1079,160,1299,186000,47161
228,161,67,-,151800,47162
382,353,29,-,151600,47163
1501,1212,289,744,174000,47164
2617,2244,373,826,170200,47165
550,480,70,1109,121200,47166
6064,4698,1366,640,157200,47167
5698,3641,2057,854,137500,47170
7289,6257,1032,1104,241500,47172
30,30,0,-,-,47174
377,337,40,-,118900,47175
686,650,36,1045,155000,47177
19206,12188,7018,1106,197600,47201
10430,8170,2260,930,209700,47203
2185,1805,380,733,157600,47220
320,298,22,-,151000,47223
161,161,0,-,-,47224
19,19,0,-,-,47225
95,51,44,736,122500,47226
599,528,71,731,151100,47227
1080,904,176,939,121200,47229
764,656,108,821,208300,47230
186,152,34,900,99000,47231
917,873,44,695,160500,47232
607,556,51,-,175200,47234
605,544,61,770,246300,47235
66,32,34,-,-,47236
8667,6259,2408,824,185200,47240
1858,1374,484,926,159700,47243
160,149,11,1375,212500,47244
1369,1178,191,921,160000,47246
88,69,19,890,99000,47247
9661,6465,3196,780,167600,47250
775,717,58,852,88600,47260
72,47,25,988,115200,47263
499,395,104,926,141100,47264
8047,6297,1750,890,124600,47265
177,159,18,529,188700,47270
660,516,144,796,110000,47272
768,700,68,734,187200,47273
12569,8511,4058,917,171200,47274
289,235,54,1155,179000,47280
539,511,28,-,175300,47281
112,94,18,669,78300,47282
1288,1069,219,683,162900,47283
10888,6736,4152,835,67000,47302
10194,5363,4831,860,96400,47303
13622,9132,4490,917,148600,47304
1718,617,1101,711,73100,47305
0,0,0,-,-,47306
1834,1565,269,761,111500,47320
77,41,36,825,74200,47324
191,168,23,-,151300,47325
542,462,80,596,-,47326
1805,1452,353,734,109400,47327
2100,1665,435,905,148500,47330
9445,6520,2925,764,99600,47331
1347,1174,173,786,162900,47334
291,210,81,708,93400,47335
1231,1042,189,783,85200,47336
74,48,26,1054,90000,47337
1093,912,181,681,95300,47338
187,148,39,835,96700,47339
1225,957,268,837,153600,47340
945,755,190,693,155300,47341
938,714,224,810,110000,47342
70,66,4,-,96900,47344
484,403,81,836,127300,47345
1523,1311,212,758,137500,47346
3875,2953,922,663,92000,47348
165,130,35,1039,101600,47351
279,227,52,915,141300,47352
2207,1761,446,823,150900,47353
521,467,54,845,126300,47354
1427,1081,346,694,98200,47355
2217,1683,534,826,159200,47356
383,326,57,640,114100,47357
361,306,55,632,127400,47358
1209,869,340,769,97600,47359
527,412,115,888,150700,47360
90,67,23,904,126800,47361
10913,7961,2952,766,118100,47362
17,0,17,-,-,47366
59,59,0,-,-,47367
796,686,110,650,100600,47368
647,447,200,981,166300,47369
82,75,7,788,79600,47370
4997,3764,1233,750,108900,47371
844,645,199,790,87200,47373
18963,11937,7026,795,116100,47374
631,539,92,625,83600,47380
66,45,21,838,95000,47381
55,32,23,634,58200,47382
1106,946,160,906,140400,47383
806,733,73,698,124400,47384
708,533,175,703,119400,47385
580,531,49,-,150100,47386
228,189,39,-,106300,47387
175,161,14,950,135400,47388
2228,1582,646,538,91400,47390
78,78,0,-,-,47392
513,429,84,864,132600,47393
3301,2491,810,823,99100,47394
2974,2660,314,-,160800,47396
18756,10587,8169,1157,311400,47401
14921,8308,6613,1064,200700,47403
10732,5892,4840,1138,218100,47404
0,0,0,-,-,47405
15,0,15,1219,-,47406
8817,3298,5519,1105,271900,47408
43,43,0,-,-,47420
12217,9441,2776,788,148300,47421
3365,2616,749,740,129200,47424
299,199,100,666,-,47427
2883,2521,362,725,206100,47429
551,452,99,1063,120400,47431
1901,1532,369,835,98600,47432
1469,1034,435,853,164200,47433
12,12,0,-,-,47434
69,69,0,-,-,47435
548,449,99,-,205100,47436
43,33,10,-,-,47437
1552,1160,392,769,99200,47438
3906,2673,1233,706,102400,47441
518,422,96,828,85600,47443
65,41,24,-,-,47445
3733,3081,652,760,127700,47446
3363,2686,677,958,221600,47448
161,151,10,-,96800,47449
571,355,216,722,116400,47451
2020,1478,542,747,147900,47452
122,44,78,-,137500,47453
3075,2396,679,770,120400,47454
17,17,0,-,-,47455
531,514,17,788,174500,47456
0,0,0,-,-,47457
0,0,0,-,-,47458
1415,1247,168,539,197500,47459
4691,3762,929,799,155400,47460
1807,1651,156,-,171100,47462
170,103,67,579,117200,47464
155,85,70,705,91000,47465
0,0,0,-,-,47467
583,536,47,-,270600,47468
717,573,144,733,148600,47469
518,468,50,-,168800,47470
1264,1028,236,734,104700,47471
7025,4443,2582,855,146300,47501
1726,1243,483,725,75400,47512
727,663,64,644,98100,47513
119,119,0,-,205100,47514
347,336,11,-,195200,47515
434,387,47,713,164500,47516
190,174,16,1021,225000,47519
1284,941,343,675,132100,47520
338,338,0,-,221200,47521
132,44,88,707,85000,47522
1204,930,274,765,117200,47523
201,193,8,-,91700,47524
110,104,6,-,187500,47525
820,730,90,-,210000,47527
196,130,66,488,62500,47528
396,298,98,688,108500,47529
385,344,41,-,195400,47531
1717,1418,299,823,185900,47532
262,182,80,-,82600,47535
324,234,90,664,201300,47537
447,369,78,594,125300,47541
3945,2967,978,749,153700,47542
9041,6726,2315,762,209800,47546
230,210,20,-,226000,47550
233,203,30,-,166500,47551
66,66,0,-,141100,47552
3141,2532,609,614,171800,47553
535,405,130,1008,140400,47557
1239,1057,182,758,235400,47558
627,419,208,634,88800,47561
1740,1345,395,544,203500,47562
542,432,110,945,143500,47564
2627,2174,453,633,125200,47567
236,154,82,736,114100,47568
7,7,0,-,-,47573
59,49,10,-,-,47574
439,376,63,-,229800,47575
150,150,0,-,125000,47576
469,362,107,574,190900,47577
255,228,27,655,110500,47578
999,911,88,1089,219200,47579
127,127,0,-,-,47580
1294,1085,209,596,133400,47581
71,59,12,950,91600,47584
278,261,17,-,148600,47585
4783,3353,1430,626,130300,47586
336,297,39,936,112300,47588
174,154,20,-,183300,47590
10380,6338,4042,758,134900,47591
47,47,0,-,97700,47596
348,283,65,685,138100,47597
1199,1045,154,763,97300,47598
5478,4320,1158,821,165500,47601
2090,1775,315,827,154600,47610
397,342,55,566,166100,47611
284,246,38,714,105300,47612
932,892,40,738,211600,47613
684,573,111,796,135800,47615
91,58,33,428,70000,47616
674,603,71,822,139200,47619
5355,3974,1381,756,196300,47620
14673,11994,2679,1098,242100,47630
841,703,138,813,185600,47631
971,832,139,674,134700,47633
857,799,58,1326,130300,47634
2326,1614,712,682,146800,47635
560,466,94,776,166000,47637
1369,1181,188,909,258000,47638
1686,1374,312,884,247000,47639
408,381,27,714,106000,47640
1958,1563,395,770,173500,47648
638,529,109,867,134500,47649
6,6,0,-,-,47654
1824,1375,449,837,121400,47660
1499,1226,273,850,181800,47665
553,442,111,784,126100,47666
4570,3143,1427,803,143300,47670
17,12,5,613,105000,47683
397,92,305,1064,235500,47708
8135,4454,3681,821,125500,47710
13119,9765,3354,933,151100,47711
9646,6282,3364,910,160300,47712
4609,1917,2692,870,82700,47713
14107,8250,5857,916,116300,47714
13537,6887,6650,971,182300,47715
7038,6020,1018,1041,194900,47720
7504,7287,217,1199,253600,47725
13358,8161,5197,847,158900,47802
8742,6151,2591,895,142700,47803
4479,2711,1768,841,86500,47804
5557,4381,1176,790,144000,47805
5626,1532,4094,864,55600,47807
0,0,0,-,-,47809
0,0,0,-,-,47831
461,383,78,880,123300,47832
374,314,60,-,166500,47833
7745,5834,1911,805,139300,47834
0,0,0,-,-,47836
393,358,35,867,133900,47837
802,686,116,745,107600,47838
755,675,80,-,161300,47840
985,762,223,692,93900,47841
4118,3011,1107,786,104900,47842
11,11,0,-,-,47845
259,249,10,-,113200,47846
446,388,58,585,56000,47847
549,422,127,674,94400,47848
142,114,28,-,150000,47849
924,805,119,600,101700,47850
0,0,0,-,-,47851
55,30,25,979,122900,47853
284,254,30,-,197100,47854
374,242,132,834,81900,47855
104,82,22,640,96400,47857
389,229,160,-,126100,47858
326,266,60,1108,122900,47859
201,130,71,585,45000,47860
234,220,14,-,195600,47861
632,524,108,903,97900,47862
110,110,0,-,76200,47863
1,1,0,-,-,47865
173,160,13,-,100900,47866
1153,969,184,936,147000,47868
16,16,0,-,-,47869
0,0,0,-,-,47870
198,142,56,935,94500,47871
2482,1958,524,748,122700,47872
1142,1015,127,639,114700,47874
0,0,0,-,-,47875
0,0,0,-,-,47876
1418,1005,413,722,109600,47879
13,13,0,-,-,47880
82,61,21,773,83800,47881
3351,2396,955,828,134100,47882
111,106,5,-,93700,47884
3526,2911,615,748,122300,47885
2677,204,2473,904,256100,47901
7292,3115,4177,927,109900,47904
17282,10608,6674,1041,200900,47905
25718,11305,14413,1068,258800,47906
0,0,0,-,-,47907
17284,10975,6309,1050,180700,47909
19,12,7,-,55000,47916
150,131,19,772,143800,47917
2196,1593,603,818,133300,47918
1016,901,115,746,224500,47920
433,353,80,906,165600,47921
504,368,136,951,96100,47922
1432,1197,235,824,155500,47923
58,58,0,-,109600,47924
0,0,0,-,-,47925
398,362,36,819,142000,47926
712,602,110,903,93100,47928
292,227,65,763,140100,47929
446,342,104,593,180000,47930
2151,1527,624,791,153200,47932
11530,8356,3174,768,165000,47933
537,425,112,746,136600,47940
513,399,114,919,155500,47941
323,278,45,697,102400,47942
375,327,48,-,327400,47943
1401,1081,320,795,122200,47944
737,560,177,675,153600,47946
533,445,88,642,93100,47948
564,507,57,975,95300,47949
305,230,75,-,99800,47950
1064,820,244,775,90000,47951
1220,857,363,759,100000,47952
859,720,139,867,159300,47954
366,297,69,660,109000,47955
723,556,167,873,127800,47957
59,47,12,475,126300,47958
894,623,271,917,119900,47959
6421,5007,1414,819,164300,47960
881,713,168,753,141400,47963
39,38,1,-,86000,47964
214,180,34,792,124400,47965
160,148,12,-,63200,47966
347,311,36,-,101500,47967
501,384,117,1071,206400,47968
103,75,28,1067,83800,47969
838,638,200,852,158700,47970
779,658,121,702,119700,47971
501,361,140,808,121900,47974
287,237,50,838,142700,47975
978,788,190,819,158400,47977
3904,2867,1037,882,156300,47978
450,360,90,735,154300,47980
298,288,10,-,185700,47981
64,50,14,867,90000,47982
63,63,0,-,138100,47983
0,0,0,-,-,47986
1529,1318,211,833,139900,47987
478,435,43,425,99700,47989
550,472,78,856,107600,47990
491,319,172,759,110600,47991
675,589,86,963,190700,47992
1429,1107,322,837,112000,47993
179,136,43,645,85600,47994
609,489,120,869,140100,47995
64,49,15,550,113700,47997
5170,4366,804,874,236400,48001
1256,1227,29,744,282400,48002
2255,2040,215,884,261800,48003
1808,1644,164,988,289500,48005
1437,1376,61,1074,214000,48006
9383,7162,2221,1803,679700,48009
1683,1356,327,783,197600,48014
3698,2045,1653,720,131900,48015
5762,4246,1516,1131,237600,48017
13232,9138,4094,1274,115100,48021
1021,995,26,925,223700,48022
2034,1736,298,1262,228600,48023
5696,5340,356,1932,483200,48025
6531,4873,1658,782,178900,48026
1183,1084,99,817,224100,48027
517,501,16,-,334300,48028
6824,4075,2749,1175,129300,48030
752,692,60,1071,233600,48032
8027,4162,3865,1232,180200,48033
7762,1664,6098,1252,255800,48034
14716,9385,5331,1078,165400,48035
9198,6487,2711,946,192800,48036
20707,12895,7812,1195,231900,48038
3287,2832,455,899,165000,48039
4343,3731,612,933,167700,48040
1758,1560,198,851,259800,48041
11356,10953,403,1478,347600,48042
6583,3917,2666,881,150900,48043
19747,17708,2039,1240,330100,48044
11688,8257,3431,999,241700,48045
15924,12978,2946,994,275200,48047
3195,2569,626,1176,169700,48048
2228,2043,185,1056,217300,48049
555,483,72,988,323600,48050
6813,5822,991,1126,231800,48051
2900,2551,349,1034,268000,48054
6287,5197,1090,998,192700,48059
16723,10180,6543,986,136300,48060
3494,2913,581,869,242100,48062
1552,1373,179,1048,268500,48063
1442,1364,78,775,270600,48064
4640,3809,831,943,309900,48065
20960,13360,7600,1121,129400,48066
12584,8467,4117,1405,293200,48067
1149,1091,58,1657,393900,48069
2304,2235,69,2266,457600,48070
13459,8408,5051,1095,172500,48071
6954,5912,1042,1309,275100,48072
16446,10536,5910,1182,286500,48073
3757,3334,423,1148,172500,48074
9861,5728,4133,1200,205900,48075
10331,7480,2851,1346,238800,48076
5074,4227,847,1096,262900,48079
10989,8694,2295,1097,174800,48080
9076,7786,1290,1172,184500,48081
7211,6209,1002,1285,184500,48082
9686,6214,3472,1259,284200,48083
6841,3362,3479,1542,395400,48084
9124,8421,703,1858,368600,48085
9573,8324,1249,1087,191000,48088
12675,6845,5830,1137,106800,48089
11259,7245,4014,1167,132000,48091
10660,8350,2310,1189,192900,48092
10316,7970,2346,1040,178400,48093
7884,6405,1479,1222,371300,48094
2048,1947,101,747,394300,48095
1577,1266,311,969,374700,48096
2166,1704,462,820,166800,48097
7349,6764,585,1590,467800,48098
11854,10219,1635,1155,165600,48101
23913,16072,7841,1653,440600,48103
17928,6346,11582,1464,485000,48104
15503,7728,7775,1503,453300,48105
11924,6562,5362,1224,351500,48108
103,0,103,1371,-,48109
18153,12147,6006,1122,224200,48111
7982,7311,671,1338,355100,48114
11152,9524,1628,1143,331300,48116
4142,3602,540,1016,248300,48117
5559,4438,1121,1586,343300,48118
2674,1081,1593,1402,222900,48120
4407,2636,1771,1111,95900,48122
13800,11065,2735,1217,175700,48124
8207,5718,2489,1264,106900,48125
15082,8812,6270,1168,183500,48126
13863,10125,3738,1157,198800,48127
4412,3890,522,1581,224200,48128
6060,5205,855,1623,432200,48130
3487,2491,996,1072,236600,48131
2371,2175,196,864,183500,48133
8932,7197,1735,1054,239200,48134
11025,8901,2124,950,152800,48135
1895,1706,189,952,275500,48137
4250,3904,346,1342,337800,48138
64,49,15,-,153100,48139
1200,1111,89,955,240800,48140
9222,4101,5121,1097,69000,48141
65,65,0,-,715900,48143
4036,3751,285,1009,223900,48144
1182,973,209,1057,216600,48145
15189,10733,4456,943,109500,48146
10511,9216,1295,1303,215700,48150
12542,10354,2188,1192,268100,48152
14736,13392,1344,1231,270900,48154
621,478,143,388,163800,48157
3215,2862,353,896,290200,48158
1067,892,175,1007,235800,48159
4962,4096,866,995,241000,48160
11282,8251,3031,939,160800,48161
11977,9012,2965,901,173700,48162
3250,3119,131,1504,305900,48164
3246,2549,697,1401,344800,48165
4845,4030,815,1157,202000,48166
9953,7258,2695,1523,404000,48167
9097,8344,753,2234,503100,48168
8407,7681,726,1263,323100,48169
17572,13592,3980,1067,394300,48170
4999,4203,796,1079,212600,48173
11816,8446,3370,1000,140700,48174
8546,7222,1324,1138,379500,48176
110,110,0,-,114600,48177
13619,12516,1103,1169,362900,48178
1437,1120,317,1308,221300,48179
24816,16140,8676,984,132300,48180
8574,7114,1460,1155,219300,48182
17604,13616,3988,984,202600,48183
7196,4326,2870,900,128400,48184
21850,12263,9587,1072,172100,48185
13436,8998,4438,1052,156400,48186
19357,13948,5409,1335,324400,48187
16168,13267,2901,1455,337100,48188
6024,4748,1276,1189,268900,48189
72,72,0,-,160200,48190
1541,1414,127,1391,253000,48191
10852,7953,2899,933,147900,48192
6580,4211,2369,1033,191400,48193
12549,8533,4016,1048,152400,48195
26768,14127,12641,1137,258500,48197
16703,9717,6986,1150,155600,48198
7631,869,6762,765,381500,48201
7216,2116,5100,842,187800,48202
8773,4132,4641,764,61100,48203
8781,4785,3996,931,46600,48204
12406,4563,7843,1123,47800,48205
6345,3176,3169,812,84600,48206
10892,3059,7833,1022,158100,48207
3845,1295,2550,789,162700,48208
8721,4961,3760,800,68900,48209
7871,4451,3420,924,54100,48210
1681,760,921,952,54000,48211
11670,7018,4652,899,88800,48212
7495,4358,3137,794,45700,48213
9496,3901,5595,779,91700,48214
4429,2077,2352,851,106200,48215
2429,799,1630,809,209800,48216
2728,1718,1010,1021,43100,48217
2904,1468,1436,731,49400,48218
17878,9868,8010,1024,74000,48219
11300,7097,4203,1173,214500,48220
15445,9880,5565,1087,121300,48221
9594,5296,4298,972,84700,48223
13153,7545,5608,1143,65900,48224
5774,3339,2435,1284,132800,48225
4160,406,3754,1667,293900,48226
15160,8393,6767,1014,61600,48227
19132,9162,9970,1032,48700,48228
3434,2210,1224,829,52000,48229
6965,5576,1389,1465,426600,48230
0,0,0,-,-,48233
12322,6448,5874,927,51200,48234
18169,9677,8492,1124,74400,48235
12525,11461,1064,1545,345500,48236
12432,7197,5235,1274,176900,48237
9961,4645,5316,937,51400,48238
14060,10773,3287,1306,132900,48239
6682,4918,1764,1299,110700,48240
0,0,0,-,-,48242
0,0,0,-,-,48243
5748,5034,714,1791,657600,48301
6588,5814,774,2033,604200,48302
6633,6028,605,1681,461600,48304
9795,9143,652,1131,490400,48306
18122,12150,5972,1405,316100,48307
11155,9090,2065,1539,370300,48309
14732,11518,3214,1283,248000,48310
13679,10402,3277,1098,232600,48312
13575,10014,3561,1175,236100,48313
9003,6799,2204,1393,291600,48314
10897,9408,1489,998,351000,48315
11341,8980,2361,1231,351800,48316
12401,7117,5284,1161,235800,48317
2079,1542,537,1124,273800,48320
12680,9570,3110,1943,356400,48322
6089,5446,643,2063,432700,48323
6507,5925,582,1326,383300,48324
11307,5546,5761,1299,217600,48326
9404,6596,2808,1004,230500,48327
11349,7386,3963,969,197400,48328
9814,8731,1083,1351,234600,48329
9030,7047,1983,1740,361900,48331
7809,5025,2784,1408,295900,48334
11106,4731,6375,1389,349300,48335
11732,8348,3384,1078,235100,48336
11087,4550,6537,1027,89900,48340
7797,3902,3895,866,115900,48341
6508,2318,4190,824,82300,48342
9445,6629,2816,1322,269800,48346
8879,8252,627,1118,400100,48348
2765,2346,419,1284,338900,48350
2860,2640,220,1538,275000,48353
3176,2934,242,792,313400,48356
3133,2762,371,1017,308600,48357
4157,2892,1265,1184,295100,48359
4785,4136,649,1275,346700,48360
5976,5011,965,1016,293800,48362
2416,2361,55,-,526400,48363
1551,1469,82,1027,391100,48367
506,484,22,-,431100,48370
9598,8436,1162,1094,329100,48371
5689,5109,580,2352,536100,48374
9947,7165,2782,1759,333800,48375
8981,4417,4564,1363,302700,48377
2777,2747,30,2105,424200,48380
5476,4515,961,1094,359800,48381
8474,7826,648,1589,368100,48382
4679,4313,366,1312,297900,48383
7320,6110,1210,1376,285400,48386
10501,7602,2899,1479,266300,48390
9206,4955,4251,912,292600,48393
595,468,127,833,153800,48401
52,41,11,838,110600,48410
30,30,0,-,-,48411
2168,2034,134,1297,224700,48412
2947,2183,764,694,135400,48413
1100,1025,75,868,168300,48414
3530,3042,488,941,182400,48415
1927,1608,319,796,176500,48416
1061,996,65,933,157300,48417
1599,1501,98,1217,224900,48418
967,848,119,895,156600,48419
8681,7037,1644,764,159700,48420
2576,2382,194,845,186900,48421
2501,2010,491,837,146400,48422
14630,9704,4926,901,192400,48423
378,321,57,806,122300,48426
1187,935,252,744,126000,48427
2085,1908,177,1101,291500,48428
3711,2965,746,795,138300,48429
15401,12504,2897,1258,279700,48430
253,220,33,867,140000,48432
10012,8586,1426,992,179900,48433
64,47,17,-,129700,48434
875,824,51,1241,140100,48435
1508,1416,92,893,231100,48436
218,128,90,725,113600,48437
2689,2601,88,1287,289500,48438
21092,15821,5271,973,230800,48439
58,40,18,-,357900,48440
1619,1318,301,683,140900,48441
9167,7128,2039,1144,236300,48442
3677,2745,932,839,220500,48444
515,436,79,660,110400,48445
12153,9725,2428,909,194800,48446
1094,947,147,1018,123500,48449
2373,1925,448,740,180500,48450
5638,5259,379,1010,264500,48451
1992,1435,557,790,135300,48453
477,434,43,645,164900,48454
3025,2798,227,1158,335600,48455
309,269,40,840,119000,48456
3340,2742,598,829,150100,48457
7976,5345,2631,863,82700,48458
1069,922,147,695,175300,48460
3009,2624,385,762,193800,48461
5019,4741,278,912,308200,48462
1746,1571,175,841,175900,48463
876,814,62,1188,158800,48464
225,195,30,917,165500,48465
648,574,74,750,112700,48466
1241,1030,211,663,151600,48467
552,510,42,667,111600,48468
638,525,113,833,172200,48469
277,238,39,950,159500,48470
2379,1619,760,733,128500,48471
587,501,86,879,126000,48472
9542,8116,1426,1056,179300,48473
1032,919,113,819,152900,48475
231,225,6,-,113600,48476
123,0,123,897,-,48502
9752,4807,4945,820,66200,48503
10158,6048,4110,867,44400,48504
7106,3576,3530,744,27900,48505
9817,6894,2923,849,79400,48506
12356,7131,5225,877,89600,48507
3911,3355,556,1035,118300,48509
3499,2404,1095,848,145000,48519
3793,2198,1595,855,62000,48529
8348,4750,3598,879,143300,48532
13572,8782,4790,824,52200,48601
10731,6435,4296,866,64600,48602
12481,8048,4433,990,167800,48603
4232,3225,1007,902,85000,48604
608,185,423,972,80200,48607
5285,4679,606,872,158600,48609
1463,1327,136,800,114200,48610
2667,2194,473,852,156800,48611
3562,3003,559,716,142500,48612
434,394,40,825,137100,48613
412,363,49,867,124400,48614
1077,869,208,814,119200,48615
3033,2412,621,743,143200,48616
3372,2616,756,816,150600,48617
2070,1754,316,689,114400,48618
237,219,18,-,168800,48619
57,57,0,-,110200,48620
430,339,91,718,133000,48621
2300,1967,333,826,121400,48622
5174,4552,622,1041,216700,48623
6898,6148,750,672,142700,48624
5180,4482,698,618,89100,48625
2351,2180,171,902,197900,48626
58,58,0,-,-,48627
796,754,42,994,171200,48628
3772,3146,626,739,130700,48629
37,37,0,-,-,48630
1738,1316,422,768,156300,48631
2026,1848,178,810,125400,48632
96,96,0,-,256300,48633
2059,1955,104,715,157200,48634
731,681,50,856,120100,48635
430,422,8,-,98600,48636
1254,1134,120,697,133300,48637
5902,3927,1975,867,151700,48638
13449,9981,3468,897,178700,48640
13743,10336,3407,1040,180800,48642
1552,1284,268,729,123400,48647
580,544,36,769,153100,48649
2633,2385,248,771,123800,48650
2029,1509,520,821,152000,48651
764,740,24,956,150400,48652
4639,4102,537,751,140600,48653
1116,956,160,600,120300,48654
2374,2103,271,671,138800,48655
1858,1509,349,756,88500,48656
3100,2660,440,856,165600,48657
1981,1522,459,617,97100,48658
952,826,126,834,110700,48659
4503,3523,980,784,151100,48661
546,498,48,1571,120900,48662
543,452,91,828,106100,48701
1469,1261,208,613,146300,48703
213,208,5,-,132400,48705
17109,12969,4140,832,126600,48706
11248,7680,3568,671,90200,48708
0,0,0,-,-,48710
440,397,43,680,110900,48720
210,210,0,-,175000,48721
1331,1199,132,850,127400,48722
4888,3869,1019,740,116300,48723
286,65,221,-,-,48724
1019,890,129,547,149800,48725
2214,1822,392,711,122600,48726
374,332,42,792,151900,48727
165,150,15,938,142900,48728
582,521,61,590,141600,48729
2308,1703,605,580,131800,48730
642,475,167,779,99900,48731
5162,3573,1589,775,149400,48732
670,550,120,889,88900,48733
3344,2440,904,823,257200,48734
424,375,49,750,125500,48735
603,511,92,902,120500,48737
530,485,45,925,127000,48738
1764,1638,126,703,155800,48739
1078,955,123,745,139100,48740
809,705,104,817,134600,48741
756,645,111,653,160500,48742
19,16,3,-,-,48743
1897,1748,149,845,132700,48744
610,495,115,1117,123700,48745
3216,2872,344,855,157000,48746
633,584,49,771,117500,48747
671,612,59,563,117600,48748
483,441,42,1008,103800,48749
4295,3306,989,723,103000,48750
379,344,35,754,94800,48754
1282,1050,232,867,151200,48755
1744,1434,310,813,83500,48756
1571,1353,218,851,159800,48757
1525,1256,269,909,99800,48759
544,507,37,914,139600,48760
445,398,47,-,107500,48761
499,480,19,-,161000,48762
1947,1694,253,823,140200,48763
255,241,14,-,126600,48765
544,475,69,827,91000,48766
888,760,128,928,118300,48767
3676,3078,598,746,124300,48768
690,572,118,605,98100,48770
5132,3667,1465,744,110300,48801
684,548,136,943,136800,48806
330,291,39,755,105200,48807
3047,2293,754,1164,236800,48808
4109,2994,1115,905,169900,48809
1810,1372,438,712,144900,48811
7531,6062,1469,865,168700,48813
774,695,79,-,229000,48815
181,19,162,-,184700,48816
2389,1689,700,932,152600,48817
925,808,117,731,161800,48818
871,808,63,1007,207600,48819
6825,5686,1139,1052,282300,48820
2462,2352,110,1000,222200,48821
895,880,15,1321,255500,48822
21062,9326,11736,1099,247500,48823
0,0,0,-,-,48824
0,0,0,-,-,48825
6076,5152,924,1023,193600,48827
1309,982,327,691,122900,48829
1410,1252,158,776,147700,48831
500,460,40,775,138500,48832
773,637,136,916,154700,48834
991,899,92,794,186500,48835
5366,4659,707,1007,241500,48836
8430,6820,1610,1004,228900,48837
6954,5182,1772,854,175200,48838
6142,3768,2374,970,252500,48840
331,287,44,932,158700,48841
9006,5938,3068,1150,194800,48842
18057,13882,4175,1191,305000,48843
343,305,38,748,124700,48845
6959,4840,2119,869,159000,48846
2271,1804,467,742,146200,48847
2830,2472,358,874,237700,48848
2042,1733,309,769,190300,48849
1647,1330,317,666,154600,48850
851,751,100,932,119900,48851
66,56,10,-,98800,48852
300,221,79,393,93800,48853
7605,6158,1447,1084,225000,48854
5956,5106,850,1471,295700,48855
311,249,62,683,133900,48856
1289,1114,175,979,131000,48857
17293,8567,8726,840,163100,48858
10,0,10,-,-,48859
533,386,147,621,170100,48860
737,695,42,1000,170900,48861
9,9,0,-,-,48862
9169,5802,3367,1202,326400,48864
627,501,126,758,103000,48865
1744,1473,271,830,152300,48866
11455,8297,3158,786,136900,48867
79,75,4,-,91700,48870
839,683,156,941,174700,48871
2583,2099,484,955,204000,48872
416,386,30,643,184700,48873
74,74,0,-,97100,48874
3970,3038,932,1034,195600,48875
1772,1244,528,904,177300,48876
841,761,80,707,105600,48877
636,529,107,539,134700,48878
6972,5755,1217,885,200100,48879
2419,1996,423,771,129500,48880
2087,1769,318,542,194900,48881
2590,2275,315,833,148300,48883
1679,1557,122,833,153900,48884
409,391,18,-,158300,48885
663,616,47,1110,119100,48886
2413,1916,497,859,126800,48888
636,515,121,952,120300,48889
733,555,178,918,160900,48890
1049,939,110,839,122100,48891
1900,1615,285,833,162100,48892
2076,1897,179,866,157300,48893
822,739,83,575,239700,48894
4709,3985,724,1013,256900,48895
71,71,0,-,-,48896
590,511,79,564,192600,48897
10910,7138,3772,1028,128800,48906
15600,8900,6700,965,109800,48910
16582,9355,7227,922,122100,48911
7901,3402,4499,1047,133600,48912
4325,2634,1691,1090,103500,48915
15451,9052,6399,1048,192800,48917
1753,136,1617,825,133300,48933
8681,4682,3999,974,129700,49001
8127,5646,2481,896,195900,49002
7462,5706,1756,1011,168500,49004
10778,3799,6979,972,180800,49006
4553,1217,3336,960,88900,49007
6408,4003,2405,925,196800,49008
19003,12229,6774,1048,300600,49009
6678,5591,1087,959,173100,49010
913,777,136,820,122500,49011
1361,1182,179,1013,240900,49012
1768,1421,347,602,125800,49013
8178,6031,2147,975,150200,49014
11680,8179,3501,952,161100,49015
8414,6017,2397,873,126400,49017
2322,2025,297,880,162600,49021
12510,7266,5244,778,130700,49022
12678,8195,4483,1138,230900,49024
721,606,115,879,152100,49026
69,56,13,890,181700,49027
2328,1835,493,837,124100,49028
539,478,61,750,184500,49029
846,722,124,885,118800,49030
3354,2572,782,796,196500,49031
1085,923,162,669,153800,49032
753,668,85,913,225500,49033
807,688,119,1000,173800,49034
9299,6968,2331,918,145600,49036
8863,5067,3796,783,87100,49037
3772,2839,933,917,177800,49038
1398,1148,250,802,132500,49040
1867,1422,445,745,153800,49042
876,542,334,731,124000,49043
2277,1881,396,787,155200,49045
3005,2708,297,1000,227700,49046
6023,4379,1644,762,156200,49047
9511,5765,3746,984,137900,49048
545,503,42,725,239400,49050
1046,955,91,1003,237000,49051
345,296,49,833,153600,49052
2688,2301,387,800,196500,49053
2542,2207,335,934,159300,49055
1200,1029,171,589,133900,49056
2209,1669,540,703,98200,49057
7446,6255,1191,915,187000,49058
971,843,128,-,-,49060
655,577,78,1054,171300,49061
42,42,0,-,-,49063
1408,1100,308,706,154700,49064
2893,2381,512,942,219700,49065
234,192,42,1047,165600,49066
1547,1361,186,845,174000,49067
6306,5064,1242,872,184700,49068
846,773,73,692,171500,49070
4255,3875,380,1090,237700,49071
1093,993,100,850,158800,49072
1955,1621,334,867,155600,49073
57,0,57,440,-,49074
64,48,16,-,-,49075
1396,1060,336,858,182700,49076
4024,3301,723,1123,185200,49078
5213,4021,1192,858,194100,49079
6089,5081,1008,886,209100,49080
2409,2063,346,840,153200,49082
3037,2793,244,861,292700,49083
9,8,1,-,135000,49084
10202,7962,2240,994,262800,49085
2291,2103,188,895,268100,49087
1414,1345,69,-,244800,49088
708,591,117,830,134600,49089
5696,4362,1334,883,229400,49090
7728,5417,2311,796,153900,49091
763,645,118,1154,128600,49092
7242,5177,2065,828,156500,49093
1407,990,417,776,120200,49094
965,864,101,1047,252600,49095
1151,993,158,931,169600,49096
4698,3985,713,861,213400,49097
2228,1794,434,994,121200,49098
2263,1765,498,823,149300,49099
1281,1095,186,976,211600,49101
675,588,87,971,215200,49102
4177,2616,1561,853,206100,49103
0,0,0,-,-,49104
2012,1525,487,1051,238000,49106
4293,3394,899,832,167200,49107
1377,1189,188,837,158200,49111
4167,3430,737,952,203600,49112
773,603,170,733,152900,49113
83,83,0,-,275000,49115
59,54,5,-,438500,49116
1764,1368,396,696,409000,49117
62,39,23,1010,171900,49119
14710,11565,3145,882,151300,49120
924,845,79,699,242400,49125
481,390,91,1053,126200,49126
4457,3465,992,1044,273900,49127
1477,1228,249,900,230900,49128
297,276,21,-,451400,49129
525,435,90,769,343800,49130
16789,12230,4559,903,186700,49201
8546,4713,3833,859,96300,49202
15301,10261,5040,971,133900,49203
1095,930,165,745,205100,49220
15421,10826,4595,932,146600,49221
4242,3001,1241,854,106100,49224
459,385,74,738,157800,49227
2076,1680,396,982,161400,49228
1279,1128,151,909,210500,49229
4544,4113,431,1086,242500,49230
941,783,158,826,202300,49232
1104,1020,84,944,217100,49233
1041,935,106,1036,258900,49234
797,702,95,983,155300,49235
1881,1608,273,911,192600,49236
1147,990,157,919,160200,49237
691,591,100,900,183100,49238
3663,3435,228,1182,258100,49240
769,689,80,947,188100,49241
5504,3940,1564,761,162300,49242
1538,1205,333,831,133300,49245
1344,1232,112,825,215200,49246
2179,1770,409,863,133600,49247
345,310,35,1219,150000,49248
1367,1231,136,891,209400,49249
2295,1848,447,772,152600,49250
2394,2051,343,1035,186600,49251
1024,791,233,747,122700,49252
1212,1125,87,838,212100,49253
1682,1373,309,1000,166000,49254
640,553,87,1000,129300,49255
1454,1160,294,784,103700,49256
5,2,3,-,-,49258
1106,1041,65,849,183700,49259
92,75,17,-,180200,49261
495,433,62,794,124500,49262
0,0,0,-,-,49263
591,538,53,739,204300,49264
2097,1914,183,777,256700,49265
1341,1160,181,746,150000,49266
1541,1397,144,1006,227600,49267
474,421,53,-,139800,49268
1956,1693,263,817,179000,49269
2050,1872,178,688,250500,49270
782,617,165,831,125300,49271
996,948,48,-,193400,49272
1434,1148,286,761,158800,49274
381,344,37,879,161300,49276
1122,990,132,1148,182800,49277
395,340,55,825,122600,49279
59,49,10,-,31500,49282
1088,811,277,1051,208600,49283
1113,919,194,925,147800,49284
2569,2109,460,806,192100,49285
5907,4662,1245,955,208000,49286
825,767,58,-,218200,49287
540,395,145,754,120400,49288
36,36,0,-,103100,49289
6946,6637,309,1873,492100,49301
3009,2921,88,1059,353600,49302
329,265,64,745,164200,49303
1630,1240,390,759,107600,49304
1130,966,164,788,98200,49305
4128,3952,176,1173,323200,49306
6810,4282,2528,835,163900,49307
751,673,78,863,113400,49309
1038,956,82,713,154200,49310
75,64,11,869,111100,49312
8973,8193,780,1292,331700,49315
9110,8024,1086,1130,310800,49316
476,412,64,1108,210100,49318
7251,6474,777,982,224300,49319
105,59,46,1037,124500,49320
6545,4339,2206,996,226100,49321
446,382,64,1125,150600,49322
3681,3597,84,1107,255100,49323
769,693,76,850,214100,49325
1372,1302,70,957,183300,49326
3122,2639,483,755,172900,49327
1470,1345,125,788,197100,49328
3268,2822,446,867,166800,49329
1954,1616,338,1052,227100,49330
6774,5662,1112,991,274900,49331
1518,1395,123,925,152400,49332
4836,4212,624,1139,276400,49333
27,27,0,-,-,49335
1564,1291,273,884,110100,49336
4892,4201,691,966,171500,49337
675,528,147,979,140200,49338
780,720,60,950,203500,49339
1031,852,179,754,150600,49340
14484,13038,1446,1177,313400,49341
663,514,149,880,117400,49342
2301,1942,359,761,212900,49343
1494,1321,173,1034,260600,49344
4770,4080,690,895,231400,49345
2149,1962,187,780,209300,49346
532,477,55,976,129600,49347
5179,4111,1068,1110,231400,49348
3022,2562,460,784,123300,49349
8256,4501,3755,1143,278200,49401
695,653,42,867,153300,49402
930,846,84,1172,237600,49403
3193,2579,614,928,249000,49404
614,556,58,750,124600,49405
409,393,16,-,377200,49406
3959,3398,561,828,190500,49408
52,52,0,-,147400,49409
710,610,100,914,133900,49410
748,709,39,983,199800,49411
4556,3757,799,879,170500,49412
2487,2378,109,1149,211400,49415
13413,10348,3065,1047,275900,49417
11896,8802,3094,1168,268600,49418
2889,2566,323,995,279700,49419
2391,1931,460,823,142500,49420
2226,1945,281,746,137800,49421
17449,12680,4769,1055,230000,49423
18308,13656,4652,1060,247700,49424
1203,1024,179,733,143200,49425
13430,12084,1346,1136,309700,49426
10204,8604,1600,1163,250600,49428
32,32,0,-,-,49430
7417,5422,1995,865,197400,49431
14,14,0,-,-,49434
1373,1252,121,970,248100,49435
768,689,79,773,203500,49436
2533,2200,333,760,177500,49437
694,179,515,686,151300,49440
14932,10992,3940,980,171200,49441
16190,11033,5157,838,102300,49442
0,0,0,-,-,49443
9637,6722,2915,942,147900,49444
8441,7596,845,1146,186600,49445
782,670,112,881,164000,49446
1724,1446,278,740,231800,49448
1173,1038,135,698,266500,49449
961,648,313,1119,124100,49450
2167,1916,251,945,186000,49451
771,702,69,749,111400,49452
1181,1003,178,830,443400,49453
1814,1376,438,758,152900,49454
1894,1520,374,646,127500,49455
8628,7137,1491,1063,283000,49456
4217,3888,329,913,174600,49457
42,39,3,-,83800,49458
510,426,84,1009,93800,49459
3116,2842,274,1261,324000,49460
3628,3142,486,862,229700,49461
10414,9166,1248,983,284000,49464
16883,6352,10531,1116,204000,49503
16979,9858,7121,1109,203200,49504
13638,8651,4987,1179,202400,49505
12603,9621,2982,1251,306400,49506
13174,8102,5072,1073,161000,49507
15868,9382,6486,1136,226900,49508
10245,6944,3301,933,164900,49509
8569,3688,4881,1126,268900,49512
10958,6410,4548,1097,191200,49519
11990,9526,2464,1296,270200,49525
9450,6379,3071,1111,247100,49534
4182,2556,1626,1076,232900,49544
13192,9069,4123,1208,355000,49546
12356,8838,3518,1056,141300,49548
8799,6863,1936,802,154000,49601
144,136,8,-,98500,49611
648,558,90,858,227300,49612
280,263,17,917,225800,49613
1137,1102,35,988,189000,49614
1936,1669,267,729,245600,49615
892,787,105,800,193600,49616
1314,1236,78,742,270800,49617
357,314,43,1300,141100,49618
397,370,27,992,126600,49619
947,818,129,979,180200,49620
1420,1287,133,1118,300200,49621
1034,922,112,1027,199500,49622
432,407,25,938,114600,49623
501,458,43,929,147000,49625
96,95,1,-,115900,49626
134,115,19,-,538600,49627
72,67,5,-,227600,49628
1066,891,175,1020,326000,49629
696,611,85,-,410400,49630
2277,1838,439,753,112500,49631
470,403,67,839,121500,49632
1433,1306,127,1095,158600,49633
57,57,0,-,81900,49634
1408,1138,270,917,314900,49635
292,278,14,-,727800,49636
1117,1038,79,1135,180500,49637
377,331,46,875,103300,49638
985,873,112,779,121800,49639
544,503,41,825,292000,49640
402,287,115,693,93500,49642
2838,2479,359,879,231100,49643
820,764,56,790,154900,49644
722,592,130,873,131100,49645
3661,2961,700,756,143300,49646
1234,1095,139,1232,390900,49648
2221,1912,309,1009,225800,49649
1276,1185,91,1306,228100,49650
3051,2499,552,862,156100,49651
726,714,12,-,417900,49653
262,196,66,1164,625000,49654
1190,1087,103,775,150800,49655
636,548,88,974,111700,49656
1338,1034,304,758,167200,49657
3038,2594,444,865,133000,49659
5738,4761,977,785,166400,49660
2150,1799,351,824,128400,49663
830,747,83,1214,366400,49664
1640,1443,197,732,130700,49665
270,202,68,761,118400,49667
1374,1196,178,971,139500,49668
766,722,44,1313,451700,49670
91,91,0,-,733000,49674
374,310,64,656,244400,49675
1442,1322,120,1005,225700,49676
2739,2197,542,665,116700,49677
497,464,33,1021,164100,49679
744,685,59,1030,139600,49680
1835,1542,293,864,345500,49682
844,690,154,1010,158500,49683
9098,6157,2941,1151,342800,49684
8163,6342,1821,1245,269700,49685
11569,8094,3475,1137,276600,49686
880,763,117,990,152000,49688
696,643,53,658,127100,49689
2443,2229,214,1395,319800,49690
3874,3524,350,1163,274200,49696
356,257,99,631,217900,49701
310,257,53,772,162100,49705
2199,1734,465,784,189100,49706
10027,7614,2413,618,125800,49707
1648,1493,155,633,115000,49709
164,152,12,-,190000,49710
3929,3232,697,948,231400,49712
886,796,90,870,185100,49713
1287,1115,172,663,158200,49715
353,331,22,889,238000,49716
35,35,0,-,-,49717
281,213,68,970,172300,49718
722,592,130,771,227800,49719
4434,3408,1026,914,240900,49720
5696,4744,952,779,161200,49721
22,22,0,-,-,49722
421,390,31,1066,166400,49724
297,285,12,-,188000,49725
541,504,37,777,222900,49726
2938,2532,406,724,170000,49727
157,133,24,738,114700,49728
634,552,82,1018,176800,49729
883,808,75,862,167000,49730
715,624,91,861,133100,49733
8862,6549,2313,859,183300,49735
232,218,14,-,133300,49736
4238,3374,864,863,140500,49738
3273,2918,355,1085,297800,49740
380,366,14,633,130300,49743
347,306,41,944,201000,49744
468,321,147,713,119300,49745
1716,1374,342,667,126400,49746
868,819,49,871,162600,49747
85,77,8,-,99400,49748
2057,1765,292,807,183500,49749
891,789,102,933,159100,49751
334,313,21,-,143800,49752
765,710,55,850,131900,49753
809,712,97,892,150600,49755
2024,1721,303,921,153200,49756
344,134,210,998,612500,49757
754,699,55,628,158300,49759
346,310,36,1120,133700,49760
302,280,22,900,120000,49762
0,0,0,-,-,49764
1852,1552,300,639,105500,49765
925,836,89,711,136200,49766
206,174,32,-,189100,49768
693,550,143,961,129000,49769
7399,5056,2343,1010,269800,49770
711,654,57,932,152900,49774
22,22,0,-,192900,49775
673,581,92,588,107600,49776
920,885,35,923,197400,49777
2142,1869,273,624,110700,49779
633,572,61,679,123300,49780
1804,1273,531,674,142700,49781
340,314,26,694,319000,49782
7808,5167,2641,784,134800,49783
0,0,0,-,-,49784
947,427,520,818,85700,49788
95,78,17,-,226000,49791
73,73,0,-,156300,49793
815,671,144,919,153600,49795
179,142,37,1307,225900,49796
847,770,77,700,153100,49799
5272,4399,873,709,149800,49801
2685,2088,597,749,97900,49802
248,215,33,-,114100,49805
242,220,22,-,255200,49806
1268,1151,117,640,152100,49807
286,248,38,-,141100,49808
342,313,29,1031,140700,49812
454,435,19,-,139200,49814
116,116,0,-,110200,49815
305,289,16,656,171500,49816
252,235,17,775,174100,49817
480,480,0,-,156000,49818
111,90,21,328,115000,49820
501,470,31,1000,124300,49821
105,82,23,931,212500,49822
116,116,0,-,179500,49825
59,47,12,-,326600,49826
451,342,109,771,99700,49827
7665,5236,2429,618,130800,49829
267,259,8,-,149400,49831
54,54,0,-,152500,49833
234,210,24,769,132100,49834
344,301,43,625,153800,49835
468,426,42,759,179400,49836
3897,3237,660,792,147500,49837
226,214,12,-,176900,49838
172,146,26,798,150000,49839
317,305,12,1125,165700,49840
2879,2019,860,721,141800,49841
461,373,88,603,113100,49847
45,38,7,-,125000,49848
4851,3976,875,665,135500,49849
50,47,3,-,85000,49852
525,477,48,593,173500,49853
3007,2481,526,563,120000,49854
13629,8183,5446,972,232700,49855
5396,4030,1366,697,117900,49858
256,249,7,500,205000,49861
1545,1160,385,699,141600,49862
76,76,0,-,71500,49863
23,17,6,-,-,49864
3342,2851,491,739,176300,49866
1567,1242,325,756,95700,49868
1532,1189,343,640,96300,49870
192,168,24,692,67800,49871
96,78,18,675,140600,49872
48,48,0,-,170800,49873
380,295,85,539,175600,49874
526,509,17,-,106900,49876
8,7,1,-,187500,49877
1422,1324,98,654,157500,49878
541,477,64,825,85000,49879
521,479,42,796,124300,49880
156,143,13,-,-,49881
56,47,9,681,164600,49883
221,146,75,685,130200,49884
756,719,37,1338,211200,49885
227,208,19,-,122400,49886
1050,911,139,671,159400,49887
209,201,8,1375,150700,49891
860,788,72,837,179000,49892
616,582,34,656,169400,49893
361,361,0,-,112200,49894
383,322,61,-,162000,49895
565,443,122,399,155700,49896
156,154,2,-,80000,49901
122,104,18,525,32000,49902
136,120,16,375,51400,49903
737,675,62,866,179200,49905
1014,696,318,514,116600,49908
136,122,14,-,306700,49910
1227,993,234,513,107400,49911
417,382,35,1038,106900,49912
3075,2332,743,622,83900,49913
258,204,54,683,47900,49915
1253,1019,234,766,200200,49916
91,81,10,850,85900,49917
49,47,2,-,273400,49918
59,58,1,-,99000,49919
1841,1682,159,733,112800,49920
148,68,80,1633,-,49921
333,274,59,688,126100,49922
318,275,43,-,97800,49925
130,124,6,-,63800,49927
84,81,3,-,52500,49929
2740,1761,979,730,185100,49930
3147,1311,1836,825,215200,49931
375,349,26,785,88800,49934
2657,2086,571,529,99600,49935
3776,3077,699,499,82900,49938
57,45,12,-,94200,49942
1292,999,293,520,120800,49945
1627,1222,405,610,112300,49946
358,347,11,-,147300,49947
248,219,29,1625,71000,49948
508,479,29,595,196300,49950
55,48,7,-,158300,49952
1158,962,196,524,92800,49953
136,136,0,-,77000,49955
382,363,19,-,137900,49958
156,133,23,-,46100,49959
81,81,0,-,62500,49960
59,59,0,-,76600,49961
115,108,7,-,172200,49962
256,217,39,623,80600,49963
253,244,9,-,208800,49965
197,193,4,-,99000,49967
949,810,139,594,70900,49968
553,454,99,445,260000,49969
141,135,6,-,102700,49970
215,205,10,-,50900,49971
190,168,22,1352,352900,50001
640,497,143,876,156600,50002
3513,2659,854,843,362400,50003
358,303,55,854,118500,50005
682,469,213,582,114900,50006
186,186,0,-,293900,50007
326,275,51,564,107200,50008
8099,5774,2325,1140,250000,50009
13900,7395,6505,946,235700,50010
0,0,0,-,-,50012
0,0,0,-,-,50013
13085,4739,8346,1075,288900,50014
573,511,62,792,122400,50020
11391,8558,2833,1414,269100,50021
3747,2517,1230,694,141900,50022
16720,11836,4884,1214,293000,50023
1414,1039,375,743,96700,50025
189,155,34,700,88500,50026
152,103,49,819,77300,50027
700,569,131,650,176600,50028
249,214,35,785,75300,50029
14,14,0,-,56700,50031
265,265,0,-,46300,50032
7,6,1,-,-,50033
169,141,28,635,95800,50034
3095,2838,257,1020,287700,50035
6661,5159,1502,844,157000,50036
88,88,0,-,-,50038
179,151,28,848,264700,50039
65,54,11,521,72500,50040
58,31,27,-,-,50041
81,72,9,1275,120000,50042
382,341,41,620,111500,50044
667,583,84,863,196800,50046
2328,1908,420,1259,194300,50047
300,230,70,954,98600,50048
2669,2000,669,774,113100,50049
308,257,51,825,89400,50050
126,124,2,-,206900,50051
43,38,5,-,91800,50052
1075,862,213,865,157600,50054
469,370,99,725,197700,50055
501,426,75,1015,163600,50056
120,120,0,-,209200,50057
802,638,164,692,137200,50058
959,696,263,704,100300,50060
773,751,22,1125,534500,50061
300,227,73,941,114400,50062
981,836,145,686,255800,50063
74,42,32,-,112000,50064
275,208,67,763,82200,50065
103,87,16,1000,-,50066
84,79,5,713,104900,50067
112,111,1,-,197900,50068
380,321,59,825,200300,50069
533,459,74,870,202800,50070
347,280,67,617,70000,50071
1071,901,170,907,285100,50072
448,393,55,775,272100,50073
103,96,7,-,418200,50074
321,237,84,-,142400,50075
636,551,85,670,93700,50076
50,37,13,775,51000,50078
26,14,12,783,43300,50101
45,45,0,-,50600,50102
170,151,19,792,77000,50103
52,43,9,-,-,50104
514,437,77,918,255200,50105
488,442,46,663,107500,50106
322,226,96,-,75500,50107
192,159,33,578,48100,50108
1295,1128,167,1018,337000,50109
18,18,0,-,45000,50110
5841,3997,1844,1042,279400,50111
4744,3288,1456,841,188400,50112
1207,971,236,764,134600,50115
74,70,4,-,125000,50116
53,41,12,-,172900,50117
294,282,12,1167,161500,50118
157,133,24,850,96500,50119
184,161,23,-,157900,50120
591,498,93,644,104500,50122
379,327,52,531,106600,50123
1636,1417,219,1195,286700,50124
7589,5490,2099,932,230200,50125
2747,1928,819,856,121900,50126
0,0,0,-,-,50127
193,162,31,619,106800,50128
2323,1742,581,839,130800,50129
590,490,100,855,128600,50130
9338,6635,2703,1221,331900,50131
167,119,48,-,85000,50132
212,162,50,720,156300,50133
321,244,77,869,247800,50134
598,448,150,771,157200,50135
159,125,34,921,95000,50136
35,22,13,-,-,50137
5126,3878,1248,790,153600,50138
437,395,42,848,116900,50139
1040,614,426,701,107500,50140
215,204,11,650,131300,50141
371,323,48,694,139400,50142
229,177,52,627,216300,50143
1092,685,407,535,120800,50144
46,46,0,-,262500,50145
173,109,64,1063,182500,50146
174,128,46,444,57800,50147
183,157,26,775,96300,50148
318,248,70,782,146900,50149
314,282,32,725,107900,50150
248,223,25,1662,137300,50151
56,44,12,-,157100,50152
373,333,40,556,167900,50153
271,219,52,631,171500,50154
60,55,5,-,94500,50155
1901,1625,276,868,207900,50156
284,164,120,738,107600,50157
11499,8067,3432,831,124600,50158
254,188,66,816,158500,50160
809,697,112,833,190600,50161
550,389,161,1364,158900,50162
287,249,38,783,89800,50163
262,240,22,533,142300,50164
15,13,2,-,112500,50165
731,687,44,860,201000,50166
326,253,73,856,168000,50167
343,290,53,863,228600,50168
895,742,153,789,176800,50169
1202,934,268,752,182300,50170
1136,766,370,857,183800,50171
327,262,65,1107,165300,50173
477,410,67,918,106700,50174
3596,2757,839,831,171700,50201
217,179,38,589,117500,50206
1050,777,273,532,145900,50207
7905,5741,2164,830,151400,50208
610,550,60,950,275600,50210
5809,4954,855,976,276100,50211
1239,990,249,737,181500,50212
3048,2099,949,638,132300,50213
304,290,14,-,329100,50214
1162,976,186,1053,202100,50216
228,192,36,688,123900,50217
128,119,9,850,116500,50218
5133,3736,1397,973,255100,50219
3636,2348,1288,905,123900,50220
151,142,9,950,219400,50222
167,136,31,600,87100,50223
1317,1098,219,769,172000,50225
2500,2255,245,723,361100,50226
31,24,7,-,74000,50227
973,769,204,863,181200,50228
486,476,10,-,388200,50229
390,355,35,517,131600,50230
63,56,7,825,106300,50231
261,184,77,996,216000,50232
594,536,58,775,196700,50233
204,189,15,438,140300,50234
140,109,31,-,177300,50235
783,667,116,1004,176300,50236
1330,1241,89,715,340400,50237
479,440,39,697,81500,50238
53,43,10,-,-,50239
901,758,143,920,253500,50240
66,49,17,1125,148200,50241
173,145,28,862,140600,50242
143,126,17,1063,154300,50243
803,724,79,878,216200,50244
290,213,77,499,112900,50246
932,719,213,740,149800,50247
1765,1322,443,863,198700,50248
582,493,89,696,110600,50249
1078,806,272,827,171700,50250
572,483,89,725,158100,50251
113,112,1,-,323100,50252
81,81,0,-,173400,50254
30,30,0,-,22000,50255
233,233,0,-,145800,50256
380,329,51,840,219600,50257
335,300,35,639,106300,50258
945,806,139,882,269300,50261
90,82,8,-,73600,50262
10140,7218,2922,1211,309900,50263
187,147,40,728,183900,50264
14505,9527,4978,1013,241800,50265
16788,8656,8132,1244,310000,50266
395,305,90,791,72900,50268
57,49,8,-,48100,50269
268,222,46,696,132500,50271
53,46,7,-,52700,50272
3606,2860,746,985,212200,50273
87,73,14,800,75800,50274
191,151,40,619,112500,50275
821,759,62,713,240500,50276
186,152,34,867,109100,50277
330,250,80,716,153100,50278
6632,817,5815,1126,309300,50309
13367,9297,4070,1012,197000,50310
6531,3161,3370,939,214500,50311
7748,5036,2712,1022,259500,50312
7060,5108,1952,1029,146900,50313
3918,1677,2241,910,138600,50314
15423,9170,6253,907,155500,50315
5507,3628,1879,946,129300,50316
14025,10128,3897,1040,152500,50317
0,0,0,-,-,50319
8255,6277,1978,979,199500,50320
3348,2001,1347,1073,258000,50321
12765,9182,3583,1099,247900,50322
5635,5095,540,1277,398900,50323
2155,1664,491,1207,234700,50324
6958,5193,1765,1089,359300,50325
4602,3733,869,1104,285100,50327
13367,9178,4189,838,129600,50401
149,122,27,375,58100,50420
1167,914,253,749,114000,50421
1092,907,185,1102,104900,50423
700,521,179,633,105200,50424
41,30,11,950,62500,50426
74,74,0,-,83400,50427
4090,3111,979,738,235900,50428
170,143,27,-,60500,50430
79,54,25,619,76700,50431
108,92,16,700,80000,50432
67,65,2,-,110900,50433
267,246,21,831,-,50434
282,217,65,625,150600,50435
2286,1737,549,718,143900,50436
1672,1325,347,745,160100,50438
126,112,14,-,84700,50439
163,98,65,623,99400,50440
2230,1552,678,722,105500,50441
153,120,33,764,119400,50444
227,176,51,703,146900,50446
515,414,101,592,78800,50447
322,258,64,643,104300,50448
378,283,95,732,94600,50449
1228,875,353,658,139800,50450
220,171,49,772,38600,50451
369,232,137,862,113000,50452
213,192,21,864,160200,50453
33,33,0,-,-,50454
147,142,5,-,122400,50455
728,496,232,644,115100,50456
154,120,34,775,80000,50457
831,727,104,721,149300,50458
1242,1014,228,675,145400,50459
177,132,45,471,234600,50460
2385,1925,460,706,143800,50461
201,182,19,917,143500,50464
78,65,13,800,44500,50465
771,532,239,650,138700,50466
37,30,7,863,141700,50467
641,494,147,759,126100,50468
645,535,110,491,169500,50469
94,85,9,-,67700,50470
272,205,67,821,96800,50471
1058,815,243,784,196300,50472
75,63,12,-,120300,50473
553,482,71,788,138100,50475
317,278,39,625,88700,50476
88,41,47,632,55600,50477
422,342,80,684,96000,50478
300,235,65,655,109600,50479
349,325,24,656,68900,50480
306,242,64,950,215100,50482
289,268,21,758,156600,50483
133,121,12,-,99600,50484
11967,7920,4047,761,134200,50501
424,304,120,697,94400,50510
3178,2184,994,871,161400,50511
523,437,86,592,100400,50514
120,89,31,1266,50600,50515
311,266,45,709,116800,50516
405,300,105,582,79800,50517
124,117,7,-,138800,50518
282,199,83,564,107800,50519
72,66,6,-,39700,50520
17,0,17,-,-,50521
327,270,57,864,85500,50522
250,179,71,-,127700,50523
210,186,24,625,182500,50524
1622,1109,513,705,120600,50525
46,39,7,-,75000,50527
127,91,36,616,-,50528
391,307,84,874,112100,50529
497,356,141,617,129600,50530
111,102,9,-,127400,50531
357,272,85,619,187500,50532
1523,1056,467,841,98200,50533
442,340,102,581,87800,50535
1792,1286,506,657,123800,50536
239,180,59,729,65000,50538
204,185,19,722,70600,50539
411,315,96,820,93200,50540
410,293,117,607,97900,50541
405,356,49,822,101900,50542
539,478,61,637,105900,50543
232,206,26,765,120800,50544
71,67,4,-,155700,50545
175,140,35,544,55900,50546
2503,1742,761,650,154300,50548
29,21,8,-,53200,50551
33,29,4,-,71300,50552
728,549,179,732,81300,50554
68,62,6,-,35000,50556
346,285,61,563,101200,50557
239,206,33,1100,127500,50558
155,71,84,758,110900,50559
269,164,105,758,74000,50560
227,176,51,617,83300,50561
181,149,32,889,82500,50562
1097,865,232,654,144500,50563
158,146,12,783,59100,50565
189,164,25,1075,166700,50566
98,92,6,-,176100,50567
532,438,94,641,122700,50568
313,269,44,550,86000,50569
69,41,28,663,110800,50570
157,145,12,-,52600,50571
25,18,7,-,-,50573
1027,769,258,754,98400,50574
285,253,32,677,76300,50575
131,91,40,541,89300,50576
203,179,24,689,81200,50577
274,232,42,642,80000,50578
1025,780,245,728,115200,50579
294,257,37,753,69500,50581
94,85,9,488,59400,50582
1170,897,273,578,119500,50583
450,384,66,755,94100,50585
100,88,12,763,116700,50586
4714,2970,1744,787,161800,50588
375,276,99,606,54600,50590
142,127,15,1042,174300,50591
51,24,27,1102,42500,50592
20,20,0,-,43300,50593
128,75,53,763,181300,50594
3712,2394,1318,843,99600,50595
444,354,90,583,160300,50597
383,340,43,608,98200,50598
213,190,23,725,140400,50599
1034,854,180,692,109800,50601
602,458,144,555,107600,50602
161,143,18,533,94600,50603
687,586,101,675,135100,50604
79,70,9,-,56000,50605
337,291,46,438,113200,50606
167,163,4,-,149100,50607
28,28,0,-,145800,50608
175,168,7,763,178600,50609
150,126,24,438,86700,50611
135,116,19,-,316100,50612
16598,10740,5858,1111,250000,50613
4211,3081,1130,622,133600,50616
848,656,192,858,147300,50619
25,20,5,-,105000,50620
661,502,159,957,165500,50621
1195,1070,125,725,245700,50622
73,73,0,-,165600,50623
639,548,91,719,239500,50624
388,311,77,708,68500,50625
609,510,99,729,192600,50626
1280,906,374,686,95600,50627
518,410,108,549,137500,50628
787,658,129,689,174200,50629
642,490,152,743,193200,50630
107,93,14,616,90300,50631
549,460,89,630,114700,50632
175,86,89,529,44000,50633
342,298,44,766,169300,50634
594,503,91,763,138000,50635
945,735,210,821,134700,50636
1300,1051,249,644,157100,50638
565,483,82,782,132500,50641
213,178,35,1154,205300,50642
1129,1028,101,1006,236900,50643
3684,2816,868,795,178200,50644
601,531,70,700,109700,50645
786,746,40,538,267000,50647
1460,1316,144,743,195400,50648
11,11,0,-,-,50649
281,222,59,783,97400,50650
1388,1129,259,814,165900,50651
50,43,7,-,103300,50652
198,162,36,618,129200,50653
142,109,33,-,183900,50654
321,240,81,618,138200,50655
52,49,3,-,-,50657
998,802,196,757,116000,50658
2348,1928,420,797,168500,50659
442,361,81,804,158400,50660
2906,2189,717,791,106900,50662
85,85,0,-,113100,50664
1081,882,199,750,209100,50665
330,290,40,646,163600,50666
329,300,29,950,205700,50667
457,404,53,748,171800,50668
1016,785,231,900,156000,50669
878,774,104,617,172800,50670
97,54,43,638,110500,50671
183,129,54,673,122100,50672
84,69,15,975,118800,50673
1448,1169,279,717,151200,50674
919,683,236,867,135800,50675
876,765,111,824,138100,50676
4763,3782,981,826,217100,50677
503,464,39,575,113100,50680
182,168,14,-,116300,50681
632,532,100,943,181100,50682
13206,8599,4607,839,173500,50701
8857,5443,3414,871,139000,50702
7611,4334,3277,915,86800,50703
3362,2374,988,847,134700,50707
3786,2763,1023,706,118300,50801
704,542,162,668,104500,50830
12,10,2,-,50000,50831
890,682,208,611,105300,50833
36,20,16,-,-,50835
158,122,36,713,114500,50836
154,146,8,517,123400,50837
25,25,0,-,71700,50839
264,213,51,599,144800,50840
1034,790,244,753,97200,50841
38,36,2,-,92500,50842
219,164,55,700,102900,50843
265,219,46,839,106800,50845
494,350,144,761,82200,50846
34,21,13,-,52500,50847
101,85,16,680,72900,50848
1072,682,390,598,132500,50849
847,688,159,707,113100,50851
293,225,68,550,154700,50853
941,679,262,687,132700,50854
84,71,13,-,152100,50857
327,275,52,739,123100,50858
320,276,44,910,138600,50859
80,75,5,-,166300,50860
130,112,18,875,89000,50861
45,40,5,-,95600,50862
76,65,11,625,83600,50863
781,598,183,760,92700,50864
972,692,280,718,172500,51001
998,842,156,855,133400,51002
672,594,78,695,215800,51003
406,299,107,1033,98100,51004
668,520,148,705,150300,51005
486,366,120,443,75800,51006
217,217,0,-,194500,51007
65,45,20,1167,122900,51008
64,51,13,525,70800,51009
213,176,37,714,108300,51010
32,25,7,729,152500,51011
2787,1908,879,650,146700,51012
243,192,51,1063,121600,51014
25,25,0,-,126400,51015
425,385,40,638,92100,51016
262,202,60,813,312200,51018
226,190,36,779,100700,51019
224,149,75,583,89600,51020
362,318,44,748,163900,51022
1198,814,384,841,146000,51023
854,698,156,917,310300,51024
813,634,179,773,126100,51025
422,402,20,850,205600,51026
444,368,76,1094,234200,51027
888,692,196,690,186000,51028
138,124,14,-,140600,51029
642,538,104,804,271200,51030
5128,3562,1566,835,190300,51031
215,176,39,1133,-,51033
710,553,157,708,101300,51034
717,562,155,723,177800,51035
281,255,26,831,262800,51036
122,99,23,703,232100,51037
649,550,99,660,171900,51038
1069,893,176,858,210800,51039
1485,1162,323,782,112600,51040
2456,1817,639,767,231100,51041
95,83,12,542,83300,51044
40,36,4,-,180300,51045
699,523,176,801,149700,51046
300,272,28,625,119600,51047
193,132,61,808,112000,51048
262,231,31,668,83800,51049
1038,861,177,821,205100,51050
26,24,2,-,-,51051
454,368,86,800,217000,51052
462,414,48,775,100800,51053
1886,1408,478,1155,267600,51054
507,394,113,938,185400,51055
195,190,5,692,101000,51056
429,353,76,438,95800,51058
301,231,70,625,102000,51060
165,132,33,525,90000,51061
214,187,27,925,307600,51062
485,365,120,863,105400,51063
526,56,470,544,219600,51101
6431,4017,2414,883,118000,51103
8361,5484,2877,949,179500,51104
3898,1703,2195,809,86000,51105
10990,7977,3013,967,175200,51106
2074,1844,230,1049,152700,51108
1544,1248,296,965,127700,51109
52,0,52,981,-,51111
2407,1728,679,639,165900,51201
202,202,0,-,166200,51230
182,177,5,-,184700,51231
331,264,67,1000,97000,51232
407,364,43,775,185600,51234
346,280,66,600,193800,51235
722,594,128,771,114500,51237
508,445,63,641,160900,51238
1058,942,116,798,224200,51239
629,542,87,1010,159000,51240
828,688,140,793,296900,51241
128,110,18,-,170000,51242
253,234,19,663,88800,51243
59,56,3,-,105000,51244
423,346,77,757,115400,51245
1335,1100,235,756,221600,51246
1852,1408,444,892,210700,51247
703,548,155,852,130000,51248
1400,1027,373,727,143300,51249
3195,2477,718,793,261700,51250
5541,3900,1641,739,160600,51301
588,503,85,658,316700,51331
177,152,25,977,195000,51333
2840,2139,701,736,102400,51334
406,321,85,703,122800,51338
50,48,2,-,82000,51340
14,14,0,-,62900,51341
555,439,116,563,84300,51342
73,61,12,-,162500,51343
202,97,105,941,136500,51345
877,685,192,731,104600,51346
659,602,57,923,153300,51347
180,139,41,463,76900,51350
2094,1627,467,820,244700,51351
519,451,68,848,98900,51354
504,376,128,910,425000,51355
306,221,85,790,87600,51357
552,441,111,685,128700,51358
4045,3040,1005,925,239300,51360
63,62,1,-,72100,51363
311,261,50,850,123000,51364
160,129,31,617,114500,51365
128,108,20,-,111500,51366
5205,3707,1498,696,182000,51401
365,272,93,762,147900,51430
214,148,66,622,94400,51431
16,15,1,-,76400,51432
215,123,92,724,76100,51433
387,282,105,741,195000,51436
350,236,114,703,84700,51439
104,99,5,-,136700,51440
152,134,18,638,96100,51441
3459,2405,1054,775,123600,51442
572,501,71,550,167600,51443
129,127,2,-,140300,51444
1171,957,214,648,116900,51445
226,205,21,575,103100,51446
66,62,4,1167,250000,51447
245,197,48,748,104200,51448
800,632,168,719,104400,51449
646,564,82,545,166500,51450
34,33,1,-,79200,51451
73,59,14,436,122500,51452
223,172,51,911,96700,51453
501,409,92,611,135200,51454
1038,835,203,563,123400,51455
501,421,80,601,103300,51458
28,20,8,725,78000,51459
38,24,14,742,45000,51460
504,383,121,489,133900,51461
407,302,105,876,126800,51462
237,222,15,675,139600,51463
260,221,39,617,104300,51465
471,414,57,594,180400,51466
233,214,19,700,154600,51467
14284,9292,4992,979,130300,51501
14856,10064,4792,951,229900,51503
1351,1088,263,1099,137700,51510
82,74,8,750,-,51520
845,653,192,804,174500,51521
142,119,23,-,99500,51523
445,355,90,656,171800,51525
628,549,79,-,277600,51526
169,153,16,671,134200,51527
284,196,88,683,95000,51528
825,593,232,817,132900,51529
303,223,80,684,128800,51530
308,230,78,600,143800,51531
290,219,71,692,82900,51532
372,298,74,983,139800,51533
3410,2736,674,774,243900,51534
721,615,106,900,128300,51535
178,148,30,950,115800,51536
2837,2088,749,1036,155600,51537
134,118,16,-,166700,51540
121,90,31,958,161800,51541
378,354,24,1625,333700,51542
164,131,33,575,101800,51543
304,269,35,656,82400,51544
113,83,30,485,53900,51545
1155,904,251,859,181000,51546
181,166,15,-,219400,51548
179,142,37,789,167900,51549
58,53,5,-,103100,51550
610,475,135,921,178700,51551
104,73,31,683,143100,51552
377,331,46,694,204400,51553
28,28,0,-,138600,51554
2019,1482,537,767,157200,51555
181,160,21,950,133300,51556
367,326,41,888,145600,51557
259,215,44,1071,73800,51558
730,537,193,929,185600,51559
739,497,242,750,151100,51560
305,279,26,1042,338400,51561
186,172,14,-,167800,51562
286,206,80,1074,184100,51563
206,171,35,738,84800,51564
242,150,92,764,121800,51565
3004,2037,967,721,103600,51566
465,325,140,860,165300,51570
216,184,32,928,196900,51571
224,181,43,575,130400,51572
413,347,66,673,106400,51573
662,547,115,1023,235200,51575
705,649,56,840,291700,51576
506,377,129,790,121100,51577
58,51,7,475,93900,51578
774,619,155,843,179500,51579
2320,1472,848,759,110400,51601
50,50,0,-,-,51630
162,132,30,870,122700,51631
2537,1753,784,647,124300,51632
197,176,21,619,112000,51636
102,97,5,742,71900,51637
609,473,136,667,100200,51638
338,254,84,620,134900,51639
638,498,140,686,119600,51640
99,85,14,-,113900,51645
311,259,52,753,89200,51646
112,97,15,-,-,51647
134,95,39,843,137100,51648
131,114,17,1028,163500,51649
134,115,19,769,38900,51650
64,59,5,938,69500,51651
586,449,137,708,125900,51652
524,432,92,663,205200,51653
127,96,31,1331,214800,51654
14,11,3,-,85000,51656
18253,11474,6779,896,158700,52001
6992,5195,1797,993,258000,52002
5523,4766,757,936,255000,52003
160,107,53,930,116300,52030
2175,1897,278,704,215100,52031
601,536,65,380,241700,52032
1326,1013,313,850,193000,52033
493,408,85,694,134300,52035
66,46,20,589,136900,52036
372,339,33,621,169600,52037
186,162,24,725,160400,52038
332,327,5,-,235500,52039
2317,2041,276,1008,211500,52040
658,548,110,713,202400,52041
605,440,165,825,186300,52042
876,660,216,790,133600,52043
85,81,4,-,-,52044
1080,857,223,840,233100,52045
934,742,192,962,248000,52046
266,219,47,603,104500,52047
108,81,27,430,101100,52048
519,428,91,793,152800,52049
196,148,48,793,159400,52050
1318,1086,232,756,190900,52052
448,348,100,-,225000,52053
327,280,47,1095,193400,52054
86,83,3,-,162000,52056
3390,2785,605,754,143800,52057
3434,2589,845,703,136600,52060
323,269,54,822,135600,52064
289,256,33,1025,197400,52065
43,35,8,-,83000,52066
1617,1476,141,914,328800,52068
591,442,149,738,158200,52069
500,407,93,593,170600,52070
74,64,10,-,208900,52071
187,98,89,-,112500,52072
587,508,79,936,241800,52073
110,90,20,1319,221900,52074
59,54,5,-,131300,52075
945,680,265,636,134300,52076
127,113,14,775,75000,52077
297,258,39,675,207400,52078
322,299,23,544,229800,52079
5077,3687,1390,771,237800,52101
740,519,221,692,212700,52132
261,244,17,731,188600,52133
113,109,4,-,203100,52134
292,251,41,565,116100,52135
2289,1734,555,803,148500,52136
215,205,10,-,172200,52140
514,457,57,646,91500,52141
676,414,262,816,126500,52142
475,430,45,1125,193800,52144
441,394,47,728,201400,52146
399,348,51,738,165800,52147
866,714,152,588,136400,52151
305,240,65,625,153800,52154
482,394,88,668,117300,52155
226,199,27,917,200800,52156
724,531,193,734,163500,52157
163,134,29,609,114300,52158
1076,778,298,909,142300,52159
436,366,70,-,195300,52160
607,509,98,704,155300,52161
1302,929,373,803,114100,52162
142,133,9,592,89400,52163
127,117,10,767,123800,52164
467,414,53,608,261700,52165
54,54,0,-,87500,52166
190,119,71,884,151000,52168
182,143,39,716,113400,52169
249,230,19,575,220500,52170
405,308,97,754,120200,52171
2600,1987,613,734,151300,52172
1495,1010,485,797,147500,52175
573,454,119,769,141700,52201
485,372,113,727,220800,52202
872,768,104,695,249000,52203
3067,2468,599,720,197800,52205
896,837,59,480,277100,52206
139,133,6,-,57500,52207
1230,1043,187,680,118600,52208
416,327,89,717,166000,52209
278,212,66,960,156700,52210
1165,872,293,905,154600,52211
192,184,8,-,121700,52212
1567,1298,269,847,229900,52213
1143,952,191,929,228400,52214
382,347,35,485,145800,52215
648,443,205,843,154800,52216
229,208,21,933,93100,52217
653,618,35,625,170700,52218
70,59,11,850,103400,52219
85,67,18,-,205000,52220
135,111,24,1324,208900,52221
299,256,43,408,116400,52222
513,442,71,790,179900,52223
820,656,164,717,163400,52224
184,184,0,-,121900,52225
1111,919,192,923,292300,52227
1315,1189,126,1352,283600,52228
324,262,62,856,165700,52229
156,140,16,731,205600,52231
90,80,10,756,225000,52232
2968,1957,1011,818,188400,52233
399,261,138,1179,214100,52235
211,211,0,-,183100,52236
554,475,79,340,156500,52237
15245,7672,7573,1080,226300,52240
9584,5169,4415,1022,271800,52241
41,0,41,-,-,52242
9312,5720,3592,1237,279300,52245
9842,4025,5817,1000,305400,52246
1913,1382,531,819,244700,52247
750,660,90,690,136300,52248
377,319,58,912,143000,52249
211,189,22,492,107900,52251
31,31,0,-,-,52252
1021,838,183,725,216600,52253
380,241,139,928,94200,52254
555,446,109,923,137900,52255
96,80,16,-,-,52257
1693,1323,370,722,139400,52301
17344,13603,3741,897,211000,52302
288,230,58,756,141700,52305
593,467,126,572,147300,52306
48,8,40,-,-,52307
87,74,13,525,98600,52308
253,225,28,775,138500,52309
2687,2091,596,671,170000,52310
27,26,1,-,57500,52312
163,134,29,883,182800,52313
1703,1430,273,746,254900,52314
513,419,94,538,170900,52315
541,426,115,674,116900,52316
8457,6184,2273,1200,292600,52317
422,342,80,1067,185000,52318
470,356,114,735,124200,52320
171,138,33,766,110200,52321
765,621,144,923,267800,52322
393,323,70,722,97600,52323
785,709,76,878,305400,52324
229,203,26,695,251000,52325
277,224,53,739,118700,52326
1432,1062,370,1102,265700,52327
1016,944,72,1000,325400,52328
305,258,47,689,162100,52329
378,245,133,583,142200,52330
691,618,73,881,235200,52332
2702,2376,326,1202,332900,52333
93,93,0,-,257000,52334
240,191,49,722,103100,52335
1034,879,155,910,194500,52336
328,237,91,947,131600,52337
1380,1292,88,1052,357900,52338
1481,946,535,811,107400,52339
1955,1657,298,1189,297100,52340
376,360,16,-,428600,52341
1188,801,387,915,123000,52342
65,39,26,-,-,52344
527,466,61,763,204000,52345
418,358,60,922,241400,52346
525,468,57,696,118100,52347
37,36,1,-,80700,52348
3207,2540,667,791,177900,52349
514,473,41,842,263800,52351
689,595,94,525,187700,52352
3575,2273,1302,907,145900,52353
111,111,0,-,185600,52354
119,104,15,663,100000,52355
1080,777,303,825,196700,52356
1589,1317,272,950,210000,52358
143,137,6,-,209200,52359
2044,1351,693,775,189500,52361
381,332,49,713,116800,52362
1275,236,1039,744,135000,52401
18247,12240,6007,948,175100,52402
10213,7816,2397,790,170500,52403
17404,11757,5647,858,155700,52404
11462,8699,2763,943,165300,52405
2847,2809,38,-,416600,52411
12202,7744,4458,919,101100,52501
358,304,54,552,170000,52530
2388,1899,489,699,134000,52531
463,378,85,643,101100,52533
175,141,34,675,71400,52534
407,332,75,1011,131300,52535
354,302,52,584,120700,52536
2525,2101,424,830,144900,52537
503,375,128,742,97900,52540
195,169,26,1042,97500,52542
123,114,9,-,110900,52543
3308,2100,1208,756,110900,52544
31,29,2,-,80600,52548
196,179,17,738,109900,52549
293,276,17,600,109900,52550
255,223,32,-,100600,52551
325,283,42,840,190300,52552
705,569,136,915,152700,52553
534,469,65,-,84700,52554
81,52,29,1045,86700,52555
5292,3279,2013,845,149700,52556
0,0,0,-,-,52557
97,94,3,-,109200,52560
390,243,147,575,100300,52561
36,32,4,-,58900,52562
583,464,119,710,110500,52563
772,640,132,545,117000,52565
84,76,8,-,56700,52566
224,167,57,840,165700,52567
38,33,5,-,76300,52568
311,306,5,-,77600,52569
312,273,39,564,93800,52570
563,497,66,730,150500,52571
404,282,122,686,81100,52572
68,61,7,-,153800,52573
216,169,47,860,76300,52574
141,132,9,542,175000,52576
5712,3664,2048,817,138200,52577
308,260,48,719,107400,52580
110,66,44,730,139300,52581
163,140,23,-,126500,52583
217,207,10,900,95100,52584
319,239,80,779,115800,52585
269,189,80,-,111500,52586
21,21,0,-,-,52588
434,363,71,641,97700,52590
1164,791,373,843,119200,52591
67,55,12,-,227500,52593
170,165,5,-,120400,52594
218,131,87,745,88700,52595
12727,8805,3922,891,121500,52601
249,241,8,-,148000,52619
311,242,69,346,159500,52620
299,246,53,979,145800,52621
771,665,106,864,184800,52623
243,207,36,-,208300,52624
867,732,135,730,173100,52625
502,407,95,750,79700,52626
5405,4094,1311,812,107900,52627
104,65,39,950,49700,52630
22,22,0,-,187500,52631
5199,3470,1729,763,101500,52632
358,227,131,965,-,52635
1148,878,270,813,168100,52637
207,156,51,710,163200,52638
696,635,61,789,136600,52639
511,460,51,831,124500,52640
4675,3336,1339,752,154300,52641
183,150,33,568,159800,52644
1402,1090,312,756,136100,52645
134,125,9,775,132800,52646
65,35,30,725,123600,52647
291,269,22,721,194500,52649
335,249,86,1079,254900,52650
165,157,8,725,75000,52651
27,27,0,-,-,52652
1346,922,424,767,127800,52653
569,450,119,650,134700,52654
1703,1033,670,870,149300,52655
1015,901,114,523,186800,52656
31,27,4,-,156300,52657
399,360,39,1141,189800,52658
566,449,117,660,109800,52659
135,92,43,-,213800,52660
46,26,20,-,112500,52701
354,279,75,940,192400,52720
320,245,75,825,163200,52721
16286,12471,3815,1063,278500,52722
2264,2076,188,1048,270800,52726
163,117,46,682,244200,52727
392,301,91,758,123800,52728
346,300,46,625,148000,52729
2159,1627,532,791,167700,52730
323,274,49,883,141800,52731
10993,7538,3455,753,116400,52732
120,117,3,-,100400,52737
1132,871,261,575,134900,52738
313,224,89,875,104100,52739
2893,2349,544,877,223700,52742
231,193,38,817,183800,52745
422,338,84,-,275000,52746
861,663,198,794,202100,52747
3697,2932,765,883,278200,52748
367,347,20,-,215800,52749
178,159,19,-,154600,52750
396,306,90,848,162200,52751
193,165,28,783,107200,52752
2257,1728,529,945,304600,52753
564,518,46,880,196500,52754
805,685,120,895,210900,52755
578,563,15,1500,321200,52756
113,100,13,750,117100,52757
108,92,16,1313,166700,52758
65,53,12,-,80600,52759
343,273,70,-,136200,52760
11875,8788,3087,936,153100,52761
174,144,30,1171,188500,52765
343,310,33,1272,124000,52766
115,104,11,-,-,52767
477,413,64,745,244500,52768
215,173,42,635,261000,52769
37,10,27,-,-,52771
2167,1763,404,724,185700,52772
1035,798,237,818,183200,52773
49,37,12,883,106300,52774
1781,1304,477,942,172200,52776
508,437,71,731,114200,52777
1610,1215,395,783,154600,52778
995,0,995,853,-,52801
3792,2779,1013,948,83100,52802
8956,6098,2858,870,147700,52803
11267,7213,4054,904,143500,52804
11347,7727,3620,928,181000,52806
7350,3715,3635,874,308800,52807
811,676,135,768,228500,53001
953,787,166,853,283300,53002
43,43,0,-,185400,53003
1477,1307,170,867,231400,53004
8303,7098,1205,1781,368300,53005
776,638,138,955,206900,53006
863,354,509,964,201300,53007
3018,2525,493,937,267600,53010
874,764,110,850,227600,53011
7625,5902,1723,1026,366300,53012
1388,1232,156,857,245500,53013
3414,2834,580,806,188700,53014
1090,969,121,924,190900,53015
163,118,45,883,126400,53016
1842,1815,27,-,413300,53017
3176,2418,758,1503,450100,53018
729,615,114,810,223600,53019
1516,1280,236,1073,304100,53020
1716,1396,320,963,271200,53021
7952,6223,1729,1270,330900,53022
544,502,42,800,188700,53023
8332,5581,2751,1114,326200,53024
9562,6937,2625,1005,275400,53027
8269,6574,1695,1087,424700,53029
22,10,12,-,-,53031
2262,1640,622,791,169100,53032
2406,2316,90,1414,376300,53033
654,460,194,872,203900,53034
911,803,108,1119,247500,53035
1215,992,223,1106,333600,53036
4293,3089,1204,1160,286300,53037
1592,1289,303,1104,287500,53038
1643,1260,383,815,208800,53039
3235,2711,524,944,282800,53040
2770,2242,528,878,199500,53042
849,786,63,1188,335400,53044
9670,7493,2177,1717,410400,53045
637,540,97,576,213300,53046
59,50,9,910,228200,53047
1499,907,592,1041,209100,53048
940,802,138,755,248100,53049
3032,2382,650,765,172900,53050
15963,11959,4004,1217,312100,53051
703,664,39,763,220400,53057
1240,906,334,1371,474600,53058
756,639,117,798,293500,53059
2183,1714,469,705,168100,53061
688,598,90,548,235200,53063
887,782,105,935,241000,53065
14858,11721,3137,1201,375800,53066
351,327,24,-,403300,53069
1847,1575,272,907,250400,53070
12087,9265,2822,1285,380100,53072
6251,4717,1534,853,222000,53073
5649,3738,1911,1049,254500,53074
1407,1072,335,877,254800,53075
1162,1096,66,-,415700,53076
764,672,92,1026,334700,53078
571,453,118,1026,223200,53079
2394,1401,993,889,265700,53080
18792,11267,7525,847,156800,53081
8891,6790,2101,959,216200,53083
5115,3793,1322,823,209600,53085
3902,2937,965,1074,326400,53086
128,87,41,665,157600,53088
7486,5899,1587,1259,363200,53089
8821,6788,2033,1087,245100,53090
876,716,160,982,177300,53091
8361,6472,1889,1757,416300,53092
759,708,51,771,217200,53093
7096,4607,2489,999,208900,53094
12039,8579,3460,970,272200,53095
2339,2230,109,1934,500000,53097
4364,3017,1347,1103,231500,53098
1,1,0,-,-,53099
1549,1447,102,1036,359500,53103
2139,1924,215,1391,292600,53104
11995,8575,3420,978,290400,53105
1301,1233,68,-,275200,53108
8603,5346,3257,949,189000,53110
846,710,136,843,210200,53114
6619,4688,1931,969,206200,53115
2911,2540,371,1318,360600,53118
2185,2047,138,1097,353100,53119
4344,3326,1018,1326,295200,53120
7698,5613,2085,970,261100,53121
2199,1962,237,1424,434300,53122
766,654,112,1348,561700,53125
2798,2439,359,1077,326000,53126
47,38,9,-,-,53127
3255,2733,522,1253,220300,53128
6121,4212,1909,1152,272000,53129
3138,1744,1394,1295,275300,53130
14016,10984,3032,1304,333100,53132
600,558,42,975,315600,53137
909,812,97,1316,260300,53139
12671,6415,6256,977,179100,53140
12973,9626,3347,1292,236300,53142
8439,5010,3429,1127,168400,53143
10169,5414,4755,1058,233600,53144
3140,3032,108,1047,302400,53146
8084,5467,2617,1106,307900,53147
7281,6201,1080,1085,365200,53149
10385,9134,1251,1223,370200,53150
14067,10262,3805,1385,326400,53151
1035,970,65,1064,371800,53153
15346,9050,6296,1312,282500,53154
1408,1069,339,741,219200,53156
0,0,0,-,-,53157
6791,5263,1528,1388,324800,53158
202,67,135,931,331600,53167
3716,3051,665,1247,267100,53168
840,668,172,929,254900,53170
8543,5562,2981,979,200500,53172
45,45,0,-,-,53176
2602,2069,533,1258,220400,53177
1084,779,305,892,304700,53178
2622,2175,447,1059,258300,53179
3475,2791,684,1070,267400,53181
3163,2282,881,1005,285900,53182
1076,911,165,1407,360600,53183
1509,932,577,1035,259400,53184
7381,6139,1242,1134,335500,53185
14702,8027,6675,1111,256800,53186
14095,9340,4755,1169,292300,53188
10218,8350,1868,1154,355900,53189
6962,3126,3836,926,234100,53190
1421,1117,304,793,325800,53191
96,95,1,-,-,53192
53,46,7,817,187500,53195
16717,3561,13156,1164,287100,53202
1269,136,1133,1714,412800,53203
13391,3500,9891,891,93900,53204
3452,886,2566,771,118500,53205
7704,2519,5185,936,61400,53206
16393,9784,6609,1084,206200,53207
11636,4660,6976,868,178300,53208
19443,8215,11228,952,123200,53209
9186,3440,5746,992,133600,53210
15316,6222,9094,1186,391700,53211
13327,4432,8895,985,187800,53212
12151,7106,5045,1171,298600,53213
16016,8277,7739,947,165900,53214
19549,9272,10277,888,132400,53215
12304,5553,6751,950,113100,53216
11664,8791,2873,1416,406300,53217
14403,5987,8416,990,108400,53218
14975,9371,5604,918,174000,53219
11958,6868,5090,1014,205200,53220
16500,9377,7123,1029,186900,53221
10693,7115,3578,991,185400,53222
12229,6143,6086,1022,171100,53223
7923,3932,3991,1121,170400,53224
9956,3992,5964,1052,165600,53225
8151,4910,3241,1310,286000,53226
10705,5083,5622,999,196100,53227
7143,3635,3508,1209,239400,53228
4506,146,4360,835,88700,53233
4870,2451,2419,882,196200,53235
0,0,0,-,-,53295
14571,10235,4336,1007,208700,53402
10711,5861,4850,1006,155900,53403
4872,2220,2652,933,120600,53404
10908,8462,2446,976,158900,53405
11432,8305,3127,963,245700,53406
150,50,100,-,-,53501
1006,814,192,840,225900,53502
831,681,150,943,212500,53503
924,754,170,618,184100,53504
164,136,28,1583,254300,53505
402,331,71,816,143100,53506
854,692,162,1115,320200,53507
2380,2041,339,964,293600,53508
548,423,125,733,196300,53510
18569,12085,6484,964,144200,53511
1084,899,185,943,311200,53515
927,780,147,634,246900,53516
750,555,195,1125,399600,53517
659,595,64,769,142300,53518
2898,2180,718,742,197000,53520
1422,1224,198,1139,346800,53521
380,304,76,750,173900,53522
2129,1767,362,1052,285300,53523
1628,1236,392,1002,210700,53525
234,204,30,950,143500,53526
4422,3582,840,1470,356700,53527
2500,1950,550,1201,407300,53528
921,654,267,775,345600,53529
1852,1427,425,874,147200,53530
1511,1229,282,948,321600,53531
6158,5003,1155,1280,301600,53532
3144,2234,910,966,229500,53533
4731,3554,1177,1073,261700,53534
3808,3057,751,894,252700,53536
385,289,96,812,137000,53537
7713,5910,1803,997,221200,53538
54,33,21,1063,81700,53540
378,317,61,755,213000,53541
710,604,106,641,192400,53543
321,265,56,838,323600,53544
10774,7018,3756,971,184300,53545
12075,8776,3299,1030,198600,53546
8314,5596,2718,987,197300,53548
4381,3187,1194,971,227300,53549
431,358,73,833,196700,53550
3554,2682,872,1074,287200,53551
266,226,40,379,156600,53553
372,323,49,775,163200,53554
3832,3241,591,1262,348200,53555
1067,878,189,760,162300,53556
193,150,43,725,164600,53557
5126,4071,1055,1372,357900,53558
2376,1824,552,1039,273700,53559
1509,1269,240,1037,305900,53560
776,680,96,968,370600,53561
12857,7219,5638,1339,468800,53562
4490,3689,801,932,254100,53563
1910,1490,420,706,237200,53565
6612,4547,2065,805,183400,53566
391,328,63,870,167600,53569
1186,871,315,824,218800,53570
68,0,68,-,-,53571
3758,2822,936,1175,354400,53572
1254,990,264,647,149400,53573
1540,1260,280,952,281700,53574
6857,5349,1508,1161,358300,53575
970,719,251,-,185600,53576
532,404,128,962,228500,53577
2630,1907,723,1095,317900,53578
627,479,148,859,201700,53579
186,131,55,963,120200,53580
4236,3034,1202,703,158600,53581
440,372,68,905,225000,53582
2518,2046,472,898,283700,53583
10,10,0,-,-,53584
848,567,281,968,189200,53585
824,670,154,843,150500,53586
485,397,88,688,163500,53587
1685,1381,304,957,246400,53588
8654,6659,1995,1097,298300,53589
17313,11667,5646,1315,330100,53590
11250,8339,2911,1474,439100,53593
2200,1601,599,944,218300,53594
8058,5928,2130,1274,428700,53597
1438,875,563,1506,356900,53598
56,47,9,-,88100,53599
19486,2529,16957,1354,461600,53703
21612,11732,9880,1182,268400,53704
12178,5971,6207,1240,427400,53705
7,0,7,-,-,53706
21955,13501,8454,1316,369300,53711
11190,3534,7656,1103,241000,53713
7738,4455,3283,1157,251800,53714
5217,1048,4169,1502,410700,53715
8389,6090,2299,1223,296300,53716
6210,3428,2782,1306,366000,53717
7843,4597,3246,1468,309600,53718
15207,7734,7473,1350,337200,53719
2425,930,1495,1408,586600,53726
0,0,0,-,-,53792
424,336,88,-,125500,53801
29,19,10,-,-,53802
523,393,130,794,142500,53803
517,439,78,640,157900,53804
2111,1484,627,675,143300,53805
774,657,117,632,124000,53806
1715,1416,299,733,200600,53807
391,265,126,722,167300,53808
1734,1258,476,721,171700,53809
130,105,25,625,144200,53810
1267,850,417,913,220500,53811
112,112,0,-,215800,53812
2325,1770,555,802,188600,53813
275,226,49,796,197500,53816
125,102,23,675,136500,53817
5620,2904,2716,878,199400,53818
933,786,147,754,180400,53820
3093,2077,1016,811,147600,53821
185,147,38,700,188200,53825
559,442,117,653,149400,53826
141,126,15,850,153300,53827
6004,3913,2091,939,200100,53901
1512,957,555,668,107700,53910
535,437,98,1174,274600,53911
9559,6481,3078,907,205900,53913
10371,6566,3805,926,186300,53916
813,665,148,766,193000,53919
213,182,31,956,218200,53920
436,385,51,641,255900,53922
825,642,183,672,194100,53923
561,478,83,775,181800,53924
3608,2538,1070,836,247500,53925
612,470,142,935,188500,53926
47,40,7,-,122700,53928
1112,908,204,830,168300,53929
551,449,102,793,198400,53930
131,101,30,965,119000,53931
922,669,253,1145,261300,53932
1278,849,429,1082,205100,53933
2090,1770,320,771,154000,53934
106,88,18,1042,145600,53935
597,546,51,875,106600,53936
355,305,50,895,205800,53937
118,104,14,725,122300,53939
0,0,0,-,-,53940
1196,1075,121,797,228000,53941
46,37,9,629,122500,53942
423,343,80,906,214500,53943
980,803,177,1000,186900,53944
1724,1422,302,799,226400,53946
122,87,35,790,180500,53947
3319,2502,817,798,155600,53948
2795,2294,501,759,191900,53949
2105,1706,399,777,153000,53950
938,697,241,796,180300,53951
1279,1129,150,855,167000,53952
91,79,12,-,154400,53953
2653,2231,422,850,234500,53954
2381,2014,367,837,277100,53955
1162,947,215,705,193500,53956
5566,4008,1558,892,215800,53959
1327,1068,259,745,243700,53960
389,338,51,1219,198100,53961
19,10,9,481,154200,53962
4887,3306,1581,803,166600,53963
1443,1040,403,769,195000,53964
4922,3762,1160,872,194200,53965
877,706,171,837,182100,53968
108,81,27,-,183900,53969
3144,2558,586,960,217900,54001
2573,2064,509,1028,255900,54002
414,399,15,-,300500,54003
901,767,134,784,214000,54004
1164,960,204,906,229100,54005
346,297,49,619,194900,54006
408,347,61,800,225000,54007
969,827,142,1118,211900,54009
2759,2073,686,934,253400,54011
1479,1197,282,1094,261700,54013
811,728,83,1125,268100,54014
1447,1116,331,877,253600,54015
13003,10577,2426,1349,394200,54016
7350,5382,1968,1017,287000,54017
3250,2444,806,1029,242900,54020
2945,2242,703,1272,294900,54021
8375,5797,2578,1002,322800,54022
1717,1419,298,1568,324000,54023
2115,1601,514,936,237700,54024
2759,2227,532,1005,304500,54025
892,789,103,977,277200,54026
419,387,32,1000,294500,54027
1008,720,288,879,230400,54028
747,673,74,-,443200,54082
1170,1110,60,825,256700,54101
406,365,41,478,137900,54102
199,180,19,930,136500,54103
555,538,17,675,144200,54104
2162,1901,261,761,243600,54106
1377,1123,254,664,181100,54107
2161,1790,371,788,203300,54110
981,830,151,865,196300,54111
1130,851,279,689,162400,54112
1405,1200,205,969,225300,54113
2660,2177,483,656,162300,54114
19357,12894,6463,999,275300,54115
216,171,45,888,158800,54119
106,98,8,-,213600,54120
1457,1302,155,531,162200,54121
84,67,17,-,127100,54123
1383,1141,242,734,124500,54124
216,169,47,584,94600,54125
1516,1354,162,859,225800,54126
26,18,8,-,125000,54127
777,563,214,455,147700,54128
1475,1305,170,944,227800,54129
10986,8384,2602,948,216500,54130
906,606,300,640,121900,54135
2863,1739,1124,820,180100,54136
436,407,29,586,224000,54137
414,369,45,933,183700,54138
1297,1088,209,708,168900,54139
3714,2421,1293,954,183400,54140
1074,1054,20,-,245900,54141
6852,5220,1632,762,122600,54143
583,554,29,-,168900,54149
335,236,99,563,64400,54150
1474,1238,236,732,120800,54151
88,32,56,900,83800,54152
3077,2242,835,787,153900,54153
2360,1666,694,679,182500,54154
2848,1836,1012,1007,304700,54155
664,570,94,850,121100,54156
2610,1966,644,696,154900,54157
562,527,35,797,165300,54159
103,87,16,810,152900,54160
1167,1040,127,683,180600,54161
3380,2681,699,770,242000,54162
2953,2169,784,847,221200,54165
7040,5134,1906,751,158000,54166
1192,1147,45,959,309900,54169
1494,1298,196,771,210900,54170
1379,1287,92,864,272200,54171
1355,1157,198,1293,307700,54173
1380,1226,154,775,157000,54174
598,570,28,675,234900,54175
1313,1097,216,702,161100,54177
1258,966,292,1166,240300,54180
2224,1881,343,794,163900,54201
811,661,150,1228,340400,54202
787,663,124,933,304000,54204
781,732,49,725,217600,54205
72,58,14,-,157500,54207
2258,1918,340,821,230100,54208
733,674,59,1094,374200,54209
390,330,60,768,332600,54210
162,147,15,879,457300,54211
388,354,34,946,438200,54212
568,505,63,618,181300,54213
290,242,48,600,238000,54214
101,67,34,742,143400,54215
2628,2293,335,793,149900,54216
2850,2408,442,891,242300,54217
17248,11875,5373,747,147500,54220
721,673,48,640,219600,54227
1185,959,226,729,160200,54228
2017,1513,504,1104,261600,54229
1726,1547,179,572,196300,54230
522,464,58,650,122800,54232
1047,697,350,1136,381300,54234
8316,6619,1697,946,234800,54235
6464,5118,1346,748,132000,54241
837,701,136,834,191600,54245
426,377,49,775,257200,54246
991,830,161,686,194400,54247
9805,6420,3385,917,193700,54301
13015,6397,6618,808,151200,54302
12172,6017,6155,811,146700,54303
12537,7104,5433,872,175600,54304
0,0,0,-,-,54307
14498,9770,4728,1020,259800,54311
15635,12928,2707,993,278700,54313
13133,8627,4506,920,173800,54401
10359,6963,3396,894,173200,54403
998,687,311,835,137500,54405
1594,1358,236,825,248800,54406
540,488,52,1035,262900,54407
492,434,58,658,164300,54408
5597,3997,1600,731,116000,54409
862,807,55,636,184600,54410
1921,1656,265,738,192100,54411
786,688,98,644,191000,54412
93,82,11,-,112500,54413
1344,1128,216,679,171400,54414
647,533,114,494,123600,54416
5,5,0,-,-,54417
346,315,31,679,163200,54418
487,384,103,543,178600,54420
1252,921,331,783,161800,54421
421,302,119,765,125000,54422
772,745,27,788,275800,54423
658,626,32,788,210300,54424
720,533,187,752,157300,54425
1740,1478,262,812,184800,54426
466,406,60,798,162500,54427
455,386,69,445,141700,54428
44,41,3,-,135900,54430
697,594,103,675,172700,54433
838,753,85,746,197800,54435
767,623,144,725,149400,54436
1171,892,279,681,149500,54437
1092,973,119,775,194300,54440
349,319,30,725,206600,54441
586,501,85,931,225700,54442
858,781,77,835,258500,54443
1155,912,243,793,150200,54446
202,170,32,742,137500,54447
1662,1471,191,779,227100,54448
11518,8059,3459,799,180400,54449
166,148,18,1125,79100,54450
4372,3332,1040,806,182100,54451
8140,6260,1880,705,147200,54452
534,461,73,714,169700,54454
7640,6088,1552,915,220000,54455
2471,1975,496,696,154400,54456
3772,3266,506,706,155200,54457
50,39,11,888,112500,54458
558,515,43,900,114200,54459
926,759,167,765,142800,54460
163,150,13,825,182200,54462
433,316,117,759,221300,54463
19,14,5,-,78800,54464
350,339,11,-,221700,54465
1100,944,156,713,165700,54466
6195,3831,2364,978,223200,54467
711,574,137,870,130600,54469
833,676,157,673,140300,54470
591,567,24,1375,250900,54471
1008,876,132,708,217900,54473
1793,1196,597,826,168900,54474
583,537,46,593,162100,54475
8303,5179,3124,919,197300,54476
1370,1093,277,492,164000,54479
536,456,80,706,158300,54480
11708,6720,4988,840,178000,54481
4067,3339,728,988,240200,54482
2420,2115,305,948,214300,54484
165,165,0,-,218400,54485
889,754,135,831,138400,54486
4241,3601,640,693,206800,54487
469,365,104,754,128000,54488
631,519,112,900,151500,54489
381,352,29,663,164700,54490
721,548,173,662,147200,54491
276,254,22,850,186700,54493
11730,8954,2776,932,162900,54494
3492,1928,1564,816,118900,54495
808,620,188,886,131700,54498
1139,876,263,701,164500,54499
8844,7197,1647,811,172200,54501
581,525,56,679,146500,54511
619,505,114,719,249700,54512
253,235,18,650,153100,54513
887,737,150,592,150200,54514
278,248,30,1000,102100,54515
84,84,0,-,328600,54517
614,538,76,1066,229400,54519
1537,1125,412,565,162500,54520
3867,3232,635,861,246000,54521
357,239,118,497,153600,54524
122,93,29,744,102700,54525
307,266,41,814,99800,54526
444,375,69,544,111400,54527
442,418,24,-,245100,54529
337,307,30,333,102700,54530
563,538,25,964,298500,54531
1198,936,262,613,100900,54534
90,78,12,725,67000,54536
240,213,27,-,99100,54537
1282,899,383,526,274100,54538
538,499,39,781,239200,54539
451,397,54,716,247600,54540
489,399,90,641,155800,54541
261,235,26,-,138000,54542
474,382,92,1084,635200,54545
494,419,75,618,116200,54546
689,597,92,630,258300,54547
2633,1971,662,940,285100,54548
286,273,13,781,106300,54550
2188,1678,510,702,125700,54552
508,443,65,675,213000,54554
2178,1674,504,792,164700,54555
524,435,89,800,115200,54556
499,486,13,1036,394800,54557
1113,898,215,900,215300,54558
403,311,92,460,152600,54559
288,274,14,1071,213200,54560
13,13,0,-,225000,54561
863,770,93,829,295100,54562
321,291,30,775,175300,54563
206,179,27,425,162500,54564
24,23,1,-,88800,54565
671,569,102,542,164900,54566
2154,1845,309,793,246100,54568
21352,11652,9700,965,201700,54601
6615,3343,3272,897,164200,54603
690,522,168,844,179600,54610
468,368,100,875,141100,54611
2137,1445,692,951,180400,54612
956,817,139,677,154400,54613
1004,790,214,862,218200,54614
4303,2963,1340,736,174300,54615
996,762,234,802,158600,54616
820,636,184,838,157200,54618
1328,1142,186,827,197000,54619
460,362,98,830,234200,54621
906,814,92,675,178000,54622
824,704,120,971,219600,54623
720,633,87,758,161700,54624
231,203,28,690,160800,54625
586,466,120,728,210400,54626
855,726,129,758,207200,54627
440,398,42,596,181800,54628
1069,888,181,1032,196300,54629
1704,1318,386,960,232800,54630
734,565,169,807,159500,54631
461,409,52,708,215100,54632
1544,1252,292,736,170600,54634
649,561,88,875,173900,54635
6114,4623,1491,1090,275100,54636
75,50,25,658,140000,54637
592,512,80,584,229400,54638
1013,805,208,654,167400,54639
820,700,120,944,174400,54642
2,2,0,-,-,54643
518,461,57,658,251800,54644
58,35,23,625,112500,54645
1535,1327,208,759,135600,54646
566,448,118,729,163300,54648
10714,7248,3466,1063,257800,54650
424,342,82,663,191300,54651
383,301,82,711,135100,54652
463,362,101,985,233800,54653
58,57,1,-,69100,54654
635,497,138,715,205400,54655
7022,4977,2045,917,188100,54656
123,82,41,775,150000,54657
1029,851,178,1118,224000,54658
473,377,96,739,163700,54659
6802,4415,2387,930,173600,54660
1591,1174,417,1052,243900,54661
602,503,99,942,153000,54664
3594,2622,972,788,201400,54665
1063,847,216,961,186100,54666
1893,1593,300,914,195000,54667
3095,2393,702,1125,261100,54669
528,484,44,764,206700,54670
16820,10031,6789,909,242600,54701
17960,11465,6495,956,207100,54703
3663,2141,1522,983,222000,54720
495,418,77,869,173500,54721
1419,1130,289,786,207200,54722
441,360,81,830,172000,54723
2814,2270,544,803,196700,54724
1293,1099,194,803,185400,54725
709,557,152,825,161800,54726
1943,1513,430,736,194200,54727
2449,2084,365,854,188800,54728
14442,9987,4455,947,242600,54729
2095,1597,498,694,209900,54730
309,258,51,786,136100,54731
1078,904,174,760,156500,54732
493,411,82,788,145600,54733
318,277,41,1083,194600,54734
1815,1430,385,722,160100,54736
208,169,39,961,218000,54737
1296,945,351,886,256100,54738
1908,1414,494,1007,229300,54739
773,617,156,955,192900,54740
663,553,110,727,144300,54741
1742,1535,207,1022,255500,54742
947,797,150,880,227200,54745
283,234,49,875,112000,54746
1053,719,334,851,174100,54747
591,502,89,939,192500,54748
575,418,157,900,201800,54749
436,388,48,775,265800,54750
9653,5433,4220,914,219400,54751
585,485,100,850,148900,54754
2934,2166,768,798,192000,54755
412,331,81,716,185200,54756
1464,1294,170,802,205000,54757
1949,1536,413,830,204700,54758
619,500,119,840,186300,54759
74,42,32,822,180000,54760
452,310,142,748,176900,54761
501,408,93,758,154700,54762
446,355,91,604,149700,54763
718,626,92,821,148300,54766
1393,1164,229,877,215200,54767
1807,1258,549,791,175000,54768
240,222,18,820,276800,54769
811,679,132,914,199000,54770
1482,1192,290,750,162600,54771
425,357,68,900,186900,54772
1319,978,341,729,165800,54773
2781,2105,676,793,186000,54801
663,526,137,752,157200,54805
4901,3418,1483,691,155200,54806
1127,940,187,1073,235400,54810
2257,1536,721,617,157600,54812
254,229,25,735,217200,54813
1306,958,348,628,232400,54814
976,852,124,596,248000,54817
1033,829,204,639,145500,54819
387,331,56,824,207300,54820
706,619,87,770,239400,54821
1960,1512,448,919,210100,54822
957,732,225,725,173600,54824
295,264,31,907,197700,54826
169,169,0,-,240800,54827
337,273,64,432,206300,54828
2288,1799,489,884,196300,54829
1614,1464,150,779,221600,54830
215,164,51,747,215900,54832
444,358,86,537,156300,54835
385,373,12,675,196500,54836
1540,1281,259,811,191700,54837
507,470,37,920,211800,54838
142,127,15,1172,146100,54839
1776,1484,292,788,165200,54840
138,106,32,-,130800,54841
77,71,6,-,187500,54842
5832,4282,1550,678,220900,54843
130,116,14,1313,240000,54844
47,41,6,-,99300,54845
265,240,25,775,136400,54846
1129,882,247,963,232400,54847
2695,1888,807,799,125200,54848
831,765,66,780,240600,54849
169,153,16,600,262900,54850
1592,1307,285,840,195000,54853
342,311,31,713,179200,54854
301,257,44,730,155900,54855
679,614,65,959,172500,54856
5,5,0,-,-,54857
751,585,166,665,188600,54858
1069,875,194,841,216400,54859
68,11,57,423,-,54861
136,130,6,-,175000,54862
570,544,26,975,209900,54864
292,248,44,617,176800,54865
186,158,28,650,90000,54867
6663,4656,2007,823,186100,54868
748,699,49,1107,266600,54870
1245,1012,233,833,196600,54871
1169,935,234,725,204400,54872
1471,1324,147,745,219200,54873
1471,1333,138,955,190900,54874
569,498,71,792,149700,54875
745,587,158,908,257900,54876
13203,8114,5089,832,162400,54880
593,519,74,675,213500,54888
1261,937,324,842,216300,54889
1515,1158,357,823,185100,54891
1775,1437,338,623,204300,54893
369,322,47,781,168400,54895
738,642,96,800,179100,54896
13921,7216,6705,870,151700,54901
9729,6094,3635,800,153600,54902
9769,7655,2114,912,249200,54904
802,683,119,908,170100,54909
10416,6160,4256,910,182600,54911
9528,6673,2855,1108,345200,54913
13560,8443,5117,889,190800,54914
17563,12726,4837,913,225800,54915
548,489,59,741,172300,54921
489,423,66,1057,168000,54922
3750,2777,973,786,168400,54923
73,64,9,-,64300,54926
141,110,31,868,256300,54927
171,156,15,1571,193800,54928
3950,3113,837,814,144700,54929
719,596,123,650,165700,54930
160,128,32,542,174400,54931
466,444,22,-,243000,54932
129,67,62,843,99200,54933
17899,10536,7363,848,154800,54935
8445,6398,2047,1002,232300,54937
1837,1626,211,964,264200,54940
1182,937,245,740,236400,54941
3994,3655,339,1037,314200,54942
894,770,124,647,180500,54943
3417,3016,401,835,283000,54944
1564,1263,301,720,183600,54945
0,0,0,-,-,54946
986,896,90,937,248300,54947
83,75,8,825,152100,54948
1503,1164,339,765,179700,54949
1109,888,221,727,139700,54950
11924,7947,3977,874,172900,54952
19365,13409,5956,960,216700,54956
1208,1036,172,758,197700,54960
5920,4207,1713,872,192500,54961
446,394,52,650,179300,54962
3013,2423,590,928,197100,54963
366,327,39,895,236400,54964
536,513,23,975,171900,54965
789,668,121,700,138300,54966
210,160,50,456,180300,54967
1192,951,241,724,165400,54968
1365,1123,242,826,135300,54970
4395,3084,1311,714,167000,54971
610,557,53,650,223200,54974
620,571,49,900,232800,54977
28,27,1,-,-,54978
647,578,69,681,260500,54979
152,143,9,-,163900,54980
6623,4969,1654,808,189200,54981
3076,2475,601,744,175500,54982
1805,1374,431,855,193400,54983
1440,1038,402,846,174400,54984
0,0,0,-,-,54985
2252,1846,406,781,268000,54986
1178,1153,25,-,637200,55001
1165,955,210,1610,351500,55003
1636,1514,122,1521,306000,55005
1400,1107,293,885,195400,55006
972,904,68,937,199400,55007
6331,4945,1386,1221,254100,55008
3301,2696,605,879,309500,55009
3890,3717,173,1771,353700,55011
714,624,90,1294,329200,55012
2649,2091,558,1130,337500,55013
10594,9091,1503,1463,300800,55014
13058,11521,1537,1604,335900,55016
316,288,28,1806,266100,55017
367,319,48,1450,298400,55018
788,761,27,1156,296400,55019
1381,1374,7,-,423100,55020
11435,8054,3381,1047,244700,55021
12458,10994,1464,1275,329600,55024
9937,7447,2490,1300,365100,55025
141,123,18,1250,272700,55026
970,830,140,957,272400,55027
17,13,4,-,109400,55029
498,441,57,893,199400,55030
700,622,78,980,366900,55031
1231,1162,69,1342,314800,55032
11670,9093,2577,1148,308500,55033
21,18,3,-,84000,55036
1940,1532,408,915,181500,55037
8930,7992,938,1785,369800,55038
5161,4452,709,1133,259300,55040
3349,2696,653,971,252000,55041
4514,4163,351,-,559700,55042
1553,1356,197,1391,341700,55043
21080,18413,2667,1648,433800,55044
2818,2578,240,1253,354100,55045
2033,1777,256,1325,305300,55046
965,923,42,2667,462700,55047
899,742,157,795,217100,55049
3854,3125,729,788,204000,55051
731,647,84,1063,263700,55052
351,321,30,1350,315000,55053
852,713,139,1441,399100,55054
1849,1236,613,1074,298500,55055
5390,4666,724,1103,280000,55056
8001,5986,2015,964,314800,55057
12128,9153,2975,929,222200,55060
3835,3173,662,655,223900,55063
465,412,53,1417,349500,55065
8211,6016,2195,917,227600,55066
11249,9782,1467,1513,355200,55068
1999,1550,449,932,253200,55069
2865,2489,376,1022,275500,55070
2359,1789,570,1691,253000,55071
1477,1086,391,1018,166900,55072
1436,1251,185,944,440800,55073
824,750,74,1110,268400,55074
8283,5897,2386,1094,249600,55075
9442,7538,1904,1250,299500,55076
5279,3310,1969,1391,462700,55077
3212,3064,148,1254,313300,55079
1145,1029,116,1379,310300,55080
13995,10988,3007,1455,442700,55082
728,602,126,947,279200,55084
171,155,16,986,271500,55085
155,147,8,567,232400,55087
591,588,3,-,468000,55088
633,580,53,1375,338100,55089
177,149,28,1667,269900,55090
4182,3886,296,1528,312900,55092
4678,1242,3436,1630,244900,55101
10418,4807,5611,1233,267900,55102
5307,2305,3002,986,226100,55103
18392,9869,8523,1065,277300,55104
11339,7580,3759,1196,444800,55105
18767,10844,7923,1172,216300,55106
5567,3243,2324,1117,237000,55107
6656,3639,3017,1313,345100,55108
12721,8305,4416,1262,279300,55109
15389,11867,3522,1429,327700,55110
100,0,100,834,-,55111
17134,11644,5490,1239,320700,55112
18048,12258,5790,1264,313500,55113
1931,506,1425,1554,286000,55114
3180,2549,631,1614,447700,55115
12209,6129,6080,1159,378200,55116
16548,9889,6659,1155,254500,55117
12770,8831,3939,1229,309200,55118
16207,10342,5865,1195,246100,55119
2106,1361,745,1292,449200,55120
3885,1729,2156,1538,268300,55121
13492,9320,4172,1481,328200,55122
10244,8361,1883,1472,416100,55123
21311,16101,5210,1607,333300,55124
17644,13778,3866,1771,366200,55125
11739,9685,2054,1410,350500,55126
7550,6307,1243,1626,393300,55127
11663,9070,2593,1239,284300,55128
10563,8796,1767,1755,500000,55129
5988,2631,3357,1089,202200,55130
53,38,15,788,383300,55150
0,0,0,-,-,55155
4464,3685,779,1382,301900,55301
2801,2424,377,978,318300,55302
19383,14653,4730,1365,326000,55303
16762,15788,974,1585,380100,55304
9904,5968,3936,1723,417400,55305
6297,4098,2199,1496,341900,55306
1255,969,286,863,215500,55307
3214,2953,261,825,282200,55308
7104,6396,708,1321,309600,55309
633,520,113,707,121200,55310
13812,12035,1777,1782,437500,55311
536,473,63,750,201600,55312
9212,7492,1720,1075,295100,55313
424,336,88,738,166800,55314
2323,2078,245,1383,395500,55315
8647,7757,890,1478,320100,55316
8225,6974,1251,1713,464900,55317
11157,7989,3168,1388,371500,55318
1978,1879,99,965,329900,55319
2025,1751,274,958,295500,55320
1887,1486,401,878,247800,55321
1400,1281,119,768,379100,55322
451,426,25,725,292600,55324
1670,1433,237,827,277800,55325
1994,1880,114,1167,438100,55327
3488,2873,615,1050,360200,55328
824,703,121,800,208000,55329
15715,13124,2591,1294,329900,55330
7359,6410,949,1171,676600,55331
733,622,111,517,118800,55332
291,241,50,638,107200,55333
1143,822,321,781,165200,55334
692,567,125,858,116900,55335
3180,2443,737,880,227100,55336
19062,13206,5856,1423,309200,55337
425,407,18,1325,235700,55338
370,319,51,786,281500,55339
3236,2976,260,1290,596300,55340
1129,1015,114,1583,396600,55341
715,582,133,1083,129600,55342
13005,5717,7288,1357,327000,55343
6801,2710,4091,1693,341900,55344
8535,7166,1369,1477,451800,55345
6577,5679,898,1798,439400,55346
11692,10742,950,1913,473100,55347
1477,1192,285,927,258800,55349
7806,5706,2100,843,213400,55350
3323,2791,532,1235,363400,55352
1128,1014,114,734,309200,55353
1088,979,109,708,229100,55354
3951,3071,880,891,194400,55355
2149,1864,285,1648,677600,55356
1161,1051,110,950,475300,55357
2056,1712,344,899,277400,55358
2538,2171,367,1108,543200,55359
1099,1047,52,1228,314000,55360
7386,5418,1968,1261,302200,55362
1931,1544,387,1248,263400,55363
6196,4981,1215,1082,405300,55364
184,149,35,646,124700,55366
378,331,47,943,283500,55367
780,560,220,1134,268500,55368
15416,12121,3295,1707,336300,55369
233,221,12,-,300800,55370
6399,5327,1072,972,268900,55371
12089,10935,1154,1319,421000,55372
2183,1738,445,1180,271600,55373
5294,4696,598,1225,410400,55374
1329,1272,57,982,374200,55375
6553,5998,555,1239,344000,55376
11405,9749,1656,1595,376200,55378
17095,12550,4545,1461,353500,55379
751,651,100,779,227300,55381
1392,1305,87,1129,318500,55382
1220,230,990,1201,540700,55384
480,428,52,775,160200,55385
3349,3002,347,2588,526400,55386
5363,4311,1052,1176,397600,55387
2237,1876,361,925,303700,55388
920,778,142,770,254500,55389
1081,989,92,943,296100,55390
6675,5368,1307,1658,760300,55391
1187,899,288,794,197100,55395
926,734,192,700,174800,55396
1144,1009,135,1034,305500,55397
6009,5456,553,1287,298900,55398
7941,2453,5488,1950,389600,55401
429,0,429,1700,-,55402
11286,2738,8548,1179,292300,55403
12249,2111,10138,1022,272100,55404
8385,3049,5336,1154,441400,55405
16560,11061,5499,1224,313400,55406
14699,8894,5805,1162,291500,55407
16561,4096,12465,1315,373400,55408
4887,3402,1485,1300,346900,55409
8432,6914,1518,1579,571200,55410
10020,4989,5031,1117,221900,55411
8925,6395,2530,1388,218300,55412
7227,2796,4431,1379,339100,55413
13208,2173,11035,1388,426300,55414
2658,926,1732,2062,512000,55415
17702,8981,8721,1623,434600,55416
10855,8719,2136,1341,349200,55417
13740,8668,5072,1254,317900,55418
11587,9063,2524,1471,469600,55419
9120,6070,3050,1223,284300,55420
12569,7585,4984,1210,241500,55421
12325,9004,3321,1390,293800,55422
15932,9839,6093,1299,293800,55423
3576,3300,276,1770,880100,55424
4380,1742,2638,1387,292900,55425
11795,7641,4154,1418,331700,55426
10890,7381,3509,1330,318600,55427
13116,7302,5814,1228,264800,55428
10264,5798,4466,1215,244500,55429
7871,5063,2808,1269,228600,55430
8294,5725,2569,1685,333700,55431
12760,8044,4716,1237,259400,55432
13784,9362,4422,1322,255100,55433
11914,9845,2069,1609,257400,55434
7659,3430,4229,1698,316800,55435
5986,4564,1422,1713,571500,55436
8685,6001,2684,1519,348600,55437
7161,5693,1468,1505,386600,55438
3415,3106,309,1591,631400,55439
7987,4858,3129,1479,428700,55441
5549,4312,1237,1708,419500,55442
12040,8934,3106,1203,323000,55443
5281,4767,514,1304,274400,55444
4679,3657,1022,2122,307800,55445
10474,8640,1834,1807,533900,55446
8905,6754,2151,1603,430400,55447
10790,9018,1772,1656,283900,55448
11236,9847,1389,1660,399800,55449
0,0,0,-,-,55450
3611,353,3258,768,150700,55454
4,0,4,-,-,55455
68,63,5,-,202800,55601
168,165,3,-,205300,55602
217,171,46,647,168100,55603
1732,1368,364,940,303500,55604
290,168,122,663,129700,55605
105,105,0,-,284100,55606
93,90,3,-,183000,55607
77,77,0,-,537500,55609
301,245,56,641,314500,55612
96,96,0,-,291700,55613
1188,1002,186,939,157900,55614
148,104,44,1333,265000,55615
3235,2626,609,777,217900,55616
193,169,24,1583,235900,55702
330,308,22,1284,164100,55703
465,388,77,493,191300,55704
1623,1393,230,475,111300,55705
814,696,118,684,94300,55706
1274,1113,161,817,217400,55707
357,289,68,769,87000,55708
1650,1506,144,942,191600,55709
632,614,18,-,188200,55710
186,154,32,833,191700,55711
280,261,19,1094,160500,55712
469,356,113,1021,117500,55713
136,86,50,690,82000,55716
107,99,8,-,298700,55717
1184,998,186,853,249100,55718
2333,1757,576,644,113800,55719
7048,5132,1916,975,197900,55720
1342,1217,125,645,252100,55721
370,290,80,813,132500,55722
919,805,114,625,169500,55723
404,374,30,-,182400,55724
43,41,2,-,308300,55725
378,291,87,1013,202000,55726
2686,2021,665,589,198500,55731
690,668,22,-,161900,55732
2040,1945,95,1409,311900,55733
2812,2176,636,743,140400,55734
713,673,40,1048,213500,55735
587,492,95,698,133700,55736
232,222,10,-,132900,55738
1384,1199,185,626,140800,55741
98,95,3,-,193800,55742
8257,6228,2029,952,216900,55744
7858,5878,1980,698,123300,55746
554,431,123,775,180300,55748
243,220,23,850,216200,55749
853,789,64,745,85100,55750
597,563,34,788,175200,55751
187,181,6,-,181900,55752
473,371,102,854,71800,55753
107,93,14,-,207500,55756
303,270,33,925,204500,55757
65,59,6,-,93100,55758
1252,1012,240,760,241700,55760
230,203,27,395,158100,55763
220,178,42,975,93300,55764
343,315,28,650,168600,55765
1213,909,304,891,207700,55767
1200,868,332,-,177900,55768
1079,974,105,788,139300,55769
667,582,85,743,168400,55771
51,19,32,857,-,55772
568,528,40,770,209300,55775
1434,1288,146,1580,247200,55779
83,76,7,463,165600,55780
318,301,17,1313,339000,55781
209,173,36,-,89800,55782
1008,921,87,1087,228500,55783
56,54,2,-,189300,55784
135,125,10,-,188500,55785
90,81,9,669,95800,55786
254,228,26,925,209100,55787
871,762,109,588,290800,55790
4623,2778,1845,796,121000,55792
253,229,24,875,170900,55793
689,594,95,763,213800,55795
58,45,13,-,92500,55796
545,505,40,1063,224000,55797
226,208,18,575,221700,55798
1346,421,925,693,450500,55802
7558,6211,1347,1332,287300,55803
6219,5419,800,1360,268600,55804
4785,1438,3347,924,158300,55805
4428,2040,2388,872,145000,55806
4371,3039,1332,790,155300,55807
2519,1829,690,1000,144000,55808
3379,2920,459,924,199700,55810
10990,7859,3131,1180,273100,55811
3533,1593,1940,1113,272700,55812
0,0,0,-,-,55814
23156,14885,8271,1239,270300,55901
11479,8201,3278,1447,387200,55902
0,0,0,-,-,55903
11944,7929,4015,1190,223200,55904
0,0,0,-,-,55905
8308,6271,2037,1012,327400,55906
551,483,68,639,199600,55909
544,478,66,744,230000,55910
11442,8123,3319,873,146400,55912
1417,1238,179,820,184500,55917
443,386,57,745,143500,55918
440,415,25,792,194000,55919
3179,2713,466,998,326800,55920
2049,1616,433,757,175200,55921
337,281,56,582,111800,55922
1684,1447,237,730,248100,55923
452,408,44,1018,188500,55924
438,407,31,575,243200,55925
282,216,66,730,182300,55926
1571,1310,261,884,202000,55927
467,406,61,774,267400,55929
182,151,31,486,153100,55931
823,672,151,722,261100,55932
97,86,11,775,196400,55933
1427,1146,281,785,289000,55934
393,331,62,707,209400,55935
680,569,111,575,198200,55936
763,628,135,811,186900,55939
1120,868,252,993,214800,55940
454,334,120,837,203600,55941
1146,965,181,786,224300,55943
2905,2620,285,811,247800,55944
585,491,94,811,206700,55945
1311,1130,181,822,214200,55946
3180,2793,387,931,247300,55947
773,635,138,550,235100,55949
59,52,7,-,101600,55950
556,441,115,767,122200,55951
885,679,206,885,216400,55952
356,295,61,581,163500,55953
533,453,80,779,127900,55954
987,930,57,1262,378000,55955
882,730,152,1086,269900,55956
307,245,62,725,259000,55957
901,705,196,826,171600,55959
1168,1109,59,1489,384800,55960
203,164,39,867,155600,55961
334,300,34,733,224000,55962
2179,1728,451,934,331000,55963
1701,1329,372,746,218300,55964
965,745,220,594,189200,55965
364,344,20,1264,245900,55967
67,50,17,1108,214300,55968
412,369,43,700,242400,55969
418,381,37,771,174700,55970
1153,933,220,794,219100,55971
2029,1725,304,906,237900,55972
105,94,11,1500,250000,55973
913,664,249,1013,161600,55974
1822,1533,289,833,187300,55975
3222,2616,606,967,266800,55976
76,62,14,925,225000,55977
363,273,90,1076,248300,55979
1815,1444,371,791,221600,55981
243,226,17,958,264700,55982
693,550,143,611,246800,55983
663,551,112,860,182000,55985
14289,8954,5335,794,190700,55987
374,289,85,832,229200,55990
604,543,61,824,285100,55991
2340,1848,492,779,256900,55992
19836,10707,9129,1022,249400,56001
6385,4883,1502,888,242300,56003
9035,6760,2275,812,150500,56007
602,526,76,875,181500,56009
492,417,75,773,146100,56010
3424,2973,451,1276,287900,56011
1889,1437,452,681,142600,56013
301,238,63,475,86700,56014
417,359,58,850,176300,56016
761,633,128,858,284800,56017
363,298,65,754,122400,56019
37,36,1,-,88000,56020
449,380,69,1027,240900,56021
45,45,0,-,61400,56022
219,185,34,730,119000,56023
1291,909,382,1363,248200,56024
200,184,16,1268,155000,56025
744,644,100,831,212800,56026
339,268,71,806,55600,56027
460,398,62,1094,320400,56028
279,250,29,713,110500,56029
3,3,0,-,-,56030
5357,3670,1687,749,163100,56031
147,129,18,1550,81300,56032
154,142,12,625,76400,56033
161,140,21,-,157400,56034
174,145,29,550,169500,56035
729,616,113,807,165700,56036
666,598,68,808,223000,56037
358,308,50,813,144900,56039
417,363,54,725,176300,56041
328,264,64,495,202200,56042
173,149,24,375,180800,56043
753,676,77,992,245100,56044
370,344,26,692,145200,56045
48,46,2,-,92000,56046
1674,1456,218,800,199800,56048
555,483,72,647,287700,56050
318,261,57,1092,53100,56051
248,228,20,1725,334000,56052
364,322,42,845,182100,56054
1603,1318,285,766,208400,56055
34,33,1,-,63800,56056
1498,1201,297,780,214800,56057
2560,1849,711,824,235000,56058
167,137,30,548,63600,56060
1209,912,297,686,160800,56062
1214,1030,184,944,370600,56063
1029,845,184,698,206000,56065
427,349,78,815,149300,56068
1901,1586,315,1044,248600,56069
4496,3943,553,1173,355500,56071
870,721,149,754,180400,56072
7200,5535,1665,886,184400,56073
662,512,150,821,241200,56074
61,50,11,692,95300,56075
176,153,23,1250,169100,56078
260,231,29,775,185000,56080
2417,1893,524,744,117000,56081
4813,3273,1540,935,246200,56082
363,309,54,563,100400,56083
2171,1894,277,756,145400,56085
1318,1036,282,732,140700,56087
912,628,284,856,126000,56088
92,69,23,656,-,56089
249,202,47,950,162000,56090
132,121,11,880,129800,56091
4955,3921,1034,870,193100,56093
1249,996,253,811,236200,56096
1575,1290,285,660,116300,56097
854,704,150,783,123500,56098
2454,1832,622,800,151200,56101
638,542,96,888,177600,56110
176,157,19,820,94400,56111
100,92,8,-,85000,56113
152,125,27,1056,164600,56114
524,430,94,964,202600,56115
208,182,26,913,229700,56116
127,90,37,1583,115000,56117
194,187,7,-,244600,56118
341,302,39,672,163800,56119
377,335,42,775,92000,56120
305,250,55,1299,91400,56121
238,181,57,763,147500,56122
182,174,8,833,93300,56123
28,28,0,-,50000,56125
235,142,93,1059,88600,56127
807,703,104,807,169400,56128
271,215,56,605,110600,56129
962,822,140,779,156100,56131
225,209,16,967,237500,56132
162,122,40,630,150000,56134
590,479,111,592,188100,56136
457,381,76,738,111200,56137
401,300,101,988,183800,56138
172,134,38,775,106300,56139
36,36,0,-,84700,56140
129,113,16,675,91600,56141
438,366,72,613,87600,56142
2125,1584,541,756,154800,56143
477,379,98,917,87200,56144
196,173,23,643,92300,56145
23,19,4,-,-,56146
54,50,4,-,150000,56147
518,407,111,575,142300,56149
1139,969,170,848,121600,56150
280,259,21,763,144800,56151
525,461,64,712,122900,56152
55,52,3,-,90000,56153
249,211,38,646,76100,56155
2595,1969,626,779,188300,56156
315,251,64,1080,177500,56157
154,125,29,714,133900,56158
963,735,228,590,132100,56159
91,79,12,575,85000,56160
128,120,8,-,103600,56161
102,91,11,1375,92100,56162
2391,1817,574,635,139100,56164
130,118,12,-,191700,56165
72,68,4,-,170500,56166
277,232,45,582,115800,56167
303,266,37,475,169600,56168
304,267,37,663,122900,56169
237,204,33,821,89200,56170
700,578,122,633,143900,56171
1322,1004,318,581,173500,56172
123,96,27,975,120000,56173
143,117,26,983,83800,56174
1117,960,157,631,119800,56175
427,361,66,621,100500,56176
671,547,124,743,151700,56178
454,351,103,575,99300,56180
480,415,65,645,103800,56181
604,462,142,658,98300,56183
209,185,24,700,145300,56185
174,149,25,-,177300,56186
5093,3489,1604,869,169900,56187
9445,6050,3395,792,186600,56201
82,72,10,900,85700,56207
940,742,198,613,84300,56208
935,772,163,818,195700,56209
4,4,0,-,112500,56210
214,178,36,740,105000,56211
218,191,27,669,102000,56212
252,209,43,890,98200,56214
1998,1389,609,898,150500,56215
322,281,41,1289,143200,56216
220,211,9,930,117000,56218
379,268,111,735,168800,56219
1165,994,171,554,153600,56220
355,294,61,707,110700,56221
833,624,209,1053,144400,56222
559,465,94,756,96800,56223
127,111,16,742,114100,56224
292,224,68,817,103200,56225
84,70,14,-,183000,56226
99,81,18,-,256900,56227
385,330,55,675,125700,56228
743,595,148,704,189400,56229
308,247,61,921,145300,56230
146,137,9,950,183900,56231
872,728,144,573,158900,56232
214,175,39,1000,128400,56235
178,169,9,-,123300,56236
230,197,33,570,120100,56237
226,187,39,945,170500,56239
345,233,112,667,123700,56240
1622,1235,387,788,157800,56241
701,547,154,812,153300,56243
614,489,125,836,152700,56244
216,164,52,770,95000,56245
369,296,73,588,144700,56248
121,106,15,567,134100,56249
375,310,65,781,202900,56251
506,371,135,735,174200,56252
372,330,42,775,193800,56253
172,119,53,645,150800,56255
1107,870,237,876,109400,56256
186,152,34,938,65000,56257
6023,3726,2297,717,199200,56258
398,307,91,645,141900,56260
276,247,29,638,102500,56262
192,172,20,495,160700,56263
861,694,167,574,165700,56264
3200,2210,990,765,140300,56265
590,485,105,1063,120700,56266
2653,1632,1021,819,197300,56267
425,387,38,900,98900,56270
512,370,142,912,177500,56271
1960,1714,246,905,285700,56273
88,88,0,-,162500,56274
109,94,15,788,69400,56276
1215,814,401,729,173600,56277
1237,926,311,707,122000,56278
456,390,66,975,202400,56279
217,168,49,836,215500,56280
238,217,21,913,164100,56281
574,447,127,838,171700,56282
2606,1947,659,831,169500,56283
756,571,185,644,128800,56284
467,400,67,796,113900,56285
27,26,1,-,112500,56287
2016,1756,260,790,360400,56288
270,238,32,739,268600,56289
190,175,15,675,159400,56291
204,183,21,1107,116300,56292
451,371,80,630,159900,56293
46,34,12,-,-,56294
139,114,25,672,96700,56295
868,698,170,564,97800,56296
335,295,40,625,134600,56297
12800,6500,6300,982,246600,56301
10745,6687,4058,929,175800,56303
6933,2889,4044,916,199500,56304
1974,1651,323,575,249800,56307
11824,8408,3416,858,294300,56308
570,456,114,870,254500,56309
1941,1676,265,1050,264800,56310
299,255,44,1000,159800,56311
855,709,146,714,225300,56312
25,21,4,-,99000,56313
494,445,49,930,258500,56314
720,607,113,900,224800,56315
616,520,96,863,205400,56316
455,395,60,702,237900,56318
561,506,55,1170,244700,56319
3170,2586,584,1140,284800,56320
0,0,0,-,-,56321
235,183,52,638,139000,56323
458,420,38,740,225000,56324
77,73,4,-,152500,56325
743,627,116,667,217100,56326
357,352,5,-,362700,56327
82,77,5,-,181000,56328
2745,2292,453,939,238000,56329
652,606,46,988,248900,56330
773,696,77,788,247600,56331
702,652,50,738,263400,56332
2563,2001,562,760,245700,56334
87,82,5,-,136100,56335
654,598,56,594,260400,56336
680,623,57,1083,252600,56338
398,314,84,691,158600,56339
908,845,63,956,259700,56340
1251,1078,173,746,223500,56342
385,347,38,675,229100,56343
6333,4733,1600,790,211000,56345
2862,2236,626,822,165400,56347
312,267,45,735,239000,56349
187,160,27,953,151300,56350
2458,1957,501,970,212600,56352
3711,2909,802,853,227000,56353
565,510,55,755,332900,56354
217,186,31,889,267900,56355
87,85,2,-,146300,56356
354,341,13,-,252200,56357
1266,1102,164,1098,217100,56358
1343,926,417,823,190700,56359
1716,1356,360,765,224800,56360
963,832,131,745,204300,56361
2244,1870,374,725,238600,56362
93,74,19,1013,145300,56363
2087,1764,323,837,229100,56364
2636,2365,271,1164,260100,56367
1606,1470,136,808,297500,56368
209,117,92,819,203400,56369
35,22,13,1146,178600,56371
1261,1019,242,704,249900,56373
3391,2576,815,1064,267800,56374
321,306,15,788,223900,56375
128,106,22,331,191900,56376
8044,4937,3107,1121,269300,56377
3366,2432,934,773,232400,56378
6794,4505,2289,953,237800,56379
995,817,178,869,190000,56381
557,487,70,525,229400,56382
153,89,64,719,129500,56384
395,351,44,850,185600,56385
309,242,67,838,251900,56386
3479,1520,1959,1023,214500,56387
32,29,3,-,102100,56389
12797,9384,3413,838,219400,56401
3611,2367,1244,1090,246400,56425
3848,3264,584,826,243400,56431
771,668,103,896,215600,56433
75,68,7,713,158300,56434
1176,1077,99,875,216800,56435
472,379,93,725,97400,56437
1107,911,196,781,167700,56438
535,426,109,781,125500,56440
1691,1085,606,787,175200,56441
1338,1180,158,993,469600,56442
635,578,57,939,295100,56443
1376,1219,157,769,278700,56444
643,556,87,725,135000,56446
404,381,23,1292,294100,56447
199,193,6,-,375000,56448
726,689,37,1067,253600,56449
501,422,79,1017,171100,56450
933,816,117,731,291600,56452
319,295,24,775,116800,56453
636,497,139,1013,172600,56455
122,113,9,1063,225000,56458
1343,1247,96,979,232300,56461
1682,1392,290,791,184300,56464
953,890,63,1472,318800,56465
1348,1114,234,746,208600,56466
1083,1040,43,725,284700,56467
1918,1783,135,993,384000,56468
479,445,34,850,219600,56469
4498,3233,1265,805,253900,56470
3377,2873,504,819,283900,56472
1304,1156,148,950,235400,56473
1898,1511,387,844,198100,56474
679,605,74,725,187500,56475
1128,903,225,722,161000,56477
1887,1513,374,873,161300,56479
951,803,148,625,161400,56481
3049,1979,1070,660,163500,56482
1353,1019,334,790,265000,56484
7502,5439,2063,913,275000,56501
966,707,259,628,128900,56510
801,718,83,846,303800,56511
1450,1210,240,815,218200,56514
1294,1116,178,913,356100,56515
118,100,18,1125,170000,56516
100,84,16,-,140900,56517
161,138,23,890,142900,56518
117,96,21,1313,112500,56519
1666,1248,418,519,160100,56520
343,293,50,698,129900,56521
193,164,29,1125,144100,56522
157,128,29,663,155000,56523
290,256,34,950,294100,56524
34,34,0,-,168800,56525
335,293,42,942,192800,56527
740,636,104,1025,302500,56528
1889,1498,391,904,265500,56529
784,604,180,735,160000,56531
105,96,9,1125,160000,56533
514,480,34,870,212200,56534
545,387,158,816,187900,56535
176,156,20,569,175000,56536
8453,6072,2381,764,197600,56537
759,645,114,726,172700,56540
23,18,5,-,-,56541
1032,773,259,850,164100,56542
84,73,11,-,182800,56543
2157,1741,416,833,224900,56544
260,237,23,395,149100,56545
101,98,3,-,203300,56546
945,835,110,1013,262100,56547
303,225,78,767,130900,56548
1753,1473,280,728,305000,56549
120,99,21,785,146600,56550
954,748,206,696,199600,56551
217,190,27,-,147500,56552
109,105,4,-,-,56553
1095,1017,78,700,279900,56554
474,332,142,550,135000,56556
983,650,333,722,111500,56557
18126,10662,7464,998,237200,56560
9,0,9,-,-,56562
0,0,0,-,-,56563
44,38,6,-,150000,56565
202,98,104,477,113900,56566
1284,1003,281,716,168900,56567
59,53,6,525,-,56568
466,390,76,813,173100,56569
489,447,42,680,247000,56570
792,719,73,913,300400,56571
2291,1897,394,360,266200,56572
2730,2072,658,789,237600,56573
115,114,1,-,125000,56574
279,226,53,738,225000,56575
388,342,46,1010,336700,56576
299,287,12,-,284300,56578
414,367,47,744,214900,56579
464,438,26,1000,260300,56580
128,128,0,-,108700,56581
73,58,15,-,193800,56583
558,459,99,993,124700,56584
483,394,89,579,196000,56585
801,735,66,988,265300,56586
550,493,57,794,310000,56587
193,184,9,950,284200,56588
672,567,105,644,161900,56589
161,139,22,688,110200,56590
228,81,147,199,-,56591
181,159,22,631,136500,56592
206,183,23,1313,174300,56594
13908,9114,4794,969,224200,56601
1679,1335,344,763,159800,56621
1197,984,213,748,208300,56623
89,58,31,768,173100,56626
129,103,26,513,51800,56627
618,518,100,1090,239500,56628
79,79,0,-,217000,56629
836,655,181,730,171700,56630
1550,1041,509,876,150800,56633
617,481,136,745,163500,56634
1876,1649,227,683,180900,56636
82,77,5,-,193800,56637
198,165,33,1458,174500,56639
145,108,37,775,163200,56641
275,224,51,525,181300,56644
143,116,27,990,175000,56646
326,267,59,850,217400,56647
4171,3277,894,691,132800,56649
422,380,42,575,163600,56650
219,196,23,1083,159600,56651
154,146,8,-,221200,56652
589,497,92,652,122600,56653
20,15,5,-,104200,56654
759,701,58,725,283100,56655
98,98,0,-,262500,56657
0,0,0,-,-,56658
61,58,3,-,250000,56659
136,131,5,-,126800,56660
391,346,45,642,158000,56661
269,262,7,-,346000,56662
85,73,12,-,118100,56663
191,92,99,436,116300,56666
291,261,30,-,198400,56667
102,85,17,-,156900,56668
134,132,2,-,139300,56669
308,223,85,535,92100,56670
853,537,316,484,95200,56671
882,743,139,743,237900,56672
195,185,10,-,161900,56673
761,697,64,1054,182700,56676
630,584,46,1300,184300,56678
55,51,4,-,173200,56680
106,91,15,729,160400,56681
268,250,18,1031,239300,56683
140,132,8,-,158300,56684
50,49,1,-,210400,56685
390,346,44,-,133300,56686
45,45,0,-,172900,56688
5731,4086,1645,937,174200,56701
175,152,23,545,121200,56710
37,8,29,-,-,56711
413,341,72,436,160300,56713
489,415,74,744,146200,56714
162,137,25,432,174300,56715
3883,2364,1519,830,170100,56716
9,9,0,-,20800,56720
4048,2920,1128,833,242000,56721
138,125,13,-,183900,56722
328,273,55,1000,211800,56723
47,44,3,-,87500,56724
383,348,35,988,192200,56725
563,516,47,517,140500,56726
362,332,30,663,132500,56727
468,382,86,779,140000,56728
53,51,2,-,145800,56729
52,49,3,-,120400,56731
436,338,98,495,124000,56732
162,146,16,688,107100,56733
208,159,49,702,84200,56734
299,226,73,738,138200,56735
304,276,28,1042,268000,56736
332,283,49,438,121200,56737
552,471,81,713,169400,56738
308,268,40,717,113600,56742
241,217,24,-,137100,56744
257,197,60,775,166400,56748
966,796,170,613,154600,56750
2290,1742,548,936,170400,56751
198,182,16,1094,191700,56754
34,32,2,-,73300,56755
242,226,16,875,167800,56756
353,316,37,927,114100,56757
151,142,9,-,112500,56758
144,133,11,-,187500,56759
189,183,6,-,179400,56760
160,154,6,-,158700,56761
990,757,233,806,137100,56762
1884,1446,438,718,169000,56763
677,540,137,816,158900,57001
694,529,165,881,213400,57002
714,625,89,1028,235300,57003
1470,1109,361,842,220600,57004
4538,3652,886,960,308700,57005
9668,5015,4653,859,228500,57006
0,0,0,-,-,57007
280,183,97,-,219400,57010
486,395,91,745,150600,57012
1908,1442,466,680,197900,57013
647,534,113,691,200900,57014
294,258,36,446,352000,57015
321,291,30,1076,191300,57016
504,412,92,767,236700,57017
533,443,90,680,216500,57018
648,600,48,1063,264600,57020
157,135,22,-,-,57021
2065,1682,383,918,273300,57022
194,167,27,775,113800,57024
1160,918,242,767,208400,57025
560,391,169,731,222800,57026
68,60,8,-,113800,57027
1288,775,513,613,164600,57028
839,655,184,680,163400,57029
1123,876,247,738,271600,57030
399,364,35,521,136400,57031
3305,2885,420,1159,271300,57032
2177,1867,310,805,276400,57033
313,253,60,-,152600,57034
455,421,34,679,269900,57035
250,206,44,663,155000,57036
376,240,136,838,140000,57037
693,634,59,613,286100,57038
1457,1126,331,788,217800,57039
153,136,17,715,102100,57040
47,47,0,-,277500,57041
3198,2137,1061,813,173400,57042
624,498,126,746,185900,57043
466,400,66,528,103000,57045
335,283,52,955,183800,57046
143,103,40,665,-,57047
511,409,102,556,286500,57048
3276,1978,1298,1104,377700,57049
83,72,11,-,171600,57050
124,109,15,-,77700,57051
123,93,30,425,172500,57052
774,641,133,859,221800,57053
255,224,31,700,112500,57054
465,431,34,-,404800,57055
71,63,8,-,308300,57057
756,604,152,922,175600,57058
549,421,128,589,109200,57059
67,55,12,900,79800,57061
517,376,141,817,145300,57062
366,290,76,547,131500,57063
2432,1829,603,1143,286700,57064
166,114,52,599,133800,57065
585,455,130,725,103800,57066
80,77,3,-,-,57067
599,503,96,1143,217900,57068
4659,2185,2474,751,213000,57069
558,378,180,667,147600,57070
1280,846,434,975,253400,57071
246,190,56,983,145600,57072
205,159,46,642,111200,57073
504,465,39,782,401900,57075
179,134,45,-,281600,57076
509,470,39,950,210300,57077
8431,5726,2705,760,198600,57078
14101,9393,4708,907,228400,57103
12032,5085,6947,792,164000,57104
9662,6266,3396,947,229600,57105
20518,12580,7938,971,249600,57106
4427,3038,1389,1014,228400,57107
12936,8253,4683,1272,378400,57108
8250,5315,2935,1022,343400,57110
0,0,0,-,-,57117
0,0,0,-,-,57197
11237,7373,3864,865,213300,57201
797,650,147,821,235500,57212
176,143,33,1556,142100,57213
55,52,3,-,66700,57214
713,610,103,719,203200,57216
119,92,27,580,122500,57217
153,117,36,1685,207200,57218
236,156,80,1028,80900,57219
366,309,57,675,163600,57220
318,237,81,660,188400,57221
494,426,68,885,205600,57223
81,66,15,-,87100,57224
704,549,155,732,137700,57225
752,557,195,585,178300,57226
129,101,28,-,191100,57227
686,551,135,711,171800,57231
190,173,17,739,295000,57232
66,57,9,-,275000,57233
511,442,69,705,154100,57234
312,277,35,844,217100,57235
40,34,6,-,53000,57236
283,254,29,446,200000,57237
152,121,31,763,175900,57238
173,157,16,-,321400,57239
369,269,100,692,143800,57241
131,128,3,-,206300,57242
277,249,28,925,114000,57243
85,51,34,1309,126000,57245
75,74,1,-,98000,57246
63,46,17,-,229400,57247
357,260,97,952,211800,57248
408,322,86,499,181700,57249
43,30,13,-,-,57251
1883,1482,401,462,176500,57252
189,152,37,475,85000,57255
85,78,7,-,-,57256
197,121,76,581,52500,57257
68,55,13,-,101000,57258
237,202,35,1063,114600,57259
390,332,58,763,127000,57260
119,87,32,433,101800,57261
1779,934,845,584,116900,57262
181,155,26,664,91400,57263
110,93,17,413,111300,57264
72,58,14,-,125000,57265
191,140,51,708,103800,57266
237,186,51,425,117500,57268
75,73,2,-,241700,57269
265,176,89,577,83300,57270
53,51,2,-,97900,57271
62,41,21,528,151800,57272
419,293,126,589,113500,57273
1198,884,314,565,161800,57274
459,382,77,669,168100,57276
243,196,47,813,170000,57278
426,370,56,641,147200,57279
8018,5017,3001,776,179500,57301
503,428,75,812,173700,57311
276,245,31,794,-,57312
437,343,94,681,119000,57313
263,208,55,917,113200,57314
414,312,102,706,94200,57315
222,152,70,514,102100,57317
353,305,48,725,112500,57319
88,88,0,-,108900,57321
104,92,12,-,125000,57322
99,88,11,-,70000,57323
152,142,10,-,162500,57324
1150,730,420,622,189500,57325
439,329,110,908,124600,57328
145,117,28,925,119200,57329
178,142,36,578,150000,57330
112,82,30,179,204200,57331
278,248,30,721,122000,57332
287,222,65,819,156300,57334
112,101,11,-,61000,57335
34,23,11,-,28300,57337
328,137,191,542,109100,57339
80,76,4,-,210400,57340
48,38,10,-,-,57341
134,129,5,-,87900,57342
60,60,0,-,88200,57344
453,384,69,863,91300,57345
29,0,29,467,-,57346
315,204,111,690,178300,57348
611,479,132,588,92400,57349
6186,4207,1979,817,153200,57350
301,271,30,575,169500,57353
12,12,0,-,-,57354
498,373,125,792,167000,57355
606,408,198,700,114900,57356
4,3,1,-,-,57358
232,192,40,935,158600,57359
60,32,28,520,23100,57361
904,600,304,527,133300,57362
350,245,105,-,202200,57363
4,0,4,-,-,57364
253,200,53,744,208300,57365
1089,811,278,727,159300,57366
108,91,17,800,241100,57367
411,305,106,875,129500,57368
1050,754,296,804,218500,57369
267,192,75,769,119300,57370
87,40,47,832,-,57371
188,132,56,-,122900,57373
121,111,10,400,157800,57374
264,198,66,684,122700,57375
434,323,111,-,99600,57376
32,28,4,-,-,57379
950,643,307,710,147600,57380
206,141,65,450,79400,57381
547,444,103,431,119800,57382
345,276,69,736,113700,57383
427,349,78,644,148800,57384
575,425,150,425,138900,57385
166,121,45,640,127500,57386
13565,8411,5154,744,204300,57401
65,54,11,-,102800,57420
10,10,0,-,-,57421
80,68,12,-,95000,57422
114,104,10,-,-,57424
18,12,6,-,-,57426
185,185,0,-,342500,57427
198,136,62,609,100000,57428
47,43,4,-,-,57429
813,639,174,779,116200,57430
113,110,3,-,160400,57432
172,161,11,1021,153000,57433
203,180,23,-,103600,57434
125,108,17,1063,183300,57435
219,184,35,670,60000,57436
597,483,114,521,75200,57437
374,284,90,936,136400,57438
22,22,0,-,-,57439
139,122,17,-,82000,57440
252,229,23,594,126500,57441
826,621,205,779,147700,57442
774,611,163,920,173700,57445
236,232,4,-,-,57446
208,187,21,300,54100,57448
122,59,63,-,117300,57449
214,181,33,-,122800,57450
900,742,158,1014,210300,57451
112,100,12,-,-,57452
258,217,41,650,146600,57454
54,39,15,-,-,57455
235,180,55,815,80700,57456
42,32,10,-,-,57457
119,100,19,-,250000,57460
124,101,23,644,129900,57461
136,131,5,-,110400,57465
81,69,12,-,-,57466
112,104,8,-,-,57467
126,113,13,775,87900,57468
1299,867,432,646,129600,57469
35,35,0,-,96900,57470
224,201,23,869,66100,57471
400,333,67,892,107000,57472
74,70,4,-,123100,57473
85,80,5,-,221400,57474
56,50,6,-,110000,57475
174,154,20,682,117900,57476
44,39,5,-,62500,57477
231,211,20,910,217900,57479
150,144,6,-,162500,57481
7213,5311,1902,921,218500,57501
89,69,20,775,107000,57520
59,36,23,-,46700,57521
215,124,91,786,166700,57522
405,295,110,498,137500,57523
401,265,136,733,62100,57528
93,92,1,-,104200,57529
36,27,9,-,88300,57531
1213,1006,207,913,171700,57532
675,500,175,640,110700,57533
72,54,18,-,-,57534
123,90,33,800,111100,57536
34,29,5,-,-,57537
98,85,13,-,-,57538
48,30,18,-,275000,57540
56,28,28,1281,-,57541
279,164,115,496,151300,57543
176,148,28,860,131400,57544
49,41,8,-,-,57547
350,113,237,457,52900,57548
757,521,236,759,118800,57551
233,193,40,-,91800,57552
86,78,8,-,159000,57553
1052,504,548,557,64800,57555
297,219,78,698,114400,57559
155,77,78,400,108000,57560
22,22,0,-,88300,57562
16,4,12,-,-,57563
352,318,34,982,187500,57564
192,68,124,486,10700,57566
426,312,114,670,153400,57567
256,210,46,780,166100,57568
106,83,23,-,81500,57569
528,159,369,540,41100,57570
16,16,0,-,56700,57571
347,184,163,532,23900,57572
62,39,23,-,274200,57574
38,35,3,-,151300,57576
201,69,132,434,-,57577
407,251,156,775,58900,57579
1611,1164,447,870,136300,57580
56,49,7,-,55800,57584
66,42,24,655,-,57585
1652,1092,560,815,122000,57601
268,208,60,944,93300,57620
52,11,41,529,-,57621
76,27,49,725,-,57622
264,171,93,712,71900,57623
1120,606,514,689,66400,57625
304,231,73,523,157500,57626
20,20,0,-,200000,57630
194,181,13,-,225000,57631
299,239,60,728,82600,57632
176,132,44,738,71700,57633
33,27,6,-,152100,57634
36,36,0,-,117900,57636
813,649,164,682,97000,57638
74,9,65,244,-,57639
28,16,12,-,-,57640
101,85,16,-,55800,57641
547,264,283,563,71100,57642
136,108,28,-,187500,57644
73,68,5,-,33300,57645
108,101,7,558,109400,57646
206,164,42,713,84400,57648
99,86,13,-,80000,57649
3,0,3,-,-,57650
26,15,11,-,142500,57651
91,49,42,441,95200,57652
327,237,90,500,87200,57656
56,52,4,-,68600,57657
79,32,47,450,50000,57658
4,4,0,-,-,57659
41,30,11,-,109400,57660
49,20,29,613,-,57661
18484,10756,7728,914,206700,57701
15005,11245,3760,1061,320300,57702
6567,5485,1082,1278,227700,57703
550,0,550,1459,-,57706
178,39,139,617,110300,57714
116,116,0,-,-,57716
3350,2619,731,883,194500,57717
3133,2746,387,1131,252000,57718
4129,2640,1489,1144,270300,57719
322,236,86,533,133300,57720
80,69,11,-,75000,57722
104,67,37,-,206900,57724
135,108,27,-,-,57725
2508,2031,477,954,286300,57730
1064,670,394,726,272100,57732
618,482,136,831,107500,57735
18,0,18,-,-,57737
211,209,2,-,-,57738
53,53,0,-,-,57741
818,784,34,-,307400,57744
690,581,109,917,282500,57745
2735,2099,636,810,184000,57747
79,61,18,-,184200,57748
84,37,47,923,196900,57750
359,302,57,561,357100,57751
464,177,287,426,-,57752
1724,1306,418,833,198400,57754
45,28,17,-,54000,57755
159,14,145,539,-,57756
19,10,9,-,-,57758
60,60,0,-,-,57759
414,367,47,-,133700,57760
347,285,62,791,210200,57761
216,188,28,798,162500,57762
149,130,19,950,103000,57763
462,199,263,555,-,57764
58,58,0,-,-,57766
98,87,11,-,-,57767
1524,1336,188,1279,293200,57769
1024,514,510,623,57100,57770
329,231,98,-,-,57772
90,78,12,-,"10,000-",57773
100,76,24,-,-,57775
0,0,0,-,-,57776
138,138,0,-,245700,57779
49,27,22,-,"10,000-",57780
20,19,1,-,277500,57782
7356,4484,2872,909,288500,57783
4327,3007,1320,782,225800,57785
187,134,53,852,-,57787
202,168,34,-,-,57788
388,316,72,625,181100,57790
72,61,11,-,113300,57791
44,44,0,-,-,57792
716,603,113,859,244900,57793
102,71,31,-,"10,000-",57794
0,0,0,-,-,57799
113,102,11,-,120800,58001
0,0,0,-,-,58002
167,150,17,-,176700,58004
326,326,0,-,353600,58005
180,153,27,644,240800,58006
47,39,8,-,310700,58007
99,83,16,-,196900,58008
14,14,0,-,182500,58009
182,165,17,-,225000,58011
1205,728,477,753,283100,58012
61,58,3,-,-,58013
99,92,7,-,275000,58015
102,73,29,-,114200,58016
147,105,42,550,59300,58017
154,144,10,-,245500,58018
195,183,12,-,231800,58021
673,526,147,843,123700,58027
31,26,5,-,383300,58029
267,250,17,379,110700,58030
136,129,7,-,85000,58031
331,245,86,720,163200,58032
157,131,26,-,223600,58033
117,113,4,-,230300,58035
119,113,6,-,245800,58036
115,103,12,560,181300,58038
470,278,192,907,165200,58040
616,532,84,423,155600,58041
493,465,28,-,337000,58042
52,50,2,-,58000,58043
923,681,242,617,171100,58045
239,189,50,596,156000,58046
1598,1560,38,831,446700,58047
175,153,22,594,153900,58048
148,141,7,-,111700,58049
633,546,87,681,328900,58051
240,207,33,688,203800,58052
619,507,112,689,85600,58053
1281,880,401,878,157000,58054
70,40,30,-,-,58056
77,69,8,-,181300,58057
54,54,0,-,125000,58058
506,457,49,1272,255900,58059
528,417,111,617,138800,58060
129,110,19,488,178100,58061
76,76,0,-,128900,58062
142,133,9,-,210900,58063
191,146,45,469,251100,58064
7,7,0,-,206300,58065
94,80,14,765,125000,58067
131,112,19,-,81300,58068
58,42,16,-,83300,58069
184,137,47,542,162900,58071
3636,2516,1120,781,163800,58072
19,19,0,-,-,58074
3852,2136,1716,736,162200,58075
0,0,0,-,-,58076
296,257,39,1053,260400,58077
15283,10085,5198,1047,283200,58078
153,153,0,-,272300,58079
354,307,47,-,169000,58081
14185,6600,7585,798,229100,58102
23152,9397,13755,817,230400,58103
20223,9794,10429,1030,332200,58104
16,11,5,-,-,58105
18879,9398,9481,941,262000,58201
147,0,147,1321,-,58202
7397,3125,4272,887,195600,58203
530,0,530,1563,-,58204
0,0,0,-,-,58205
122,106,16,638,95000,58210
176,116,60,375,84400,58212
180,159,21,771,201300,58214
55,43,12,-,229500,58216
303,262,41,675,222100,58218
39,39,0,-,80900,58219
984,659,325,771,142800,58220
104,89,15,1328,64200,58222
69,57,12,-,284100,58223
26,26,0,-,68300,58224
463,365,98,584,115100,58225
228,193,35,-,113100,58227
339,234,105,821,159800,58228
36,36,0,-,94000,58229
244,178,66,575,84500,58230
173,159,14,-,79700,58231
150,133,17,-,145800,58233
212,198,14,1063,94100,58235
36,34,2,-,-,58236
2134,1514,620,646,121800,58237
35,34,1,-,73300,58238
15,12,3,-,75000,58239
483,417,66,598,157900,58240
71,41,30,1554,-,58241
229,204,25,1021,117300,58243
17,17,0,-,-,58244
942,750,192,702,142200,58249
98,72,26,567,83300,58250
845,681,164,704,186500,58251
227,189,38,542,100800,58254
0,0,0,-,-,58255
306,277,29,1125,199600,58256
847,423,424,747,188200,58257
141,139,2,-,99000,58258
243,181,62,967,101800,58259
74,66,8,-,84000,58260
530,492,38,650,119500,58261
23,17,6,-,-,58262
181,169,12,-,103600,58265
61,33,28,-,75500,58266
532,432,100,741,194300,58267
122,96,26,1086,73600,58269
783,585,198,1006,115700,58270
232,175,57,681,129200,58271
108,104,4,950,108800,58272
78,74,4,-,61700,58273
390,324,66,507,187500,58274
325,284,41,-,190800,58275
212,196,16,531,78900,58276
65,58,7,-,185400,58277
775,710,65,756,280600,58278
25,25,0,-,-,58281
609,423,186,587,110200,58282
4389,2591,1798,662,201700,58301
5,5,0,-,-,58310
34,28,6,-,137500,58311
25,22,3,-,83300,58313
1658,1102,556,450,86600,58316
73,67,6,-,-,58317
1545,1195,350,678,199600,58318
33,29,4,-,260900,58321
18,18,0,-,-,58323
598,415,183,659,148100,58324
19,18,1,-,-,58325
121,118,3,-,235700,58327
845,518,327,395,74800,58329
265,183,82,775,82700,58330
85,78,7,-,77500,58331
117,87,30,641,81200,58332
201,92,109,400,38100,58335
53,45,8,-,113100,58338
7,1,6,-,-,58339
1138,783,355,587,133700,58341
21,21,0,-,217500,58343
367,247,120,565,121000,58344
56,52,4,-,83300,58345
248,193,55,612,86600,58346
354,257,97,569,71700,58348
157,124,33,707,109200,58351
175,155,20,715,118400,58352
48,30,18,610,214300,58353
18,18,0,-,-,58355
803,520,283,604,105600,58356
179,150,29,-,50900,58357
100,78,22,775,227500,58361
9,9,0,-,-,58362
39,39,0,-,-,58363
101,76,25,515,61400,58365
306,217,89,559,134500,58366
498,298,200,660,104200,58367
1452,1149,303,759,155200,58368
341,287,54,706,181800,58369
276,182,94,385,68600,58370
33,33,0,-,-,58372
271,224,47,543,111300,58374
105,80,25,575,159600,58377
65,27,38,733,-,58379
181,141,40,542,155400,58380
158,145,13,833,246900,58381
74,67,7,-,187500,58382
138,116,22,621,80800,58384
52,42,10,-,142900,58385
33,26,7,-,53300,58386
7740,4686,3054,745,200400,58401
0,0,0,-,-,58402
1,0,1,-,-,58405
532,415,117,538,63300,58413
63,60,3,-,-,58415
178,156,22,-,96700,58416
207,180,27,-,82200,58418
108,104,4,-,191700,58420
1307,1007,300,720,168300,58421
68,59,9,-,154200,58422
42,42,0,-,117900,58423
135,120,15,-,238400,58424
505,403,102,497,128600,58425
63,52,11,-,131300,58426
103,67,36,-,165100,58428
136,111,25,-,190300,58429
55,55,0,-,143800,58430
64,60,4,-,196400,58431
529,414,115,524,120000,58433
639,456,183,779,171400,58436
334,269,65,702,69900,58438
66,66,0,-,-,58439
44,33,11,-,88300,58440
96,90,6,-,121900,58441
192,166,26,-,94100,58442
76,65,11,-,46800,58443
86,67,19,579,58100,58444
55,50,5,-,-,58445
155,114,41,658,125000,58448
34,31,3,-,114000,58451
13,13,0,-,-,58452
141,134,7,483,99500,58454
114,99,15,856,120800,58455
248,220,28,650,95200,58456
415,330,85,650,150400,58458
58,49,9,581,52800,58460
176,153,23,675,157300,58461
304,234,70,403,85000,58463
95,91,4,-,153100,58464
205,194,11,608,112600,58466
231,192,39,613,78100,58467
167,153,14,950,179200,58472
1105,873,232,698,166000,58474
77,76,1,-,-,58475
233,218,15,1286,115700,58476
54,39,15,-,96500,58477
71,64,7,-,-,58478
79,73,6,-,151800,58479
91,76,15,-,58200,58480
112,99,13,-,239300,58481
471,345,126,700,165500,58482
139,122,17,-,125000,58483
39,32,7,-,-,58484
74,67,7,-,93100,58486
202,156,46,800,91100,58487
105,89,16,479,-,58488
117,111,6,-,119200,58490
172,148,24,583,250000,58492
137,101,36,1031,137500,58494
494,381,113,640,114900,58495
77,57,20,425,179400,58496
89,77,12,-,252500,58497
11823,7269,4554,914,266100,58501
15057,11168,3889,1108,378800,58503
11704,8896,2808,935,275900,58504
0,0,0,-,-,58505
110,104,6,-,86700,58520
309,282,27,-,398000,58521
1373,1137,236,1054,221300,58523
31,31,0,-,-,58524
160,53,107,420,193800,58528
299,262,37,447,72300,58529
407,331,76,586,192900,58530
185,185,0,-,317000,58531
158,102,56,947,195000,58532
452,361,91,638,120300,58533
224,192,32,913,109500,58535
628,230,398,417,90000,58538
1244,1030,214,780,230300,58540
223,198,25,1313,124400,58541
103,89,14,1583,97100,58542
247,197,50,680,129000,58544
1400,1133,267,1055,191400,58545
98,91,7,-,164800,58549
732,568,164,618,109100,58552
11404,8212,3192,981,264100,58554
307,269,38,1214,289900,58558
143,124,19,-,245000,58559
90,75,15,784,317600,58560
450,364,86,775,93800,58561
136,128,8,-,81900,58562
735,633,102,871,194200,58563
52,50,2,-,-,58564
103,82,21,-,219000,58565
102,64,38,-,-,58566
152,96,56,750,95000,58568
44,44,0,-,-,58569
151,140,11,-,139300,58570
297,273,24,485,121900,58571
133,126,7,-,437500,58572
277,223,54,541,102200,58573
380,321,59,815,174600,58575
493,423,70,684,199700,58576
821,592,229,822,223700,58577
447,399,48,808,230600,58579
264,246,18,933,263300,58580
150,116,34,500,32500,58581
11768,7271,4497,982,264800,58601
74,58,16,-,99100,58620
495,359,136,854,147800,58621
652,500,152,1136,195300,58622
785,587,198,852,181300,58623
106,104,2,-,300000,58625
195,119,76,896,212500,58626
63,54,9,-,225000,58627
209,158,51,1341,231100,58630
456,362,94,785,110800,58631
101,71,30,-,143800,58632
128,103,25,-,232100,58634
327,258,69,900,130000,58636
376,296,80,795,108300,58638
783,558,225,536,121000,58639
481,336,145,1010,298200,58640
28,23,5,-,144300,58641
121,85,36,-,337500,58642
70,60,10,513,-,58643
9,9,0,-,-,58644
118,61,57,704,-,58645
465,377,88,933,89800,58646
506,374,132,844,163500,58647
136,107,29,-,56100,58649
194,167,27,800,87200,58650
227,208,19,-,113800,58651
473,412,61,585,173300,58652
268,222,46,725,128900,58653
96,92,4,-,95000,58654
233,208,25,770,284400,58655
166,150,16,590,197600,58656
14189,8568,5621,870,263600,58701
9609,5917,3692,1043,241700,58703
1276,4,1272,1458,-,58704
0,0,0,-,-,58705
0,0,0,-,-,58707
249,224,25,686,112500,58710
92,89,3,-,202500,58711
45,40,5,-,86900,58712
32,32,0,-,612100,58713
117,114,3,-,252400,58716
392,355,37,700,238200,58718
202,171,31,496,119300,58721
610,479,131,942,225900,58722
87,75,12,-,152500,58723
135,134,1,-,180800,58725
86,78,8,-,160300,58727
533,338,195,1061,168900,58730
143,107,36,1089,123000,58731
119,113,6,-,158000,58733
111,106,5,-,181300,58734
140,135,5,-,303800,58735
239,204,35,733,81700,58736
61,60,1,-,71100,58737
283,236,47,1042,200000,58740
282,252,30,725,121200,58741
75,73,2,-,187500,58744
707,535,172,792,143900,58746
64,62,2,-,-,58748
196,143,53,825,192100,58750
164,104,60,675,139100,58752
99,99,0,-,-,58755
83,77,6,-,130700,58756
341,130,211,842,166100,58757
119,117,2,-,112100,58758
248,227,21,1083,214600,58759
101,95,6,-,93900,58760
315,242,73,900,151400,58761
77,55,22,469,114800,58762
1432,748,684,786,200800,58763
143,126,17,1142,94600,58765
145,141,4,-,167900,58768
99,68,31,788,114000,58769
611,359,252,666,172600,58770
213,181,32,1047,133900,58771
91,64,27,629,80000,58772
375,336,39,1063,251100,58773
60,40,20,542,-,58775
122,20,102,1277,-,58776
60,60,0,-,430800,58778
131,106,25,531,-,58779
238,221,17,1000,263500,58781
192,175,17,725,55000,58782
183,162,21,559,210000,58783
1058,682,376,1167,217000,58784
595,576,19,-,292200,58785
32,26,6,-,-,58787
413,333,80,100-,111000,58788
166,139,27,-,123400,58789
578,432,146,700,219500,58790
106,67,39,-,244600,58792
219,195,24,-,125700,58793
87,63,24,-,-,58794
67,55,12,-,106900,58795
13202,6580,6622,1108,270100,58801
84,78,6,-,150000,58830
380,293,87,1154,346700,58831
88,65,23,575,154700,58833
308,291,17,-,327500,58835
147,122,25,-,210000,58838
281,263,18,1482,414100,58843
55,34,21,-,-,58844
313,265,48,-,183900,58845
108,71,37,-,282100,58847
515,381,134,871,237100,58849
893,577,316,1010,200200,58852
205,128,77,716,-,58853
3487,1683,1804,1286,367700,58854
38,35,3,-,225000,58856
667,537,130,863,295600,59001
74,30,44,1138,375000,59002
499,178,321,572,164300,59003
445,291,154,868,236000,59006
52,28,24,857,160700,59007
143,113,30,-,255000,59008
102,67,35,-,266100,59010
1222,920,302,813,264900,59011
26,17,9,-,-,59012
70,70,0,-,439100,59013
631,423,208,752,260300,59014
144,127,17,-,183800,59015
283,194,89,604,152500,59016
288,223,65,921,275000,59018
1712,1467,245,746,316700,59019
48,27,21,1156,394400,59020
464,331,133,725,87300,59022
142,104,38,392,165000,59024
22,0,22,-,-,59025
67,39,28,-,210400,59026
358,289,69,763,415800,59027
227,188,39,1125,491300,59028
359,295,64,799,253600,59029
714,329,385,706,392600,59030
65,57,8,-,-,59031
216,165,51,488,176000,59032
61,61,0,-,-,59033
1714,1052,662,726,162700,59034
95,89,6,-,131700,59035
639,480,159,714,171300,59036
867,845,22,-,286900,59037
284,202,82,875,208300,59038
10,8,2,-,-,59039
805,685,120,1175,311800,59041
677,389,288,525,110700,59043
5049,3758,1291,947,284500,59044
181,146,35,909,234000,59046
6080,4298,1782,941,396000,59047
347,242,105,663,169600,59050
62,50,12,1250,1375000,59052
109,101,8,-,181500,59053
105,89,16,-,177500,59054
32,14,18,944,225000,59055
348,333,15,415,447000,59057
9,9,0,-,-,59058
86,64,22,-,216700,59059
149,131,18,970,391700,59061
22,14,8,-,-,59062
740,594,146,1023,278800,59063
110,84,26,-,276900,59064
52,47,5,-,598700,59065
151,114,37,1875,170300,59066
77,51,26,-,341700,59067
1865,1225,640,861,392700,59068
235,221,14,1705,315000,59069
454,361,93,1166,471300,59070
42,31,11,-,-,59071
1936,1564,372,1058,223100,59072
198,181,17,675,118400,59074
71,60,11,-,190300,59075
20,6,14,-,275000,59076
24,14,10,-,-,59077
67,45,22,470,116300,59078
1527,1458,69,1467,303300,59079
53,51,2,-,577200,59081
6,4,2,-,-,59082
3,3,0,-,-,59083
58,58,0,-,95000,59085
399,311,88,1158,294800,59086
169,115,54,713,151600,59087
499,324,175,1023,222500,59088
147,85,62,553,217000,59089
17140,9919,7221,921,224200,59101
21063,14125,6938,1082,283700,59102
13312,10231,3081,1218,287900,59105
7457,5842,1615,1327,463900,59106
1654,1077,577,674,131400,59201
47,35,12,-,-,59211
122,100,22,734,191700,59212
238,195,43,-,63900,59213
27,24,3,-,-,59214
433,360,73,482,192700,59215
66,66,0,-,-,59217
385,264,121,811,243500,59218
62,54,8,-,116100,59219
819,661,158,685,227300,59221
119,105,14,-,106000,59222
21,21,0,-,-,59223
138,82,56,458,95000,59225
172,142,30,661,176400,59226
1715,1272,443,711,199100,59230
157,131,26,-,20800,59231
9,9,0,-,-,59240
201,146,55,550,115400,59241
32,30,2,-,115600,59242
154,119,35,775,245000,59243
10,10,0,-,333300,59244
156,113,43,800,88300,59247
386,325,61,763,202300,59248
107,76,31,-,-,59250
33,25,8,-,104200,59252
30,30,0,-,195000,59253
797,598,199,758,156500,59254
757,463,294,460,75800,59255
45,45,0,-,-,59256
24,17,7,-,-,59257
79,48,31,-,106300,59258
175,145,30,411,119000,59259
52,47,5,-,212500,59260
176,135,41,585,169300,59261
277,175,102,645,191800,59262
541,422,119,533,165500,59263
3486,2380,1106,827,249600,59270
4,3,1,-,-,59273
140,130,10,-,107400,59274
185,166,19,583,82800,59275
11,11,0,-,-,59276
4837,3205,1632,870,197100,59301
67,51,16,-,-,59311
5,5,0,-,-,59312
954,684,270,842,217300,59313
30,22,8,-,333300,59314
44,36,8,-,250000,59315
13,13,0,-,-,59316
456,365,91,670,150500,59317
50,48,2,-,207100,59318
17,13,4,-,"2,000,000+",59319
43,22,21,-,-,59322
941,787,154,638,147500,59323
331,217,114,617,113700,59324
105,56,49,894,231300,59326
980,648,332,740,188100,59327
3477,2479,998,794,202500,59330
87,31,56,-,-,59332
8,8,0,-,155000,59333
78,66,12,-,277300,59336
280,187,93,639,163900,59337
85,81,4,-,266400,59338
64,57,7,-,237500,59339
20,14,6,-,-,59343
174,145,29,635,330000,59344
21,19,2,-,165600,59345
134,104,30,-,242900,59347
387,313,74,527,127700,59349
97,79,18,-,216300,59351
468,349,119,964,103000,59353
53,15,38,-,-,59354
6088,3358,2730,766,186300,59401
10959,9309,1650,1003,262900,59404
13971,8016,5955,895,218200,59405
279,191,88,760,226100,59410
190,146,44,-,295800,59411
605,467,138,905,226900,59412
327,191,136,799,176500,59414
160,107,53,832,135900,59416
2186,1254,932,532,118800,59417
28,5,23,914,-,59418
41,33,8,-,117000,59419
79,67,12,-,-,59420
925,758,167,883,323900,59421
1084,766,318,874,210100,59422
27,16,11,-,272700,59424
1342,875,467,844,188300,59425
1617,1113,504,799,147400,59427
250,204,46,850,201800,59430
61,47,14,-,203600,59432
208,148,60,730,127200,59433
184,139,45,850,171500,59434
24,24,0,-,-,59435
824,651,173,1025,257500,59436
125,68,57,-,228200,59440
44,32,12,-,225000,59441
682,536,146,613,185900,59442
188,146,42,-,187500,59443
88,45,43,930,168000,59444
216,175,41,563,115300,59446
129,100,29,-,204000,59447
157,79,78,473,57500,59448
201,135,66,1342,226300,59450
76,48,28,-,111500,59451
229,170,59,514,195500,59452
144,119,25,608,157500,59453
77,67,10,-,73900,59454
72,30,42,-,261500,59456
4054,2650,1404,829,178100,59457
117,113,4,-,112300,59460
28,25,3,-,263200,59461
64,59,5,-,-,59462
74,68,6,-,333300,59463
231,167,64,810,189600,59464
23,23,0,-,176600,59465
55,26,29,-,-,59466
25,20,5,-,170800,59467
282,251,31,575,227300,59468
56,56,0,-,198100,59469
145,96,49,540,158300,59471
249,208,41,912,231700,59472
1269,837,432,723,176100,59474
125,104,21,-,192800,59477
335,236,99,408,170000,59479
131,116,15,875,216700,59480
219,138,81,791,145800,59482
163,146,17,-,366700,59483
42,31,11,-,187500,59484
253,252,1,-,267200,59485
496,386,110,729,143800,59486
561,424,137,857,173300,59487
179,158,21,558,-,59489
5005,3354,1651,770,198100,59501
464,325,139,-,119400,59520
1027,476,551,330,92800,59521
441,219,222,670,147500,59522
930,649,281,668,202600,59523
239,185,54,520,67900,59524
69,45,24,560,88900,59525
777,441,336,658,86500,59526
267,159,108,496,65400,59527
107,76,31,-,103100,59528
63,27,36,-,267300,59529
49,49,0,-,-,59530
140,120,20,-,101700,59531
59,56,3,-,-,59532
15,7,8,-,-,59535
29,29,0,-,-,59537
1227,980,247,550,179400,59538
197,106,91,632,116700,59540
114,79,35,613,87200,59542
83,50,33,285,245500,59544
34,34,0,-,101400,59545
87,84,3,-,827900,59546
21,13,8,-,157500,59547
14574,8429,6145,941,328500,59601
11371,9346,2025,1283,351100,59602
0,0,0,-,-,59623
0,0,0,-,-,59625
165,147,18,-,222600,59631
917,684,233,743,245300,59632
158,137,21,-,409500,59633
1835,1669,166,1181,447700,59634
3189,2717,472,909,299300,59635
0,0,0,-,-,59636
222,198,24,-,257100,59638
576,472,104,740,268800,59639
35,20,15,-,137500,59640
37,29,8,-,-,59642
319,294,25,-,210700,59643
1918,1473,445,871,300200,59644
677,571,106,850,267000,59645
172,155,17,-,298200,59647
170,124,46,964,319200,59648
14651,10161,4490,794,191500,59701
111,82,29,695,453800,59710
4451,2995,1456,653,181700,59711
60,40,20,910,188900,59713
9126,6360,2766,1312,410500,59714
15232,8524,6708,1195,692500,59715
971,641,330,1506,796900,59716
17623,10023,7600,1619,492500,59718
172,149,23,-,-,59720
192,138,54,864,491700,59721
1799,1242,557,753,208700,59722
52,32,20,1028,-,59724
3493,2242,1251,844,275000,59725
121,100,21,908,344800,59727
165,127,38,790,387500,59728
1037,797,240,1036,418700,59729
902,661,241,1398,716600,59730
71,63,8,475,362500,59731
64,35,29,725,-,59732
54,38,16,739,345000,59733
95,71,24,1196,356900,59735
66,47,19,-,304500,59736
143,127,16,-,171300,59739
197,173,24,-,608700,59740
2079,1630,449,1597,435500,59741
81,66,15,840,485700,59743
50,40,10,-,135700,59745
49,43,6,-,350000,59746
72,61,11,-,342300,59747
97,97,0,-,280900,59748
790,698,92,844,341200,59749
111,108,3,-,431700,59750
70,50,20,800,184400,59751
1698,1393,305,1233,362200,59752
382,266,116,927,331400,59754
56,52,4,-,280600,59755
15,0,15,-,-,59756
700,503,197,817,455800,59758
1599,1299,300,824,263400,59759
114,85,29,875,226800,59760
145,101,44,836,252500,59761
107,98,9,788,405300,59762
14586,5680,8906,1024,354900,59801
8881,4383,4498,1020,368900,59802
6374,4750,1624,1158,450500,59803
3265,2060,1205,1118,441300,59804
9438,6041,3397,1167,374900,59808
6,0,6,-,-,59812
830,728,102,878,324600,59820
942,679,263,971,334300,59821
773,664,109,775,426800,59823
590,459,131,842,267100,59824
871,772,99,1214,319000,59825
321,294,27,1250,468000,59826
175,149,26,572,420700,59827
2337,1877,460,1072,365100,59828
1088,828,260,914,374800,59829
64,45,19,-,228100,59830
194,146,48,597,115400,59831
301,235,66,626,244400,59832
2239,2011,228,991,416500,59833
845,718,127,1622,296400,59834
161,115,46,735,296700,59837
6554,4551,2003,936,355700,59840
205,139,66,1284,163400,59841
56,49,7,-,278100,59842
99,45,54,500,531300,59843
259,202,57,1069,387900,59844
578,389,189,599,173500,59845
634,617,17,-,404400,59846
2661,2086,575,1045,341900,59847
48,37,11,-,187500,59848
30,20,10,-,-,59851
384,293,91,773,296000,59853
91,72,19,719,407700,59854
184,127,57,826,96100,59855
89,83,6,-,438600,59856
671,480,191,1052,241000,59858
1856,1413,443,769,338900,59859
4660,3163,1497,882,357600,59860
89,89,0,-,-,59863
2547,1699,848,768,243200,59864
1309,919,390,496,318500,59865
469,359,110,865,302200,59866
10,10,0,-,-,59867
926,828,98,986,287700,59868
4842,3934,908,900,400200,59870
146,111,35,-,299000,59871
1058,845,213,709,251700,59872
1233,1024,209,619,216300,59873
793,648,145,559,445600,59874
1630,1349,281,916,380800,59875
23190,16695,6495,986,371600,59901
265,199,66,-,538000,59910
3843,3195,648,1215,556700,59911
5810,4598,1212,946,361600,59912
248,208,40,-,412500,59913
153,103,50,1142,865000,59914
155,100,55,-,-,59915
93,82,11,-,378600,59916
1992,1588,404,1014,292300,59917
221,189,32,1102,273800,59918
386,264,122,797,-,59919
543,469,74,911,477200,59920
1038,770,268,1130,477600,59922
4695,3403,1292,682,209200,59923
574,532,42,850,349700,59925
135,115,20,-,-,59926
122,82,40,-,428600,59927
78,68,10,-,600000,59928
84,82,2,-,-,59929
322,254,68,-,231800,59930
104,102,2,-,-,59931
661,451,210,1128,744300,59932
7,7,0,-,-,59933
279,209,70,853,291700,59934
1366,1081,285,1084,231800,59935
193,134,59,763,569000,59936
6417,4749,1668,1289,612500,59937
9229,7367,1862,1161,265700,60002
20391,15766,4625,1664,404400,60004
12740,7867,4873,1496,375400,60005
12795,9578,3217,1541,324900,60007
8757,6256,2501,1477,275800,60008
16901,14920,1981,2330,602900,60010
3953,3731,222,1859,374000,60012
9495,8334,1161,1465,283000,60013
17566,14204,3362,1342,275900,60014
10214,8506,1708,2198,592700,60015
24263,16565,7698,1334,285800,60016
9724,7064,2660,1136,287800,60018
5150,3823,1327,1184,203400,60020
1987,1661,326,2183,253300,60021
2993,2781,212,1705,1178300,60022
15989,12661,3328,1628,500500,60025
5608,3906,1702,1847,652700,60026
194,188,6,-,944900,60029
14311,11537,2774,1479,261200,60030
14331,10791,3540,1541,308300,60031
4902,3401,1501,1123,191900,60033
698,501,197,1065,245500,60034
12098,10175,1923,1904,593100,60035
1904,958,946,1770,502800,60040
3570,2748,822,951,224800,60041
3113,2544,569,1747,225300,60042
789,759,30,"3,500+",1358000,60043
4334,2974,1360,1645,542300,60044
7573,6618,955,1998,880200,60045
12086,9957,2129,1551,267200,60046
14866,13403,1463,1732,491500,60047
10633,8994,1639,1476,517700,60048
12825,9756,3069,1472,227500,60050
9171,7672,1499,1582,255500,60051
9166,7925,1241,2217,366300,60053
22084,15447,6637,1370,367200,60056
13390,9950,3440,1503,292200,60060
10608,7069,3539,1879,374800,60061
16566,13637,2929,1847,602100,60062
5390,2113,3277,1076,120900,60064
15294,11589,3705,1462,429100,60067
15211,12938,2273,1487,519200,60068
3616,2907,709,2778,550000,60069
6230,4089,2141,1313,332800,60070
1800,1272,528,1107,297700,60071
350,342,8,-,368900,60072
19333,14797,4536,1457,202800,60073
14237,8821,5416,1389,286900,60074
0,0,0,-,-,60075
11462,9197,2265,1546,378100,60076
10919,7183,3736,1416,318600,60077
3269,3060,209,1165,314900,60081
3556,3356,200,1758,281400,60083
6387,5033,1354,1242,275900,60084
24590,10859,13731,1095,150700,60085
9698,5768,3930,1270,171400,60087
1332,11,1321,1813,-,60088
15731,13088,2643,1988,380500,60089
15462,9668,5794,1474,236700,60090
10328,9006,1322,1918,768600,60091
7137,6453,684,1855,1069400,60093
2725,2370,355,1115,231600,60096
4421,3808,613,1237,195200,60097
12699,9198,3501,1154,242700,60098
11364,7108,4256,1083,172100,60099
13651,9260,4391,1224,300400,60101
11833,10199,1634,1823,302800,60102
14652,12656,1996,1909,337000,60103
6121,4719,1402,1140,207000,60104
7502,4167,3335,1330,264400,60106
13205,11352,1853,1760,244200,60107
9202,6804,2398,1580,358300,60108
173,124,49,1232,279200,60109
11791,8668,3123,1383,213500,60110
77,72,5,-,344400,60111
1709,1255,454,1423,195500,60112
81,60,21,888,144400,60113
16992,7145,9847,983,193700,60115
6455,4472,1983,1380,323300,60118
4103,3875,228,1446,341300,60119
16113,10530,5583,1203,214700,60120
17693,12336,5357,1158,233600,60123
8690,8417,273,1866,367700,60124
17680,14223,3457,1855,506100,60126
104,94,10,642,140500,60129
7328,4044,3284,1271,267600,60130
5759,4242,1517,1111,246500,60131
11113,8361,2752,1463,247500,60133
11129,9547,1582,1748,410000,60134
2738,2031,707,1079,219500,60135
2729,2290,439,1813,317600,60136
14651,11853,2798,1218,476800,60137
11276,7288,3988,1485,234900,60139
7290,6044,1246,1616,307600,60140
150,0,150,585,-,60141
12887,11587,1300,1337,304400,60142
4572,3323,1249,1633,385600,60143
38,30,8,1063,307700,60144
956,794,162,845,223000,60145
889,648,241,1093,200000,60146
20170,14314,5856,1704,316000,60148
677,461,216,978,178600,60150
1450,1263,187,1596,325200,60151
4547,3409,1138,1001,242200,60152
7672,4779,2893,1143,195700,60153
7145,6502,643,1680,284600,60154
2995,2007,988,1128,216000,60155
9878,8501,1377,1579,280000,60156
947,922,25,-,459500,60157
8104,4463,3641,1143,248500,60160
2961,1818,1143,1421,228600,60162
1886,1716,170,979,214800,60163
7226,5276,1950,1088,228600,60164
1241,673,568,1104,215500,60165
12170,7972,4198,1595,282700,60169
3822,2293,1529,1244,240700,60171
9102,7179,1923,1470,305500,60172
6586,2213,4373,1706,315900,60173
12742,8528,4214,1671,333800,60174
8594,8342,252,2803,457200,60175
4311,2464,1847,1212,269700,60176
8318,6719,1599,1637,284400,60177
8648,6184,2464,1060,257700,60178
580,500,80,1736,275300,60180
11384,7748,3636,1564,282800,60181
0,0,0,-,-,60183
891,842,49,-,664100,60184
10626,8275,2351,1359,299800,60185
10252,7170,3082,1661,414000,60187
15267,10565,4702,1398,299300,60188
11998,9475,2523,1706,453200,60189
4434,4115,319,1453,354300,60190
5226,4025,1201,1646,283800,60191
5829,5294,535,2466,407400,60192
15629,11585,4044,1595,314000,60193
7909,5550,2359,1789,285400,60194
2341,701,1640,1621,199200,60195
16967,9456,7511,1700,557200,60201
13917,7824,6093,1564,369100,60202
1661,1558,103,1854,468000,60203
16,0,16,-,-,60208
2040,333,1707,2224,208000,60301
14698,8798,5900,1308,446000,60302
6607,4763,1844,1255,445400,60304
4341,3809,532,1347,668900,60305
2947,2451,496,1112,222100,60401
22598,14421,8177,1107,264500,60402
7710,5245,2465,1346,208200,60403
6907,6588,319,2032,300400,60404
9182,4493,4689,1038,159400,60406
584,474,110,1125,161800,60407
2039,1610,429,1148,204000,60408
14412,8520,5892,1083,125600,60409
4433,3890,543,1689,284300,60410
18205,11772,6433,1142,131100,60411
5251,3041,2210,1161,203300,60415
3773,2933,840,1098,219800,60416
5837,5203,634,1227,216700,60417
4868,3671,1197,1126,185700,60418
8110,5902,2208,1301,128800,60419
1847,1247,600,978,158600,60420
1573,1412,161,1050,232900,60421
3585,3428,157,2172,285400,60422
10999,10211,788,1416,367400,60423
845,638,207,953,181600,60424
3017,2372,645,1644,155700,60425
8396,4380,4016,986,90200,60426
3611,2515,1096,1581,101300,60428
5172,3435,1737,1457,161900,60429
7394,5796,1598,1316,192600,60430
8904,8013,891,1359,262200,60431
6287,3357,2930,1185,171200,60432
5308,3458,1850,1226,159700,60433
18872,12303,6569,1109,202300,60435
6372,3647,2725,1178,159400,60436
36,35,1,-,121900,60437
11327,8102,3225,1210,158000,60438
8701,7744,957,1078,456000,60439
17537,12963,4574,1596,242100,60440
12460,10110,2350,1486,274900,60441
4469,4100,369,996,323600,60442
8359,6363,1996,1397,212200,60443
714,593,121,917,203500,60444
5925,4603,1322,1152,183800,60445
12592,10596,1996,1760,233800,60446
5376,4819,557,1454,270200,60447
9013,8258,755,1353,360900,60448
3704,3440,264,1339,247400,60449
8702,5721,2981,1108,255600,60450
12425,11572,853,1224,352000,60451
10048,8016,2032,1262,233600,60452
21984,17994,3990,1285,250900,60453
6182,4140,2042,1058,224700,60455
1907,1421,486,585,151400,60456
5288,3822,1466,1018,270100,60457
4986,2634,2352,1207,219800,60458
9463,7601,1862,1223,250100,60459
555,441,114,1018,144100,60460
1883,1642,241,"3,500+",275100,60461
16074,13366,2708,1379,321700,60462
5323,5048,275,1696,329400,60463
3795,3471,324,1661,452900,60464
7356,5814,1542,1248,241000,60465
8052,4964,3088,1370,94300,60466
9690,8977,713,1660,375800,60467
2251,1651,600,988,270200,60468
1598,1292,306,1316,152100,60469
160,135,25,713,120100,60470
5189,2543,2646,1241,183000,60471
1433,845,588,1022,105600,60472
7719,6416,1303,1866,180300,60473
281,251,30,1225,154100,60474
4285,2643,1642,976,125000,60475
916,770,146,1101,130400,60476
15266,12610,2656,1374,247000,60477
5545,4370,1175,1629,163100,60478
303,233,70,1255,184700,60479
2353,1948,405,1345,337700,60480
4691,3449,1242,939,205800,60481
4535,2865,1670,1124,207600,60482
2429,1659,770,1278,128200,60484
9026,8520,506,1394,321300,60487
6413,5899,514,2228,362000,60490
7560,7128,432,1465,385500,60491
3807,2244,1563,1019,217300,60501
8331,6758,1573,1875,365200,60502
5098,4608,490,2057,302500,60503
13754,8480,5274,1806,258700,60504
17930,10664,7266,1212,177500,60505
17784,11507,6277,1209,224900,60506
10440,8072,2368,1264,353700,60510
628,569,59,1386,268900,60511
330,268,62,-,270600,60512
7742,6147,1595,1201,298600,60513
3812,3068,744,1181,549800,60514
11803,9112,2691,1460,437300,60515
11468,8866,2602,1594,406000,60516
12778,8568,4210,1431,330400,60517
1512,1026,486,960,148700,60518
34,34,0,-,232700,60519
1121,895,226,1508,285700,60520
6079,5374,705,1857,954200,60521
4399,3497,902,669,714700,60523
12500,9938,2562,1372,395700,60525
5197,3819,1378,1387,394800,60526
12111,9435,2676,1529,491200,60527
247,211,36,1156,253800,60530
850,605,245,1477,215200,60531
12945,7204,5741,1463,375200,60532
4022,2598,1424,1062,222700,60534
33,28,5,1094,187500,60536
228,212,16,1375,187500,60537
9617,7483,2134,1678,242700,60538
0,0,0,-,-,60539
15577,11640,3937,1806,482200,60540
1096,937,159,1521,293800,60541
6962,5150,1812,1585,300300,60542
14398,12477,1921,1494,303500,60543
10214,8847,1367,1752,289500,60544
4703,3407,1296,1536,223900,60545
6324,4841,1483,1190,374700,60546
4354,3531,823,1123,216000,60548
185,167,18,-,287500,60549
512,353,159,846,197700,60550
1409,1158,251,977,228700,60551
1668,1372,296,1047,238200,60552
248,210,38,1321,165000,60553
4523,4103,420,1146,342600,60554
5681,4431,1250,1673,256900,60555
746,605,141,859,224300,60556
64,64,0,-,-,60557
4521,4368,153,1871,680900,60558
10031,5734,4297,1415,348700,60559
9232,7838,1394,1458,321400,60560
9343,7498,1845,1725,378300,60561
15830,8574,7256,1729,409400,60563
15344,13353,1991,2182,523400,60564
13659,12090,1569,1797,463600,60565
7534,6844,690,2323,394300,60585
13928,12883,1045,1928,284600,60586
9252,2820,6432,2513,556900,60601
468,267,201,2277,-,60602
674,458,216,2056,757500,60603
452,170,282,2167,601300,60604
18817,8035,10782,2330,480000,60605
2666,879,1787,2366,352900,60606
13474,6179,7295,2358,487000,60607
29081,11492,17589,1168,321600,60608
22973,9103,13870,977,228800,60609
25622,9607,16015,1959,503100,60610
23054,10016,13038,2388,655500,60611
14255,4604,9651,1247,342700,60612
28437,10632,17805,1593,399300,60613
34068,15390,18678,1949,730300,60614
22490,7052,15438,1374,306400,60615
24744,9389,15355,1240,391100,60616
30306,17376,12930,994,160800,60617
37060,18716,18344,1461,502700,60618
28103,12257,15846,1018,196600,60619
26150,12697,13453,1044,177500,60620
11134,2827,8307,972,125100,60621
25088,10462,14626,1854,616500,60622
26964,10179,16785,1008,203400,60623
13358,3725,9633,1099,223700,60624
31234,12476,18758,1415,395000,60625
23460,6823,16637,1202,268500,60626
23332,13081,10251,1140,150900,60628
33825,19979,13846,1024,224500,60629
21340,14422,6918,1323,358000,60630
11977,8902,3075,1550,407400,60631
26662,14902,11760,983,226200,60632
4951,3167,1784,1117,169300,60633
27488,20320,7168,1237,321200,60634
11334,5675,5659,1054,130600,60636
22272,5724,16548,1119,240600,60637
20642,16283,4359,1201,274100,60638
26601,12634,13967,1162,279400,60639
37129,11805,25324,1318,353200,60640
25018,13439,11579,1207,357900,60641
11044,3704,7340,2109,593300,60642
18197,13531,4666,1249,228300,60643
18557,5257,13300,1083,225100,60644
17000,8692,8308,1349,309800,60645
10806,8706,2100,1252,480700,60646
37624,14475,23149,1623,538100,60647
24076,5893,18183,1054,187200,60649
20754,9241,11513,1177,241600,60651
13643,11585,2058,1308,226700,60652
16967,5003,11964,856,342400,60653
15073,5237,9836,2490,496200,60654
10672,9020,1652,1355,297200,60655
12524,7746,4778,1364,339200,60656
38694,14603,24091,1781,526600,60657
13657,6217,7440,1331,356200,60659
21002,7700,13302,1223,277700,60660
7234,2269,4965,2396,404700,60661
9448,6988,2460,1187,332200,60706
15767,9933,5834,1285,308700,60707
4669,3833,836,3272,450700,60712
11391,8725,2666,1217,336900,60714
9082,6002,3080,1088,191400,60803
24600,13432,11168,1094,224300,60804
7449,6214,1235,1209,244000,60805
9347,3373,5974,1020,112900,60827
13145,7866,5279,980,138700,60901
229,165,64,939,139400,60910
487,371,116,906,151700,60911
264,204,60,732,83300,60912
655,569,86,754,224200,60913
9621,6853,2768,1175,231300,60914
4048,2552,1496,1094,134300,60915
167,163,4,825,164800,60917
279,240,39,800,93500,60918
228,166,62,1026,143800,60919
81,71,10,910,151800,60920
652,487,165,677,102800,60921
971,679,292,978,156800,60922
678,530,148,675,144200,60924
39,37,2,-,80400,60926
912,733,179,900,168100,60927
244,201,43,788,109000,60928
267,204,63,938,105600,60929
278,209,69,992,131500,60930
195,166,29,921,111300,60931
134,128,6,-,578000,60932
121,98,23,917,80000,60933
78,59,19,950,135200,60934
399,361,38,1118,230700,60935
1921,1371,550,664,124700,60936
718,579,139,693,115400,60938
0,0,0,-,-,60939
1096,920,176,1167,228800,60940
617,490,127,967,203200,60941
2383,1619,764,836,72700,60942
93,81,12,1036,93700,60945
165,128,37,965,56500,60946
740,706,34,1063,243000,60948
204,140,64,541,127000,60949
5233,3618,1615,959,240900,60950
317,248,69,790,150000,60951
251,214,37,809,80000,60952
946,751,195,716,88300,60953
2230,1670,560,931,154000,60954
622,559,63,727,109200,60955
46,32,14,738,100000,60956
2261,1812,449,619,118000,60957
650,433,217,818,84500,60958
431,322,109,723,94200,60959
321,250,71,732,78500,60960
359,337,22,1263,132400,60961
226,151,75,1022,72500,60962
530,417,113,872,95300,60963
1841,1373,468,760,183200,60964
744,509,235,687,73500,60966
0,0,0,-,-,60967
208,193,15,533,89600,60968
23,20,3,-,160000,60969
2633,1984,649,758,112400,60970
129,97,32,844,77600,60973
116,83,33,888,81700,60974
568,468,100,1021,232100,61001
619,487,132,750,154400,61006
143,131,12,-,144400,61007
12756,10119,2637,911,166800,61008
2824,2185,639,1002,212800,61010
956,904,52,1726,273500,61011
764,643,121,933,163200,61012
290,269,21,625,110000,61013
444,384,60,850,99200,61014
313,266,47,-,215200,61015
2114,1861,253,850,217600,61016
369,298,71,788,153800,61018
1234,1063,171,1103,216300,61019
1009,923,86,1071,189600,61020
9130,6354,2776,771,138900,61021
972,763,209,746,160700,61024
2089,1611,478,854,176000,61025
32,17,15,-,-,61027
810,680,130,821,161300,61028
862,729,133,824,137800,61030
620,429,191,817,126500,61031
13266,8320,4946,759,97400,61032
3281,2609,672,719,251800,61036
52,52,0,-,137500,61037
343,328,15,-,221000,61038
300,236,64,741,140300,61039
619,420,199,759,110800,61041
169,139,30,914,156900,61042
50,36,14,863,135000,61043
98,98,0,-,143300,61044
1152,1003,149,806,137500,61046
628,545,83,983,189200,61047
1619,1366,253,613,158300,61048
208,150,58,929,175000,61049
124,106,18,-,197700,61050
657,528,129,681,95900,61051
429,381,48,1070,174200,61052
1132,887,245,734,108200,61053
1776,1170,606,507,126600,61054
26,26,0,-,-,61057
65,40,25,1114,68000,61059
601,512,89,577,150000,61060
3063,2318,745,782,187600,61061
719,577,142,848,175200,61062
1646,1433,213,1123,147600,61063
1679,1101,578,818,153800,61064
3518,3360,158,1619,190400,61065
327,284,43,830,178400,61067
5902,3548,2354,854,153900,61068
530,498,32,1156,177400,61070
5865,4308,1557,787,102700,61071
4217,3612,605,839,218300,61072
7138,5814,1324,1224,220800,61073
1917,1215,702,756,90300,61074
433,371,62,746,215400,61075
61,61,0,-,-,61077
458,408,50,717,131000,61078
97,82,15,1016,98400,61079
4423,3163,1260,887,164200,61080
8831,6243,2588,763,120000,61081
1189,1027,162,810,199300,61084
1345,1051,294,812,125500,61085
690,621,69,733,104100,61087
2349,2106,243,1115,183800,61088
265,198,67,778,124100,61089
0,0,0,-,-,61091
7947,4164,3783,922,83800,61101
6320,3798,2522,845,81100,61102
10053,5345,4708,916,103900,61103
8049,2951,5098,788,77500,61104
12776,8809,3967,980,156100,61107
11771,7572,4199,961,123000,61108
10891,6975,3916,901,125800,61109
9660,6084,3576,999,137700,61111
63,0,63,-,-,61112
6372,4448,1924,1204,183700,61114
8558,6871,1687,1113,150400,61115
15439,9627,5812,803,115700,61201
378,339,39,688,150300,61230
2182,1370,812,767,130800,61231
682,601,81,783,166500,61232
116,92,24,786,135500,61233
478,372,106,627,131500,61234
671,537,134,860,127900,61235
27,22,5,-,113900,61236
0,0,0,-,-,61237
1144,1022,122,931,130400,61238
507,195,312,971,95900,61239
2340,2143,197,-,234100,61240
2825,2351,474,850,156300,61241
507,441,66,910,198400,61242
114,98,16,-,310000,61243
9263,6327,2936,778,132800,61244
1159,880,279,826,161800,61250
167,150,17,-,171100,61251
2433,1828,605,873,137400,61252
4950,4044,906,921,211300,61254
879,703,176,972,167500,61256
316,250,66,1700,95000,61257
70,66,4,-,70000,61258
580,527,53,-,210800,61259
300,221,79,589,99200,61260
290,230,60,1144,111000,61261
281,238,43,750,209200,61262
288,203,85,779,131300,61263
4619,3595,1024,902,149900,61264
18984,12735,6249,884,140600,61265
2770,2254,516,906,144200,61270
501,423,78,496,122700,61272
1126,967,159,855,170900,61273
108,95,13,-,129700,61274
1726,1463,263,639,237600,61275
24,24,0,-,85500,61276
1126,931,195,765,124600,61277
266,242,24,1193,247100,61278
366,342,24,1000,147200,61279
1020,934,86,750,200300,61281
4215,2424,1791,932,130800,61282
487,416,71,836,111800,61283
785,692,93,795,229000,61284
751,645,106,814,158300,61285
4403,2844,1559,955,110200,61301
1546,1134,412,818,166600,61310
93,83,10,-,-,61311
188,145,43,1094,145200,61312
105,97,8,-,168800,61313
369,282,87,945,92200,61314
88,56,32,781,46400,61315
94,79,15,875,91000,61316
212,172,40,795,87600,61317
245,177,68,1143,124200,61318
600,545,55,882,156600,61319
275,229,46,867,148900,61320
117,77,40,717,92500,61321
555,438,117,866,59300,61322
52,48,4,-,110700,61323
40,24,16,-,116700,61324
400,352,48,563,164600,61325
840,647,193,730,135700,61326
514,452,62,821,211000,61327
30,30,0,-,-,61328
522,423,99,819,123600,61329
479,389,90,789,139400,61330
0,0,0,-,-,61331
66,58,8,950,81700,61332
96,92,4,-,95000,61333
259,217,42,850,112500,61334
133,114,19,688,137500,61335
243,196,47,640,175000,61336
187,154,33,940,98300,61337
115,85,30,744,89000,61338
226,171,55,814,150500,61340
2873,2174,699,1046,165700,61341
3424,2553,871,791,131300,61342
128,111,17,1031,64200,61344
302,268,34,771,97300,61345
30,26,4,-,72500,61346
2010,1594,416,595,130500,61348
402,346,56,705,113600,61349
9958,7077,2881,909,154400,61350
463,356,107,854,152100,61353
4607,3431,1176,844,161500,61354
4728,3550,1178,731,149600,61356
168,158,10,-,132100,61358
191,162,29,678,94700,61359
1290,1020,270,1028,225900,61360
517,440,77,841,125900,61361
2418,1598,820,909,124500,61362
153,126,27,720,100800,61363
8447,5695,2752,768,90800,61364
349,197,152,974,197700,61367
549,427,122,817,117900,61368
617,478,139,773,110200,61369
487,400,87,730,148000,61370
46,0,46,-,-,61371
88,71,17,738,163800,61372
777,679,98,1118,211900,61373
27,20,7,-,85000,61374
468,439,29,725,157400,61375
907,664,243,848,121600,61376
672,467,205,699,111600,61377
167,100,67,1075,162500,61378
543,424,119,775,94700,61379
13663,8364,5299,683,89800,61401
0,0,0,-,-,61402
1565,1193,372,767,79400,61410
171,101,70,-,102500,61411
522,491,31,763,94200,61412
414,340,74,900,125800,61413
334,311,23,735,108200,61414
795,660,135,715,101400,61415
124,118,6,-,45300,61416
99,99,0,-,90700,61417
285,270,15,950,98500,61418
71,59,12,-,96300,61419
425,328,97,783,88100,61420
577,453,124,857,82700,61421
1292,934,358,637,75000,61422
250,176,74,-,120600,61423
15,12,3,-,-,61424
180,154,26,-,75600,61425
35,35,0,-,30900,61426
912,745,167,818,117100,61427
453,415,38,593,244100,61428
291,238,53,748,106800,61430
143,131,12,-,113500,61431
280,243,37,-,85700,61432
9,9,0,-,-,61433
1196,978,218,753,86100,61434
54,31,23,-,-,61435
369,316,53,817,173800,61436
280,210,70,950,145700,61437
281,241,40,768,113700,61438
106,79,27,833,95600,61439
324,280,44,743,83600,61440
334,286,48,811,96700,61441
309,272,37,564,72900,61442
5691,4032,1659,752,72700,61443
456,402,54,713,96100,61447
1570,1340,230,688,132800,61448
133,122,11,-,49400,61449
772,640,132,675,95800,61450
72,65,7,-,112500,61451
78,72,6,-,69200,61452
277,211,66,777,86800,61453
209,163,46,666,81700,61454
7350,3775,3575,685,117300,61455
223,187,36,753,99300,61458
130,128,2,-,86700,61459
77,65,12,825,81700,61460
4316,3217,1099,670,100600,61462
513,478,35,593,101700,61465
105,101,4,800,93100,61466
441,357,84,831,118900,61467
72,72,0,-,94300,61468
908,820,88,643,99600,61469
213,195,18,933,104800,61470
47,47,0,-,75000,61471
189,172,17,715,165200,61472
562,397,165,755,100400,61473
125,97,28,-,70300,61474
107,89,18,-,113300,61475
246,227,19,625,122700,61476
206,200,6,-,137500,61477
116,116,0,-,71800,61478
12,12,0,-,220000,61479
495,386,109,733,115600,61480
222,174,48,756,80700,61482
755,551,204,759,102200,61483
351,299,52,408,52500,61484
144,118,26,744,82500,61485
604,532,72,922,121000,61486
548,434,114,569,119000,61488
338,317,21,588,108200,61489
522,393,129,660,138200,61490
1022,791,231,645,111300,61491
768,585,183,648,64600,61501
279,273,6,925,122500,61516
1133,950,183,846,244100,61517
100,79,21,575,118800,61519
6460,4711,1749,771,110600,61520
4383,3630,753,920,153300,61523
155,141,14,900,108800,61524
3995,3404,591,1296,311300,61525
332,320,12,-,266300,61526
1181,1145,36,-,297400,61528
991,800,191,741,152700,61529
2729,1882,847,844,162600,61530
1304,1018,286,921,114700,61531
191,135,56,859,107600,61532
878,707,171,762,142200,61533
703,571,132,799,153100,61534
697,686,11,-,236000,61535
1425,1170,255,837,164700,61536
1190,878,312,705,120300,61537
68,52,16,675,73300,61539
1058,844,214,870,138100,61540
55,38,17,1057,72500,61541
1469,1128,341,739,112300,61542
52,30,22,500,56700,61543
290,245,45,869,92600,61544
329,308,21,1288,169000,61545
1653,1442,211,702,128800,61546
1430,1384,46,544,235000,61547
4625,4181,444,1036,235900,61548
7601,6075,1526,989,231500,61550
78,78,0,-,91700,61552
91,79,12,778,66300,61553
17247,12146,5101,749,120600,61554
1453,1208,245,971,173100,61559
305,282,23,-,215800,61560
932,744,188,1107,147500,61561
64,64,0,-,87700,61562
251,241,10,825,62700,61563
382,310,72,814,96600,61564
614,502,112,625,153300,61565
268,222,46,871,94400,61567
1749,1329,420,936,224900,61568
428,389,39,839,183500,61569
679,558,121,852,96600,61570
9552,7777,1775,1022,195500,61571
444,351,93,750,94500,61572
608,100,508,826,235500,61602
6528,3122,3406,961,69600,61603
12056,7986,4070,892,96500,61604
5836,2257,3579,810,47800,61605
2540,1085,1455,895,121600,61606
4300,3711,589,921,153600,61607
2083,1600,483,692,83800,61610
9883,7761,2122,879,160500,61611
13319,8179,5140,907,168000,61614
10573,6582,3991,997,203100,61615
2794,1744,1050,889,105300,61616
10,0,10,-,-,61625
16187,9047,7140,862,133100,61701
15517,10197,5320,1027,233100,61704
4875,3921,954,1165,286800,61705
113,92,21,1150,99500,61720
231,207,24,1179,129000,61721
236,195,41,1096,118100,61722
1037,856,181,767,141300,61723
160,148,12,690,113200,61724
607,565,42,1293,222500,61725
938,683,255,815,132700,61726
4077,2874,1203,813,114000,61727
489,360,129,789,143200,61728
404,349,55,938,219700,61729
135,98,37,938,157500,61730
42,29,13,-,265000,61731
743,674,69,1109,188200,61732
373,295,78,1109,172700,61733
1002,832,170,900,139300,61734
139,129,10,-,164200,61735
918,798,120,964,284300,61736
180,163,17,-,141300,61737
1490,1130,360,899,158300,61738
1894,1312,582,798,155700,61739
605,506,99,837,132200,61740
654,533,121,647,158400,61741
489,448,41,1090,226200,61742
78,60,18,727,112500,61743
652,473,179,696,140600,61744
1588,1349,239,958,204200,61745
587,466,121,864,181700,61747
987,942,45,432,210000,61748
291,257,34,833,91000,61749
43,4,39,-,-,61750
30,30,0,-,81300,61751
1723,1491,232,762,170100,61752
1296,1109,187,825,196200,61753
424,348,76,1125,138200,61754
1834,1551,283,909,202500,61755
954,738,216,784,163500,61756
529,458,71,746,141700,61759
953,657,296,959,120000,61760
19823,11108,8715,925,195300,61761
5501,3595,1906,823,121200,61764
247,244,3,-,103100,61769
418,329,89,860,106300,61770
309,297,12,1042,247100,61771
80,56,24,1313,257700,61772
141,114,27,1146,132400,61773
371,309,62,953,129700,61774
123,107,16,1063,113000,61775
552,488,64,967,189100,61776
439,361,78,733,134800,61777
243,233,10,-,89000,61778
11101,3229,7872,915,173700,61801
9151,4888,4263,948,158100,61802
82,71,11,613,97900,61810
265,207,58,815,127500,61811
106,98,8,-,125000,61812
694,559,135,708,101500,61813
501,431,70,885,115800,61814
128,85,43,892,154900,61815
158,132,26,950,136800,61816
1103,801,302,862,118400,61817
664,513,151,820,113600,61818
14416,3129,11287,1001,156600,61820
12359,7420,4939,1012,165800,61821
11175,7585,3590,1255,246800,61822
161,128,33,858,120000,61830
82,82,0,-,153600,61831
13630,8017,5613,761,81200,61832
970,738,232,738,57700,61833
2528,2150,378,1002,157600,61834
210,144,66,769,103800,61839
214,192,22,-,250000,61840
430,381,49,736,126700,61841
990,855,135,906,151100,61842
786,685,101,850,165100,61843
345,311,34,1029,131500,61844
118,93,25,-,259400,61845
2030,1476,554,704,77000,61846
493,438,55,875,172300,61847
103,76,27,929,82700,61848
757,673,84,879,160900,61849
171,166,5,725,63800,61850
147,134,13,838,126900,61851
65,60,5,-,-,61852
4913,4176,737,1189,257800,61853
573,490,83,1050,153900,61854
40,35,5,-,92800,61855
3392,2829,563,991,208400,61856
68,60,8,-,77700,61857
1093,924,169,725,126800,61858
442,398,44,1250,162400,61859
228,202,26,644,140800,61862
321,281,40,850,169300,61863
558,495,63,1054,194200,61864
486,409,77,722,101000,61865
5585,3008,2577,883,105200,61866
512,372,140,813,83400,61870
143,122,21,963,146600,61871
247,232,15,860,150000,61872
2165,1865,300,773,228700,61873
3453,1977,1476,995,260200,61874
377,322,55,864,282100,61875
281,259,22,810,71200,61876
488,419,69,1131,187500,61877
556,458,98,825,115400,61878
1737,1345,392,767,206700,61880
249,220,29,811,125000,61882
1802,1379,423,734,93800,61883
436,410,26,-,260200,61884
1449,1078,371,785,150000,61910
1650,1236,414,701,154700,61911
540,477,63,719,96000,61912
542,469,73,688,112900,61913
843,659,184,725,102600,61914
227,211,16,-,79000,61917
324,286,38,525,146200,61919
8739,4713,4026,821,135500,61920
854,599,255,721,106600,61924
446,364,82,622,117100,61925
272,250,22,892,150800,61928
299,242,57,788,102200,61929
278,254,24,817,86800,61930
490,385,105,842,116800,61931
247,160,87,942,80900,61932
438,321,117,384,75300,61933
96,86,10,-,132100,61936
730,518,212,693,88200,61937
9342,5586,3756,743,100300,61938
137,97,40,693,48100,61940
77,77,0,-,92300,61941
441,401,40,729,96500,61942
684,537,147,522,98500,61943
5448,3992,1456,711,95800,61944
80,70,10,675,73300,61949
3010,2444,566,835,135200,61951
2695,2088,607,743,159900,61953
64,54,10,1125,55400,61955
1252,984,268,785,110100,61956
750,612,138,741,109900,61957
709,574,135,806,180100,62001
13042,8321,4721,910,108100,62002
119,118,1,-,182500,62006
708,495,213,802,78400,62009
4555,3597,958,906,165100,62010
121,121,0,-,-,62011
2327,2116,211,1034,154400,62012
165,144,21,869,120000,62013
1443,1218,225,872,172300,62014
239,182,57,1051,87300,62015
1478,1021,457,817,112900,62016
471,394,77,856,95500,62017
1111,850,261,999,79700,62018
129,96,33,606,-,62019
373,373,0,-,222100,62021
321,283,38,-,259900,62022
46,46,0,-,71100,62023
4161,3197,964,787,111300,62024
13020,9601,3419,1118,276900,62025
0,0,0,-,-,62026
218,184,34,-,110700,62027
251,184,67,734,153800,62028
21,14,7,-,94000,62030
270,256,14,-,111300,62031
326,268,58,677,87100,62032
1871,1362,509,707,103800,62033
5971,4098,1873,1127,265800,62034
6641,5492,1149,1088,166200,62035
207,195,12,-,206900,62036
656,537,119,-,222700,62037
16883,12162,4721,851,100400,62040
742,619,123,755,99400,62044
147,146,1,-,97900,62045
349,267,82,738,225000,62046
411,339,72,410,163100,62047
723,565,158,926,71100,62048
2597,1960,637,699,118200,62049
109,99,10,763,109300,62050
337,265,72,471,88800,62051
4740,3563,1177,801,157500,62052
96,73,23,569,79600,62053
140,119,21,638,91700,62054
3878,2707,1171,652,113000,62056
352,267,85,596,96900,62058
204,115,89,720,32600,62059
1793,935,858,888,48100,62060
622,552,70,908,170900,62061
3476,2983,493,927,236100,62062
391,331,60,786,117700,62063
861,702,159,975,204800,62067
1408,1100,308,776,99200,62069
445,409,36,788,248500,62074
1311,1053,258,802,87200,62075
45,45,0,-,104200,62076
136,116,20,1067,68600,62077
31,28,3,-,-,62078
138,99,39,775,255800,62079
935,796,139,779,87400,62080
99,98,1,-,81300,62081
1007,865,142,767,75900,62082
99,99,0,-,208800,62083
705,539,166,929,94900,62084
70,61,9,733,81300,62085
463,414,49,803,85900,62086
761,527,234,782,87000,62087
2609,2084,525,838,132100,62088
265,221,44,744,68400,62089
457,215,242,749,51200,62090
115,115,0,-,116100,62091
920,677,243,672,62400,62092
189,144,45,817,73000,62093
409,293,116,508,50900,62094
4596,3231,1365,896,103600,62095
1089,957,132,-,181300,62097
11,11,0,-,-,62098
2284,753,1531,397,66500,62201
2101,1563,538,958,63600,62203
2448,1649,799,714,47500,62204
2164,1357,807,951,44600,62205
4660,2257,2403,1037,51700,62206
2746,1077,1669,673,55200,62207
7157,4439,2718,1142,158300,62208
404,377,27,525,180200,62214
805,673,132,1143,202600,62215
1086,873,213,1015,208300,62216
310,282,28,975,115200,62217
761,707,54,705,193900,62218
426,325,101,1040,97800,62219
7719,5253,2466,925,136100,62220
11808,8255,3553,1054,195200,62221
7222,5465,1757,1049,140500,62223
1391,13,1378,1710,-,62225
11878,7813,4065,955,148900,62226
2679,2181,498,746,189800,62230
2665,2181,484,1025,157100,62231
2685,2077,608,1043,105900,62232
2411,1823,588,637,116000,62233
14059,9660,4399,956,156300,62234
5487,4682,805,1047,292000,62236
1063,992,71,642,130000,62237
183,156,27,912,86000,62238
1726,1133,593,905,91600,62239
641,450,191,1080,78900,62240
377,347,30,750,142300,62241
675,586,89,625,82000,62242
2349,1853,496,1116,251500,62243
357,289,68,943,248300,62244
726,662,64,635,188500,62245
3713,2393,1320,672,150600,62246
215,174,41,700,151000,62248
7112,5545,1567,802,204100,62249
231,210,21,788,103100,62250
291,233,58,578,79400,62253
2444,1741,703,1117,163800,62254
379,320,59,765,159800,62255
12,9,3,-,168800,62256
906,709,197,573,101500,62257
3670,2675,995,1139,202800,62258
2748,2435,313,1046,217200,62260
12,12,0,-,-,62261
707,609,98,847,120800,62262
2143,1744,399,831,152800,62263
1307,1076,231,905,140000,62264
1821,1193,628,1152,182400,62265
13,13,0,-,-,62266
404,339,65,643,128800,62268
13458,9932,3526,1249,260400,62269
827,666,161,717,167900,62271
703,493,210,652,110300,62272
109,85,24,988,103000,62273
2757,2168,589,447,113200,62274
1042,869,173,988,166100,62275
398,339,59,758,108500,62277
2608,2043,565,807,180100,62278
26,26,0,-,275000,62279
197,167,30,-,247600,62280
1069,982,87,1340,256300,62281
287,221,66,816,160800,62282
261,227,34,738,127100,62284
1722,1539,183,801,246800,62285
2361,1569,792,727,127500,62286
1198,944,254,756,152500,62288
199,153,46,864,68800,62289
338,204,134,806,65800,62292
1847,1478,369,829,197100,62293
5777,4586,1191,1015,242200,62294
542,436,106,1255,179800,62295
178,151,27,-,291100,62297
6862,5752,1110,856,246600,62298
13740,8343,5397,746,122400,62301
7932,6596,1336,876,197000,62305
353,255,98,-,85300,62311
647,483,164,556,91600,62312
158,136,22,-,88500,62313
195,134,61,719,133100,62314
315,252,63,303,68800,62316
106,101,5,-,94500,62319
885,716,169,677,165800,62320
1711,1381,330,675,119800,62321
89,81,8,-,-,62323
518,395,123,755,113000,62324
178,144,34,1238,121700,62325
967,729,238,682,97400,62326
686,569,117,863,81600,62330
83,71,12,575,59200,62334
38,35,3,-,74200,62336
447,433,14,-,165800,62338
429,342,87,625,124000,62339
727,468,259,500,101600,62340
1429,1084,345,801,114300,62341
297,262,35,675,89300,62343
11,3,8,-,-,62344
140,117,23,571,76900,62345
60,57,3,-,127500,62346
773,666,107,590,206100,62347
77,61,16,-,117500,62348
294,254,40,731,94600,62349
752,661,91,842,145600,62351
82,69,13,1275,68800,62352
1452,909,543,658,123300,62353
526,415,111,830,132200,62354
279,266,13,1025,88200,62355
168,135,33,731,77000,62356
113,90,23,675,95300,62357
185,183,2,-,163000,62358
31,31,0,-,126600,62359
669,588,81,783,116800,62360
106,96,10,-,117900,62361
165,130,35,525,71700,62362
2255,1819,436,700,113000,62363
165,156,9,675,106300,62365
439,342,97,675,82200,62366
653,565,88,742,96900,62367
135,126,9,-,74000,62370
144,144,0,-,-,62373
130,115,15,1016,87100,62374
284,272,12,950,113200,62375
486,404,82,817,166200,62376
327,279,48,467,128700,62378
789,666,123,710,93100,62379
116,107,9,-,54600,62380
7865,5744,2121,698,181800,62401
456,436,20,531,118800,62410
1732,1455,277,842,134700,62411
140,140,0,-,176600,62413
705,546,159,675,119000,62414
1124,816,308,843,81200,62417
812,655,157,825,137400,62418
99,86,13,781,78300,62419
1788,1465,323,792,107500,62420
173,156,17,745,71300,62421
367,281,86,675,152300,62422
311,292,19,-,145500,62423
888,735,153,641,207400,62424
294,294,0,-,110400,62425
427,364,63,539,71700,62426
731,678,53,532,88400,62427
1165,942,223,667,97100,62428
292,256,36,586,87500,62431
207,197,10,-,279200,62432
472,354,118,725,91300,62433
160,149,11,-,163400,62434
288,273,15,788,107200,62436
96,87,9,-,233100,62438
2788,1946,842,741,101500,62439
501,451,50,1296,124800,62440
2872,2247,625,835,122800,62441
1061,856,205,622,81200,62442
734,677,57,-,158500,62443
152,152,0,-,115100,62444
403,375,28,390,171700,62445
131,119,12,-,95500,62446
1225,1023,202,721,155000,62447
2320,1810,510,760,105000,62448
1288,983,305,515,103800,62449
5121,3559,1562,724,110200,62450
835,706,129,768,80000,62451
161,143,18,1021,56900,62452
4079,3122,957,810,119100,62454
831,741,90,720,94900,62458
89,84,5,200,95800,62459
431,354,77,803,87200,62460
323,309,14,-,147700,62461
445,351,94,604,127900,62462
504,445,59,832,123900,62463
55,43,12,-,100700,62464
343,301,42,917,152700,62465
1039,909,130,663,95600,62466
1549,1282,267,639,210800,62467
990,746,244,591,108200,62468
110,63,47,-,96000,62469
3516,2519,997,711,111900,62471
485,432,53,539,124400,62473
276,252,24,682,80000,62474
79,79,0,-,151900,62475
579,519,60,700,88200,62476
302,246,56,1281,153100,62477
133,115,18,-,88100,62478
301,211,90,854,161900,62479
221,182,39,775,101900,62480
118,103,15,-,92200,62481
927,866,61,973,176200,62501
715,455,260,626,92700,62510
248,186,62,617,125000,62512
663,554,109,1192,125500,62513
165,116,49,-,103300,62514
435,317,118,821,149500,62515
80,47,33,869,79200,62517
108,79,29,-,133900,62518
23,23,0,-,-,62519
607,524,83,900,196800,62520
14073,10333,3740,850,119000,62521
6070,3883,2187,748,98300,62522
255,27,228,297,-,62523
13923,7922,6001,748,92500,62526
623,502,121,868,132100,62530
694,571,123,775,123500,62531
32,32,0,-,114100,62532
336,257,79,726,117600,62533
486,412,74,807,131600,62534
1435,1336,99,-,276800,62535
299,277,22,-,261400,62536
105,95,10,-,91500,62537
167,147,20,738,103900,62538
476,396,80,698,97000,62539
605,453,152,733,80400,62540
22,22,0,-,-,62541
253,159,94,584,98800,62543
654,538,116,776,131700,62544
574,537,37,806,180800,62545
610,534,76,725,119400,62546
286,266,20,1023,92300,62547
912,780,132,763,117900,62548
2401,1959,442,754,172600,62549
1105,859,246,979,127000,62550
341,281,60,700,105500,62551
151,142,9,850,99100,62553
651,598,53,827,133800,62554
496,396,100,639,128700,62555
136,122,14,594,85000,62556
2973,2288,685,685,94800,62557
1464,1208,256,840,165800,62558
514,385,129,725,100600,62560
2306,1711,595,1070,146600,62561
2139,2038,101,1201,244800,62563
3260,2327,933,736,124000,62565
397,315,82,840,114100,62567
6158,4623,1535,711,116400,62568
228,202,26,531,67800,62570
576,436,140,650,140400,62571
189,154,35,575,183800,62572
481,364,117,725,134600,62573
110,98,12,-,181000,62601
61,48,13,763,54000,62610
472,447,25,1094,131800,62611
656,565,91,538,118200,62612
1497,1173,324,826,193500,62613
1917,1638,279,871,145300,62615
252,225,27,900,91300,62617
2592,1872,720,687,83900,62618
450,364,86,678,90000,62621
26,26,0,-,-,62622
122,111,11,-,74200,62624
358,323,35,942,262700,62625
3116,2221,895,819,129900,62626
454,373,81,892,76800,62627
320,282,38,879,100000,62628
5754,4635,1119,1134,221200,62629
265,256,9,-,114000,62630
137,120,17,-,113100,62631
268,223,45,675,80600,62633
408,341,67,759,131800,62634
273,196,77,909,116700,62635
504,415,89,886,115600,62638
97,68,29,-,-,62639
1188,924,264,850,159000,62640
590,492,98,622,99700,62642
281,165,116,931,92100,62643
2068,1636,432,750,93400,62644
166,129,37,808,130500,62649
9983,6658,3325,689,133800,62650
261,216,45,672,115200,62655
6999,4595,2404,756,118300,62656
504,424,80,893,138200,62661
79,77,2,-,84500,62663
1286,1023,263,696,96900,62664
579,445,134,617,64000,62665
196,154,42,747,93900,62666
234,191,43,635,155100,62667
496,445,51,697,118300,62668
1007,785,222,800,170400,62670
220,164,56,789,117000,62671
63,57,6,-,39800,62672
163,127,36,522,105600,62673
517,399,118,650,101000,62674
2503,1964,539,692,192100,62675
882,777,105,830,204400,62677
2174,1725,449,812,103300,62681
289,249,40,900,68100,62682
2018,1822,196,-,276700,62684
618,527,91,-,119200,62685
356,326,30,788,126500,62688
235,227,8,860,84700,62689
1502,1117,385,832,104000,62690
1011,752,259,642,99100,62691
883,721,162,746,108000,62692
691,611,80,986,191500,62693
1190,942,248,593,100600,62694
199,182,17,841,112500,62695
568,17,551,604,-,62701
14797,9335,5462,820,97800,62702
12335,6786,5549,948,95600,62703
18933,11256,7677,896,156200,62704
0,0,0,-,-,62706
3398,3129,269,930,153600,62707
7318,5895,1423,1176,287200,62711
4376,3714,662,1089,243200,62712
7735,5453,2282,744,91000,62801
411,242,169,840,142500,62803
1373,1032,341,759,107000,62806
360,317,43,463,120700,62807
702,568,134,599,139900,62808
111,107,4,-,101300,62809
410,339,71,633,98900,62810
113,89,24,825,44600,62811
4756,3493,1263,726,94200,62812
712,628,84,750,109800,62814
112,71,41,477,69400,62815
492,439,53,777,83600,62816
292,251,41,838,-,62817
170,154,16,771,81300,62818
128,117,11,850,52800,62819
53,50,3,-,39300,62820
3048,2234,814,703,114600,62821
1207,821,386,683,69100,62822
656,567,89,679,113800,62823
714,550,164,578,99300,62824
116,106,10,-,83100,62825
455,333,122,346,75600,62827
504,434,70,693,128800,62828
46,30,16,-,-,62829
627,468,159,382,130800,62830
187,174,13,-,132700,62831
3737,2618,1119,685,93700,62832
131,105,26,-,100900,62833
527,469,58,620,92100,62835
361,296,65,840,93300,62836
3794,2850,944,566,106200,62837
572,455,117,714,101700,62838
2779,2079,700,715,103500,62839
53,42,11,-,81300,62841
269,236,33,850,98000,62842
58,22,36,-,-,62843
845,585,260,709,78400,62844
314,233,81,679,87500,62846
228,189,39,870,79500,62848
765,690,75,675,88400,62849
131,115,16,-,-,62850
83,83,0,-,88200,62851
60,54,6,-,54000,62852
372,293,79,946,87000,62853
748,633,115,586,89500,62854
143,126,17,880,51700,62856
1258,922,336,611,99400,62858
2186,1613,573,668,87800,62859
214,191,23,557,96400,62860
44,44,0,-,42500,62861
131,123,8,-,76900,62862
4082,3034,1048,727,92400,62863
9671,6370,3301,862,111800,62864
857,715,142,752,151400,62865
177,120,57,436,53300,62867
706,569,137,596,111000,62868
970,803,167,530,109300,62869
869,646,223,838,118700,62870
232,211,21,575,88600,62871
388,344,44,-,80500,62872
164,138,26,675,48100,62874
468,427,41,735,93800,62875
74,67,7,917,60700,62876
183,168,15,850,98200,62877
141,133,8,-,92000,62878
16,13,3,-,-,62879
287,257,30,575,127600,62880
4492,3176,1316,730,105900,62881
869,681,188,582,78500,62882
255,223,32,-,154400,62883
1089,886,203,669,89400,62884
170,144,26,-,106300,62885
152,134,18,-,97800,62886
99,63,36,1121,42100,62887
780,702,78,823,112000,62888
454,361,93,-,151600,62889
982,723,259,1008,93300,62890
303,258,45,646,67700,62891
85,78,7,-,97500,62892
375,319,56,868,176600,62893
354,302,52,635,112000,62894
886,690,196,609,116700,62895
4631,3397,1234,696,89900,62896
226,181,45,871,111500,62897
749,653,96,843,156900,62898
583,491,92,608,141600,62899
10410,3140,7270,734,137800,62901
1913,1252,661,788,181400,62902
1141,495,646,797,157800,62903
244,197,47,493,138900,62905
2909,2060,849,748,136100,62906
647,569,78,671,132100,62907
150,140,10,-,162500,62908
788,664,124,783,80200,62910
576,472,104,762,93500,62912
644,447,197,-,34400,62914
222,93,129,547,82100,62915
307,267,40,710,126400,62916
1003,808,195,623,72200,62917
4551,3221,1330,909,175900,62918
272,217,55,478,86200,62919
1255,1119,136,-,162700,62920
103,71,32,-,73400,62921
1165,1061,104,638,158700,62922
148,131,17,795,70300,62923
1200,665,535,836,96400,62924
784,621,163,610,117400,62926
129,108,21,800,45000,62927
44,23,21,-,-,62928
2656,2026,630,714,75800,62930
603,476,127,235,91500,62931
519,326,193,688,76600,62932
544,394,150,806,130200,62933
343,295,48,325,87900,62934
837,712,125,874,92900,62935
1010,825,185,365,123800,62938
1089,1010,79,720,150200,62939
241,141,100,671,23800,62940
228,200,28,883,100000,62941
224,180,44,630,28300,62942
108,94,14,-,119400,62943
5066,3511,1555,693,93200,62946
182,167,15,-,163200,62947
5602,3587,2015,850,105200,62948
370,196,174,370,70500,62949
83,58,25,-,115000,62950
2349,1922,427,741,86700,62951
1185,944,241,720,109100,62952
99,54,45,775,-,62953
298,268,30,-,100000,62954
407,345,62,725,108800,62956
197,139,58,933,57700,62957
881,665,216,857,154200,62958
11518,8083,3435,834,164600,62959
4217,3225,992,740,119000,62960
16,16,0,-,38800,62961
0,0,0,-,-,62962
232,103,129,631,46100,62963
454,321,133,604,85200,62964
16,6,10,-,-,62965
6139,3840,2299,765,113500,62966
100,99,1,-,103300,62967
126,98,28,-,82000,62969
168,119,49,536,152400,62970
475,458,17,-,176500,62972
646,580,66,844,156400,62974
93,72,21,-,-,62975
161,98,63,592,87000,62976
277,219,58,964,109500,62977
462,355,107,584,82400,62979
388,293,95,488,64800,62982
717,523,194,730,79600,62983
651,412,239,492,78300,62984
249,239,10,-,104900,62985
647,557,90,820,135200,62987
411,351,60,483,67900,62988
321,289,32,690,120400,62990
259,211,48,515,89600,62992
265,235,30,1000,131900,62994
1524,1104,420,546,136900,62995
185,152,33,-,89100,62996
244,197,47,775,71900,62997
97,92,5,-,-,62998
624,424,200,704,54400,62999
7329,6509,820,1377,640400,63005
13879,10800,3079,1039,195500,63010
14354,12134,2220,1495,355400,63011
3839,3377,462,1227,217100,63012
432,423,9,-,289500,63013
285,255,30,743,147600,63014
797,656,141,774,185100,63015
2626,2402,224,882,192700,63016
17220,13503,3717,1446,428900,63017
1854,1378,476,877,165700,63019
8049,6605,1444,838,165900,63020
22096,17528,4568,1260,308700,63021
1871,1695,176,1101,217600,63023
6277,5318,959,1207,339600,63025
16952,13402,3550,1026,264400,63026
10946,8107,2839,939,201200,63028
84,54,30,-,175000,63030
19208,13797,5411,1249,135300,63031
16363,10662,5701,1079,146300,63033
6379,5804,575,1766,219200,63034
570,510,60,-,211400,63036
1233,1085,148,688,160200,63037
2522,2395,127,2060,496100,63038
204,175,29,-,127200,63039
3220,2794,426,1352,384000,63040
136,136,0,-,-,63041
8677,4442,4235,961,131900,63042
9302,6668,2634,1154,201500,63043
4245,2719,1526,946,227700,63044
0,0,0,-,-,63045
0,0,0,-,-,63047
1542,1297,245,2160,187500,63048
6679,5737,942,959,194700,63049
6244,5109,1135,930,245600,63050
4733,4055,678,1027,176300,63051
10576,8774,1802,899,237700,63052
33,26,7,-,204200,63053
691,612,79,877,334100,63055
672,612,60,-,187100,63056
839,757,82,1026,120200,63060
22,22,0,-,192200,63061
2164,1890,274,845,207100,63068
6030,4370,1660,837,258000,63069
3100,2341,759,825,202900,63070
507,350,157,840,127200,63071
1207,1138,69,1074,196100,63072
526,526,0,-,700500,63073
7131,3745,3386,895,113600,63074
4701,3337,1364,808,148700,63077
77,71,6,-,225000,63079
5763,4324,1439,852,153400,63080
7553,5628,1925,846,212100,63084
413,348,65,-,197300,63087
4208,2191,2017,1216,220700,63088
2198,1817,381,893,173700,63089
9129,7037,2092,812,231600,63090
584,507,77,515,224400,63091
1985,579,1406,1284,234700,63101
1404,58,1346,958,192000,63102
5149,756,4393,921,190200,63103
9797,4511,5286,1067,243000,63104
6725,3748,2977,1500,734100,63105
4014,664,3350,713,190200,63106
4061,1709,2352,843,55200,63107
11098,3069,8029,1146,356900,63108
13928,8903,5025,896,227100,63109
8728,3765,4963,1147,292600,63110
8772,3355,5417,818,104800,63111
8917,3075,5842,867,217800,63112
4987,2493,2494,858,72700,63113
14860,8414,6446,1054,99900,63114
7057,2956,4101,899,57100,63115
19417,10782,8635,919,147900,63116
4723,2421,2302,1252,300800,63117
11830,4919,6911,901,194800,63118
14966,10441,4525,1194,314500,63119
2498,1067,1431,869,51000,63120
11204,5710,5494,889,89800,63121
16691,13317,3374,1232,417900,63122
22083,15885,6198,959,191900,63123
4978,3750,1228,1638,862400,63124
13606,9777,3829,922,160700,63125
6039,5177,862,1053,269800,63126
2145,1649,496,1563,566900,63127
12974,10114,2860,1075,295000,63128
21325,16783,4542,1050,263400,63129
13174,8231,4943,1156,298700,63130
6778,6276,502,2072,711600,63131
6068,3286,2782,1238,416800,63132
2890,1160,1730,962,54900,63133
5120,2534,2586,1100,79500,63134
8100,4363,3737,1098,89000,63135
18061,7920,10141,972,74600,63136
8516,4304,4212,969,73300,63137
7217,3471,3746,1030,114900,63138
10924,6746,4178,1030,189600,63139
127,37,90,845,-,63140
8868,6132,2736,1401,546200,63141
4811,2193,2618,847,218800,63143
4561,2930,1631,1385,274800,63144
14912,8843,6069,1247,267200,63146
3519,1847,1672,926,75600,63147
0,0,0,-,-,63155
20858,14501,6357,1040,232200,63301
20664,15321,5343,1236,283100,63303
15922,14233,1689,1452,300700,63304
47,41,6,-,-,63330
648,623,25,-,374200,63332
316,274,42,808,109200,63333
2410,1715,695,727,126500,63334
433,336,97,761,125000,63336
389,330,59,656,185300,63339
1351,1248,103,1135,477900,63341
1707,1222,485,1031,124100,63343
581,519,62,841,162700,63344
203,177,26,425,57400,63345
829,784,45,936,177800,63347
3820,3306,514,1579,346100,63348
682,560,122,869,263600,63349
246,178,68,833,-,63350
590,434,156,908,221600,63351
491,370,121,571,92000,63352
1932,1329,603,704,92600,63353
2181,1966,215,1064,227100,63357
538,412,126,724,171200,63359
2091,1613,478,728,161400,63361
3130,2585,545,1098,204300,63362
518,399,119,796,130100,63363
29,24,5,-,371400,63365
20378,16492,3886,1194,262500,63366
10177,8530,1647,1443,362000,63367
16831,13892,2939,1385,298200,63368
1013,715,298,1024,272600,63369
259,226,33,1070,197200,63373
29450,24339,5111,1206,240300,63376
1182,1071,111,791,212300,63377
10089,7919,2170,963,223200,63379
309,211,98,1030,174200,63380
210,164,46,849,185600,63381
1198,858,340,718,84400,63382
5800,4291,1509,983,213800,63383
782,644,138,675,95700,63384
16660,14194,2466,1151,304300,63385
176,152,24,900,169400,63386
44,33,11,863,-,63387
391,335,56,-,67300,63388
2469,1773,696,872,184200,63389
4120,3366,754,937,222900,63390
8448,5586,2862,788,147400,63401
156,153,3,-,123400,63430
105,105,0,-,142500,63431
147,124,23,-,125800,63432
0,0,0,-,-,63433
258,150,108,444,97500,63434
1526,1105,421,569,121800,63435
551,461,90,613,144900,63436
586,417,169,613,79900,63437
101,87,14,-,127100,63438
101,74,27,-,-,63439
390,310,80,775,124200,63440
435,335,100,-,83500,63441
189,138,51,473,53300,63443
1257,894,363,499,105900,63445
146,129,17,733,-,63446
337,225,112,469,67900,63447
517,421,96,722,111400,63448
71,38,33,-,120800,63450
108,108,0,-,-,63451
390,354,36,648,82500,63452
128,121,7,-,195400,63453
366,340,26,731,108300,63454
1848,1174,674,705,140500,63456
106,102,4,-,150000,63457
47,34,13,519,-,63458
1678,1509,169,798,151900,63459
53,51,2,-,-,63460
2211,1700,511,706,163900,63461
602,498,104,531,120000,63462
307,254,53,561,130000,63463
193,142,51,-,-,63465
11,11,0,-,-,63466
20,20,0,-,166700,63467
979,736,243,838,84400,63468
373,288,85,609,96300,63469
214,208,6,-,229800,63471
204,181,23,642,-,63472
104,98,6,-,201400,63473
169,111,58,619,59000,63474
7369,4166,3203,760,145900,63501
388,321,67,600,118800,63530
107,97,10,500,85400,63531
524,455,69,619,100600,63532
277,222,55,771,174000,63533
318,281,37,617,93800,63534
13,6,7,-,-,63535
290,232,58,357,147800,63536
611,511,100,631,90800,63537
71,63,8,-,81700,63538
89,79,10,-,-,63539
66,64,2,-,69100,63540
156,140,16,650,113000,63541
78,56,22,-,-,63543
401,346,55,438,114600,63544
355,283,72,720,108200,63545
544,474,70,775,142200,63546
199,172,27,640,68800,63547
292,218,74,444,115000,63548
891,608,283,459,118700,63549
101,101,0,-,-,63551
3059,2219,840,740,121800,63552
1070,831,239,450,137900,63555
1086,755,331,736,95400,63556
119,119,0,-,256600,63557
236,204,32,592,111900,63558
607,518,89,516,130700,63559
25,9,16,-,-,63560
324,212,112,407,90800,63561
151,133,18,957,221900,63563
1426,1126,300,603,107700,63565
31,28,3,-,102300,63566
27,15,12,-,83200,63567
6642,4439,2203,709,103700,63601
373,301,72,549,119700,63620
661,569,92,-,146500,63621
460,306,154,573,95700,63622
303,255,48,813,135800,63623
1405,1098,307,711,91200,63624
151,143,8,-,197300,63625
389,370,19,-,104300,63626
1084,958,126,950,218500,63627
5095,3885,1210,730,159000,63628
487,413,74,297,126500,63629
1412,1077,335,805,101700,63630
341,286,55,793,145700,63631
256,207,49,615,130800,63633
203,170,33,819,65900,63636
335,279,56,720,193800,63637
880,623,257,674,90300,63638
10081,6576,3505,781,176800,63640
4209,3296,913,834,123700,63645
542,425,117,828,99000,63648
1615,1251,364,822,99600,63650
423,261,162,802,49600,63653
265,239,26,850,182000,63654
557,439,118,555,136200,63655
219,192,27,710,115700,63656
946,814,132,726,96500,63660
345,300,45,-,110200,63662
324,185,139,645,107500,63663
3441,2636,805,660,114400,63664
140,123,17,-,94700,63665
4632,3668,964,751,194500,63670
806,670,136,731,199500,63673
24,24,0,-,-,63674
8,8,0,-,-,63675
14992,9406,5586,834,192900,63701
3688,1426,2262,822,126000,63703
1549,1239,310,715,104500,63730
355,327,28,850,162500,63732
336,214,122,-,67100,63735
1481,1083,398,886,144200,63736
0,0,0,-,-,63738
190,105,85,-,129200,63739
2025,1573,452,855,133400,63740
39,31,8,-,80600,63742
19,19,0,-,-,63743
56,39,17,800,109800,63744
32,32,0,-,106300,63745
9,9,0,-,-,63746
242,242,0,-,146500,63747
515,493,22,864,126600,63748
12,12,0,-,-,63750
391,271,120,-,135800,63751
10293,8054,2239,968,221300,63755
198,122,76,764,184800,63758
216,200,16,-,217100,63760
39,39,0,-,-,63763
1619,1242,377,717,116200,63764
588,571,17,-,173200,63766
243,199,44,823,79000,63767
511,473,38,682,190100,63769
70,58,12,-,92900,63770
951,684,267,740,118800,63771
51,19,32,845,73000,63774
6158,4594,1564,880,188700,63775
2383,1735,648,715,139800,63780
526,447,79,1032,145600,63781
77,74,3,-,133300,63782
48,48,0,-,-,63783
62,52,10,-,60000,63784
444,425,19,650,166900,63785
228,209,19,-,95800,63787
9024,5849,3175,811,141500,63801
97,89,8,1250,50300,63820
308,206,102,564,48600,63821
1054,746,308,754,90000,63822
509,389,120,613,103100,63823
62,26,36,900,125000,63824
1491,1117,374,746,95800,63825
50,44,6,-,63600,63826
188,136,52,494,68100,63827
71,59,12,-,40500,63828
415,201,214,718,69500,63829
2590,1390,1200,756,127300,63830
79,73,6,-,-,63833
1607,886,721,681,96700,63834
596,377,219,566,53300,63837
135,60,75,769,53300,63839
26,26,0,-,45000,63840
5514,3683,1831,721,156800,63841
2344,1387,957,742,90100,63845
440,368,72,716,98000,63846
26,12,14,-,-,63847
429,299,130,671,54600,63848
96,46,50,-,109400,63849
0,0,0,-,-,63850
1425,702,723,646,65700,63851
524,351,173,574,88000,63852
60,47,13,-,53800,63853
343,288,55,613,68300,63855
4700,2912,1788,603,102400,63857
87,61,26,-,59600,63860
441,310,131,700,80900,63862
2340,1224,1116,697,95000,63863
157,64,93,683,48000,63866
372,248,124,708,80700,63867
371,212,159,605,59100,63868
1442,870,572,671,114400,63869
440,270,170,597,51500,63870
1777,1145,632,719,118000,63873
95,72,23,680,63300,63874
742,510,232,614,94400,63876
1263,731,532,673,138700,63877
27,27,0,-,51700,63878
343,282,61,650,55500,63879
6,0,6,-,-,63880
150,102,48,538,61100,63882
13228,8356,4872,729,133700,63901
385,225,160,905,123100,63932
1140,876,264,703,82100,63933
9,9,0,-,-,63934
2822,2235,587,734,105900,63935
195,116,79,847,180300,63936
981,731,250,631,229000,63937
472,422,50,-,103900,63939
593,462,131,900,140800,63940
77,62,15,-,-,63941
194,160,34,525,108600,63942
343,266,77,669,77900,63943
578,553,25,475,147300,63944
420,360,60,633,154900,63945
17,17,0,-,-,63950
104,82,22,-,85500,63951
114,95,19,494,111000,63952
349,277,72,593,79900,63953
354,266,88,521,71500,63954
61,41,20,-,96100,63955
294,152,142,619,160900,63956
2226,1509,717,616,101900,63957
1149,849,300,669,98900,63960
653,448,205,635,86700,63961
30,0,30,-,-,63962
159,98,61,-,-,63964
787,483,304,438,141600,63965
936,762,174,682,108800,63966
662,575,87,611,127700,63967
322,272,50,747,135600,64001
1347,1178,169,546,335700,64011
11602,7862,3740,1182,192000,64012
10588,7241,3347,1204,216100,64014
12363,8928,3435,1117,231400,64015
1738,1401,337,989,200200,64016
86,71,15,-,103400,64017
316,244,72,1130,252300,64018
974,918,56,748,187800,64019
1213,787,426,753,174800,64020
189,172,17,1028,101900,64021
54,45,9,850,137500,64022
5539,4021,1518,878,172100,64024
73,66,7,863,181300,64028
7550,5521,2029,1270,264400,64029
11113,5562,5551,942,154600,64030
3139,2870,269,1699,289500,64034
373,296,77,1065,105700,64035
163,82,81,836,-,64036
2527,1907,620,807,169900,64037
2312,1894,418,704,207800,64040
1377,1255,122,920,289100,64048
9494,4612,4882,867,128700,64050
9476,5279,4197,1064,114200,64052
2492,1285,1207,942,73300,64053
1254,783,471,1019,87900,64054
15790,10877,4913,1052,162200,64055
6158,3739,2419,1130,159100,64056
6198,3709,2489,1152,219300,64057
2389,1923,466,1050,175100,64058
6015,5076,939,1067,296100,64060
1176,1108,68,900,241700,64061
2214,1814,400,1084,216900,64062
8685,5572,3113,1121,224100,64063
7448,6039,1409,1369,347100,64064
8,0,8,550,-,64065
16,10,6,-,-,64066
2158,1433,725,832,162300,64067
13691,9980,3711,1019,249600,64068
1151,1052,99,1121,329000,64070
244,203,41,950,158500,64071
143,123,20,1042,67200,64072
248,181,67,1658,297500,64074
4274,3143,1131,941,209400,64075
3396,2723,673,892,212600,64076
659,541,118,970,150300,64077
3748,3239,509,970,249100,64078
5082,3689,1393,1305,284100,64079
5308,4316,992,1100,274100,64080
9958,7342,2616,1366,311600,64081
6415,5541,874,1737,365000,64082
9217,7360,1857,1407,278600,64083
536,516,20,-,246500,64084
3457,2333,1124,800,152000,64085
9155,7116,2039,1279,270800,64086
458,415,43,988,319400,64088
4972,4238,734,1115,277900,64089
53,41,12,725,153400,64090
14,0,14,-,-,64092
10694,5908,4786,843,212300,64093
423,284,139,790,106300,64096
389,314,75,990,183000,64097
1217,950,267,883,274100,64098
65,0,65,1141,-,64101
0,0,0,-,-,64102
4052,627,3425,1526,224400,64105
5340,826,4514,1128,215400,64106
5069,1753,3316,1353,257700,64108
4696,1880,2816,899,198100,64109
7620,3640,3980,1116,226400,64110
10661,3305,7356,1134,255900,64111
4921,2061,2860,1305,442600,64112
4753,4505,248,1611,470700,64113
12779,8076,4703,1252,242800,64114
8531,3629,4902,1105,218500,64116
6492,3547,2945,947,159300,64117
18492,10662,7830,1070,183300,64118
12926,9495,3431,1227,194300,64119
297,87,210,1553,91900,64120
3890,2270,1620,987,101700,64123
3800,1883,1917,915,101500,64124
638,409,229,875,58000,64125
2056,1329,727,934,52100,64126
7279,3126,4153,859,71000,64127
5241,2340,2901,888,53500,64128
3457,1950,1507,924,98400,64129
8574,4596,3978,953,60300,64130
9697,4495,5202,1080,206200,64131
4828,2064,2764,981,91000,64132
15369,9290,6079,1094,159300,64133
8878,4501,4377,1192,127200,64134
707,394,313,1328,147800,64136
4431,2134,2297,1083,173100,64137
10290,6131,4159,1083,152600,64138
730,504,226,1623,368500,64139
2038,1694,344,1491,331000,64145
730,596,134,1671,185100,64146
165,0,165,850,-,64147
135,92,43,-,366700,64149
1670,712,958,873,265100,64150
11837,6989,4848,1245,274000,64151
11761,9752,2009,1242,300300,64152
2770,1395,1375,1154,289000,64153
5696,2910,2786,1348,324300,64154
10681,7541,3140,1287,263400,64155
2641,1931,710,1426,357800,64156
7265,6566,699,1855,321700,64157
2640,1493,1147,1347,294900,64158
138,95,43,1269,132500,64161
430,226,204,773,206600,64163
25,25,0,-,-,64164
67,67,0,-,-,64165
130,130,0,-,297100,64166
130,130,0,-,546300,64167
481,471,10,775,216600,64401
961,700,261,572,99800,64402
19,10,9,-,187500,64420
335,287,48,1304,104200,64421
107,88,19,-,87700,64422
388,316,72,481,165400,64423
1457,925,532,619,119000,64424
146,93,53,815,-,64426
245,189,56,725,119200,64427
281,220,61,-,79200,64428
4041,2628,1413,939,172000,64429
281,244,37,938,197200,64430
183,150,33,475,144400,64431
16,16,0,-,112500,64432
21,17,4,-,-,64433
232,211,21,445,164400,64434
320,273,47,1691,239000,64436
196,177,19,840,106300,64437
60,54,6,-,-,64438
621,520,101,713,192900,64439
313,254,59,767,178300,64440
55,54,1,-,108700,64441
308,277,31,546,99800,64442
574,426,148,819,265100,64443
572,425,147,584,209700,64444
135,94,41,725,94000,64445
494,344,150,552,91100,64446
399,351,48,838,165600,64448
170,156,14,708,103200,64449
197,150,47,-,96700,64451
65,63,2,-,227100,64453
952,830,122,850,212500,64454
156,119,37,395,112500,64455
528,413,115,361,84000,64456
114,110,4,-,-,64457
63,63,0,-,66600,64458
186,170,16,889,169400,64459
354,310,44,529,82100,64461
549,393,156,684,137100,64463
1550,1217,333,785,174900,64465
191,153,38,525,103600,64466
67,63,4,-,230200,64467
5456,2942,2514,753,192200,64468
799,547,252,730,118300,64469
649,505,144,680,133900,64470
197,118,79,811,52300,64471
509,387,122,645,114600,64473
316,217,99,779,139600,64474
155,107,48,625,114800,64475
131,113,18,646,114100,64476
1461,1094,367,726,215200,64477
351,284,67,700,113300,64479
145,143,2,-,206800,64480
363,280,83,532,98300,64481
876,639,237,673,114600,64482
211,188,23,767,142500,64483
349,269,80,767,109800,64484
3227,2350,877,771,164000,64485
101,75,26,289,47000,64486
308,243,65,706,81700,64487
717,562,155,710,141900,64489
657,550,107,800,186400,64490
749,524,225,615,85400,64491
715,587,128,908,183000,64492
187,151,36,1050,-,64493
400,325,75,813,122700,64494
94,58,36,-,-,64496
186,173,13,578,331100,64497
117,107,10,-,63000,64498
59,59,0,-,93500,64499
4386,1955,2431,817,97300,64501
4948,3304,1644,947,127500,64503
4034,2838,1196,881,100100,64504
5189,3685,1504,923,172600,64505
8874,5223,3651,849,202900,64506
5332,3532,1800,878,126200,64507
4562,3046,1516,761,143300,64601
175,167,8,675,-,64620
223,167,56,564,73800,64622
136,127,9,925,57400,64623
603,511,92,680,95700,64624
315,216,99,615,79200,64625
2290,1727,563,677,102500,64628
211,171,40,600,155700,64630
321,256,65,603,100000,64631
171,149,22,508,91700,64632
1809,1165,644,758,111900,64633
174,144,30,768,120800,64635
101,90,11,875,81700,64636
223,170,53,548,137500,64637
191,154,37,493,150000,64638
63,56,7,-,78300,64639
1251,902,349,769,154900,64640
251,164,87,-,103900,64641
307,242,65,675,70000,64642
455,360,95,447,113800,64643
1183,918,265,679,175000,64644
73,66,7,242,-,64645
85,72,13,413,107100,64646
173,114,59,554,58300,64647
679,550,129,586,107300,64648
242,197,45,1375,111300,64649
292,235,57,606,192800,64650
194,142,52,763,68800,64651
156,135,21,479,157800,64652
242,225,17,328,97100,64653
13,9,4,-,-,64654
71,71,0,-,-,64655
100,71,29,589,94500,64656
121,97,24,-,-,64657
1180,893,287,595,120300,64658
367,282,85,588,131000,64659
166,155,11,563,124300,64660
328,239,89,483,102700,64661
105,94,11,495,130800,64664
106,89,17,1057,44400,64667
591,433,158,819,99900,64668
324,251,73,586,157900,64670
809,709,100,658,148700,64671
56,50,6,-,-,64672
814,661,153,473,100100,64673
126,112,14,296,91400,64674
63,54,9,-,77100,64676
316,217,99,-,91100,64679
66,59,7,-,82100,64681
152,133,19,-,105900,64682
3046,2041,1005,713,116500,64683
96,93,3,-,89200,64686
194,150,44,825,179700,64688
186,169,17,-,113500,64689
5536,3775,1761,903,216400,64701
1536,1224,312,767,153400,64720
97,69,28,613,-,64722
258,198,60,650,171300,64723
824,563,261,493,90700,64724
763,529,234,1014,191800,64725
132,114,18,-,200000,64726
152,128,24,605,128100,64728
2518,1621,897,718,170200,64730
410,307,103,685,182300,64733
758,607,151,1100,278900,64734
5843,4010,1833,730,167100,64735
507,430,77,824,155000,64738
363,321,42,753,230700,64739
727,643,84,679,112300,64740
86,79,7,-,98100,64741
909,716,193,829,212100,64742
93,58,35,886,150000,64743
2916,1922,994,801,153900,64744
29,20,9,-,55000,64745
620,500,120,951,196200,64746
1636,1328,308,881,200200,64747
540,373,167,633,91000,64748
113,99,14,-,132500,64750
242,203,39,830,119600,64752
895,738,157,654,150900,64755
245,203,42,525,85300,64756
2882,1882,1000,692,128500,64759
601,493,108,878,121800,64761
642,497,145,569,93700,64762
619,433,186,-,119900,64763
3,2,1,-,-,64765
260,246,14,-,136900,64767
288,255,33,625,39800,64769
514,386,128,729,130300,64770
182,154,28,588,161900,64771
5408,3664,1744,727,135000,64772
1566,1217,349,586,139500,64776
170,145,25,822,97500,64778
890,731,159,731,87600,64779
148,119,29,775,-,64780
55,43,12,-,67000,64781
264,228,36,529,96000,64783
531,364,167,494,106300,64784
570,475,95,784,160100,64788
355,265,90,756,107200,64790
15257,8682,6575,873,160000,64801
14609,10419,4190,865,159300,64804
310,205,105,888,88300,64830
2309,1536,773,738,136300,64831
471,367,104,958,162500,64832
16,15,1,-,66300,64833
3570,2827,743,1142,179700,64834
691,487,204,922,93100,64835
9364,5768,3596,843,150600,64836
1248,959,289,596,155300,64840
411,255,156,830,99500,64841
286,219,67,817,99400,64842
1230,937,293,775,102800,64843
1681,1190,491,792,102800,64844
153,69,84,625,65000,64847
190,188,2,-,-,64848
74,71,3,-,90600,64849
8763,5781,2982,779,155900,64850
1592,726,866,737,80500,64854
990,852,138,748,168000,64855
1425,1015,410,730,159800,64856
153,128,25,920,77500,64857
153,153,0,-,-,64858
507,370,137,517,100800,64859
424,290,134,647,183000,64861
1273,943,330,817,108300,64862
508,309,199,587,98800,64863
1940,1515,425,811,154500,64865
390,351,39,775,117400,64866
351,304,47,858,126000,64867
33,33,0,-,-,64868
5967,3750,2217,893,159300,64870
323,315,8,-,89300,64873
235,127,108,458,82800,64874
108,100,8,-,175000,65001
2938,2124,814,1122,269600,65010
634,495,139,-,206000,65011
1161,787,374,604,193100,65013
991,810,181,707,136100,65014
496,454,42,525,215500,65016
458,382,76,717,115500,65017
3277,2487,790,779,159500,65018
5254,4129,1125,806,231000,65020
682,602,80,929,200700,65023
419,356,63,750,114300,65024
302,181,121,695,149200,65025
4766,3492,1274,748,155000,65026
548,494,54,742,167600,65032
288,253,35,-,96100,65034
624,550,74,-,209900,65035
2367,2037,330,759,227200,65037
1102,1052,50,396,378300,65039
458,418,40,-,174700,65040
2296,1776,520,663,188700,65041
3735,2926,809,838,185700,65043
540,507,33,440,177300,65046
622,389,233,402,211800,65047
116,110,6,-,-,65048
3006,2338,668,924,322100,65049
186,170,16,-,205300,65050
1882,1389,493,606,164700,65051
1289,1192,97,703,280800,65052
573,506,67,718,292900,65053
389,363,26,-,213800,65054
488,441,47,561,164200,65058
469,339,130,926,234800,65059
180,171,9,-,88800,65061
8,8,0,-,-,65062
1405,1150,255,714,224100,65063
246,242,4,-,151800,65064
2595,1714,881,787,284600,65065
2375,1851,524,684,151700,65066
240,199,41,885,114100,65067
336,288,48,636,169000,65068
200,187,13,-,201700,65069
783,656,127,1323,216500,65072
1193,1011,182,694,179200,65074
366,327,39,675,244500,65075
252,207,45,-,171500,65076
190,190,0,-,211900,65077
1412,1090,322,734,92100,65078
2114,1908,206,1160,316400,65079
497,407,90,1067,291900,65080
990,728,262,714,142100,65081
382,340,42,1070,160300,65082
78,67,11,-,-,65083
2455,1770,685,536,145400,65084
479,403,76,509,239400,65085
10626,7032,3594,728,216000,65101
16728,10828,5900,827,190600,65109
18942,5928,13014,993,220300,65201
18941,12148,6793,1044,190600,65202
25357,15923,9434,975,296900,65203
0,0,0,-,-,65215
0,0,0,-,-,65216
190,162,28,473,74400,65230
1122,892,230,561,149800,65231
134,119,15,810,96300,65232
3736,2791,945,739,176700,65233
481,323,158,456,99800,65236
432,334,98,702,121200,65237
710,689,21,939,166600,65239
3474,2645,829,644,167700,65240
811,724,87,633,172800,65243
178,155,23,-,144000,65244
22,22,0,-,56700,65246
257,238,19,-,87900,65247
1340,973,367,845,134900,65248
177,169,8,-,152300,65250
6969,5058,1911,782,175900,65251
721,621,100,663,133400,65254
1837,1458,379,1086,196300,65255
743,704,39,936,246300,65256
573,492,81,693,112100,65257
221,187,34,717,155600,65258
950,750,200,695,128800,65259
185,161,24,720,96400,65260
434,323,111,385,115500,65261
426,349,77,1005,196900,65262
556,460,96,692,147700,65263
379,343,36,385,118800,65264
5819,4012,1807,718,121500,65265
6250,3742,2508,739,129500,65270
628,522,106,696,146700,65274
962,840,122,513,125800,65275
691,538,153,708,157000,65276
38,25,13,738,68300,65278
654,582,72,1122,273500,65279
93,70,23,622,-,65280
967,817,150,644,135900,65281
102,102,0,-,-,65282
222,219,3,-,214200,65283
808,592,216,842,185200,65284
206,197,9,-,158200,65285
34,29,5,-,95000,65286
134,108,26,-,184100,65287
13544,9079,4465,837,148100,65301
1008,5,1003,1208,-,65305
26,25,1,-,225000,65320
157,130,27,781,104300,65321
239,217,22,883,136500,65322
364,316,48,530,119700,65323
585,549,36,840,225500,65324
1138,836,302,801,171600,65325
783,686,97,1024,154200,65326
87,76,11,788,142900,65327
125,104,21,-,381300,65329
176,133,43,728,103100,65330
699,622,77,641,161500,65332
403,369,34,622,119800,65333
442,307,135,1114,165700,65334
91,83,8,-,-,65335
2740,1716,1024,909,182500,65336
655,446,209,713,138200,65337
1062,830,232,838,137500,65338
162,126,36,921,81700,65339
5177,3697,1480,746,142200,65340
69,54,15,1094,160000,65344
237,222,15,-,162100,65345
354,334,20,833,130300,65347
526,434,92,642,172700,65348
962,598,364,516,98500,65349
667,556,111,921,202200,65350
725,572,153,735,120700,65351
213,121,92,896,193500,65354
4825,4042,783,836,156800,65355
1679,1306,373,756,131000,65360
12998,7167,5831,763,187300,65401
13,13,0,-,-,65409
0,0,0,-,-,65436
993,841,152,477,109100,65438
24,17,7,-,-,65439
140,136,4,-,113600,65440
2113,1589,524,831,169400,65441
44,44,0,-,211100,65443
370,271,99,587,123700,65444
164,67,97,-,-,65446
71,71,0,-,55600,65449
1007,783,224,666,116800,65452
3435,2529,906,747,164400,65453
126,105,21,-,201100,65456
113,99,14,-,219900,65457
2640,2213,427,747,164500,65459
70,70,0,-,162500,65461
522,500,22,741,100000,65462
576,318,258,-,128800,65463
214,200,14,-,129400,65464
487,302,185,726,185400,65466
22,22,0,-,-,65468
331,283,48,-,197300,65470
2028,25,2003,1147,-,65473
93,93,0,-,227900,65479
1797,1296,501,710,118800,65483
24,24,0,-,-,65484
1227,1094,133,497,111600,65486
90,90,0,-,-,65501
107,107,0,-,93400,65529
158,148,10,-,-,65534
492,416,76,757,96500,65535
11818,8291,3527,801,152500,65536
79,79,0,-,190600,65541
2121,1594,527,653,121900,65542
209,186,23,-,204300,65543
2337,1677,660,514,123800,65548
1253,909,344,660,124700,65550
771,671,100,925,167300,65552
451,358,93,468,106100,65555
2063,1609,454,554,110400,65556
79,67,12,-,218500,65557
3401,2360,1041,786,175200,65559
5408,3900,1508,655,123200,65560
43,18,25,-,-,65564
2074,1471,603,763,152100,65565
287,233,54,332,95700,65566
602,507,95,620,142800,65567
295,277,18,890,77300,65570
727,532,195,345,98300,65571
317,217,100,650,231900,65580
898,641,257,588,137200,65582
5016,3033,1983,982,189400,65583
3948,2130,1818,1040,191000,65584
7,7,0,-,-,65586
904,761,143,547,141600,65588
29,16,13,-,118200,65589
772,587,185,850,183600,65590
495,377,118,969,150600,65591
309,243,66,714,161700,65601
81,81,0,-,-,65603
1630,1345,285,721,164900,65604
4735,3407,1328,762,131300,65605
994,707,287,841,129600,65606
3256,2520,736,702,130400,65608
270,209,61,836,90500,65609
2058,1846,212,768,232800,65610
994,872,122,857,196800,65611
762,554,208,483,278900,65612
6508,4353,2155,781,172400,65613
218,171,47,864,194200,65614
10932,6317,4615,901,198000,65616
625,573,52,1117,198800,65617
56,56,0,-,118900,65618
3784,2876,908,899,191700,65619
125,63,62,-,334100,65620
3179,2100,1079,602,133400,65622
8,4,4,-,-,65623
647,619,28,-,220600,65624
2874,1983,891,670,154400,65625
897,744,153,664,143800,65626
330,210,120,930,138600,65627
255,200,55,-,247500,65629
168,149,19,-,511600,65630
2212,1781,431,1038,190600,65631
1005,745,260,823,167000,65632
1342,1041,301,888,154200,65633
146,140,6,-,159600,65634
238,208,30,525,192200,65635
342,233,109,588,188500,65637
281,224,57,-,200000,65638
333,333,0,-,170800,65640
527,443,84,-,165700,65641
724,648,76,645,175000,65644
649,579,70,545,145700,65646
1136,946,190,613,145000,65647
2276,1878,398,822,185800,65648
868,708,160,915,208800,65649
531,427,104,548,103400,65650
1353,1190,163,653,191600,65652
2519,1994,525,669,165200,65653
106,71,35,-,100600,65654
1116,839,277,642,118700,65655
1725,1482,243,699,224800,65656
90,57,33,-,164400,65657
709,550,159,536,201100,65658
102,96,6,-,116000,65660
934,666,268,548,126700,65661
358,273,85,-,167400,65662
1010,770,240,-,211800,65663
19,3,16,942,-,65664
40,40,0,-,-,65666
1054,809,245,465,187100,65667
728,565,163,1005,86600,65668
911,791,120,956,205600,65669
3335,2328,1007,794,164800,65672
1017,718,299,593,87700,65674
14,11,3,-,84200,65675
177,130,47,-,85000,65676
1351,860,491,798,180000,65679
458,442,16,678,129600,65680
916,843,73,-,165900,65681
794,547,247,844,133300,65682
391,352,39,581,72900,65685
2228,1837,391,948,239300,65686
27,20,7,-,-,65688
2141,1594,547,638,124800,65689
78,63,15,-,213200,65690
383,254,129,956,107400,65692
110,95,15,-,258000,65702
1774,1321,453,433,170100,65704
1549,992,557,843,144400,65705
6120,4794,1326,718,202200,65706
851,627,224,832,145600,65707
4939,2970,1969,823,161800,65708
471,350,121,769,184700,65710
3235,2565,670,801,107400,65711
3380,2414,966,638,183400,65712
932,653,279,643,153000,65713
12702,9149,3553,950,240000,65714
20,20,0,-,-,65715
881,690,191,550,147400,65717
247,220,27,725,200000,65720
12492,9388,3104,951,232600,65721
467,387,80,750,136300,65722
1116,809,307,837,140300,65723
678,612,66,739,105700,65724
1038,849,189,913,155800,65725
0,0,0,-,-,65726
47,47,0,-,321900,65727
15,15,0,-,-,65728
103,72,31,-,266000,65729
10,10,0,-,-,65730
94,88,6,-,-,65731
469,403,66,775,250800,65732
237,211,26,-,77400,65733
1201,847,354,739,113800,65734
24,14,10,-,-,65735
3241,2611,630,857,218600,65737
8312,5492,2820,1045,170700,65738
396,361,35,915,259300,65739
1200,871,329,956,107500,65740
0,0,0,-,-,65741
5112,3945,1167,786,240600,65742
45,38,7,-,195000,65744
991,626,365,804,105900,65745
2801,2256,545,691,164600,65746
1719,1627,92,785,253700,65747
179,123,56,842,127700,65752
1906,1518,388,760,189000,65753
227,206,21,-,252000,65754
251,235,16,-,115600,65755
312,292,20,-,218700,65756
2923,2514,409,949,227400,65757
380,338,42,775,154900,65759
225,225,0,-,138800,65760
610,563,47,733,198300,65761
168,128,40,806,206100,65762
437,353,84,-,107200,65764
18,14,4,-,-,65766
767,622,145,531,144400,65767
71,58,13,-,223500,65768
1041,884,157,660,142500,65769
1057,895,162,735,157700,65770
535,535,0,-,256300,65771
1031,879,152,631,155000,65772
151,137,14,-,350000,65773
420,317,103,546,95900,65774
9879,6576,3303,746,152600,65775
59,59,0,-,-,65777
206,109,97,710,134000,65778
674,523,151,570,105800,65779
3292,2376,916,1098,192300,65781
51,41,10,-,-,65783
0,0,0,-,-,65784
2157,1636,521,821,156100,65785
610,527,83,636,172900,65786
443,422,21,940,241700,65787
131,126,5,-,84300,65788
526,410,116,626,125000,65789
343,295,48,-,85000,65790
1488,1014,474,773,112100,65791
2091,1435,656,594,123000,65793
0,0,0,-,-,65801
19121,10657,8464,857,144900,65802
18181,10011,8170,861,144600,65803
19374,10033,9341,857,202800,65804
7815,985,6830,788,82600,65806
27029,12448,14581,944,159700,65807
4804,4045,759,945,328400,65809
9628,7299,2329,1044,254700,65810
0,0,0,-,-,65897
4668,3032,1636,779,122500,66002
2798,2088,710,1001,286000,66006
3579,2895,684,1040,313900,66007
90,86,4,-,191100,66008
222,191,31,530,155400,66010
3515,2775,740,1087,229800,66012
748,748,0,-,678900,66013
231,191,40,-,383000,66014
311,236,75,493,112500,66015
194,183,11,-,185100,66016
149,121,28,-,110700,66017
2306,1566,740,1003,360700,66018
555,505,50,907,281600,66020
921,783,138,1133,212400,66021
398,342,56,625,105300,66023
233,178,55,923,68700,66024
2703,2036,667,1347,249800,66025
216,209,7,-,250800,66026
1546,10,1536,1818,-,66027
8692,6217,2475,1241,259200,66030
0,0,0,-,-,66031
1891,1412,479,786,158800,66032
340,287,53,785,157100,66033
264,220,44,563,153600,66035
304,266,38,810,157900,66039
1452,1182,270,943,143700,66040
394,370,24,-,143800,66041
294,244,50,511,187500,66042
3403,2716,687,1124,234800,66043
11687,4336,7351,965,217900,66044
0,0,0,-,-,66045
8429,4045,4384,897,201000,66046
9175,4010,5165,1114,276200,66047
13905,8553,5352,931,188100,66048
14253,7928,6325,1126,335400,66049
733,673,60,1029,231200,66050
715,508,207,1263,269100,66052
3127,2412,715,1389,277700,66053
1039,923,116,927,214500,66054
708,558,150,722,123200,66056
102,85,17,675,90700,66058
485,416,69,895,137200,66060
23467,17516,5951,1150,314200,66061
28059,20751,7308,1283,321700,66062
2262,1751,511,995,145500,66064
1158,1034,124,836,214000,66066
6339,4301,2038,870,168500,66067
856,838,18,988,191800,66070
5245,4122,1123,964,248500,66071
467,445,22,1096,250600,66072
976,806,170,769,173000,66073
972,720,252,589,118000,66075
846,694,152,907,176600,66076
307,260,47,796,213500,66078
299,260,39,788,161500,66079
384,322,62,850,154300,66080
3978,3321,657,1033,289100,66083
3872,3294,578,1559,482000,66085
4111,3302,809,1159,252400,66086
809,642,167,762,111300,66087
1089,780,309,735,184300,66088
1026,815,211,687,127700,66090
172,129,43,826,-,66091
1620,1330,290,1097,235900,66092
275,266,9,-,113600,66093
150,99,51,670,154700,66094
362,325,37,1023,224200,66095
435,382,53,847,216200,66097
5004,2040,2964,732,78500,66101
9826,5212,4614,998,90500,66102
6232,2585,3647,1093,117700,66103
9569,6170,3399,1006,109600,66104
885,383,502,878,55300,66105
8332,5847,2485,921,140500,66106
9838,7597,2241,1629,233500,66109
3801,2881,920,1018,130500,66111
5047,2368,2679,1100,171300,66112
0,0,0,-,-,66115
0,0,0,-,-,66118
0,0,0,-,-,66160
8649,4401,4248,1152,241900,66202
7800,5089,2711,1147,219500,66203
8726,4030,4696,1241,223900,66204
6069,4769,1300,1522,310500,66205
4727,4081,646,2250,573000,66206
6258,4848,1410,1762,373900,66207
9311,7381,1930,1601,385000,66208
8179,6033,2146,1380,507100,66209
9136,4957,4179,1339,330700,66210
2617,1869,748,1435,580600,66211
14519,8730,5789,1206,259600,66212
12910,7542,5368,1458,421000,66213
5327,2433,2894,1062,290600,66214
11481,6783,4698,1370,279200,66215
9563,8050,1513,1222,301000,66216
2538,1336,1202,1207,392500,66217
2501,2135,366,1709,371500,66218
6669,2364,4305,1401,360000,66219
2855,2670,185,1225,523200,66220
8266,7027,1239,1624,639800,66221
10169,5762,4407,1600,383800,66223
4851,4352,499,1735,600900,66224
4963,4314,649,1201,364800,66226
3132,2684,448,1909,401200,66227
5,0,5,-,-,66251
768,600,168,-,184300,66401
1147,923,224,814,233400,66402
256,224,32,880,232500,66403
160,147,13,-,265200,66404
218,146,72,-,165600,66406
148,117,31,1238,169200,66407
140,126,14,-,168500,66408
1565,1511,54,873,275500,66409
540,430,110,956,59600,66411
133,106,27,-,250000,66412
766,556,210,685,115900,66413
1007,813,194,621,133300,66414
286,240,46,870,66900,66415
170,146,24,535,98300,66416
163,145,18,-,57600,66417
171,160,11,696,95300,66418
182,152,30,782,114100,66419
323,301,22,-,-,66422
318,250,68,657,-,66423
177,143,34,650,108900,66424
248,187,61,738,108000,66425
528,478,50,667,107500,66427
95,72,23,-,122500,66428
188,168,20,-,134500,66429
231,196,35,1310,155000,66431
238,173,65,768,229200,66432
1749,1287,462,679,117400,66434
2324,1615,709,808,192800,66436
34,22,12,-,308300,66438
973,595,378,613,82000,66439
782,700,82,967,189000,66440
10353,5234,5119,992,156900,66441
3884,31,3853,1355,220200,66442
376,316,60,933,181000,66449
636,557,79,750,150800,66451
111,95,16,1250,87800,66501
18620,7780,10840,930,215800,66502
6696,4122,2574,1179,301400,66503
2,0,2,-,-,66506
313,273,40,1087,187800,66507
1691,1313,378,678,117300,66508
911,693,218,969,157900,66509
281,218,63,857,159800,66510
1184,979,205,969,174900,66512
615,540,75,1093,230500,66514
111,110,1,-,106700,66515
119,95,24,694,100700,66516
685,370,315,1177,145100,66517
137,136,1,-,112500,66518
227,198,29,638,170800,66520
528,349,179,813,160400,66521
85,14,71,955,42500,66522
1609,1045,564,836,147100,66523
933,860,73,703,156700,66524
326,259,67,935,209500,66526
74,52,22,911,77500,66527
261,233,28,767,168100,66528
547,505,42,1071,174900,66531
247,220,27,733,201000,66532
619,434,185,946,208400,66533
1497,1060,437,711,164000,66534
1363,1046,317,1175,212200,66535
1173,856,317,860,201600,66536
472,404,68,1020,85700,66537
1319,1054,265,750,234000,66538
1084,894,190,944,195200,66539
258,240,18,913,165900,66540
116,116,0,-,57100,66541
1145,1044,101,954,190100,66542
432,376,56,1053,160700,66543
135,126,9,706,68500,66544
478,420,58,967,220300,66546
3017,2472,545,1019,207500,66547
372,322,50,654,96400,66548
582,468,114,948,187700,66549
215,189,26,919,108100,66550
238,170,68,497,137500,66552
225,209,16,1115,235900,66554
652,173,479,604,91500,66603
9989,5759,4230,985,118500,66604
8327,5823,2504,873,150200,66605
4743,2553,2190,925,105000,66606
3248,1596,1652,766,42700,66607
2084,1247,837,888,65500,66608
2902,2095,807,918,110500,66609
4251,4037,214,1211,284300,66610
4555,2056,2499,932,129000,66611
1141,215,926,664,47900,66612
14712,10000,4712,963,167100,66614
1453,998,455,1159,268700,66615
2450,1639,811,936,79900,66616
3256,2757,499,1108,194700,66617
3766,3388,378,937,210900,66618
979,347,632,1358,79700,66619
0,0,0,-,-,66621
0,0,0,-,-,66622
4830,3285,1545,784,95200,66701
288,244,44,738,82500,66710
232,181,51,725,41000,66711
783,467,316,767,92500,66712
2037,1466,571,768,94900,66713
46,41,5,-,75000,66714
258,214,44,731,46900,66716
223,207,16,575,59500,66717
4320,3176,1144,634,96300,66720
407,348,59,764,88900,66724
2080,1423,657,697,92300,66725
95,92,3,-,72500,66732
898,696,202,497,87600,66733
150,134,16,-,172500,66734
230,179,51,952,-,66735
1511,1011,500,717,94100,66736
113,109,4,450,177700,66738
2146,1451,695,710,76700,66739
65,59,6,750,203100,66740
82,75,7,-,209200,66741
15,12,3,-,-,66742
1551,978,573,826,94700,66743
59,50,9,-,-,66746
1122,927,195,545,100600,66748
2829,1836,993,740,97200,66749
323,263,60,708,58500,66751
575,507,68,575,88400,66753
126,97,29,1085,120300,66754
389,297,92,558,109200,66755
470,382,88,339,86700,66756
1263,946,317,702,100000,66757
85,70,15,1031,56700,66758
11,11,0,-,-,66760
91,91,0,-,120200,66761
10180,5336,4844,835,122500,66762
1358,883,475,832,147400,66763
133,101,32,575,-,66767
183,156,27,1328,116200,66769
306,267,39,-,113900,66770
334,253,81,627,113100,66771
103,79,24,721,106300,66772
236,189,47,625,70200,66773
68,62,6,-,163900,66775
561,437,124,1025,118200,66776
256,229,27,575,77400,66777
0,0,0,-,-,66778
259,230,29,729,97200,66779
212,209,3,-,157400,66780
338,234,104,946,75000,66781
63,52,11,1042,40000,66782
834,652,182,584,84500,66783
11424,6201,5223,763,139400,66801
96,84,12,838,85000,66830
296,232,64,488,-,66833
399,301,98,880,145800,66834
432,329,103,931,110000,66835
67,65,2,-,116400,66838
1530,1004,526,832,155300,66839
194,161,33,708,86900,66840
188,149,39,1086,120600,66842
57,44,13,-,105700,66843
456,351,105,533,96400,66845
1327,1037,290,672,135300,66846
181,150,31,788,96000,66849
96,59,37,1118,115100,66850
307,225,82,764,51900,66851
279,185,94,669,87600,66852
154,132,22,775,29100,66853
321,244,77,693,71000,66854
681,629,52,700,157900,66856
469,369,100,758,99000,66857
153,128,25,669,104700,66858
69,62,7,-,117300,66859
582,458,124,583,82600,66860
1291,1064,227,622,123500,66861
49,36,13,586,98300,66862
25,25,0,-,-,66863
154,145,9,-,59000,66864
375,311,64,625,187500,66865
631,498,133,757,95700,66866
273,253,20,850,-,66868
279,182,97,463,107100,66869
57,47,10,-,137500,66870
541,443,98,842,116100,66871
422,345,77,1016,82100,66872
103,103,0,-,49600,66873
2569,1680,889,714,104100,66901
64,42,22,-,-,66930
32,27,5,-,68800,66932
184,125,59,725,98800,66933
1055,727,328,643,89000,66935
129,103,26,-,44100,66936
337,283,54,340,83000,66937
486,390,96,768,76100,66938
164,120,44,694,110400,66939
187,148,39,-,48700,66940
52,45,7,-,87000,66941
112,95,17,-,53200,66942
222,154,68,653,109400,66943
101,99,2,-,227400,66944
423,366,57,563,122000,66945
78,59,19,-,120600,66946
214,189,25,494,84400,66948
242,189,53,562,76900,66949
344,279,65,910,59600,66951
205,174,31,327,83800,66952
245,174,71,480,133000,66953
29,29,0,-,-,66955
481,395,86,-,66600,66956
132,89,43,-,56400,66958
77,72,5,-,35600,66959
47,35,12,-,20500,66960
4,4,0,-,-,66961
93,76,17,525,121900,66962
115,71,44,-,32200,66963
81,77,4,-,"10,000-",66964
252,163,89,620,75000,66966
827,674,153,619,103300,66967
636,486,150,544,97300,66968
32,32,0,-,135700,66970
782,692,90,994,328000,67001
5341,4302,1039,1583,258000,67002
926,702,224,652,80300,67003
353,297,56,638,116400,67004
6058,4164,1894,759,84600,67005
255,193,62,763,143100,67008
348,223,125,657,51800,67009
5558,4455,1103,971,164300,67010
17,17,0,-,-,67012
1273,997,276,815,153100,67013
160,134,26,1000,109100,67016
785,699,86,1054,211800,67017
42,28,14,-,57500,67018
338,279,59,742,78400,67019
541,412,129,837,113100,67020
11,11,0,-,-,67021
695,539,156,661,72400,67022
62,51,11,592,-,67023
422,333,89,518,-,67024
1279,1063,216,986,164400,67025
1727,1459,268,1018,231800,67026
109,106,3,-,-,67028
465,302,163,685,74200,67029
931,774,157,1308,212300,67030
893,712,181,908,156000,67031
357,295,62,731,124400,67035
56,40,16,-,-,67036
11505,8277,3228,1077,214200,67037
224,189,35,621,95400,67038
1038,868,170,821,187700,67039
88,84,4,-,134300,67041
6479,4341,2138,846,119300,67042
1247,951,296,670,73600,67045
282,217,65,493,71900,67047
15,15,0,-,217900,67049
702,594,108,982,254500,67050
181,175,6,-,87400,67051
2808,2328,480,1417,228300,67052
190,143,47,758,93200,67053
480,359,121,682,179200,67054
46,34,12,-,138200,67055
1105,813,292,895,162200,67056
117,83,34,785,51200,67057
753,546,207,756,100000,67058
299,248,51,913,88800,67059
5135,4221,914,937,160900,67060
101,79,22,-,-,67061
1696,1053,643,612,175100,67062
1281,1033,248,727,146200,67063
117,111,6,-,72000,67065
173,98,75,1066,154200,67066
807,597,210,1607,226300,67067
1827,1179,648,828,78200,67068
394,313,81,450,88100,67070
46,46,0,-,-,67071
158,69,89,527,-,67072
125,100,25,906,121400,67073
524,468,56,811,111500,67074
2701,1547,1154,1232,213200,67101
30,21,9,-,106300,67102
80,70,10,825,175000,67103
807,608,199,703,76700,67104
68,59,9,-,74200,67105
99,99,0,-,153700,67106
1128,818,310,779,179500,67107
572,500,72,872,153700,67108
179,121,58,716,89300,67109
3125,2592,533,1163,172700,67110
86,63,23,1161,275000,67111
94,82,12,-,-,67112
8302,5930,2372,880,148000,67114
806,536,270,828,197700,67117
313,265,48,850,89900,67118
527,369,158,525,106600,67119
384,369,15,-,221400,67120
125,89,36,-,-,67122
327,310,17,744,112500,67123
2964,2046,918,763,114300,67124
322,274,48,431,57900,67127
124,109,15,-,245600,67131
132,96,36,817,167500,67132
2383,2064,319,1239,215500,67133
131,108,23,603,126900,67134
1148,939,209,1053,191000,67135
232,195,37,717,40800,67137
182,171,11,-,249000,67138
386,328,58,538,92600,67140
130,109,21,833,75000,67142
34,32,2,-,59300,67143
1069,913,156,967,164500,67144
655,539,116,850,138800,67146
3964,2950,1014,894,208400,67147
389,380,9,-,220800,67149
6,6,0,-,-,67150
188,147,41,1083,309500,67151
3475,2338,1137,834,97700,67152
635,552,83,860,121800,67154
43,36,7,-,-,67155
5262,3632,1630,804,123200,67156
80,64,16,-,78000,67159
1233,154,1079,999,591700,67202
13140,6073,7067,857,118500,67203
8678,6511,2167,887,138000,67204
6910,5733,1177,1278,289600,67205
7761,4867,2894,1079,298200,67206
11266,5015,6251,913,191100,67207
7134,3740,3394,983,159000,67208
4921,3815,1106,901,189400,67209
3153,1259,1894,873,168900,67210
7927,3395,4532,830,92100,67211
18218,11560,6658,1008,178200,67212
8440,3974,4466,882,80000,67213
6173,2461,3712,707,70300,67214
2140,1840,300,1509,199800,67215
8744,4782,3962,842,89400,67216
11853,7766,4087,941,107700,67217
9891,4970,4921,805,113300,67218
4199,2854,1345,1045,136900,67219
5858,3466,2392,872,178300,67220
0,0,0,-,-,67221
210,210,0,-,304400,67223
8444,4950,3494,1108,260000,67226
83,83,0,-,-,67227
792,765,27,-,399800,67228
3967,3725,242,2110,375000,67230
210,210,0,-,597600,67232
4982,4677,305,1535,280200,67235
0,0,0,-,-,67260
5251,3772,1479,762,106800,67301
600,462,138,932,107400,67330
61,53,8,-,68200,67332
1025,810,215,485,121700,67333
27,19,8,-,23900,67334
1299,946,353,684,85900,67335
575,465,110,486,67100,67336
4429,3079,1350,751,68800,67337
160,136,24,571,55000,67340
178,178,0,-,155100,67341
336,292,44,800,118100,67342
238,187,51,864,92900,67344
58,48,10,-,60000,67345
124,98,26,742,50800,67346
152,151,1,-,162500,67347
382,307,75,508,84800,67349
161,106,55,689,111100,67351
233,187,46,579,55300,67352
201,167,34,525,58300,67353
233,191,42,563,56400,67354
77,70,7,-,140800,67355
1080,772,308,678,88100,67356
4813,3556,1257,737,110700,67357
141,132,9,-,47600,67360
708,571,137,782,53800,67361
43,43,0,-,185400,67363
106,103,3,-,109300,67364
20965,13875,7090,866,162800,67401
4456,3357,1099,746,149800,67410
339,284,55,921,179800,67416
59,39,20,-,-,67417
104,78,26,-,178300,67418
1608,1209,399,809,100400,67420
512,448,64,844,181300,67422
102,84,18,1025,71400,67423
196,162,34,850,116700,67425
196,181,15,772,31300,67427
485,395,90,922,149300,67428
248,181,67,857,92800,67430
819,635,184,835,191700,67431
2491,1694,797,743,132100,67432
219,155,64,597,70200,67436
420,340,80,655,102000,67437
96,81,15,613,131800,67438
1058,807,251,665,133400,67439
346,271,75,863,101200,67441
84,84,0,-,-,67442
747,640,107,686,180000,67443
253,196,57,1089,55000,67444
215,206,9,-,43500,67445
315,224,91,388,153100,67446
124,79,45,438,-,67447
431,387,44,790,116300,67448
1364,978,386,829,83800,67449
290,251,39,656,68200,67450
387,285,102,653,122600,67451
116,116,0,-,94000,67452
302,275,27,692,82700,67454
691,525,166,524,94400,67455
1745,1315,430,866,177100,67456
224,184,40,668,134100,67457
165,128,37,-,185600,67458
121,110,11,-,56000,67459
6815,4834,1981,909,194900,67460
465,385,80,908,115000,67464
261,172,89,727,73300,67466
1125,792,333,629,140400,67467
115,96,19,-,55600,67468
235,161,74,1125,162100,67470
837,590,247,600,88000,67473
96,95,1,-,54100,67474
46,40,6,-,76000,67475
7,7,0,-,-,67476
45,40,5,-,-,67478
623,507,116,955,175200,67480
304,261,43,554,97000,67481
44,34,10,-,118800,67482
150,111,39,665,104200,67483
390,354,36,597,130600,67484
154,107,47,433,120600,67485
573,469,104,833,166100,67487
361,302,59,638,93200,67490
125,93,32,731,173200,67491
84,70,14,950,116700,67492
9197,5513,3684,823,83000,67501
10232,7726,2506,888,160700,67502
1282,762,520,591,135500,67505
112,98,14,1063,187500,67510
77,73,4,-,69300,67511
94,87,7,-,57300,67512
45,38,7,-,-,67513
319,230,89,787,80700,67514
22,19,3,-,37500,67515
216,167,49,499,72300,67516
14,9,5,-,-,67518
91,83,8,-,317000,67519
120,118,2,-,54500,67520
58,45,13,-,65200,67521
757,637,120,736,139800,67522
185,139,46,1065,63200,67523
264,192,72,671,73300,67524
358,300,58,536,111600,67525
1028,759,269,678,101600,67526
82,67,15,397,45000,67529
6978,4459,2519,746,122700,67530
856,734,122,815,97000,67543
1308,928,380,798,75100,67544
76,69,7,-,-,67545
986,830,156,904,171300,67546
708,509,199,699,64600,67547
676,446,230,716,78600,67548
2013,1175,838,772,100000,67550
310,268,42,533,55600,67552
38,31,7,-,67000,67553
1722,1212,510,735,85000,67554
77,74,3,-,58600,67556
255,191,64,538,79700,67557
24,21,3,-,-,67559
611,493,118,700,102600,67560
574,394,180,770,76900,67561
128,111,17,945,91800,67563
108,101,7,-,90700,67564
158,146,12,950,78900,67565
486,452,34,780,95300,67566
262,213,49,840,77500,67567
103,89,14,656,119300,67568
567,463,104,746,135400,67570
184,155,29,627,56800,67572
56,54,2,-,67500,67573
85,70,15,664,65000,67574
245,197,48,923,77300,67575
738,622,116,642,114000,67576
482,354,128,565,68100,67578
1054,823,231,630,139900,67579
151,147,4,-,67000,67581
373,296,77,631,71800,67583
78,64,14,-,34500,67584
9966,5885,4081,861,209600,67601
137,120,17,350,84000,67621
283,179,104,632,102300,67622
79,59,20,713,-,67623
115,108,7,-,-,67625
143,124,19,-,113300,67626
79,34,45,-,270000,67627
66,61,5,-,98800,67628
59,54,5,-,71300,67629
55,53,2,-,89600,67631
127,89,38,666,90600,67632
88,84,4,-,100000,67634
64,53,11,-,123400,67635
1163,931,232,-,157200,67637
80,61,19,-,-,67638
86,83,3,-,167000,67639
157,116,41,745,95500,67640
829,626,203,698,95400,67642
119,113,6,-,-,67643
79,61,18,-,73500,67644
246,214,32,478,37500,67645
358,259,99,569,69900,67646
69,56,13,600,116300,67647
296,249,47,653,42500,67648
97,90,7,231,96700,67649
156,147,9,-,67200,67650
240,176,64,626,39200,67651
119,95,24,784,82400,67653
1328,1020,308,760,127800,67654
73,61,12,-,173400,67656
101,87,14,588,103400,67657
49,45,4,-,-,67658
40,40,0,-,50000,67659
30,21,9,-,151600,67660
1308,910,398,620,95900,67661
1066,754,312,708,87200,67663
111,90,21,639,154500,67664
2151,1575,576,768,120300,67665
83,81,2,-,116300,67667
781,633,148,578,93800,67669
650,424,226,903,172000,67671
1046,848,198,649,112600,67672
48,23,25,-,-,67673
32,22,10,-,-,67674
79,66,13,-,-,67675
2491,1699,792,740,167400,67701
782,512,270,709,118500,67730
297,197,100,683,104900,67731
200,157,43,850,144200,67732
43,28,15,-,142900,67733
60,59,1,-,108900,67734
2075,1315,760,822,128600,67735
77,67,10,585,54200,67736
228,156,72,675,115600,67737
200,169,31,715,108200,67738
127,98,29,553,55600,67739
692,510,182,637,152800,67740
184,155,29,893,101500,67741
89,89,0,-,-,67743
47,37,10,-,112500,67744
177,135,42,-,-,67745
58,37,21,-,-,67747
1176,795,381,790,162000,67748
1008,768,240,682,73800,67749
82,78,4,-,91400,67751
633,488,145,716,122500,67752
200,151,49,-,103000,67753
899,752,147,669,117800,67756
175,142,33,600,95000,67757
493,356,137,535,94600,67758
96,80,16,-,97500,67761
97,49,48,577,99500,67762
125,105,20,531,61900,67764
10227,6444,3783,972,116900,67801
434,297,137,768,67300,67831
391,301,90,809,99700,67834
925,666,259,746,177900,67835
44,43,1,-,-,67836
416,335,81,608,206700,67837
289,214,75,655,81400,67838
480,413,67,-,88900,67839
42,38,4,-,65700,67840
152,134,18,930,87500,67841
165,118,47,722,144100,67842
74,0,74,880,-,67843
292,184,108,891,120500,67844
11956,7590,4366,966,182600,67846
131,117,14,692,77000,67849
199,116,83,544,67400,67850
946,829,117,1058,198800,67851
268,228,40,994,137100,67853
472,370,102,891,82200,67854
783,616,167,908,83300,67855
34,14,20,-,-,67857
251,201,50,823,116200,67859
960,689,271,978,152200,67860
789,644,145,690,99700,67861
108,95,13,342,-,67862
173,147,26,-,95000,67863
766,545,221,713,133200,67864
369,294,75,900,106000,67865
557,458,99,771,157600,67867
50,29,21,-,-,67868
580,423,157,743,145300,67869
494,354,140,703,104800,67870
2115,1290,825,641,168400,67871
632,499,133,786,163300,67876
759,631,128,756,151200,67877
658,503,155,901,128100,67878
551,410,141,749,114800,67879
2506,1857,649,681,148200,67880
138,104,34,-,198000,67882
6711,4328,2383,826,125600,67901
563,422,141,636,104800,67950
1525,1042,483,900,129800,67951
181,132,49,-,148000,67952
43,40,3,-,-,67953
351,243,108,914,76900,67954
27,21,6,-,61300,68001
943,763,180,883,265800,68002
2053,1599,454,794,261100,68003
441,351,90,823,113900,68004
8899,5035,3864,1015,179300,68005
5546,5093,453,1348,344900,68007
4940,3970,970,921,244700,68008
12,1,11,-,-,68010
132,105,27,775,122700,68014
438,397,41,1086,157400,68015
171,158,13,1271,344100,68016
883,766,117,873,189700,68017
173,148,25,-,174200,68018
199,174,25,1056,121000,68019
299,232,67,325,92500,68020
11404,8446,2958,1277,435000,68022
1046,813,233,980,349000,68023
12366,7873,4493,895,179400,68025
5528,4601,927,1414,347700,68028
360,245,115,676,167500,68029
252,203,49,905,164500,68030
544,386,158,839,175000,68031
126,111,15,890,198400,68033
317,266,51,986,220500,68034
234,191,43,989,133600,68036
972,797,175,900,276500,68037
585,439,146,674,111100,68038
217,77,140,815,53400,68039
149,135,14,-,303200,68040
419,369,50,867,208300,68041
38,25,13,-,143800,68042
274,238,36,1000,81300,68044
785,567,218,675,148900,68045
11959,8867,3092,1180,303300,68046
701,547,154,835,163200,68047
5235,4155,1080,979,231900,68048
226,207,19,779,129500,68050
94,61,33,759,53000,68055
0,0,0,-,-,68056
562,438,124,824,126000,68057
154,145,9,850,446700,68058
1287,1122,165,988,324600,68059
927,739,188,652,123400,68061
119,98,21,694,159400,68062
113,80,33,1089,90000,68063
1792,1341,451,943,324600,68064
513,472,41,917,261200,68065
2162,1538,624,916,206600,68066
330,216,114,680,52300,68067
78,76,2,-,183300,68068
1363,1196,167,1061,371000,68069
348,327,21,925,213900,68070
546,244,302,628,76400,68071
78,78,0,-,159200,68072
858,733,125,1355,211400,68073
4840,622,4218,1242,321400,68102
15367,9021,6346,976,139500,68104
9940,4313,5627,953,167900,68105
10191,5777,4414,1203,181400,68106
9367,5794,3573,977,119100,68107
5544,2630,2914,1083,120100,68108
3214,1584,1630,909,97400,68110
8503,3340,5163,1039,87900,68111
4255,3078,1177,1235,128600,68112
253,10,243,1328,-,68113
8297,4027,4270,1152,236700,68114
12598,10022,2576,1352,295000,68116
3073,2405,668,1234,145400,68117
3360,2732,628,1710,347200,68118
4453,3636,817,1261,220200,68122
12087,6838,5249,1310,251100,68123
6620,4169,2451,1173,266200,68124
9890,4422,5468,981,216500,68127
7995,4699,3296,1176,242500,68128
8091,6347,1744,1526,353200,68130
6199,1650,4549,1077,189400,68131
6558,3604,2954,970,308400,68132
5160,4001,1159,1300,331000,68133
12830,7084,5746,990,185500,68134
10434,9395,1039,1712,298000,68135
7072,6378,694,1523,311900,68136
10512,6859,3653,1254,208500,68137
4649,3481,1168,1073,203200,68138
1978,1887,91,1523,283100,68142
10645,7214,3431,1064,231400,68144
4434,3441,993,1118,187800,68147
2744,2112,632,1024,275200,68152
10076,6046,4030,1132,280800,68154
2103,1452,651,1398,200100,68157
12016,7682,4334,1210,220600,68164
156,0,156,938,-,68178
0,0,0,-,-,68182
0,0,0,-,-,68183
608,514,94,1003,267300,68301
111,99,12,508,57500,68303
107,102,5,-,292900,68304
1768,1150,618,659,125600,68305
187,167,20,844,208300,68307
42,39,3,-,-,68309
6217,4047,2170,700,150900,68310
258,212,46,1685,139700,68313
159,151,8,-,166100,68314
35,24,11,-,-,68315
194,159,35,710,99200,68316
784,739,45,1028,259700,68317
165,126,39,1109,64000,68318
215,161,54,936,149000,68319
165,100,65,671,96700,68320
183,156,27,610,225900,68321
160,134,26,658,127800,68322
87,57,30,-,-,68323
29,29,0,-,108000,68324
45,32,13,635,52500,68325
108,93,15,-,126600,68326
169,146,23,835,80000,68327
159,124,35,960,141100,68328
241,182,59,525,91500,68329
20,19,1,-,75000,68330
406,347,59,1229,239600,68331
42,40,2,-,-,68332
2912,2089,823,803,188200,68333
223,171,52,725,77300,68335
272,227,45,1119,290600,68336
146,133,13,883,81700,68337
98,89,9,950,91700,68338
409,398,11,755,430000,68339
386,287,99,-,90700,68340
394,325,69,683,141500,68341
274,186,88,543,119900,68342
424,329,95,540,144600,68343
198,174,24,1058,162500,68344
96,76,20,775,68300,68345
217,183,34,753,118800,68346
805,781,24,741,206600,68347
118,104,14,320,100000,68348
490,425,65,845,220700,68349
111,95,16,-,67500,68350
355,293,62,633,101800,68351
2102,1357,745,680,123000,68352
420,363,57,604,84500,68354
2252,1585,667,704,94800,68355
143,133,10,-,160400,68357
536,473,63,922,381500,68358
641,527,114,663,159800,68359
213,196,17,-,229200,68360
943,725,218,704,158900,68361
8,5,3,-,47500,68362
119,114,5,-,155400,68364
140,132,8,-,98800,68365
317,288,29,968,165700,68366
178,128,50,484,68400,68367
147,132,15,959,284500,68368
801,575,226,767,105300,68370
567,496,71,902,155300,68371
1337,1209,128,1296,319900,68372
68,59,9,-,30700,68375
584,409,175,610,79000,68376
151,126,25,-,135300,68377
254,243,11,595,172800,68378
28,28,0,-,100000,68379
23,22,1,-,45600,68380
56,35,21,-,73100,68381
30,18,12,-,88600,68382
357,319,38,871,158000,68401
465,356,109,872,365300,68402
109,97,12,925,183900,68403
435,386,49,-,231900,68404
1273,863,410,897,230000,68405
194,170,24,775,114400,68406
374,332,42,800,314900,68407
293,253,40,1156,194300,68409
3383,2431,952,900,158200,68410
190,163,27,-,247000,68413
97,66,31,850,75000,68414
238,214,24,640,123400,68415
113,91,22,306,92900,68416
119,99,20,1045,53100,68417
523,467,56,1096,202000,68418
103,90,13,950,190000,68419
506,442,64,535,59400,68420
318,223,95,542,96000,68421
266,216,50,1105,262700,68422
400,354,46,750,214300,68423
296,254,42,940,133900,68424
487,408,79,-,368200,68428
38,26,12,675,93300,68429
752,714,38,877,431700,68430
105,105,0,-,90800,68431
67,39,28,-,50600,68433
3221,2136,1085,921,233700,68434
224,185,39,785,161900,68436
149,125,24,850,62500,68437
48,39,9,1188,164600,68438
252,236,16,741,113100,68439
63,47,16,325,-,68440
77,50,27,-,112500,68441
125,94,31,-,108300,68442
401,322,79,810,151500,68443
13,8,5,-,275000,68444
76,60,16,-,-,68445
1236,939,297,715,199300,68446
235,198,37,713,142500,68447
129,111,18,1077,114800,68448
920,590,330,818,115400,68450
46,39,7,-,-,68452
170,130,40,-,111400,68453
300,242,58,1009,178400,68454
327,233,94,1574,275000,68455
536,396,140,813,170200,68456
204,178,26,722,83400,68457
88,78,10,708,-,68458
252,235,17,850,165100,68460
311,297,14,-,451300,68461
1699,1395,304,929,245300,68462
603,457,146,829,186000,68463
223,208,15,625,141700,68464
931,668,263,774,182900,68465
664,519,145,670,82400,68466
3759,2618,1141,845,164100,68467
11395,6066,5329,808,199800,68502
6301,2194,4107,892,147800,68503
7932,2448,5484,951,150300,68504
7425,4339,3086,1083,201100,68505
12658,8104,4554,1085,228100,68506
6635,4579,2056,883,189900,68507
6054,523,5531,729,95500,68508
9181,5576,3605,890,207000,68510
5726,3767,1959,1168,282000,68512
110,110,0,-,387300,68514
18521,12816,5705,1176,310000,68516
203,183,20,-,466400,68517
911,725,186,1368,459200,68520
14714,8356,6358,1170,219300,68521
4471,3197,1274,1136,203000,68522
652,623,29,-,485900,68523
2049,1252,797,920,192000,68524
2982,2342,640,1254,394200,68526
739,719,20,-,471100,68527
2587,1469,1118,1175,222100,68528
64,56,8,-,463000,68531
205,205,0,-,487300,68532
0,0,0,-,-,68588
11790,8585,3205,874,194200,68601
1157,885,272,662,196000,68620
102,87,15,-,178600,68621
149,111,38,394,135900,68622
192,158,34,719,34500,68623
389,360,29,722,147500,68624
251,212,39,838,163900,68626
312,282,30,696,110800,68627
343,293,50,825,141800,68628
498,418,80,489,89700,68629
138,117,21,867,183000,68631
1556,1161,395,720,162900,68632
453,379,74,792,159900,68633
229,221,8,750,137000,68634
230,164,66,779,166700,68635
562,442,120,700,98000,68636
127,105,22,625,94800,68637
706,586,120,681,128800,68638
423,362,61,808,138800,68640
455,408,47,525,109900,68641
683,594,89,707,249100,68642
396,324,72,785,129200,68643
303,204,99,769,210300,68644
293,265,28,880,185800,68647
150,97,53,-,265000,68648
719,576,143,733,198600,68649
465,352,113,625,150000,68651
286,239,47,740,154900,68652
253,233,20,925,176500,68653
234,191,43,396,85800,68654
51,49,2,-,120300,68655
261,245,16,-,161400,68658
88,75,13,1268,317300,68659
446,363,83,672,128500,68660
2258,1694,564,943,102400,68661
424,377,47,725,153500,68662
400,351,49,779,195800,68663
117,99,18,890,95500,68664
307,271,36,763,89600,68665
592,448,144,812,160000,68666
26,26,0,-,-,68667
229,194,35,679,121900,68669
12693,8371,4322,809,191800,68701
286,214,72,566,135700,68710
50,15,35,-,225000,68711
917,686,231,706,166700,68713
500,382,118,571,88200,68714
593,527,66,894,191400,68715
402,258,144,732,102400,68716
107,69,38,680,132500,68717
756,528,228,706,109300,68718
73,67,6,-,157100,68719
97,81,16,675,99200,68720
186,158,28,588,58200,68722
255,238,17,840,144600,68723
64,52,12,775,61700,68724
252,214,38,775,87100,68725
286,167,119,852,98800,68726
315,187,128,589,115900,68727
79,72,7,-,117600,68728
687,532,155,745,133500,68729
825,702,123,709,184000,68730
987,833,154,1059,168100,68731
67,64,3,-,134400,68732
461,349,112,690,121700,68733
43,19,24,-,-,68734
351,257,94,725,105100,68735
265,200,65,917,226900,68736
1034,921,113,653,180900,68739
286,249,37,1234,210600,68740
257,216,41,1156,173200,68741
88,77,11,706,135400,68742
212,174,38,1231,174300,68743
620,454,166,730,142900,68745
159,147,12,578,66300,68746
67,60,7,-,-,68747
877,681,196,788,125800,68748
25,25,0,-,38800,68749
25,21,4,-,75000,68751
245,205,40,927,123900,68752
25,18,7,-,158300,68753
167,140,27,-,102600,68755
782,583,199,896,137900,68756
324,275,49,742,111100,68757
465,323,142,669,96900,68758
113,93,20,-,69200,68759
445,268,177,509,88000,68760
164,143,21,820,52100,68761
1840,1257,583,755,155800,68763
271,207,64,495,101000,68764
428,354,74,632,167500,68765
110,86,24,-,107600,68766
1385,1080,305,826,207000,68767
262,161,101,682,178800,68768
704,502,202,765,106600,68769
639,461,178,667,167300,68770
594,461,133,715,159200,68771
80,61,19,671,-,68773
119,106,13,-,203800,68774
5296,3114,2182,958,154600,68776
264,196,68,681,102500,68777
238,196,42,715,116700,68778
853,626,227,714,176800,68779
363,279,84,750,166300,68780
625,518,107,623,115600,68781
340,265,75,512,105400,68783
623,420,203,642,114100,68784
93,85,8,1031,173200,68785
358,305,53,743,100200,68786
2591,1598,993,772,180300,68787
1849,1294,555,882,172900,68788
32,32,0,-,-,68789
408,313,95,736,168900,68790
815,581,234,792,155200,68791
169,160,9,-,113500,68792
11167,6397,4770,897,162200,68801
10544,6807,3737,872,215500,68803
330,247,83,871,127600,68810
229,178,51,650,192100,68812
213,145,68,593,143800,68813
411,290,121,1037,108000,68814
292,231,61,588,159700,68815
51,40,11,-,161500,68816
192,154,38,785,90600,68817
2127,1638,489,847,205400,68818
136,109,27,657,106700,68820
47,42,5,-,164300,68821
1978,1283,695,777,133900,68822
924,705,219,590,130200,68823
630,439,191,802,187300,68824
420,315,105,580,161300,68825
1547,1073,474,685,168700,68826
246,197,49,630,-,68827
116,95,21,1438,89600,68828
348,227,121,864,152000,68831
820,688,132,993,239600,68832
82,59,23,763,87900,68833
87,73,14,625,91000,68834
243,176,67,663,125800,68835
678,506,172,802,200900,68836
36,32,4,-,225000,68837
112,89,23,582,236300,68838
1158,857,301,913,172600,68840
247,222,25,838,192500,68841
238,175,63,635,59700,68842
317,260,57,870,197500,68843
89,84,5,-,191700,68844
8343,4997,3346,887,258000,68845
110,93,17,-,85300,68846
7244,4961,2283,898,211300,68847
0,0,0,-,-,68849
3845,2337,1508,920,137200,68850
238,182,56,758,108800,68852
600,408,192,815,108200,68853
297,273,24,765,202300,68854
151,122,29,725,209500,68855
262,196,66,923,175000,68856
139,107,32,806,151800,68858
207,164,43,550,90000,68859
138,112,26,483,58600,68860
57,49,8,-,119600,68861
1258,949,309,497,132100,68862
559,363,196,583,113000,68863
444,392,52,913,129400,68864
417,349,68,748,237900,68865
383,306,77,566,183000,68866
917,630,287,852,142900,68869
203,183,20,1083,206000,68870
118,108,10,-,102500,68871
338,290,48,1550,197500,68872
1302,980,322,786,188100,68873
310,242,68,719,80000,68874
217,180,37,536,87300,68875
675,529,146,827,145800,68876
211,139,72,850,114600,68878
145,102,43,-,86700,68879
20,20,0,-,-,68881
171,133,38,719,58200,68882
894,721,173,982,170400,68883
10796,7002,3794,815,161800,68901
560,453,107,681,168100,68920
459,352,107,1188,91300,68922
46,46,0,-,135700,68923
537,453,84,1005,211100,68924
184,162,22,817,215100,68925
261,188,73,663,60000,68926
458,376,82,796,169700,68927
152,145,7,-,65000,68928
65,56,9,-,90000,68929
569,437,132,715,162700,68930
150,130,20,815,64000,68932
362,307,55,610,122200,68933
61,46,15,-,-,68934
273,177,96,529,86000,68935
104,81,23,675,33100,68936
799,664,135,784,265500,68937
232,185,47,669,119600,68938
467,386,81,489,98100,68939
158,139,19,769,204700,68940
317,269,48,687,204700,68941
165,158,7,-,57400,68942
101,85,16,575,90600,68943
530,409,121,623,109200,68944
100,56,44,750,220400,68945
19,19,0,-,27500,68946
261,236,25,681,136800,68947
178,138,40,1225,69200,68948
2919,1957,962,697,159900,68949
141,124,17,556,103300,68950
55,42,13,-,103600,68952
12,12,0,-,-,68954
797,727,70,800,228200,68955
437,362,75,775,163400,68956
217,202,15,570,101500,68957
230,173,57,732,166300,68958
1539,1210,329,739,199800,68959
91,78,13,-,50000,68960
278,226,52,-,68300,68961
24,24,0,-,-,68964
199,166,33,500,92500,68966
491,373,118,941,112700,68967
571,456,115,602,73300,68970
164,146,18,-,148600,68971
99,68,31,-,96700,68972
181,147,34,761,159400,68973
128,126,2,-,78800,68974
44,44,0,-,-,68975
75,59,16,950,118100,68976
112,97,15,625,55700,68977
1031,815,216,634,81200,68978
697,583,114,818,148900,68979
158,129,29,1057,205400,68980
102,85,17,414,89600,68981
255,172,83,793,139500,68982
3692,2563,1129,776,150700,69001
189,151,38,903,86700,69020
557,426,131,478,110900,69021
713,601,112,835,112100,69022
127,94,33,722,291700,69023
468,327,141,917,95300,69024
399,224,175,498,154100,69025
77,59,18,-,-,69026
16,12,4,-,-,69027
305,249,56,925,148400,69028
182,140,42,443,80000,69029
87,66,21,888,92500,69030
211,142,69,479,108300,69032
1047,792,255,832,202500,69033
302,245,57,695,102300,69034
36,30,6,-,-,69036
76,76,0,-,-,69037
185,124,61,658,96100,69038
36,26,10,-,216700,69039
263,225,38,688,73800,69040
49,28,21,-,104400,69041
1,1,0,-,-,69042
217,183,34,600,60400,69043
270,195,75,613,86500,69044
355,232,123,660,89100,69045
104,96,8,-,211800,69046
12009,7784,4225,865,167100,69101
467,315,152,722,130000,69120
138,102,36,933,163500,69121
320,245,75,860,96100,69122
338,293,45,819,158900,69123
127,101,26,763,81300,69125
363,294,69,633,173700,69127
148,93,55,-,79800,69128
578,507,71,672,89500,69129
2175,1460,715,823,118600,69130
293,247,46,906,88500,69131
43,25,18,-,162500,69132
177,153,24,788,98800,69133
152,128,24,538,150000,69134
0,0,0,-,-,69135
1628,1246,382,760,157000,69138
699,532,167,850,153800,69140
196,160,36,900,125000,69141
43,21,22,408,153100,69142
692,597,95,763,174700,69143
97,53,44,-,277700,69144
1191,849,342,778,93300,69145
132,108,24,-,177800,69146
257,214,43,725,111300,69147
30,18,12,542,-,69148
337,286,51,725,105300,69149
123,115,8,900,159800,69150
284,243,41,777,201000,69151
331,150,181,589,87000,69152
2764,2025,739,716,150200,69153
540,441,99,773,85200,69154
398,267,131,771,138500,69155
285,246,39,733,97500,69156
54,38,16,-,55400,69157
43,36,7,-,307100,69161
3292,1928,1364,857,127000,69162
331,280,51,725,134400,69163
708,510,198,843,187300,69165
301,174,127,715,115400,69166
145,107,38,636,100800,69167
89,76,13,890,74300,69168
256,153,103,534,113800,69169
123,90,33,900,146400,69170
0,0,0,-,-,69171
1512,829,683,834,144700,69201
955,719,236,946,101600,69210
134,82,52,629,108300,69211
125,37,88,231,-,69212
87,35,52,890,-,69214
84,54,30,-,66300,69216
189,173,16,810,46200,69217
167,123,44,-,109200,69218
20,17,3,-,315000,69219
19,9,10,-,-,69220
43,27,16,-,-,69221
4098,2961,1137,738,166400,69301
11,11,0,-,-,69331
91,68,23,-,-,69333
874,778,96,710,114800,69334
22,19,3,-,-,69335
870,657,213,734,107200,69336
2726,1590,1136,891,151900,69337
593,462,131,808,83200,69339
16,12,4,-,-,69340
4242,3104,1138,843,162300,69341
1029,694,335,682,94300,69343
160,101,59,1083,180400,69345
219,146,73,938,86300,69346
539,433,106,813,114100,69347
497,383,114,843,114400,69348
156,101,55,733,113800,69350
92,49,43,-,120100,69351
319,231,88,867,91900,69352
38,34,4,-,90000,69353
64,44,20,-,161700,69354
75,65,10,775,-,69355
847,677,170,538,117200,69356
1465,1148,317,891,159700,69357
870,644,226,567,150200,69358
498,313,185,824,84200,69360
7380,4393,2987,921,145600,69361
12,12,0,-,-,69365
103,74,29,1094,168800,69366
91,80,11,513,-,69367
17647,8968,8679,1110,286000,70001
8671,4478,4193,1091,361200,70002
16503,12868,3635,1133,243200,70003
11332,7599,3733,1173,362200,70005
6013,3809,2204,1132,308800,70006
1334,1239,95,1479,199500,70030
515,483,32,-,183800,70031
1831,1300,531,939,201300,70032
297,287,10,-,167000,70036
5811,3930,1881,1674,323100,70037
14,14,0,-,-,70038
811,572,239,1164,238300,70039
492,441,51,-,107700,70040
1068,928,140,936,69800,70041
7902,4849,3053,1047,192800,70043
4828,3885,943,1145,290200,70047
470,449,21,-,149500,70049
18,0,18,-,-,70050
591,512,79,-,133000,70051
1043,918,125,862,208300,70052
7307,3438,3869,994,212000,70053
14425,8143,6282,1137,212200,70056
1399,1231,168,577,214700,70057
14713,9714,4999,1179,180700,70058
6154,3187,2967,1089,180000,70062
20524,12960,7564,1083,242200,70065
976,833,143,1069,214000,70067
11952,9290,2662,1173,184600,70068
5009,4246,763,1444,260000,70070
1150,962,188,828,184200,70071
20692,15735,4957,1057,181000,70072
1728,1635,93,782,209400,70075
42,42,0,-,161100,70076
1179,845,334,1107,227800,70079
318,267,51,-,170200,70080
112,65,47,-,32900,70082
767,618,149,-,95800,70083
2347,1820,527,1107,150800,70084
1676,1340,336,1097,140600,70085
721,510,211,639,148900,70086
2613,2005,608,796,183400,70087
2870,2177,693,656,167700,70090
51,31,20,-,-,70091
2434,2027,407,1196,159200,70092
12051,7375,4676,1136,138700,70094
2444,198,2246,1050,415300,70112
4015,907,3108,917,253100,70113
9359,4014,5345,1035,178000,70114
14033,7805,6228,1382,586300,70115
5679,2322,3357,1170,391800,70116
12023,5685,6338,1135,241700,70117
12793,6435,6358,1195,425200,70118
16829,6307,10522,1248,327000,70119
5526,3049,2477,1096,233200,70121
14935,8440,6495,1159,262900,70122
12914,7683,5231,1290,291400,70123
7962,5820,2142,1715,557600,70124
6390,2873,3517,1250,392000,70125
10777,5074,5703,1098,182300,70126
9799,4450,5349,1036,186600,70127
7916,5086,2830,1135,213300,70128
3076,2084,992,1074,169500,70129
7052,2572,4480,1379,506300,70130
10450,6653,3797,1029,222900,70131
0,0,0,-,-,70139
137,0,137,696,-,70148
0,0,0,-,-,70163
18451,13716,4735,933,206400,70301
0,0,0,-,-,70310
2046,1844,202,814,160400,70339
66,66,0,-,-,70340
1623,1296,327,1366,123500,70341
1754,1346,408,497,158400,70342
1923,1697,226,-,179700,70343
1993,1619,374,775,97400,70344
3453,2848,605,700,175800,70345
3515,2268,1247,736,162200,70346
142,106,36,-,-,70352
330,299,31,766,-,70353
1742,1419,323,801,111600,70354
469,435,34,-,118100,70355
731,522,209,648,109600,70356
1085,859,226,707,132400,70357
420,304,116,1028,257900,70358
3406,2957,449,1014,148300,70359
10905,8072,2833,1022,283100,70360
9248,6576,2672,913,142500,70363
10951,7569,3382,964,189000,70364
904,820,84,1197,116800,70372
2236,1774,462,717,153500,70373
2522,1919,603,881,160600,70374
48,48,0,-,246200,70375
1327,1080,247,808,113400,70377
8123,5562,2561,849,139900,70380
2606,1918,688,758,126000,70390
67,0,67,-,-,70391
2906,1978,928,736,155400,70392
48,48,0,-,-,70393
5662,4600,1062,839,170000,70394
1527,1327,200,833,169500,70395
316,316,0,-,158500,70397
8025,3926,4099,921,204000,70401
0,0,0,-,-,70402
11534,8059,3475,950,199000,70403
3057,2478,579,1065,266300,70420
4834,3216,1618,835,186100,70422
2062,1409,653,-,105500,70426
6854,4043,2811,791,115100,70427
2079,1928,151,1169,229700,70431
16573,11465,5108,1336,305200,70433
7768,7123,645,1106,258200,70435
125,93,32,-,-,70436
2936,2693,243,504,275100,70437
7675,5735,1940,701,150500,70438
2164,1591,573,-,72400,70441
96,96,0,-,226000,70442
2619,2156,463,911,139900,70443
3695,3078,617,738,165400,70444
3723,3127,596,1074,207400,70445
2278,2239,39,-,219200,70446
5615,5284,331,2197,361400,70447
9822,7900,1922,1477,306700,70448
1240,1052,188,843,251400,70449
1000,807,193,-,-,70450
69,0,69,-,-,70451
5005,4308,697,876,208400,70452
481,441,40,-,104600,70453
12424,10379,2045,1053,202500,70454
818,818,0,-,192400,70455
811,718,93,863,108500,70456
0,0,0,-,-,70457
15362,11102,4260,1372,212500,70458
8083,6268,1815,1104,174900,70460
11680,9018,2662,1123,258800,70461
2082,1962,120,-,191100,70462
51,33,18,731,-,70463
93,30,63,-,-,70464
186,116,70,850,-,70465
3290,2239,1051,824,168600,70466
9223,7141,2082,1184,365900,70471
10738,4875,5863,889,117100,70501
12009,8026,3983,1080,300200,70503
17861,9624,8237,965,205700,70506
7144,5132,2012,931,192600,70507
16489,10357,6132,1204,288300,70508
9476,6663,2813,744,152100,70510
3974,3166,808,491,129100,70512
52,0,52,-,-,70513
727,334,393,917,126100,70514
1164,892,272,815,127700,70515
454,416,38,-,137900,70516
9616,7441,2175,917,141000,70517
5817,4656,1161,987,272100,70518
18,18,0,-,-,70519
8199,6551,1648,886,191100,70520
34,21,13,-,-,70522
131,113,18,800,122900,70523
109,44,65,638,92900,70524
4770,3291,1479,768,135900,70525
6966,3954,3012,632,141400,70526
1000,772,228,843,124800,70528
5704,4226,1478,772,184200,70529
616,530,86,-,226500,70531
1038,835,203,489,89000,70532
2708,2133,575,778,143400,70533
242,168,74,634,97800,70534
6470,4126,2344,772,154900,70535
102,102,0,-,-,70537
5161,3799,1362,831,107000,70538
381,121,260,629,140600,70541
1174,984,190,647,121700,70542
1521,1191,330,629,170600,70543
3988,3199,789,847,106400,70544
6330,4593,1737,811,148800,70546
3594,2750,844,722,109500,70548
1163,859,304,707,96800,70549
38,38,0,-,-,70550
181,170,11,-,-,70551
395,270,125,821,93900,70552
2151,1320,831,525,89600,70554
3200,2708,492,810,217300,70555
340,259,81,463,56800,70556
24,0,24,-,-,70558
903,621,282,493,106900,70559
14159,8203,5956,831,120500,70560
7914,6409,1505,924,186600,70563
14651,10083,4568,751,160500,70570
16,16,0,-,-,70575
374,216,158,711,154300,70576
1590,1119,471,678,126000,70577
6320,4840,1480,811,156500,70578
80,17,63,-,-,70580
328,288,40,-,226400,70581
7902,6113,1789,682,129700,70582
4091,2957,1134,843,122100,70583
2270,1744,526,861,184900,70584
102,77,25,537,87500,70585
7373,4629,2744,697,104200,70586
1170,842,328,598,127700,70589
1686,1474,212,667,164200,70591
10069,8599,1470,1130,232100,70592
12980,7282,5698,865,145700,70601
15650,11387,4263,1305,278200,70605
10295,6153,4142,984,169900,70607
0,0,0,-,-,70609
7748,6412,1336,1206,236600,70611
4571,2709,1862,1039,126100,70615
0,0,0,-,-,70629
701,604,97,-,180000,70630
148,148,0,-,162500,70631
189,185,4,-,-,70632
2520,2194,326,676,174600,70633
9847,7630,2217,900,156500,70634
367,338,29,-,-,70637
368,254,114,1125,-,70638
180,175,5,-,111400,70639
113,78,35,-,96100,70640
102,78,24,-,-,70643
227,209,18,-,-,70644
352,305,47,-,235700,70645
140,104,36,-,173900,70646
3971,3353,618,1078,259200,70647
2427,1814,613,705,156700,70648
100,48,52,-,-,70650
39,39,0,-,-,70651
628,539,89,751,148900,70652
1371,1152,219,565,111900,70653
49,49,0,-,-,70654
972,723,249,425,85900,70655
1255,1123,132,1258,64000,70656
1650,1571,79,-,168600,70657
231,212,19,688,76800,70658
508,310,198,728,176800,70659
564,529,35,-,-,70660
561,437,124,240,71700,70661
204,194,10,-,152800,70662
10721,8318,2403,866,166600,70663
4463,3804,659,1349,208700,70665
2118,1549,569,845,154400,70668
3667,3038,629,956,149200,70669
7463,6677,786,1209,225200,70706
2512,2076,436,890,233700,70710
1837,1472,365,798,218800,70711
139,12,127,-,-,70712
6223,4825,1398,1032,151000,70714
358,348,10,-,57800,70715
1431,1101,330,967,234600,70719
166,149,17,277,182900,70721
2288,1847,441,591,218800,70722
410,375,35,-,-,70723
346,305,41,-,-,70725
21089,16089,5000,1170,211000,70726
300,275,25,-,275000,70729
1379,1233,146,686,224300,70730
425,357,68,1071,180800,70732
523,426,97,1125,219600,70733
2956,2403,553,1398,287400,70734
256,246,10,-,103000,70736
18158,14620,3538,1404,240000,70737
4891,4677,214,1609,279000,70739
385,346,39,-,122700,70740
197,186,11,-,176900,70743
1855,1741,114,961,130900,70744
121,67,54,-,-,70747
1633,1155,478,682,201600,70748
580,414,166,788,242500,70749
558,440,118,475,87500,70750
234,234,0,-,165500,70752
329,247,82,-,80200,70753
4433,3497,936,1146,172700,70754
706,573,133,637,195800,70755
159,118,41,-,-,70756
1009,708,301,743,128200,70757
593,484,109,1008,-,70759
2854,1941,913,838,161600,70760
201,181,20,850,187500,70761
242,235,7,-,243300,70762
1657,1584,73,-,272300,70763
6198,4888,1310,809,160100,70764
5868,4143,1725,997,202100,70767
16907,15123,1784,1285,287500,70769
1215,1198,17,-,185500,70770
439,430,9,-,96900,70772
0,0,0,-,-,70773
3518,3069,449,1108,222800,70774
3539,2680,859,1054,240400,70775
1447,897,550,859,288500,70776
1531,1251,280,1055,191000,70777
1157,1041,116,1023,243100,70778
349,287,62,-,-,70780
32,25,7,-,278800,70782
941,813,128,1305,316300,70783
7884,6766,1118,1052,214700,70785
0,0,0,-,-,70786
112,60,52,-,-,70787
1423,779,644,692,156600,70788
299,229,70,378,117100,70789
11092,9319,1773,1343,263700,70791
231,0,231,1600,-,70801
9812,3090,6722,884,101300,70802
0,0,0,-,-,70803
9061,3628,5433,846,94000,70805
12572,5605,6967,985,310100,70806
5357,2449,2908,853,111700,70807
16270,8591,7679,1221,384600,70808
11800,6384,5416,1314,294200,70809
15941,11415,4526,1240,343400,70810
4554,2819,1735,922,145600,70811
3460,2524,936,1104,118600,70812
0,0,0,-,-,70813
4318,2902,1416,1064,179900,70814
10899,7099,3800,980,204300,70815
18157,9552,8605,1117,224600,70816
13329,10818,2511,1279,276500,70817
3678,2841,837,1266,243700,70818
1402,1249,153,1060,171500,70819
8633,2498,6135,1021,282400,70820
0,0,0,-,-,70825
179,0,179,1361,-,70836
1805,1195,610,600,87600,71001
89,51,38,850,116800,71002
315,260,55,936,86600,71003
183,140,43,1069,170000,71004
5553,4810,743,1059,294300,71006
573,496,77,-,153000,71007
169,105,64,660,-,71008
40,40,0,-,-,71009
587,460,127,528,83800,71016
443,338,105,-,57600,71018
2820,2178,642,701,101600,71019
231,150,81,308,64200,71021
1252,1075,177,1075,80200,71023
448,419,29,482,129900,71024
455,313,142,1027,-,71027
601,445,156,508,80600,71028
76,69,7,-,112500,71029
504,413,91,-,162500,71030
332,289,43,897,80700,71031
941,809,132,-,171700,71032
1655,1456,199,578,200000,71033
118,85,33,-,84800,71034
7773,6801,972,1089,193800,71037
1683,1208,475,464,84300,71038
688,558,130,929,102700,71039
2392,1616,776,657,72500,71040
171,147,24,-,81400,71043
319,268,51,675,103000,71044
285,235,50,388,97900,71045
327,289,38,-,97300,71046
3958,3449,509,870,142900,71047
83,67,16,-,56100,71048
1380,987,393,450,86600,71049
1005,794,211,-,-,71051
3509,2075,1434,599,89000,71052
7309,4584,2725,793,132900,71055
1000,815,185,1022,129300,71060
776,420,356,-,117100,71061
260,222,38,-,72300,71063
1338,1098,240,488,96700,71064
339,240,99,578,55200,71065
5,5,0,-,-,71066
949,583,366,721,96800,71067
1433,1048,385,353,71900,71068
252,154,98,665,72000,71069
483,437,46,619,99300,71070
932,732,200,386,84000,71071
563,498,65,488,88100,71072
920,675,245,696,130700,71073
2391,1206,1185,719,101900,71075
2757,2464,293,968,247800,71078
110,101,9,-,74500,71079
1705,1249,456,754,60400,71082
3305,960,2345,710,88400,71101
2403,1054,1349,815,79100,71103
5563,2604,2959,1022,159300,71104
9227,4936,4291,1192,201600,71105
12553,8358,4195,825,295300,71106
11907,7562,4345,893,144200,71107
7324,3159,4165,1048,79500,71108
7106,3272,3834,829,88100,71109
993,0,993,1613,-,71110
17012,9644,7368,1001,256700,71111
12485,7975,4510,1124,175700,71112
6618,4195,2423,1034,227400,71115
9128,5652,3476,1050,161100,71118
4633,3493,1140,1015,186500,71119
5515,3338,2177,893,171400,71129
8905,4668,4237,859,261300,71201
8875,4103,4772,815,77000,71202
14839,8313,6526,935,172700,71203
0,0,0,-,-,71209
0,0,0,-,-,71212
0,0,0,-,-,71218
381,294,87,1188,89600,71219
7611,5023,2588,734,96300,71220
1197,817,380,673,95800,71222
203,65,138,632,51300,71223
3094,2617,477,858,223000,71225
808,568,240,685,65200,71226
1417,1100,317,922,173500,71227
641,538,103,454,144400,71229
0,0,0,-,-,71230
2190,1453,737,812,112800,71232
47,27,20,-,-,71233
1581,1370,211,1054,141700,71234
1788,1228,560,843,127900,71235
395,236,159,975,105500,71237
971,793,178,885,132200,71238
3126,2419,707,702,132200,71241
12,6,6,-,-,71242
62,62,0,-,160900,71243
1408,515,893,778,143800,71245
487,298,189,685,66200,71247
30,23,7,-,-,71250
2694,1590,1104,705,98300,71251
194,151,43,624,-,71253
2100,1197,903,724,68300,71254
243,194,49,504,45500,71256
705,602,103,912,124300,71259
1176,946,230,469,103900,71260
603,381,222,380,77100,71261
2633,2049,584,607,97400,71263
372,278,94,-,138600,71264
594,439,155,763,117000,71266
965,872,93,825,136200,71268
4449,2666,1783,735,125600,71269
12526,5941,6585,814,209400,71270
0,0,0,-,-,71272
1265,849,416,773,89900,71275
69,63,6,-,81200,71276
754,513,241,1294,81100,71277
59,0,59,-,-,71279
1876,1360,516,1106,232200,71280
2866,1564,1302,597,89200,71282
187,187,0,-,85600,71286
13453,8550,4903,1022,204700,71291
8255,5689,2566,812,119100,71292
5130,3848,1282,768,94100,71295
7333,3567,3766,904,148900,71301
5017,2966,2051,828,100200,71302
8978,5204,3774,1109,233000,71303
28,28,0,-,-,71316
67,51,16,-,308900,71320
2343,1524,819,803,114300,71322
313,280,33,-,162200,71323
555,366,189,654,133000,71325
335,278,57,444,-,71326
1420,1016,404,705,110400,71327
3013,2703,310,1033,147600,71328
18,18,0,-,-,71330
357,347,10,-,156500,71331
263,214,49,663,-,71333
2992,2116,876,648,78200,71334
631,471,160,635,111300,71336
0,0,0,-,-,71339
338,250,88,527,77800,71340
995,667,328,964,127900,71341
2819,2312,507,522,128000,71342
2346,1855,491,757,94500,71343
0,0,0,-,-,71345
1016,809,207,676,165800,71346
1745,1227,518,763,158700,71350
4581,2969,1612,761,128700,71351
652,592,60,-,108000,71353
412,394,18,-,107100,71354
906,718,188,595,129600,71355
177,149,28,-,130100,71356
622,411,211,550,53900,71357
368,250,118,773,87300,71358
0,0,0,-,-,71359
13441,9147,4294,885,190900,71360
705,520,185,661,124100,71362
638,446,192,685,89500,71366
687,550,137,626,166100,71367
465,348,117,573,101500,71368
950,684,266,409,100900,71369
579,535,44,-,158700,71371
2329,1594,735,929,113600,71373
333,234,99,489,72300,71375
865,550,315,670,109900,71378
11,11,0,-,-,71401
1472,1224,248,1250,157100,71403
282,211,71,-,-,71404
2007,1731,276,988,176200,71405
38,26,12,-,-,71406
452,372,80,-,-,71407
2074,1480,594,884,157600,71409
23,19,4,-,83000,71410
1244,703,541,583,109600,71411
102,27,75,934,53800,71414
124,67,57,768,-,71415
382,180,202,725,86900,71416
1701,1298,403,744,95800,71417
1823,1257,566,672,87000,71418
664,596,68,736,95000,71419
661,551,110,721,103100,71422
1582,1430,152,960,121600,71423
472,439,33,-,145300,71424
10,0,10,-,-,71425
43,26,17,-,-,71426
85,63,22,-,78000,71427
0,0,0,-,-,71428
1207,911,296,806,95700,71429
879,633,246,1214,176900,71430
355,297,58,814,57800,71432
1478,1116,362,710,111800,71433
17,17,0,-,-,71434
1484,1056,428,848,148300,71435
489,436,53,-,178700,71438
643,458,185,775,104300,71439
284,243,41,-,22800,71441
8635,5531,3104,892,147400,71446
405,319,86,843,111700,71447
3457,2350,1107,621,162300,71449
387,320,67,882,-,71450
85,21,64,-,319200,71452
895,763,132,768,82700,71454
61,17,44,-,-,71455
523,420,103,-,258700,71456
9249,5012,4237,797,182600,71457
3298,0,3298,1109,-,71459
967,450,517,796,128200,71461
582,486,96,683,56900,71462
2787,1990,797,776,114100,71463
976,793,183,596,112000,71465
218,218,0,-,152700,71466
1969,1555,414,708,160600,71467
297,220,77,845,182000,71468
912,602,310,935,92200,71469
49,49,0,-,-,71472
177,158,19,-,-,71473
134,125,9,-,158000,71474
4,4,0,-,-,71475
191,137,54,642,103500,71479
201,174,27,1075,84100,71480
3292,2185,1107,595,111000,71483
1077,797,280,795,282100,71485
1799,1360,439,630,104900,71486
162,5,157,524,-,71497
4832,2652,2180,809,67300,71601
5549,3457,2092,785,130300,71602
11873,7703,4170,847,114700,71603
216,177,39,615,89800,71630
231,195,36,-,55000,71631
4173,2965,1208,617,87500,71635
1157,745,412,575,62800,71638
2244,1387,857,591,91900,71639
1113,704,409,516,55100,71640
313,298,15,-,58700,71642
412,312,100,534,73000,71643
230,187,43,605,130300,71644
2240,1728,512,595,94100,71646
551,411,140,432,68400,71647
37,37,0,-,224300,71651
301,248,53,780,57200,71652
1833,1371,462,695,146100,71653
1695,957,738,657,99500,71654
5724,3637,2087,699,130500,71655
186,137,49,730,53000,71658
10,10,0,-,-,71659
347,255,92,-,137200,71660
52,41,11,825,47000,71661
10,0,10,-,-,71662
232,204,28,531,65300,71663
1879,1548,331,605,111000,71665
0,0,0,-,-,71666
2608,2092,516,704,116600,71667
540,434,106,575,83300,71670
2905,1814,1091,662,97600,71671
230,198,32,760,66300,71674
722,595,127,752,129500,71675
209,162,47,520,46300,71676
57,46,11,-,-,71677
0,0,0,-,-,71678
6563,4770,1793,724,101000,71701
822,550,272,771,90900,71720
0,0,0,-,-,71721
28,21,7,-,-,71722
130,110,20,-,55700,71724
125,97,28,475,80700,71725
476,414,62,389,81100,71726
11,11,0,-,-,71728
11248,7686,3562,776,125200,71730
538,452,86,664,152600,71740
1536,1039,497,582,93500,71742
1295,947,348,627,109600,71743
985,803,182,838,91300,71744
58,57,1,-,65000,71745
318,303,15,-,66000,71747
30,30,0,-,208300,71748
1124,976,148,746,98000,71749
215,196,19,728,99400,71751
314,240,74,516,59000,71752
5387,3589,1798,694,151400,71753
54,44,10,-,-,71758
173,160,13,-,155600,71759
1145,848,297,818,85800,71762
579,469,110,495,88700,71763
473,405,68,428,74600,71764
993,902,91,647,44700,71765
178,163,15,475,58100,71766
1308,1139,169,727,90600,71770
8,8,0,-,107500,71772
5538,3468,2070,757,103500,71801
33,33,0,-,-,71820
3087,2621,466,748,120200,71822
27,26,1,-,-,71823
144,125,19,706,94800,71825
507,392,115,-,60000,71826
303,241,62,-,-,71827
46,46,0,-,-,71831
3592,2141,1451,690,96600,71832
872,756,116,448,95500,71833
629,629,0,-,-,71834
439,395,44,525,102200,71835
1181,1007,174,584,79400,71836
1476,1250,226,973,74000,71837
504,450,54,744,119800,71838
162,69,93,475,33200,71839
253,219,34,900,64600,71841
738,529,209,813,149800,71842
590,418,172,705,83300,71845
948,708,240,715,88900,71846
92,84,8,-,118300,71847
781,575,206,822,94400,71851
3811,2736,1075,723,138600,71852
139,108,31,685,43000,71853
13596,8569,5027,834,148600,71854
139,120,19,-,44400,71855
1918,1056,862,807,91000,71857
738,625,113,625,41300,71858
164,120,44,-,153300,71859
926,706,220,653,73400,71860
735,615,120,919,81200,71861
338,230,108,-,-,71862
26,22,4,-,-,71864
90,59,31,892,79700,71865
204,143,61,670,229900,71866
12474,7872,4602,784,162500,71901
9432,8042,1390,1148,244200,71909
20363,13095,7268,939,165600,71913
1204,972,232,770,85800,71921
78,31,47,703,41900,71922
5713,3278,2435,694,157400,71923
1712,1470,242,884,179300,71929
467,322,145,573,109700,71933
341,288,53,-,148200,71935
868,669,199,716,96400,71937
623,549,74,604,92700,71940
843,721,122,816,149400,71941
59,52,7,-,96600,71942
1560,1038,522,654,135700,71943
276,231,45,797,81300,71944
594,449,145,672,80400,71945
452,358,94,-,111400,71949
275,198,77,-,108500,71950
18,18,0,-,118800,71952
5429,4417,1012,764,143500,71953
584,525,59,584,79600,71956
1238,987,251,628,152400,71957
927,694,233,484,95400,71958
254,213,41,-,120800,71959
485,358,127,683,128700,71960
489,392,97,-,76700,71961
333,328,5,-,107100,71962
2067,1847,220,1122,163000,71964
98,61,37,-,91300,71965
1711,1420,291,1050,197100,71968
120,105,15,-,117000,71969
300,290,10,-,114700,71970
217,140,77,786,170200,71971
124,87,37,-,-,71972
488,357,131,605,90900,71973
0,0,0,-,-,71998
0,0,0,-,-,71999
293,220,73,578,92100,72001
7412,6551,861,985,183200,72002
284,241,43,918,107600,72003
303,212,91,435,86900,72004
23,23,0,-,-,72005
927,646,281,600,120200,72006
3580,2917,663,1229,193400,72007
2209,1481,728,809,123200,72010
1727,1471,256,879,152500,72011
4801,3177,1624,768,152000,72012
814,538,276,-,131200,72013
13,11,2,-,-,72014
10824,7604,3220,971,161500,72015
1138,782,356,746,155100,72016
174,91,83,668,63000,72017
11129,8520,2609,946,235600,72019
1170,924,246,599,91600,72020
1551,942,609,560,84700,72021
7414,5055,2359,946,207100,72022
13635,9638,3997,962,190200,72023
1535,1300,235,691,123300,72024
336,296,40,-,98800,72025
84,62,22,-,108300,72026
534,416,118,-,90000,72027
0,0,0,-,-,72028
611,378,233,482,76400,72029
294,217,77,-,-,72030
2554,1935,619,642,119900,72031
13122,8185,4937,933,168400,72032
20032,9452,10580,946,235000,72034
0,0,0,-,-,72035
261,151,110,487,39300,72036
50,50,0,-,156600,72038
818,676,142,941,122100,72039
1060,711,349,612,74300,72040
527,423,104,600,35000,72041
2044,1507,537,770,111700,72042
463,430,33,-,194400,72044
531,454,77,941,132200,72045
1655,1111,544,765,105200,72046
293,270,23,625,194200,72047
48,48,0,-,267600,72048
170,121,49,-,66000,72051
36,27,9,-,108900,72052
0,0,0,-,-,72053
246,196,50,680,98800,72055
460,448,12,-,96200,72057
6371,5178,1193,889,192400,72058
8,8,0,-,-,72059
222,189,33,683,86800,72060
48,48,0,-,212500,72061
746,632,114,801,96300,72063
999,787,212,876,103000,72064
2001,1447,554,877,165200,72065
74,74,0,-,-,72066
1217,983,234,714,159600,72067
267,153,114,720,80900,72068
465,311,154,462,86400,72069
682,552,130,722,123000,72070
136,124,12,-,107500,72072
302,229,73,765,95600,72073
44,40,4,-,94000,72074
10,0,10,-,-,72075
16034,8676,7358,874,146500,72076
161,148,13,-,137200,72079
167,162,5,-,-,72080
2854,1992,862,632,127100,72081
779,347,432,686,87100,72082
98,50,48,875,-,72083
393,315,78,688,85000,72084
106,65,41,848,116500,72085
4438,3281,1157,891,131500,72086
631,596,35,793,174500,72087
1477,1284,193,784,154600,72088
0,0,0,-,-,72099
1290,903,387,590,97200,72101
1222,1004,218,700,96800,72102
5323,4264,1059,987,125900,72103
8038,5944,2094,710,109800,72104
2183,1696,487,861,152400,72106
37,37,0,-,110400,72107
0,0,0,-,-,72108
4510,2540,1970,686,133500,72110
559,500,59,581,142600,72111
3889,2292,1597,653,95000,72112
11420,6718,4702,1043,256500,72113
5019,1469,3550,768,85800,72114
9663,6338,3325,1012,210400,72116
5652,3530,2122,999,126300,72117
9490,5209,4281,955,114000,72118
0,0,0,-,-,72119
13537,9648,3889,993,184800,72120
1046,720,326,816,131700,72121
507,469,38,-,176700,72122
123,90,33,508,45800,72123
270,209,61,729,103800,72125
1347,1044,303,613,120500,72126
1071,905,166,686,134300,72127
274,201,73,1018,112200,72128
504,453,51,673,97500,72129
139,108,31,564,119300,72130
1705,1431,274,836,141000,72131
1297,1082,215,980,111400,72132
16,0,16,-,-,72133
259,210,49,-,120300,72134
1401,1173,228,861,269300,72135
779,644,135,-,155500,72136
853,674,179,891,130400,72137
126,61,65,354,69000,72139
98,81,17,-,111500,72140
172,140,32,-,99000,72141
904,838,66,704,205200,72142
12842,8022,4820,831,173100,72143
4729,3663,1066,800,175900,72150
175,112,63,-,89200,72152
1410,1262,148,654,118300,72153
234,204,30,-,261100,72156
481,393,88,751,159000,72157
3487,1985,1502,745,156300,72160
48,33,15,-,-,72165
79,75,4,-,-,72166
510,456,54,694,91800,72167
88,88,0,-,53700,72168
33,23,10,-,47500,72169
104,100,4,-,85200,72170
3665,3271,394,599,183000,72173
99,51,48,1052,-,72175
3008,2026,982,963,150900,72176
14,14,0,-,75000,72178
139,115,24,-,86300,72179
21,21,0,-,-,72180
5,5,0,-,-,72181
29,10,19,-,-,72182
0,0,0,-,-,72183
16,16,0,-,-,72199
471,99,372,1257,241700,72201
5374,1393,3981,989,221200,72202
12370,7047,5323,923,113400,72204
10263,5199,5064,1074,196300,72205
8340,5755,2585,828,129000,72206
5558,3958,1600,898,383400,72207
12089,5471,6618,899,92100,72209
6278,3769,2509,932,215700,72210
10876,5528,5348,1091,249900,72211
5321,4616,705,995,317800,72212
11070,6785,4285,1203,426600,72223
4764,3075,1689,957,241700,72227
9683,4318,5365,802,109000,72301
29,23,6,775,55800,72311
0,0,0,-,-,72313
7829,4602,3227,771,110500,72315
24,24,0,-,-,72320
27,22,5,-,68300,72322
851,612,239,925,82600,72324
3,1,2,-,-,72325
973,657,316,728,109500,72326
503,391,112,615,136900,72327
17,0,17,-,-,72328
0,0,0,-,-,72329
144,114,30,688,67100,72330
852,434,418,661,73600,72331
42,7,35,702,96300,72332
151,96,55,396,56000,72333
5354,2505,2849,762,85600,72335
11,0,11,-,-,72338
72,64,8,788,-,72339
42,42,0,-,90600,72340
90,39,51,-,60800,72341
1642,627,1015,681,103200,72342
181,153,28,-,-,72346
293,188,105,708,57400,72347
1048,704,344,614,98300,72348
397,249,148,607,69000,72350
314,202,112,761,98800,72351
6,6,0,-,-,72352
31,31,0,-,-,72353
861,577,284,561,68800,72354
776,516,260,903,94600,72355
483,342,141,661,40400,72358
166,99,67,-,40500,72359
1887,1059,828,638,70500,72360
6050,4120,1930,975,189900,72364
936,579,357,555,61400,72365
789,525,264,640,62000,72366
0,0,0,-,-,72367
427,347,80,725,112500,72368
0,0,0,-,-,72369
2556,1238,1318,806,99400,72370
619,460,159,648,77900,72372
370,215,155,575,45600,72373
203,132,71,-,84800,72374
617,558,59,606,108600,72376
31,9,22,-,-,72377
6,6,0,-,-,72379
15,15,0,-,-,72383
247,162,85,713,81300,72384
571,409,162,611,75700,72386
0,0,0,-,-,72387
181,89,92,286,73600,72389
2474,1352,1122,747,64600,72390
20,20,0,-,-,72391
158,132,26,589,99000,72392
133,115,18,775,43800,72394
518,328,190,833,150000,72395
4960,3246,1714,811,124900,72396
16920,8060,8860,810,165900,72401
11337,7788,3549,923,217500,72404
6210,4192,2018,1040,226500,72405
183,112,71,-,56300,72410
1088,572,516,907,92300,72411
185,177,8,-,-,72412
248,177,71,759,66100,72413
135,89,46,472,67200,72414
428,333,95,638,74200,72415
2008,1561,447,853,147900,72416
1997,1237,760,901,158600,72417
641,452,189,676,60000,72419
144,85,59,655,58200,72421
1777,1277,500,544,85400,72422
27,25,2,-,33200,72424
138,133,5,-,101500,72425
92,69,23,469,115600,72426
25,19,6,-,68300,72427
50,21,29,-,129700,72428
114,84,30,575,58200,72429
179,134,45,586,34600,72430
134,104,30,675,-,72431
2452,1747,705,742,108900,72432
1104,709,395,669,80900,72433
812,692,120,481,96300,72434
145,136,9,-,-,72435
282,263,19,563,110300,72436
1423,1045,378,790,132600,72437
968,663,305,404,119200,72438
90,75,15,825,78300,72440
13,13,0,-,70700,72441
1488,1061,427,597,140500,72442
1260,837,423,720,99600,72443
612,521,91,663,106100,72444
17,13,4,-,95000,72445
743,508,235,567,111500,72447
57,41,16,-,56300,72449
15438,9644,5794,817,164900,72450
84,84,0,-,113600,72453
1950,1406,544,775,94000,72454
5083,3590,1493,700,116500,72455
230,183,47,859,90400,72456
94,90,4,-,93300,72457
189,174,15,1016,86900,72458
646,512,134,492,58100,72459
347,292,55,519,106600,72460
1553,1111,442,611,86800,72461
165,74,91,620,80000,72462
3,1,2,-,-,72464
423,357,66,480,120300,72466
27,0,27,-,-,72467
473,381,92,919,123500,72469
129,101,28,755,61500,72470
398,303,95,506,62800,72471
3873,2190,1683,642,105700,72472
952,770,182,709,84100,72473
2907,1675,1232,716,83500,72476
77,77,0,-,78600,72478
429,323,106,741,84000,72479
555,479,76,670,65400,72482
9875,6417,3458,777,119900,72501
905,721,184,615,103200,72512
1046,791,255,583,102200,72513
0,0,0,-,-,72515
63,63,0,-,51300,72517
938,737,201,458,130800,72519
263,256,7,-,-,72520
1986,1364,622,723,89200,72521
159,119,40,-,-,72522
361,318,43,518,81300,72523
169,90,79,-,310000,72524
58,53,5,-,106300,72526
290,255,35,-,134200,72527
166,118,48,-,162300,72528
2100,1839,261,770,86700,72529
687,599,88,-,154800,72530
296,281,15,-,151500,72531
442,399,43,583,101300,72532
102,79,23,933,155100,72533
626,626,0,-,63000,72534
152,137,15,-,72100,72536
324,265,59,781,110600,72537
275,275,0,-,-,72538
79,79,0,-,66100,72539
55,24,31,-,110000,72540
1527,1354,173,619,96500,72542
5440,3972,1468,843,174000,72543
422,340,82,944,163000,72544
18,18,0,-,-,72546
295,292,3,-,-,72550
26,16,10,-,133300,72553
1091,966,125,525,105300,72554
140,102,38,-,162500,72555
1387,908,479,634,133100,72556
3101,2130,971,513,165000,72560
232,199,33,350,124700,72561
884,602,282,575,93600,72562
125,110,15,525,85600,72564
333,299,34,633,86600,72565
195,187,8,533,57000,72566
87,73,14,620,58000,72567
470,345,125,-,127200,72568
196,196,0,-,-,72569
194,194,0,-,-,72571
140,84,56,-,158600,72572
108,108,0,-,-,72573
1417,948,469,638,95400,72576
327,182,145,519,117600,72577
75,75,0,-,336400,72578
579,411,168,809,-,72579
482,455,27,-,136800,72581
661,546,115,782,79400,72583
107,107,0,-,83800,72584
148,148,0,-,94100,72585
4,4,0,-,-,72587
12235,8316,3919,696,165400,72601
605,477,128,838,97900,72611
7,7,0,-,-,72615
4217,3147,1070,734,153500,72616
90,87,3,-,-,72617
803,609,194,595,155500,72619
230,224,6,-,175000,72623
117,110,7,-,145500,72624
683,524,159,563,168000,72626
328,282,46,-,131000,72628
169,161,8,-,-,72629
41,33,8,-,108800,72630
2014,1689,325,804,221300,72631
1983,1547,436,781,213100,72632
840,792,48,611,140000,72633
1922,1487,435,734,137900,72634
1466,1028,438,827,116600,72635
4,4,0,-,-,72636
2465,1718,747,696,152900,72638
244,178,66,-,98300,72639
183,183,0,-,159900,72640
946,631,315,664,173900,72641
1008,790,218,737,169000,72642
982,883,99,663,95000,72644
630,432,198,399,96900,72645
153,121,32,-,164700,72648
1565,1150,415,589,102800,72650
656,491,165,953,132300,72651
13169,9550,3619,824,158900,72653
187,148,39,-,108600,72655
646,513,133,661,153000,72658
264,233,31,875,133000,72660
364,364,0,-,120900,72661
1166,737,429,547,175800,72662
99,78,21,-,67800,72663
55,41,14,-,-,72666
153,153,0,-,56500,72668
53,50,3,-,-,72669
63,50,13,-,571400,72670
102,71,31,-,-,72672
615,452,163,713,125700,72675
255,204,51,813,150900,72677
40,28,12,-,-,72679
443,289,154,1078,154200,72680
118,118,0,-,95600,72682
148,51,97,-,167000,72683
487,393,94,569,151900,72685
55,55,0,-,111200,72686
2791,2257,534,831,153400,72687
17582,7379,10203,896,299600,72701
16171,6325,9846,907,295200,72703
12449,7803,4646,1121,273900,72704
14336,8568,5768,1100,352600,72712
9369,4912,4457,1205,334200,72713
5417,4762,655,1192,229600,72714
7265,6422,843,1068,235900,72715
471,337,134,774,170400,72717
1696,1619,77,2168,353600,72718
6312,4086,2226,1261,240900,72719
254,247,7,-,225600,72721
937,543,394,817,158500,72722
2471,2019,452,1102,177500,72727
91,91,0,-,338500,72729
3740,2988,752,1149,219500,72730
2049,1818,231,919,227000,72732
3195,2443,752,937,176400,72734
2396,1970,426,1017,250700,72736
760,684,76,738,146200,72738
194,107,87,1060,-,72739
3493,2725,768,652,154000,72740
263,263,0,-,-,72742
1848,1219,629,981,156100,72744
4763,3178,1585,1037,219500,72745
63,63,0,-,-,72747
56,25,31,-,-,72749
3202,2456,746,1314,227100,72751
107,73,34,-,114300,72752
3801,2719,1082,872,205800,72753
14965,9706,5259,854,215000,72756
16138,9749,6389,1219,312100,72758
122,112,10,-,113000,72760
7850,5143,2707,905,205600,72761
15426,10857,4569,1052,242400,72762
19570,9018,10552,880,203600,72764
488,315,173,662,207300,72768
451,332,119,838,-,72769
527,417,110,-,132000,72773
2510,2054,456,1076,179700,72774
350,325,25,-,165200,72776
6196,2874,3322,781,135400,72801
9036,7393,1643,860,180800,72802
775,532,243,674,98700,72821
2386,1743,643,862,118400,72823
711,477,234,690,119900,72824
2,2,0,-,-,72826
73,31,42,-,-,72827
63,3,60,-,-,72828
0,0,0,-,-,72829
6013,3765,2248,712,139800,72830
311,193,118,475,88300,72832
1300,768,532,621,119900,72833
3704,2607,1097,745,137700,72834
303,294,9,-,137800,72835
3289,2663,626,859,126900,72837
103,103,0,-,88000,72838
216,171,45,-,58500,72839
881,697,184,666,98500,72840
91,53,38,-,119600,72841
406,345,61,698,91800,72842
806,693,113,877,119600,72843
401,371,30,775,98300,72845
1448,1197,251,716,133600,72846
1186,1045,141,910,99300,72847
305,297,8,-,167500,72851
66,58,8,-,123400,72852
965,691,274,509,119200,72853
239,201,38,-,88000,72854
2530,1818,712,661,118400,72855
168,143,25,-,228100,72856
545,381,164,324,111200,72857
1118,969,149,869,162500,72858
38,28,10,-,183900,72860
631,567,64,625,127300,72863
493,426,67,821,136500,72865
8824,3965,4859,768,112500,72901
11088,5798,5290,759,214200,72903
7881,3884,3997,780,102500,72904
0,0,0,-,-,72905
5946,3588,2358,883,164500,72908
4404,2977,1427,1022,239700,72916
4560,3272,1288,813,170000,72921
2217,1740,477,892,125500,72923
248,182,66,892,216700,72926
3139,2032,1107,706,107600,72927
333,258,75,678,100000,72928
117,101,16,-,121400,72930
610,586,24,930,126800,72932
2013,1591,422,676,117200,72933
428,417,11,660,-,72934
219,156,63,517,161500,72935
5752,4466,1286,806,172200,72936
1353,1051,302,762,134600,72937
411,347,64,833,88800,72938
657,528,129,697,143600,72940
1848,1609,239,773,165500,72941
986,775,211,807,135400,72943
1090,855,235,730,93000,72944
174,80,94,948,62700,72945
1272,1134,138,1004,129700,72946
1421,1216,205,651,138500,72947
96,96,0,-,165000,72948
3701,2673,1028,693,116100,72949
268,187,81,-,93200,72950
328,276,52,664,92900,72951
968,961,7,-,134300,72952
191,157,34,-,-,72955
13251,9470,3781,793,155700,72956
2629,1945,684,691,91600,72958
1260,1147,113,746,180400,72959
20,11,9,-,-,73001
380,330,50,736,93800,73002
9182,5326,3856,1320,208300,73003
339,265,74,1109,149500,73004
2721,1826,895,652,89000,73005
1019,790,229,641,96200,73006
1001,900,101,959,496000,73007
7951,4229,3722,1028,152200,73008
361,280,81,667,126300,73009
6999,5923,1076,997,223900,73010
213,199,14,1063,73800,73011
15093,12233,2860,1730,282100,73012
21401,16512,4889,1456,269900,73013
451,377,74,1000,156700,73014
894,650,244,591,80600,73015
777,681,96,1234,244400,73016
479,379,100,614,79200,73017
7911,4683,3228,849,122600,73018
0,0,0,-,-,73019
9241,8115,1126,1253,233000,73020
144,110,34,674,154000,73021
0,0,0,-,-,73022
234,200,34,739,106300,73024
5409,5293,116,2722,410500,73025
4192,3920,272,1022,255000,73026
558,437,121,729,-,73027
1475,1157,318,860,137100,73028
469,372,97,723,120700,73029
1584,1053,531,755,138000,73030
19,14,5,-,-,73031
75,54,21,913,94300,73032
139,96,43,696,81300,73033
17001,12518,4483,1110,358400,73034
7058,4326,2732,858,150600,73036
592,503,89,719,96100,73038
596,397,199,820,100300,73040
143,113,30,621,-,73041
343,248,95,658,107100,73042
62,55,7,-,78800,73043
8810,7348,1462,850,178300,73044
3999,3254,745,962,197400,73045
1841,1266,575,820,151300,73047
896,701,195,741,151900,73048
2393,1970,423,796,202700,73049
92,38,54,507,-,73050
2719,2135,584,905,140700,73051
2381,1731,650,835,137700,73052
210,159,51,567,141300,73053
1710,1528,182,1023,201400,73054
3840,3135,705,777,143100,73055
261,212,49,-,62000,73056
964,779,185,785,130600,73057
95,95,0,-,181300,73058
1116,786,330,491,147100,73059
700,575,125,1024,188800,73061
545,453,92,299,83600,73062
324,298,26,550,162500,73063
9627,7732,1895,1184,221400,73064
3876,3171,705,915,221900,73065
69,43,26,-,-,73066
641,572,69,958,137300,73067
4695,3534,1161,999,170800,73068
11336,5257,6079,971,194400,73069
0,0,0,-,-,73070
17985,8581,9404,990,189800,73071
19392,10442,8950,1062,274500,73072
345,306,39,-,308800,73073
426,298,128,846,116900,73074
3581,2248,1333,792,120900,73075
2341,1807,534,729,120800,73077
4653,4388,265,1538,256200,73078
218,181,37,920,132800,73079
3590,2508,1082,880,191800,73080
1099,842,257,718,116600,73082
2603,1840,763,905,114300,73084
3090,2350,740,871,154900,73086
4826,4258,568,865,241600,73089
202,157,45,856,183000,73090
302,218,84,714,102000,73092
1337,1125,212,1136,246100,73093
766,598,168,907,142100,73095
5365,2976,2389,706,231100,73096
66,66,0,-,-,73097
1362,959,403,830,131000,73098
30334,22790,7544,1179,210600,73099
1198,99,1099,1244,288600,73102
3072,1019,2053,926,348100,73103
2072,352,1720,1427,326500,73104
3003,1124,1879,1066,140000,73105
4917,1799,3118,986,220800,73106
11062,6780,4282,968,134200,73107
5202,1898,3304,806,71000,73108
7164,3470,3694,786,84200,73109
14135,6218,7917,952,116900,73110
4846,2673,2173,883,87500,73111
15102,7779,7323,951,161700,73112
8187,3075,5112,1091,118400,73114
8289,4794,3495,979,103900,73115
4552,3270,1282,1077,283600,73116
2815,1138,1677,802,91400,73117
6790,3868,2922,1004,219400,73118
10470,4849,5621,890,86000,73119
17968,9361,8607,975,217500,73120
1324,1075,249,928,221200,73121
5231,3003,2228,926,147700,73122
9077,4033,5044,890,135600,73127
2625,1637,988,1296,182100,73128
6617,3224,3393,875,68500,73129
8443,6107,2336,1129,181700,73130
1400,1323,77,1988,289500,73131
11360,5993,5367,959,189300,73132
3634,671,2963,1177,137500,73134
8527,5127,3400,1095,153000,73135
7722,3272,4450,880,150700,73139
1027,783,244,833,117000,73141
7438,4217,3221,1143,317200,73142
595,8,587,1587,-,73145
1830,934,896,920,92100,73149
2022,1675,347,780,281000,73150
656,656,0,-,576900,73151
12568,6867,5701,1050,137000,73159
23674,15757,7917,1181,171100,73160
11727,8498,3229,1067,220700,73162
2667,2531,136,1016,287500,73165
916,731,185,1124,204400,73169
15860,12885,2975,1325,240200,73170
1383,1289,94,-,337500,73173
2589,2198,391,1541,202900,73179
14106,8894,5212,917,163700,73401
61,55,6,-,340200,73425
539,487,52,617,144700,73430
375,275,100,757,112800,73432
919,709,210,778,126600,73433
206,157,49,975,153300,73434
25,19,6,-,95000,73435
41,18,23,663,85000,73436
28,28,0,-,-,73437
1278,1057,221,814,61700,73438
2590,2129,461,811,136400,73439
74,70,4,-,166700,73440
59,54,5,463,95000,73441
128,120,8,-,112500,73442
1126,807,319,1016,154200,73443
65,65,0,-,138800,73444
3037,2213,824,722,145100,73446
417,314,103,782,94100,73447
2058,1381,677,777,148300,73448
1355,1024,331,874,131900,73449
518,442,76,1014,126800,73450
255,217,38,719,244500,73453
232,178,54,814,67500,73455
649,539,110,659,92600,73456
321,232,89,1052,150900,73458
582,315,267,971,153100,73459
1561,917,644,641,113300,73460
270,187,83,696,99600,73461
1502,1299,203,765,107900,73463
363,333,30,580,78300,73481
65,48,17,575,65000,73487
10,7,3,-,-,73488
295,221,74,888,98300,73491
7697,3434,4263,790,120800,73501
1746,0,1746,1246,-,73503
18614,9650,8964,871,139200,73505
8554,4945,3609,907,150200,73507
37,30,7,592,60000,73520
8216,4813,3403,868,117700,73521
0,0,0,-,-,73523
705,540,165,713,150000,73526
1826,1491,335,763,170500,73527
217,172,45,697,157500,73528
1721,1384,337,703,92800,73529
168,136,32,525,49500,73530
124,111,13,-,109800,73531
178,111,67,869,99300,73532
11048,7845,3203,842,129300,73533
210,194,16,814,49400,73537
2230,1734,496,1183,256400,73538
79,72,7,-,92000,73539
128,103,25,566,166500,73540
1523,1281,242,895,153200,73541
1531,1076,455,705,60000,73542
828,662,166,1036,102800,73543
115,104,11,-,64500,73544
472,313,159,735,55900,73546
477,383,94,653,113300,73547
160,149,11,-,75500,73548
126,106,20,933,223300,73549
795,577,218,732,85200,73550
15,15,0,-,49200,73551
485,435,50,860,129300,73552
4,3,1,-,-,73553
1313,878,435,630,94600,73554
57,47,10,-,35800,73555
40,24,16,644,104200,73556
116,99,17,1225,328100,73557
163,106,57,486,29600,73559
324,155,169,539,89700,73560
189,162,27,806,150900,73562
148,135,13,594,84500,73564
341,248,93,572,52300,73565
544,396,148,591,110500,73566
324,246,78,544,115600,73567
403,304,99,582,60300,73568
180,123,57,438,47500,73569
330,252,78,-,68300,73570
18,10,8,-,-,73571
1174,898,276,739,113300,73572
909,603,306,545,75800,73573
3678,2764,914,832,130900,73601
524,355,169,660,138700,73620
114,94,20,920,62600,73622
688,308,380,781,102600,73624
173,140,33,688,91300,73625
346,282,64,950,155900,73626
185,155,30,831,142000,73627
662,490,172,700,145200,73628
1078,826,252,696,102200,73632
63,63,0,-,237500,73638
281,198,83,742,100800,73639
222,165,57,586,66800,73641
60,38,22,-,56900,73642
5782,3850,1932,828,160300,73644
437,284,153,734,85700,73645
147,141,6,-,104700,73646
260,224,36,586,163400,73647
344,305,39,546,124000,73650
1501,1063,438,754,60300,73651
323,274,49,829,121900,73654
356,276,80,578,73900,73655
114,101,13,-,91000,73658
50,42,8,-,-,73659
171,126,45,-,113600,73660
179,159,20,1057,90800,73661
1689,1135,554,730,125100,73662
406,333,73,922,167300,73663
520,403,117,705,94000,73664
180,123,57,-,155400,73666
180,131,49,750,128700,73667
11,11,0,-,-,73668
536,415,121,645,144200,73669
230,172,58,-,-,73673
8988,5025,3963,743,96200,73701
11888,8154,3734,970,175400,73703
0,0,0,-,-,73705
219,191,28,509,97900,73716
2591,1634,957,790,142000,73717
225,208,17,-,127400,73718
42,32,10,-,212500,73719
74,74,0,-,75600,73720
99,73,26,513,178100,73722
307,261,46,758,64100,73724
150,114,36,850,55700,73726
47,47,0,-,206800,73727
768,593,175,833,126000,73728
237,217,20,860,103900,73729
301,268,33,957,191700,73730
80,70,10,-,90000,73731
68,55,13,-,104500,73733
305,237,68,800,158000,73734
295,276,19,795,126400,73735
231,216,15,-,267500,73736
1517,1194,323,625,123100,73737
382,325,57,950,99700,73738
185,172,13,613,105100,73739
168,130,38,577,74200,73741
1342,1022,320,850,151500,73742
31,24,7,-,108300,73743
76,54,22,-,108300,73744
5,0,5,-,-,73746
104,66,38,-,-,73747
233,194,39,757,74100,73749
2520,1763,757,876,205200,73750
216,191,25,1330,134800,73753
426,338,88,706,129500,73754
304,278,26,-,115100,73755
124,92,32,961,141700,73756
62,46,16,-,66600,73757
99,88,11,-,-,73758
495,398,97,790,59800,73759
167,149,18,541,131900,73760
113,104,9,-,98600,73761
716,575,141,980,213100,73762
646,394,252,979,113900,73763
129,104,25,686,162700,73764
409,292,117,869,103000,73766
607,518,89,816,131500,73768
10,10,0,-,-,73770
138,110,28,560,58900,73771
1211,780,431,838,156900,73772
758,542,216,946,129700,73773
6380,4313,2067,831,158100,73801
455,412,43,538,105600,73832
588,508,80,723,91100,73834
109,79,30,633,132500,73835
221,198,23,563,145700,73838
172,144,28,1014,93900,73840
164,123,41,688,95300,73841
218,202,16,900,206400,73842
286,222,64,770,100000,73843
128,111,17,-,86800,73844
605,459,146,784,120200,73848
59,55,4,-,210200,73851
751,638,113,993,171700,73852
192,156,36,1117,192100,73853
66,45,21,-,185200,73855
352,323,29,994,172800,73857
525,396,129,738,135900,73858
526,375,151,855,148600,73859
495,408,87,775,156300,73860
62,47,15,-,-,73901
233,170,63,942,88100,73931
688,524,164,829,115100,73932
458,356,102,619,65500,73933
70,60,10,-,110400,73937
214,187,27,983,79800,73938
366,201,165,727,108800,73939
4463,2875,1588,904,159700,73942
150,113,37,575,48200,73944
919,690,229,857,133000,73945
5,2,3,-,-,73946
209,177,32,545,94500,73947
477,371,106,482,137000,73949
396,337,59,892,119900,73950
408,357,51,775,58500,73951
7,7,0,-,-,73960
109,98,11,638,75000,74001
634,482,152,688,102100,74002
5383,3295,2088,869,95200,74003
10806,8287,2519,917,170500,74006
11181,8518,2663,1203,283900,74008
3975,2719,1256,691,141100,74010
12069,9509,2560,1290,224300,74011
24169,16252,7917,1139,206000,74012
14512,12667,1845,1350,225400,74014
3288,2206,1082,951,195000,74015
2203,1569,634,762,110900,74016
10816,7395,3421,994,170000,74017
7642,6329,1313,909,213500,74019
2919,2173,746,853,120500,74020
7790,6404,1386,1105,204900,74021
799,723,76,591,116100,74022
4671,2909,1762,740,126800,74023
280,209,71,861,88300,74026
316,261,55,633,90900,74027
615,512,103,718,157400,74028
1951,1349,602,799,143600,74029
1340,957,383,489,76700,74030
777,637,140,736,134600,74032
4512,3224,1288,1204,175700,74033
46,44,2,-,50000,74034
1309,970,339,639,83800,74035
2603,2153,450,910,186300,74036
8065,6281,1784,1402,250900,74037
822,711,111,850,148700,74038
1479,1091,388,938,149200,74039
948,800,148,1108,190500,74041
139,108,31,725,80000,74042
2955,2330,625,868,167200,74044
101,85,16,1063,235400,74045
53,18,35,-,-,74046
2505,2136,369,758,177400,74047
2211,1469,742,728,111100,74048
158,103,55,564,49400,74050
727,614,113,881,154700,74051
410,269,141,622,64200,74052
1845,1475,370,925,192300,74053
282,207,75,475,67400,74054
17924,12783,5141,1169,243700,74055
2018,1433,585,617,109500,74056
1378,1005,373,763,105100,74058
2360,1768,592,856,169500,74059
157,115,42,600,75400,74060
828,683,145,883,217300,74061
326,231,95,641,133500,74062
11895,9505,2390,964,171100,74063
12208,9268,2940,979,157500,74066
24,24,0,-,-,74068
5455,4021,1434,889,192000,74070
93,30,63,633,92000,74071
638,513,125,838,149400,74072
1901,1647,254,985,201600,74073
12586,6009,6577,961,231300,74074
10555,4485,6070,898,196900,74075
0,0,0,-,-,74077
0,0,0,-,-,74078
1767,1346,421,701,145800,74079
1023,874,149,824,206700,74080
637,589,48,1250,105200,74081
105,26,79,1088,82500,74082
392,335,57,964,160900,74083
207,168,39,723,41700,74084
1010,766,244,823,131900,74085
473,4,469,1404,-,74103
5412,2563,2849,1099,210100,74104
12798,6944,5854,927,294900,74105
6950,3266,3684,775,87800,74106
7937,4188,3749,897,116600,74107
2889,1958,931,1004,115100,74108
4902,2519,2383,874,60500,74110
9355,5233,4122,996,136800,74112
7442,5798,1644,1264,257500,74114
8234,4516,3718,957,69000,74115
1308,585,723,779,118000,74116
12,12,0,-,-,74117
2284,568,1716,1057,210500,74119
2805,950,1855,1003,367100,74120
3739,2277,1462,968,60200,74126
6414,3717,2697,924,114600,74127
4412,2635,1777,1028,103300,74128
7111,3539,3572,870,134100,74129
707,493,214,1058,77400,74130
932,737,195,1043,186800,74131
4197,2352,1845,1095,239000,74132
20948,10761,10187,1066,239300,74133
8080,5277,2803,952,193900,74134
9455,4904,4551,906,219200,74135
14599,5374,9225,878,275500,74136
11680,7916,3764,1081,365000,74137
7565,4354,3211,998,150800,74145
5585,1940,3645,795,124700,74146
0,0,0,-,-,74171
3950,2658,1292,808,117500,74301
1086,910,176,793,160500,74330
3281,2509,772,878,157800,74331
645,504,141,795,168400,74332
363,305,58,644,128300,74333
1776,1455,321,723,120200,74337
1764,1298,466,694,111700,74338
843,567,276,660,66400,74339
84,66,18,685,142900,74340
840,691,149,983,119000,74342
1285,913,372,732,116800,74343
6415,4644,1771,882,191700,74344
2809,1953,856,700,116900,74346
1144,990,154,764,92500,74347
349,260,89,858,237500,74349
309,227,82,723,119600,74350
2151,1578,573,706,123000,74352
6521,4161,2360,787,116900,74354
83,61,22,888,55000,74358
69,51,18,850,59600,74359
8,8,0,-,-,74360
6474,4444,2030,873,172500,74361
1051,797,254,751,112000,74363
711,611,100,-,144800,74364
1612,1186,426,704,120100,74365
602,517,85,812,102000,74366
226,213,13,-,82000,74367
29,13,16,742,-,74368
666,495,171,755,133700,74369
1477,1103,374,582,120400,74370
6428,3718,2710,804,110400,74401
11380,7276,4104,803,136400,74403
1593,1305,288,930,157900,74421
412,356,56,1094,127700,74422
335,273,62,658,99600,74423
405,300,105,731,106500,74425
3469,2666,803,693,106500,74426
684,631,53,745,123000,74427
280,249,31,763,98200,74428
5665,4382,1283,852,199500,74429
299,246,53,636,114900,74430
335,269,66,756,83200,74431
4046,3225,821,718,152600,74432
3712,2996,716,757,165700,74434
1168,915,253,823,123000,74435
2000,1636,364,857,145900,74436
3630,2559,1071,762,89700,74437
127,100,27,681,97500,74438
2011,1607,404,853,143000,74441
266,228,38,1075,148100,74442
1038,700,338,783,155700,74445
182,144,38,750,77600,74446
5910,3629,2281,742,95700,74447
623,541,82,714,89500,74450
1675,1401,274,979,134400,74451
123,101,22,378,186800,74452
1305,1052,253,562,169300,74454
1119,919,200,678,109800,74455
43,38,5,-,87500,74456
118,112,6,-,168300,74457
38,34,4,-,78000,74458
40,37,3,-,85000,74459
196,172,24,500,-,74460
2831,2059,772,749,132600,74462
61,36,25,825,-,74463
11579,6579,5000,766,146600,74464
5688,3839,1849,829,141700,74467
125,113,12,833,62900,74468
703,463,240,693,98000,74469
676,506,170,-,136600,74470
514,422,92,621,112500,74471
253,194,59,750,108800,74472
9,0,9,-,-,74477
11165,7746,3419,848,147300,74501
22,17,5,725,46900,74521
86,86,0,-,191700,74522
2203,1617,586,571,98900,74523
3372,2447,925,648,132600,74525
41,38,3,-,60000,74528
87,72,15,-,72000,74530
311,231,80,642,86300,74531
330,278,52,754,113000,74533
71,57,14,-,176400,74534
36,36,0,-,64000,74535
628,431,197,361,104300,74536
1520,1018,502,673,89600,74538
67,60,7,-,104500,74540
172,154,18,-,180500,74543
242,154,88,793,84800,74546
1205,894,311,614,101500,74547
40,23,17,-,148200,74549
383,306,77,661,121700,74552
528,414,114,658,115300,74553
811,456,355,786,95700,74554
220,182,38,740,115600,74555
128,113,15,663,152700,74556
249,224,25,729,121600,74557
148,122,26,575,91100,74558
184,148,36,642,95000,74560
736,568,168,617,84700,74561
248,187,61,475,94700,74562
789,629,160,733,107000,74563
160,119,41,750,103400,74565
32,26,6,-,52500,74567
206,172,34,732,85800,74569
448,392,56,850,130200,74570
1413,933,480,499,103400,74571
290,238,52,817,86100,74572
511,425,86,584,108200,74574
94,88,6,-,274400,74576
123,93,30,531,33000,74577
2200,1454,746,746,91200,74578
7087,4149,2938,796,89600,74601
4741,3715,1026,763,178700,74604
219,173,46,618,104300,74630
2582,1751,831,829,84800,74631
273,234,39,-,-,74632
148,119,29,694,107200,74633
87,60,27,817,125000,74636
636,540,96,569,56200,74637
104,97,7,-,85400,74640
239,218,21,575,133800,74641
171,125,46,945,66300,74643
192,163,29,544,80300,74644
94,94,0,-,-,74646
1158,882,276,702,104800,74647
186,169,17,725,90400,74650
369,282,87,495,259100,74651
403,351,52,700,75000,74652
1453,1037,416,680,77700,74653
9855,5564,4291,884,175200,74701
159,115,44,825,78500,74720
0,0,0,-,-,74721
72,51,21,517,114100,74722
538,425,113,763,108200,74723
43,37,6,-,105400,74724
807,630,177,700,112500,74726
873,563,310,680,94300,74727
3937,2890,1047,689,132100,74728
996,816,180,805,118400,74729
2097,1295,802,925,156100,74730
532,459,73,926,150200,74731
1220,857,363,794,101700,74733
341,273,68,575,116800,74734
699,555,144,788,139400,74735
315,259,56,615,135100,74736
15,15,0,-,107500,74737
170,139,31,500,82500,74738
758,571,187,631,75000,74740
366,280,86,750,96700,74741
3342,1990,1352,650,117100,74743
3646,2270,1376,682,103900,74745
169,107,62,706,102200,74747
238,202,36,591,84700,74748
75,67,8,775,50700,74750
16,0,16,-,-,74753
177,140,37,-,33600,74754
40,32,8,-,-,74755
254,216,38,750,150000,74756
494,417,77,650,106200,74759
46,17,29,656,-,74760
19,16,3,-,106300,74761
1186,938,248,694,120900,74764
409,331,78,670,69000,74766
8372,4919,3453,822,116900,74801
7859,5485,2374,906,187100,74804
12163,7619,4544,851,156000,74820
467,414,53,775,128400,74824
690,515,175,901,103700,74825
527,433,94,780,135300,74826
111,86,25,675,185900,74827
189,164,25,607,92100,74829
63,54,9,713,33900,74830
240,176,64,736,118300,74831
307,252,55,839,101300,74832
180,145,35,747,113600,74833
2987,2361,626,747,162600,74834
127,104,23,-,175600,74836
69,59,10,725,65800,74837
224,179,45,750,74200,74839
705,610,95,888,150900,74840
95,72,23,-,150000,74842
85,76,9,788,278900,74843
125,76,49,838,86700,74844
121,102,19,625,70000,74845
2054,1475,579,600,87300,74848
1154,794,360,672,102100,74849
103,87,16,1125,101600,74850
3643,2985,658,681,149800,74851
551,487,64,743,128100,74852
631,509,122,525,74500,74854
1560,1109,451,914,135900,74855
269,225,44,860,110200,74856
3938,3572,366,1229,155600,74857
2332,1523,809,678,103000,74859
584,506,78,683,125700,74860
1730,1420,310,768,156000,74864
701,620,81,892,119700,74865
27,25,2,-,65000,74866
233,173,60,770,68200,74867
4393,2983,1410,698,91400,74868
295,254,41,620,103300,74869
1000,838,162,663,143900,74871
1230,871,359,626,152400,74872
3939,2877,1062,814,119900,74873
338,286,52,713,122600,74875
694,627,67,772,140300,74878
731,581,150,584,78700,74880
2054,1722,332,676,132400,74881
820,586,234,524,79200,74883
2014,1311,703,782,83900,74884
733,438,295,689,58400,74901
1707,1171,536,759,110100,74902
717,576,141,677,94900,74930
436,364,72,669,100700,74931
870,676,194,777,150800,74932
57,38,19,825,86700,74935
512,378,134,780,110100,74936
1837,1317,520,760,81700,74937
212,169,43,756,87400,74939
808,608,200,682,96000,74940
899,688,211,626,94600,74941
54,40,14,475,65000,74942
37,31,6,-,85000,74943
436,353,83,592,70800,74944
58,50,8,800,60000,74945
23,12,11,775,-,74946
34,24,10,706,-,74947
4488,3444,1044,742,113400,74948
129,97,32,1047,94800,74949
574,347,227,815,118600,74951
4329,2880,1449,794,158300,74953
1705,1100,605,788,135500,74954
5410,3621,1789,818,117700,74955
794,577,217,773,122400,74956
373,332,41,558,105500,74957
2377,1681,696,794,95700,74959
4088,2755,1333,625,110100,74960
1745,1331,414,667,121700,74962
222,191,31,-,95900,74963
839,670,169,846,105600,74964
1805,1147,658,561,108000,74965
1246,1008,238,646,109900,74966
9355,1449,7906,1620,414900,75001
22731,17980,4751,1827,372100,75002
18491,9564,8927,1453,278300,75006
20170,13807,6363,1479,332900,75007
8507,7692,815,1806,434500,75009
12616,6157,6459,1685,390300,75010
16562,10797,5765,1681,487700,75013
16923,11058,5865,1698,488900,75019
9509,5791,3718,1055,165400,75020
3373,2740,633,758,178600,75021
9029,7695,1334,1918,574200,75022
18408,11513,6895,1789,359600,75023
17915,6921,10994,1748,519000,75024
18492,12338,6154,1856,438600,75025
17404,14125,3279,2081,427900,75028
12283,9944,2339,1871,439200,75032
15042,11008,4034,1942,514500,75033
20853,8526,12327,1613,639900,75034
26920,20411,6509,2064,500500,75035
11343,9697,1646,2134,460300,75036
13716,2821,10895,1373,349800,75038
11306,1725,9581,1765,574100,75039
20062,13777,6285,1494,221800,75040
9728,5736,3992,1266,193700,75041
11471,6735,4736,1239,200600,75042
22026,13158,8868,1399,236300,75043
16357,10068,6289,1625,282000,75044
9725,8584,1141,1677,328700,75048
16155,6985,9170,1334,195300,75050
13290,6214,7076,1144,172200,75051
30996,20659,10337,1611,252000,75052
4941,4573,368,1738,408700,75054
26243,15664,10579,1679,386400,75056
6583,2531,4052,1483,194900,75057
1167,971,196,1403,453400,75058
14516,9310,5206,1320,203700,75060
18697,7391,11306,1196,202900,75061
17665,7248,10417,1306,234600,75062
17497,6529,10968,1562,458900,75063
4646,3444,1202,1594,269200,75065
27074,10037,17037,1425,292600,75067
21699,17812,3887,2062,358500,75068
15279,8057,7222,1438,379100,75069
21648,11777,9871,1712,392000,75070
21977,16691,5286,1946,415600,75071
17785,14576,3209,2218,429600,75072
17979,9525,8454,1544,322100,75074
14600,8715,5885,1561,366500,75075
3407,2698,709,1378,222500,75076
13801,11175,2626,1681,398100,75077
11942,10721,1221,2089,582500,75078
19011,10102,8909,1708,386600,75080
14005,7132,6873,1646,323700,75081
12184,6109,6075,1813,449900,75082
14195,11701,2494,1556,373500,75087
9676,7556,2120,1899,291100,75088
11364,9051,2313,1724,313100,75089
8618,5420,3198,992,139300,75090
11598,6401,5197,1143,231600,75092
19475,11464,8011,1698,588600,75093
6384,5814,570,2454,451700,75094
20779,16362,4417,1844,328200,75098
216,117,99,1105,88600,75101
581,489,92,1046,123400,75102
6205,4981,1224,1074,208800,75103
16240,11470,4770,1677,247100,75104
47,44,3,-,-,75105
1593,1379,214,1295,151800,75109
10541,6252,4289,976,151400,75110
2281,2014,267,1471,236900,75114
20429,14338,6091,1414,258200,75115
6907,4203,2704,1339,192300,75116
1510,1206,304,1094,184100,75117
10230,7133,3097,1168,213800,75119
1883,1615,268,863,157200,75124
2162,1655,507,1098,157400,75125
21282,17095,4187,1786,301500,75126
745,616,129,691,194300,75127
0,0,0,-,-,75132
6849,5128,1721,1483,189400,75134
2683,2261,422,1250,303400,75135
6742,4582,2160,1727,238800,75137
2894,2297,597,859,117300,75140
1327,622,705,1440,-,75141
6996,5282,1714,1121,171400,75142
5475,4517,958,1085,146500,75143
1304,995,309,805,150800,75144
8493,4966,3527,1502,216300,75146
2828,1957,871,989,205300,75147
2550,1877,673,857,152600,75148
19826,12921,6905,1314,184800,75149
22931,11467,11464,1322,206800,75150
1914,1519,395,1461,156900,75152
165,102,63,1281,136300,75153
15535,13199,2336,1362,267700,75154
960,784,176,960,112500,75155
6764,5027,1737,928,191600,75156
92,66,26,914,82000,75157
1869,1649,220,1095,268200,75158
6469,5151,1318,1219,204000,75159
8719,5956,2763,1155,186600,75160
2388,1915,473,910,198700,75161
1204,986,218,731,185600,75163
175,158,17,1313,202100,75164
17069,11123,5946,1371,274300,75165
1887,1681,206,1737,331700,75166
4176,3768,408,1862,355300,75167
5900,4492,1408,929,159000,75169
1766,1143,623,1199,87100,75172
2664,2521,143,1297,285300,75173
8112,4980,3132,1166,183800,75180
7951,7119,832,1463,256900,75181
2624,2218,406,999,496500,75182
12919,11621,1298,1732,314300,75189
11514,1314,10200,1923,649900,75201
1578,437,1141,2002,297600,75202
6204,2221,3983,1070,116500,75203
19316,3947,15369,1736,435100,75204
9226,5506,3720,2203,1412600,75205
21567,6126,15441,1610,514900,75206
2335,24,2311,1807,-,75207
12159,6733,5426,1408,382400,75208
6753,4183,2570,1715,762100,75209
2849,832,2017,910,90900,75210
22587,12031,10556,1129,168000,75211
8401,4574,3827,1022,163300,75212
15398,8666,6732,1453,649700,75214
7356,2256,5100,1111,100900,75215
18776,10279,8497,1079,106800,75216
23868,13936,9932,1114,141000,75217
9540,6196,3344,1499,447100,75218
16456,5153,11303,1672,383500,75219
14128,4338,9790,1085,400500,75220
4478,2165,2313,1286,223500,75223
11701,6110,5591,1113,190000,75224
8944,6849,2095,2156,1396500,75225
2631,160,2471,1590,-,75226
18746,10684,8062,1183,170100,75227
24158,11659,12499,1144,230900,75228
11442,7954,3488,1424,540900,75229
13069,7980,5089,1291,792100,75230
17702,3001,14701,1141,445300,75231
11294,7643,3651,1212,188800,75232
4809,2587,2222,1197,230600,75233
12179,7066,5113,1623,281300,75234
8904,1892,7012,1526,244500,75235
6747,2265,4482,1182,194600,75236
7959,1017,6942,1141,173900,75237
13108,6550,6558,1194,478000,75238
10496,2485,8011,1247,314400,75240
10554,6853,3701,1152,145000,75241
27520,7163,20357,1162,341100,75243
5726,2939,2787,1749,527800,75244
1254,197,1057,980,445600,75246
341,0,341,1233,-,75247
16721,8915,7806,1523,505700,75248
5226,3761,1465,1788,239400,75249
2262,0,2262,1660,-,75251
12617,5762,6855,1240,484000,75252
6699,4536,2163,1330,113900,75253
11663,2568,9095,1398,286400,75254
0,0,0,-,-,75261
0,0,0,-,-,75270
26763,6202,20561,1286,379600,75287
0,0,0,-,-,75390
7883,4146,3737,1106,133700,75401
7406,4770,2636,1325,219900,75402
8574,6764,1810,1630,270000,75407
7456,6007,1449,1881,275700,75409
2004,1786,218,900,174200,75410
358,142,216,774,206800,75411
216,163,53,-,100500,75412
71,52,19,-,66700,75413
1256,970,286,848,212800,75414
127,119,8,-,-,75415
1182,984,198,855,139000,75416
948,689,259,1193,120100,75417
4867,3422,1445,1012,176600,75418
573,491,82,826,130400,75420
249,233,16,850,121000,75421
1134,888,246,1115,177800,75422
1091,884,207,886,140300,75423
1204,1058,146,1550,271300,75424
1665,1162,503,617,72000,75426
3812,1950,1862,920,127500,75428
0,0,0,-,-,75429
583,389,194,811,124600,75431
1164,835,329,881,156500,75432
1178,934,244,944,148400,75433
0,0,0,-,-,75434
473,335,138,583,94100,75435
820,660,160,604,211200,75436
422,393,29,993,186800,75437
383,261,122,1191,179200,75438
416,242,174,1050,128100,75439
2749,2232,517,966,201100,75440
79,73,6,-,-,75441
3902,3290,612,1271,309500,75442
1389,1034,355,675,197400,75446
463,434,29,-,216100,75447
277,246,31,-,157700,75448
406,258,148,-,118100,75449
255,229,26,-,212900,75450
567,524,43,-,139300,75451
1596,1183,413,1019,229900,75452
1119,1011,108,1127,167700,75453
5421,4895,526,2250,368200,75454
9327,5869,3458,814,148800,75455
1984,1410,574,929,212200,75457
1766,1129,637,1073,197900,75459
10066,5195,4871,849,111400,75460
4298,3380,918,888,211000,75462
379,322,57,-,177100,75468
141,126,15,765,209800,75469
92,61,31,-,-,75470
585,378,207,1089,134800,75471
1485,1173,312,845,158800,75472
1429,1316,113,850,186800,75473
6209,5099,1110,1025,155000,75474
19,19,0,-,-,75475
554,501,53,-,213500,75476
441,333,108,746,-,75477
319,261,58,864,119500,75478
706,543,163,964,154800,75479
750,744,6,-,309600,75480
154,141,13,-,141800,75481
9667,6402,3265,955,184700,75482
1033,998,35,1563,204500,75486
499,417,82,701,115300,75487
331,296,35,938,231400,75488
356,233,123,1152,209700,75489
1001,839,162,1356,242400,75490
1903,1558,345,913,218800,75491
129,107,22,-,161900,75492
151,105,46,733,49400,75493
3975,3209,766,950,163800,75494
3238,2600,638,1366,326400,75495
1224,969,255,943,170000,75496
1648,1395,253,860,183700,75497
13063,7482,5581,812,122000,75501
10481,6363,4118,1088,209300,75503
240,215,25,588,90800,75550
4224,3269,955,933,156900,75551
979,820,159,767,149100,75554
723,624,99,687,93400,75555
422,318,104,1049,83100,75556
669,669,0,-,99900,75558
2277,1632,645,672,116900,75559
393,342,51,1143,52900,75560
1879,1407,472,848,113500,75561
43,43,0,-,-,75562
1684,1239,445,642,103300,75563
12,12,0,-,-,75564
36,7,29,-,178100,75565
245,242,3,-,97000,75566
1594,1212,382,742,142500,75567
1144,791,353,787,114100,75568
1181,663,518,887,152600,75569
3222,2236,986,755,120500,75570
1033,924,109,779,110100,75571
1342,1002,340,766,72400,75572
75,18,57,950,"10,000-",75573
528,487,41,-,65000,75574
5646,3504,2142,891,177800,75601
7304,4794,2510,857,106300,75602
2585,2190,395,793,162200,75603
11983,6797,5186,1000,173600,75604
14740,8194,6546,1146,229600,75605
1090,918,172,851,98800,75630
867,697,170,869,126500,75631
4852,3728,1124,765,146800,75633
1998,1546,452,738,99700,75638
824,755,69,-,126800,75639
2008,1618,390,1013,256800,75640
42,28,14,-,170000,75641
36,36,0,-,-,75642
870,732,138,815,155100,75643
4468,3298,1170,874,161500,75644
4027,3427,600,1050,183100,75645
4876,3393,1483,923,149500,75647
3501,2354,1147,1030,169700,75650
825,675,150,973,149300,75651
3791,2703,1088,961,182500,75652
4696,3651,1045,922,150700,75654
1766,1330,436,778,117500,75656
2948,2193,755,859,106000,75657
16,10,6,-,-,75658
0,0,0,-,-,75659
996,850,146,-,97200,75661
8416,6702,1714,944,156100,75662
459,388,71,969,89700,75667
980,596,384,850,128400,75668
227,227,0,-,135900,75669
6168,3445,2723,818,87600,75670
0,0,0,-,-,75671
6072,4734,1338,948,169500,75672
0,0,0,-,-,75680
1073,951,122,1017,152100,75681
264,254,10,1125,171200,75682
1435,1208,227,1076,100400,75683
2235,1820,415,893,130800,75684
4705,3751,954,755,146100,75686
0,0,0,-,-,75687
53,47,6,-,-,75689
1662,1242,420,954,149700,75691
1855,1719,136,1167,148700,75692
2153,1476,677,1104,191800,75693
0,0,0,-,-,75694
12102,7164,4938,1137,178900,75701
8096,4215,3881,836,95900,75702
17142,9492,7650,1176,287600,75703
3152,2612,540,1150,158000,75704
645,444,201,1672,164100,75705
3162,2604,558,887,107800,75706
5799,4515,1284,1356,222300,75707
2868,2265,603,820,133000,75708
2176,1393,783,1209,186100,75709
0,0,0,-,-,75711
1254,953,301,1057,135700,75750
6275,3854,2421,1031,163400,75751
2756,2403,353,991,168600,75752
2611,2218,393,939,227000,75754
1824,1207,617,1001,106100,75755
1565,1190,375,1024,177200,75756
4837,3982,855,1194,238200,75757
3615,3017,598,940,129500,75758
49,43,6,-,93700,75759
1069,884,185,981,144200,75760
5268,4349,919,1204,248800,75762
2402,2082,320,1120,151600,75763
59,35,24,440,96800,75764
3119,2651,468,944,159600,75765
9558,6659,2899,840,135100,75766
1026,869,157,1053,226700,75770
7558,6292,1266,1277,239800,75771
5438,3810,1628,851,181700,75773
1137,782,355,1030,142900,75778
11,11,0,-,-,75779
128,108,20,940,-,75780
34,31,3,-,-,75782
3206,2758,448,995,159300,75783
248,228,20,880,119300,75784
3303,2509,794,854,137100,75785
43,43,0,-,-,75788
2889,2317,572,1002,180300,75789
1358,989,369,1008,166000,75790
5049,3697,1352,1482,206900,75791
1136,889,247,1078,115200,75792
6303,3636,2667,972,146100,75801
5807,4267,1540,949,166400,75803
2080,1465,615,922,95400,75831
1064,882,182,967,169900,75833
4450,2897,1553,739,134400,75835
126,79,47,-,147900,75838
2010,1498,512,1069,126400,75839
2510,1674,836,831,187800,75840
1874,1401,473,840,122800,75844
1003,843,160,605,85200,75845
1095,882,213,912,205400,75846
553,408,145,1102,113500,75847
30,16,14,639,95000,75848
53,35,18,900,87500,75849
472,417,55,-,159100,75850
774,669,105,889,150200,75851
473,406,67,973,168100,75852
427,367,60,-,219600,75853
1172,982,190,780,171000,75855
85,35,50,-,-,75856
30,30,0,-,-,75858
1099,883,216,1396,169000,75859
1557,1337,220,659,118300,75860
694,493,201,847,208000,75861
4336,3205,1131,783,111800,75862
0,0,0,-,-,75865
0,0,0,-,-,75884
0,0,0,-,-,75886
10040,6519,3521,1022,151000,75901
85,0,85,-,-,75903
13028,7625,5403,994,159700,75904
1312,780,532,773,99700,75925
541,455,86,721,110600,75926
431,364,67,-,62100,75928
511,428,83,491,165400,75929
740,641,99,967,80100,75930
959,795,164,686,170000,75931
569,512,57,-,69800,75932
518,451,67,-,60300,75933
45,45,0,-,-,75934
4575,3420,1155,907,103500,75935
326,287,39,668,165800,75936
465,394,71,653,75000,75937
966,820,146,697,98200,75938
1701,1160,541,693,108900,75939
2574,1972,602,608,93400,75941
42,0,42,-,-,75942
520,447,73,1188,188300,75943
444,421,23,-,70300,75944
1598,1193,405,1019,144400,75946
2598,2175,423,773,184300,75948
3352,2265,1087,855,102300,75949
5899,4416,1483,840,118800,75951
1127,817,310,738,86700,75954
2996,2460,536,781,117500,75956
336,309,27,-,115600,75959
259,259,0,-,111200,75960
6369,3107,3262,916,134800,75961
0,0,0,-,-,75962
7337,4757,2580,846,103100,75964
7563,3842,3721,853,207100,75965
1647,1123,524,888,104600,75966
843,662,181,571,93500,75968
1597,1222,375,1079,142000,75969
2425,1740,685,700,70700,75972
1150,984,166,975,107700,75973
939,633,306,666,102000,75974
1363,1025,338,721,135300,75975
369,253,116,725,65300,75976
214,166,48,942,-,75977
3542,2620,922,937,111300,75979
1032,896,136,825,84200,75980
11522,8963,2559,1743,292500,76001
9606,8028,1578,2009,279900,76002
1596,1472,124,2685,434000,76005
12094,2905,9189,1264,291100,76006
7536,6928,608,2122,417800,76008
6474,4931,1543,1183,169600,76009
18520,6004,12516,1151,172800,76010
10211,2023,8188,1199,201600,76011
10722,6705,4017,1222,281000,76012
13274,6637,6637,1222,268600,76013
10687,5097,5590,1401,195500,76014
6358,2960,3398,1443,214600,76015
10903,9019,1884,1749,285000,76016
15895,10692,5203,1431,253000,76017
8268,6371,1897,1744,217600,76018
12132,9741,2391,1114,235000,76020
14761,7970,6791,1307,322300,76021
5709,2974,2735,1429,232800,76022
2491,2170,321,1048,261000,76023
26150,19785,6365,1558,272900,76028
5858,4574,1284,1157,177200,76031
10340,6538,3802,1209,201400,76033
9225,8847,378,2785,673900,76034
959,744,215,1407,354500,76035
9920,7382,2538,1526,259300,76036
17107,6281,10826,1622,286200,76039
11654,4821,6833,1129,263400,76040
267,267,0,-,154400,76041
2619,2023,596,853,249000,76043
2594,2333,261,1190,336900,76044
11084,7960,3124,1165,206200,76048
11875,10524,1351,1432,291700,76049
2624,2065,559,1148,207100,76050
21224,11190,10034,1750,429200,76051
8811,7795,1016,1837,367000,76052
11655,6161,5494,1245,226100,76053
4660,3860,800,1490,337700,76054
1245,1031,214,859,162200,76055
7083,5174,1909,1206,184500,76058
1697,675,1022,953,184500,76059
2829,2092,737,1181,333500,76060
29,29,0,-,-,76061
25817,19506,6311,1619,350900,76063
701,444,257,1537,241900,76064
14017,11800,2217,1522,343200,76065
1496,1198,298,584,235100,76066
7188,4754,2434,987,134200,76067
287,287,0,-,103400,76070
1442,1157,285,1132,244200,76071
2444,2080,364,1119,290300,76073
160,160,0,-,218500,76077
3143,2590,553,1440,242800,76078
7651,6435,1216,1134,234300,76082
3431,3150,281,1605,223100,76084
3834,3306,528,1646,320900,76085
8423,4484,3939,1310,204000,76086
11666,10403,1263,1515,327000,76087
5215,4332,883,1276,339900,76088
9431,8966,465,2518,856100,76092
1269,983,286,1133,106300,76093
4303,1023,3280,1579,325200,76102
5500,3462,2038,1062,167800,76103
7386,2903,4483,1253,123900,76104
6865,3567,3298,1070,104800,76105
10814,5264,5550,1123,132800,76106
15194,6982,8212,1395,385100,76107
16385,11526,4859,1362,216000,76108
9878,5133,4745,1582,600300,76109
11276,7005,4271,1201,219400,76110
7673,4270,3403,1162,166500,76111
17111,8437,8674,1132,188700,76112
9635,5287,4348,1153,175300,76114
6074,2805,3269,1103,116800,76115
22150,7345,14805,1143,280700,76116
11679,6075,5604,1133,167800,76117
5849,4097,1752,1370,256000,76118
14805,7976,6829,1151,116300,76119
7807,3740,4067,1294,257500,76120
12777,9949,2828,2028,245900,76123
9159,7570,1589,1544,319700,76126
44,0,44,1794,-,76127
0,0,0,-,-,76129
16817,12732,4085,1649,284100,76131
12405,3975,8430,1271,363400,76132
19147,11578,7569,1348,203900,76133
9983,6185,3798,1289,188800,76134
7724,5010,2714,1156,216900,76135
21937,13004,8933,1519,256400,76137
10064,6704,3360,1393,179800,76140
8071,6423,1648,1758,201400,76148
3457,21,3436,1320,-,76155
4422,2586,1836,1040,116200,76164
8720,4466,4254,1640,312600,76177
24505,19194,5311,1754,275100,76179
14943,7485,7458,1427,267900,76180
11252,9542,1710,1688,340800,76182
11217,2152,9065,1076,242100,76201
0,0,0,-,-,76203
7698,2961,4737,1288,263400,76205
6578,4295,2283,1522,335700,76207
8373,5641,2732,1446,341200,76208
10591,4919,5672,1290,239700,76209
16099,11838,4261,1636,317900,76210
1255,1024,231,929,251700,76225
12723,11838,885,2863,490600,76226
17982,13852,4130,1877,341900,76227
498,427,71,938,126700,76228
3835,3055,780,1088,180400,76230
1249,971,278,1109,214100,76233
6805,5315,1490,1164,278400,76234
151,93,58,-,-,76238
501,380,121,772,207600,76239
11397,7174,4223,1069,183300,76240
5,5,0,-,-,76241
24135,17538,6597,1851,326700,76244
877,723,154,639,175600,76245
5689,4720,969,1889,321600,76247
14315,11622,2693,1855,479500,76248
3124,2533,591,1434,257500,76249
339,284,55,1088,244000,76250
237,201,36,1386,216000,76251
1028,831,197,1159,256100,76252
82,73,9,-,122500,76253
2229,1674,555,763,139300,76255
2791,2002,789,1200,318400,76258
2156,1640,516,1233,287100,76259
76,50,26,-,70000,76261
14948,11085,3863,1605,473800,76262
9,9,0,-,-,76263
525,433,92,862,296000,76264
659,487,172,559,170100,76265
6801,5580,1221,1237,291300,76266
14,0,14,-,-,76267
41,32,9,-,125000,76268
841,824,17,-,233800,76270
703,562,141,1548,308000,76271
1873,1662,211,779,286700,76272
3995,3028,967,1097,231300,76273
6326,3219,3107,755,60300,76301
4858,2929,1929,940,130100,76302
1994,1585,409,799,155300,76305
5485,3127,2358,902,102200,76306
8391,4587,3804,1040,185300,76308
5714,3311,2403,940,127300,76309
7711,5545,2166,1003,178800,76310
650,12,638,1440,-,76311
687,503,184,499,98100,76351
4777,3082,1695,876,138700,76354
211,176,35,-,105800,76357
1108,737,371,705,59100,76360
107,87,20,-,-,76363
94,57,37,1694,63900,76364
1904,1471,433,767,134300,76365
810,664,146,743,122900,76366
3993,3425,568,968,128600,76367
181,151,30,-,80800,76370
589,516,73,475,54100,76371
406,302,104,538,91700,76372
57,50,7,-,-,76373
1713,1226,487,605,91100,76374
210,174,36,625,84800,76377
195,158,37,904,127400,76379
1497,1013,484,568,91800,76380
4398,2589,1809,790,84900,76384
87,62,25,-,50000,76388
502,442,60,814,189600,76389
11897,6757,5140,1079,227500,76401
0,0,0,-,-,76402
3166,2445,721,688,94500,76424
3830,2866,964,1097,235900,76426
356,218,138,959,117900,76427
72,72,0,-,-,76429
972,795,177,478,172900,76430
1609,1377,232,1224,163100,76431
446,414,32,758,130900,76432
734,629,105,969,362300,76433
203,185,18,1313,87700,76435
43,38,5,-,-,76436
2320,1697,623,847,113800,76437
0,0,0,-,-,76439
2814,2266,548,815,132400,76442
774,554,220,695,119800,76443
1461,1197,264,535,104900,76444
108,104,4,-,-,76445
3188,2659,529,955,172300,76446
2083,1457,626,759,178100,76448
1110,961,149,788,222500,76449
5328,3951,1377,887,168500,76450
60,60,0,-,-,76452
671,581,90,992,317000,76453
630,388,242,629,86400,76454
335,298,37,725,113800,76455
1434,1119,315,988,149800,76457
2058,1492,566,822,136900,76458
72,72,0,-,56500,76459
161,116,45,-,201800,76460
1478,1278,200,1396,254700,76462
194,166,28,642,84000,76463
211,170,41,725,117200,76464
155,118,37,-,-,76466
35,35,0,-,67000,76469
1264,796,468,585,54400,76470
650,480,170,626,101300,76471
541,444,97,-,-,76472
111,104,7,-,320400,76474
381,268,113,708,138500,76475
1056,899,157,1161,193900,76476
150,150,0,-,72800,76481
375,263,112,-,57900,76483
284,278,6,-,166200,76484
539,411,128,1031,280400,76486
954,833,121,1457,189500,76487
21,14,7,-,-,76490
215,151,64,772,99700,76491
6600,4313,2287,879,147700,76501
17425,11352,6073,1330,222600,76502
9990,3177,6813,1023,142600,76504
895,725,170,738,150200,76511
14872,10069,4803,1134,235500,76513
524,404,120,688,160700,76518
177,177,0,-,171900,76519
2731,2005,726,836,135000,76520
15716,9399,6317,966,153000,76522
135,131,4,-,170800,76523
1452,1181,271,1136,176800,76524
495,374,121,739,142600,76525
1501,1108,393,766,374400,76527
6592,4591,2001,862,157900,76528
963,816,147,727,201200,76530
1680,1402,278,853,128500,76531
1065,814,251,836,185000,76534
3951,3225,726,1604,251900,76537
496,423,73,658,123200,76538
3124,2886,238,894,237200,76539
8321,1996,6325,824,87400,76541
18996,11639,7357,1191,210900,76542
13081,4971,8110,1036,123100,76543
4207,25,4182,1291,"10,000-",76544
11655,6516,5139,1062,239400,76548
19398,10059,9339,1248,185600,76549
5050,3817,1233,854,218300,76550
807,616,191,1073,158000,76554
735,668,67,-,156600,76556
1805,1383,422,1055,168800,76557
2319,1529,790,1046,171600,76559
427,325,102,835,136000,76561
10,10,0,-,-,76565
120,116,4,-,250000,76566
3668,2659,1009,938,152500,76567
991,833,158,994,102700,76569
861,692,169,723,79300,76570
3555,3073,482,1135,351300,76571
6,6,0,-,-,76573
7686,5648,2038,1050,235100,76574
1262,966,296,970,134100,76577
460,364,96,1094,235700,76578
1713,1072,641,1129,189700,76579
0,0,0,-,-,76596
0,0,0,-,-,76597
0,0,0,-,-,76598
0,0,0,-,-,76599
360,342,18,1347,224100,76621
495,418,77,611,200000,76622
63,56,7,-,85000,76623
918,832,86,882,126600,76624
541,432,109,1102,151000,76626
558,502,56,1115,121900,76627
18,18,0,-,178600,76628
832,637,195,890,149800,76629
804,695,109,991,226900,76630
153,124,29,1031,121400,76631
577,473,104,836,126500,76632
1996,1787,209,1680,300200,76633
2936,2247,689,904,154000,76634
469,347,122,763,118600,76635
581,529,52,775,208400,76636
208,139,69,805,262500,76637
1023,959,64,1113,328700,76638
692,444,248,603,113200,76639
1091,827,264,852,162100,76640
592,474,118,1087,137000,76641
2306,1697,609,779,170000,76642
5955,3953,2002,1308,233700,76643
3940,2440,1500,903,139100,76645
1006,778,228,845,113800,76648
316,263,53,1073,122800,76649
30,27,3,-,110900,76650
1401,986,415,1080,190900,76651
436,400,36,-,162500,76652
590,485,105,-,136900,76653
84,66,18,-,158000,76654
3048,2710,338,1390,259600,76655
909,695,214,967,106200,76656
4048,3079,969,1210,341700,76657
195,148,47,981,125000,76660
1988,1417,571,558,78200,76661
1216,912,304,958,120100,76664
1047,635,412,611,117600,76665
79,45,34,-,118800,76666
3717,2586,1131,768,108900,76667
626,441,185,940,157800,76670
820,685,135,820,185300,76671
377,310,67,1035,115600,76673
125,112,13,917,155000,76676
52,52,0,-,154500,76678
375,358,17,-,120400,76679
51,51,0,-,29400,76680
175,157,18,-,86800,76681
1124,933,191,1125,136600,76682
31,31,0,-,-,76685
96,70,26,-,110000,76686
795,698,97,889,249300,76687
1496,1233,263,1124,183400,76689
474,343,131,1064,121000,76690
2345,1849,496,935,213300,76691
4039,3102,937,880,121900,76692
800,619,181,844,134700,76693
826,152,674,1137,100000,76701
3250,1060,2190,713,105200,76704
10811,6384,4427,882,152000,76705
14397,5390,9007,997,162900,76706
5656,3182,2474,1012,99500,76707
9523,6170,3353,1058,182400,76708
10762,5096,5666,1022,202900,76710
3814,1982,1832,1313,90500,76711
10732,7378,3354,1244,277900,76712
0,0,0,-,-,76798
9660,6034,3626,851,126100,76801
2180,1698,482,1125,182800,76802
80,56,24,-,316000,76820
1701,1228,473,964,89500,76821
1049,839,210,762,117000,76823
0,0,0,-,-,76824
2658,1786,872,805,93800,76825
280,263,17,725,160300,76827
111,108,3,-,126400,76828
0,0,0,-,-,76831
187,115,72,-,116100,76832
2098,1475,623,752,88000,76834
1,1,0,-,-,76836
442,328,114,688,87100,76837
9,0,9,-,-,76841
107,107,0,-,-,76842
1343,1127,216,625,184600,76844
106,94,12,-,226000,76845
30,30,0,-,-,76848
1429,1131,298,700,189600,76849
124,107,17,1031,197000,76852
551,430,121,582,225000,76853
86,29,57,-,157300,76854
1278,1016,262,818,239600,76856
958,667,291,1558,152500,76857
108,100,8,-,81800,76858
948,734,214,714,89500,76859
690,529,161,850,150900,76861
76,70,6,-,-,76862
317,277,40,716,230600,76864
85,73,12,-,107700,76865
206,172,34,-,125000,76866
32,32,0,-,-,76869
23,20,3,-,-,76870
193,168,25,650,192900,76871
312,245,67,1065,129200,76872
30,23,7,-,820300,76873
0,0,0,-,-,76874
234,192,42,738,147200,76875
1555,1174,381,914,132400,76877
618,424,194,550,67500,76878
0,0,0,-,-,76880
78,53,25,-,205000,76882
30,23,7,-,42100,76884
19,7,12,-,-,76885
59,47,12,-,238500,76887
73,47,26,-,-,76888
365,281,84,775,117200,76890
12274,9125,3149,1071,161600,76901
0,0,0,-,-,76902
11958,7536,4422,915,105300,76903
15094,9493,5601,1029,245900,76904
4800,3329,1471,1547,153900,76905
0,0,0,-,-,76908
0,0,0,-,-,76909
36,36,0,-,-,76930
1090,735,355,1057,123900,76932
501,336,165,837,135300,76933
281,249,32,939,160200,76934
668,668,0,-,331100,76935
899,757,142,645,96700,76936
33,31,2,-,-,76937
0,0,0,-,-,76939
0,0,0,-,-,76940
547,471,76,1145,127100,76941
1246,935,311,583,180400,76943
832,579,253,406,55800,76945
1072,685,387,701,133200,76950
392,337,55,882,121000,76951
49,28,21,-,-,76953
84,73,11,-,183000,76955
42,10,32,-,-,76957
89,85,4,-,-,76958
6436,651,5785,1714,293000,77002
5354,2450,2904,1510,345400,77003
15465,5646,9819,1269,375500,77004
9955,7241,2714,1984,1296300,77005
13902,4774,9128,1713,560600,77006
22436,10957,11479,1933,483700,77007
18349,11197,7152,1473,553800,77008
15088,9026,6062,1101,383000,77009
529,0,529,3400,-,77010
6178,3060,3118,888,163000,77011
5996,2280,3716,884,113300,77012
5813,2503,3310,1094,130100,77013
11968,6033,5935,1139,189900,77014
18311,9618,8693,1126,149600,77015
9767,6202,3565,1067,98900,77016
10355,5179,5176,1020,131800,77017
11684,8107,3577,1248,529300,77018
12079,5141,6938,1799,739200,77019
9081,4707,4374,878,116600,77020
10935,4080,6855,1170,163300,77021
9232,4304,4928,1005,169600,77022
10139,4510,5629,996,202100,77023
15875,9814,6061,1760,1153200,77024
13724,5503,8221,1436,532200,77025
8101,3299,4802,886,91200,77026
11185,3028,8157,1737,896500,77027
6307,3559,2748,1047,95900,77028
5573,3632,1941,1039,108600,77029
5870,2228,3642,1588,740600,77030
6103,2689,3414,1044,219100,77031
4375,1701,2674,1153,110700,77032
9179,5627,3552,1172,88700,77033
12297,6040,6257,1167,163200,77034
13831,5732,8099,1049,249200,77035
26160,4295,21865,966,205200,77036
4994,3515,1479,906,141000,77037
8863,5024,3839,1189,163300,77038
7923,4608,3315,1115,137400,77039
18348,9392,8956,1246,197400,77040
10965,8184,2781,1593,255500,77041
19166,4916,14250,1224,320400,77042
10048,5588,4460,1365,363800,77043
16587,12478,4109,1587,252300,77044
10312,5862,4450,1250,142300,77045
1016,551,465,1692,258400,77046
12238,8529,3709,1577,204500,77047
7104,4014,3090,1157,151400,77048
11807,8069,3738,1408,192000,77049
1710,975,735,1138,100800,77050
6269,2468,3801,1171,139700,77051
9248,6183,3065,1471,142000,77053
16001,1874,14127,1400,165300,77054
15885,7290,8595,1171,579400,77055
12078,4207,7871,1783,809900,77056
21814,6935,14879,1319,346900,77057
9603,2873,6730,1237,229700,77058
6427,5973,454,1853,369300,77059
15007,3519,11488,974,126600,77060
9171,3513,5658,935,195700,77061
9439,7199,2240,1204,268600,77062
20255,4460,15795,1272,271700,77063
15868,9736,6132,1499,222400,77064
15902,6863,9039,1283,241500,77065
11766,8690,3076,1438,202700,77066
10044,4316,5728,1091,161200,77067
3920,2687,1233,1258,275600,77068
8444,5122,3322,1447,307400,77069
21502,9884,11618,1489,245300,77070
10090,5065,5025,1016,208200,77071
18899,8500,10399,1174,162100,77072
13898,8748,5150,1266,185400,77073
13087,4243,8844,1003,186600,77074
12407,7481,4926,1167,202700,77075
9915,4883,5032,1122,134100,77076
29223,10249,18974,1382,352900,77077
4784,2803,1981,1142,124800,77078
13717,7264,6453,1582,604500,77079
15536,7345,8191,1214,302100,77080
19202,1167,18035,951,338600,77081
21825,8029,13796,1299,208500,77082
22672,14568,8104,1278,203800,77083
35552,21476,14076,1400,215600,77084
5477,3572,1905,1288,159800,77085
8700,4923,3777,1162,168100,77086
11222,6296,4926,948,127200,77087
17424,11397,6027,1116,152100,77088
18635,12630,6005,1401,216000,77089
16452,4654,11798,1135,209000,77090
11083,4118,6965,1052,201100,77091
14509,5885,8624,1130,222300,77092
13665,7928,5737,1015,107100,77093
4064,3356,708,1555,453400,77094
24914,17623,7291,1479,269100,77095
12975,6372,6603,1200,401000,77096
8680,2796,5884,1862,717000,77098
16146,5879,10267,1167,163100,77099
0,0,0,-,-,77204
11240,6332,4908,1177,172300,77301
6458,5178,1280,1347,241500,77302
8003,6078,1925,1164,192000,77303
16525,9813,6712,1297,294100,77304
5017,4269,748,880,156000,77306
10469,9239,1230,1504,386900,77316
7235,5773,1462,1311,265500,77318
9978,6230,3748,990,179400,77320
133,133,0,-,183700,77326
10281,8263,2018,937,127200,77327
6177,4667,1510,1078,150400,77328
3106,2563,543,925,193400,77331
62,42,20,-,-,77334
1092,902,190,1120,111800,77335
4032,3334,698,1217,237600,77336
16523,8339,8184,1279,195500,77338
17303,9961,7342,1540,257000,77339
12472,5647,6825,976,205200,77340
0,0,0,-,-,77341
0,0,0,-,-,77342
9317,8107,1210,1890,353800,77345
23614,19925,3689,1657,264700,77346
50,37,13,-,83800,77350
12506,9843,2663,940,161900,77351
13451,10820,2631,1456,344600,77354
10409,8939,1470,1249,316600,77355
12457,10614,1843,1604,338500,77356
9967,7444,2523,1234,181400,77357
2141,1621,520,931,166700,77358
137,82,55,-,182600,77359
2205,1643,562,1019,125700,77360
2317,2108,209,1338,246100,77362
1385,1206,179,1175,296900,77363
1052,908,144,913,150000,77364
13179,11296,1883,1270,243000,77365
225,139,86,1285,210900,77367
0,0,0,-,-,77368
247,192,55,-,107300,77369
2173,1744,429,959,131600,77371
4251,3564,687,1178,176600,77372
21753,15779,5974,1632,198300,77373
155,133,22,-,-,77374
23062,16453,6609,1452,272000,77375
289,281,8,-,-,77376
12748,10535,2213,1560,330300,77377
5797,4534,1263,1324,149500,77378
28224,21387,6837,1499,309200,77379
14398,5170,9228,1478,336900,77380
13554,10556,2998,1637,417200,77381
13262,10537,2725,1905,507200,77382
9974,5600,4374,1395,394300,77384
8717,6740,1977,1627,274800,77385
21060,16979,4081,1810,311900,77386
17711,12567,5144,1749,246000,77388
14072,11288,2784,1699,377900,77389
19761,13182,6579,1415,207900,77396
6107,5342,765,2423,956600,77401
20063,17713,2350,1879,368700,77406
22646,17798,4848,1824,338000,77407
0,0,0,-,-,77412
9430,6052,3378,990,153800,77414
142,93,49,-,113200,77415
835,598,237,979,115200,77417
3844,2865,979,1051,282700,77418
349,324,25,-,162700,77419
783,583,200,750,167400,77420
5067,4226,841,1058,181500,77422
4495,3768,727,1298,248600,77423
850,699,151,-,354500,77426
30,0,30,-,-,77428
30660,25707,4953,1591,321100,77429
623,549,74,-,280900,77430
253,243,10,-,-,77431
0,0,0,-,-,77432
31919,25917,6002,1775,365000,77433
1240,1005,235,866,72700,77434
1725,1457,268,1125,231700,77435
0,0,0,-,-,77436
6414,4201,2213,960,166800,77437
23,23,0,-,-,77440
8588,8197,391,1745,492700,77441
329,219,110,696,169000,77442
38,0,38,-,-,77443
345,315,30,871,201000,77444
5239,2961,2278,1046,247300,77445
991,106,885,1182,241900,77446
6411,5383,1028,1390,266000,77447
79,27,52,-,-,77448
38037,26706,11331,1636,213500,77449
24931,17369,7562,1641,318400,77450
162,114,48,1089,96000,77451
61,17,44,-,-,77453
77,77,0,-,-,77454
641,522,119,1104,143400,77455
372,314,58,850,117900,77456
310,232,78,-,162500,77457
13,13,0,-,-,77458
26003,21752,4251,1926,354200,77459
24,24,0,-,-,77460
4136,3256,880,1156,237200,77461
182,82,100,1130,206800,77464
2796,2150,646,909,179200,77465
182,130,52,-,290200,77466
0,0,0,-,-,77467
0,0,0,-,-,77468
20975,16689,4286,1448,279700,77469
172,154,18,-,149200,77470
15698,8940,6758,1302,210900,77471
11,6,5,-,-,77473
5917,4908,1009,1126,222600,77474
251,229,22,-,186900,77475
93,74,19,-,344200,77476
13289,5543,7746,1385,215900,77477
8883,6802,2081,1689,368300,77478
29236,24640,4596,1971,437500,77479
2859,2388,471,1086,161700,77480
87,25,62,-,215600,77481
551,470,81,-,158300,77482
141,141,0,-,144000,77483
4781,3259,1522,1074,232900,77484
1393,944,449,906,186300,77485
2885,2241,644,1246,210100,77486
5390,3305,2085,788,161900,77488
12758,9531,3227,1670,184200,77489
16669,13694,2975,1608,290200,77493
40821,29303,11518,1977,420100,77494
16830,11764,5066,1753,263500,77498
10961,7014,3947,1132,148100,77502
7978,4288,3690,1155,147500,77503
9144,3790,5354,1168,193100,77504
8190,5534,2656,1502,256200,77505
10582,3992,6590,996,114700,77506
334,0,334,1699,-,77507
5104,4360,744,980,245900,77510
17517,11984,5533,1218,197700,77511
2044,1683,361,1120,149900,77514
11786,8562,3224,1026,189900,77515
2140,1923,217,830,263000,77517
3629,2047,1582,1174,159000,77518
214,192,22,-,-,77519
13192,7484,5708,1094,125300,77520
23523,13873,9650,1285,202100,77521
9277,7698,1579,1366,330600,77523
9081,6625,2456,1005,149400,77530
6222,3430,2792,1198,216000,77531
10870,8960,1910,1084,228400,77532
376,291,85,960,110900,77533
927,851,76,1063,217500,77534
10777,9211,1566,1041,199800,77535
11282,8846,2436,1302,224200,77536
306,282,24,-,152700,77538
17641,13434,4207,1338,224500,77539
6561,4547,2014,1063,136600,77541
8458,7092,1366,2008,236800,77545
18777,14338,4439,1644,320400,77546
2570,1724,846,1127,97400,77547
11282,4656,6626,1115,245300,77550
9174,4359,4815,1251,242800,77551
4628,3127,1501,1435,391800,77554
0,0,0,-,-,77555
375,320,55,-,251500,77560
17,17,0,-,-,77561
3430,2627,803,1071,179600,77562
4221,3233,988,1252,194800,77563
733,641,92,-,105000,77564
2997,1808,1189,1640,342100,77565
11525,7610,3915,1404,242400,77566
7592,5792,1800,1125,183300,77568
13480,9828,3652,1266,199800,77571
34834,25927,8907,1625,322500,77573
5584,4234,1350,916,153900,77575
429,407,22,575,229900,77577
8297,6957,1340,1392,339600,77578
0,0,0,-,-,77580
17599,13549,4050,1485,289400,77581
164,164,0,-,-,77582
11571,10398,1173,1124,267400,77583
29940,22585,7355,1661,324700,77584
442,373,69,-,-,77585
9416,6537,2879,1430,305100,77586
4829,2508,2321,1131,146300,77587
13176,6986,6190,1122,156700,77590
6260,3397,2863,1152,172500,77591
190,142,48,-,318800,77597
12443,2435,10008,1231,207800,77598
3528,2664,864,1041,181200,77611
3799,3291,508,686,113400,77612
432,296,136,790,180200,77613
219,167,52,-,115700,77614
141,109,32,-,79300,77615
187,176,11,-,164600,77616
22,14,8,-,-,77617
6034,4453,1581,1210,147500,77619
629,579,50,-,223900,77622
256,245,11,-,-,77623
260,260,0,-,149000,77624
3153,2533,620,899,115300,77625
8874,6509,2365,1210,177000,77627
249,229,20,-,152100,77629
10587,7002,3585,993,155300,77630
8086,6467,1619,1014,178800,77632
6655,4522,2133,1101,91100,77640
13549,6974,6575,885,90800,77642
1161,1073,88,-,363800,77650
4936,3743,1193,1038,223500,77651
171,163,8,-,142500,77655
6302,5095,1207,937,113700,77656
7938,6582,1356,975,219200,77657
1921,1690,231,1176,187600,77659
360,320,40,-,140600,77660
123,66,57,-,-,77661
9726,7943,1783,874,119300,77662
389,265,124,-,233700,77663
1050,958,92,1115,123100,77664
2059,1613,446,1000,161100,77665
4544,2446,2098,911,69100,77701
1469,857,612,975,152800,77702
4345,2027,2318,838,87100,77703
10432,5987,4445,823,114600,77705
13285,7605,5680,1098,217200,77706
6298,4372,1926,1118,147900,77707
5305,2773,2532,990,163300,77708
5613,3605,2008,1316,205200,77713
6058,881,5177,923,173200,77801
10904,5688,5216,1193,223000,77802
9411,5691,3720,1122,120000,77803
4677,2780,1897,1189,220700,77807
5460,4992,468,1050,316100,77808
1091,891,200,975,304400,77830
1164,1063,101,934,113000,77831
11373,8017,3356,985,232100,77833
1150,1028,122,1318,288800,77835
4932,3991,941,978,181900,77836
589,394,195,854,111600,77837
21526,2275,19251,1036,234100,77840
0,0,0,-,-,77843
28150,18165,9985,1307,322700,77845
14,14,0,-,-,77852
392,335,57,779,116400,77853
25,25,0,-,-,77855
1617,1259,358,928,250400,77856
437,350,87,692,269400,77857
2721,1966,755,616,124100,77859
1085,931,154,882,244800,77861
39,0,39,-,-,77863
2666,1786,880,782,128200,77864
687,539,148,1169,162500,77865
0,0,0,-,-,77866
77,72,5,-,-,77867
5170,3574,1596,905,186000,77868
1180,924,256,742,185200,77871
754,587,167,1102,166000,77872
525,488,37,540,204900,77873
0,0,0,-,-,77875
63,63,0,-,-,77876
372,206,166,905,136800,77878
2231,1764,467,892,132500,77879
1052,973,79,1408,284200,77880
15,15,0,-,-,77882
14909,8597,6312,1017,127600,77901
11455,7933,3522,1178,226500,77904
6104,5068,1036,1068,183200,77905
68,53,15,-,62500,77950
537,336,201,739,57300,77951
3382,2226,1156,937,166000,77954
2990,2212,778,916,111700,77957
55,55,0,-,-,77960
137,45,92,-,-,77961
1297,858,439,853,187900,77962
1929,1552,377,775,172800,77963
3229,2292,937,909,207700,77964
1154,1014,140,675,278300,77968
92,92,0,-,490000,77969
80,53,27,695,-,77970
253,253,0,-,223700,77971
9,0,9,-,-,77973
194,133,61,1112,183700,77974
720,513,207,920,170100,77975
22,22,0,-,200000,77976
238,212,26,-,44100,77977
170,121,49,984,98300,77978
6508,4858,1650,944,123500,77979
365,345,20,-,256600,77982
1004,826,178,1355,156300,77983
1761,1542,219,963,199300,77984
8,8,0,-,-,77986
51,45,6,-,-,77987
75,26,49,-,-,77988
327,285,42,980,89400,77990
98,98,0,-,-,77991
54,54,0,-,204300,77993
128,109,19,-,-,77994
3906,2963,943,838,171400,77995
0,0,0,-,-,78001
2386,1784,602,1193,162200,78002
3705,3087,618,962,221100,78003
265,206,59,-,520100,78004
604,373,231,-,-,78005
15316,11319,3997,1487,470700,78006
44,35,9,-,-,78007
116,58,58,-,-,78008
3102,2618,484,1221,320000,78009
1560,1207,353,-,246200,78010
571,537,34,-,61600,78011
82,58,24,-,92300,78012
2193,1870,323,956,344900,78013
1333,1010,323,848,95000,78014
7440,6940,500,1485,474600,78015
3805,2945,860,683,168100,78016
1037,771,266,697,106300,78017
442,412,30,910,106500,78019
2,2,0,-,-,78021
1564,1111,453,951,154100,78022
9545,8524,1021,1561,374800,78023
483,383,100,883,492100,78024
2164,1616,548,985,207100,78025
2613,1693,920,955,139200,78026
160,160,0,-,226100,78027
16878,11480,5398,1068,259300,78028
0,0,0,-,-,78029
823,707,116,933,86600,78039
11438,4673,6765,853,101100,78040
15212,7854,7358,914,194100,78041
12624,6751,5873,956,130200,78043
139,110,29,-,232400,78044
20412,15689,4723,1289,210700,78045
17552,13777,3775,984,131900,78046
178,162,16,-,125000,78050
1939,1584,355,1022,142700,78052
805,731,74,963,215000,78055
772,701,71,-,469800,78056
173,173,0,-,-,78057
417,364,53,-,326500,78058
2008,1799,209,969,154700,78059
2971,1653,1318,817,94000,78061
0,0,0,-,-,78062
3940,3631,309,915,238200,78063
5228,3813,1415,1066,188900,78064
3547,2582,965,917,122500,78065
356,344,12,-,172800,78066
239,239,0,-,74900,78067
2124,1886,238,895,96900,78069
7074,6487,587,1250,432400,78070
1250,855,395,917,142800,78071
136,120,16,-,97400,78072
2616,2173,443,1029,143400,78073
32,32,0,-,-,78074
106,71,35,-,105300,78075
4328,3174,1154,557,86300,78076
3183,2844,339,803,265000,78101
7180,4706,2474,991,113200,78102
25,0,25,-,-,78104
180,131,49,-,-,78107
14779,12468,2311,1925,282500,78108
17790,13390,4400,1471,219100,78109
0,0,0,-,-,78111
3469,3092,377,1167,113100,78112
1051,844,207,1046,232800,78113
8249,6874,1375,1051,254900,78114
108,108,0,-,270000,78116
285,276,9,-,241700,78117
1203,939,264,829,110900,78118
1731,1035,696,962,129200,78119
4807,4242,565,1055,328300,78121
123,106,17,-,257900,78122
953,828,125,1184,198600,78123
2552,2197,355,1119,237200,78124
12,12,0,-,-,78125
34859,22527,12332,1420,276200,78130
13664,11579,2085,1349,504200,78132
9113,7700,1413,1219,278300,78133
1280,862,418,875,90100,78140
365,315,50,975,70300,78141
21,16,5,-,162500,78142
51,51,0,-,-,78143
0,0,0,-,-,78144
28,20,8,-,-,78145
208,112,96,1330,125000,78146
569,370,199,1137,181300,78147
8316,4226,4090,1184,226600,78148
0,0,0,-,-,78150
729,401,328,417,103300,78151
1062,961,101,1696,283900,78152
14580,10307,4273,1596,273200,78154
19013,13520,5493,1083,216300,78155
266,202,64,950,86400,78159
1717,1431,286,1070,183500,78160
157,148,9,-,-,78161
112,86,26,-,170800,78162
5499,5247,252,1396,411000,78163
1284,1013,271,881,168000,78164
16937,8099,8838,983,164600,78201
4375,2188,2187,1066,208900,78202
2102,1031,1071,877,106800,78203
5024,2250,2774,1327,117800,78204
1234,97,1137,1259,600400,78205
16655,7277,9378,808,85800,78207
1860,626,1234,890,118300,78208
19559,9445,10114,1301,468900,78209
12046,6997,5049,1045,142900,78210
9763,6345,3418,990,98500,78211
11309,5190,6119,1046,269100,78212
16553,7728,8825,1101,188000,78213
8004,4717,3287,891,110900,78214
2207,98,2109,1707,461300,78215
19492,6576,12916,1134,261200,78216
14182,6300,7882,1132,189900,78217
14097,6718,7379,1132,165400,78218
5589,3137,2452,1057,134500,78219
6052,3323,2729,1137,112600,78220
13023,8837,4186,1043,138900,78221
8315,5759,2556,1235,172300,78222
19963,11222,8741,1000,137800,78223
6554,3505,3049,1106,129500,78224
5185,3530,1655,983,97500,78225
2320,898,1422,887,105000,78226
14960,8437,6523,1036,129700,78227
19636,11375,8261,953,147800,78228
16317,2392,13925,1172,178500,78229
19070,9335,9735,1214,317000,78230
4020,2691,1329,1267,366800,78231
15086,8611,6475,1353,322700,78232
18078,10910,7168,1391,185800,78233
967,2,965,2110,-,78234
1209,0,1209,1388,-,78235
476,12,464,1832,-,78236
12406,7687,4719,939,93700,78237
10528,5005,5523,1113,180900,78238
9988,7246,2742,1357,201600,78239
24651,8456,16195,1252,228800,78240
10605,5493,5112,1111,116400,78242
0,0,0,-,-,78243
12073,8510,3563,1512,180700,78244
29831,21554,8277,1480,218100,78245
18576,14000,4576,1418,235000,78247
5503,3836,1667,1304,424900,78248
22566,11375,11191,1379,262800,78249
19612,14372,5240,1421,200300,78250
21758,11271,10487,1259,227200,78251
4546,4079,467,1529,216400,78252
20536,16061,4475,1435,307500,78253
23499,19324,4175,1674,271700,78254
6347,5346,1001,1601,451800,78255
5258,1515,3743,1488,513200,78256
5301,2054,3247,1607,484800,78257
18598,11020,7578,1607,415700,78258
10358,6779,3579,1469,351400,78259
11882,10517,1365,1762,435500,78260
8972,7170,1802,1476,379200,78261
1930,1595,335,1123,271600,78263
3931,3214,717,1133,130900,78264
2594,2418,176,2226,474100,78266
178,150,28,-,85000,78330
8677,5550,3127,876,91000,78332
4599,3075,1524,1151,167200,78336
0,0,0,-,-,78338
129,129,0,-,69400,78339
206,181,25,1688,156700,78340
419,239,180,850,84600,78341
110,56,54,-,21600,78342
1687,1494,193,852,96800,78343
175,159,16,-,87500,78344
24,24,0,-,-,78347
109,106,3,-,138600,78349
172,41,131,1082,86300,78351
38,38,0,-,-,78352
194,104,90,-,80900,78353
2585,1631,954,395,81200,78355
884,625,259,938,79600,78357
469,434,35,1156,250800,78358
654,379,275,815,98600,78359
0,0,0,-,-,78360
1342,855,487,754,115100,78361
3839,2651,1188,1271,172800,78362
11232,5870,5362,972,133000,78363
3587,2780,807,655,88600,78368
86,62,24,-,-,78369
1698,1266,432,1120,159600,78370
62,55,7,-,75000,78371
1711,1316,395,779,115200,78372
1555,1137,418,2098,478800,78373
7037,4604,2433,1731,217400,78374
1199,769,430,737,81700,78375
94,55,39,1119,77200,78376
1049,689,360,697,92000,78377
674,572,102,1186,97100,78379
8319,6584,1735,1035,122100,78380
9365,7476,1889,1187,221500,78382
1609,1335,274,1018,210600,78383
1589,1222,367,-,61100,78384
38,6,32,-,-,78385
2975,1979,996,572,103900,78387
701,593,108,962,55700,78389
1776,1214,562,1168,109500,78390
50,23,27,-,-,78391
611,512,99,719,92600,78393
1551,264,1287,962,76000,78401
147,107,40,-,194600,78402
5911,3006,2905,1110,157700,78404
5432,2814,2618,963,70500,78405
380,115,265,1585,-,78406
562,357,205,1021,131400,78407
3916,2019,1897,844,85200,78408
858,473,385,930,120300,78409
9649,6562,3087,1162,207800,78410
8874,5337,3537,1145,163900,78411
15443,7226,8217,1205,167600,78412
14185,7673,6512,1245,216600,78413
17760,11580,6180,1420,249300,78414
14544,8280,6264,1149,124200,78415
5005,3060,1945,985,90400,78416
1495,936,559,1194,134000,78417
12073,7841,4232,1207,258700,78418
172,0,172,1796,-,78419
21415,11073,10342,892,142400,78501
6441,3791,2650,1055,124600,78503
19158,13018,6140,1095,181500,78504
10175,7682,2493,720,82800,78516
19253,11328,7925,800,114900,78520
26617,15585,11032,831,84300,78521
16690,11643,5047,1025,145300,78526
226,130,96,542,65400,78535
136,116,20,-,123400,78536
13828,10149,3679,711,69600,78537
2973,2236,737,495,81000,78538
13999,7733,6266,970,183200,78539
0,0,0,-,-,78540
15113,7930,7183,875,125000,78541
21779,16283,5496,837,102400,78542
2815,2138,677,707,73300,78543
202,197,5,-,41200,78545
120,80,40,-,-,78547
467,374,93,783,43100,78548
251,225,26,-,48800,78549
19305,9834,9471,841,104700,78550
13672,10530,3142,978,134500,78552
3705,2800,905,832,136100,78557
125,125,0,-,55700,78558
4037,2952,1085,886,94300,78559
1352,863,489,638,108100,78560
208,156,52,-,77100,78561
624,467,157,335,119500,78562
34,32,2,-,-,78563
13,0,13,-,-,78564
51,44,7,-,-,78565
7035,5264,1771,846,124000,78566
135,109,26,-,44200,78567
1273,1041,232,663,102700,78569
9267,6971,2296,626,83500,78570
25476,18868,6608,853,113600,78572
11790,8304,3486,835,130800,78573
16492,12798,3694,814,107800,78574
1637,1070,567,1049,178100,78575
3068,2462,606,703,98900,78576
23309,13668,9641,925,98300,78577
4119,2880,1239,636,184100,78578
732,631,101,-,-,78579
3319,2122,1197,740,63800,78580
12422,9253,3169,696,97700,78582
2095,1735,360,761,124300,78583
5098,3336,1762,607,72300,78584
0,0,0,-,-,78585
14690,11270,3420,812,75800,78586
44,31,13,-,22700,78588
11276,8785,2491,880,104500,78589
134,100,34,-,47800,78590
122,118,4,-,256800,78591
166,147,19,-,34800,78592
1522,1062,460,772,63700,78593
523,378,145,382,54100,78594
1853,1536,317,566,76500,78595
11497,7521,3976,883,88200,78596
1233,878,355,1361,389400,78597
67,56,11,-,208700,78598
8920,6599,2321,842,97000,78599
12244,9144,3100,1198,248700,78602
2643,2397,246,1081,189800,78605
2650,2090,560,777,326200,78606
71,54,17,-,356300,78607
124,105,19,-,265000,78608
819,676,143,989,260600,78609
16017,12606,3411,1540,346700,78610
5318,4299,1019,1100,258700,78611
5381,4642,739,1386,217400,78612
33717,21834,11883,1646,416000,78613
160,148,12,-,403100,78614
528,397,131,1065,265700,78615
2590,2130,460,1127,171500,78616
8116,6528,1588,1366,222100,78617
139,120,19,863,335600,78618
2104,1914,190,1257,655500,78619
7000,6020,980,1486,585300,78620
8747,6968,1779,1163,247900,78621
136,107,29,1344,117500,78622
508,508,0,-,435400,78623
9698,6720,2978,1297,404600,78624
13927,9070,4857,1677,324300,78626
15543,12012,3531,1417,419900,78628
4419,2723,1696,922,185700,78629
1021,832,189,1158,310200,78631
531,463,68,-,162600,78632
13531,12393,1138,1765,400400,78633
14077,11432,2645,1821,289800,78634
34,34,0,-,-,78635
1669,1180,489,1033,349500,78636
770,661,109,1106,197200,78638
3495,2726,769,907,236300,78639
22797,16113,6684,1498,259900,78640
29559,23731,5828,1788,395700,78641
6877,5880,997,1415,454600,78642
3008,2206,802,968,273600,78643
6565,4570,1995,1133,214500,78644
6187,5463,724,1140,367500,78645
3414,2442,972,1023,183500,78648
859,788,71,-,223200,78650
1796,1579,217,2248,435300,78652
10029,8789,1240,1685,288500,78653
7344,5187,2157,1278,294800,78654
1401,917,484,1064,194400,78655
882,535,347,1108,-,78656
3090,2670,420,1510,409300,78657
40,40,0,-,409100,78658
1107,1022,85,-,247600,78659
39826,27929,11897,1631,335500,78660
147,141,6,-,161500,78661
1289,900,389,1058,228900,78662
316,283,33,-,178800,78663
23021,12576,10445,1500,281800,78664
22105,14523,7582,1812,381300,78665
33173,12400,20773,1245,248700,78666
4256,3841,415,1265,548300,78669
61,37,24,1643,262500,78670
340,208,132,-,176400,78671
349,320,29,-,197300,78672
56,38,18,-,-,78674
45,45,0,-,411400,78675
6345,5051,1294,1175,434100,78676
0,0,0,-,-,78677
20005,14842,5163,1781,418900,78681
6667,3294,3373,2574,609800,78701
12349,5200,7149,1749,569700,78702
11272,5651,5621,2131,1194200,78703
27465,8730,18735,1673,721200,78704
10053,1196,8857,1479,493900,78705
0,0,0,-,-,78712
13022,7325,5697,1678,532400,78717
528,497,31,-,130000,78719
4237,2128,2109,1637,436900,78721
3136,1520,1616,1668,622900,78722
15420,7500,7920,1389,456100,78723
8446,5601,2845,1396,224200,78724
3807,3243,564,2176,266000,78725
6123,2707,3416,1536,592500,78726
13624,6057,7567,1754,417300,78727
12720,3536,9184,1426,355000,78728
14597,6169,8428,1489,381600,78729
4149,2691,1458,1588,929500,78730
13432,7363,6069,1484,778000,78731
7062,5042,2020,1638,666800,78732
3069,2737,332,3013,859100,78733
9362,7681,1681,1933,571100,78734
9116,4223,4893,1829,741000,78735
3979,2804,1175,1741,493800,78736
7729,6857,872,2075,628800,78737
11128,8543,2585,1896,691400,78738
6775,6165,610,2965,644200,78739
22410,4147,18263,1379,325200,78741
378,259,119,1355,-,78742
18012,9144,8868,1460,265900,78744
29030,13936,15094,1603,398200,78745
10904,7282,3622,1923,1209300,78746
7959,5789,2170,1643,318700,78747
23542,13097,10445,1642,385300,78748
15459,9732,5727,1761,474900,78749
11391,7184,4207,1729,531700,78750
8982,1977,7005,1602,626600,78751
10322,2160,8162,1353,330500,78752
23524,7902,15622,1331,302200,78753
11885,7279,4606,1537,288100,78754
4558,2016,2542,1337,720100,78756
11362,6705,4657,1465,598900,78757
23625,6251,17374,1462,361900,78758
22112,10511,11601,1569,587700,78759
7142,4766,2376,1047,131300,78801
0,0,0,-,-,78802
327,253,74,556,96800,78827
44,44,0,-,-,78828
284,212,72,1083,42400,78829
184,135,49,760,71300,78830
1105,829,276,728,112200,78832
356,201,155,864,67500,78833
2274,1426,848,680,64000,78834
23,11,12,-,-,78836
62,62,0,-,-,78837
64,64,0,-,435300,78838
2778,1990,788,816,79700,78839
16507,10880,5627,913,138600,78840
0,0,0,-,-,78841
0,0,0,-,-,78842
41,0,41,-,-,78843
226,190,36,879,272200,78850
61,61,0,-,-,78851
17539,11920,5619,757,123000,78852
0,0,0,-,-,78860
4479,3372,1107,1106,156200,78861
387,317,70,820,163700,78870
12,12,0,-,-,78871
365,283,82,-,69900,78872
524,431,93,780,279500,78873
362,279,83,-,-,78877
94,80,14,-,-,78879
486,390,96,680,87500,78880
566,439,127,546,74700,78881
131,95,36,-,344900,78883
397,291,106,810,208300,78884
44,36,8,-,345500,78885
128,128,0,-,103200,78886
93,93,0,-,-,78931
194,180,14,1719,286400,78932
405,347,58,-,275900,78933
2371,1792,579,910,211500,78934
382,382,0,-,-,78935
103,86,17,721,223100,78938
874,818,56,950,246600,78940
1232,992,240,871,177700,78941
3442,2463,979,1069,180500,78942
178,96,82,-,-,78943
286,283,3,-,400900,78944
4237,3321,916,812,269000,78945
437,257,180,1114,164200,78946
1799,1552,247,1064,235300,78947
247,172,75,779,238600,78948
216,197,19,-,241700,78949
889,825,64,-,232800,78950
0,0,0,-,-,78951
594,406,188,1682,264100,78953
526,491,35,-,431000,78954
1779,1349,430,1149,205800,78956
3954,3047,907,971,227000,78957
686,534,152,818,100000,78959
1951,1645,306,539,222200,78962
234,234,0,-,247700,78963
66,36,30,1125,129200,79001
15,15,0,-,-,79002
48,34,14,-,65000,79003
592,463,129,869,136100,79005
4482,3533,949,883,92900,79007
0,0,0,-,-,79008
539,375,164,807,104800,79009
31,0,31,-,-,79010
85,59,26,970,231300,79011
0,0,0,-,-,79012
903,363,540,699,53800,79013
1287,933,354,1028,201100,79014
7997,5551,2446,935,268300,79015
0,0,0,-,-,79016
157,92,65,782,93800,79018
682,601,81,937,166700,79019
25,14,11,-,85500,79021
3194,2460,734,1113,143700,79022
145,90,55,765,109100,79024
5,5,0,-,-,79025
1505,929,576,844,103200,79027
5000,3327,1673,933,140600,79029
472,360,112,761,91800,79031
43,28,15,-,93300,79032
21,6,15,-,-,79033
189,149,40,690,115600,79034
1843,1380,463,789,148200,79035
1644,1545,99,868,114700,79036
287,229,58,1057,124300,79039
671,504,167,890,167100,79040
1021,835,186,629,98400,79041
421,316,105,969,100000,79042
526,296,230,1024,54700,79043
309,211,98,1619,182100,79044
5982,3850,2132,844,103600,79045
217,194,23,675,110300,79046
4,4,0,-,-,79051
473,339,134,830,104400,79052
20,12,8,-,90000,79053
180,131,49,917,41000,79054
34,34,0,-,75000,79056
436,316,120,950,81900,79057
0,0,0,-,-,79058
273,233,40,554,122300,79059
111,104,7,592,86700,79061
74,65,9,-,115600,79062
219,197,22,585,189800,79063
763,533,230,809,88300,79064
7410,5201,2209,843,96300,79065
5,5,0,-,-,79066
1267,1027,240,973,142800,79068
3575,2503,1072,848,115800,79070
8367,4864,3503,766,97100,79072
3,3,0,-,-,79073
60,59,1,-,53500,79078
993,716,277,875,85300,79079
170,150,20,845,43800,79080
1158,828,330,834,93600,79081
82,62,20,-,47000,79082
683,522,161,875,83900,79083
540,463,77,933,111700,79084
0,0,0,-,-,79085
1228,945,283,949,106300,79086
307,181,126,679,96600,79087
1772,1143,629,739,83800,79088
17,17,0,-,-,79091
459,372,87,1101,140300,79092
48,48,0,-,305900,79093
8,8,0,-,-,79094
970,736,234,652,89600,79095
711,533,178,937,147200,79096
422,356,66,793,167300,79097
185,151,34,1097,130500,79098
1252,128,1124,852,156300,79101
4089,1982,2107,962,126600,79102
3722,2472,1250,1041,113200,79103
2244,1150,1094,877,79300,79104
11806,5586,6220,938,148700,79106
10512,6309,4203,956,81900,79107
4493,3440,1053,1049,130600,79108
18217,11042,7175,894,198900,79109
7047,4762,2285,1146,141800,79110
475,4,471,1206,-,79111
10131,8104,2027,1213,205400,79118
8832,5750,3082,1155,310600,79119
2554,1911,643,924,252900,79121
4247,3797,450,1037,314400,79124
1910,1364,546,858,109200,79201
69,41,28,-,116300,79220
23,23,0,-,-,79223
309,238,71,780,62400,79225
1012,698,314,717,103400,79226
490,332,158,537,63000,79227
124,117,7,-,27100,79229
19,16,3,-,-,79230
8,8,0,-,-,79231
42,25,17,-,-,79233
37,19,18,-,220500,79234
1141,724,417,531,92600,79235
72,28,44,-,-,79236
191,175,16,575,76300,79237
58,56,2,-,96700,79239
26,20,6,-,-,79240
775,617,158,864,90900,79241
10,5,5,-,-,79243
295,229,66,709,85000,79244
900,621,279,544,74400,79245
18,18,0,-,-,79247
638,404,234,395,48400,79248
463,331,132,628,66800,79250
13,13,0,-,142200,79251
1036,686,350,559,69200,79252
181,126,55,744,66000,79255
113,83,30,-,47500,79256
392,314,78,1083,76100,79257
4,4,0,-,-,79258
21,21,0,-,-,79259
125,80,45,565,43000,79261
1401,1007,394,726,129400,79311
313,245,68,593,49400,79312
544,404,140,1069,63900,79313
26,10,16,-,29000,79314
3724,2440,1284,762,103300,79316
705,466,239,513,68400,79322
2447,1538,909,826,176000,79323
4,4,0,-,-,79324
725,475,250,1033,144700,79325
15,15,0,-,-,79326
1279,958,321,758,178800,79329
40,32,8,-,-,79330
3928,2795,1133,806,95600,79331
5843,4182,1661,758,124200,79336
2498,1752,746,806,76400,79339
125,121,4,-,118400,79342
525,418,107,442,113100,79343
0,0,0,-,-,79344
309,219,90,693,110900,79345
739,480,259,671,44500,79346
2023,1445,578,668,113900,79347
184,173,11,-,52500,79350
448,320,128,908,90800,79351
9,9,0,-,-,79353
623,325,298,882,124200,79355
1646,1144,502,1054,91000,79356
788,555,233,719,65500,79357
459,321,138,883,206300,79358
1263,868,395,684,85300,79359
5143,4035,1108,811,192800,79360
2031,1757,274,1083,186200,79363
2668,1950,718,986,89700,79364
451,440,11,-,314400,79366
215,129,86,857,78800,79367
12,12,0,-,-,79369
491,421,70,450,70200,79370
520,423,97,907,104000,79371
546,395,151,619,90200,79372
1050,752,298,961,109600,79373
19,1,18,-,-,79376
89,61,28,-,85000,79377
70,54,16,479,136800,79378
207,170,37,729,70000,79379
31,25,6,-,-,79380
499,400,99,807,202600,79381
3132,2424,708,1223,215900,79382
31,17,14,-,83600,79383
4039,408,3631,1021,105800,79401
0,0,0,-,-,79402
5789,3452,2337,888,76500,79403
3225,2155,1070,870,87900,79404
0,0,0,-,-,79406
10537,4602,5935,1101,173700,79407
4377,1463,2914,1299,189400,79410
2942,934,2008,872,125500,79411
5763,2839,2924,918,103100,79412
8889,5064,3825,1266,182700,79413
8524,3009,5515,1063,140500,79414
6325,2519,3806,936,84200,79415
14332,7209,7123,1197,187000,79416
16494,12009,4485,1274,204500,79423
20548,14225,6323,1092,259500,79424
1154,915,239,917,86500,79501
413,345,68,757,53700,79502
102,81,21,-,112500,79503
1116,878,238,676,99300,79504
65,45,20,520,60300,79505
311,243,68,725,79800,79506
435,360,75,1091,165000,79508
3002,2534,468,948,135000,79510
360,307,53,975,186900,79511
2053,1418,635,770,84100,79512
66,47,19,-,-,79517
41,25,16,-,-,79518
37,37,0,-,195600,79519
1073,766,307,866,49600,79520
1266,829,437,692,79600,79521
1164,1125,39,903,135700,79525
356,319,37,-,136900,79526
111,106,5,-,118300,79527
200,164,36,929,75000,79528
439,300,139,1002,58000,79529
211,173,38,950,72100,79530
294,233,61,340,86500,79532
197,165,32,883,40600,79533
96,83,13,-,180100,79534
53,48,5,-,88300,79535
1919,1512,407,1260,118600,79536
14,6,8,-,-,79537
62,58,4,-,331600,79538
73,51,22,770,-,79539
18,18,0,-,-,79540
540,369,171,-,264900,79541
471,391,80,760,66100,79543
164,119,45,919,-,79544
685,575,110,893,85000,79545
707,511,196,563,79000,79546
401,319,82,1070,54200,79547
73,62,11,-,83100,79548
5222,4185,1037,1032,108100,79549
1329,969,360,1066,72800,79553
4863,3073,1790,803,92500,79556
27,21,6,-,106300,79560
220,181,39,675,76600,79561
1401,1277,124,1550,266700,79562
414,366,48,1000,60200,79563
79,74,5,-,103300,79565
94,88,6,-,267900,79566
1166,941,225,703,64300,79567
7667,3580,4087,931,156800,79601
9529,7442,2087,985,213500,79602
8827,5098,3729,976,105200,79603
11606,6267,5339,1061,151900,79605
11689,6305,5384,1114,238700,79606
924,63,861,1287,452100,79607
0,0,0,-,-,79699
10368,6643,3725,1222,186900,79701
8017,5086,2931,1515,211300,79703
17513,12049,5464,1426,316200,79705
11222,9194,2028,1110,243500,79706
15453,9263,6190,1368,372600,79707
266,192,74,-,140600,79713
6603,4789,1814,1345,179300,79714
205,154,51,1102,58600,79718
129,101,28,858,59800,79719
11539,7663,3876,983,132700,79720
0,0,0,-,-,79721
31,31,0,-,31100,79730
1614,1371,243,913,118000,79731
116,50,66,385,-,79733
1021,904,117,1113,170900,79734
4380,3091,1289,983,141600,79735
87,63,24,-,-,79738
349,203,146,-,260300,79739
133,112,21,-,208800,79741
189,161,28,650,91800,79742
98,69,29,-,85500,79743
562,344,218,1179,185100,79744
2336,1944,392,919,108300,79745
99,61,38,-,-,79748
239,100,139,805,153900,79749
809,634,175,1164,83900,79752
40,12,28,-,218800,79754
23,7,16,-,-,79755
3563,2818,745,1109,131000,79756
915,819,96,-,371100,79758
0,0,0,-,-,79759
12754,7234,5520,1229,139900,79761
15263,8716,6547,1322,208400,79762
13638,9676,3962,1085,116900,79763
9097,6450,2647,933,156100,79764
8132,5188,2944,1514,292900,79765
3460,2725,735,1065,166300,79766
0,0,0,-,-,79769
0,0,0,-,-,79770
3896,2930,966,950,110300,79772
0,0,0,-,-,79776
51,42,9,-,192500,79777
523,402,121,519,113500,79778
18,7,11,-,-,79780
46,46,0,-,-,79781
1481,954,527,1022,123400,79782
32,24,8,-,-,79783
13,13,0,-,49300,79785
317,293,24,750,75500,79788
349,295,54,183,117800,79789
1842,1461,381,977,145000,79821
4264,2684,1580,795,206800,79830
0,0,0,-,-,79832
181,14,167,777,-,79834
3974,2875,1099,905,95600,79835
2364,1902,462,907,99500,79836
107,33,74,-,24700,79837
1941,1486,455,635,84000,79838
446,301,145,497,57100,79839
191,94,97,421,115300,79842
1426,1072,354,391,215200,79843
849,611,238,391,81100,79845
0,0,0,-,-,79846
40,34,6,-,-,79847
375,337,38,-,107500,79848
3853,2687,1166,847,91700,79849
163,115,48,854,-,79851
254,176,78,779,121400,79852
902,824,78,964,83600,79853
74,74,0,-,73200,79854
618,466,152,918,82600,79855
3759,267,3492,502,84000,79901
8591,3266,5325,751,214400,79902
6137,3623,2514,843,115500,79903
11792,4760,7032,935,112300,79904
7984,3736,4248,605,97000,79905
1482,0,1482,1414,-,79906
16466,9556,6910,864,102100,79907
1080,0,1080,1638,-,79908
3175,2533,642,1453,280700,79911
29899,16546,13353,1134,228300,79912
13099,7766,5333,755,109800,79915
0,0,0,-,-,79916
0,0,0,-,-,79918
0,0,0,-,-,79920
2644,2296,348,1313,286800,79922
21219,13069,8150,985,122600,79924
15076,7679,7397,969,167400,79925
13243,10542,2701,992,112300,79927
22317,19824,2493,1020,167000,79928
10138,4516,5622,845,117300,79930
10154,7288,2866,958,233500,79932
9513,6293,3220,1352,179800,79934
6537,3436,3101,1032,172600,79935
35900,23926,11974,1133,156400,79936
27649,22322,5327,1235,180800,79938
9416,4671,4745,1639,486600,80002
14254,9858,4396,1625,450500,80003
14819,10539,4280,1651,549300,80004
11341,10031,1310,1980,589500,80005
6238,5888,350,2574,745300,80007
14229,5904,8325,1262,360800,80010
18213,9621,8592,1531,333900,80011
19160,9537,9623,1579,372300,80012
25691,19787,5904,1854,422600,80013
18613,11049,7564,1726,365800,80014
24481,19959,4522,2095,495000,80015
22537,18185,4352,1942,666900,80016
14050,8691,5359,1594,351500,80017
5187,4537,650,2146,488400,80018
1498,1334,164,1195,463700,80019
20795,14240,6555,1895,495700,80020
15984,8406,7578,1902,482500,80021
18433,13578,4855,1432,421500,80022
9665,7531,2134,2065,747800,80023
43,29,14,-,-,80024
14,14,0,-,-,80025
13639,9434,4205,1934,629000,80026
12610,8348,4262,2156,767800,80027
6526,3759,2767,1209,375100,80030
14260,10214,4046,1767,482200,80031
12512,6158,6354,1447,524200,80033
796,11,785,1927,-,80045
177,127,50,1782,407400,80101
2122,1824,298,1174,472400,80102
952,796,156,1380,455300,80103
12993,10222,2771,1752,518500,80104
716,648,68,660,359100,80105
1926,1809,117,1278,654200,80106
5065,4826,239,1690,627900,80107
11491,9715,1776,1875,752100,80108
9249,7546,1703,1933,615200,80109
9908,5650,4258,1512,424700,80110
12822,8107,4715,1939,845100,80111
15927,8602,7325,1868,571000,80112
10556,5432,5124,1464,677000,80113
1736,1659,77,2150,836400,80116
920,819,101,1190,567200,80117
2236,2139,97,2034,787600,80118
13755,8117,5638,1433,549300,80120
7143,6248,895,1865,646000,80121
12715,10799,1916,1983,573400,80122
19084,14102,4982,1836,517500,80123
9837,5404,4433,1892,692600,80124
4677,4369,308,2454,656500,80125
15642,13256,2386,2251,666800,80126
16997,14686,2311,1956,610600,80127
14319,11946,2373,1852,513200,80128
12082,8665,3417,2278,619600,80129
9235,7087,2148,2527,618300,80130
117,99,18,-,376300,80131
9696,8514,1182,2021,632400,80132
1046,959,87,1722,391600,80133
27062,21807,5255,1866,603000,80134
1520,1358,162,2148,808400,80135
1912,1748,164,1216,486300,80136
525,512,13,-,608000,80137
12012,9713,2299,1906,637900,80138
11449,2684,8765,2149,682500,80202
15327,3186,12141,1488,461800,80203
16249,6354,9895,1606,515600,80204
16818,6484,10334,1691,600400,80205
14038,6359,7679,1590,815600,80206
8944,6693,2251,1704,623100,80207
14099,6607,7492,1863,875500,80209
16803,9539,7264,1851,812600,80210
18950,9310,9640,1789,692700,80211
9947,6777,3170,1603,661700,80212
11927,4420,7507,1412,472700,80214
8593,5081,3512,1666,585000,80215
6187,1862,4325,1813,369900,80216
11785,4108,7677,1418,565300,80218
22245,12490,9755,1358,392500,80219
16560,9542,7018,1552,690300,80220
14191,9517,4674,1612,405300,80221
11031,4810,6221,1622,563500,80222
8449,3856,4593,1545,459100,80223
8259,4820,3439,1482,532200,80224
13472,7095,6377,1625,478000,80226
15500,10200,5300,1697,480000,80227
14814,10194,4620,1759,574900,80228
19362,12848,6514,1631,349600,80229
5198,2477,2721,1844,780000,80230
15917,6536,9381,1619,448900,80231
9305,6551,2754,1656,449600,80232
17492,10727,6765,1815,405900,80233
11889,7024,4865,1708,464100,80234
4063,2117,1946,1655,509800,80235
6198,3838,2360,1629,460100,80236
11463,5044,6419,1806,564300,80237
10821,7706,3115,1981,748500,80238
13753,8091,5662,1791,366100,80239
11871,9350,2521,1926,462300,80241
7514,1602,5912,1578,598800,80246
14718,5559,9159,1650,280200,80247
12511,10020,2491,2041,426800,80249
12349,7468,4881,1444,202400,80260
0,0,0,-,-,80264
0,0,0,-,-,80266
263,0,263,2260,-,80290
0,0,0,-,-,80293
0,0,0,-,-,80294
11858,6335,5523,1936,695200,80301
12612,4994,7618,1709,1065500,80302
11595,5288,6307,1771,891000,80303
11101,7649,3452,1948,1059900,80304
6853,4187,2666,2161,924200,80305
0,0,0,-,-,80310
16865,11067,5798,1751,691000,80401
8423,7337,1086,1911,742000,80403
0,0,0,-,-,80419
423,284,139,1805,430800,80420
3652,3417,235,2079,488700,80421
2106,1695,411,1181,472100,80422
75,75,0,-,490700,80423
3989,2870,1119,2009,853900,80424
127,94,33,-,528300,80425
25,25,0,-,-,80426
375,199,176,1399,358200,80427
187,154,33,-,677300,80428
51,48,3,-,326700,80430
149,149,0,-,415300,80432
3509,3295,214,1440,650100,80433
25,14,11,-,-,80434
2658,1598,1060,1302,768100,80435
205,205,0,-,316300,80436
390,225,165,1222,297900,80438
10143,9081,1062,1725,755000,80439
1164,836,328,1370,417500,80440
836,457,379,1409,495900,80442
1772,1093,679,2525,733200,80443
577,370,207,1179,426900,80444
1568,1105,463,1213,470500,80446
1054,709,345,-,483800,80447
0,0,0,-,-,80448
544,544,0,-,394500,80449
325,277,48,1163,347500,80451
1586,1163,423,1256,396900,80452
134,107,27,-,448000,80453
604,581,23,-,695100,80454
208,185,23,1113,377300,80455
212,199,13,-,453000,80456
231,205,26,-,448800,80457
850,660,190,1132,331800,80459
2612,1979,633,1563,320400,80461
45,45,0,-,776800,80463
6043,5423,620,1983,574400,80465
1618,1101,517,1604,680200,80466
1057,859,198,1300,613400,80467
146,40,106,675,-,80468
159,130,29,-,295700,80469
1641,1586,55,1792,561200,80470
0,0,0,-,-,80471
40,8,32,-,-,80473
121,121,0,-,476000,80474
9,9,0,-,-,80475
119,88,31,966,568200,80476
594,549,45,-,803800,80478
12,12,0,-,-,80479
529,426,103,-,208000,80480
214,199,15,1893,480100,80481
631,513,118,1560,-,80482
227,188,39,-,294400,80483
7560,5643,1917,1817,800500,80487
3538,2837,701,1627,675800,80498
17732,10157,7575,1512,432500,80501
14907,10136,4771,1791,663200,80503
22022,17981,4041,1804,493200,80504
203,158,45,856,545500,80510
754,708,46,2813,571900,80512
6083,5439,644,1689,496600,80513
2133,1617,516,1682,421100,80514
385,363,22,-,443800,80515
12171,10587,1584,2591,645100,80516
4957,3696,1261,1211,626100,80517
672,582,90,1643,389600,80520
14547,5492,9055,1322,494700,80521
16038,10577,5461,1534,482900,80524
23989,14234,9755,1659,519800,80525
19108,10545,8563,1518,475500,80526
8490,5804,2686,1841,615900,80528
2041,1820,221,2218,424400,80530
99,99,0,-,363500,80532
7009,5435,1574,1797,472200,80534
1146,810,336,1140,387200,80535
984,955,29,-,537100,80536
18994,12283,6711,1542,431500,80537
20472,14395,6077,1637,448800,80538
1992,1681,311,1694,728300,80540
1595,1541,54,-,502900,80542
3250,2870,380,1348,392900,80543
0,0,0,-,-,80544
517,511,6,-,380100,80545
84,55,29,-,370500,80546
2393,2218,175,1641,678100,80547
5097,4280,817,2212,428800,80549
15584,12586,2998,1663,494400,80550
13443,9304,4139,1627,430700,80601
13196,12101,1095,2381,603900,80602
5445,4906,539,1664,406100,80603
1259,962,297,916,388700,80610
248,206,42,1125,425600,80611
138,127,11,-,516500,80612
3456,3159,297,1351,454400,80615
6287,4364,1923,1400,295100,80620
4775,3567,1208,1238,388300,80621
67,67,0,-,-,80622
304,261,43,1724,267200,80623
239,180,59,-,454500,80624
17603,8278,9325,1118,285400,80631
23689,17277,6412,1430,376300,80634
4670,3890,780,2117,437400,80640
1620,1338,282,1263,501900,80642
1394,1006,388,1682,435900,80643
949,716,233,911,378900,80644
1644,1390,254,1164,361500,80645
0,0,0,-,-,80646
466,448,18,2179,369900,80648
160,120,40,1125,544500,80649
666,614,52,1333,319500,80650
1570,1348,222,1347,395500,80651
136,136,0,-,454100,80652
350,263,87,933,354700,80653
937,628,309,1054,384900,80654
6452,4022,2430,1049,284800,80701
316,189,127,888,154400,80705
1007,717,290,1006,204000,80720
79,53,26,-,318800,80721
146,127,19,-,197400,80722
2533,1694,839,1008,255300,80723
199,116,83,838,219400,80726
227,183,44,768,115300,80727
438,344,94,845,192900,80728
179,123,56,695,221200,80729
618,486,132,841,215600,80731
12,12,0,-,-,80732
208,149,59,988,224300,80733
1160,837,323,859,264100,80734
139,79,60,875,219600,80735
230,192,38,1153,139800,80736
729,461,268,687,146400,80737
48,27,21,-,218800,80740
390,296,94,1105,311300,80741
120,91,29,738,-,80742
503,356,147,862,205000,80743
189,151,38,645,86800,80744
39,24,15,-,221400,80745
29,12,17,825,179200,80746
195,167,28,950,203000,80747
128,102,26,783,143300,80749
90,76,14,-,-,80750
6375,4474,1901,836,204200,80751
59,43,16,575,214600,80754
48,48,0,-,-,80755
97,45,52,-,152500,80757
1400,1038,362,901,217300,80758
1786,1257,529,858,198600,80759
50,44,6,-,170000,80801
48,25,23,-,-,80802
154,100,54,383,147400,80804
155,132,23,1536,187500,80805
1825,1188,637,962,180000,80807
2487,1976,511,1029,333200,80808
433,371,62,1452,450000,80809
509,406,103,893,167700,80810
119,79,40,958,158000,80812
835,457,378,1176,278900,80813
1915,1512,403,1347,371500,80814
404,242,162,792,188200,80815
3059,2913,146,1621,349600,80816
10856,7920,2936,1633,339200,80817
168,128,40,867,175000,80818
354,252,102,1205,433300,80819
276,250,26,-,408800,80820
530,397,133,1047,230400,80821
133,88,45,1146,137500,80822
88,63,25,575,177200,80823
170,111,59,-,255000,80824
156,126,30,488,164300,80825
0,0,0,-,-,80826
412,374,38,-,287100,80827
951,672,279,947,287000,80828
2606,1524,1082,1170,533400,80829
74,67,7,-,334600,80830
9970,9207,763,2106,444100,80831
360,321,39,1196,417400,80832
441,395,46,747,168400,80833
149,118,31,744,-,80834
322,206,116,1162,247300,80835
372,255,117,1181,174500,80836
660,0,660,2015,-,80840
289,159,130,550,169600,80860
108,87,21,856,232700,80861
25,25,0,-,197900,80862
5189,4018,1171,1808,463000,80863
552,484,68,1271,300000,80864
3423,0,3423,1867,-,80902
7451,3113,4338,1145,372900,80903
10831,6182,4649,1368,380400,80904
8199,4096,4103,1343,320600,80905
15445,9932,5513,1556,505500,80906
12593,6984,5609,1233,334300,80907
7648,6932,716,1472,642900,80908
16248,8799,7449,1136,319500,80909
12899,5959,6940,1211,250400,80910
12088,9795,2293,1600,313800,80911
0,0,0,-,-,80913
0,0,0,-,-,80914
8772,6363,2409,1363,309700,80915
14315,7459,6856,1434,259300,80916
13361,8115,5246,1375,322600,80917
19326,12286,7040,1461,381100,80918
11641,8641,3000,1697,511000,80919
14201,9803,4398,1878,450300,80920
9428,7265,2163,2067,603500,80921
10899,7995,2904,1809,362300,80922
11941,8563,3378,1814,403300,80923
5118,3538,1580,2049,606500,80924
4841,4206,635,2241,377900,80925
704,622,82,-,534000,80926
1982,1832,150,2782,487500,80927
239,189,50,2109,247900,80928
48,48,0,-,277300,80929
596,199,397,1890,279200,80930
287,270,17,-,454800,80938
0,0,0,-,-,80939
1520,1134,386,1941,354800,80951
12649,6509,6140,931,177500,81001
5690,2779,2911,764,151900,81003
11106,6078,5028,949,158700,81004
12982,9846,3136,935,245400,81005
4554,3655,899,952,290700,81006
12108,10412,1696,1220,330000,81007
4885,3070,1815,1334,246100,81008
705,476,229,1215,194000,81019
458,359,99,663,109100,81020
9,5,4,-,-,81021
586,477,109,1322,208700,81022
621,538,83,1184,284800,81023
128,128,0,-,296200,81024
348,297,51,1156,108800,81025
69,41,28,-,53100,81027
117,96,21,810,81300,81029
83,62,21,1025,95000,81030
56,39,17,1156,71200,81033
430,328,102,769,132800,81036
736,464,272,875,142900,81039
146,127,19,-,343800,81040
252,184,68,610,84000,81041
16,14,2,-,-,81043
71,63,8,900,93000,81044
31,24,7,1000,78000,81045
2,2,0,-,-,81046
639,459,180,-,117900,81047
79,53,26,-,117400,81049
4197,2901,1296,749,150900,81050
3397,2401,996,810,121800,81052
1430,800,630,777,95000,81054
751,632,119,939,321600,81055
163,133,30,836,193800,81057
426,355,71,744,116000,81058
26,26,0,-,-,81059
335,237,98,1018,97100,81062
756,497,259,1000,102500,81063
135,111,24,775,73700,81064
1899,1242,657,903,113400,81067
953,827,126,-,333700,81069
89,54,35,1094,-,81071
762,527,235,500,146200,81073
188,160,28,790,61400,81076
351,324,27,-,135600,81077
74,30,44,-,-,81081
5346,3735,1611,852,195700,81082
29,19,10,-,97500,81084
65,40,25,425,66700,81087
1875,1364,511,722,170800,81089
482,379,103,281,121600,81090
436,305,131,662,266800,81091
313,242,71,810,236800,81092
6043,3420,2623,824,197800,81101
1034,770,264,629,124400,81120
126,114,12,-,218200,81121
3622,2860,762,1426,404500,81122
332,261,71,856,107800,81123
76,76,0,-,-,81124
1585,922,663,614,129600,81125
88,83,5,-,154500,81126
13,13,0,-,-,81128
0,0,0,-,-,81129
407,300,107,824,378300,81130
594,457,137,1245,287500,81131
1472,1210,262,728,156100,81132
460,363,97,766,222900,81133
159,69,90,677,192700,81136
2154,1587,567,1017,298500,81137
34,18,16,-,-,81138
750,605,145,682,199600,81140
420,344,76,675,154000,81141
365,286,79,-,133300,81143
2566,1814,752,669,214200,81144
278,220,58,789,206300,81146
5456,4094,1362,1186,438000,81147
160,127,33,725,105200,81148
478,372,106,599,135400,81149
688,557,131,728,152400,81151
537,363,174,673,129300,81152
498,409,89,1005,308800,81154
157,123,34,-,420300,81155
4414,3065,1349,1594,542600,81201
183,156,27,-,629800,81210
3365,2130,1235,1192,485900,81211
11627,8383,3244,970,269800,81212
55,48,7,-,325000,81220
172,150,22,925,190600,81221
148,148,0,-,275000,81222
1007,929,78,1648,261200,81223
1661,1107,554,1375,853400,81224
491,353,138,1567,663500,81225
2383,1726,657,696,221900,81226
0,0,0,-,-,81227
0,0,0,-,-,81228
4711,2624,2087,1100,458200,81230
17,17,0,-,-,81232
520,417,103,435,372900,81233
439,337,102,979,386100,81235
798,703,95,221,624100,81236
56,56,0,-,471800,81237
79,79,0,-,882500,81239
1617,1379,238,1218,285800,81240
93,90,3,-,404700,81241
497,419,78,1333,396800,81242
55,37,18,-,467900,81243
222,213,9,-,165300,81244
68,68,0,-,-,81248
225,217,8,-,434800,81251
1868,1612,256,881,311200,81252
199,181,18,-,-,81253
12684,8301,4383,1382,584700,81301
3439,2602,837,1290,470100,81303
246,246,0,-,195700,81320
5662,4064,1598,928,248100,81321
2277,1656,621,881,318400,81323
752,633,119,950,150200,81324
43,43,0,-,275000,81325
1056,935,121,1188,483300,81326
156,152,4,-,367600,81327
1768,1512,256,1164,363900,81328
72,0,72,-,-,81330
114,114,0,-,-,81331
238,192,46,1784,471400,81332
461,228,233,549,-,81334
32,32,0,-,-,81335
9584,6922,2662,1032,298800,81401
4736,3828,908,1206,428300,81403
810,699,111,935,326000,81410
2,0,2,-,-,81411
2302,1795,507,984,293500,81413
801,693,108,1565,353200,81415
4979,3399,1580,895,261700,81416
568,467,101,1536,233700,81418
1308,1088,220,900,324400,81419
222,174,48,820,155400,81422
739,552,187,1158,355300,81423
517,406,111,781,182500,81424
1849,1511,338,962,272200,81425
66,53,13,1156,772100,81426
559,420,139,940,506500,81427
1691,1327,364,775,334200,81428
31,31,0,-,212500,81429
344,286,58,1908,857100,81430
184,171,13,-,272000,81431
1534,1159,375,1244,685500,81432
307,155,152,1031,332800,81433
79,66,13,-,-,81434
2721,1480,1241,1297,632200,81435
10706,4997,5709,921,257700,81501
6150,4761,1389,1093,279700,81503
12166,9486,2680,1244,264900,81504
5056,3532,1524,1441,393700,81505
5125,3297,1828,1068,389900,81506
6642,6058,584,1645,447600,81507
5287,3465,1822,1026,198500,81520
6037,4850,1187,1328,360800,81521
54,54,0,-,-,81522
420,345,75,-,705400,81523
870,765,105,-,631700,81524
495,349,146,1340,314700,81525
2197,1738,459,1038,384000,81526
652,551,101,1328,402000,81527
6084,3853,2231,1487,654900,81601
132,111,21,1038,-,81610
4703,2788,1915,1725,736700,81611
35,0,35,-,-,81612
1492,1037,455,1796,-,81615
4163,2284,1879,2058,790900,81620
2396,1665,731,2150,1106700,81621
6562,4464,2098,2075,733900,81623
530,459,71,1153,468500,81624
4968,3313,1655,972,250500,81625
424,344,80,1192,257400,81630
2748,1963,785,1591,688600,81631
3875,2693,1182,1870,726000,81632
0,0,0,-,-,81633
2618,1857,761,923,225400,81635
2849,2189,660,1720,478700,81637
30,24,6,-,895800,81638
1029,835,194,1386,362000,81639
48,18,30,-,-,81640
1560,1206,354,959,264500,81641
12,0,12,-,-,81642
239,223,16,-,489100,81643
408,280,128,2181,915500,81645
104,91,13,-,436500,81646
2533,1940,593,1307,438200,81647
940,771,169,805,198600,81648
121,89,32,1800,669900,81649
4699,3527,1172,1161,328300,81650
2014,1630,384,1717,460500,81652
0,0,0,-,-,81653
667,558,109,545,-,81654
86,86,0,-,"2,000,000+",81655
294,294,0,-,-,81656
2421,1670,751,1650,849200,81657
16504,10602,5902,995,264700,82001
0,0,0,-,-,82005
8793,5868,2925,1088,213000,82007
14100,11669,2431,1098,387500,82009
113,105,8,967,140700,82050
17,17,0,-,-,82051
40,40,0,-,602900,82052
584,497,87,1710,228400,82053
309,294,15,-,-,82054
188,165,23,-,571800,82055
16,16,0,-,-,82058
118,118,0,-,407700,82059
156,156,0,-,358500,82060
0,0,0,-,-,82061
32,32,0,-,300000,82063
8622,4617,4005,967,296000,82070
7142,3195,3947,883,280700,82072
16,16,0,-,-,82073
32,24,8,-,-,82081
709,566,143,781,306400,82082
136,63,73,1194,126000,82083
49,49,0,-,-,82084
192,0,192,637,-,82190
2995,2181,814,706,239200,82201
132,117,15,646,256400,82210
246,196,50,1078,223800,82212
236,176,60,1638,198100,82213
499,387,112,845,171400,82214
73,50,23,1075,460000,82215
26,26,0,-,-,82217
4,4,0,-,-,82218
21,21,0,-,358300,82219
241,180,61,539,185000,82221
70,65,5,-,-,82222
356,276,80,806,207500,82223
2,2,0,-,-,82224
782,512,270,959,199100,82225
125,107,18,600,79600,82227
17,17,0,-,-,82229
3857,2849,1008,739,216700,82240
67,56,11,-,334900,82242
56,56,0,-,-,82243
226,177,49,588,224300,82244
3212,2192,1020,805,206600,82301
18,18,0,-,-,82310
290,224,66,1045,219800,82321
72,66,6,-,-,82322
76,62,14,-,117400,82323
63,46,17,-,211500,82324
409,360,49,1021,225500,82325
345,218,127,1105,114900,82327
178,143,35,-,76500,82329
1013,798,215,783,280400,82331
9,9,0,-,-,82332
208,178,30,1309,188800,82334
0,0,0,-,-,82335
89,41,48,-,-,82336
3056,2218,838,688,190000,82401
755,608,147,718,147900,82410
202,152,50,850,161800,82411
201,153,48,583,175400,82412
7026,5227,1799,964,360800,82414
229,208,21,1069,187500,82420
131,123,8,783,124400,82421
0,0,0,-,-,82422
85,44,41,618,120800,82423
1185,923,262,795,182800,82426
43,27,16,-,93200,82428
33,33,0,-,82500,82430
1105,836,269,870,206200,82431
156,107,49,-,-,82432
488,314,174,733,250000,82433
41,24,17,-,-,82434
5299,3950,1349,861,290900,82435
49,0,49,-,-,82440
94,46,48,-,615400,82441
412,282,130,692,338800,82442
2064,1462,602,824,196100,82443
89,89,0,-,-,82450
6996,4695,2301,831,219400,82501
237,136,101,467,158300,82510
161,108,53,-,-,82512
821,597,224,822,264800,82513
372,240,132,500,119700,82514
184,146,38,650,197600,82515
120,106,14,719,246200,82516
4871,3591,1280,840,288000,82520
350,310,40,1083,246300,82523
11092,7736,3356,865,240700,82601
10787,8976,1811,1109,247800,82604
8407,5252,3155,977,275500,82609
110,62,48,-,437100,82620
0,0,0,-,-,82630
4064,3275,789,911,259500,82633
49,35,14,-,-,82635
1423,1043,380,812,251900,82636
1578,1265,313,945,236100,82637
18,18,0,-,-,82638
375,329,46,1356,268600,82639
73,73,0,-,-,82640
34,30,4,-,366700,82642
124,114,10,525,54300,82643
811,627,184,815,157900,82644
13,13,0,-,-,82646
45,45,0,-,-,82648
449,356,93,764,156800,82649
1884,1725,159,820,221800,82701
151,141,10,-,232400,82710
9,9,0,-,-,82711
151,115,36,-,-,82712
7,0,7,-,-,82714
7061,5277,1784,859,214100,82716
9017,7209,1808,982,281000,82718
322,271,51,703,207600,82720
1004,809,195,777,279200,82721
73,73,0,-,109500,82723
41,27,14,-,-,82725
695,629,66,-,345200,82727
1081,784,297,923,271100,82729
708,591,117,763,182200,82730
50,12,38,-,-,82731
619,523,96,1015,220300,82732
10813,7093,3720,915,332700,82801
73,70,3,-,-,82831
501,461,40,-,599700,82832
124,124,0,-,-,82833
3492,2404,1088,929,291600,82834
126,66,60,842,342900,82835
383,342,41,779,269600,82836
16,7,9,-,337500,82837
220,204,16,-,518200,82838
541,463,78,723,380600,82839
286,208,78,-,355900,82842
10,0,10,-,-,82844
41,41,0,-,-,82845
10795,7866,2929,903,240600,82901
167,167,0,-,850300,82922
277,277,0,-,575100,82923
139,139,0,-,372400,82925
7,0,7,-,-,82929
5602,4244,1358,740,215600,82930
350,223,127,-,140300,82932
225,192,33,-,340700,82933
84,64,20,-,129200,82934
4648,3501,1147,923,247500,82935
6,6,0,-,-,82936
1091,959,132,1038,239700,82937
109,109,0,-,318500,82938
559,410,149,829,204200,82939
1851,1489,362,1268,293800,82941
39,39,0,-,-,82942
61,0,61,-,-,82943
125,107,18,-,-,82944
81,73,8,-,45600,82945
7152,4420,2732,1690,1050400,83001
120,84,36,-,1511900,83011
54,0,54,-,-,83012
173,60,113,-,-,83013
1285,1011,274,1310,1576200,83014
484,205,279,-,"2,000,000+",83025
1453,1131,322,722,184900,83101
1767,1252,515,625,312400,83110
148,119,29,-,377300,83111
277,277,0,-,426000,83112
875,642,233,753,236400,83113
282,236,46,1146,185400,83114
168,168,0,-,594400,83115
302,241,61,593,120500,83116
177,177,0,-,354400,83118
80,45,35,-,-,83119
105,72,33,-,409400,83120
0,0,0,-,-,83121
240,205,35,-,426800,83122
273,243,30,-,267000,83123
56,50,6,-,-,83124
141,106,35,-,450000,83126
1685,1486,199,1130,411600,83127
690,454,236,1257,504700,83128
14458,9655,4803,823,219000,83201
8318,5950,2368,888,267900,83202
20,4,16,-,-,83203
7694,4927,2767,698,207100,83204
199,0,199,638,-,83209
1280,1005,275,650,157200,83210
2125,1375,750,716,187700,83211
137,126,11,381,122000,83212
520,397,123,532,127200,83213
223,181,42,-,229800,83214
16,14,2,-,-,83215
313,290,23,1025,223800,83217
159,135,24,1036,201300,83218
46,33,13,-,-,83220
9046,7181,1865,789,226700,83221
76,60,16,-,325000,83223
900,634,266,663,259700,83226
29,29,0,-,-,83227
318,276,42,814,234700,83228
150,125,25,-,245100,83232
117,97,20,-,-,83233
504,427,77,883,164900,83234
35,35,0,-,54300,83235
856,699,157,750,260700,83236
447,358,89,1021,337700,83237
50,42,8,-,256300,83238
217,202,15,1018,173900,83239
771,590,181,715,184200,83241
14,14,0,-,-,83243
169,106,63,-,233300,83244
805,708,97,950,273500,83245
439,368,71,783,340000,83246
711,639,72,803,263700,83250
576,494,82,979,301500,83251
1821,1603,218,884,224300,83252
28,18,10,-,-,83253
1362,1018,344,603,165800,83254
423,344,79,828,223000,83255
209,185,24,868,196000,83261
346,315,31,-,181100,83262
3250,2442,808,729,265500,83263
130,122,8,-,225000,83271
73,71,2,-,215900,83272
3459,2818,641,892,303600,83274
1459,1103,356,693,206000,83276
60,44,16,-,255600,83277
195,192,3,-,617200,83278
33,33,0,-,-,83281
43,43,0,-,-,83283
13,13,0,-,-,83285
464,372,92,1303,280300,83286
122,114,8,-,551000,83287
23058,15169,7889,950,255100,83301
91,37,54,-,146700,83302
232,198,34,964,282500,83311
52,38,14,-,-,83312
1370,1019,351,1272,469500,83313
340,262,78,871,276700,83314
3982,3102,880,738,226900,83316
6378,4303,2075,879,222900,83318
346,297,49,1034,198400,83320
210,148,62,1045,266700,83321
25,10,15,-,231300,83322
591,377,214,869,283800,83323
219,152,67,725,210700,83324
262,182,80,929,181300,83325
275,220,55,950,208900,83327
2243,1731,512,1097,284100,83328
2410,1619,791,854,179400,83330
1111,881,230,864,209700,83332
4387,3120,1267,1127,579700,83333
835,484,351,874,207700,83334
748,489,259,577,166600,83335
2205,1458,747,971,195300,83336
15,8,7,-,-,83337
7007,5147,1860,841,238600,83338
2463,1876,587,1373,776100,83340
2736,2415,321,990,349000,83341
439,370,69,677,224800,83342
377,252,125,1042,234300,83344
401,339,62,767,219800,83346
1081,833,248,699,260200,83347
17,4,13,-,-,83348
451,357,94,685,163900,83349
4213,3121,1092,772,185500,83350
1262,933,329,877,180400,83352
624,578,46,2162,907300,83353
10,10,0,-,-,83354
1568,1127,441,814,218800,83355
15297,11102,4195,1004,273400,83401
10630,6550,4080,871,261900,83402
8911,6724,2187,961,318200,83404
6252,4537,1715,1120,296200,83406
265,223,42,-,1121400,83414
966,794,172,781,271700,83420
173,173,0,-,251400,83421
1259,886,373,1099,433800,83422
229,158,71,730,175000,83423
14,14,0,-,-,83424
210,156,54,1076,213300,83425
767,733,34,1219,313000,83427
219,205,14,-,514100,83428
324,324,0,-,484600,83429
279,214,65,919,223700,83431
16,16,0,-,275000,83433
612,480,132,914,227500,83434
215,106,109,1655,204800,83435
243,205,38,1125,244000,83436
77,57,20,-,229500,83438
11184,4264,6920,906,330700,83440
7265,6239,1026,970,306800,83442
430,332,98,1000,134200,83443
387,276,111,-,211300,83444
2150,1707,443,724,210900,83445
19,16,3,-,112500,83446
793,555,238,1229,299600,83448
97,85,12,-,431700,83449
365,223,142,1006,152200,83450
327,282,45,883,233800,83451
849,695,154,1137,406600,83452
112,95,17,-,277900,83454
2195,1789,406,1017,584500,83455
0,0,0,-,-,83460
216,216,0,-,-,83462
37,37,0,-,212500,83463
105,78,27,778,-,83464
27,21,6,-,-,83465
61,55,6,-,-,83466
2743,2270,473,726,258900,83467
84,59,25,-,341900,83468
13,13,0,-,-,83469
15251,10806,4445,890,265500,83501
72,44,28,922,190600,83520
671,535,136,856,211700,83522
355,312,43,875,181400,83523
364,277,87,880,209700,83524
175,118,57,-,288900,83525
101,82,19,663,216700,83526
2377,1662,715,797,260300,83530
73,55,18,525,291100,83533
487,351,136,1015,253600,83535
1837,1440,397,639,232200,83536
441,374,67,833,232100,83537
894,758,136,758,266400,83539
753,500,253,853,166800,83540
491,443,48,827,281500,83541
62,54,8,-,290000,83542
262,213,49,669,157300,83543
2368,1826,542,877,222600,83544
203,184,19,875,173900,83545
213,193,20,500,157100,83546
137,122,15,-,282400,83547
44,36,8,975,150000,83548
326,246,80,681,344100,83549
395,326,69,745,231000,83552
541,465,76,497,221500,83553
194,185,9,-,534400,83554
169,135,34,763,212500,83555
5,5,0,-,-,83602
213,153,60,520,238400,83604
13034,8580,4454,935,256200,83605
11204,9064,2140,1214,337000,83607
344,260,84,709,226100,83610
1009,888,121,892,375700,83611
840,674,166,772,259300,83612
382,299,83,807,206100,83615
12687,11139,1548,1761,652300,83616
6454,4763,1691,819,323200,83617
3143,2313,830,913,251200,83619
933,823,110,917,409800,83622
613,400,213,585,147100,83623
613,324,289,912,216100,83624
503,356,147,1395,258600,83626
237,177,60,944,146800,83627
1624,1129,495,875,209800,83628
795,638,157,828,312900,83629
662,531,131,729,254400,83631
161,132,29,729,286800,83632
221,138,83,802,-,83633
9538,7896,1642,1600,367200,83634
99,47,52,-,424200,83636
127,118,9,-,203300,83637
2381,2004,377,969,561300,83638
1157,868,289,612,360000,83639
1277,1078,199,1084,360600,83641
20545,14753,5792,1499,429400,83642
49,43,6,-,255000,83643
5120,4474,646,1050,349700,83644
309,257,52,639,286800,83645
24841,20384,4457,1605,432500,83646
8606,5869,2737,980,238500,83647
853,6,847,1546,-,83648
177,146,31,-,260000,83650
13306,9707,3599,1234,263100,83651
635,558,77,781,356600,83654
1931,1605,326,842,308700,83655
188,152,36,1051,218200,83656
99,88,11,-,450000,83657
2183,1502,681,969,297900,83660
3840,2390,1450,800,223300,83661
21,16,5,-,187500,83666
4925,4082,843,1264,470800,83669
279,266,13,-,-,83670
3490,2456,1034,903,205100,83672
1834,1426,408,751,290200,83676
67,67,0,-,-,83677
18998,14528,4470,1190,341300,83686
12876,9446,3430,1223,323800,83687
11448,5811,5637,1098,644600,83702
7794,4989,2805,1232,429300,83703
16478,10569,5909,1219,320900,83704
12332,6788,5544,1093,321700,83705
14801,7119,7682,1279,445700,83706
21349,17696,3653,1548,392500,83709
4277,2519,1758,1179,680100,83712
11552,9014,2538,1554,376300,83713
11194,8052,3142,1271,418100,83714
8195,6329,1866,1796,504600,83716
0,0,0,-,-,83720
0,0,0,-,-,83725
2633,2145,488,1125,418600,83801
15,10,5,-,-,83802
298,269,29,-,678300,83803
816,767,49,1014,265300,83804
3141,2510,631,822,321300,83805
93,91,2,-,100700,83806
41,37,4,-,-,83808
231,231,0,-,429200,83809
685,642,43,-,419600,83810
764,476,288,1052,222000,83811
10,10,0,-,125000,83812
388,370,18,-,459300,83813
11422,6577,4845,1129,451400,83814
15556,10235,5321,1264,409500,83815
95,87,8,-,-,83821
906,720,186,739,240700,83822
691,583,108,1034,324000,83823
125,102,23,927,346400,83824
84,65,19,2250,397200,83825
72,72,0,-,170900,83826
89,75,14,-,169800,83827
135,135,0,-,217900,83830
704,641,63,1042,284100,83832
697,639,58,963,474400,83833
83,83,0,-,385400,83834
9128,7824,1304,1412,434900,83835
434,386,48,981,500000,83836
1259,758,501,912,152900,83837
582,451,131,859,301700,83839
267,218,49,-,275300,83840
208,143,65,-,367500,83841
44,34,10,-,236400,83842
11115,5381,5734,869,322400,83843
10,0,10,-,-,83844
881,636,245,686,322100,83845
325,246,79,893,158300,83846
597,414,183,-,328100,83847
124,112,12,-,806600,83848
927,755,172,687,163000,83849
904,734,170,894,209300,83850
711,506,205,870,194100,83851
534,172,362,899,344400,83852
18240,12922,5318,1207,375400,83854
844,708,136,631,276400,83855
2746,2325,421,809,315200,83856
456,456,0,-,281300,83857
6560,5512,1048,1162,388200,83858
2836,2470,366,1003,425200,83860
2778,2045,733,824,258500,83861
7785,5665,2120,1095,420100,83864
139,106,33,-,-,83866
179,163,16,-,260100,83867
397,263,134,843,101000,83868
1979,1835,144,1038,372000,83869
147,111,36,438,341100,83870
973,813,160,720,288200,83871
316,301,15,-,425000,83872
736,500,236,665,222200,83873
52,52,0,-,310300,83874
646,529,117,863,346600,83876
200,189,11,-,216500,84001
111,91,20,-,247500,84002
14978,11564,3414,1628,499200,84003
2837,2449,388,2814,815800,84004
10789,9516,1273,1740,431100,84005
325,202,123,1366,322400,84006
159,103,56,-,273600,84007
0,0,0,-,-,84008
11469,10762,707,1795,502400,84009
15279,10908,4371,1386,442300,84010
200,187,13,888,424300,84013
5675,4913,762,1462,452600,84014
21570,16443,5127,1300,338400,84015
1375,1075,300,1158,446600,84017
66,66,0,-,428300,84018
15861,11586,4275,1735,663400,84020
1088,827,261,983,198600,84021
247,50,197,881,351400,84022
53,30,23,275,283300,84023
22,18,4,-,340000,84024
6890,5653,1237,1446,558300,84025
255,147,108,630,179000,84026
212,197,15,-,212500,84027
224,170,54,867,511500,84028
3611,3071,540,964,377800,84029
101,92,9,-,345800,84031
7759,5838,1921,1482,567200,84032
324,268,56,786,381700,84033
50,27,23,-,-,84034
261,245,16,-,151500,84035
2688,2192,496,1284,588900,84036
11191,9916,1275,1408,545100,84037
185,178,7,-,366200,84038
189,172,17,-,187500,84039
8829,7514,1315,1667,439900,84040
18060,11733,6327,1257,354900,84041
3125,2471,654,1389,598900,84042
21371,16758,4613,1685,499700,84043
8738,7016,1722,1463,298400,84044
9630,8089,1541,2049,491000,84045
182,167,15,1100,234400,84046
15604,7166,8438,1375,352700,84047
2392,1957,435,3347,810300,84049
3440,2982,458,1276,564900,84050
142,126,16,-,221100,84051
401,318,83,840,185400,84052
244,230,14,-,176500,84053
7431,5209,2222,1530,425500,84054
454,413,41,2500,508900,84055
978,21,957,1633,295800,84056
11919,7574,4345,1283,360200,84057
10770,4719,6051,1289,398900,84058
4950,2643,2307,1736,450400,84059
3030,2207,823,1765,1551500,84060
117,99,18,-,494000,84061
13959,9830,4129,1432,445600,84062
120,81,39,-,258300,84063
205,119,86,627,184200,84064
14784,12694,2090,1607,530600,84065
4515,3429,1086,870,230900,84066
12868,11028,1840,1376,306200,84067
168,135,33,1079,343600,84069
11177,6481,4696,1475,392700,84070
630,615,15,692,440200,84071
155,130,25,725,280400,84072
78,78,0,-,227500,84073
16976,14108,2868,1141,335300,84074
8770,8122,648,2044,467400,84075
126,118,8,-,306300,84076
9577,6885,2692,791,263700,84078
87,74,13,1000,245500,84080
14754,12511,2243,1583,443700,84081
276,272,4,-,444700,84082
385,99,286,579,172700,84083
10344,7451,2893,1558,384300,84084
74,44,30,-,131300,84085
151,138,13,-,183900,84086
4983,4330,653,1476,431500,84087
12641,9549,3092,1404,400800,84088
9240,8530,710,2112,644700,84092
7823,7018,805,2044,591700,84093
9538,7403,2135,1730,433300,84094
12972,9824,3148,1653,615700,84095
19969,16230,3739,1711,476800,84096
6713,5041,1672,1295,453100,84097
6584,5532,1052,2410,1033200,84098
4319,973,3346,1256,506100,84101
9960,2358,7602,1231,442900,84102
12004,5158,6846,1232,678400,84103
7832,4362,3470,1157,287800,84104
9866,5954,3912,1427,602000,84105
15205,9038,6167,1445,473900,84106
16020,7416,8604,1297,373900,84107
7563,5865,1698,1431,708900,84108
8806,6992,1814,1563,631800,84109
7202,1727,5475,1188,375000,84111
211,0,211,1071,-,84112
0,0,0,-,-,84113
0,0,0,-,-,84114
12426,4833,7593,1147,357300,84115
12470,6965,5505,1230,307800,84116
10368,6915,3453,1558,510500,84117
11658,9564,2094,1694,309500,84118
15827,8546,7281,1304,286100,84119
13648,10336,3312,1402,339700,84120
15268,11454,3814,1632,533000,84121
14047,8131,5916,1350,385200,84123
8384,6480,1904,1348,651600,84124
8332,7423,909,1754,344500,84128
11836,9580,2256,1372,360900,84129
0,0,0,-,-,84138
7,7,0,-,-,84150
0,0,0,-,-,84180
264,222,42,1636,334100,84301
8749,6135,2614,882,303200,84302
31,31,0,-,-,84304
269,265,4,-,243300,84305
110,110,0,-,450000,84306
386,331,55,945,299300,84307
89,73,16,810,273200,84308
168,165,3,-,444000,84309
1618,1509,109,2522,661400,84310
238,181,57,897,332500,84311
1473,1142,331,805,284000,84312
11,5,6,-,-,84313
360,305,55,1040,332600,84314
2743,2721,22,-,461500,84315
90,86,4,-,190000,84316
1094,991,103,-,528600,84317
1499,1299,200,1055,414900,84318
2916,2477,439,950,324500,84319
798,643,155,858,291000,84320
15690,7828,7862,941,320800,84321
0,0,0,-,-,84322
347,335,12,1167,473000,84324
701,655,46,722,443600,84325
708,654,54,795,396700,84326
267,232,35,628,304600,84327
508,474,34,1313,489200,84328
58,42,16,-,325000,84329
135,129,6,-,289300,84330
77,60,17,1104,257700,84331
2581,2242,339,1350,412200,84332
948,811,137,792,336000,84333
51,51,0,-,-,84334
4421,3568,853,1076,357900,84335
98,67,31,1723,172900,84336
4804,3749,1055,1026,294000,84337
190,135,55,638,302800,84338
1640,1477,163,856,360300,84339
1089,952,137,1486,368800,84340
8462,3884,4578,1178,359700,84341
16021,9293,6728,1078,357700,84401
13532,9266,4266,1071,347000,84403
22635,16636,5999,1240,311700,84404
11997,9092,2905,1254,348700,84405
0,0,0,-,-,84408
9981,8593,1388,1408,408000,84414
4906,3327,1579,841,188800,84501
1476,1061,415,877,234200,84511
195,165,30,-,88300,84512
472,387,85,693,161000,84513
0,0,0,-,-,84515
36,29,7,-,176000,84516
239,201,38,680,161300,84518
425,262,163,848,81200,84520
225,176,49,659,169800,84521
110,97,13,-,111700,84522
556,425,131,603,191600,84523
353,248,105,753,147800,84525
1864,1245,619,737,183900,84526
971,736,235,643,164600,84528
63,34,29,-,-,84529
144,131,13,-,-,84530
163,148,15,-,58200,84531
4548,3111,1437,1029,429900,84532
0,0,0,-,-,84533
652,541,111,675,53500,84534
895,716,179,1160,282200,84535
380,349,31,-,46300,84536
485,399,86,799,176300,84537
142,123,19,-,79500,84539
0,0,0,-,-,84540
598,364,234,776,152000,84542
10890,4802,6088,1103,341900,84601
10,0,10,-,-,84602
11812,5905,5907,1093,463400,84604
10559,2343,8216,1070,367800,84606
371,352,19,781,227700,84620
14,14,0,-,-,84621
439,388,51,775,250000,84622
12,12,0,-,-,84623
1951,1387,564,782,242700,84624
114,69,45,-,401800,84626
1797,1020,777,892,362400,84627
319,311,8,825,197800,84628
1146,1068,78,900,293300,84629
120,62,58,807,226900,84630
870,685,185,725,236500,84631
450,397,53,1000,259400,84632
285,208,77,1032,236400,84633
601,456,145,1072,241000,84634
288,193,95,938,127800,84635
167,143,24,1100,207500,84636
204,155,49,332,267900,84637
107,105,2,-,251700,84638
267,241,26,-,274500,84639
70,49,21,-,208900,84640
1074,814,260,1042,239800,84642
196,171,25,-,332200,84643
101,90,11,925,238200,84644
689,617,72,744,386200,84645
573,524,49,729,216600,84646
1417,1107,310,1003,266800,84647
2283,1668,615,989,339400,84648
266,237,29,-,197000,84649
8054,6811,1243,1255,372100,84651
316,276,40,850,197000,84652
2927,2681,246,1441,490100,84653
997,744,253,813,232900,84654
4193,3677,516,1104,386900,84655
129,121,8,863,229800,84656
197,150,47,-,230600,84657
12562,10081,2481,1276,410300,84660
567,526,41,1045,298100,84662
10401,7334,3067,1370,392100,84663
3217,2774,443,1184,656200,84664
182,164,18,-,280000,84665
122,76,46,912,343800,84667
2852,1999,853,756,244500,84701
59,49,10,888,340900,84710
292,290,2,-,277600,84711
57,51,6,-,375000,84712
1344,1070,274,953,287900,84713
289,231,58,-,212900,84714
209,164,45,1005,310200,84715
167,97,70,-,213500,84716
110,75,35,636,215000,84718
36,31,5,-,245000,84719
7873,5075,2798,864,320800,84720
8528,5923,2605,999,299400,84721
346,335,11,-,335300,84722
125,110,15,745,233300,84723
429,382,47,850,161800,84724
513,451,62,1148,272900,84725
454,283,171,882,308300,84726
24,8,16,-,-,84728
118,116,2,-,161800,84729
249,225,24,-,297000,84730
9,9,0,-,-,84731
23,23,0,-,236100,84732
99,75,24,-,-,84733
98,40,58,-,-,84734
61,43,18,-,513900,84735
101,88,13,-,162500,84736
8190,6106,2084,1149,378800,84737
3797,3044,753,1491,453200,84738
165,126,39,907,229200,84739
101,96,5,-,184100,84740
2760,2105,655,1132,299800,84741
139,130,9,-,325900,84742
93,90,3,-,214500,84743
67,47,20,657,202300,84744
1427,1079,348,1153,324600,84745
463,403,60,1694,406000,84746
361,298,63,795,278300,84747
72,72,0,-,325000,84749
217,189,28,-,247200,84750
645,506,139,906,210100,84751
292,258,34,938,221700,84752
0,0,0,-,-,84753
1416,1260,156,814,248300,84754
13,13,0,-,708300,84755
105,105,0,-,208300,84756
589,500,89,1595,493500,84757
205,190,15,1016,257100,84758
713,601,112,791,229500,84759
371,320,51,1086,223200,84760
1114,707,407,952,245600,84761
70,41,29,-,-,84762
105,82,23,1229,475000,84763
88,8,80,726,-,84764
2367,1857,510,1813,465600,84765
45,34,11,-,223700,84766
186,141,45,-,797400,84767
16851,10239,6612,1248,376300,84770
82,63,19,-,326900,84772
122,77,45,-,503200,84773
576,535,41,1375,417000,84774
177,158,19,-,613600,84775
211,192,19,-,219400,84776
264,257,7,870,468600,84779
9761,7268,2493,1328,444800,84780
127,127,0,-,422700,84781
215,202,13,-,334600,84782
450,404,46,-,553300,84783
173,78,95,1083,363000,84784
17711,13353,4358,1473,450900,84790
4745,1364,3381,1246,536800,85003
4652,1002,3650,1610,368300,85004
9227,3567,5660,1078,340400,85006
5413,2157,3256,978,359600,85007
23098,6651,16447,1180,308500,85008
14332,7157,7175,1022,183100,85009
4288,1823,2465,1604,632000,85012
10402,4457,5945,1270,426300,85013
13111,4891,8220,1235,404700,85014
16429,5643,10786,1116,278400,85015
18559,9244,9315,1396,459300,85016
12195,5405,6790,1104,214200,85017
17332,9219,8113,1221,748600,85018
7897,4283,3614,1242,225400,85019
16578,8828,7750,1257,363700,85020
16489,6474,10015,1116,398600,85021
23566,11917,11649,1383,349000,85022
13495,7877,5618,1286,320600,85023
10156,6719,3437,1665,379800,85024
0,0,0,-,-,85026
16426,8706,7720,1387,283000,85027
7700,6653,1047,1718,506500,85028
18857,10415,8442,1238,269900,85029
8479,5154,3325,1288,219600,85031
28545,16426,12119,1343,343700,85032
16437,8953,7484,1209,224600,85033
2297,366,1931,1078,281300,85034
15728,7431,8297,1231,215700,85035
15305,9563,5742,1469,244900,85037
11159,5130,6029,1138,240100,85040
18359,13355,5004,1413,274200,85041
15407,9669,5738,1362,309600,85042
11049,7153,3896,1434,256200,85043
17348,11031,6317,1654,386800,85044
2797,2527,270,2300,546200,85045
13197,9622,3575,1814,487200,85048
12037,9145,2892,2036,481400,85050
15795,8359,7436,1120,253000,85051
11196,6976,4220,1215,296100,85053
4293,1437,2856,1957,541200,85054
6389,5796,593,2043,524200,85083
10827,6502,4325,1684,530500,85085
15650,13032,2618,2034,488000,85086
3497,3279,218,1523,465400,85087
6601,6137,464,1232,384200,85118
10539,8312,2227,1133,238900,85119
14085,11485,2600,898,132200,85120
544,268,276,498,88300,85121
19985,13620,6365,1202,203900,85122
3727,2850,877,1013,193000,85123
5473,3700,1773,949,177600,85128
4132,2727,1405,900,184300,85131
9544,7993,1551,1151,260800,85132
202,156,46,-,39500,85135
996,846,150,1020,129600,85137
15377,12679,2698,1787,294100,85138
6370,4812,1558,1402,263400,85139
15670,12995,2675,1766,350700,85140
149,135,14,-,-,85141
24923,21801,3122,1980,444000,85142
13384,10468,2916,1665,297700,85143
1113,1001,112,1463,229700,85145
1233,948,285,382,95000,85147
554,223,331,917,143600,85172
1324,967,357,778,123600,85173
21,21,0,-,-,85191
958,832,126,550,153200,85192
1480,1121,359,1019,99500,85193
3104,2788,316,1129,281600,85194
20978,7596,13382,1231,251800,85201
16917,8159,8758,1292,306300,85202
13145,7323,5822,1260,359600,85203
23259,13500,9759,1330,277100,85204
19284,13586,5698,1277,282100,85205
16013,10048,5965,1542,287100,85206
18833,15444,3389,1449,411500,85207
14985,11634,3351,1418,231600,85208
17421,13065,4356,1653,327700,85209
15385,6703,8682,1260,281000,85210
14475,12292,2183,1809,458300,85212
13263,10355,2908,1481,370500,85213
7524,5956,1568,1553,352300,85215
20237,10331,9906,1671,358400,85224
27745,16595,11150,1508,343600,85225
16361,10044,6317,1637,406600,85226
14791,10328,4463,1707,416800,85233
16870,12674,4196,1733,441300,85234
0,0,0,-,-,85236
17360,13750,3610,1726,438400,85248
16211,14546,1665,2172,539300,85249
8194,6232,1962,1621,465800,85250
21961,10332,11629,1582,452400,85251
7408,6284,1124,1949,1671100,85253
18696,13595,5101,1773,634400,85254
18969,13643,5326,2352,877200,85255
1143,916,227,803,110300,85256
14622,9469,5153,1689,396600,85257
12532,9281,3251,1827,695300,85258
9441,7357,2084,1562,857500,85259
18498,11167,7331,1820,593600,85260
6166,5940,226,2388,1045200,85262
1721,1696,25,-,668500,85263
352,319,33,525,461500,85264
5451,5241,210,3063,899500,85266
11168,9492,1676,1624,521700,85268
27715,5981,21734,1421,333600,85281
23457,10744,12713,1472,343000,85282
18987,8996,9991,1492,363600,85283
7156,5930,1226,1958,588000,85284
17054,11495,5559,1936,485500,85286
18499,12324,6175,1845,451800,85295
16675,12237,4438,1901,436600,85296
10461,8196,2265,1980,476400,85297
13601,12541,1060,2381,520700,85298
22594,9244,13350,1076,192200,85301
14574,7473,7101,1182,285900,85302
10138,5944,4194,1399,255500,85303
9810,7749,2061,1299,310400,85304
4911,2961,1950,1728,345800,85305
9057,5762,3295,1491,309500,85306
4265,1871,2394,1624,290900,85307
25090,18247,6843,1655,373700,85308
0,0,0,-,-,85309
6916,6104,812,1922,443700,85310
196,177,19,-,356400,85320
1737,1241,496,742,108100,85321
199,190,9,-,231000,85322
13790,8093,5697,1456,287300,85323
1179,1023,156,-,239300,85324
581,572,9,-,137900,85325
20262,16148,4114,1465,291600,85326
136,136,0,-,37200,85328
809,577,232,1168,202100,85329
12392,11492,900,2271,624400,85331
810,732,78,-,213300,85332
231,131,100,948,181300,85333
621,293,328,665,-,85334
11130,7635,3495,1606,246800,85335
2960,1539,1421,860,183700,85336
837,488,349,914,117400,85337
20456,15573,4883,1673,365500,85338
14527,11548,2979,1890,352000,85339
11863,9533,2330,1761,449600,85340
15,0,15,-,-,85341
870,774,96,525,229900,85342
21,21,0,-,-,85343
4430,2818,1612,703,168800,85344
22720,15035,7685,1435,249000,85345
1482,903,579,789,49800,85346
162,35,127,-,184400,85347
1266,1108,158,925,97700,85348
6179,4275,1904,710,167100,85349
5685,4199,1486,873,175900,85350
17320,14743,2577,1311,225200,85351
173,78,95,549,107500,85352
11676,8224,3452,1550,292300,85353
2603,2286,317,1250,242600,85354
4094,3757,337,2234,404000,85355
1805,1490,315,728,98800,85356
305,238,67,489,73800,85357
42,42,0,-,197500,85360
2467,2162,305,907,357100,85361
366,246,120,859,224500,85362
2499,1341,1158,1139,262500,85363
27182,15829,11353,907,180400,85364
19843,15290,4553,1165,177800,85365
10463,8711,1752,1103,159700,85367
90,24,66,347,-,85371
9413,8116,1297,1851,290800,85373
18651,14653,3998,1808,318100,85374
15882,13967,1915,1474,317400,85375
1866,1640,226,1467,1011100,85377
3842,2368,1474,1216,215500,85378
15118,11368,3750,1879,363200,85379
10646,6855,3791,1597,372900,85381
17141,11742,5399,1786,365400,85382
23219,21291,1928,2054,540200,85383
6864,6463,401,1956,420900,85387
10073,8148,1925,1956,366900,85388
4760,3824,936,1270,406900,85390
13764,8212,5552,1680,330800,85392
12868,10279,2589,1787,457900,85395
12091,11283,808,1907,411300,85396
5347,3772,1575,895,142100,85501
544,479,65,282,34500,85530
189,76,113,1703,241200,85531
148,128,20,-,118600,85532
1098,1009,89,-,77300,85533
1003,801,202,611,130500,85534
0,0,0,-,-,85535
146,109,37,-,153100,85536
1338,984,354,1020,80600,85539
1154,0,1154,522,-,85540
10878,8609,2269,1210,290300,85541
642,326,316,457,31500,85542
1460,1089,371,971,211100,85543
1350,1200,150,1223,342500,85544
351,272,79,-,183500,85545
6584,5006,1578,855,174000,85546
1333,747,586,360,55700,85550
138,89,49,638,163300,85551
2240,1629,611,950,239400,85552
837,699,138,402,194000,85553
286,210,76,593,239500,85554
332,270,62,-,86000,85601
4177,3197,980,742,162700,85602
3394,2494,900,790,192500,85603
243,167,76,619,71600,85605
359,290,69,885,180000,85606
5469,3563,1906,715,124800,85607
0,0,0,-,-,85608
207,207,0,-,-,85609
305,264,41,491,168500,85610
531,508,23,-,292900,85611
918,0,918,1402,-,85613
13390,11069,2321,1182,245600,85614
3902,3591,311,649,216200,85615
2209,1544,665,910,147300,85616
534,432,102,535,108900,85617
523,400,123,831,81800,85618
18,18,0,-,-,85619
331,282,49,683,74200,85620
7390,3632,3758,661,163000,85621
3579,3227,352,1188,291400,85622
2351,2194,157,1198,346400,85623
700,404,296,797,367300,85624
1013,857,156,788,142400,85625
261,227,34,-,84800,85626
177,176,1,-,145000,85627
9374,7755,1619,1496,284700,85629
907,720,187,805,150900,85630
1634,1284,350,797,100400,85631
375,319,56,654,151100,85632
11,0,11,-,-,85633
1512,948,564,540,74700,85634
15471,9424,6047,963,190600,85635
502,449,53,-,413000,85637
763,562,201,830,157500,85638
113,71,42,-,-,85639
43,43,0,-,-,85640
10447,9807,640,1733,338200,85641
3040,2051,989,661,147700,85643
549,515,34,-,212900,85645
778,665,113,1750,465700,85646
6844,5599,1245,1002,191000,85648
6157,4944,1213,1118,279800,85650
7092,5792,1300,954,248600,85653
0,0,0,-,-,85654
6715,5765,950,1598,415600,85658
3056,655,2401,1156,393200,85701
15871,9080,6791,1277,350700,85704
25356,11665,13691,847,105900,85705
18533,10583,7950,949,144500,85706
16,0,16,-,-,85707
1332,8,1324,1453,-,85708
0,0,0,-,-,85709
24995,13771,11224,1088,222700,85710
17660,8546,9114,954,224300,85711
15893,6419,9474,913,225500,85712
17062,10544,6518,955,157100,85713
5650,2873,2777,827,167400,85714
8793,6011,2782,1263,299200,85715
15898,6087,9811,931,271400,85716
12827,8580,4247,1133,647500,85718
19082,5350,13732,973,264400,85719
0,0,0,-,-,85721
0,0,0,-,-,85723
0,0,0,-,-,85724
0,0,0,-,-,85726
15339,10166,5173,1133,196000,85730
0,0,0,-,-,85734
4149,3709,440,871,180000,85735
1762,1522,240,996,129000,85736
9814,7582,2232,1654,394400,85737
8639,7892,747,1314,371100,85739
14156,8571,5585,1347,242600,85741
11860,9449,2411,1578,293400,85742
11943,10180,1763,1511,293100,85743
16204,10072,6132,984,291400,85745
15570,10877,4693,1200,199600,85746
9003,7254,1749,1693,308800,85747
8158,6238,1920,1355,291600,85748
7469,6289,1180,1359,511900,85749
11784,8655,3129,1209,483800,85750
7817,7029,788,1861,421100,85755
11422,9147,2275,1217,180600,85756
6711,5464,1247,940,239800,85757
7730,5803,1927,1043,238200,85901
0,0,0,-,-,85902
393,199,194,548,74100,85911
92,92,0,-,164500,85912
309,262,47,950,293500,85920
49,47,2,-,229400,85922
187,187,0,-,157700,85923
867,822,45,-,83300,85924
1530,1263,267,806,211000,85925
249,83,166,408,66100,85926
58,58,0,-,508300,85927
197,151,46,-,337300,85928
3260,2526,734,1104,241400,85929
254,177,77,713,86800,85930
92,82,10,-,382000,85931
210,210,0,-,-,85932
1551,1280,271,826,236700,85933
250,207,43,-,317500,85934
2089,1771,318,798,313800,85935
955,800,155,753,167200,85936
2756,2169,587,1095,238800,85937
902,639,263,859,165500,85938
1397,1131,266,-,269200,85939
534,470,64,-,236200,85940
2810,1680,1130,612,78000,85941
0,0,0,-,-,85942
13174,4757,8417,1470,494300,86001
22,15,7,-,-,86003
13939,8752,5187,1471,438100,86004
6846,3975,2871,1398,516200,86005
40,2,38,1266,-,86011
586,508,78,-,383400,86015
18,18,0,-,-,86016
554,498,56,-,358600,86017
359,317,42,2098,520100,86018
623,551,72,446,67900,86020
753,487,266,-,217100,86021
618,518,100,675,212800,86022
609,113,496,674,37800,86023
548,521,27,-,372300,86024
1696,1069,627,911,134400,86025
14,14,0,-,-,86028
24,24,0,-,-,86029
240,211,29,-,132700,86030
667,467,200,804,64100,86031
585,415,170,1003,152700,86032
2606,1649,957,656,35800,86033
592,367,225,579,72500,86034
545,429,116,550,60600,86035
59,40,19,-,62500,86036
76,76,0,-,274000,86038
556,516,40,825,126500,86039
3892,2558,1334,1041,138500,86040
641,314,327,927,62600,86042
578,447,131,-,79100,86043
1078,836,242,696,54400,86044
3116,1871,1245,798,63800,86045
2611,2054,557,1109,302200,86046
4333,2661,1672,805,111300,86047
0,0,0,-,-,86052
697,591,106,633,49900,86053
565,433,132,591,68300,86054
11834,8377,3457,1351,441200,86301
9679,6722,2957,1017,451400,86303
9034,7341,1693,1026,572600,86305
0,0,0,-,-,86313
15865,10602,5263,1289,325700,86314
3706,3182,524,2004,398600,86315
1098,968,130,1080,168000,86320
1002,140,862,615,35400,86321
4578,3394,1184,895,260400,86322
8135,6615,1520,1098,312900,86323
2412,2037,375,849,312000,86324
2548,1983,565,1325,360600,86325
11230,7055,4175,1029,277900,86326
5522,4847,675,1355,345200,86327
374,270,104,961,223200,86329
228,123,105,863,320800,86331
1129,1024,105,864,167400,86332
2699,2140,559,788,158500,86333
1644,1220,424,938,293800,86334
2501,1590,911,1263,272700,86335
5728,4285,1443,1400,657000,86336
845,663,182,685,117300,86337
264,189,75,885,630200,86338
67,44,23,-,347100,86343
3422,2183,1239,1367,592900,86351
12278,8437,3841,1028,228100,86401
8467,5421,3046,1076,279300,86403
8620,7036,1584,1254,399900,86404
11468,8919,2549,1165,381900,86406
13272,8956,4316,868,155100,86409
197,176,21,-,144400,86411
4938,4401,537,962,110700,86413
6769,5724,1045,970,252800,86426
4021,2477,1544,980,302900,86429
192,117,75,626,92600,86431
1844,1474,370,834,201500,86432
75,75,0,-,-,86433
503,227,276,625,113000,86434
0,0,0,-,-,86435
584,235,349,-,166400,86436
30,21,9,-,279200,86437
331,321,10,-,199700,86438
3573,2847,726,1023,230900,86440
824,760,64,1017,89000,86441
15199,9807,5392,923,165800,86442
0,0,0,-,-,86443
881,832,49,-,142100,86444
122,122,0,-,120000,86445
320,299,21,706,45800,86502
3066,2311,755,539,40000,86503
1613,1150,463,695,35600,86504
1967,1650,317,513,33900,86505
413,400,13,-,50200,86506
557,496,61,850,53600,86507
184,172,12,-,28000,86508
1447,1140,307,575,86900,86510
945,900,45,788,46500,86511
724,504,220,614,71500,86512
837,602,235,693,59400,86514
1030,564,466,637,55800,86515
746,682,64,675,58600,86520
336,323,13,-,47000,86535
556,429,127,479,44300,86538
252,190,62,468,32500,86540
377,316,61,550,57700,86544
336,283,53,469,50900,86545
243,208,35,-,42600,86547
603,406,197,446,41800,86556
1024,667,357,818,217900,87001
7419,5914,1505,834,152400,87002
4703,3573,1130,966,206100,87004
25,25,0,-,-,87005
326,300,26,-,187500,87006
428,215,213,-,36000,87007
1153,1054,99,882,332500,87008
667,373,294,1323,373700,87010
2,2,0,-,-,87011
169,139,30,-,306900,87012
1586,1179,407,725,97100,87013
363,234,129,-,19700,87014
5920,5407,513,1274,239000,87015
1179,907,272,727,120600,87016
99,95,4,-,262500,87017
199,119,80,-,50900,87018
3409,2235,1174,819,153400,87020
967,585,382,834,-,87021
230,224,6,-,"10,000-",87022
200,178,22,-,153800,87023
615,394,221,1013,210600,87024
707,657,50,1146,412700,87025
981,776,205,391,89800,87026
186,81,105,642,-,87027
51,51,0,-,239700,87028
176,159,17,-,160200,87029
14967,12550,2417,1008,189400,87031
115,115,0,-,-,87032
690,651,39,-,72100,87034
2323,1892,431,698,127000,87035
622,561,61,807,133700,87036
442,357,85,675,53900,87037
68,68,0,-,41300,87038
108,108,0,-,46200,87040
357,312,45,917,164600,87041
1401,1108,293,867,242800,87042
2015,1882,133,1604,470300,87043
104,104,0,-,157100,87044
584,556,28,675,27900,87045
85,85,0,-,235000,87046
2056,1844,212,1136,389100,87047
3693,3314,379,1201,487300,87048
71,71,0,-,-,87049
354,354,0,-,85900,87051
588,404,184,857,159500,87052
364,233,131,888,241100,87053
463,448,15,-,222300,87056
4093,3744,349,1566,297800,87059
0,0,0,-,-,87060
105,105,0,-,-,87061
498,430,68,-,-,87062
126,102,24,-,93900,87063
67,67,0,-,92000,87064
2025,1834,191,871,237700,87068
10,0,10,-,-,87070
170,155,15,-,214100,87072
278,246,32,1417,182000,87083
0,0,0,-,-,87101
10324,3643,6681,828,170900,87102
5737,3703,2034,1017,292300,87104
18911,13736,5175,905,174900,87105
12031,4989,7042,859,311600,87106
12505,7775,4730,887,278400,87107
17252,6124,11128,771,207000,87108
19259,9652,9607,1053,280900,87109
18112,10808,7304,1046,237400,87110
26600,16344,10256,1231,330300,87111
19008,11558,7450,970,231800,87112
6603,4872,1731,1472,337900,87113
26747,18253,8494,1220,272400,87114
1359,40,1319,1607,-,87116
0,0,0,-,-,87117
26258,20735,5523,1266,248800,87120
25812,19379,6433,1251,172800,87121
6730,6186,544,1788,592600,87122
18943,12216,6727,913,225300,87123
21520,16851,4669,1262,236100,87124
17268,14654,2614,1461,259400,87144
0,0,0,-,-,87151
7247,4030,3217,838,141800,87301
574,562,12,-,50300,87305
311,304,7,-,64000,87310
1298,1041,257,834,39300,87311
195,172,23,-,34300,87312
1577,1110,467,441,64300,87313
121,121,0,-,-,87315
475,280,195,1101,78600,87316
461,382,79,-,-,87317
676,563,113,907,34400,87319
198,176,22,775,34400,87320
723,531,192,1114,139400,87321
147,143,4,-,-,87322
1459,1328,131,857,91600,87323
644,568,76,667,58500,87325
655,631,24,-,54000,87326
1814,1507,307,598,73800,87327
832,295,537,588,48400,87328
105,75,30,-,155100,87347
334,147,187,595,-,87357
472,421,51,481,80100,87364
20,17,3,-,-,87365
1166,1074,92,1319,43800,87375
15463,9578,5885,970,193800,87401
3605,2744,861,1002,265500,87402
5925,4541,1384,841,183400,87410
462,408,54,-,137100,87412
5052,3798,1254,852,162100,87413
910,644,266,1260,194700,87415
1372,1096,276,795,87200,87416
1589,1058,531,779,160400,87417
355,334,21,-,187900,87418
138,87,51,-,114700,87419
3224,1967,1257,641,86100,87420
493,408,85,1563,104700,87421
505,430,75,650,27400,87455
444,417,27,-,29600,87461
270,232,38,933,80000,87499
8409,5460,2949,1485,614500,87501
15497,9678,5819,1248,446800,87505
7029,5702,1327,1050,416400,87506
20139,13713,6426,1219,303000,87507
7367,6638,729,1589,478800,87508
395,303,92,-,314200,87510
835,734,101,379,225400,87511
67,67,0,-,-,87512
466,452,14,-,415900,87513
513,490,23,-,450000,87514
97,97,0,-,348000,87515
47,47,0,-,-,87516
150,150,0,-,262700,87517
0,0,0,-,-,87518
249,222,27,-,-,87519
544,465,79,-,206500,87520
378,306,72,850,185000,87521
1339,1096,243,908,216700,87522
160,143,17,-,110300,87523
99,99,0,-,-,87524
14,14,0,-,422200,87525
372,372,0,-,296000,87527
849,479,370,535,59000,87528
1986,1597,389,1384,392500,87529
428,428,0,-,270400,87530
132,132,0,-,200000,87531
7158,5041,2117,824,217400,87532
918,727,191,1324,363300,87535
908,652,256,585,196500,87537
147,147,0,-,174200,87538
35,35,0,-,-,87539
533,325,208,877,625800,87540
83,83,0,-,-,87543
6116,3961,2155,1226,406000,87544
2033,1968,65,1356,420000,87547
367,261,106,933,-,87548
523,459,64,-,167600,87549
125,125,0,-,-,87551
889,664,225,901,-,87552
528,397,131,718,181300,87553
0,0,0,-,-,87554
907,754,153,853,191800,87556
1990,1755,235,1240,371600,87557
438,251,187,934,422300,87558
617,469,148,680,130700,87560
125,110,15,-,-,87562
49,49,0,-,-,87564
193,193,0,-,-,87565
694,600,94,693,360900,87566
462,358,104,955,-,87567
203,197,6,-,180800,87569
4901,3554,1347,938,357200,87571
6,0,6,-,-,87573
278,187,91,-,-,87575
248,248,0,-,346500,87577
133,75,58,1145,215600,87578
613,515,98,-,99500,87579
161,161,0,-,-,87580
18,18,0,-,-,87581
429,331,98,-,252400,87582
177,146,31,-,111500,87583
7891,5078,2813,724,148100,87701
545,441,104,1264,366900,87710
290,265,25,-,39900,87711
205,205,0,-,-,87712
116,116,0,-,-,87713
538,266,272,628,150000,87714
136,113,23,-,-,87715
228,193,35,896,188800,87718
397,384,13,-,108400,87722
153,153,0,-,140500,87723
0,0,0,-,-,87724
204,141,63,521,85200,87728
45,45,0,-,541700,87729
7,7,0,-,-,87730
123,111,12,-,218100,87731
522,462,60,-,58900,87732
39,27,12,-,103800,87733
136,112,24,-,-,87734
32,32,0,-,-,87735
22,22,0,-,-,87736
3248,2323,925,666,122800,87740
153,153,0,-,245800,87742
143,92,51,1065,-,87743
498,498,0,-,122100,87745
35,32,3,-,217500,87746
657,498,159,568,108500,87747
48,48,0,-,-,87749
0,0,0,-,-,87750
320,236,84,638,-,87752
29,29,0,-,-,87753
3045,1997,1048,706,145900,87801
94,88,6,-,95700,87820
346,334,12,-,226400,87821
131,131,0,-,110100,87823
97,97,0,-,-,87824
749,601,148,-,99800,87825
157,107,50,-,250500,87827
132,122,10,-,160300,87828
443,401,42,-,171900,87829
229,154,75,733,121200,87830
89,71,18,-,-,87831
86,86,0,-,204100,87832
2687,1674,1013,682,101800,87901
207,182,25,-,219800,87930
335,216,119,-,145400,87931
0,0,0,-,-,87933
1022,882,140,1091,161700,87935
123,123,0,-,139500,87936
1024,827,197,463,99200,87937
125,125,0,-,372900,87939
133,93,40,-,-,87940
268,191,77,-,64000,87941
551,476,75,766,113600,87942
137,137,0,-,-,87943
15338,6375,8963,816,144800,88001
341,14,327,1280,-,88002
0,0,0,-,-,88003
0,0,0,-,-,88004
11067,6025,5042,814,189900,88005
9022,7332,1690,742,216100,88007
4194,3452,742,954,225100,88008
0,0,0,-,-,88009
13645,8226,5419,1004,297900,88011
11014,8191,2823,1191,189500,88012
298,246,52,-,150000,88020
5483,3953,1530,620,130500,88021
328,300,28,-,180000,88022
893,577,316,666,97700,88023
134,68,66,-,91400,88024
19,19,0,-,-,88025
555,380,175,788,108300,88026
231,165,66,600,204700,88027
147,114,33,-,240000,88028
487,250,237,379,77000,88029
8464,5712,2752,595,104300,88030
43,43,0,-,-,88034
101,101,0,-,232100,88038
229,210,19,-,161600,88039
37,37,0,-,55500,88040
462,405,57,-,-,88041
209,166,43,-,213300,88042
707,545,162,763,82300,88043
899,744,155,522,154200,88044
1158,767,391,690,86400,88045
351,194,157,985,264300,88046
563,510,53,471,98900,88047
1289,1098,191,717,98700,88048
419,389,30,-,189600,88049
34,16,18,-,191700,88051
62,37,25,-,-,88052
102,45,57,677,284400,88053
15,15,0,-,-,88055
101,87,14,-,137500,88056
7153,4867,2286,825,178300,88061
3986,2860,1126,707,114600,88063
277,219,58,-,167800,88065
736,577,159,-,107700,88072
4500,3180,1320,754,90200,88081
17359,10102,7257,956,153400,88101
0,0,0,-,-,88103
143,120,23,-,359500,88112
34,15,19,-,-,88113
29,29,0,-,235000,88114
7,7,0,-,-,88115
175,151,24,-,-,88116
102,92,10,-,214300,88118
695,460,235,688,250000,88119
192,108,84,713,142200,88120
73,54,19,-,150000,88121
382,319,63,810,124500,88124
19,6,13,-,-,88125
6,6,0,-,-,88126
6480,3851,2629,800,128700,88130
100,49,51,-,126100,88132
37,17,20,-,-,88134
547,423,124,1036,110500,88135
37,25,12,-,-,88136
9830,6870,2960,951,192500,88201
10700,6828,3872,745,109200,88203
6823,4783,2040,1017,203700,88210
14873,11094,3779,1151,180700,88220
1780,1282,498,846,99300,88230
1286,1002,284,1119,130300,88231
647,513,134,591,110800,88232
14207,8932,5275,1059,161400,88240
2537,2074,463,1168,213200,88242
0,0,0,-,-,88244
128,67,61,-,-,88250
822,583,239,750,112800,88252
377,239,138,1096,154200,88253
14,0,14,-,-,88254
37,37,0,-,-,88255
691,559,132,1170,164200,88256
4835,3587,1248,932,161400,88260
2,2,0,-,-,88262
56,56,0,-,232100,88263
0,0,0,-,-,88264
61,61,0,-,261900,88265
600,409,191,840,91500,88267
0,0,0,-,-,88268
651,558,93,582,85500,88301
15187,9809,5378,851,153400,88310
355,314,41,-,85700,88311
1246,1216,30,-,312500,88312
52,52,0,-,-,88314
1061,943,118,906,148700,88316
815,690,125,746,201600,88317
168,132,36,-,218800,88318
113,88,25,-,1088200,88321
0,0,0,-,-,88323
44,44,0,-,-,88324
461,400,61,-,249000,88325
1129,0,1129,1209,-,88330
245,227,18,-,-,88336
848,657,191,708,123400,88337
108,68,40,-,184900,88338
255,255,0,-,278500,88339
985,625,360,308,43800,88340
265,257,8,-,226800,88341
0,0,0,-,-,88342
12,12,0,-,-,88343
23,23,0,-,140300,88344
3735,2489,1246,846,230000,88345
1070,712,358,765,-,88346
0,0,0,-,-,88347
204,204,0,-,-,88348
0,0,0,-,-,88349
26,26,0,-,-,88350
132,98,34,575,268200,88351
1251,1065,186,875,118100,88352
154,79,75,414,48500,88353
44,44,0,-,-,88354
96,54,42,-,-,88355
2852,1825,1027,708,65800,88401
51,51,0,-,-,88410
32,30,2,-,306300,88411
49,20,29,-,38900,88414
1133,737,396,581,122600,88415
112,112,0,-,-,88416
20,0,20,-,-,88417
155,98,57,728,159600,88418
19,15,4,-,184400,88419
19,0,19,-,-,88421
53,24,29,-,-,88422
21,19,2,-,-,88424
511,429,82,1081,104500,88426
40,37,3,-,85800,88427
91,70,21,-,-,88430
42,42,0,-,-,88431
122,82,40,606,65600,88434
1011,842,169,408,117800,88435
28,20,8,-,-,88436
0,0,0,-,-,88439
478,314,164,721,154100,89001
12945,10620,2325,1714,384200,89002
378,167,211,779,134100,89003
111,79,32,-,552100,89004
6133,4547,1586,1257,401100,89005
216,183,33,-,320600,89007
436,298,138,629,169600,89008
188,128,60,565,113800,89010
12959,8708,4251,1615,406300,89011
15800,9876,5924,1786,440700,89012
115,89,26,-,86300,89013
16635,8293,8342,1497,377900,89014
15156,9456,5700,1236,348000,89015
22,22,0,-,-,89017
302,205,97,944,298700,89018
1150,807,343,769,249400,89019
667,410,257,583,119600,89020
825,751,74,985,398500,89021
0,0,0,-,-,89022
386,298,88,755,287500,89025
0,0,0,-,-,89026
7602,5741,1861,1075,301700,89027
4410,2231,2179,930,229100,89029
15445,5274,10171,1045,222000,89030
23430,16958,6472,1708,341700,89031
15425,9437,5988,1499,309200,89032
1446,1379,67,1805,453100,89034
178,118,60,788,80000,89039
1616,1141,475,1084,200400,89040
357,256,101,907,246200,89042
352,322,30,-,171700,89043
11170,9408,1762,1890,483400,89044
925,497,428,972,72500,89045
221,154,67,494,114900,89046
73,34,39,-,38900,89047
10189,7343,2846,1105,261600,89048
1203,665,538,775,167300,89049
23914,14978,8936,1809,528000,89052
90,90,0,-,-,89054
5129,4248,881,902,208800,89060
3326,2956,370,1470,286400,89061
0,0,0,-,-,89070
20751,11943,8808,1681,401700,89074
12672,8334,4338,1725,353400,89081
11293,8074,3219,1760,415400,89084
1510,1242,268,2260,430800,89085
2768,1160,1608,1487,370600,89086
15867,3015,12852,902,235000,89101
15280,4437,10843,1115,343600,89102
22318,6946,15372,1196,248500,89103
14864,6350,8514,1068,272100,89104
9616,3111,6505,1121,232300,89106
12878,6666,6212,1255,273300,89107
26668,12653,14015,1312,274100,89108
3269,1186,2083,1159,489100,89109
21453,11547,9906,1220,278000,89110
14501,8326,6175,1654,429900,89113
19413,6891,12522,1190,234300,89115
22814,10866,11948,1495,443000,89117
8982,3694,5288,1446,372600,89118
22029,4416,17613,1117,279400,89119
9423,5333,4090,1313,329700,89120
24049,12152,11897,1206,256800,89121
19166,11106,8060,1259,262700,89122
23140,12994,10146,1518,396700,89123
315,292,23,1113,446700,89124
15423,7675,7748,1480,341600,89128
20658,14240,6418,1667,392300,89129
12862,9358,3504,1511,368800,89130
17350,13413,3937,1852,464700,89131
11624,9544,2080,1892,402800,89134
13293,9732,3561,2194,612600,89135
7804,6269,1535,2364,692800,89138
13863,8738,5125,1760,422400,89139
13352,9931,3421,1896,463600,89141
10495,6429,4066,1355,289600,89142
4113,3007,1106,1731,391300,89143
7974,5189,2785,1795,474700,89144
9868,6477,3391,1415,315800,89145
7735,3167,4568,1292,395000,89146
21139,10781,10358,1645,345800,89147
22790,13398,9392,1775,416200,89148
16130,10934,5196,1709,460900,89149
9779,5563,4216,1213,256000,89156
351,191,160,2200,1443200,89158
178,149,29,-,464800,89161
9484,6740,2744,1672,426000,89166
10456,2105,8351,1076,255000,89169
14454,10328,4126,1849,419800,89178
3877,3152,725,1956,380600,89179
14711,7732,6979,1634,359800,89183
4,0,4,-,-,89191
2568,1804,764,942,199100,89301
121,79,42,-,112500,89310
77,50,27,-,-,89311
76,45,31,500,61700,89314
13,13,0,-,-,89315
327,223,104,843,217700,89316
141,141,0,-,247000,89317
424,348,76,1167,135200,89318
117,117,0,-,68500,89319
84,59,25,-,"2,000,000+",89402
6439,5202,1237,1266,352100,89403
23,23,0,-,-,89404
62,0,62,-,-,89405
9595,6419,3176,1142,255200,89406
8538,6167,2371,1397,328200,89408
49,21,28,-,-,89409
4947,3402,1545,1266,511300,89410
480,449,31,-,978600,89411
34,13,21,-,-,89412
320,306,14,-,"2,000,000+",89413
58,39,19,-,-,89414
1404,1042,362,1016,167600,89415
93,93,0,-,-,89418
1365,876,489,658,173000,89419
21,7,14,-,-,89420
188,156,32,-,65000,89421
91,87,4,-,-,89422
4472,3847,625,1689,596500,89423
162,135,27,517,53400,89424
214,168,46,-,224600,89425
66,60,6,-,-,89426
365,254,111,537,84700,89427
39,28,11,-,339100,89428
3342,2804,538,1276,245700,89429
56,42,14,-,-,89430
15055,6939,8116,1183,303200,89431
7177,4957,2220,1154,285600,89433
10645,6675,3970,1708,405500,89434
17354,12864,4490,1894,482000,89436
0,0,0,-,-,89437
16,16,0,-,-,89438
834,686,148,1106,681300,89439
385,385,0,-,325600,89440
4892,4357,535,1990,567800,89441
303,170,133,889,113500,89442
1599,1385,214,1168,425300,89444
6836,4821,2015,924,249600,89445
0,0,0,-,-,89446
3668,2570,1098,802,221300,89447
909,750,159,1796,1267600,89448
1446,817,629,1496,731500,89449
0,0,0,-,-,89450
3938,2765,1173,1967,1204800,89451
5458,4201,1257,1230,462800,89460
0,0,0,-,-,89496
2659,585,2074,1012,376800,89501
19344,6639,12705,1156,355900,89502
12770,5693,7077,1249,406300,89503
15638,10581,5057,1582,357400,89506
4848,4493,355,1848,394300,89508
16772,8859,7913,1364,625100,89509
566,512,54,606,489700,89510
12246,8278,3968,1708,841500,89511
11544,3182,8362,1057,295500,89512
3918,3110,808,1934,810000,89519
15180,10854,4326,1999,584600,89521
15614,9528,6086,1636,512000,89523
23,0,23,-,-,89557
10846,6543,4303,1151,378800,89701
4862,3538,1324,921,544600,89703
1811,1732,79,1201,527200,89704
2226,1732,494,1368,421800,89705
8326,4890,3436,1160,314600,89706
9742,6124,3618,1141,270200,89801
5115,4604,511,1464,297300,89815
2148,1634,514,857,200600,89820
222,189,33,1071,-,89821
868,518,350,1174,187100,89822
171,165,6,-,454300,89823
316,138,178,610,-,89825
0,0,0,-,-,89826
126,113,13,-,-,89828
35,35,0,-,-,89830
22,22,0,-,-,89831
377,210,167,521,58900,89832
82,44,38,-,-,89833
20,9,11,-,-,89834
428,321,107,965,215600,89835
1836,796,1040,770,168900,89883
13597,4736,8861,1377,487800,90001
13013,5314,7699,1434,462400,90002
17936,4845,13091,1407,494600,90003
23047,3794,19253,1680,1289600,90004
16607,1301,15306,1572,1020300,90005
19100,2033,17067,1346,781400,90006
12520,1329,11191,1396,789700,90007
14694,4632,10062,1468,920700,90008
2381,394,1987,2349,904600,90010
24399,6519,17880,1425,531600,90011
14945,957,13988,2044,702100,90012
7781,625,7156,1092,755100,90013
6100,212,5888,1424,654000,90014
12838,1107,11731,2287,904900,90015
17601,6403,11198,1595,838500,90016
13564,734,12830,1493,708900,90017
16339,5369,10970,1486,850900,90018
23576,5895,17681,1708,1151500,90019
17321,1630,15691,1652,704900,90020
1459,100,1359,961,1046900,90021
17165,5949,11216,1322,574300,90022
11750,3095,8655,1376,586500,90023
16843,5602,11241,2618,1451200,90024
22166,5486,16680,2418,1072300,90025
26230,6225,20005,1702,1108500,90026
21331,4462,16869,1840,1578200,90027
17228,690,16538,1722,879100,90028
12836,1485,11351,1541,1032300,90029
11960,3921,8039,1416,689000,90031
13427,7254,6173,1448,694800,90032
13341,2632,10709,1311,632200,90033
25261,5137,20124,2124,1316100,90034
11420,3657,7763,2374,1657200,90035
19753,2915,16838,2622,1869500,90036
17571,4416,13155,1374,598700,90037
12929,1026,11903,1697,1020800,90038
12052,5662,6390,1996,1139300,90039
3441,1838,1603,1337,550500,90040
9875,5150,4725,1747,1042100,90041
21199,9549,11650,1756,850700,90042
17132,9093,8039,1389,816600,90043
27738,8441,19297,1397,551800,90044
15852,7596,8256,2790,1277400,90045
28346,6110,22236,2071,1389100,90046
17202,9291,7911,1471,612200,90047
11564,3342,8222,2284,1694500,90048
16151,8793,7358,2827,"2,000,000+",90049
0,0,0,-,-,90052
3432,1984,1448,2245,1358200,90056
16986,511,16475,1369,625000,90057
1039,138,901,941,457500,90058
10351,4797,5554,1248,486500,90059
7666,3094,4572,1393,513300,90061
9802,4624,5178,1451,632300,90062
13529,5028,8501,1404,587000,90063
11414,5944,5470,2554,1655300,90064
16200,7704,8496,1709,959500,90065
24679,9061,15618,2082,1519200,90066
1719,1120,599,"3,500+",1529200,90067
11740,5447,6293,2107,1724100,90068
13004,5293,7711,2183,1026300,90069
8,8,0,-,-,90071
0,0,0,-,-,90073
3001,2560,441,2803,"2,000,000+",90077
0,0,0,-,-,90079
6,0,6,-,-,90089
5903,1773,4130,"3,500+",1258800,90094
0,0,0,-,-,90095
24126,5035,19091,1512,511100,90201
7893,5853,2040,3034,"2,000,000+",90210
3784,1534,2250,2494,"2,000,000+",90211
5483,1221,4262,2664,"2,000,000+",90212
13710,8531,5179,1410,464900,90220
12588,6780,5808,1488,482400,90221
8568,4356,4212,1405,509400,90222
13290,7686,5604,2300,984600,90230
7183,3088,4095,2465,1391000,90232
7685,4967,2718,1913,710700,90240
14476,6069,8407,1775,707200,90241
12627,6165,6462,1824,634800,90242
7075,2985,4090,2476,1479000,90245
16120,6433,9687,1644,600100,90247
3947,2532,1415,1640,617100,90248
8733,5255,3478,1523,643900,90249
32230,10322,21908,1643,758600,90250
8882,4564,4318,2659,1862400,90254
18718,5646,13072,1354,528400,90255
10242,4455,5787,1794,688100,90260
15168,7523,7645,1488,540500,90262
0,0,0,-,-,90263
6360,5034,1326,3136,"2,000,000+",90265
13400,9391,4009,3366,"2,000,000+",90266
6347,1918,4429,1392,565500,90270
8135,6329,1806,3109,"2,000,000+",90272
9273,8235,1038,3227,"2,000,000+",90274
15414,12297,3117,3290,1412200,90275
16533,7813,8720,2463,1317500,90277
15776,9041,6735,2406,1164300,90278
23885,10705,13180,1401,578900,90280
2081,1507,574,"3,500+",1394200,90290
13670,4864,8806,2439,"2,000,000+",90291
13355,4309,9046,3437,1217000,90292
6657,3202,3455,2628,955500,90293
12142,3122,9020,1616,637000,90301
10340,3243,7097,1719,707100,90302
6894,2666,4228,1648,684700,90303
7174,2107,5067,1388,682400,90304
5894,3522,2372,1820,728000,90305
4789,295,4494,2377,1743800,90401
4777,3556,1221,2162,"2,000,000+",90402
13064,3584,9480,2362,1597800,90403
10492,2307,8185,2072,1097600,90404
14000,4363,9637,2148,1683300,90405
14607,6816,7791,1771,824600,90501
6457,4475,1982,1869,587000,90502
17183,8779,8404,2210,991400,90503
11654,7190,4464,2110,854800,90504
14113,7929,6184,2215,1095000,90505
0,0,0,-,-,90506
10812,6386,4426,1745,708400,90601
7905,3098,4807,1624,684600,90602
6428,5065,1363,2228,738800,90603
11667,7525,4142,1755,650100,90604
10917,7365,3552,1752,632300,90605
8645,6056,2589,1779,592600,90606
13223,9746,3477,2206,693200,90620
10892,3988,6904,1927,732400,90621
5045,3374,1671,2138,868400,90623
16137,10842,5295,2313,822500,90630
22289,13384,8905,1872,716700,90631
14908,11360,3548,1940,706600,90638
0,0,0,-,-,90639
19348,8982,10366,1701,628600,90640
26508,17929,8579,1860,593100,90650
16665,11477,5188,1702,596500,90660
5345,3436,1909,1789,588600,90670
10007,5022,4985,1864,532600,90680
4484,2323,2161,2128,697900,90701
15850,11880,3970,2735,860900,90703
1397,445,952,1793,978100,90704
24065,9397,14668,1686,619400,90706
9276,5022,4254,1441,606400,90710
10193,7532,2661,2334,696400,90712
9343,7906,1437,2469,731000,90713
6515,3405,3110,2069,628000,90715
3631,1709,1922,1694,480300,90716
8327,3722,4605,1740,732200,90717
8208,5306,2902,2366,1127100,90720
14378,5849,8529,1699,470800,90723
23249,7878,15371,1606,751400,90731
8743,6299,2444,2409,748100,90732
13011,9928,3083,2305,476600,90740
308,140,168,2179,1160700,90742
188,128,60,2625,"2,000,000+",90743
14949,5087,9862,1365,557600,90744
15441,10682,4759,1756,601300,90745
8441,7222,1219,2660,645200,90746
0,0,0,-,-,90747
4604,2425,2179,1842,690100,90755
21734,4599,17135,1755,521800,90802
17082,7500,9582,1949,1102400,90803
14967,3154,11813,1710,630300,90804
28163,11960,16203,1545,564900,90805
12541,4284,8257,1489,632300,90806
12771,6990,5781,1819,772400,90807
14198,11785,2413,2204,854200,90808
9965,5677,4288,1442,551700,90810
17215,2401,14814,1464,470000,90813
9267,2998,6269,1867,823700,90814
15210,9874,5336,2151,840300,90815
0,0,0,-,-,90822
0,0,0,-,-,90831
0,0,0,-,-,90840
12408,9822,2586,2160,1002600,91001
10626,7630,2996,2050,1154100,91006
11860,5936,5924,2021,1229300,91007
282,261,21,-,1580900,91008
8340,5263,3077,1939,657700,91010
6455,5743,712,"3,500+",1982600,91011
14912,7281,7631,1949,820600,91016
3181,790,2391,2056,892500,91020
5018,2822,2196,1994,1141200,91024
10274,4787,5487,2135,1453500,91030
7383,5335,2048,1716,738900,91040
9974,5363,4611,1715,713200,91042
78,15,63,-,-,91046
10777,1614,9163,2161,669800,91101
8776,3981,4795,1770,900400,91103
13260,7161,6099,1892,955400,91104
5647,3249,2398,2999,1503300,91105
10572,3668,6904,2073,933200,91106
12675,7692,4983,2221,1045300,91107
4004,3298,706,"3,500+","2,000,000+",91108
86,0,86,-,-,91125
8014,2569,5445,1937,1036400,91201
8825,3688,5137,2187,1061900,91202
6856,1377,5479,2209,644900,91203
6536,462,6074,1844,768100,91204
13708,2140,11568,1815,780300,91205
12591,4509,8082,2052,1019300,91206
3989,2289,1700,2165,1163000,91207
5919,3788,2131,2250,1198100,91208
164,30,134,"3,500+",1000000,91210
10590,7737,2853,2298,1003600,91214
8846,7088,1758,3125,994500,91301
9644,6946,2698,2859,1561700,91302
10270,2336,7934,1879,626000,91303
18276,9273,9003,1847,786000,91304
14466,8155,6311,1765,652600,91306
8527,6936,1591,"3,500+",879700,91307
14220,9405,4815,2154,789500,91311
12625,6371,6254,1961,857300,91316
15056,11398,3658,2651,884500,91320
11068,6579,4489,1972,603300,91321
10084,4904,5180,2174,803400,91324
12773,5807,6966,1829,834300,91325
12719,9611,3108,2606,942700,91326
0,0,0,-,-,91330
22995,14495,8500,1694,583300,91331
24392,11934,12458,1763,642700,91335
8685,5386,3299,1697,599300,91340
24927,16724,8203,1862,605900,91342
18045,8940,9105,1717,698400,91343
17596,12761,4835,2101,809800,91344
5410,4062,1348,1882,617600,91345
13223,10796,2427,2339,684300,91350
10311,7646,2665,2171,557200,91351
12175,6468,5707,1720,657700,91352
10808,8567,2241,2789,736800,91354
11898,7676,4222,2469,686800,91355
11903,6842,5061,1926,1157700,91356
15146,10211,4935,2315,845700,91360
7752,5396,2356,2622,1242600,91361
13856,9725,4131,2641,977800,91362
10308,6895,3413,2794,1107700,91364
18234,8925,9309,2591,912900,91367
0,0,0,-,-,91371
5015,3577,1438,2963,927400,91377
6817,4266,2551,2457,964900,91381
7103,6032,1071,1788,645600,91384
14036,9012,5024,2351,665800,91387
6194,5412,782,2230,800000,91390
14963,5073,9890,1731,911700,91401
20036,7194,12842,1525,563700,91402
11923,5000,6923,2305,1316400,91403
18370,4943,13427,1649,648600,91405
18792,7367,11425,1764,701900,91406
9218,2735,6483,1804,876700,91411
14902,5652,9250,2154,1256200,91423
5965,4624,1341,3258,1738100,91436
7731,2925,4806,1985,963300,91501
5585,537,5048,1817,889000,91502
10224,5639,4585,2072,923800,91504
13017,5970,7047,2229,927200,91505
8103,4698,3405,1856,984800,91506
17625,2999,14626,1967,876100,91601
10057,3247,6810,2084,996300,91602
14449,6356,8093,2365,1549300,91604
16145,6347,9798,1661,682200,91605
15339,5204,10135,1673,763600,91606
13751,4237,9514,1927,985900,91607
41,0,41,1811,-,91608
13098,10278,2820,2118,664100,91701
16947,9913,7034,1798,569000,91702
18343,10943,7400,1755,555200,91706
4702,2263,2439,2599,602100,91708
25192,17767,7425,2575,775900,91709
23254,15628,7626,1819,603800,91710
12893,8434,4459,1983,839400,91711
10024,6755,3269,1898,588200,91722
6164,2395,3769,1650,634800,91723
9052,6254,2798,2026,664900,91724
24998,12106,12892,2137,558600,91730
8370,2856,5514,1508,585800,91731
15614,6776,8838,1672,604300,91732
10952,4750,6202,1600,576400,91733
7902,5598,2304,2308,775700,91737
11586,8461,3125,2303,798600,91739
8393,5479,2914,2092,647000,91740
8703,6227,2476,2073,875100,91741
18445,12685,5760,1807,556300,91744
16388,12369,4019,2084,742500,91745
7139,5352,1787,1680,595800,91746
13654,8786,4868,1861,730300,91748
12316,8438,3878,2006,734500,91750
9679,5931,3748,1944,583400,91752
11919,6496,5423,1784,808600,91754
8466,3804,4662,1802,704600,91755
150,126,24,1359,350000,91759
17767,11707,6060,1820,543400,91761
18412,10139,8273,1665,512800,91762
10096,5517,4579,1711,484900,91763
16525,7400,9125,1979,475300,91764
15081,11633,3448,2310,839700,91765
19218,10158,9060,1654,517500,91766
14736,8129,6607,1651,547900,91767
8407,4621,3786,1546,485900,91768
16458,8482,7976,1674,673800,91770
11910,8410,3500,2202,714400,91773
8245,5396,2849,1922,976500,91775
11437,4850,6587,1742,777500,91776
11617,7033,4584,1984,875200,91780
8853,7562,1291,2663,801400,91784
19495,8454,11041,1798,573100,91786
12698,10412,2286,2690,910400,91789
12735,8039,4696,2113,653400,91790
10793,7213,3580,1806,715400,91791
9256,5318,3938,2136,619200,91792
19985,7391,12594,1810,761100,91801
10100,4933,5167,1735,772000,91803
6425,4666,1759,1963,740000,91901
6033,4849,1184,2043,843400,91902
530,438,92,427,339800,91905
1280,934,346,1158,302800,91906
25709,13178,12531,1830,621200,91910
25537,13072,12465,1875,574200,91911
16135,11554,4581,2786,675600,91913
4750,3754,996,3084,865900,91914
10019,7147,2872,2788,692300,91915
587,444,143,"3,500+",576900,91916
229,182,47,1608,574500,91917
318,274,44,-,-,91931
9115,2823,6292,1841,744100,91932
425,252,173,-,325800,91934
3025,2810,215,1942,793400,91935
12440,8004,4436,1867,842300,91941
17368,7467,9901,1809,645500,91942
9182,4948,4234,1693,593300,91945
44,44,0,-,275000,91948
17728,5952,11776,1486,504300,91950
1012,943,69,2683,459700,91962
140,82,58,-,371100,91963
19647,12277,7370,1813,589400,91977
3392,2104,1288,2200,528000,91978
14,14,0,-,-,91980
1744,1166,578,2032,838000,92003
1576,1167,409,986,377800,92004
4387,2775,1612,2506,1658800,92007
11753,5727,6026,2223,1051400,92008
16152,11417,4735,2825,1158900,92009
6629,4337,2292,2465,899000,92010
9378,5823,3555,2894,1079100,92011
5489,3954,1535,3087,"2,000,000+",92014
15118,10405,4713,1977,675400,92019
19725,8436,11289,1695,676200,92020
22877,11857,11020,1721,545600,92021
19490,12817,6673,2471,1299800,92024
17008,7172,9836,1700,705700,92025
19009,11659,7350,1943,632600,92026
17331,10378,6953,1844,609400,92027
16898,11765,5133,1637,710800,92028
7619,5669,1950,2212,850900,92029
1428,1209,219,1477,537700,92036
16275,10065,6210,2327,1839900,92037
15507,10376,5131,1779,613500,92040
15014,5899,9115,1784,753400,92054
0,0,0,-,-,92055
19695,12926,6769,2301,646800,92056
18698,12802,5896,2381,624600,92057
14149,4097,10052,2471,571200,92058
442,276,166,1549,390600,92059
148,148,0,-,625000,92060
746,628,118,-,652300,92061
16180,12207,3973,2165,911900,92064
12113,9092,3021,1853,678800,92065
158,100,58,-,365200,92066
3181,2884,297,"3,500+","2,000,000+",92067
14930,8271,6659,1987,659900,92069
300,147,153,1375,425900,92070
20727,15156,5571,1982,603100,92071
5110,3381,1729,2853,1617500,92075
18045,12675,5370,2274,787600,92078
10596,5666,4930,2323,681400,92081
6336,5515,821,1281,719600,92082
11259,5443,5816,1929,564500,92083
15007,8662,6345,1845,689500,92084
548,471,77,1368,342100,92086
668,570,98,"3,500+",1584200,92091
0,0,0,-,-,92092
0,0,0,-,-,92093
0,0,0,-,-,92096
27295,6849,20446,2222,751800,92101
14482,4623,9859,1783,548700,92102
18834,6797,12037,1900,912900,92103
22454,6365,16089,1805,776100,92104
22847,7368,15479,1549,560800,92105
7519,4571,2948,2194,1241800,92106
13653,4885,8768,1988,1146100,92107
12637,3764,8873,2521,586100,92108
21783,6952,14831,2198,1082700,92109
12296,4464,7832,2170,810100,92110
16911,8944,7967,1973,681200,92111
13719,3767,9952,1532,491600,92113
18293,12914,5379,1728,564200,92114
21271,8105,13166,1779,668000,92115
16421,5536,10885,1823,817700,92116
20750,11588,9162,2026,836800,92117
6549,3554,2995,3046,1872000,92118
9311,6905,2406,2031,743000,92119
11882,7583,4299,2233,807000,92120
1658,803,855,2433,1017800,92121
19549,6608,12941,2461,894700,92122
12222,5495,6727,2629,737000,92123
11383,5034,6349,2907,818100,92124
25122,13242,11880,2460,715900,92126
15895,11048,4847,2442,1096000,92127
20428,13370,7058,2620,788200,92128
18040,12994,5046,2555,932400,92129
20810,13119,7691,3090,1438500,92130
12623,10116,2507,2865,1064400,92131
0,0,0,-,-,92132
0,0,0,-,-,92134
0,0,0,-,-,92135
16,0,16,-,-,92136
9960,5887,4073,1979,567600,92139
0,0,0,-,-,92140
0,0,0,-,-,92145
0,0,0,-,-,92147
23076,14327,8749,1986,578700,92154
0,0,0,-,-,92155
0,0,0,-,-,92161
7998,2338,5660,1449,464500,92173
0,0,0,-,-,92179
0,0,0,-,-,92182
23790,14440,9350,1304,321000,92201
12109,9888,2221,1743,448000,92203
2581,2010,571,873,941200,92210
13181,9442,3739,1776,482000,92211
11788,8490,3298,1390,300000,92220
0,0,0,-,-,92222
19156,15451,3705,1413,423100,92223
5367,3145,2222,880,186500,92225
7839,4194,3645,927,261700,92227
719,584,135,986,242300,92230
9413,4768,4645,1086,263200,92231
1151,760,391,833,191100,92233
18868,12133,6735,1445,381800,92234
13996,9512,4484,982,301900,92236
120,94,26,-,140500,92239
14278,7505,6773,1277,272600,92240
3725,3141,584,838,96800,92241
628,521,107,773,126200,92242
13520,7106,6414,936,260400,92243
1834,1248,586,931,252000,92249
2073,1119,954,756,272700,92250
6049,4114,1935,1309,313600,92251
3347,2251,1096,1122,272800,92252
15371,11411,3960,1779,560500,92253
3390,2433,957,881,177500,92254
1559,1081,478,1316,230900,92256
587,271,316,756,56400,92257
208,88,120,867,-,92258
145,97,48,-,158200,92259
14728,9650,5078,1478,424100,92260
13086,8109,4977,1332,540600,92262
11234,7697,3537,1492,456100,92264
113,34,79,939,-,92266
0,0,0,-,-,92267
232,194,38,-,490000,92268
8735,7100,1635,1642,690100,92270
373,222,151,874,161700,92273
5983,5168,815,830,128800,92274
521,458,63,-,150000,92275
2835,2229,606,1318,252800,92276
10511,4063,6448,1194,203000,92277
0,0,0,-,-,92278
0,0,0,-,-,92280
549,277,272,821,196600,92281
454,362,92,1216,264900,92282
596,333,263,725,74800,92283
10451,7112,3339,1183,271600,92284
1081,918,163,951,179000,92285
9259,5738,3521,1309,276100,92301
0,0,0,-,-,92304
172,141,31,-,463800,92305
13326,9100,4226,1297,356600,92307
14117,9822,4295,1315,333500,92308
216,73,143,774,96100,92309
2853,42,2811,1483,-,92310
11935,5617,6318,998,172300,92311
4652,2962,1690,1701,447900,92313
4372,3023,1349,1348,392200,92314
2252,1502,750,1126,509200,92315
7877,5304,2573,1435,424200,92316
279,217,62,1558,515300,92317
3767,3375,392,1656,343200,92320
373,314,59,956,477100,92321
336,336,0,-,378700,92322
17896,9563,8333,1460,376200,92324
3359,2467,892,1572,325800,92325
351,102,249,769,-,92327
477,85,392,779,78700,92328
61,15,46,-,-,92332
203,151,52,1519,373600,92333
24907,11786,13121,1533,406600,92335
27112,21849,5263,1968,574800,92336
9618,7209,2409,1953,470500,92337
0,0,0,-,-,92338
433,269,164,1779,388300,92339
145,122,23,1113,309500,92341
2374,2075,299,1634,322800,92342
5761,4537,1224,2004,421900,92344
25630,15956,9674,1376,330400,92345
18015,12066,5949,1437,430400,92346
258,174,84,624,90300,92347
15,0,15,-,-,92350
2308,1974,334,1794,544500,92352
8132,3375,4757,1573,477900,92354
2462,1690,772,1073,205600,92356
329,279,50,1488,512000,92358
3261,2117,1144,1240,379800,92359
2218,1305,913,694,136800,92363
12,0,12,-,-,92364
910,667,243,933,144200,92365
296,172,124,1104,288700,92368
0,0,0,-,-,92369
5789,4356,1433,1495,330800,92371
1827,1438,389,1339,400000,92372
13078,7044,6034,1796,648200,92373
14590,8351,6239,1816,471700,92374
22026,12980,9046,1508,388100,92376
5337,4449,888,2126,480400,92377
164,130,34,1157,350000,92378
1914,1542,372,1680,341900,92382
16,0,16,-,-,92384
101,88,13,-,381800,92385
914,557,357,1820,358200,92386
111,94,17,-,-,92389
927,598,329,-,306300,92391
16786,11363,5423,1707,328200,92392
9657,6157,3500,1441,308600,92394
15343,8404,6939,1375,291200,92395
2319,1867,452,1512,426500,92397
652,344,308,627,137800,92398
18926,14009,4917,1463,435400,92399
720,139,581,1042,296000,92401
18914,9218,9696,1272,347300,92404
9377,4638,4739,1381,337300,92405
17625,10755,6870,1608,440600,92407
3721,1475,2246,1168,371100,92408
13378,5752,7626,1176,233700,92410
6594,3567,3027,1341,280100,92411
0,0,0,-,-,92415
6798,2893,3905,1489,439900,92501
24503,16215,8288,1701,489200,92503
15843,9958,5885,1640,457800,92504
14324,7287,7037,1856,463500,92505
14639,10994,3645,1777,605800,92506
17561,6056,11505,1625,472300,92507
10031,7950,2081,2511,633900,92508
19370,13870,5500,1661,453500,92509
493,31,462,1985,-,92518
0,0,0,-,-,92521
16620,10863,5757,1642,439500,92530
7928,6153,1775,2226,484700,92532
1040,900,140,1746,410800,92536
1369,1093,276,1012,311900,92539
13473,7390,6083,1228,199100,92543
16194,10872,5322,1436,316700,92544
15700,11042,4658,1761,313900,92545
2159,1580,579,1405,208200,92548
1440,1061,379,1327,449600,92549
8349,5600,2749,1867,391200,92551
19372,9782,9590,1759,371600,92553
11570,8894,2676,2251,474500,92555
14864,9882,4982,1878,435600,92557
729,595,134,1432,436700,92561
20620,14126,6494,2148,586500,92562
22250,16119,6131,2264,584300,92563
2703,2032,671,1322,457300,92567
14325,9673,4652,1354,376300,92570
13832,9769,4063,1830,382500,92571
5228,4330,898,2260,404200,92582
9495,6246,3249,1381,297400,92583
15884,13119,2765,2251,494300,92584
7448,6357,1091,2100,447100,92585
9096,6755,2341,1482,324700,92586
6207,4757,1450,2112,517400,92587
1962,695,1267,1205,1115800,92590
13641,8285,5356,2137,610600,92591
24778,19533,5245,2435,625800,92592
10136,7716,2420,1868,482400,92595
9417,7696,1721,2343,581200,92596
9405,4060,5345,2786,1116300,92602
7267,4062,3205,3313,1603500,92603
10364,6399,3965,2629,919800,92604
9026,3263,5763,2713,947400,92606
4555,3576,979,2843,876400,92610
14404,4015,10389,2625,896300,92612
11626,4412,7214,2625,912300,92614
4358,1310,3048,1513,691900,92617
22546,8883,13663,2841,1103600,92618
21469,12047,9422,3024,1142700,92620
2731,1646,1085,2429,1065500,92624
5807,3380,2427,"3,500+","2,000,000+",92625
19313,8100,11213,2388,962000,92626
22380,8433,13947,2174,958000,92627
11446,7279,4167,2662,1158200,92629
23337,15895,7442,2451,828400,92630
11932,8224,3708,2136,358300,92637
21493,16297,5196,2406,951600,92646
21287,9183,12104,2336,903300,92647
19968,9350,10618,2232,1147000,92648
14589,8266,6323,2360,1023100,92649
11106,7578,3528,2724,"2,000,000+",92651
10772,7494,3278,2513,891400,92653
2510,755,1755,1469,687000,92655
20053,11506,8547,2615,804000,92656
3584,2618,966,3321,"2,000,000+",92657
15676,7882,7794,3179,"2,000,000+",92660
1708,644,1064,2655,"2,000,000+",92661
1173,675,498,2381,"2,000,000+",92662
10702,5092,5610,2513,1843900,92663
14940,7652,7288,2291,1174200,92672
9649,7686,1963,3028,1152100,92673
11769,8991,2778,2330,888200,92675
726,632,94,1858,744700,92676
25239,16669,8570,2736,1052800,92677
247,231,16,-,919000,92678
10410,9326,1084,3008,1148900,92679
27692,14526,13166,1978,777100,92683
15637,10901,4736,2446,819000,92688
16295,12408,3887,2463,867600,92691
16680,12904,3776,2684,903000,92692
11538,8611,2927,2870,978900,92694
0,0,0,-,-,92697
12741,3904,8837,1607,579400,92701
13524,6215,7309,1858,572100,92703
19931,10047,9884,2001,600900,92704
15310,9444,5866,2164,1074600,92705
10019,5281,4738,1765,773200,92706
14062,7058,7004,2040,606100,92707
18906,12455,6451,2412,932800,92708
17342,7900,9442,2070,798100,92780
11041,6696,4345,2656,1011300,92782
18780,6867,11913,1881,598700,92801
12149,4592,7557,1905,664600,92802
24586,10380,14206,1888,661400,92804
20917,8443,12474,1900,640600,92805
12550,5374,7176,2112,749500,92806
12389,10057,2332,2851,874400,92807
7721,5599,2122,2653,951100,92808
14658,8543,6115,2190,812600,92821
1796,1489,307,3207,972900,92823
12732,5205,7527,1976,746800,92831
8403,3016,5387,1946,690200,92832
16402,9367,7035,1985,757000,92833
9321,6520,2801,2218,937500,92835
15588,8629,6959,1862,678700,92840
9598,5251,4347,1850,706300,92841
11719,5679,6040,1800,630100,92843
6735,2800,3935,1994,667900,92844
5435,4260,1175,2578,835000,92845
6953,5753,1200,1884,684000,92860
1926,1737,189,-,1469200,92861
6983,4635,2348,2317,786900,92865
5534,1864,3670,1852,863100,92866
13203,8846,4357,2081,899100,92867
8354,2849,5505,2229,643500,92868
11497,8620,2877,2241,883600,92869
16982,10840,6142,2170,835300,92870
14040,8048,5992,1909,546900,92879
19333,14555,4778,2563,668700,92880
9204,7458,1746,2085,677900,92881
19761,12556,7205,1945,623500,92882
11817,9460,2357,2559,633500,92883
16715,13713,3002,2906,968400,92886
7098,6023,1075,2271,1035000,92887
12755,5808,6947,1758,735000,93001
20087,11854,8233,2003,704200,93003
11119,7351,3768,2207,691100,93004
16379,10620,5759,2299,747700,93010
13471,9283,4188,2656,746100,93012
6296,3723,2573,2249,994200,93013
5659,3385,2274,1844,525600,93015
11844,9420,2424,2453,805600,93021
2159,1647,512,2398,682800,93022
8389,5997,2392,1772,829200,93023
15040,6973,8067,1778,604600,93030
16851,9708,7143,1796,519600,93033
9137,5550,3587,2280,686300,93035
13763,7461,6302,2117,615000,93036
529,347,182,1649,467600,93040
7430,3294,4136,1958,497600,93041
0,0,0,-,-,93042
0,0,0,-,-,93043
10103,5373,4730,1648,545000,93060
19936,14471,5465,2297,697100,93063
0,0,0,-,-,93064
25047,18420,6627,2490,710200,93065
1024,707,317,2318,1248500,93066
418,285,133,2170,1489300,93067
12401,2768,9633,2009,1036800,93101
7523,3624,3899,2263,1332400,93103
10783,5801,4982,2415,1405700,93105
24,0,24,-,-,93106
4581,3400,1181,"3,500+","2,000,000+",93108
4587,2506,2081,2874,1705700,93109
6508,3929,2579,2206,953600,93110
6304,4199,2105,2719,1094300,93111
17009,6477,10532,1936,932400,93117
298,108,190,919,88600,93201
1021,658,363,1328,219700,93202
4842,2507,2335,1063,229300,93203
3067,1373,1694,1043,211100,93204
897,536,361,1030,139000,93205
481,214,267,1028,203100,93206
85,70,15,-,237500,93207
105,105,0,-,319200,93208
4619,2420,2199,946,230300,93210
4540,2319,2221,978,209800,93212
12328,7344,4984,1053,248400,93215
151,106,45,1179,158700,93218
2427,1098,1329,902,211100,93219
0,0,0,-,-,93220
4661,3018,1643,1248,315300,93221
1050,890,160,1404,346300,93222
2763,1859,904,867,226500,93223
158,124,34,1159,158300,93224
2062,1430,632,1187,282100,93225
35,23,12,-,216100,93226
74,32,42,-,-,93227
21942,13351,8591,1181,294300,93230
1690,361,1329,949,234500,93234
1253,703,550,888,205000,93235
67,20,47,-,-,93237
400,395,5,-,244500,93238
525,90,435,1038,135000,93239
2446,1711,735,1018,189100,93240
4387,1667,2720,905,175900,93241
925,564,361,1083,510100,93242
504,281,223,2147,343200,93243
62,52,10,-,167600,93244
11788,5802,5986,1468,305300,93245
0,0,0,-,-,93246
5309,3025,2284,914,256100,93247
541,176,365,838,156000,93249
3600,1878,1722,1039,234700,93250
80,35,45,594,231300,93251
622,342,280,943,164500,93252
329,248,81,988,184600,93254
419,372,47,-,134000,93255
1452,683,769,1027,199200,93256
23692,13287,10405,1057,250100,93257
374,84,290,897,-,93258
77,69,8,-,252500,93260
529,190,339,803,174400,93261
0,0,0,-,-,93262
5914,3646,2268,1146,247300,93263
1192,1137,55,-,339700,93265
369,152,217,1137,242900,93266
1664,1262,402,934,181800,93267
5692,2623,3069,957,196100,93268
1644,1012,632,1031,248100,93270
1200,801,399,1362,404900,93271
1117,382,735,1173,233800,93272
22523,13020,9503,1239,286500,93274
55,29,26,638,110400,93276
18525,11098,7427,1307,293300,93277
6387,3777,2610,925,226500,93280
1172,1056,116,1105,115700,93283
1328,1004,324,791,156500,93285
2916,1512,1404,908,264300,93286
59,58,1,-,246700,93287
18443,10795,7648,1196,366800,93291
13868,8723,5145,1379,295800,93292
5434,2025,3409,997,227300,93301
15205,6641,8564,1117,209500,93304
11081,3788,7293,1034,215700,93305
22116,13857,8259,1190,265600,93306
23152,11264,11888,1111,220400,93307
19913,9357,10556,1180,284400,93308
22145,10552,11593,1206,268800,93309
16105,11402,4703,1730,385200,93311
18163,14269,3894,1855,382800,93312
16200,12940,3260,1759,320200,93313
10803,9086,1717,1734,468900,93314
12794,5988,6806,1781,880900,93401
6394,4399,1995,1833,703300,93402
8439,2794,5645,1904,863500,93405
0,0,0,-,-,93407
0,0,0,-,-,93408
0,0,0,-,-,93409
0,0,0,-,-,93410
12470,8431,4039,2028,836500,93420
13275,8745,4530,1715,655700,93422
551,358,193,1446,1138200,93424
572,388,184,885,468500,93426
2251,1433,818,1953,733400,93427
2876,2131,745,1950,843400,93428
51,15,36,-,-,93429
1442,860,582,1549,940600,93430
525,429,96,1740,884900,93432
5140,2931,2209,1799,639400,93433
2080,1092,988,1456,409700,93434
18132,10128,8004,1458,438200,93436
1190,0,1190,2313,-,93437
424,343,81,536,639000,93440
421,353,68,1722,1208800,93441
5123,2976,2147,1727,809900,93442
7579,5606,1973,1891,730700,93444
2829,1800,1029,1301,491100,93445
17486,11987,5499,1679,621300,93446
4113,2659,1454,2199,943700,93449
225,99,126,1368,363200,93450
1550,962,588,1813,487100,93451
170,90,80,1450,289700,93452
1072,685,387,638,623900,93453
11611,6186,5425,1661,434300,93454
15609,11867,3742,2165,529600,93455
13893,6137,7756,1735,421800,93458
2386,1700,686,2516,1141500,93460
453,314,139,1714,430800,93461
3321,2000,1321,1826,979100,93463
3762,2915,847,2533,808200,93465
2022,941,1081,1094,145000,93501
4509,2712,1797,950,217000,93505
2418,2186,232,1714,664000,93510
152,131,21,-,273000,93512
693,506,187,972,320400,93513
5939,4224,1715,1326,399400,93514
998,570,428,1071,101400,93516
225,215,10,-,320700,93517
418,354,64,1418,257100,93518
0,0,0,-,-,93519
46,46,0,-,40600,93522
1215,272,943,2012,94600,93523
0,0,0,-,-,93524
342,248,94,1089,242900,93526
814,692,122,828,276000,93527
50,22,28,-,-,93528
141,115,26,-,588100,93529
28,7,21,-,-,93530
182,169,13,-,319400,93531
982,783,199,1500,380000,93532
15006,5231,9775,1421,298200,93534
22857,14666,8191,1473,300000,93535
22872,15559,7313,1813,450800,93536
247,206,41,-,369300,93541
3512,2456,1056,1623,329500,93543
545,455,90,-,316700,93544
580,369,211,893,238800,93545
3726,2343,1383,1297,569000,93546
123,80,43,1289,169200,93549
22916,12270,10646,1457,345200,93550
16966,13292,3674,2101,488600,93551
10826,8192,2634,1797,383300,93552
559,497,62,-,391400,93553
32,32,0,-,-,93554
13234,8295,4939,1139,222800,93555
8,8,0,-,-,93558
6759,4989,1770,1144,295500,93560
12203,9601,2602,1216,358100,93561
737,445,292,785,68900,93562
41,31,10,-,-,93563
0,0,0,-,-,93581
1991,1415,576,1359,261500,93591
570,453,117,927,354000,93601
1153,923,230,1311,339400,93602
141,75,66,-,-,93603
158,158,0,-,887300,93604
35,20,15,1354,-,93605
270,113,157,980,204000,93606
292,84,208,752,-,93608
1306,715,591,1172,258300,93609
5488,3012,2476,1077,300600,93610
15213,11517,3696,1982,426100,93611
13906,5591,8315,1286,289000,93612
4341,3917,424,1565,346500,93614
1468,666,802,1162,205000,93615
600,326,274,838,228200,93616
8339,4836,3503,1067,267800,93618
15647,13633,2014,2253,526100,93619
2979,1517,1462,1036,275900,93620
89,89,0,-,-,93621
2696,1286,1410,745,222700,93622
0,0,0,-,-,93623
196,29,167,705,-,93624
2579,1429,1150,1147,352400,93625
926,864,62,1156,600500,93626
46,0,46,-,-,93627
225,42,183,-,-,93628
5567,2699,2868,1139,308700,93630
5543,3762,1781,1129,352500,93631
26,26,0,-,-,93633
0,0,0,-,-,93634
13046,7472,5574,1419,394600,93635
4171,3753,418,1458,450900,93636
11353,6393,4960,1258,337500,93637
12166,6634,5532,1126,277800,93638
3276,1464,1812,809,239800,93640
89,76,13,-,-,93641
1352,1052,300,968,322600,93643
3030,2303,727,1303,375500,93644
280,161,119,-,283600,93645
2636,1039,1597,899,215000,93646
2737,1452,1285,917,223300,93647
3979,1917,2062,977,218900,93648
955,349,606,1178,296300,93650
576,340,236,1539,401600,93651
117,74,43,696,190000,93652
554,487,67,1611,504300,93653
8575,4836,3739,1132,301800,93654
1592,732,860,989,252600,93656
10604,6972,3632,1067,356200,93657
918,394,524,988,254300,93660
8896,4805,4091,1169,262900,93662
167,142,25,-,623300,93664
153,89,64,-,-,93665
184,38,146,740,218800,93666
795,644,151,1629,346000,93667
309,186,123,1272,324100,93668
88,67,21,-,294100,93669
35,0,35,-,-,93670
112,69,43,954,205100,93673
1368,1051,317,1202,287900,93675
3720,406,3314,851,206900,93701
12966,4117,8849,1044,182300,93702
10323,4332,5991,1090,220200,93703
11611,6084,5527,1297,347400,93704
13027,6033,6994,1160,255600,93705
11784,4264,7520,1035,217300,93706
12126,4863,7263,1212,328100,93710
16095,9950,6145,1473,450900,93711
18625,10793,7832,1889,434000,93720
2472,202,2270,899,217100,93721
26499,16007,10492,1437,322900,93722
3333,2586,747,1647,449900,93723
6788,4059,2729,1123,254000,93725
14979,5985,8994,1177,253800,93726
24012,14621,9391,1202,341800,93727
6376,2325,4051,1151,233000,93728
4637,3602,1035,2283,650100,93730
2071,1809,262,1566,436000,93737
0,0,0,-,-,93740
74,55,19,-,-,93741
10590,4822,5768,1700,658000,93901
13787,5540,8247,1698,513300,93905
17751,9825,7926,1981,568500,93906
7241,5145,2096,1941,642000,93907
4454,3619,835,1731,962100,93908
594,198,396,920,1166700,93920
1327,668,659,2705,1966500,93921
5401,4182,1219,2257,1444200,93923
2710,2180,530,1416,1071400,93924
306,131,175,1316,621200,93925
2451,1387,1064,1404,580300,93926
4494,2217,2277,1594,422100,93927
0,0,0,-,-,93928
4375,2344,2031,1544,391600,93930
199,138,61,969,457100,93932
9503,3840,5663,1855,692800,93933
14177,5806,8371,2212,960400,93940
6,0,6,-,-,93943
5,0,5,-,-,93944
6860,3355,3505,2302,1059900,93950
1582,1296,286,"3,500+",1596800,93953
106,37,69,1538,311900,93954
10665,4130,6535,2134,652300,93955
4702,2745,1957,1404,521400,93960
115,86,29,-,860000,93962
10854,6148,4706,2837,"2,000,000+",94002
1902,1269,633,2638,1118400,94005
16070,9949,6121,2593,"2,000,000+",94010
14014,8234,5780,2083,992300,94014
20476,12375,8101,2753,1116900,94015
1366,1089,277,2535,1384000,94018
5548,4214,1334,2113,1459500,94019
844,610,234,-,1067400,94020
61,25,36,-,-,94021
7341,5997,1344,"3,500+","2,000,000+",94022
8117,7139,978,"3,500+","2,000,000+",94024
14349,8624,5725,2925,"2,000,000+",94025
2192,1883,309,"3,500+","2,000,000+",94027
2575,2143,432,"3,500+","2,000,000+",94028
8074,4955,3119,3322,1874100,94030
1033,929,104,-,1400400,94037
1087,1016,71,-,1080400,94038
15064,5648,9416,2878,"2,000,000+",94040
6467,2064,4403,2869,"2,000,000+",94041
13369,5948,7421,2839,1562200,94043
13951,9542,4409,2935,1188000,94044
362,236,126,839,1302100,94060
13176,6938,6238,2763,1845000,94061
9679,7005,2674,2757,"2,000,000+",94062
10969,3501,7468,2671,1094000,94063
4659,2983,1676,"3,500+",1768200,94065
15169,9530,5639,2671,1187600,94066
11627,8153,3474,2759,"2,000,000+",94070
68,54,14,-,1039100,94074
22220,13690,8530,2649,1111900,94080
8952,3520,5432,3087,1495000,94085
20118,6075,14043,2860,1631700,94086
20553,11662,8891,3127,"2,000,000+",94087
9023,4768,4255,3291,382500,94089
19031,1679,17352,1512,1039000,94102
16675,3416,13259,1921,1065100,94103
279,66,213,737,"2,000,000+",94104
7616,2984,4632,3431,1455500,94105
15271,5472,9799,3178,1284700,94107
6483,655,5828,1492,1295700,94108
32462,5331,27131,2143,1364200,94109
27220,11084,16136,2315,1446800,94110
2446,522,1924,2451,1233700,94111
23106,15689,7417,2171,1144800,94112
16946,7632,9314,2644,1658200,94114
16737,4281,12456,2379,1709100,94115
15368,11371,3997,2947,1368100,94116
17619,4626,12993,2715,1571000,94117
16984,6085,10899,2527,1755100,94118
17955,7836,10119,2152,1583700,94121
22420,11187,11233,2675,1446400,94122
12732,3624,9108,3107,"2,000,000+",94123
11165,5631,5534,1276,1004000,94124
7351,6016,1335,"3,500+",1773800,94127
0,0,0,-,-,94128
1331,0,1331,"3,500+",-,94129
626,0,626,2596,-,94130
12477,6927,5550,2881,1628900,94131
10576,5037,5539,2460,1373800,94132
12998,2281,10717,1598,1472600,94133
12467,7982,4485,1729,1027600,94134
4501,1703,2798,2692,1506900,94158
0,0,0,-,-,94188
7130,3929,3201,2868,"2,000,000+",94301
14276,8100,6176,2458,1670900,94303
2035,456,1579,3331,"2,000,000+",94304
3574,952,2622,1831,"2,000,000+",94305
10722,5910,4812,2945,"2,000,000+",94306
12993,5861,7132,2649,1093400,94401
10073,6352,3721,3315,"2,000,000+",94402
16612,8767,7845,3166,1681500,94403
14371,7515,6856,"3,500+",1592100,94404
24978,10344,14634,2266,1148400,94501
4842,4067,775,"3,500+",1145500,94502
5790,4567,1223,2296,641200,94503
5482,4926,556,2859,768200,94505
9211,8145,1066,"3,500+",1641900,94506
5007,4602,405,"3,500+","2,000,000+",94507
988,645,343,1553,775800,94508
23166,12857,10309,2011,516200,94509
10922,7662,3260,2220,738900,94510
842,616,226,1369,475400,94511
28,0,28,-,-,94512
21808,17779,4029,2393,735700,94513
573,379,194,2336,764800,94514
2728,1792,936,1648,821600,94515
74,57,17,1163,682100,94516
4408,4037,371,"3,500+",911500,94517
10229,7212,3017,2231,783000,94518
7055,4859,2196,2244,662400,94519
13308,4717,8591,2028,571400,94520
15513,11521,3992,2284,778300,94521
14056,8908,5148,2400,959200,94523
1686,949,737,2070,703000,94525
12174,10342,1832,3459,1465900,94526
230,230,0,-,"2,000,000+",94528
10850,6091,4759,2334,1046500,94530
13233,9544,3689,2800,624900,94531
24660,13597,11063,1827,462500,94533
13549,10352,3197,2592,675700,94534
1015,14,1001,2783,-,94535
24789,14527,10262,2755,1160200,94536
22104,9897,12207,2753,1075100,94538
16411,13101,3310,3151,1735200,94539
21963,10154,11809,2171,750000,94541
5013,3542,1471,2424,1053100,94542
23082,12181,10901,2239,736300,94544
10027,7198,2829,2355,799300,94545
15897,10447,5450,2371,935700,94546
8990,7193,1797,2759,690000,94547
211,211,0,-,1041700,94548
10141,7621,2520,2938,1838500,94549
17260,13033,4227,2492,1069200,94550
14192,9983,4209,2463,898400,94551
4993,4617,376,"3,500+",1228700,94552
19174,13812,5362,2170,723400,94553
11691,8009,3682,3116,1223500,94555
5665,4767,898,2741,1475900,94556
24253,16495,7758,2128,816200,94558
10313,5173,5140,1974,791000,94559
14805,10290,4515,2644,1034900,94560
13463,10314,3149,2076,610200,94561
0,0,0,-,-,94562
7447,6918,529,2393,1739600,94563
6784,4886,1898,2409,666700,94564
29858,17557,12301,2077,528000,94565
16051,11500,4551,2548,1452900,94566
219,140,79,2204,378100,94567
23583,15179,8404,3094,1164100,94568
171,50,121,-,589700,94569
5342,4186,1156,1327,454900,94571
3046,1748,1298,1815,628500,94572
51,14,37,2060,-,94573
3457,2333,1124,1877,1602900,94574
0,0,0,-,-,94575
86,73,13,-,1043000,94576
16684,9428,7256,2073,788100,94577
13872,5558,8314,1951,733900,94578
6589,5018,1571,2046,780100,94579
8775,6614,2161,2114,787100,94580
16184,11304,4880,2746,1385200,94582
13707,10026,3681,2799,1179800,94583
9659,5969,3690,2052,486500,94585
323,267,56,3114,1276800,94586
20860,13758,7102,2593,1006600,94587
12292,7962,4330,2977,1233800,94588
9552,6028,3524,1969,448100,94589
15456,6574,8882,1667,469600,94590
19742,13425,6317,2096,574000,94591
422,375,47,2732,675100,94592
9586,7721,1865,2411,739900,94595
10738,4839,5899,2420,1241200,94596
10691,5150,5541,2539,917500,94597
10443,7804,2639,2926,1235200,94598
1531,1028,503,2010,679700,94599
16023,5431,10592,1596,649100,94601
12094,7294,4800,1799,1061400,94602
10574,4787,5787,1772,547600,94603
16861,10236,6625,1740,823500,94605
15692,3061,12631,1711,709400,94606
11899,4018,7881,1747,742300,94607
15674,5252,10422,2543,813100,94608
10651,3489,7162,2117,1097200,94609
15826,5759,10067,2142,1350600,94610
17997,10958,7039,2090,1409200,94611
9906,1015,8891,1749,837200,94612
0,0,0,-,-,94613
7434,4804,2630,2664,1679300,94618
9621,6732,2889,2218,905500,94619
10119,3496,6623,1507,517800,94621
7428,3613,3815,1771,1126900,94702
8339,3212,5127,2149,1215900,94703
8156,951,7205,2058,977100,94704
5843,3388,2455,2195,1746900,94705
8107,4132,3975,2279,1130000,94706
5176,4439,737,2120,1555600,94707
4543,3889,654,2914,1445200,94708
5244,1430,3814,1945,1196000,94709
3597,1256,2341,2400,1062500,94710
155,61,94,1917,-,94720
10126,4663,5463,1585,558600,94801
9353,6616,2737,2101,696600,94803
15657,7445,8212,1760,591100,94804
5541,3778,1763,2095,705100,94805
20412,10252,10160,2007,562500,94806
15601,7953,7648,2158,1298400,94901
12308,7977,4331,2776,1107500,94903
5675,3567,2108,2557,1939900,94904
5144,3582,1562,"3,500+","2,000,000+",94920
91,91,0,-,803200,94922
652,478,174,1903,1290800,94923
578,376,202,1493,1588200,94924
4023,2797,1226,3361,1640900,94925
17001,8553,8448,2132,620000,94928
186,111,75,"3,500+",1318500,94929
3648,2414,1234,2301,1056100,94930
3783,2278,1505,1708,720400,94931
595,402,193,2891,866400,94933
544,414,130,1493,1241600,94937
228,150,78,"3,500+",1132400,94938
3464,1665,1799,2833,"2,000,000+",94939
118,63,55,-,"2,000,000+",94940
12388,8350,4038,2853,1798100,94941
7250,5299,1951,2111,1038900,94945
293,222,71,2025,"2,000,000+",94946
9204,6815,2389,2419,928100,94947
7343,4646,2697,2467,961600,94949
15,15,0,-,-,94950
1468,1022,446,1811,1153700,94951
13672,8124,5548,2167,959400,94952
14403,9382,5021,2392,750000,94954
666,484,182,2062,1585500,94956
712,581,131,3113,"2,000,000+",94957
6117,4215,1902,2530,1568400,94960
157,141,16,-,1103600,94963
93,0,93,-,-,94964
6079,3256,2823,2886,1358700,94965
228,136,92,1750,1718800,94970
114,93,21,-,906300,94971
41,4,37,-,-,94972
627,550,77,2419,1114200,94973
541,335,206,2375,894200,95002
10082,7498,2584,2364,1107300,95003
1270,928,342,1989,913300,95004
2798,1833,965,2225,889800,95005
3479,2704,775,2266,721900,95006
190,146,44,-,827400,95007
19015,9539,9476,2592,1487400,95008
4382,2044,2338,2191,878200,95010
2412,1174,1238,1611,559200,95012
16,16,0,-,-,95013
21485,12700,8785,"3,500+","2,000,000+",95014
275,125,150,1703,1028800,95017
2705,2118,587,2327,778500,95018
1840,446,1394,1339,655100,95019
19807,12832,6975,2237,944000,95020
17255,11351,5904,1819,691600,95023
5278,4114,1164,2734,"2,000,000+",95030
10416,6703,3713,2937,"2,000,000+",95032
3763,3036,727,2761,1312600,95033
24477,14846,9631,2980,1155300,95035
16607,11924,4683,2243,1100500,95037
388,233,155,1464,254700,95039
316,192,124,-,1076700,95041
256,161,95,1225,891700,95043
1509,1007,502,2077,808400,95045
1832,1332,500,2154,1317400,95046
15204,5722,9482,2381,1371700,95050
23189,10719,12470,2963,1498200,95051
42,0,42,-,-,95053
8988,3420,5568,3250,1392500,95054
18430,9396,9034,2265,1147700,95060
15019,8121,6898,2273,968300,95062
503,165,338,1449,456200,95064
2871,1960,911,2504,1088700,95065
6002,4584,1418,2356,1079400,95066
11099,9649,1450,"3,500+","2,000,000+",95070
4310,3279,1031,2167,964200,95073
184,156,28,-,853200,95075
24567,13859,10708,1805,702700,95076
6854,2615,4239,2558,891500,95110
15687,9186,6501,1982,797900,95111
21187,6048,15139,2008,918700,95112
1263,195,1068,2612,1051800,95113
13529,5356,8173,1960,827900,95116
10327,3895,6432,2313,1330800,95117
11361,7198,4163,2477,1304900,95118
3412,2506,906,2957,1128900,95119
12458,11080,1378,"3,500+",1774100,95120
9828,7351,2477,2790,955300,95121
12013,6079,5934,2273,817000,95122
24018,14487,9531,2920,1076400,95123
17388,12731,4657,2788,1512400,95124
20934,12357,8577,2354,1579700,95125
15432,5326,10106,2433,1171100,95126
15806,10408,5398,2401,915900,95127
13787,6103,7684,2366,1201800,95128
14068,8303,5765,2728,1875900,95129
4581,2784,1797,2217,1691500,95130
9754,6163,3591,2964,1112000,95131
12044,8871,3173,3065,1213200,95132
9046,5357,3689,2180,1003700,95133
13722,1785,11937,3233,380900,95134
7545,6603,942,"3,500+",1345700,95135
16017,9153,6864,2655,1047400,95136
5587,4704,883,2830,1277100,95138
2126,1607,519,3416,1082400,95139
57,48,9,-,1466700,95140
11913,9494,2419,3048,1164700,95148
3070,111,2959,830,358200,95202
5423,2108,3315,1162,326000,95203
11080,6470,4610,1264,342700,95204
10548,5112,5436,1263,270000,95205
17415,10345,7070,1385,354600,95206
18894,7271,11623,1469,372500,95207
13256,9657,3599,1768,427700,95209
11983,5968,6015,1385,310400,95210
0,0,0,-,-,95211
7905,5645,2260,2229,475600,95212
6679,4126,2553,1206,352900,95215
11018,6223,4795,1757,488500,95219
2683,1754,929,1418,720700,95220
92,36,56,-,-,95221
2205,1681,524,1631,440000,95222
1224,1071,153,1115,407600,95223
160,138,22,-,-,95224
325,131,194,686,599700,95225
0,0,0,-,-,95226
375,321,54,-,824600,95227
1749,1450,299,1838,387700,95228
202,134,68,2122,668200,95230
674,390,284,1563,470400,95231
48,48,0,-,592100,95232
115,115,0,-,425000,95233
1676,1043,633,1608,618700,95236
1479,1209,270,1154,406200,95237
16242,8070,8172,1342,413900,95240
10149,6917,3232,1815,518400,95242
1040,905,135,1302,401000,95245
506,451,55,3056,325000,95246
1671,1340,331,1665,443800,95247
31,14,17,-,-,95248
1655,1186,469,1487,392000,95249
317,267,50,-,389100,95251
4984,4485,499,1851,418300,95252
136,39,97,1164,-,95253
189,86,103,-,465300,95254
726,578,148,1182,255100,95255
148,97,51,1886,317800,95257
1511,1227,284,1406,572400,95258
12828,7492,5336,1174,342900,95301
318,203,115,1010,636500,95303
4631,2874,1757,2226,812900,95304
56,27,29,-,-,95305
389,352,37,1140,352000,95306
13030,8293,4737,1460,369300,95307
0,0,0,-,-,95309
764,555,209,795,376700,95310
1060,924,136,-,270600,95311
73,42,31,1261,181300,95312
356,132,224,-,562500,95313
3596,2586,1010,1204,326700,95315
2472,1723,749,1324,399100,95316
263,59,204,962,450000,95317
269,180,89,724,293100,95318
557,269,288,1083,268900,95319
4544,3216,1328,1559,484300,95320
1771,1541,230,1452,373500,95321
3236,1711,1525,1185,418800,95322
463,323,140,1077,490800,95323
2646,1349,1297,1305,380600,95324
29,29,0,-,-,95325
4055,2439,1616,1408,441700,95326
2968,1919,1049,1039,314100,95327
1103,529,574,1279,408100,95328
1094,920,174,1397,336800,95329
7481,6237,1244,2134,543600,95330
809,544,265,1035,310900,95333
4086,2203,1883,1222,304200,95334
58,16,42,-,-,95335
15812,10552,5260,1691,476200,95336
13012,9204,3808,1841,568100,95337
4751,3491,1260,1144,345200,95338
12323,6848,5475,1120,355600,95340
9074,3613,5461,1089,265600,95341
270,181,89,-,389700,95345
429,326,103,997,495700,95346
10998,4911,6087,1402,331700,95348
19205,10248,8957,1386,367600,95350
13429,6709,6720,1314,284000,95351
8721,4162,4559,1348,328700,95354
21175,12941,8234,1600,414500,95355
11288,7592,3696,1659,459200,95356
4300,3103,1197,2004,392700,95357
8339,5081,3258,1503,376200,95358
4090,2797,1293,1134,356800,95360
12478,8643,3835,1423,469200,95361
8063,5752,2311,1566,429300,95363
0,0,0,-,-,95364
1183,591,592,909,225500,95365
6573,4500,2073,1752,627000,95366
7478,5208,2270,1425,414900,95367
4350,3507,843,2044,416700,95368
330,183,147,882,353300,95369
12154,8793,3361,1181,390400,95370
609,517,92,1735,322000,95372
513,240,273,979,425900,95374
61,15,46,-,-,95375
16713,9899,6814,1898,560000,95376
9307,6983,2324,2696,680800,95377
1622,1351,271,-,371300,95379
14844,7230,7614,1261,366900,95380
13327,8292,5035,1585,443900,95382
1666,1319,347,1460,421600,95383
201,126,75,-,-,95385
2941,1689,1252,1395,369900,95386
306,54,252,1269,-,95387
3748,2196,1552,978,273700,95388
331,69,262,1135,-,95389
6190,4323,1867,3138,737600,95391
13682,7827,5855,1917,605500,95401
16000,8850,7150,2159,631600,95403
15697,9111,6586,1830,830700,95404
9359,5519,3840,2255,730800,95405
13058,6824,6234,1756,585400,95407
11856,7883,3973,2302,774900,95409
395,305,90,-,788600,95410
123,74,49,-,692300,95412
430,227,203,1187,597700,95415
63,63,0,-,350000,95417
131,87,44,-,-,95419
150,143,7,-,1099700,95420
700,515,185,1260,604400,95421
5999,3628,2371,1069,186000,95422
1605,1110,495,1167,270300,95423
4401,3059,1342,1352,633300,95425
564,492,72,-,313900,95426
202,132,70,-,859400,95427
946,646,300,944,374500,95428
85,85,0,-,346200,95429
0,0,0,-,-,95430
0,0,0,-,-,95431
304,224,80,-,696400,95432
83,0,83,-,-,95435
2432,1674,758,1745,661200,95436
6366,3655,2711,1243,494800,95437
266,238,28,-,753800,95439
702,442,260,1484,1169400,95441
1253,911,342,1839,1437500,95442
35,9,26,-,-,95443
215,203,12,-,793400,95444
884,649,235,1451,692100,95445
2407,1657,750,1463,584400,95446
6949,4270,2679,2076,1044100,95448
587,269,318,1513,546600,95449
112,69,43,2250,820700,95450
4973,3571,1402,1311,305700,95451
527,376,151,3076,946600,95452
4583,3435,1148,1044,347500,95453
763,636,127,643,369600,95454
400,195,205,-,431100,95456
1363,996,367,1149,379600,95457
1474,932,542,999,245200,95458
345,215,130,1027,558500,95459
1059,774,285,1848,619200,95460
1418,994,424,2113,400900,95461
575,444,131,1795,708300,95462
33,33,0,-,652800,95463
974,631,343,1319,146300,95464
531,346,185,1871,1110500,95465
284,174,110,1325,468500,95466
2184,1673,511,2186,407600,95467
681,441,240,1170,490800,95468
622,422,200,1611,573200,95469
2111,1426,685,1196,563200,95470
400,300,100,1694,637600,95471
11591,8313,3278,1835,971300,95472
15267,9908,5359,2042,846000,95476
1,0,1,-,-,95480
11653,6629,5024,1252,450100,95482
1164,881,283,1111,411200,95485
27,0,27,-,-,95486
276,236,40,-,-,95488
5542,3231,2311,1191,360800,95490
9826,7526,2300,2223,737100,95492
68,68,0,-,640200,95493
71,38,33,-,642900,95494
643,598,45,1598,1104800,95497
9658,4250,5408,1100,361100,95501
9873,7064,2809,1312,378600,95503
58,58,0,-,414700,95511
50,50,0,-,-,95514
7446,4621,2825,1329,404300,95519
8736,3239,5497,1251,441900,95521
630,510,120,1778,558400,95524
681,395,286,1240,429900,95525
216,147,69,810,322400,95526
270,212,58,-,374200,95527
584,461,123,889,482100,95528
7741,5014,2727,1176,290400,95531
1241,752,489,1178,527900,95536
148,72,76,-,237500,95537
431,400,31,-,263500,95538
5725,3271,2454,1122,349400,95540
1276,667,609,1187,393200,95542
250,210,40,880,-,95543
117,99,18,-,466300,95545
812,639,173,625,256300,95546
461,397,64,1044,484700,95547
382,300,82,963,240900,95548
372,294,78,1889,639300,95549
89,23,66,-,738600,95550
585,314,271,1224,474100,95551
227,157,70,416,240300,95552
388,257,131,1123,-,95553
149,69,80,-,-,95554
132,62,70,700,380000,95555
227,181,46,763,337000,95556
133,92,41,-,1041700,95558
0,0,0,-,-,95559
600,415,185,-,385500,95560
1381,769,612,948,276700,95562
233,149,84,1809,525600,95563
219,69,150,1207,403600,95564
281,126,155,1175,330800,95565
726,568,158,662,292900,95567
41,31,10,-,358300,95568
57,50,7,-,380000,95569
1131,835,296,1883,548500,95570
0,0,0,-,-,95571
597,385,212,1846,300900,95573
225,143,82,725,394800,95585
0,0,0,-,-,95587
548,425,123,1075,411500,95589
74,46,28,-,597800,95595
175,108,67,1173,353300,95601
7325,6011,1314,1649,609700,95602
12031,7922,4109,1391,585300,95603
23,12,11,-,-,95604
4742,2128,2614,1288,356300,95605
95,87,8,-,-,95606
116,108,8,-,457900,95607
26050,13859,12191,1453,516000,95608
17223,8999,8224,1670,439100,95610
457,249,208,2344,834400,95612
0,0,0,-,-,95613
1756,1566,190,1932,470300,95614
413,200,213,976,597400,95615
18369,6436,11933,1819,834200,95616
9952,5351,4601,2170,803600,95618
2547,1359,1188,1866,332400,95619
7523,4630,2893,1683,555100,95620
16201,10980,5221,1628,375900,95621
1642,1405,237,1738,495300,95623
20424,15836,4588,1853,560100,95624
65,0,65,-,-,95625
1911,1532,379,1444,454100,95626
1202,840,362,1232,437900,95627
16954,12012,4942,1793,587700,95628
359,324,35,-,485200,95629
28274,19579,8695,2164,673000,95630
2610,2267,343,-,485200,95631
10001,7497,2504,1485,466200,95632
1336,1179,157,2155,385200,95633
1795,1473,322,1684,335900,95634
405,376,29,-,450300,95635
484,445,39,-,313500,95636
125,91,34,-,528400,95637
796,728,68,1203,619500,95638
109,61,48,2038,-,95639
3912,3100,812,1214,427000,95640
772,589,183,1003,222600,95641
2984,1985,999,1428,425700,95642
447,306,141,988,337300,95645
59,47,12,-,529800,95646
20954,17356,3598,2026,603600,95648
5355,4752,603,1681,763200,95650
255,201,54,1375,629700,95651
345,0,345,935,-,95652
175,143,32,-,237500,95653
1618,1224,394,-,528800,95655
2274,2056,218,1456,786500,95658
308,193,115,1273,482100,95659
10797,6654,4143,1473,304200,95660
13002,7992,5010,1858,623800,95661
12531,9379,3152,1771,470200,95662
1128,1021,107,1417,792000,95663
516,432,84,1357,391200,95664
2012,1627,385,1286,363700,95665
2516,2302,214,1005,328900,95666
14504,11224,3280,1377,485900,95667
208,153,55,2036,555200,95668
986,847,139,1201,550500,95669
22046,12597,9449,1587,432900,95670
24,0,24,2184,-,95671
2067,1868,199,2123,664500,95672
5129,3569,1560,1654,390700,95673
281,217,64,1047,612500,95674
140,123,17,-,-,95675
29,3,26,922,-,95676
10501,7259,3242,1994,597200,95677
17588,9786,7802,1929,486200,95678
56,47,9,-,-,95679
9,9,0,-,-,95680
336,258,78,1522,366000,95681
11510,8554,2956,1711,640700,95682
2657,2378,279,2437,619300,95683
1410,1168,242,1653,558900,95684
2114,1505,609,1241,528700,95685
406,225,181,834,357600,95686
22564,14746,7818,2158,540800,95687
14035,9906,4129,2022,638100,95688
539,517,22,-,459100,95689
598,368,230,1141,688800,95690
14276,8865,5411,1435,485400,95691
1737,1154,583,1434,387100,95692
2413,2055,358,1801,773900,95693
3269,2098,1171,1395,550600,95694
14626,7674,6952,1376,475100,95695
89,22,67,1619,-,95697
121,81,40,-,900700,95698
15,9,6,-,-,95699
398,372,26,-,506900,95701
733,617,116,1207,610300,95703
2521,1839,682,1405,543000,95709
3877,3117,760,1331,484600,95713
159,122,37,1156,368600,95714
42,42,0,-,350000,95715
54,28,26,929,575000,95717
39,39,0,-,506300,95720
0,0,0,-,-,95721
1885,1669,216,1641,655000,95722
3454,2912,542,968,388400,95726
219,172,47,1778,919400,95728
22,22,0,-,525000,95735
60,0,60,-,-,95736
4341,3769,572,2429,589400,95742
7915,7154,761,2576,965500,95746
27164,21963,5201,2061,625400,95747
15139,10829,4310,2395,616200,95757
22176,15631,6545,2063,503100,95758
16066,13940,2126,2364,822200,95762
14103,9174,4929,2186,659900,95765
8165,5228,2937,1611,496400,95776
4534,706,3828,1463,629700,95811
6868,649,6219,1195,619200,95814
9592,3805,5787,1372,270900,95815
10747,2918,7829,1521,743500,95816
6637,2656,3981,1401,455300,95817
10681,5941,4740,1469,731200,95818
8100,5810,2290,1934,689500,95819
13656,7566,6090,1496,373800,95820
15841,7747,8094,1283,428700,95821
16601,10155,6446,1505,401100,95822
24396,11366,13030,1429,340600,95823
9024,3759,5265,1283,297700,95824
16047,3855,12192,1437,406500,95825
15920,8570,7350,1622,408100,95826
7444,4651,2793,1723,378600,95827
17941,11963,5978,1602,356200,95828
9280,7072,2208,1965,528300,95829
210,197,13,-,927800,95830
19337,10600,8737,1762,575200,95831
3152,2073,1079,1782,359300,95832
15628,7717,7911,1736,402100,95833
12195,6348,5847,1665,474500,95834
14491,9915,4576,2082,531900,95835
119,79,40,2575,1069400,95837
11766,6379,5387,1462,322500,95838
8406,3051,5355,1456,388200,95841
11855,5741,6114,1496,343400,95842
14974,9969,5005,1936,432300,95843
9930,7348,2582,1735,717700,95864
12777,6893,5884,1054,328800,95901
482,3,479,2371,-,95903
49,49,0,-,118600,95910
1522,1078,444,979,398000,95912
133,87,46,1500,280200,95913
206,154,52,1259,378800,95914
0,0,0,-,-,95915
397,322,75,858,229800,95916
1287,944,343,1458,292200,95917
911,793,118,-,572500,95918
561,467,94,-,323400,95919
85,55,30,584,412500,95920
294,203,91,990,284500,95922
29,29,0,-,1076400,95923
43,16,27,-,-,95925
17000,7144,9856,1367,433500,95926
15583,6893,8690,1346,451600,95928
0,0,0,-,-,95929
120,51,69,-,-,95930
3010,1871,1139,1024,349400,95932
24,24,0,-,"2,000,000+",95934
207,183,24,-,372000,95935
42,42,0,-,1048100,95936
496,300,196,670,-,95937
1460,1030,430,1382,543700,95938
158,69,89,800,295800,95939
133,114,19,-,259800,95941
793,727,66,-,482400,95942
283,156,127,886,475000,95943
65,0,65,-,-,95944
11846,6783,5063,1309,474100,95945
3561,2867,694,2044,500100,95946
585,484,101,777,304300,95947
3749,2111,1638,1137,321900,95948
8273,7371,902,1695,508300,95949
171,101,70,1175,-,95950
845,517,328,843,289800,95951
3406,2129,1277,819,321900,95953
4000,3266,734,1153,247900,95954
538,358,180,1179,291900,95955
180,170,10,-,292600,95956
268,160,108,937,291900,95957
0,0,0,-,-,95958
7605,5803,1802,1719,562900,95959
252,141,111,744,367900,95960
9766,6575,3191,1218,358100,95961
455,375,80,-,368200,95962
5537,3615,1922,987,320600,95963
7377,4267,3110,1059,258500,95965
11978,8969,3009,1073,285100,95966
538,280,258,1018,119400,95968
3447,2609,838,1158,354700,95969
183,124,59,1138,458300,95970
2162,1301,861,1309,287800,95971
56,0,56,-,-,95972
15106,9417,5689,1394,464400,95973
33,33,0,-,-,95974
703,546,157,1184,575200,95975
678,646,32,-,433800,95977
30,11,19,-,-,95978
172,123,49,736,216200,95979
18,18,0,-,-,95981
1112,849,263,1217,342900,95982
165,101,64,967,-,95983
89,68,21,-,-,95984
39,26,13,-,-,95986
1878,1066,812,1202,359600,95987
2900,1552,1348,1073,265300,95988
14583,7169,7414,1262,350000,95991
12594,8684,3910,1427,408500,95993
13156,7817,5339,1199,369800,96001
12734,7920,4814,1199,329000,96002
18084,10581,7503,1356,343300,96003
196,172,24,-,250000,96006
9971,6763,3208,1038,272300,96007
420,359,61,-,348900,96008
111,76,35,1009,188900,96009
0,0,0,-,-,96010
77,53,24,758,148200,96011
1605,1110,495,949,205600,96013
99,47,52,-,124500,96014
121,105,16,-,340900,96015
143,105,38,-,245300,96016
78,56,22,591,315400,96017
3958,2460,1498,1247,244200,96019
1125,909,216,1031,264700,96020
5384,3360,2024,1103,270800,96021
5708,4592,1116,1370,321400,96022
485,366,119,761,137700,96023
369,282,87,1069,302700,96024
1017,619,398,949,241900,96025
778,598,180,1068,258700,96027
676,478,198,888,340700,96028
39,34,5,-,450000,96029
38,31,7,-,173200,96031
1072,726,346,978,268000,96032
128,102,26,1400,125000,96033
149,120,29,1018,331300,96034
1651,1126,525,1106,233100,96035
60,21,39,-,-,96037
232,164,68,900,294400,96038
360,196,164,746,177700,96039
30,30,0,-,-,96040
1121,664,457,667,256700,96041
471,338,133,970,207900,96044
123,22,101,-,-,96046
362,313,49,1036,370900,96047
341,271,70,670,380200,96048
241,210,31,544,237000,96050
517,391,126,1568,299300,96051
620,483,137,939,339200,96052
128,104,24,-,146600,96054
1494,1051,443,1129,260600,96055
545,526,19,-,374200,96056
525,393,132,1080,307500,96057
223,134,89,-,147200,96058
152,141,11,-,338200,96059
0,0,0,-,-,96061
398,348,50,1313,363600,96062
59,46,13,-,196300,96063
1794,1366,428,883,234400,96064
153,115,38,727,286000,96065
3630,2359,1271,1326,350400,96067
17,7,10,-,-,96068
529,462,67,728,346400,96069
7,7,0,-,-,96071
1919,1769,150,1804,506500,96073
43,43,0,-,151800,96074
172,79,93,847,-,96075
63,35,28,-,-,96076
34,34,0,-,-,96078
12003,7592,4411,1114,291000,96080
279,201,78,1196,245200,96084
14,14,0,-,-,96085
125,93,32,1013,234300,96086
299,287,12,-,368200,96087
2179,1906,273,1175,289900,96088
202,137,65,1188,242600,96090
329,279,50,1021,320800,96091
105,71,34,-,405000,96092
1660,1224,436,976,321100,96093
2926,1998,928,847,276500,96094
336,291,45,990,348500,96096
4229,2769,1460,953,219200,96097
1906,1349,557,816,173000,96101
605,545,60,1466,403100,96103
431,299,132,882,200700,96104
192,187,5,-,426100,96105
167,95,72,-,468200,96106
348,212,136,912,394700,96107
61,50,11,-,-,96108
450,420,30,-,205000,96109
25,12,13,-,-,96110
14,14,0,-,-,96111
63,32,31,425,183300,96112
354,181,173,1080,66600,96113
1222,897,325,1353,293300,96114
66,64,2,-,-,96115
19,19,0,-,-,96116
84,74,10,-,197200,96117
593,504,89,1056,244800,96118
16,16,0,-,-,96119
350,309,41,867,465900,96120
43,8,35,-,-,96121
1822,1226,596,866,219100,96122
21,13,8,-,206300,96123
60,39,21,-,359500,96124
143,143,0,-,381300,96125
69,63,6,-,781300,96126
225,211,14,-,342600,96128
187,187,0,-,349200,96129
5389,3503,1886,988,229700,96130
9,4,5,-,-,96132
76,34,42,-,-,96133
769,600,169,697,166200,96134
56,56,0,-,-,96135
5,5,0,-,-,96136
1351,1052,299,754,320700,96137
521,447,74,1717,836500,96140
260,229,31,-,973400,96141
425,259,166,1627,727900,96142
1277,748,529,1225,654600,96143
1274,899,375,1798,915300,96145
482,234,248,1708,1559700,96146
286,263,23,-,661500,96148
12442,6959,5483,1340,595300,96150
0,0,0,-,-,96155
7291,5683,1608,2023,822800,96161
14621,10286,4335,1892,857500,96701
808,674,134,1529,507400,96703
2814,1877,937,1723,493200,96704
664,425,239,1514,630700,96705
22598,15441,7157,2690,732600,96706
15205,11003,4202,2382,724100,96707
4031,2686,1345,2360,933200,96708
139,130,9,-,764500,96710
2675,1421,1254,1928,1150600,96712
375,213,162,"3,500+",530800,96713
407,245,162,-,1178400,96714
702,507,195,1526,657500,96716
1181,625,556,2215,805600,96717
433,324,109,1574,587400,96719
17584,11508,6076,1229,421800,96720
991,695,296,1375,1062500,96722
1626,1013,613,1476,831100,96725
15,15,0,-,-,96726
1446,1151,295,1193,510000,96727
165,124,41,1708,380600,96728
410,341,69,858,190200,96729
536,345,191,1807,894700,96730
789,487,302,1670,701500,96731
8082,5231,2851,1499,764800,96732
16738,10456,6282,3136,1213900,96734
1718,1263,455,772,205100,96737
2752,1979,773,1722,627000,96738
14338,9795,4543,1635,685700,96740
1994,1438,556,1667,844100,96741
32,0,32,1297,-,96742
4869,3611,1258,2078,678300,96743
17608,13471,4137,2104,948200,96744
6704,4593,2111,1816,746300,96746
302,0,302,1016,-,96747
1529,911,618,994,347700,96748
6539,5091,1448,1080,403800,96749
1173,737,436,1105,598500,96750
55,23,32,-,-,96751
998,610,388,2123,489500,96752
10921,6744,4177,1966,845900,96753
1321,1024,297,2174,994900,96754
1231,1010,221,1163,682200,96755
2114,1211,903,1470,852300,96756
201,162,39,1452,384100,96757
91,0,91,-,-,96759
1390,1251,139,1981,330500,96760
7284,4167,3117,2022,869300,96761
1073,408,665,2422,957100,96762
1241,655,586,1111,486900,96763
196,127,69,1104,568000,96764
232,131,101,1947,793400,96765
4859,3024,1835,1707,687900,96766
6401,4332,2069,1788,857500,96768
80,0,80,725,-,96769
233,121,112,971,243900,96770
2453,1778,675,1212,273100,96771
1070,869,201,1215,347700,96772
73,48,25,-,886400,96773
135,111,24,-,334700,96774
565,401,164,1333,402300,96776
536,440,96,605,214400,96777
5815,4474,1341,1319,220400,96778
924,607,317,2414,938200,96779
215,175,40,-,419800,96780
573,482,91,1363,671300,96781
12118,8092,4026,2178,815600,96782
581,325,256,548,427800,96783
2024,1669,355,1163,299700,96785
13576,3795,9781,2660,658000,96786
18945,15066,3879,2253,832900,96789
3197,2272,925,1900,1057700,96790
2235,1387,848,2090,879800,96791
13476,8004,5472,1699,515800,96792
9899,7316,2583,1667,708100,96793
2391,1876,515,1527,707700,96795
747,296,451,1541,520200,96796
20040,13564,6476,1870,772400,96797
12014,6443,5571,1783,759000,96813
11779,5501,6278,1701,668200,96814
14870,6721,8149,1874,617700,96815
17933,11253,6680,1833,1103700,96816
19297,8061,11236,1402,907300,96817
18865,6986,11879,3047,658000,96818
12189,6109,6080,1726,921500,96819
0,0,0,-,-,96820
6631,5578,1053,2491,1310400,96821
18595,10299,8296,1679,878700,96822
11003,9112,1891,3346,1006800,96825
14623,4594,10029,1529,486900,96826
5,0,5,-,-,96848
0,0,0,-,-,96850
0,0,0,-,-,96853
0,0,0,-,-,96857
0,0,0,-,-,96858
0,0,0,-,-,96859
0,0,0,-,-,96860
0,0,0,-,-,96863
57,28,29,386,56400,97001
2187,1845,342,1293,432500,97002
10462,5862,4600,1816,428800,97003
1697,1519,178,1710,639300,97004
11455,4503,6952,1454,448400,97005
18266,9015,9251,1769,487500,97006
18598,14146,4452,1759,544100,97007
12358,6631,5727,1581,494800,97008
3015,2616,399,1250,580800,97009
396,381,15,-,548900,97011
9018,6474,2544,1337,475100,97013
680,512,168,1052,340700,97014
9176,5728,3448,1692,462800,97015
2750,2180,570,907,312200,97016
1127,1059,68,-,493600,97017
690,612,78,1321,397800,97018
983,860,123,1744,618100,97019
420,370,50,1210,300000,97020
610,412,198,1090,330300,97021
1314,1025,289,1515,584100,97022
4167,3455,712,1165,463900,97023
4515,2325,2190,1462,399900,97024
1010,873,137,1432,343400,97026
5028,3269,1759,1617,442000,97027
151,114,37,-,116000,97028
146,85,61,464,-,97029
15581,6756,8825,1541,373800,97030
7323,4921,2402,1318,522800,97031
1715,1275,440,1330,408100,97032
56,38,18,-,212500,97033
8486,6459,2027,1957,921400,97034
10914,6901,4013,1906,696800,97035
399,276,123,960,280600,97037
5907,4016,1891,1379,420600,97038
176,102,74,1018,220800,97039
594,478,116,1353,379000,97040
1077,768,309,1269,535500,97041
1045,969,76,1667,640700,97042
20820,15523,5297,1530,499300,97045
2785,2089,696,893,331700,97048
879,796,83,1593,443200,97049
117,99,18,800,160900,97050
6330,4338,1992,1223,341700,97051
1478,1343,135,-,420100,97053
603,587,16,-,362600,97054
6964,5646,1318,1494,456400,97055
4871,3754,1117,1633,418600,97056
9,7,2,-,"10,000-",97057
8202,5114,3088,908,295700,97058
7249,5043,2206,1443,399100,97060
11256,6608,4648,1646,566800,97062
460,387,73,-,260100,97063
1387,1152,235,1541,334300,97064
275,215,60,1082,176100,97065
892,621,271,1522,373400,97067
11165,9407,1758,1898,701300,97068
11020,5756,5264,1717,564800,97070
10419,6785,3634,1271,291800,97071
8965,5654,3311,1722,430600,97078
16631,11972,4659,1516,456700,97080
11899,7641,4258,1476,621700,97086
4805,4475,330,2526,591700,97089
1348,957,391,1426,444300,97101
215,197,18,-,612000,97102
7111,4480,2631,1124,404000,97103
1815,1584,231,1459,487900,97106
1014,781,233,1003,319800,97107
307,268,39,639,417900,97108
168,150,18,-,551000,97109
594,245,349,1107,671300,97110
1379,1025,354,1668,437600,97111
871,640,231,1314,338600,97112
5061,3810,1251,1356,396600,97113
1521,1252,269,1443,401100,97114
1325,1137,188,1162,450000,97115
10173,6600,3573,1281,451600,97116
258,218,40,1467,606100,97117
330,238,92,1154,303300,97118
1765,1556,209,1354,558200,97119
706,436,270,1182,352400,97121
118,118,0,-,250000,97122
16728,11562,5166,1552,457700,97123
21300,9717,11583,1832,477700,97124
32,32,0,-,411100,97125
1440,1280,160,1116,353800,97127
14462,9286,5176,1217,387200,97128
390,336,54,1350,586200,97130
1200,1053,147,1318,395700,97131
11393,7717,3676,1564,469100,97132
2215,1759,456,1673,605600,97133
92,77,15,-,494600,97134
659,418,241,1313,454500,97135
989,758,231,1189,324000,97136
389,246,143,1257,540300,97137
5181,2930,2251,976,412800,97138
9126,7088,2038,1947,589800,97140
5107,3487,1620,1113,354800,97141
65,65,0,-,484400,97144
132,75,57,820,589300,97145
2902,1943,959,1181,407500,97146
219,106,113,916,355000,97147
928,739,189,1740,542100,97148
186,144,42,-,489400,97149
9539,2732,6807,1530,641400,97201
18708,9702,9006,1609,657700,97202
12714,7476,5238,1459,448500,97203
426,26,400,737,-,97204
5847,1190,4657,1305,637400,97205
21188,13803,7385,1573,457600,97206
0,0,0,-,-,97208
14124,3172,10952,1594,582500,97209
7138,2575,4563,1524,921500,97210
14228,9206,5022,1732,598400,97211
11473,7671,3802,1674,792400,97212
14205,9277,4928,1422,583800,97213
14697,4914,9783,1590,693800,97214
7590,4790,2800,1454,645500,97215
7067,3899,3168,1393,416500,97216
15527,8920,6607,1779,535800,97217
6223,3636,2587,1476,457900,97218
18344,13156,5188,1632,622600,97219
11546,6316,5230,1373,414000,97220
5418,3857,1561,1582,724200,97221
15851,8588,7263,1500,434300,97222
20630,12937,7693,1658,528500,97223
15731,10602,5129,1641,533400,97224
11714,6001,5713,1604,685700,97225
3318,839,2479,1600,599900,97227
27117,18813,8304,1836,690400,97229
16262,10256,6006,1427,415400,97230
1695,1500,195,1458,755900,97231
8399,2260,6139,1523,726900,97232
13771,7007,6764,1313,355900,97233
13499,8114,5385,1391,386200,97236
9361,4187,5174,1701,688500,97239
0,0,0,-,-,97258
13133,7432,5701,1470,381900,97266
12543,9136,3407,1463,461800,97267
20070,8511,11559,1118,274900,97301
16750,10408,6342,1172,381700,97302
14844,9300,5544,1249,365800,97303
13581,8714,4867,1332,426900,97304
14754,7950,6804,1284,314800,97305
13688,9176,4512,1392,388300,97306
0,0,0,-,-,97310
8588,6141,2447,1325,369900,97317
11285,8527,2758,1176,397600,97321
14298,7965,6333,1195,290900,97322
538,330,208,990,259800,97324
2236,1846,390,1593,344600,97325
340,319,21,-,324500,97326
1310,1074,236,1064,355400,97327
38,6,32,-,-,97329
18764,9173,9591,1289,462600,97330
0,0,0,-,-,97331
9944,4601,5343,1362,432100,97333
89,89,0,-,-,97335
22,22,0,-,-,97336
8782,6577,2205,1142,357900,97338
1700,1280,420,1217,315800,97341
53,48,5,-,220000,97342
190,129,61,992,325000,97343
559,396,163,1097,261600,97344
154,111,43,-,581300,97345
402,356,46,1134,333800,97346
590,260,330,603,305900,97347
651,508,143,-,334500,97348
64,55,9,1275,259400,97350
3436,2105,1331,1436,316900,97351
1928,1541,387,1170,403300,97352
12919,8687,4232,1179,310400,97355
81,81,0,-,-,97357
993,905,88,938,374100,97358
737,573,164,1024,266500,97360
4259,2245,2014,1124,373000,97361
1519,851,668,962,392400,97362
219,119,100,-,391800,97364
4784,3053,1731,1091,380400,97365
859,723,136,1125,414100,97366
4967,3298,1669,1135,341600,97367
1282,1018,264,1058,227400,97368
121,113,8,-,545300,97369
3785,2926,859,1290,390200,97370
319,191,128,856,453100,97371
0,0,0,-,-,97373
1840,1595,245,850,458300,97374
454,432,22,973,462400,97375
563,414,149,898,366300,97376
256,159,97,1347,417700,97377
3452,2301,1151,1089,290500,97378
800,603,197,1009,187900,97380
5582,3659,1923,1311,441100,97381
3851,2450,1401,993,383200,97383
47,47,0,-,-,97384
1561,1123,438,1236,451800,97385
5999,4360,1639,1041,286800,97386
435,323,112,855,430400,97388
625,401,224,1673,300700,97389
377,309,68,703,289700,97390
2397,1513,884,985,358400,97391
2143,1866,277,1018,476100,97392
2572,1999,573,975,321100,97394
1273,893,380,1148,283900,97396
22848,6994,15854,1193,450800,97401
22508,11122,11386,1218,305400,97402
4800,1877,2923,1128,496700,97403
13353,9500,3853,1397,361800,97404
19707,13818,5889,1378,457500,97405
163,163,0,-,260900,97406
6268,3738,2530,1645,496700,97408
227,173,54,-,387800,97410
3523,2524,999,1141,394600,97411
235,212,23,925,267400,97412
438,277,161,703,385100,97413
103,103,0,-,-,97414
6833,5200,1633,1193,367800,97415
370,298,72,696,254500,97416
1081,714,367,897,171700,97417
336,307,29,-,442300,97419
12233,8025,4208,936,258900,97420
2607,2106,501,1120,244400,97423
7351,5116,2235,998,309800,97424
3823,2924,899,1211,385900,97426
352,243,109,767,351000,97429
166,143,23,1054,353600,97430
803,658,145,1522,303200,97431
76,25,51,-,-,97432
296,194,102,-,346600,97434
1058,785,273,957,263600,97435
316,237,79,946,275000,97436
895,734,161,1638,387600,97437
463,394,69,1821,424200,97438
7665,5488,2177,1156,342800,97439
94,29,65,970,-,97441
946,665,281,888,280700,97442
1049,747,302,773,326200,97443
2621,1931,690,1058,370100,97444
1929,1472,457,1126,311800,97446
262,184,78,-,422700,97447
5818,4052,1766,933,366000,97448
986,771,215,997,270000,97449
298,266,32,-,324200,97450
219,181,38,-,347700,97451
676,534,142,996,285200,97452
376,282,94,1100,303300,97453
381,333,48,1250,401900,97454
829,670,159,1193,665600,97455
1148,887,261,1068,355900,97456
4079,2912,1167,905,233600,97457
2051,1421,630,834,241800,97458
6084,4086,1998,957,308200,97459
406,378,28,-,441100,97461
1737,1444,293,990,339200,97462
1740,1202,538,791,201200,97463
1097,836,261,639,272200,97465
478,382,96,583,201100,97466
2468,1725,743,774,202300,97467
1107,868,239,838,212900,97469
8322,4908,3414,974,233700,97470
12621,9779,2842,1133,296700,97471
156,128,28,845,337100,97473
157,157,0,-,265200,97476
16420,8484,7936,1095,310800,97477
14435,9940,4495,1260,335300,97478
4541,2995,1546,1092,247500,97479
138,97,41,794,267000,97480
329,266,63,-,182900,97481
93,58,35,655,320800,97484
244,231,13,-,339700,97486
3640,2975,665,1288,305100,97487
412,370,42,1600,407500,97488
454,410,44,-,378700,97489
148,118,30,1397,366700,97490
484,470,14,1281,220400,97492
143,131,12,-,516200,97493
28,28,0,-,-,97494
845,717,128,980,380200,97495
3010,2236,774,1036,222700,97496
666,473,193,490,311900,97497
988,758,230,950,418400,97498
703,599,104,1012,253500,97499
18464,9920,8544,1166,297600,97501
11170,8320,2850,1236,344200,97502
4609,3743,866,1000,275000,97503
19991,12233,7758,1270,405600,97504
12193,7114,5079,1214,568900,97520
222,181,41,957,221900,97522
2887,2331,556,1084,305300,97523
5919,4525,1394,1227,380100,97524
2188,1699,489,1147,415500,97525
14972,9686,5286,1028,349400,97526
14522,10426,4096,1302,379600,97527
3557,2639,918,1684,499600,97530
223,209,14,-,247500,97531
1058,864,194,777,359000,97532
383,383,0,-,201600,97534
2081,1377,704,1143,319100,97535
464,352,112,731,277400,97536
2802,2057,745,1132,307200,97537
785,725,60,768,292900,97538
1454,1100,354,1103,297100,97539
3704,2275,1429,1282,390700,97540
634,567,67,1078,249400,97541
256,135,121,924,446600,97543
882,682,200,1576,418900,97544
9283,5498,3785,916,250200,97601
12725,8465,4260,968,231300,97603
0,0,0,-,-,97604
21,15,6,-,-,97620
140,139,1,-,563200,97621
120,76,44,584,-,97622
1181,976,205,852,228200,97623
1751,1438,313,868,223300,97624
54,43,11,-,325000,97625
85,63,22,-,124100,97626
180,132,48,-,319500,97627
2073,1411,662,821,174900,97630
520,345,175,842,234400,97632
558,366,192,873,188500,97633
141,136,5,-,198800,97634
101,31,70,-,147800,97635
166,60,106,-,119400,97636
68,46,22,629,110700,97637
167,101,66,850,114200,97638
21,21,0,-,-,97639
48,31,17,-,256800,97640
681,412,269,746,157100,97641
17536,9413,8123,1618,488200,97701
21181,15066,6115,1654,556000,97702
13717,10464,3253,1711,844800,97703
3056,2691,365,1787,491800,97707
0,0,0,-,-,97709
36,20,16,-,240000,97710
24,21,3,-,837500,97711
38,0,38,-,-,97712
1844,1210,634,703,150700,97720
85,62,23,-,272200,97721
15,12,3,-,283300,97722
124,97,27,1708,605100,97730
117,49,68,-,341700,97731
63,40,23,625,-,97732
235,190,45,-,162500,97733
1259,932,327,936,284000,97734
70,26,44,-,1345200,97735
30,10,20,-,-,97736
243,191,52,-,285900,97737
895,683,212,511,212600,97738
5641,4516,1125,1017,309600,97739
4539,2849,1690,946,287500,97741
160,90,70,830,233300,97750
46,30,16,-,-,97751
0,0,0,-,-,97752
1251,1017,234,-,639900,97753
8936,6644,2292,1118,342200,97754
16813,11680,5133,1383,424200,97756
27,13,14,475,-,97758
3224,2744,480,1334,598800,97759
3140,2786,354,1199,416600,97760
859,519,340,526,146200,97761
7613,4491,3122,886,242500,97801
336,260,76,1156,246100,97810
312,214,98,1175,235700,97812
586,439,147,892,170800,97813
5304,3888,1416,776,232900,97814
6,2,4,-,-,97817
1562,981,581,852,214200,97818
10,10,0,-,106300,97819
489,406,83,778,201300,97820
538,421,117,830,138600,97823
761,619,142,964,329500,97824
178,155,23,725,229800,97825
430,267,163,925,415600,97826
1048,834,214,927,219500,97827
1424,984,440,765,327000,97828
303,241,62,668,175300,97830
250,191,59,823,397400,97833
522,335,187,794,304700,97834
217,192,25,650,232500,97835
905,556,349,700,280700,97836
42,33,9,-,-,97837
9257,6401,2856,974,267700,97838
124,106,18,660,250000,97839
40,16,24,421,-,97840
187,162,25,1080,245000,97841
58,54,4,-,246200,97842
333,247,86,788,214100,97843
1281,1044,237,956,198100,97844
1029,747,282,889,190800,97845
1006,746,260,950,364500,97846
84,50,34,950,425000,97848
6844,4110,2734,916,243600,97850
250,154,96,663,189300,97856
259,206,53,944,325000,97857
66,55,11,-,232100,97859
4411,2765,1646,752,209500,97862
189,155,34,400,353600,97864
528,445,83,646,178000,97865
401,313,88,828,136900,97867
656,558,98,957,173100,97868
478,395,83,805,161700,97869
268,184,84,625,240200,97870
94,73,21,713,94200,97873
159,98,61,750,279500,97874
1031,746,285,950,185600,97875
373,329,44,1580,415000,97876
162,154,8,-,-,97877
155,127,28,-,-,97880
2310,1664,646,1008,175000,97882
1112,776,336,967,215100,97883
74,59,15,-,248600,97884
524,427,97,841,297100,97885
354,282,72,1167,217900,97886
240,189,51,825,418800,97901
8,7,1,-,-,97902
14,14,0,-,-,97903
107,94,13,525,594300,97904
53,19,34,-,-,97905
110,84,26,933,216700,97906
305,203,102,625,111900,97907
10,5,5,-,-,97908
11,0,11,-,-,97909
195,93,102,680,208900,97910
35,22,13,-,-,97911
1765,1007,758,742,165900,97913
5958,3357,2601,750,182400,97914
15,10,5,-,-,97917
1565,1015,550,842,235200,97918
16,13,3,-,-,97920
12096,9382,2714,1764,483900,98001
14489,6869,7620,1477,354900,98002
19332,9154,10178,1570,403200,98003
18787,6756,12031,2593,1862200,98004
8919,4596,4323,2304,1242200,98005
13903,11189,2714,2802,1172500,98006
11646,3810,7836,2223,865300,98007
9448,6780,2668,2413,1053500,98008
2374,2059,315,1570,787200,98010
11190,6570,4620,2109,819200,98011
26994,18265,8729,2214,745000,98012
2711,2462,249,1733,786900,98014
3860,3495,365,2839,681600,98019
8929,6541,2388,1894,861700,98020
11969,9398,2571,2398,820800,98021
8844,7053,1791,1372,539700,98022
17917,11742,6175,1807,479100,98023
1913,1721,192,1833,923900,98024
0,0,0,-,-,98025
15193,11262,3931,1822,691900,98026
11382,7805,3577,2244,912500,98027
9220,6335,2885,1850,803000,98028
12330,7827,4503,2511,909000,98029
12791,6596,6195,1726,471500,98030
13696,9084,4612,1882,494400,98031
14190,5668,8522,1670,432500,98032
17087,10828,6259,2281,1199900,98033
20842,12780,8062,2240,813500,98034
15973,9690,6283,1645,660300,98036
11123,6754,4369,1805,622200,98037
12809,11034,1775,2090,659000,98038
1027,840,187,"3,500+","2,000,000+",98039
9782,6649,3133,2315,1683600,98040
16654,13900,2754,2000,568100,98042
8922,5187,3735,1830,560400,98043
5627,4713,914,1868,779800,98045
2414,1230,1184,1769,366500,98047
73,73,0,-,-,98050
1347,1099,248,2138,590100,98051
31338,15134,16204,2295,1043700,98052
8466,7244,1222,2509,1082000,98053
9532,5068,4464,1975,496900,98055
14327,7905,6422,1899,681400,98056
6226,1618,4608,1715,526700,98057
15454,11018,4436,1968,584900,98058
14574,11223,3351,2069,763800,98059
5415,4601,814,2877,815100,98065
256,220,36,1150,688600,98068
4661,3773,888,1413,675000,98070
9728,7335,2393,2263,965300,98072
10123,8733,1390,2728,1113700,98074
8186,7141,1045,2871,1288200,98075
4750,4281,469,2178,1032800,98077
15803,8260,7543,1992,597700,98087
17163,12758,4405,1786,540200,98092
11079,1761,9318,2393,773200,98101
16213,4191,12022,1912,1042000,98102
25620,11104,14516,1982,970100,98103
8480,855,7625,1502,712900,98104
17875,5677,12198,1755,1253600,98105
11446,6311,5135,1718,633900,98106
15125,6181,8944,2172,896300,98107
8238,4672,3566,1444,676000,98108
19897,4354,15543,2241,941100,98109
9850,8001,1849,1965,985400,98110
10756,6783,3973,1984,1259800,98112
23067,13980,9087,2078,985000,98115
13172,7186,5986,1973,873900,98116
14913,10412,4501,2076,957700,98117
18022,10422,7600,1796,726800,98118
13661,5499,8162,1917,953100,98119
13689,3535,10154,2280,799600,98121
22152,5947,16205,1961,938000,98122
19765,9053,10712,1777,809000,98125
9555,5832,3723,1665,698800,98126
22478,10809,11669,1744,690900,98133
249,77,172,1628,413500,98134
7922,5186,2736,1992,857700,98136
14863,6946,7917,1762,857100,98144
10422,6836,3586,1699,595600,98146
4129,2053,2076,1717,508800,98148
0,0,0,-,-,98154
13896,9862,4034,1877,712200,98155
0,0,0,-,-,98158
154,118,36,-,704900,98164
9181,5994,3187,1644,732600,98166
12726,6807,5919,1630,472700,98168
0,0,0,-,-,98174
7997,6773,1224,2101,945900,98177
9523,6412,3111,1702,591000,98178
11108,4881,6227,1612,432800,98188
0,0,0,-,-,98195
14606,7840,6766,1709,475100,98198
9955,6082,3873,2258,1117900,98199
13313,6046,7267,1360,447500,98201
13890,9105,4785,1736,507000,98203
17373,6074,11299,1661,369900,98204
0,0,0,-,-,98207
21948,15019,6929,1795,587100,98208
190,166,24,-,398500,98220
10243,7389,2854,1499,604600,98221
64,48,16,-,653800,98222
16971,13538,3433,1718,505300,98223
111,100,11,-,519200,98224
21899,9269,12630,1341,531200,98225
19347,11716,7631,1432,509800,98226
13525,9600,3925,1450,505500,98229
7905,6151,1754,1273,419400,98230
1551,1404,147,1747,620400,98232
6533,3968,2565,1494,434300,98233
204,124,80,689,481500,98235
2703,2233,470,1487,563600,98236
1876,1495,381,1122,319000,98237
45,0,45,-,-,98238
3394,2807,587,1181,506100,98239
1225,1083,142,1433,510400,98240
898,651,247,889,337900,98241
161,103,58,1281,1060700,98243
1295,1055,240,1170,408600,98244
2004,1603,401,1132,648600,98245
3079,2135,944,1176,458400,98247
9297,7112,2185,1311,475300,98248
2080,1830,250,1467,559100,98249
4190,3195,995,1358,695700,98250
1865,1564,301,1696,382900,98251
3833,3072,761,1421,468100,98252
1139,1056,83,-,603800,98253
145,122,23,2021,300000,98255
148,131,17,1063,325000,98256
2094,1647,447,1197,448600,98257
17134,13601,3533,1962,536400,98258
2572,2135,437,1336,595500,98260
1478,1154,324,1117,628500,98261
492,452,40,640,520600,98262
64,56,8,1100,357100,98263
8082,5247,2835,1424,465200,98264
1526,1084,442,976,261800,98266
103,59,44,-,278400,98267
18991,13448,5543,1734,465900,98270
10971,8360,2611,1763,445300,98271
9977,7881,2096,1820,564800,98272
11483,7262,4221,1119,395900,98273
6866,5392,1474,1499,453900,98274
8253,5761,2492,1999,760700,98275
561,486,75,1565,405400,98276
16264,9497,6767,1542,415500,98277
0,0,0,-,-,98278
321,203,118,1638,725500,98279
203,184,19,1781,858100,98280
668,572,96,1043,375300,98281
7346,6649,697,1618,530100,98282
147,133,14,-,259000,98283
10413,7292,3121,1399,387000,98284
75,67,8,713,675800,98286
88,70,18,1063,378600,98288
14531,11934,2597,1433,660000,98290
9141,7341,1800,1685,558000,98292
2865,2339,526,1548,384700,98294
1094,679,415,1122,340400,98295
9334,8554,780,2403,785800,98296
40,38,2,-,375000,98297
825,825,0,-,449000,98303
413,344,69,-,242200,98304
106,95,11,-,268300,98305
9304,4533,4771,1418,376400,98310
10198,7705,2493,1701,407000,98311
12922,7942,4980,1532,383900,98312
31,0,31,2167,-,98314
1086,11,1075,2205,-,98315
686,568,118,959,235100,98320
6033,5175,858,1703,488600,98321
249,227,22,1375,380800,98323
685,593,92,683,351100,98325
353,185,168,892,237300,98326
4006,2297,1709,2168,470600,98327
3567,3043,524,1126,472800,98328
4210,3733,477,1722,410000,98329
12,12,0,-,-,98330
2179,1434,745,779,189600,98331
7452,6169,1283,2162,648000,98332
1385,1316,69,2115,903800,98333
10868,8396,2472,1818,703100,98335
222,142,80,-,334900,98336
3492,1774,1718,1306,360800,98337
10821,9142,1679,1709,431400,98338
1400,1021,379,1148,357500,98339
1343,1182,161,2259,438200,98340
611,508,103,1414,585500,98342
155,73,82,-,600500,98345
3967,3317,650,1438,519600,98346
2148,1838,310,1432,346100,98349
89,48,41,583,57000,98350
532,466,66,-,561400,98351
14,0,14,-,-,98353
3031,1723,1308,1871,438800,98354
237,152,85,-,434200,98355
969,824,145,1018,235100,98356
491,369,122,616,144000,98357
444,332,112,1431,464900,98358
1797,1513,284,1303,514600,98359
5154,4456,698,2050,430500,98360
271,249,22,-,256900,98361
10801,7204,3597,1068,340000,98362
6101,4529,1572,1173,301800,98363
18,0,18,-,-,98364
2558,2324,234,1943,567800,98365
14218,9502,4716,1562,408800,98366
11738,10137,1601,1707,459100,98367
8641,6644,1997,1147,457800,98368
13126,10203,2923,1698,532800,98370
8974,6338,2636,1547,457000,98371
10249,5356,4893,1658,503500,98372
10887,6185,4702,1757,454300,98373
15142,10881,4261,1896,445300,98374
10269,7504,2765,2004,425100,98375
932,817,115,1132,362900,98376
1100,824,276,906,395800,98377
1855,1626,229,2173,540000,98380
109,77,32,889,172500,98381
14412,11401,3011,1198,425000,98382
8840,4954,3886,2013,505500,98383
196,187,9,-,410000,98385
16436,12585,3851,1721,373400,98387
2778,1812,966,1592,550800,98388
4713,2461,2252,1754,440600,98390
19577,16884,2693,2014,516600,98391
1353,1019,334,1295,411400,98392
524,397,127,1019,455500,98394
237,200,37,1414,482900,98396
4079,904,3175,1385,534500,98402
4496,1857,2639,1315,702100,98403
12538,8420,4118,1310,352800,98404
10294,5223,5071,1390,396600,98405
10002,6497,3505,1557,516600,98406
9718,6343,3375,1693,567200,98407
8117,5400,2717,1476,355500,98408
11632,5106,6526,1478,330600,98409
0,0,0,-,-,98416
4006,2644,1362,1468,346300,98418
55,6,49,-,-,98421
7987,6251,1736,2029,569300,98422
4347,2125,2222,1737,440600,98424
0,0,0,-,-,98430
4341,46,4295,2203,-,98433
13,0,13,-,-,98438
2275,171,2104,1372,18500,98439
2261,1872,389,1358,452800,98443
12940,5762,7178,1427,326000,98444
12045,8550,3495,1626,373900,98445
4800,3442,1358,1773,438500,98446
0,0,0,-,-,98447
3699,1950,1749,1378,485600,98465
12191,6671,5520,1602,491600,98466
6156,3627,2529,1483,517600,98467
11653,7010,4643,1411,427600,98498
14069,4848,9221,1322,371300,98499
18682,11172,7510,1453,457500,98501
14659,8309,6350,1499,464100,98502
17162,9936,7226,1482,358200,98503
0,0,0,-,-,98505
8626,5814,2812,1349,409800,98506
12338,8484,3854,1582,405300,98512
13627,10633,2994,1736,391800,98513
10860,7654,3206,1800,474800,98516
8530,5387,3143,934,226700,98520
1615,1596,19,-,455500,98524
66,44,22,933,-,98526
134,128,6,-,345800,98527
4695,3651,1044,943,351000,98528
183,120,63,1160,204800,98530
10588,6626,3962,1038,263900,98531
9634,7258,2376,1023,355400,98532
322,220,102,810,337500,98533
182,174,8,-,-,98535
0,0,0,-,-,98536
1070,844,226,779,273000,98537
164,113,51,1234,358800,98538
73,62,11,1000,221400,98539
3735,2843,892,924,287400,98541
242,201,41,-,363800,98542
7,7,0,-,-,98544
1284,1110,174,1362,418800,98546
696,599,97,713,180000,98547
1331,1198,133,1351,241200,98548
5051,3260,1791,925,185900,98550
84,67,17,731,220500,98552
161,123,38,-,-,98555
0,0,0,-,-,98556
1441,1229,212,806,330200,98557
0,0,0,-,-,98558
0,0,0,-,-,98559
30,20,10,-,388900,98560
78,0,78,-,-,98562
3187,2398,789,1103,289000,98563
1201,969,232,1275,180100,98564
146,101,45,1125,234100,98565
93,89,4,-,-,98566
1039,803,236,917,330000,98568
3631,2925,706,1179,299200,98569
1575,1160,415,918,308600,98570
76,0,76,-,-,98571
298,216,82,731,188400,98572
56,56,0,-,254500,98575
1747,1499,248,1145,365700,98576
3037,2551,486,973,218000,98577
5121,4049,1072,1159,365900,98579
4390,3689,701,1860,454400,98580
251,251,0,-,169200,98581
141,141,0,-,-,98582
53,22,31,-,-,98583
14102,10641,3461,1186,323800,98584
279,219,60,-,338100,98585
780,456,324,906,222400,98586
303,240,63,672,91700,98587
774,712,62,1542,260900,98588
2877,2290,587,1083,375900,98589
192,171,21,1052,544500,98590
1538,1378,160,743,358100,98591
848,710,138,-,394900,98592
537,455,82,975,277600,98593
1209,840,369,788,227500,98595
2449,2013,436,1140,323700,98596
9300,7495,1805,1408,377100,98597
1038,882,156,1093,484700,98601
67,67,0,-,411800,98602
438,311,127,726,338000,98603
12726,10356,2370,1478,483900,98604
548,363,185,1391,300500,98605
3398,3050,348,1558,640300,98606
11958,9438,2520,1785,588500,98607
0,0,0,-,-,98609
1167,927,240,1044,324600,98610
3326,2774,552,1156,350100,98611
1414,1226,188,1105,343700,98612
233,213,20,1417,318400,98613
301,301,0,-,237700,98614
40,40,0,-,431800,98616
475,324,151,1182,321500,98617
270,211,59,722,267600,98619
3383,2327,1056,875,218600,98620
110,110,0,-,258300,98621
18,18,0,-,-,98623
551,377,174,1092,367900,98624
2805,2178,627,-,411800,98625
10336,7197,3139,1079,310500,98626
170,122,48,879,167500,98628
3201,2884,317,1968,509300,98629
1697,1288,409,831,314300,98631
20690,12189,8501,1068,317500,98632
805,621,184,1121,435100,98635
606,507,99,1084,279200,98638
457,308,149,1038,362000,98639
2699,2401,298,983,263600,98640
29,29,0,-,-,98641
8752,7386,1366,1876,579300,98642
186,140,46,1671,234000,98643
404,330,74,650,256000,98644
794,751,43,771,417600,98645
125,112,13,-,188500,98647
1350,1069,281,950,453100,98648
309,262,47,827,292200,98649
460,394,66,977,635300,98650
428,390,38,1000,579400,98651
6074,2416,3658,1270,413300,98660
20733,8962,11771,1371,388800,98661
13632,8609,5023,1640,391900,98662
6284,3774,2510,1440,396200,98663
9244,5936,3308,1511,405300,98664
11497,6973,4524,1559,412700,98665
34,34,0,-,286700,98670
8579,6891,1688,1403,488600,98671
2898,2327,571,1253,496500,98672
190,128,62,1033,159600,98673
5310,3626,1684,1240,455400,98674
2138,1926,212,1694,487900,98675
23365,16349,7016,1680,398400,98682
13367,7519,5848,1677,463400,98683
13279,7218,6061,1789,420800,98684
11849,9645,2204,1625,513000,98685
7785,5917,1868,1677,497100,98686
17009,10051,6958,1171,387500,98801
11518,8236,3282,1319,400700,98802
49,16,33,-,-,98811
1719,829,890,934,238100,98812
838,455,383,811,148900,98813
299,233,66,860,423600,98814
2758,1973,785,965,477500,98815
2795,1781,1014,1412,409000,98816
58,47,11,-,-,98817
116,83,33,778,226600,98819
221,46,175,-,-,98821
734,571,163,1076,302100,98822
4419,3028,1391,977,223200,98823
60,44,16,-,-,98824
3389,2450,939,1155,583400,98826
221,71,150,1146,-,98827
814,681,133,1586,342500,98828
249,179,70,-,204000,98829
246,184,62,480,226700,98830
1436,894,542,748,493900,98831
65,54,11,-,173200,98832
78,78,0,-,547600,98833
109,107,2,-,388500,98834
285,204,81,-,420400,98836
16958,10624,6334,1016,259400,98837
1863,1211,652,960,229100,98840
3513,2594,919,835,258300,98841
806,485,321,698,499000,98843
2068,1595,473,705,216200,98844
83,56,27,917,237500,98845
427,372,55,717,297700,98846
914,634,280,868,383600,98847
3734,2419,1315,980,269000,98848
491,292,199,982,242700,98849
578,466,112,863,252500,98850
1654,1211,443,776,198000,98851
16,14,2,-,604200,98852
0,0,0,-,-,98853
2415,1727,688,798,205200,98855
1096,748,348,862,425800,98856
1236,934,302,704,185400,98857
752,560,192,1208,232100,98858
122,100,22,-,-,98859
111,91,20,867,162500,98860
1423,1032,391,1020,580500,98862
11261,5620,5641,935,234600,98901
16686,8392,8294,982,214500,98902
5926,4575,1351,1162,240800,98903
14681,10421,4260,1174,329200,98908
0,0,0,-,-,98921
3494,2937,557,1034,550800,98922
502,179,323,916,224000,98923
243,201,42,1800,501700,98925
13579,7399,6180,1148,396700,98926
4493,2661,1832,939,244500,98930
1308,703,605,965,169500,98932
395,263,132,860,184300,98933
558,373,185,1111,255200,98934
1133,663,470,968,168400,98935
2383,2037,346,1332,300800,98936
1824,1260,564,987,331900,98937
648,504,144,1020,210600,98938
30,20,10,-,-,98939
259,176,83,-,485400,98940
378,244,134,1775,429600,98941
7167,5196,1971,1287,321700,98942
324,193,131,1159,339200,98943
6721,4288,2433,953,199700,98944
151,105,46,1444,409400,98946
868,655,213,879,192900,98947
3611,2186,1425,896,198900,98948
0,0,0,-,-,98950
3560,1924,1636,811,175400,98951
491,316,175,565,97600,98952
2262,1755,507,1185,349400,98953
2344,1003,1341,1217,229700,99001
1779,1554,225,769,376600,99003
8422,4917,3505,1042,340700,99004
3532,3255,277,1276,410900,99005
5092,4373,719,851,331000,99006
176,108,68,1110,-,99008
1733,1530,203,745,328600,99009
776,5,771,1566,-,99011
343,237,106,879,258500,99012
513,269,244,704,193100,99013
0,0,0,-,-,99014
7486,5569,1917,1510,412400,99016
105,99,6,575,99300,99017
111,83,28,-,312100,99018
4463,3072,1391,1703,468800,99019
7,7,0,-,-,99020
3457,3132,325,1263,383400,99021
3201,2635,566,738,300500,99022
290,290,0,-,612500,99023
1984,1910,74,-,406800,99025
3336,3222,114,699,388200,99026
2547,2349,198,1093,342100,99027
634,485,149,697,300800,99029
268,248,20,875,247000,99030
433,358,75,1083,331300,99031
369,301,68,781,130700,99032
346,246,100,728,240000,99033
126,47,79,-,-,99034
628,547,81,1238,541900,99036
5720,3783,1937,1267,395000,99037
62,52,10,850,-,99039
293,229,64,381,149200,99040
648,563,85,725,302500,99101
235,119,116,988,200900,99102
209,158,51,1179,214800,99103
15,10,5,-,70000,99105
2147,1697,450,822,241400,99109
635,462,173,805,416800,99110
1609,1140,469,841,237000,99111
242,205,37,938,301300,99113
4946,3513,1433,882,244300,99114
517,379,138,689,146800,99115
684,460,224,882,189600,99116
235,200,35,539,229200,99117
379,288,91,827,289700,99118
691,580,111,709,278700,99119
106,79,27,1375,425000,99121
1589,1284,305,902,269900,99122
413,353,60,871,235200,99123
117,93,24,725,198800,99124
232,141,91,920,156300,99125
280,251,29,-,240600,99126
130,111,19,550,265600,99128
297,191,106,483,133000,99129
306,243,63,913,187900,99130
85,52,33,-,250000,99131
712,447,265,661,208100,99133
253,190,63,889,190000,99134
183,166,17,1014,186100,99135
13,13,0,-,114600,99136
190,113,77,614,248500,99137
417,254,163,504,187000,99138
371,285,86,860,212500,99139
255,185,70,558,139300,99140
2661,2053,608,882,252700,99141
344,292,52,670,121100,99143
11,11,0,-,-,99144
37,37,0,-,539100,99146
81,81,0,-,425000,99147
1043,975,68,960,336100,99148
65,64,1,-,63000,99149
112,112,0,-,292500,99150
79,71,8,850,158200,99151
87,65,22,633,222900,99152
263,131,132,753,172100,99153
10,10,0,-,187500,99154
369,248,121,400,140100,99155
3763,2875,888,863,295500,99156
323,225,98,740,204900,99157
235,192,43,694,195500,99158
544,406,138,877,164900,99159
33,33,0,-,-,99160
568,483,85,682,271000,99161
12509,3997,8512,970,385900,99163
1207,890,317,772,251900,99166
331,311,20,-,253600,99167
1039,770,269,805,167500,99169
380,307,73,906,179300,99170
418,305,113,903,209600,99171
650,537,113,695,206000,99173
17,10,7,-,187500,99174
71,65,6,-,241700,99176
182,125,57,1219,307600,99179
301,253,48,-,293800,99180
896,754,142,875,227200,99181
547,395,152,818,231100,99185
7692,2177,5515,824,220000,99201
8123,3663,4460,979,230400,99202
9304,7068,2236,1208,414600,99203
3937,1217,2720,994,302000,99204
17809,12449,5360,1199,255300,99205
16742,10247,6495,1064,331200,99206
12583,6957,5626,1040,206000,99207
23054,15066,7988,1123,375100,99208
8704,5956,2748,1137,274000,99212
11501,5478,6023,1204,301100,99216
7902,5298,2604,1163,286400,99217
6104,3128,2976,1089,357700,99218
14665,9458,5207,1139,410500,99223
10236,6669,3567,1188,386900,99224
0,0,0,-,-,99251
4,0,4,-,-,99258
25585,17929,7656,1151,318700,99301
3570,2961,609,1028,267500,99320
156,95,61,-,-,99321
220,197,23,666,-,99322
1307,1133,174,979,298400,99323
3493,2320,1173,1032,303700,99324
1451,1002,449,1021,206200,99326
1647,1258,389,852,224000,99328
65,53,12,-,290600,99329
214,161,53,-,277000,99330
28,20,8,-,590900,99333
55,43,12,917,153100,99335
19384,9616,9768,1079,274100,99336
10952,9398,1554,1211,330900,99337
6249,5334,915,1370,457300,99338
299,236,63,832,190000,99341
827,544,283,917,-,99343
5493,3434,2059,905,222000,99344
67,38,29,446,348000,99345
114,85,29,1000,223600,99346
1067,819,248,725,200400,99347
488,179,309,846,183000,99348
2247,1241,1006,1097,385000,99349
4771,3004,1767,932,278500,99350
14082,9570,4512,1407,398400,99352
5811,4972,839,1379,381000,99353
10178,6154,4024,1203,328400,99354
82,41,41,790,235000,99356
1006,590,416,741,203800,99357
54,33,21,-,-,99359
476,364,112,1063,400000,99360
702,467,235,865,265800,99361
16446,10672,5774,1080,348000,99362
42,34,8,-,227800,99363
124,84,40,775,125000,99371
152,152,0,-,318300,99401
730,652,78,938,320600,99402
8632,6070,2562,941,262400,99403
7482,2790,4692,1180,368200,99501
9047,6640,2407,1520,391900,99502
6090,1910,4180,1131,286200,99503
15868,10354,5514,1431,299500,99504
862,0,862,2491,-,99505
2049,5,2044,1928,-,99506
13210,9488,3722,1518,353300,99507
12776,6892,5884,1283,301900,99508
0,0,0,-,-,99513
7511,5957,1554,1698,381200,99515
7402,6563,839,1245,541400,99516
6620,4126,2494,1237,357100,99517
4231,2664,1567,1627,291400,99518
0,0,0,-,-,99519
0,0,0,-,-,99530
205,157,48,-,375900,99540
77,18,59,1578,61700,99546
6,6,0,-,100000,99547
11,7,4,-,-,99548
28,21,7,-,81000,99549
66,63,3,-,210700,99550
98,70,28,663,-,99551
65,48,17,417,-,99552
58,30,28,595,106300,99553
246,164,82,836,85000,99554
42,34,8,1333,112500,99555
1185,1001,184,1101,200600,99556
208,131,77,1579,233000,99557
30,21,9,-,43800,99558
2179,963,1216,1522,303700,99559
90,73,17,917,-,99561
60,47,13,-,92500,99563
21,16,5,-,90000,99564
14,9,5,-,154200,99565
45,22,23,-,-,99566
2639,2363,276,2521,417400,99567
192,183,9,-,230400,99568
10,7,3,-,103100,99569
109,38,71,1375,156300,99571
60,52,8,-,437500,99572
311,250,61,865,235600,99573
918,605,313,1335,338300,99574
11,4,7,-,-,99575
814,435,379,1228,272000,99576
10297,7928,2369,1706,398500,99577
108,80,28,642,80600,99578
10,7,3,-,143800,99579
19,18,1,-,-,99580
343,240,103,967,107200,99581
33,12,21,-,158300,99583
30,30,0,-,26300,99585
193,124,69,542,316700,99586
845,519,326,1327,506700,99587
489,322,167,1163,226500,99588
37,31,6,-,129200,99589
72,57,15,667,95800,99590
10,9,1,-,91000,99591
100,82,18,725,51400,99602
4485,3431,1054,1177,333800,99603
169,104,65,819,101500,99604
63,63,0,-,236600,99605
86,64,22,-,150000,99606
62,44,18,1063,175000,99607
11,11,0,-,135400,99608
70,56,14,592,-,99609
806,685,121,850,240300,99610
5658,4077,1581,1102,279600,99611
358,187,171,862,118200,99612
152,77,75,1212,292500,99613
138,98,40,425,43300,99614
4203,2331,1872,1660,373500,99615
241,176,65,644,51100,99620
116,81,35,829,-,99621
126,94,32,568,116700,99622
7571,6100,1471,1489,279100,99623
18,13,5,-,106300,99624
16,6,10,-,-,99625
59,47,12,475,172900,99626
97,75,22,860,83600,99627
141,108,33,563,85600,99628
124,98,26,563,89300,99630
99,57,42,-,-,99631
200,130,70,728,-,99632
132,72,60,1208,262500,99633
210,111,99,-,30800,99634
0,0,0,-,-,99635
120,82,38,900,94000,99636
184,140,44,700,86900,99637
2,0,2,-,-,99638
541,471,70,950,229000,99639
32,13,19,-,350000,99640
153,120,33,-,87700,99641
75,49,26,888,122900,99643
42,33,9,-,117500,99644
10899,8479,2420,1260,313500,99645
10,10,0,-,216700,99647
24,15,9,967,168800,99648
27,20,7,950,137500,99649
83,81,2,-,34800,99650
6,6,0,-,-,99651
1716,1256,460,993,259500,99652
21,12,9,875,500000,99653
15764,11391,4373,1234,318900,99654
237,196,41,675,20000,99655
5,5,0,-,-,99656
19,19,0,-,117200,99657
319,239,80,931,111000,99658
65,41,24,833,78800,99659
78,50,28,983,103600,99660
341,262,79,1250,213700,99661
126,79,47,-,77900,99662
188,154,34,975,205400,99663
1524,996,528,956,275300,99664
17,3,14,533,-,99665
16,13,3,-,45000,99666
55,55,0,-,209600,99667
25,21,4,-,162500,99668
6633,5101,1532,1181,278200,99669
26,14,12,1042,-,99670
164,120,44,595,109300,99671
1658,1464,194,971,295400,99672
596,497,99,886,218900,99674
11,2,9,875,-,99675
713,533,180,875,236300,99676
17,10,7,-,98000,99677
238,157,81,857,104600,99678
25,9,16,-,-,99679
130,96,34,500,82700,99680
81,55,26,-,-,99681
109,73,36,600,46400,99682
204,199,5,-,170800,99683
162,104,58,1094,157100,99684
650,185,465,1765,434200,99685
1664,1067,597,1408,252300,99686
1215,1086,129,1151,232700,99688
231,129,102,1304,152100,99689
16,16,0,-,"10,000-",99690
60,42,18,-,91700,99691
146,0,146,1488,-,99692
156,43,113,957,79500,99693
557,447,110,788,222100,99694
0,0,0,-,-,99695
7454,3162,4292,1251,241500,99701
875,0,875,2069,-,99702
1935,0,1935,2074,-,99703
0,0,0,-,-,99704
7925,6183,1742,1409,273800,99705
12,6,6,-,325000,99706
0,0,0,-,-,99707
11978,7523,4455,1174,289500,99709
4730,3980,750,1217,293700,99712
468,423,45,1339,255300,99714
70,46,24,-,54000,99720
67,41,26,1050,117500,99721
65,48,17,-,-,99722
1568,611,957,1272,248000,99723
41,30,11,-,-,99724
293,228,65,-,209900,99725
20,12,8,-,76700,99726
133,110,23,1071,76700,99727
90,76,14,-,213600,99729
59,56,3,-,-,99730
1,1,0,-,-,99732
29,23,6,-,94400,99733
0,0,0,-,-,99734
45,41,4,-,108800,99736
1382,1027,355,1354,259300,99737
78,59,19,675,-,99738
68,51,17,917,106300,99739
250,194,56,1292,130000,99740
266,166,100,1163,107400,99741
124,104,20,938,76700,99742
300,276,24,529,236500,99743
55,50,5,-,162500,99744
21,10,11,-,-,99745
63,53,10,975,26900,99746
61,54,7,-,93000,99747
69,49,20,806,-,99748
92,75,17,917,130400,99749
144,115,29,925,112500,99750
36,19,17,1125,131300,99751
852,372,480,1633,251900,99752
99,55,44,744,83900,99753
48,45,3,-,81300,99754
46,25,21,1583,473500,99755
12,6,6,-,-,99756
11,11,0,-,-,99757
47,20,27,857,-,99758
43,24,19,-,118200,99759
320,235,85,1315,117100,99760
102,85,17,-,157500,99761
1341,680,661,1622,303700,99762
120,74,46,633,116700,99763
60,41,19,-,151600,99764
77,66,11,-,-,99765
149,103,46,1250,171900,99766
17,17,0,-,75000,99767
70,57,13,-,77000,99768
165,150,15,950,100000,99769
120,75,45,475,61000,99770
74,66,8,-,90000,99771
150,109,41,900,118300,99772
46,41,5,-,127100,99773
3,0,3,-,-,99774
171,0,171,1330,-,99775
28,13,15,-,-,99776
81,38,43,886,66000,99777
89,53,36,1055,109400,99778
680,527,153,608,191900,99780
39,28,11,-,-,99781
140,92,48,807,97100,99782
86,62,24,-,86700,99783
70,47,23,967,101300,99784
129,103,26,625,83400,99785
86,76,10,-,86700,99786
31,25,6,-,30400,99788
107,64,43,1094,131300,99789
11,11,0,-,-,99790
33,23,10,-,99200,99791
12003,7875,4128,1473,405300,99801
162,109,53,525,175900,99820
1014,490,524,1413,390300,99824
9,9,0,-,-,99825
248,192,56,1175,275000,99826
816,568,248,883,284200,99827
269,191,78,1153,246500,99829
172,121,51,925,171900,99830
51,43,8,-,121500,99832
1254,920,334,1074,279800,99833
3459,2231,1228,1309,424700,99835
24,21,3,-,-,99836
410,269,141,1044,434300,99840
98,82,16,-,275000,99841
0,0,0,-,-,99850
5568,3656,1912,1275,361000,99901
1,1,0,-,-,99903
101,92,9,-,235700,99918
259,183,76,883,252800,99919
793,537,256,922,243000,99921
125,81,44,750,128800,99922
25,25,0,-,-,99923
374,274,100,865,284100,99925
447,347,100,807,163900,99926
14,14,0,-,-,99927
927,604,323,966,274200,99929
