housing_units_occ,homeowner_units_occ,renters_units_occ,med_rent,med_household_price,zip
5972,3203,2769,359,104500,601
12968,9877,3091,395,90200,602
18674,11490,7184,384,128400,603
1915,1388,527,280,108500,606
9404,7179,2225,424,113200,610
22971,15356,7615,410,102000,612
3636,2618,1018,475,95800,616
8352,6516,1836,448,106300,617
2557,1387,1170,547,137400,622
14558,8650,5908,388,112800,623
8216,6296,1920,407,82700,624
11934,8621,3313,397,100900,627
657,247,410,278,74900,631
7088,5364,1724,421,97600,637
6018,4082,1936,366,109800,638
9540,6196,3344,391,96200,641
12360,9633,2727,644,140100,646
1791,1390,401,550,87000,647
5017,3722,1295,436,90200,650
1390,1183,207,407,105500,652
3664,2656,1008,356,91200,653
6612,4932,1680,342,84900,656
14337,10551,3786,422,129300,659
6418,4891,1527,435,106900,660
14620,9064,5556,472,109400,662
4846,3348,1498,399,91400,664
8494,4712,3782,421,97900,667
9735,5540,4195,392,91900,669
3163,2048,1115,286,80800,670
16090,11465,4625,457,114600,674
12356,8682,3674,420,99600,676
5451,4163,1288,428,126900,677
9584,5690,3894,451,114700,678
19352,11557,7795,390,94200,680
11636,6698,4938,358,113100,682
11921,8430,3491,368,106600,683
13794,8706,5088,365,108600,685
9788,6974,2814,472,101200,687
4203,3164,1039,482,95900,688
2147,1614,533,561,118800,690
11803,8575,3228,498,122700,692
17837,14843,2994,554,116100,693
49,49,0,-,124000,694
10422,8122,2300,383,92700,698
8968,6083,2885,430,99900,703
3024,2392,632,359,83100,704
8614,6931,1683,409,128900,705
4086,3006,1080,345,99200,707
6265,4710,1555,453,91500,714
1263,873,390,300,91000,715
11763,7266,4497,379,114000,716
6995,2864,4131,337,108400,717
8718,6873,1845,418,94300,718
8837,6798,2039,434,103300,719
6821,4939,1882,352,107600,720
6436,4741,1695,336,95400,723
31555,20254,11301,465,131500,725
20561,15371,5190,667,148100,727
13692,9936,3756,461,100700,728
16611,12851,3760,501,119400,729
12582,8023,4559,383,95500,730
4765,3533,1232,368,96000,731
4663,3666,997,477,97000,735
17629,12102,5527,459,117400,736
12194,8619,3575,471,108100,738
12621,9552,3069,496,119700,739
565,268,297,(X),80000,740
1639,1331,308,597,90100,741
17053,13174,3879,531,117300,745
8349,6810,1539,367,86800,751
13595,9640,3955,466,119300,754
7727,5789,1938,409,91800,757
2711,2279,432,599,112700,765
8094,6155,1939,326,95700,766
12205,8721,3484,419,91400,767
13493,10416,3077,440,93300,769
12805,9084,3721,456,114700,771
6829,4675,2154,425,97900,772
6788,4646,2142,489,111000,773
515,358,157,542,122800,775
13106,9685,3421,424,117800,777
15306,12599,2707,586,163600,778
4408,3525,883,467,120000,780
5991,3871,2120,354,93600,782
10863,8322,2541,416,101300,783
14753,10681,4072,430,95700,784
130,130,0,-,160400,786
16890,12680,4210,458,106600,791
9424,6787,2637,374,99500,794
15836,12352,3484,426,102800,795
2612,1060,1552,477,259600,901
51,44,7,-,291700,906
8519,4980,3539,695,238900,907
2574,964,1610,446,155800,909
3820,2025,1795,643,273000,911
2437,1313,1124,526,153200,912
3267,509,2758,171,395400,913
11578,5056,6522,390,103200,915
8161,3942,4219,455,117700,917
7930,3478,4452,267,193100,918
7278,4165,3113,625,155000,920
14156,6705,7451,528,152200,921
10550,4343,6207,410,117000,923
19890,10745,9145,382,137700,924
2976,634,2342,442,134900,925
38019,26833,11186,626,182100,926
5925,3357,2568,537,225900,927
47,0,47,-,-,934
0,0,0,-,-,936
26693,19923,6770,541,138200,949
0,0,0,-,-,950
15,15,0,-,-,951
3113,1957,1156,566,125900,952
22190,18757,3433,586,151500,953
26424,18909,7515,578,135900,956
15329,10772,4557,541,138000,957
18772,12337,6435,543,151700,959
0,0,0,-,-,960
11460,7957,3503,488,154500,961
7334,4158,3176,289,111200,962
2974,1759,1215,414,102200,965
6380,5028,1352,668,245000,966
1885,1415,470,864,226500,968
15671,12215,3456,897,242100,969
10334,7207,3127,530,154600,971
21587,14733,6854,522,158700,976
7751,5224,2527,776,186000,979
5850,3819,2031,616,143500,982
14719,9700,5019,581,153600,983
12860,8938,3922,519,144000,985
21444,16039,5405,659,154400,987
7103,4953,2150,911,203700,1001
9541,4440,5101,1127,342600,1002
29,0,29,1698,-,1003
1812,1468,344,913,209800,1005
5716,4429,1287,877,255800,1007
505,478,27,836,235700,1008
184,128,56,862,227600,1009
1484,1232,252,736,255600,1010
552,464,88,800,176000,1011
245,212,33,890,233800,1012
9196,4061,5135,841,173200,1013
12571,8011,4560,806,176800,1020
1226,986,240,1379,128200,1022
457,369,88,780,265300,1026
7960,4753,3207,886,241800,1027
6039,5127,912,738,262900,1028
314,275,39,578,309000,1029
4385,3553,832,864,243600,1030
575,322,253,696,193800,1031
278,252,26,1375,243200,1032
2344,2003,341,742,260400,1033
805,696,109,975,273600,1034
2288,1675,613,1033,329600,1035
1917,1765,152,763,274000,1036
264,247,17,-,310100,1037
1256,975,281,1009,283000,1038
568,458,110,1078,270100,1039
15324,6190,9134,700,186500,1040
959,819,140,775,217400,1050
571,443,128,(X),269700,1053
824,712,112,1056,343900,1054
8093,6210,1883,888,227900,1056
3534,2934,600,821,230100,1057
6467,2759,3708,1033,301100,1060
4446,3233,1213,877,287700,1062
0,0,0,-,-,1063
10,0,10,-,-,1066
668,601,67,1050,256000,1068
3500,2581,919,682,196600,1069
243,217,26,600,236400,1070
516,483,33,1025,229200,1071
635,554,81,1281,260200,1072
2484,2194,290,983,297700,1073
83,24,59,-,-,1074
6933,5020,1913,912,231100,1075
3566,2968,598,927,283400,1077
262,168,94,1314,160200,1079
917,613,304,879,159600,1080
689,543,146,829,199800,1081
4268,3094,1174,795,186400,1082
1180,672,508,832,199800,1083
72,72,0,-,312500,1084
15190,10418,4772,866,224300,1085
0,0,0,-,-,1086
290,193,97,782,249400,1088
11495,7008,4487,858,201600,1089
560,342,218,(X),253600,1092
133,117,16,1125,327200,1093
185,69,116,484,178500,1094
5415,4842,573,832,281100,1095
993,842,151,1077,256300,1096
10,0,10,-,-,1097
514,447,67,775,260100,1098
1412,144,1268,793,103100,1103
8784,4136,4648,799,131200,1104
4844,500,4344,710,130700,1105
5765,5178,587,1419,333100,1106
3923,990,2933,652,154000,1107
9716,3776,5940,890,148200,1108
9379,4469,4910,871,127200,1109
5543,4287,1256,901,158300,1118
4730,3637,1093,965,145200,1119
997,977,20,-,170200,1128
2923,2342,581,980,163100,1129
3303,1287,2016,867,141400,1151
0,0,0,-,-,1199
19894,12309,7585,787,174000,1201
3838,2579,1259,650,146000,1220
345,304,41,791,254500,1222
1018,941,77,1295,250200,1223
77,36,41,720,192200,1224
1374,1132,242,692,199600,1225
2843,2215,628,644,181900,1226
61,51,10,-,306500,1229
3281,2302,979,930,323300,1230
1214,1061,153,663,194300,1235
524,422,102,1658,304300,1236
976,856,120,1017,224600,1237
2492,1832,660,743,256000,1238
2306,1444,862,764,336700,1240
144,79,65,-,247900,1242
177,166,11,675,220000,1243
63,51,12,-,337500,1244
417,346,71,942,410300,1245
7069,4031,3038,667,154800,1247
302,291,11,758,237800,1253
440,399,41,1216,443300,1254
353,314,39,883,278000,1255
337,302,35,775,190300,1256
950,741,209,898,317800,1257
179,171,8,-,396900,1258
260,226,34,1049,446400,1259
144,77,67,-,367600,1260
574,327,247,966,335200,1262
66,54,12,1250,333300,1264
661,591,70,1511,390300,1266
2381,1801,580,1008,310200,1267
316,312,4,-,272700,1270
7850,4502,3348,830,184900,1301
622,502,120,735,276700,1330
5341,3934,1407,718,150300,1331
1122,937,185,1089,229700,1337
79,69,10,-,282800,1338
595,482,113,808,234300,1339
716,548,168,1012,183500,1340
688,630,58,1164,295300,1341
484,245,239,1102,313500,1342
27,27,0,-,343800,1343
626,480,146,832,206700,1344
210,185,25,894,227400,1346
66,44,22,-,103100,1347
446,414,32,717,200700,1349
50,39,11,825,102500,1350
939,761,178,808,257600,1351
569,486,83,708,237900,1354
418,365,53,1055,251900,1355
1234,964,270,807,241000,1360
3302,2261,1041,706,154300,1364
496,420,76,738,286200,1366
247,213,34,1100,193100,1367
515,437,78,1069,205000,1368
1768,1199,569,836,238600,1370
1914,1504,410,1038,273000,1373
1528,678,850,1171,287700,1375
2252,1148,1104,772,184300,1376
337,304,33,1114,206900,1378
376,319,57,875,195500,1379
14842,8053,6789,857,177700,1420
2216,2056,160,944,241700,1430
1048,924,124,1286,239100,1431
3308,2094,1214,924,288200,1432
160,142,18,-,303700,1434
1299,989,310,(X),187900,1436
233,209,24,-,226900,1438
8156,4135,4021,729,171700,1440
3992,3425,567,1184,430000,1450
1652,1513,139,1417,540900,1451
1592,1457,135,945,239900,1452
16784,9249,7535,886,227500,1453
3446,2853,593,905,392900,1460
4287,3279,1008,1301,268400,1462
4247,3286,961,1162,310800,1463
2331,1597,734,942,308700,1464
113,113,0,-,490800,1467
1612,1418,194,996,215300,1468
2547,2068,479,896,258800,1469
2779,2437,342,1108,250900,1473
729,614,115,1168,267100,1474
3948,2897,1051,804,192300,1475
6267,5277,990,949,241300,1501
1078,918,160,1096,377500,1503
3333,2343,990,929,264500,1504
1618,1435,183,1092,345900,1505
1390,1101,289,808,225400,1506
4744,3803,941,900,286800,1507
5644,3054,2590,1001,241200,1510
827,656,171,978,239700,1515
3100,2580,520,1139,283100,1516
1213,809,404,669,308100,1518
2360,1858,502,969,384100,1519
5178,4706,472,1185,286000,1520
998,856,142,1075,205700,1521
1139,995,144,1056,277100,1522
2261,1847,414,1078,292100,1523
2623,1913,710,706,220100,1524
73,50,23,-,200000,1525
5162,3753,1409,961,259200,1527
1061,813,248,1096,276200,1529
392,356,36,993,260800,1531
5108,4156,952,1288,366600,1532
2137,1612,525,976,324800,1534
1820,1269,551,772,231600,1535
2743,2132,611,1130,294500,1536
828,683,145,961,204300,1537
4220,3096,1124,820,237300,1540
1252,1097,155,1108,353000,1541
773,581,192,979,248700,1542
2898,2485,413,853,274900,1543
12839,9436,3403,1205,365500,1545
6762,2981,3781,848,186800,1550
1705,909,796,1026,346700,1560
58,0,58,791,-,1561
4656,3134,1522,791,251100,1562
2748,2326,422,1169,331600,1564
2396,2107,289,1154,275500,1566
2633,2162,471,959,395200,1568
4824,3883,941,1175,274200,1569
6669,3542,3127,830,210200,1570
4037,3102,935,851,246600,1571
6992,4363,2629,1324,406300,1581
2143,1765,378,851,265100,1583
1880,1387,493,1204,214800,1585
3752,2316,1436,927,255700,1588
3093,2749,344,830,354500,1590
9179,5485,3694,1093,218400,1602
7203,3371,3832,921,180200,1603
14130,6514,7616,1022,209600,1604
10472,3275,7197,843,193500,1605
7688,5230,2458,980,207400,1606
3741,1635,2106,901,182900,1607
1438,47,1391,745,43800,1608
7049,2783,4266,913,286700,1609
7843,1257,6586,954,166800,1610
927,602,325,960,228800,1611
1508,1360,148,1183,279300,1612
12344,9821,2523,1288,360800,1701
14745,4975,9770,1164,298600,1702
173,134,39,-,277500,1718
2101,1585,516,952,488200,1719
8503,6456,2047,1215,514100,1720
6596,5262,1334,1222,361400,1721
5129,3637,1492,1637,578300,1730
572,4,568,2376,-,1731
1619,1507,112,1347,470300,1740
1762,1690,72,2109,733800,1741
6920,5332,1588,1735,702300,1742
133,124,9,-,356900,1745
5037,4241,796,977,393500,1746
2237,1731,506,1115,314100,1747
5422,4718,704,1351,526900,1748
7638,5797,1841,1134,296600,1749
15558,8842,6716,1142,302900,1752
4284,2960,1324,1080,334000,1754
1993,1768,225,1384,389800,1756
10916,7259,3657,1075,288200,1757
13874,9976,3898,1274,447000,1760
1461,1343,118,1301,739900,1770
3175,2849,326,1274,552800,1772
2021,1702,319,1648,887100,1773
2538,2319,219,1601,454600,1775
6063,5708,355,569,640700,1776
5213,4575,638,747,611500,1778
15016,8928,6088,1346,365600,1801
9359,6565,2794,1635,424800,1803
12174,9759,2415,1247,567100,1810
11083,8955,2128,1300,349800,1821
9821,8408,1413,1146,364900,1824
11008,8746,2262,1163,289000,1826
1176,1148,28,(X),435500,1827
10202,5426,4776,1064,268500,1830
8461,5446,3015,992,239700,1832
3115,2604,511,1290,407900,1833
2385,1917,468,1096,361400,1834
5118,3633,1485,1122,260800,1835
2258,95,2163,783,108000,1840
15253,4120,11133,1006,219100,1841
8983,3270,5713,1078,222200,1843
17451,12440,5011,1071,282500,1844
10830,7864,2966,1345,442400,1845
5445,2659,2786,1120,209300,1850
10052,4138,5914,1008,245400,1851
13564,6108,7456,1012,242300,1852
9446,3725,5721,930,216600,1854
2528,2160,368,1151,310400,1860
3367,2876,491,1126,338900,1862
3931,3075,856,1064,274200,1863
5361,4670,691,1482,439500,1864
8898,7166,1732,1222,455500,1867
10974,9426,1548,1552,331700,1876
4252,3725,527,1180,341200,1879
9851,7364,2487,1204,413700,1880
7878,7125,753,1580,465100,1886
7652,6590,1062,1624,378600,1887
7586,6447,1139,1565,738200,1890
761,63,698,548,177100,1901
16863,5608,11255,1004,238900,1902
6386,5010,1376,1225,277600,1904
8390,3911,4479,1046,246000,1905
10108,7909,2199,1119,345700,1906
5512,4213,1299,1293,434900,1907
1639,1062,577,1117,498700,1908
7055,4999,2056,997,310700,1913
16113,9762,6351,1102,369600,1915
2713,2661,52,(X),597800,1921
979,829,150,(X),451900,1922
10394,7136,3258,1234,358000,1923
1425,1022,403,1170,524500,1929
12303,7704,4599,980,364000,1930
0,0,0,-,-,1937
5535,4066,1469,1055,412300,1938
4771,3938,833,1348,564700,1940
2063,1355,708,1339,768900,1944
8137,6544,1593,1242,570900,1945
2633,2172,461,1750,410600,1949
7555,5535,2020,1120,444200,1950
1714,1333,381,1281,475600,1951
3446,2524,922,1050,307900,1952
21411,13526,7885,1224,336700,1960
3282,2218,1064,990,450400,1966
2219,1860,359,1054,416300,1969
18001,8673,9328,1094,308800,1970
2728,2181,547,1145,501200,1982
2282,2111,171,(X),529700,1983
1372,1224,148,920,516600,1984
1518,1410,108,(X),479500,1985
6196,4929,1267,1382,282700,2019
8749,6798,1951,1416,425600,2021
2967,2293,674,1205,808600,2025
9579,6484,3095,1483,383700,2026
1935,1766,169,2145,976500,2030
1564,1267,297,1257,413500,2032
6411,4284,2127,1286,378200,2035
11115,8892,2223,1124,386300,2038
8435,6916,1519,1999,681100,2043
4892,3505,1387,1216,348100,2045
84,19,65,-,-,2047
8115,5812,2303,1138,378900,2048
9559,7540,2019,1322,398400,2050
4090,3598,492,991,599400,2052
4562,3854,708,1010,373300,2053
3069,2502,567,1248,373500,2054
3177,3035,142,1185,451000,2056
3638,3351,287,(X),555500,2061
11670,6665,5005,1277,383200,2062
6510,5536,974,972,497800,2066
6212,5379,833,1660,462900,2067
321,304,17,-,481300,2071
10555,7770,2785,1147,313500,2072
7098,5812,1286,1357,427400,2081
5589,4816,773,1459,631700,2090
3893,3302,591,1048,411800,2093
2114,888,1226,1908,973700,2108
2001,587,1414,2130,757600,2109
1293,688,605,2303,740600,2110
3108,882,2226,1545,634500,2111
4319,1025,3294,1661,472000,2113
7000,1728,5272,1973,583600,2114
9535,1334,8201,1435,567000,2115
11460,4526,6934,1631,861100,2116
12500,4327,8173,1098,622300,2118
10693,2253,8440,923,320700,2119
4741,484,4257,1057,346200,2120
10329,2073,8256,768,318700,2121
8409,3016,5393,1285,332500,2122
18593,7102,11491,1192,318300,2124
12427,3928,8499,1194,332300,2125
9660,3921,5739,1210,291600,2126
16332,6146,10186,1279,435800,2127
15820,4444,11376,1139,308800,2128
8457,3618,4839,1127,545800,2129
16070,7456,8614,1375,430100,2130
12092,6460,5632,1196,367900,2131
11270,7994,3276,1447,428000,2132
7826,1046,6780,1484,398700,2134
18029,4100,13929,1558,406400,2135
11048,5930,5118,1030,326900,2136
13654,5653,8001,1764,679100,2138
14058,4972,9086,1708,537100,2139
8561,3243,5318,1381,587800,2140
6297,2131,4166,1533,485100,2141
1307,238,1069,2812,950000,2142
11340,3460,7880,1534,452000,2143
10760,3619,7141,1677,566200,2144
10037,3882,6155,1332,394700,2145
22960,9369,13591,1288,330000,2148
15476,5778,9698,1232,318100,2149
12276,3434,8842,1171,274100,2150
20500,10104,10396,1187,313500,2151
7602,4175,3427,1271,357400,2152
22114,12403,9711,1477,400900,2155
525,0,525,2121,-,2163
24364,10346,14018,1236,334400,2169
7625,3995,3630,1219,374900,2170
7487,4334,3153,1360,375400,2171
11349,7707,3642,1133,432300,2176
9055,5900,3155,1289,398200,2180
13706,9519,4187,1316,372000,2184
9049,7134,1915,1303,499300,2186
6211,3498,2713,1197,327000,2188
6088,3786,2302,1076,288500,2189
6879,4942,1937,1240,345800,2190
3530,2763,767,1264,317200,2191
797,34,763,3061,"2,000,000+",2199
0,0,0,-,-,2203
1216,472,744,2696,557500,2210
7472,803,6669,1647,423400,2215
21284,9958,11326,1030,237500,2301
11480,7919,3561,987,203400,2302
1659,1363,296,1024,295300,2322
7803,5996,1807,1271,324600,2324
4423,4006,417,1387,265200,2330
5406,4782,624,1542,548900,2332
4986,4252,734,1042,300700,2333
2852,2597,255,1718,281600,2338
4862,4097,765,1251,429000,2339
3458,3054,404,975,331800,2341
4333,3589,744,974,274500,2343
8566,6778,1788,1093,297300,2346
3780,3254,526,1159,353400,2347
6035,4178,1857,1105,304900,2351
4278,3496,782,1211,404300,2356
0,0,0,-,-,2357
6309,5422,887,1508,351400,2359
21945,17334,4611,1329,323000,2360
4585,3728,857,1299,344500,2364
0,0,0,-,-,2366
1028,912,116,850,349100,2367
12045,8359,3686,1324,266900,2368
6517,4749,1768,1159,266500,2370
3445,2806,639,1325,311000,2375
2343,1977,366,1022,303400,2379
5503,4038,1465,989,278800,2382
5026,4488,538,1828,726500,2420
6505,4861,1644,1643,745900,2421
8643,4586,4057,1940,720000,2445
13431,5740,7691,1862,706300,2446
7662,4309,3353,1493,397100,2451
5080,3066,2014,1629,452200,2452
11506,4813,6693,1262,415900,2453
0,0,0,-,-,2457
4920,2881,2039,1637,672500,2458
6626,5334,1292,1738,855700,2459
3755,2445,1310,1617,658800,2460
2691,1925,766,1813,788400,2461
618,375,243,1393,677100,2462
1205,739,466,1734,515300,2464
4249,3278,971,1606,670100,2465
2876,1348,1528,1632,697200,2466
6586,4455,2131,1994,699800,2467
1959,1795,164,2065,1015100,2468
14357,7473,6884,1593,449500,2472
11450,6536,4914,1459,504700,2474
7193,4836,2357,1343,546700,2476
9504,6033,3471,1697,681000,2478
4761,4154,607,2242,997900,2481
3800,2959,841,1334,853600,2482
6891,6093,798,879,708500,2492
3781,3298,483,1253,1170400,2493
3683,2707,976,1651,639200,2494
5106,4131,975,946,306800,2532
361,285,76,1115,367900,2534
485,373,112,1342,1028500,2535
8019,6490,1529,1296,327600,2536
2392,2087,305,1659,395100,2537
1185,978,207,1185,229100,2538
1436,1216,220,1676,661000,2539
3994,2661,1333,931,484500,2540
237,3,234,1009,-,2542
368,250,118,1230,741500,2543
132,71,61,-,411300,2553
3844,2489,1355,1609,903200,2554
1270,1041,229,1425,505600,2556
1712,1422,290,1511,604900,2557
683,419,264,967,192800,2558
1903,1476,427,1057,335900,2559
229,219,10,-,315200,2561
1348,1121,227,1181,368600,2562
3783,3153,630,1176,341700,2563
70,70,0,-,928600,2564
1337,867,470,1215,605400,2568
4507,3131,1376,1088,259600,2571
996,894,102,1182,738400,2575
1786,1702,84,1340,263300,2576
9,9,0,-,-,2584
6393,3193,3200,987,251900,2601
856,763,93,1774,497600,2630
4205,3417,788,1015,436400,2631
4626,3856,770,1264,339500,2632
1819,1442,377,806,543500,2633
1553,1438,115,1717,382900,2635
44,30,14,-,-,2637
1597,1438,159,1137,486000,2638
1300,958,342,972,298200,2639
140,140,0,-,678600,2641
2277,1907,370,1107,432400,2642
9,0,9,-,-,2643
1373,1160,213,1433,297300,2644
3956,3362,594,1173,361100,2645
1018,841,177,1199,433100,2646
61,52,9,-,-,2647
2686,2549,137,1102,346200,2648
5907,5133,774,1288,319700,2649
524,447,77,1063,746400,2650
14,14,0,-,-,2651
432,382,50,728,547900,2652
2926,2314,612,923,592800,2653
1658,1310,348,1691,473100,2655
1782,1165,617,990,473500,2657
393,341,52,1422,484700,2659
3064,2370,694,897,323100,2660
56,56,0,-,(X),2663
4355,3138,1217,1067,290200,2664
388,294,94,1034,576800,2666
1492,1222,270,916,492600,2667
1314,1033,281,1514,434500,2668
80,70,10,-,478600,2669
700,533,167,954,363200,2670
477,342,135,705,359400,2671
62,37,25,-,-,2672
3684,2794,890,1316,263400,2673
3086,2827,259,1267,356900,2675
1541,1324,217,1287,314900,2702
16787,10869,5918,993,268000,2703
28,27,1,-,605800,2713
1056,976,80,-,316500,2715
1531,1350,181,927,310000,2717
2294,1874,420,893,245700,2718
6687,4900,1787,864,263000,2719
13214,5312,7902,795,239200,2720
11144,3737,7407,702,227000,2721
6514,1760,4754,706,229200,2723
7613,2469,5144,692,225900,2724
965,733,232,1040,247600,2725
5910,4775,1135,960,274600,2726
1851,1385,466,972,468200,2738
2299,1868,431,931,394100,2739
18274,7392,10882,772,202400,2740
3917,3430,487,790,272800,2743
4661,1843,2818,727,216300,2744
10136,5882,4254,812,211700,2745
5969,1266,4703,741,196100,2746
6504,5064,1440,957,305100,2747
4826,3721,1105,967,336100,2748
9823,7107,2716,937,321100,2760
3358,2587,771,1133,329700,2762
700,598,102,1031,330100,2763
1447,1304,143,929,308000,2764
6151,5080,1071,1154,312600,2766
4834,3720,1114,1337,308000,2767
4012,3650,362,1064,340300,2769
1812,1618,194,1302,377800,2770
5501,4805,696,1110,302000,2771
6015,5202,813,875,272100,2777
2184,2107,77,-,347900,2779
19681,11902,7779,926,234900,2780
6196,5246,950,940,353100,2790
104,96,8,-,604500,2791
424,165,259,795,192500,2802
954,883,71,589,207200,2804
6235,5499,736,1316,394300,2806
426,330,96,838,1156300,2807
825,720,105,964,232800,2808
8389,5622,2767,950,307500,2809
497,481,16,-,336100,2812
3048,2644,404,1168,297000,2813
2709,2463,246,787,258700,2814
62,62,0,-,-,2815
13084,10304,2780,906,211800,2816
2175,1690,485,1406,300300,2817
7458,5603,1855,990,372300,2818
2361,1938,423,895,326300,2822
1957,1630,327,1067,278000,2825
328,265,63,947,207700,2826
730,630,100,1571,301700,2827
2940,2369,571,1026,259200,2828
2547,1839,708,826,229600,2830
1266,1127,139,979,295600,2831
2028,1392,636,824,265700,2832
278,201,77,(X),274300,2833
2360,1864,496,1639,516200,2835
44,44,0,-,195400,2836
1640,1289,351,929,527400,2837
1425,763,662,920,223700,2838
567,436,131,970,212700,2839
10728,4441,6287,1033,379800,2840
0,0,0,-,-,2841
6414,3405,3009,1208,334400,2842
8960,6370,2590,958,293000,2852
3700,3293,407,806,284000,2857
235,128,107,974,264000,2858
2460,1758,702,927,228100,2859
17973,6046,11927,787,169600,2860
10058,6234,3824,942,170800,2861
6413,1583,4830,815,151300,2863
13362,9920,3442,859,248900,2864
6335,4663,1672,1003,274400,2865
6916,5159,1757,1175,351100,2871
120,120,0,-,227800,2872
123,99,24,-,347400,2873
2329,2104,225,1650,387000,2874
173,83,90,876,270500,2875
138,49,89,1125,-,2876
6670,5293,1377,924,260900,2878
8248,6037,2211,976,334200,2879
1171,781,390,1055,322300,2881
6316,4175,2141,1171,394300,2882
4666,2561,2105,951,251100,2885
12427,8390,4037,1063,207100,2886
8555,6267,2288,1017,189100,2888
11158,8560,2598,1022,184300,2889
9163,5715,3448,1086,291800,2891
1749,1601,148,(X),291900,2892
12964,6709,6255,924,184500,2893
290,203,87,1097,330900,2894
17324,6642,10682,821,159900,2895
4481,3361,1120,999,285000,2896
581,422,159,1105,242600,2898
4607,799,3808,998,235600,2903
12721,6561,6160,827,192200,2904
8610,3998,4612,867,174200,2905
10914,5224,5690,1142,385700,2906
8699,2315,6384,870,141800,2907
12310,5198,7112,922,171200,2908
14891,4281,10610,876,146900,2909
7801,5306,2495,990,178400,2910
6685,3824,2861,931,195400,2911
0,0,0,-,-,2912
8768,4276,4492,874,198900,2914
7343,4605,2738,972,208400,2915
3657,2456,1201,821,238500,2916
4299,3400,899,923,274200,2917
11765,8080,3685,887,212800,2919
14358,8576,5782,993,212400,2920
4217,3585,632,1023,331700,2921
3932,3532,400,1609,334200,3031
1932,1747,185,898,287700,3032
1676,1526,150,996,316400,3033
1519,1446,73,841,264800,3034
1618,1496,122,1670,307600,3036
1562,1441,121,1081,265200,3037
13241,8309,4932,1132,218900,3038
2581,2258,323,1078,223700,3042
575,527,48,1185,284400,3043
1613,1397,216,1599,241300,3044
5106,4024,1082,1122,232500,3045
1031,929,102,1125,283100,3046
606,503,103,1000,214900,3047
1355,1049,306,800,189700,3048
2832,2594,238,1503,410100,3049
8864,7293,1571,1218,256500,3051
2821,2375,446,1172,286900,3052
8368,7251,1117,1316,284500,3053
9576,8172,1404,1348,252500,3054
6091,3944,2147,1070,238300,3055
901,865,36,1103,297700,3057
11823,4178,7645,1028,215500,3060
10636,7859,2777,1235,247200,3062
6508,3982,2526,1219,233300,3063
5652,3433,2219,1003,242000,3064
1882,1747,135,985,314700,3070
1795,1571,224,1116,231500,3071
4453,3851,602,1105,317200,3076
3970,2992,978,1132,213900,3077
11110,8597,2513,1045,284200,3079
618,543,75,1029,267900,3082
512,471,41,875,246300,3084
1508,1174,334,995,245200,3086
5096,4668,428,1973,367300,3087
1695,143,1552,838,218100,3101
13200,5443,7757,1018,202300,3102
13796,6821,6975,1006,188100,3103
13580,6575,7005,1051,236400,3104
5167,4329,838,1070,237800,3106
4003,3242,761,978,214600,3109
7383,6566,817,1540,374800,3110
106,106,0,-,383300,3215
880,743,137,1050,188900,3216
937,590,347,734,156400,3217
364,339,25,-,215000,3218
2853,2374,479,964,191800,3220
869,749,120,1080,224100,3221
2247,1783,464,850,201900,3222
1442,1255,187,591,172900,3223
898,845,53,(X),259000,3224
1337,1123,214,1081,176000,3225
435,357,78,960,321200,3226
492,372,120,1321,297500,3227
2068,1793,275,1000,271300,3229
546,462,84,919,168600,3230
104,104,0,-,242500,3231
47,47,0,-,287900,3233
1810,1447,363,1040,196600,3234
3471,2043,1428,784,159700,3235
858,819,39,1184,228700,3237
35,27,8,-,187500,3238
535,440,95,830,163800,3240
367,284,83,813,274200,3241
1668,1190,478,1016,230700,3242
430,404,26,1260,186400,3243
3170,2615,555,952,186300,3244
816,644,172,993,271300,3245
6776,3780,2996,891,184000,3246
3055,2563,492,1024,245600,3249
608,350,258,733,216900,3251
2611,1839,772,906,283500,3253
1807,1553,254,1313,337900,3254
828,774,54,1276,275900,3255
871,759,112,939,208700,3256
1734,1346,388,835,352300,3257
980,895,85,1028,247400,3258
153,137,16,-,305800,3259
324,272,52,1277,296200,3260
1644,1441,203,1098,230600,3261
437,309,128,732,191400,3262
1524,904,620,769,188100,3263
2245,1300,945,836,187700,3264
960,815,145,897,173000,3266
520,485,35,963,199500,3268
1184,1108,76,917,244900,3269
146,132,14,-,245500,3273
4377,3183,1194,826,205500,3275
3267,2275,992,870,171100,3276
1090,854,236,866,246100,3278
313,238,75,738,146300,3279
476,445,31,894,214100,3280
3144,2877,267,1483,238200,3281
341,314,27,775,189400,3282
392,337,55,930,220700,3284
912,773,139,1039,214200,3285
611,474,137,1282,255900,3287
1734,1664,70,1159,268100,3290
19,19,0,-,-,3291
35,25,10,-,205000,3293
12897,6704,6193,969,218000,3301
6074,4304,1770,912,191300,3303
2783,2429,354,1305,293400,3304
2062,1739,323,999,233900,3307
10265,5735,4530,1008,181900,3431
1050,834,216,821,193000,3440
181,138,43,-,163300,3441
553,403,150,993,171200,3442
301,223,78,-,285800,3443
613,490,123,1031,282100,3444
278,212,66,1113,197800,3445
2413,1964,449,867,181000,3446
1058,936,122,990,170500,3447
300,253,47,1010,191300,3448
727,647,80,1000,288500,3449
453,373,80,881,246300,3450
1777,1346,431,744,139800,3451
2170,1524,646,805,188500,3452
812,571,241,881,200700,3455
304,266,38,1163,160400,3456
290,221,69,1051,266900,3457
3202,2134,1068,880,241700,3458
1836,1499,337,992,230500,3461
705,584,121,767,279300,3462
483,450,33,1063,216000,3464
947,677,270,882,158300,3465
464,426,38,-,274100,3466
636,555,81,1106,269000,3467
1990,1493,497,836,151500,3470
2591,1358,1233,615,163500,3561
4095,2476,1619,688,88400,3570
1049,636,413,844,148400,3574
13,13,0,-,767900,3575
1488,1074,414,612,145400,3576
257,198,59,740,200000,3579
599,484,115,895,312900,3580
1433,1056,377,687,136000,3581
1058,780,278,701,91200,3582
433,372,61,650,192700,3583
1633,1134,499,749,151900,3584
1059,858,201,874,148900,3585
295,265,30,790,291300,3586
718,616,102,642,156200,3588
399,320,79,521,94400,3590
568,455,113,638,155700,3592
187,163,24,850,228200,3593
323,242,81,792,187200,3595
143,98,45,647,73300,3597
1482,975,507,736,133000,3598
197,161,36,1056,167700,3601
1049,844,205,814,200200,3602
2186,1839,347,629,146500,3603
143,88,55,-,192300,3604
402,367,35,850,173900,3605
152,134,18,(X),162200,3607
1047,886,161,855,223000,3608
392,206,186,771,180200,3609
317,294,23,861,185700,3740
1583,1248,335,1079,182500,3741
5445,3431,2014,794,138700,3743
578,514,64,1318,239200,3745
81,70,11,-,267500,3746
2024,1467,557,946,263800,3748
365,265,100,1340,497500,3750
294,221,73,922,289400,3751
298,227,71,1042,181900,3752
1115,1026,89,1680,248600,3753
113,0,113,-,-,3754
2607,1501,1106,1468,487100,3755
228,197,31,-,159700,3765
4402,2428,1974,1010,234300,3766
679,596,83,1295,427700,3768
178,168,10,-,321100,3770
339,318,21,(X),196400,3771
3136,2177,959,841,158900,3773
572,489,83,1148,153100,3774
557,454,103,1191,230400,3777
335,286,49,583,190100,3779
170,150,20,-,157100,3780
701,603,98,1167,255800,3781
1351,943,408,1132,286700,3782
1942,751,1191,938,277600,3784
1039,649,390,755,116900,3785
10567,5642,4925,1145,357200,3801
1524,1311,213,798,261900,3809
600,485,115,2048,287000,3810
2630,2398,232,752,292700,3811
408,284,124,566,184600,3812
1297,1096,201,910,194200,3813
1014,836,178,946,153300,3814
525,452,73,981,235700,3816
339,219,120,286,195500,3817
1615,1148,467,704,159500,3818
1548,1345,203,896,262500,3819
12681,6534,6147,977,240600,3820
613,497,116,1115,327200,3823
3116,1871,1245,1032,343000,3824
3336,2929,407,1140,249800,3825
1047,784,263,779,254200,3826
1194,1078,116,1659,342300,3827
745,674,71,1157,207500,3830
164,138,26,838,314800,3832
8490,6204,2286,1190,278800,3833
2624,1695,929,910,168700,3835
566,470,96,1088,261800,3836
606,581,25,(X),262400,3837
534,422,112,-,267400,3838
1523,967,556,958,180200,3839
1447,1300,147,1516,395300,3840
2503,2130,373,1171,274700,3841
6767,4908,1859,1125,336100,3842
930,793,137,1356,443500,3844
565,403,162,733,205400,3845
391,306,85,1031,390900,3846
154,122,32,-,377400,3847
2502,2092,410,888,256800,3848
593,514,79,1268,208600,3849
157,142,15,-,366700,3850
1469,1208,261,998,202000,3851
207,201,6,-,230700,3852
288,260,28,-,252600,3853
468,385,83,1768,987500,3854
970,868,102,1121,224300,3855
562,505,57,1313,392600,3856
3854,2032,1822,1056,268400,3857
1792,1354,438,1135,283200,3858
1854,1103,751,968,223200,3860
1776,1414,362,998,291000,3861
1729,1561,168,1197,374800,3862
640,486,154,1278,181400,3864
2838,2213,625,1234,249800,3865
9096,5584,3512,859,166300,3867
2161,1685,476,1106,123900,3868
986,727,259,1008,231500,3869
2398,2017,381,1761,557500,3870
17,17,0,-,-,3871
1636,1466,170,(X),186800,3872
2171,1975,196,1301,243500,3873
3858,2483,1375,944,261100,3874
489,442,47,1406,190200,3875
4613,2633,1980,961,184300,3878
593,507,86,852,173300,3882
62,62,0,-,212900,3883
1409,1293,116,1037,266900,3884
2776,2445,331,1463,368700,3885
1072,721,351,807,159500,3886
743,668,75,1194,167600,3887
143,133,10,-,190200,3890
2744,2227,517,1024,284100,3894
2775,2342,433,1011,213900,3901
1094,898,196,1075,348700,3902
2459,1926,533,1183,326600,3903
3631,2162,1469,1199,277600,3904
855,839,16,-,334700,3905
1799,1404,395,915,227400,3906
677,583,94,1260,524300,3907
2702,2071,631,822,269300,3908
4332,3520,812,1221,371500,3909
165,65,100,-,291700,3910
78,24,54,-,-,3911
947,816,131,1134,208800,4001
2979,2642,337,750,215200,4002
201,186,15,-,612500,4003
9147,4612,4535,866,210300,4005
81,19,62,1250,715900,4006
1293,1176,117,1018,175400,4008
2030,1344,686,843,187500,4009
502,453,49,1009,187500,4010
8328,5634,2694,801,215900,4011
1509,1164,345,1007,186200,4015
239,203,36,625,355200,4017
0,0,0,-,-,4019
571,408,163,804,178200,4020
2137,1932,205,(X),309700,4021
423,381,42,434,205500,4022
225,215,10,-,189000,4024
2277,2014,263,595,178600,4027
749,605,144,971,181300,4029
1052,979,73,(X),190400,4030
3199,2522,677,1017,265800,4032
1422,1114,308,775,179300,4037
5889,4818,1071,977,243100,4038
2885,2191,694,1049,214600,4039
1361,1156,205,728,178500,4040
616,524,92,967,149700,4041
1743,1431,312,875,198300,4042
4738,3648,1090,966,269600,4043
3197,2585,612,938,305300,4046
678,510,168,848,161100,4047
1091,915,176,1130,168400,4048
1351,1212,139,530,167700,4049
130,113,17,1031,325900,4050
415,362,53,686,177900,4051
1647,1505,142,890,173700,4055
115,84,31,678,195000,4056
0,0,0,-,-,4057
935,856,79,-,166100,4061
6450,5344,1106,987,222900,4062
280,140,140,307,344400,4063
3985,2390,1595,852,187500,4064
254,198,56,1128,617000,4066
572,461,111,890,140700,4068
595,519,76,983,231700,4069
2087,1784,303,859,252100,4071
7847,4961,2886,894,237600,4072
6658,4219,2439,783,166000,4073
7403,5780,1623,1149,317400,4074
1048,938,110,948,193300,4076
1583,1241,342,972,359900,4079
1803,1201,602,802,168900,4083
2989,2682,307,865,213800,4084
675,649,26,-,179600,4085
3778,2846,932,831,210500,4086
769,697,72,-,198200,4087
624,552,72,778,148300,4088
4513,3778,735,877,285300,4090
318,299,19,1125,159400,4091
7851,4790,3061,903,194800,4092
3190,2740,450,892,210300,4093
565,460,105,1006,187300,4095
3462,2578,884,990,337700,4096
1361,1254,107,1389,283000,4097
8756,1534,7222,895,273700,4101
7757,3646,4111,908,237900,4102
13147,7489,5658,1073,233700,4103
4596,3715,881,1521,388200,4105
10655,6175,4480,1045,221900,4106
3722,3305,417,1012,378100,4107
412,369,43,604,317700,4108
47,31,16,-,308300,4109
582,490,92,794,569700,4110
9742,5453,4289,721,150800,4210
167,152,15,(X),122600,4216
1171,937,234,593,198400,4217
619,547,72,810,148600,4219
1179,986,193,716,143500,4220
381,312,69,625,118800,4221
1585,1442,143,533,214300,4222
1056,852,204,393,109600,4224
80,80,0,-,130000,4226
34,18,16,-,95000,4227
20,0,20,-,-,4228
123,110,13,505,155700,4231
55,46,9,-,(X),4234
1702,1345,357,1004,172000,4236
80,67,13,775,165300,4237
473,399,74,879,186300,4238
1790,1548,242,565,120600,4239
15784,7635,8149,683,144300,4240
1727,1263,464,678,127700,4250
1806,1276,530,694,142400,4252
848,693,155,850,129700,4253
1312,881,431,631,94100,4254
269,235,34,929,170800,4255
1145,788,357,781,116600,4256
1026,770,256,581,81500,4257
930,862,68,736,172200,4258
1279,1084,195,875,174300,4259
2074,1771,303,1019,210700,4260
179,160,19,867,158900,4261
828,703,125,818,154300,4263
436,344,92,921,156700,4265
30,19,11,-,179200,4267
1773,1370,403,650,115500,4268
2321,2043,278,484,128200,4270
0,0,0,-,-,4271
2204,1840,364,903,183200,4274
175,157,18,608,115600,4275
2406,1558,848,562,88200,4276
2769,2225,544,1047,141200,4280
2032,1185,847,630,123100,4281
2234,1966,268,968,169500,4282
493,461,32,850,188800,4284
185,174,11,(X),131600,4285
61,50,11,-,-,4286
1399,1168,231,776,191500,4287
657,519,138,697,147600,4289
544,512,32,717,127700,4290
404,365,39,611,124200,4292
1535,1175,360,630,132900,4294
11185,6603,4582,684,144600,4330
782,669,113,767,167800,4342
29,29,0,-,-,4343
1423,925,498,683,147000,4344
4784,3506,1278,704,144500,4345
796,569,227,620,117600,4346
1211,640,571,830,203700,4347
1211,1010,201,852,175000,4348
453,422,31,820,160700,4349
1520,1349,171,750,163200,4350
1082,880,202,692,209100,4351
689,586,103,981,173100,4352
930,813,117,913,142600,4353
629,556,73,809,150300,4354
1096,1002,94,798,188800,4355
1477,1114,363,789,145900,4357
1731,1408,323,809,153000,4358
197,154,43,-,108000,4359
243,230,13,-,163800,4360
1071,908,163,929,132600,4363
2407,1788,619,727,166600,4364
18736,9713,9023,760,157400,4401
310,283,27,828,130800,4406
67,54,13,746,166700,4408
449,381,68,582,110500,4410
668,542,126,652,137000,4411
3920,2424,1496,779,159100,4412
91,72,19,-,129500,4413
493,424,69,561,73800,4414
106,87,19,675,59800,4415
2461,1850,611,704,124700,4416
124,110,14,-,66700,4417
652,535,117,724,88200,4418
1048,909,139,796,132500,4419
354,224,130,940,381300,4421
414,349,65,588,125900,4422
304,269,35,231,58200,4424
1997,1411,586,577,134000,4426
1114,973,141,657,124100,4427
1313,1070,243,776,148200,4428
1808,1512,296,665,186500,4429
845,630,215,460,56600,4430
38,38,0,-,160700,4431
494,381,113,874,148500,4434
424,386,38,567,117200,4435
481,373,108,632,98600,4438
889,625,264,655,175300,4441
22,22,0,-,-,4442
1048,742,306,631,105100,4443
3369,2844,525,930,189100,4444
576,422,154,573,88700,4448
607,521,86,737,151000,4449
532,415,117,763,123600,4450
109,94,15,-,56200,4451
295,225,70,581,88500,4453
14,14,0,-,(X),4454
355,316,39,633,118400,4455
1127,898,229,878,150600,4456
2368,1660,708,585,97600,4457
396,309,87,469,78500,4459
538,475,63,484,69800,4460
1290,933,357,739,119100,4461
2155,1542,613,543,66700,4462
1286,869,417,731,79100,4463
285,243,42,388,105400,4464
3973,2364,1609,635,120100,4468
0,0,0,-,-,4469
290,254,36,636,89300,4471
937,791,146,744,187300,4472
2908,1334,1574,843,207900,4473
1627,1415,212,709,175100,4474
197,168,29,575,82100,4475
607,520,87,780,181200,4476
162,149,13,-,197300,4478
585,459,126,675,104700,4479
210,190,20,-,119300,4481
108,100,8,-,147900,4485
380,351,29,589,75300,4487
471,446,25,920,128000,4488
116,85,31,-,132800,4489
108,94,14,546,80900,4490
56,47,9,525,48100,4491
81,62,19,579,57500,4492
792,688,104,796,99700,4493
237,229,8,-,69800,4495
1660,1398,262,711,167700,4496
175,148,27,538,70000,4497
4888,3067,1821,772,173900,4530
266,251,15,969,184200,4535
881,795,86,(X),225400,4537
939,669,270,686,237200,4538
504,477,27,-,229800,4539
51,38,13,-,480000,4541
924,566,358,767,222500,4543
354,331,23,-,512600,4544
453,426,27,950,163000,4547
464,375,89,1051,361500,4548
375,357,18,1050,224600,4551
804,563,241,887,261100,4553
469,406,63,833,313400,4554
698,566,132,855,216500,4555
484,360,124,937,260500,4556
150,150,0,-,275000,4558
896,757,139,883,226700,4562
595,428,167,838,182100,4563
162,162,0,-,334500,4564
245,192,53,1025,360700,4568
0,0,0,-,-,4570
172,164,8,-,207100,4571
2035,1626,409,631,159700,4572
222,191,31,1333,269900,4573
596,515,81,770,149000,4574
31,31,0,-,697900,4575
342,255,87,861,391900,4576
1826,1163,663,728,189900,4578
1193,1105,88,875,190400,4579
5915,4174,1741,732,179500,4605
502,413,89,661,163300,4606
506,384,122,715,157900,4607
2410,1373,1037,790,331600,4609
201,163,38,775,119500,4611
234,179,55,782,259800,4612
69,57,12,-,165800,4613
1120,762,358,936,216200,4614
354,315,39,1188,265100,4616
339,309,30,867,236900,4617
1394,737,657,581,87200,4619
645,485,160,612,93500,4622
464,367,97,678,113900,4623
66,57,9,-,272800,4624
32,29,3,-,220800,4625
191,154,37,961,157800,4626
725,537,188,548,183600,4627
300,249,51,575,107900,4628
105,105,0,-,237800,4629
570,452,118,675,111800,4630
725,522,203,610,137500,4631
837,644,193,904,143100,4634
14,14,0,-,200000,4635
70,67,3,-,140300,4637
1053,728,325,858,142700,4640
45,42,3,-,275000,4642
448,376,72,725,111500,4643
0,0,0,-,-,4644
29,22,7,-,333300,4645
33,24,9,-,283300,4646
220,175,45,863,106300,4648
583,457,126,693,102800,4649
62,58,4,-,212500,4650
853,701,152,511,121500,4652
244,120,124,485,244400,4653
1362,845,517,634,118200,4654
430,353,77,695,133100,4655
152,134,18,625,123400,4657
652,529,123,607,125900,4658
593,495,98,891,419300,4660
295,209,86,818,426900,4662
498,412,86,838,153200,4664
513,452,61,604,110200,4666
674,500,174,380,109700,4667
706,439,267,290,67000,4668
90,85,5,-,(X),4669
237,225,12,1063,152600,4671
62,62,0,-,183300,4673
258,211,47,836,250400,4674
181,135,46,981,298200,4675
472,398,74,528,213400,4676
121,103,18,1125,174300,4677
880,526,354,729,296900,4679
491,371,120,764,117200,4680
551,373,178,841,230500,4681
46,20,26,-,-,4683
702,553,149,833,189200,4684
167,132,35,631,231000,4685
51,51,0,-,76300,4686
153,136,17,635,168100,4691
223,155,68,720,169600,4693
978,805,173,595,82800,4694
4163,2695,1468,514,89100,4730
789,651,138,430,78500,4732
122,119,3,-,145500,4733
354,280,74,667,85800,4734
249,211,38,323,78500,4735
4222,2783,1439,621,89300,4736
407,336,71,463,124300,4739
500,352,148,581,83700,4740
0,0,0,-,-,4741
1504,969,535,558,79300,4742
1994,1432,562,540,127200,4743
389,338,51,517,76700,4745
236,188,48,349,68000,4746
597,513,84,381,100100,4747
853,513,340,633,66800,4750
1608,1135,473,488,89600,4756
1170,1011,159,509,124300,4757
635,435,200,346,119300,4758
327,258,69,433,82900,4760
226,178,48,752,121100,4761
271,234,37,475,110400,4762
267,213,54,380,83300,4763
27,25,2,-,178400,4764
569,444,125,393,88700,4765
159,131,28,833,90300,4766
207,192,15,583,127800,4768
4086,2295,1791,622,103600,4769
347,268,79,410,113100,4772
331,266,65,607,165500,4773
326,262,64,275,91000,4774
391,343,48,482,87300,4776
175,165,10,1000,71700,4777
128,113,15,-,133700,4779
297,250,47,489,86200,4780
232,205,27,850,98200,4781
214,184,30,581,96300,4783
1096,714,382,421,71400,4785
793,617,176,523,101000,4786
220,197,23,583,86100,4787
3554,2064,1490,692,152700,4841
2366,1708,658,778,315900,4843
610,507,103,767,222200,4847
382,316,66,865,298400,4848
1731,1438,293,965,214300,4849
29,29,0,-,221200,4851
19,17,2,-,265000,4852
206,150,56,931,244400,4853
719,622,97,894,237300,4854
142,135,7,-,225000,4855
1313,1101,212,958,294400,4856
560,465,95,794,199700,4858
293,260,33,942,248000,4859
695,638,57,1163,237500,4860
1176,814,362,974,170100,4861
1475,1295,180,909,178300,4862
534,444,90,563,238900,4863
1654,1372,282,714,164300,4864
11195,6730,4465,618,131600,4901
761,619,142,646,126500,4910
880,730,150,599,92400,4911
401,343,58,539,104000,4912
3703,2456,1247,770,165600,4915
1106,984,122,963,181200,4917
160,134,26,-,181700,4918
761,648,113,454,80700,4920
626,461,165,692,139100,4921
520,432,88,644,94800,4922
227,195,32,775,84300,4923
920,734,186,782,101800,4924
70,60,10,(X),110700,4925
18,18,0,-,-,4926
1354,1114,240,757,101900,4927
863,665,198,777,117200,4928
350,248,102,746,108600,4929
1905,1404,501,586,95200,4930
536,468,68,725,151900,4932
17,17,0,-,-,4933
77,61,16,483,179500,4936
2697,1981,716,667,117600,4937
3665,2654,1011,631,123400,4938
486,453,33,806,99800,4939
0,0,0,-,-,4940
613,533,80,542,138900,4941
563,506,57,1028,89100,4942
694,534,160,613,79600,4943
66,0,66,-,-,4944
452,329,123,614,107400,4945
711,646,65,681,173100,4947
373,317,56,554,138400,4949
1954,1397,557,705,114900,4950
435,382,53,990,152600,4951
778,638,140,693,156000,4952
1384,963,421,738,136200,4953
518,473,45,796,130500,4955
277,248,29,875,130900,4956
1810,1536,274,777,112700,4957
853,777,76,616,102900,4958
481,434,47,757,114000,4961
53,22,31,-,-,4962
3057,2396,661,735,158500,4963
91,74,17,-,354500,4964
877,811,66,548,95900,4965
734,595,139,531,103500,4966
1511,1069,442,920,96500,4967
537,449,88,723,131500,4969
717,600,117,627,231300,4970
822,674,148,737,98200,4971
714,615,99,847,164300,4973
1381,926,455,(X),138400,4974
44,44,0,-,-,4975
4332,2801,1531,651,110600,4976
321,282,39,588,150500,4978
453,354,99,486,103300,4979
1020,862,158,738,158600,4981
174,119,55,554,130800,4982
633,528,105,621,108700,4983
292,240,52,725,124200,4984
34,28,6,-,191700,4985
648,546,102,826,130400,4986
379,310,69,772,154500,4987
827,547,280,654,144400,4988
1619,1258,361,792,158600,4989
138,65,73,-,-,4992
4094,2643,1451,873,222600,5001
76,62,14,-,384600,5031
1051,781,270,800,198300,5032
1194,827,367,675,181200,5033
126,90,36,850,561200,5034
283,198,85,1078,210000,5035
436,342,94,910,218800,5036
207,194,13,1583,283600,5037
558,408,150,797,178200,5038
454,419,35,1042,169700,5039
181,148,33,625,163900,5040
153,146,7,-,137500,5041
189,166,23,793,156700,5042
317,262,55,665,216300,5043
912,671,241,1093,234800,5045
441,361,80,464,157400,5046
1116,837,279,890,236400,5048
49,14,35,-,163900,5050
718,629,89,889,182200,5051
105,53,52,-,111800,5052
176,166,10,1500,303300,5053
1330,1050,280,1214,434000,5055
190,161,29,550,301700,5056
106,104,2,-,203800,5058
312,159,153,1648,250600,5059
1927,1455,472,786,177300,5060
524,473,51,790,200800,5061
299,244,55,878,297700,5062
448,362,86,1076,188100,5065
113,113,0,-,360300,5067
1434,732,702,917,215600,5068
238,189,49,1000,144700,5069
199,169,30,1042,326600,5070
96,84,12,-,335300,5071
232,200,32,1654,241700,5072
507,453,54,1125,265600,5075
160,132,28,848,165000,5076
512,436,76,950,214800,5077
292,256,36,788,172500,5079
252,141,111,655,130700,5081
103,64,39,564,96700,5083
106,106,0,-,232400,5084
315,283,32,1550,154500,5086
2201,1465,736,737,178200,5089
1590,1209,381,1094,369300,5091
1937,1129,808,816,151400,5101
71,42,29,-,152900,5141
300,246,54,741,200000,5142
1943,1393,550,841,206500,5143
328,270,58,758,263100,5146
469,354,115,888,250800,5148
1008,615,393,771,242500,5149
522,376,146,920,129700,5150
616,578,38,(X),187100,5151
183,151,32,850,350000,5152
352,264,88,838,167100,5153
240,152,88,808,184600,5154
362,264,98,(X),296300,5155
3583,2320,1263,879,145900,5156
438,336,102,723,157700,5158
252,201,51,905,340400,5161
6033,3820,2213,814,162900,5201
1594,1202,392,950,255700,5250
691,546,145,1087,377100,5251
126,109,17,(X),206800,5252
315,275,40,774,244800,5253
114,105,9,-,390500,5254
1849,1232,617,890,284500,5255
910,634,276,995,199800,5257
149,95,54,617,100900,5260
1152,932,220,920,176900,5261
1124,946,178,939,233200,5262
7362,4318,3044,866,215800,5301
300,250,50,745,333300,5340
216,169,47,794,224300,5341
278,246,32,1056,235800,5342
362,294,68,784,219700,5343
1044,900,144,957,216200,5345
1959,1582,377,781,209500,5346
375,313,62,473,160700,5350
378,341,37,797,215000,5352
405,296,109,821,211600,5353
818,627,191,750,221800,5354
299,252,47,745,178800,5355
447,296,151,679,252700,5356
93,80,13,-,188300,5358
232,216,16,913,226100,5359
105,91,14,792,359400,5360
376,315,61,813,212700,5361
45,45,0,-,227900,5362
983,752,231,1033,252200,5363
12242,3566,8676,1064,314500,5401
8166,5347,2819,1281,267900,5403
3046,1161,1885,1027,224900,5404
0,0,0,-,-,5405
4034,3025,1009,894,233300,5408
51,0,51,-,-,5439
713,552,161,926,194600,5440
376,338,38,1000,216500,5441
140,116,24,950,136900,5442
2683,2011,672,873,234000,5443
656,573,83,907,237300,5444
1469,1319,150,1443,480200,5445
6481,4623,1858,1137,263200,5446
32,29,3,-,147100,5447
376,355,21,1104,226600,5448
1956,1414,542,769,182900,5450
8415,6034,2381,1091,271400,5452
1814,1361,453,1154,241900,5454
380,306,74,1059,233300,5455
536,392,144,925,257500,5456
603,533,70,835,195400,5457
915,696,219,1063,256500,5458
862,772,90,1149,187800,5459
1805,1493,312,1068,274600,5461
758,651,107,1086,255000,5462
218,190,28,878,225000,5463
1306,870,436,914,233400,5464
2049,1844,205,1153,287400,5465
5005,4247,758,1060,236000,5468
357,246,111,983,155700,5471
648,509,139,1032,247500,5472
577,486,91,996,274200,5473
414,371,43,1080,286800,5474
1210,895,315,854,134800,5476
1738,1321,417,1142,281900,5477
5777,3889,1888,860,199400,5478
0,0,0,-,-,5481
3001,2307,694,1855,369900,5482
554,468,86,742,217300,5483
21,21,0,-,96600,5485
705,545,160,1417,357700,5486
533,465,68,900,228600,5487
3027,2076,951,790,192900,5488
1229,1088,141,1141,312000,5489
2477,1899,578,878,226000,5491
273,240,33,936,167300,5492
643,594,49,946,276600,5494
4095,3192,903,1048,288600,5495
5207,3464,1743,893,238200,5602
87,83,4,-,282100,5640
7202,5039,2163,749,165200,5641
444,378,66,1063,168000,5647
157,143,14,-,246200,5648
239,205,34,781,159600,5649
507,406,101,1077,237800,5650
688,552,136,982,226400,5651
329,299,30,929,113100,5652
180,133,47,975,195800,5653
307,237,70,700,123600,5654
1243,1014,229,814,184000,5655
1166,677,489,800,167200,5656
35,35,0,-,316700,5657
559,446,113,773,165600,5658
729,655,74,1105,287400,5660
2454,1782,672,715,218900,5661
2149,1608,541,906,197700,5663
29,29,0,-,-,5664
815,641,174,891,190500,5667
281,218,63,1125,153400,5669
1989,1302,687,1032,373200,5672
1107,883,224,1082,342000,5673
757,605,152,746,279000,5674
436,370,66,783,196400,5675
2164,1590,574,919,250600,5676
971,790,181,849,277800,5677
54,35,19,-,115600,5678
1344,1006,338,859,162000,5679
859,744,115,976,206500,5680
166,166,0,-,223700,5681
465,410,55,1262,215500,5682
8956,5072,3884,748,171800,5701
127,125,2,-,255700,5730
369,191,178,909,180200,5732
2487,1940,547,797,185900,5733
534,406,128,910,225000,5734
1288,965,323,760,174800,5735
338,173,165,773,258000,5736
327,238,89,813,208800,5737
424,369,55,938,237500,5738
585,474,111,996,174500,5739
0,0,0,-,-,5740
232,205,27,-,233100,5742
1762,1255,507,807,160800,5743
215,153,62,1102,171600,5744
135,95,40,717,161700,5747
153,124,29,708,128600,5748
420,336,84,1144,292100,5751
3599,2234,1365,851,269500,5753
356,293,63,905,230700,5757
367,304,63,1115,190500,5758
801,672,129,935,192100,5759
486,398,88,970,203600,5760
378,318,60,695,248400,5761
220,167,53,947,246600,5762
1183,971,212,892,198100,5763
1320,952,368,791,160900,5764
724,561,163,850,153700,5765
269,214,55,808,214500,5766
480,362,118,659,193000,5767
476,369,107,838,258400,5769
422,363,59,1066,211700,5770
302,258,44,822,196000,5772
918,712,206,787,195900,5773
490,441,49,653,170400,5774
253,183,70,756,158000,5775
273,227,46,944,249100,5776
1393,1176,217,800,164100,5777
287,222,65,950,226900,5778
3936,2608,1328,717,163600,5819
279,254,25,631,154700,5820
428,390,38,1000,214900,5821
730,566,164,445,126900,5822
459,368,91,739,143900,5824
78,60,18,-,133300,5825
355,307,48,813,184600,5826
132,117,15,488,212500,5827
794,714,80,894,190900,5828
775,585,190,783,171800,5829
750,574,176,688,136000,5830
282,228,54,830,227800,5832
106,83,23,694,85500,5833
404,336,68,764,158800,5836
156,142,14,750,115000,5837
301,254,47,(X),150000,5839
200,177,23,581,262500,5841
203,171,32,788,109900,5842
1032,694,338,742,146300,5843
481,400,81,708,146600,5845
423,281,142,597,128100,5846
306,257,49,979,124800,5847
10,0,10,-,-,5850
2646,1773,873,718,143700,5851
282,238,44,1085,172600,5853
2884,1966,918,684,153000,5855
666,577,89,863,166100,5857
168,150,18,-,112500,5858
758,604,154,839,155500,5859
1014,836,178,709,127500,5860
155,126,29,(X),235300,5862
263,231,32,925,137500,5866
341,312,29,783,151400,5867
171,171,0,-,170100,5868
625,498,127,757,158700,5871
367,278,89,769,175700,5872
269,249,20,588,175900,5873
200,174,26,682,211500,5874
230,194,36,645,222100,5875
9,9,0,-,375000,5901
81,51,30,567,111200,5902
423,358,65,635,115400,5903
129,74,55,733,70000,5904
374,323,51,795,160700,5905
522,441,81,917,117100,5906
76,65,11,625,155200,5907
7202,6166,1036,1269,371600,6001
8484,6232,2252,1212,207900,6002
24921,16371,8550,894,194600,6010
3374,3144,230,1346,317200,6013
2559,1717,842,1228,234800,6016
1031,678,353,1095,207700,6018
3994,3243,751,1172,299200,6019
0,0,0,-,-,6020
118,108,10,-,288600,6021
14,14,0,-,-,6022
469,446,23,-,279800,6023
339,302,37,1280,256400,6024
2081,1592,489,913,283900,6026
516,474,42,794,270700,6027
6352,4308,2044,1210,257100,6029
610,524,86,839,295900,6031
7231,5238,1993,1255,339900,6032
11031,8834,2197,1153,334700,6033
3144,2879,265,1002,275400,6035
7442,6256,1186,1083,288600,6037
726,448,278,1022,366100,6039
14317,7971,6346,1073,199600,6040
9824,5477,4347,1274,174300,6042
2021,1814,207,1047,293100,6043
11700,3174,8526,860,146900,6051
3014,1863,1151,1025,192300,6052
13155,6198,6957,912,160400,6053
2390,2191,199,925,281200,6057
701,527,174,725,301400,6058
0,0,0,-,-,6059
788,714,74,-,373200,6060
106,106,0,-,147800,6061
7462,5068,2394,977,199300,6062
1249,1147,102,1026,248800,6063
306,295,11,-,260300,6065
13192,7200,5992,979,205800,6066
7911,5263,2648,1297,260200,6067
667,460,207,1143,564600,6068
1155,998,157,1138,413300,6069
5407,4719,688,1241,327500,6070
3388,2848,540,1145,308000,6071
2090,1839,251,1467,460600,6073
9602,8339,1263,1133,276300,6074
5095,3737,1358,939,195300,6076
3607,3027,580,1209,292400,6078
604,458,146,942,209500,6081
16225,12020,4205,1061,186900,6082
5254,4940,314,1182,280500,6084
2889,2215,674,718,315500,6085
1863,1390,473,1080,169100,6088
1227,925,302,1067,296800,6089
407,346,61,-,289300,6090
55,44,11,1917,277500,6091
1567,1417,150,2636,391300,6092
1063,1004,59,1300,323300,6093
10775,8891,1884,1180,223100,6095
4974,3847,1127,1061,195800,6096
5486,3403,2083,956,186900,6098
1001,200,801,1581,150000,6103
9687,1551,8136,825,247100,6105
13875,3267,10608,900,158400,6106
7617,6485,1132,1387,364300,6107
9332,4155,5177,921,165200,6108
10775,8369,2406,1026,249300,6109
4938,3290,1648,994,223900,6110
12649,10132,2517,1149,228600,6111
7315,2523,4792,919,153800,6112
9405,2670,6735,968,164500,6114
5490,4558,932,1287,357000,6117
10893,7274,3619,940,165600,6118
6664,3535,3129,1218,295300,6119
4187,651,3536,743,161400,6120
0,0,0,-,-,6160
6688,2494,4194,751,143300,6226
1265,1168,97,1571,311400,6231
1158,1056,102,807,276200,6232
2928,2266,662,927,223100,6234
799,676,123,980,206000,6235
2063,1751,312,1136,241900,6237
4580,4141,439,1141,256700,6238
4340,2667,1673,884,172300,6239
2815,2325,490,1065,220000,6241
566,490,76,868,246400,6242
0,0,0,-,-,6243
1066,903,163,1190,229300,6247
2105,1970,135,1129,291200,6248
2661,2387,274,1110,265400,6249
1880,1428,452,1107,238000,6250
710,626,84,1528,242000,6254
1904,1349,555,909,191300,6255
1031,816,215,976,172100,6256
1541,1198,343,850,284800,6259
3825,2200,1625,843,178300,6260
289,236,53,924,161400,6262
77,24,53,-,-,6263
29,29,0,-,195800,6264
162,146,16,-,155100,6266
3553,1898,1655,1079,246800,6268
0,0,0,-,-,6269
1538,1388,150,781,209700,6277
1737,1459,278,843,232000,6278
2417,1609,808,1036,229300,6279
1286,982,304,1065,195300,6280
2645,2270,375,1033,253300,6281
476,440,36,-,211100,6282
10786,3786,7000,880,185400,6320
1275,889,386,1097,220700,6330
1891,1689,202,853,234200,6331
181,159,22,-,151800,6332
2355,2035,320,1198,347200,6333
996,836,160,1307,237500,6334
2619,2178,441,1131,245500,6335
16,16,0,-,(X),6336
3018,2451,567,1162,242300,6339
12563,4917,7646,1138,222600,6340
49,36,13,-,195000,6350
6067,4459,1608,956,214200,6351
16,16,0,-,-,6353
2346,1635,711,891,169700,6354
5536,4254,1282,1273,313500,6355
4873,3724,1149,1202,288600,6357
2019,1652,367,1078,289000,6359
14996,8071,6925,948,175500,6360
1935,1598,337,1151,244400,6365
2733,2388,345,1168,220700,6370
4129,3349,780,1351,410500,6371
113,86,27,-,180700,6373
2934,2265,669,751,177000,6374
1505,1334,171,1009,234700,6375
93,93,0,-,592900,6376
937,846,91,1304,227300,6377
2297,1755,542,1262,391900,6378
3616,2438,1178,876,280300,6379
1068,402,666,889,187300,6380
4060,3169,891,1001,185000,6382
1060,926,134,889,223700,6384
6377,5383,994,1176,259200,6385
87,0,87,982,-,6387
16,0,16,-,-,6389
134,93,41,1381,1058300,6390
6954,3972,2982,1057,216500,6401
2356,1967,389,1205,234000,6403
12337,8401,3936,1192,297000,6405
335,222,113,833,278200,6409
9921,8720,1201,1185,337700,6410
1830,1319,511,1103,330400,6412
5307,4291,1016,1234,282900,6413
32,32,0,-,411100,6414
5946,4601,1345,1150,274500,6415
5456,4597,859,1088,245600,6416
1917,1551,366,984,270200,6417
4911,2780,2131,1086,207000,6418
2513,2391,122,1167,385300,6419
1530,1425,105,1388,271000,6420
2594,2357,237,1206,355600,6422
2019,1709,310,974,330600,6423
4939,4248,691,1147,260300,6424
1473,1206,267,1205,494300,6426
8725,7372,1353,1288,382900,6437
1077,954,123,807,322100,6438
2037,1852,185,1356,312400,6441
1184,909,275,1089,339600,6442
6779,5943,836,1217,455700,6443
82,45,37,-,-,6444
2289,2093,196,1132,295800,6447
14916,9055,5861,966,181300,6450
9791,5766,4025,934,175800,6451
1307,1223,84,-,296400,6455
137,115,22,-,325000,6456
19070,10092,8978,1054,226800,6457
15711,11472,4239,1428,295200,6460
5544,4940,604,1228,319200,6461
21,21,0,-,-,6467
6694,6171,523,1719,377200,6468
1198,992,206,1102,255500,6469
5773,4956,817,1289,422800,6470
3052,2643,409,1122,262400,6471
2377,2203,174,1354,306700,6472
8566,7234,1332,1212,295900,6473
4264,3552,712,1622,369300,6475
4875,4243,632,1810,384500,6477
4385,3836,549,1285,350200,6478
4134,3416,718,1014,263200,6479
3907,3297,610,998,260000,6480
444,361,83,1309,314000,6481
3941,3525,416,1407,404800,6482
6119,4498,1621,981,256100,6483
15392,12392,3000,1198,343200,6484
7669,6599,1070,1444,311400,6488
12801,10731,2070,1043,273900,6489
17708,13241,4467,1066,262800,6492
2841,2193,648,1204,357500,6498
1520,127,1393,1378,340600,6510
20861,4759,16102,1144,218600,6511
11788,7684,4104,1124,207700,6512
14760,5686,9074,976,170300,6513
10197,6486,3711,1233,194600,6514
6667,2865,3802,1057,211000,6515
20137,11110,9027,1084,200800,6516
6331,4235,2096,1074,256500,6517
6626,4615,2011,1488,253000,6518
5368,1158,4210,1074,156300,6519
2042,1822,220,1105,340900,6524
3084,2766,318,1197,474500,6525
10251,2800,7451,1052,171700,6604
8293,2438,5855,1121,203100,6605
16548,9823,6725,1154,175800,6606
2694,834,1860,1168,149500,6607
4294,986,3308,1047,161600,6608
8287,3980,4307,1086,140700,6610
12123,10709,1414,1965,396500,6611
2682,2513,169,1702,645900,6612
13414,11644,1770,1369,259400,6614
7300,4897,2403,1107,225800,6615
1605,44,1561,490,101200,6702
9127,3970,5157,887,119300,6704
10178,4418,5760,941,126500,6705
5050,2385,2665,858,136400,6706
10948,6625,4323,969,144500,6708
3296,994,2302,849,142700,6710
3205,2875,330,999,305400,6712
5746,4974,772,957,240900,6716
622,395,227,747,261100,6750
1277,1077,200,892,340800,6751
753,680,73,1342,494900,6752
654,550,104,1083,404600,6754
299,283,16,-,315500,6755
1091,1006,85,1092,385100,6756
826,482,344,1298,374600,6757
128,114,14,1750,381300,6758
2383,1912,471,1055,351300,6759
2718,2441,277,1288,344200,6762
785,650,135,790,360100,6763
12143,8006,4137,980,183400,6770
10110,7927,2183,1139,292700,6776
635,524,111,1146,387400,6777
531,531,0,-,276100,6778
3199,2487,712,957,197000,6779
867,743,124,953,225000,6782
922,787,135,1094,628800,6783
1450,1344,106,2516,486500,6784
271,199,72,1164,493400,6785
3823,3105,718,992,187900,6786
2982,2346,636,837,209200,6787
15077,10029,5048,873,168000,6790
2031,1931,100,647,290100,6791
476,368,108,1786,603800,6793
570,517,53,855,437100,6794
4934,4282,652,887,286400,6795
418,374,44,1023,438200,6796
4101,3063,1038,1102,334500,6798
7216,5641,1575,1337,329700,6801
5935,5033,902,1518,365700,6804
2521,1883,638,1918,961300,6807
17788,8338,9450,1286,265000,6810
11076,8952,2124,1292,312900,6811
4851,4630,221,1903,352800,6812
6555,5680,875,2717,1279900,6820
11204,9318,1886,1970,651600,6824
7375,5857,1518,1388,461600,6825
9406,4910,4496,1720,1218800,6830
5123,3866,1257,2013,1182300,6831
6857,5349,1508,1899,1332000,6840
7408,4956,2452,1469,397900,6850
11003,7799,3204,1463,419600,6851
1447,1213,234,2941,993400,6853
11061,5293,5768,1351,356400,6854
3122,1752,1370,1420,443100,6855
0,0,0,-,-,6856
2426,2056,370,2369,1368000,6870
8912,7516,1396,1487,673700,6877
2654,2177,477,1821,1229800,6878
9868,8437,1431,1913,1036600,6880
3379,3170,209,2530,865500,6883
1614,1408,206,2164,812000,6890
3518,2888,630,1424,605600,6896
5961,5118,843,2510,811400,6897
3880,515,3365,1385,284400,6901
24102,10967,13135,1606,401100,6902
5018,4755,263,"3,500+",776500,6903
7158,5339,1819,1747,517200,6905
3352,2013,1339,1573,447300,6906
3417,2563,854,1767,446800,6907
4974,2601,2373,1199,269000,7001
25474,9536,15938,1137,318300,7002
17479,9686,7793,1217,315200,7003
2508,2260,248,1704,476400,7004
5635,4374,1261,1287,426300,7005
9210,6878,2332,1376,507000,7006
7790,4370,3420,1289,245500,7008
4304,3308,996,1419,440200,7009
10473,5085,5388,1245,400800,7010
12601,6087,6514,1303,297600,7011
4654,2693,1961,1244,338700,7012
9931,7424,2507,1223,353000,7013
1768,1339,429,1369,334200,7014
8349,6629,1720,1404,453900,7016
14317,4060,10257,973,212500,7017
11270,2602,8668,1024,211100,7018
5671,1724,3947,2137,534800,7020
748,703,45,2850,830000,7021
5404,1967,3437,1184,354100,7022
2508,2299,209,1888,412100,7023
16533,9755,6778,1563,333600,7024
10891,3994,6897,1203,328000,7026
1633,1013,620,1400,360700,7027
2487,2225,262,1473,584000,7028
5969,1719,4250,1226,300500,7029
24579,7715,16864,1931,591900,7030
6122,3164,2958,1223,349800,7031
13783,6358,7425,1184,307100,7032
2605,2140,465,1473,342700,7033
3478,2352,1126,1169,329900,7034
3865,3029,836,1620,335400,7035
14949,8501,6448,1130,264400,7036
9696,8817,879,2291,568800,7039
7991,6143,1848,1352,471100,7040
2510,1526,984,1594,674600,7041
10075,4559,5516,1406,501400,7042
4293,3494,799,1642,667000,7043
5405,4202,1203,1364,422000,7044
3646,3449,197,2132,511800,7045
1370,1279,91,1850,815100,7046
21676,8938,12738,1211,296000,7047
11125,2379,8746,1041,238000,7050
16269,11049,5220,1369,353500,7052
11124,5999,5125,1179,435000,7054
19802,4822,14980,1092,302200,7055
4594,1936,2658,1109,366200,7057
1977,1067,910,1504,616200,7058
5010,4566,444,1439,698100,7059
14318,6036,8282,1138,264800,7060
4038,2624,1414,1200,237400,7062
3818,2466,1352,1267,253000,7063
1205,962,243,1440,280500,7064
10858,6276,4582,1262,268100,7065
5610,4460,1150,1276,412600,7066
5982,5290,692,1243,342500,7067
2426,2014,412,1933,494900,7068
2053,1716,337,2018,764900,7069
6939,4119,2820,1340,425200,7070
8165,4471,3694,1202,367100,7071
2313,1279,1034,1238,389800,7072
3637,1456,2181,1382,392000,7073
979,750,229,993,346100,7074
2948,2223,725,1627,376300,7075
8345,6470,1875,1389,473700,7076
930,733,197,1078,295200,7077
4010,3684,326,1741,1228100,7078
5301,3596,1705,1608,502000,7079
8018,6477,1541,1553,323100,7080
7068,4583,2485,1568,406000,7081
1683,1605,78,1635,534500,7082
19293,14372,4921,1354,311900,7083
5718,1835,3883,1269,491100,7086
23075,4261,18814,1114,290300,7087
1243,735,508,1362,208600,7088
10367,8362,2005,1600,670500,7090
2312,2126,186,2213,627200,7092
23547,5110,18437,1193,311200,7093
6751,3997,2754,1599,394200,7094
7365,3986,3379,1532,271300,7095
4617,327,4290,790,218200,7102
10100,2461,7639,903,180700,7103
18071,3622,14449,970,233500,7104
16424,3238,13186,1077,286700,7105
10739,3356,7383,983,204000,7106
12392,2562,9830,946,245300,7107
7392,1358,6034,874,189000,7108
12906,6714,6192,1177,276700,7109
11018,7455,3563,1310,359600,7110
20062,6509,13553,969,191800,7111
9201,2690,6511,994,224400,7112
3850,472,3378,781,215300,7114
7894,2088,5806,1080,252100,7201
13087,2984,10103,1065,265100,7202
8128,4297,3831,1084,213800,7203
4910,2896,2014,1183,271300,7204
7242,4757,2485,1199,236900,7205
7508,1677,5831,1122,234900,7206
10930,3272,7658,994,282700,7208
19180,5593,13587,1811,497400,7302
15517,4217,11300,1022,273100,7304
22113,8876,13237,1115,285900,7305
20273,4373,15900,1075,292600,7306
15929,4738,11191,1161,293500,7307
5809,823,4986,2509,613800,7310
191,0,191,3023,-,7311
2211,1937,274,1690,690800,7401
2851,1899,952,1387,320100,7403
6288,4899,1389,1427,423800,7405
6912,3888,3024,1473,358200,7407
11766,9105,2661,1423,390200,7410
2240,1566,674,1060,215400,7416
3734,3242,492,2242,952900,7417
663,617,46,-,275700,7418
3638,3045,593,1462,228200,7419
1580,1252,328,1402,272400,7420
2617,2224,393,1646,268500,7421
2369,2227,142,1182,216400,7422
1415,1289,126,2243,723000,7423
9594,6046,3548,1273,368300,7424
9224,7648,1576,1815,452000,7430
2786,1808,978,1421,457300,7432
980,806,174,1067,376000,7435
4361,4027,334,1516,436000,7436
4148,3760,388,1008,335100,7438
877,672,205,1331,249500,7439
1608,1371,237,691,373600,7440
4120,3089,1031,1367,296200,7442
4643,3485,1158,2203,371900,7444
5436,4746,690,1297,523100,7446
8306,6461,1845,1981,716100,7450
3862,3589,273,1557,601800,7452
3802,3698,104,2111,356700,7456
1959,1432,527,1960,333700,7457
3718,3300,418,1849,951600,7458
1282,1222,60,2141,266700,7460
6923,5742,1181,1103,282100,7461
2606,1801,805,1264,223800,7462
3428,2922,506,1893,424400,7463
2551,2132,419,1362,325200,7465
18123,14436,3687,1443,444800,7470
5868,5256,612,1367,297300,7480
5802,5297,505,1425,701400,7481
0,0,0,-,-,7495
10014,1459,8555,1046,230600,7501
4137,1998,2139,1299,237800,7502
5439,1647,3792,1134,267600,7503
3215,1277,1938,1150,275500,7504
1000,52,948,843,364700,7505
6829,4404,2425,1420,361500,7506
7318,5008,2310,1299,353500,7508
3308,2645,663,1466,378100,7512
3253,973,2280,1219,264300,7513
6377,1787,4590,1120,241500,7514
5860,1298,4562,1090,235400,7522
3742,917,2825,1088,222400,7524
18169,6603,11566,1270,283300,7601
2878,1935,943,1205,318300,7603
4471,2961,1510,1309,411300,7604
3336,2039,1297,1478,476700,7605
909,397,512,1431,387200,7606
3530,2246,1284,1328,380800,7607
43,2,41,1573,-,7608
575,501,74,2250,"2,000,000+",7620
8972,6032,2940,1189,337000,7621
2687,2165,522,1928,639100,7624
2964,2538,426,1834,557300,7626
1682,1524,158,3331,675600,7627
6308,4594,1714,1194,359300,7628
2401,1951,450,1748,461100,7630
10675,5645,5030,1415,376700,7631
1763,1563,200,3297,986800,7632
1564,1374,190,1694,603700,7640
1134,1064,70,3214,644900,7641
3534,3012,522,1453,511300,7642
4237,1946,2291,1262,319000,7643
9061,3632,5429,1172,341800,7644
2828,2383,445,1691,587300,7645
5979,3720,2259,1219,384500,7646
1763,1444,319,1449,464700,7647
2083,1661,422,1677,576300,7648
2633,2406,227,1339,549100,7649
7317,2309,5008,1388,515900,7650
8470,7431,1039,1832,545700,7652
3201,2547,654,1511,518100,7656
4002,2088,1914,1356,459200,7657
4633,2588,2045,1256,325300,7660
3949,2939,1010,1440,460200,7661
1923,1319,604,1350,352100,7662
5280,3613,1667,1421,362500,7663
13321,9902,3419,1314,393900,7666
4758,3710,1048,1718,743400,7670
9599,7707,1892,1504,549000,7675
3200,2984,216,2334,498200,7676
2088,1847,241,3420,736600,7677
9689,6282,3407,1297,378700,7701
1370,1258,112,2161,519800,7702
5,5,0,-,-,7703
2027,1920,107,1805,643800,7704
565,433,132,1422,639800,7711
16025,7025,9000,1066,372400,7712
3567,2691,876,1205,394500,7716
909,560,349,1395,880300,7717
2382,2153,229,1593,342900,7718
8674,6143,2531,1332,420800,7719
2152,953,1199,1208,494100,7720
1067,647,420,1218,281100,7721
3285,3041,244,1818,745400,7722
351,238,113,1237,1115400,7723
8957,5934,3023,1167,325900,7724
14972,13319,1653,1477,430000,7726
2719,1947,772,986,418200,7727
19761,15518,4243,1492,334700,7728
5934,5223,711,747,312800,7730
12539,11259,1280,1313,314700,7731
2533,1644,889,1061,250900,7732
5617,4878,739,1188,618900,7733
5365,3359,2006,977,216300,7734
7126,5088,2038,1167,253400,7735
1427,1236,191,1166,354000,7737
2050,1825,225,395,503200,7738
2080,1956,124,2129,597400,7739
12100,4985,7115,1223,319200,7740
6210,5956,254,2583,503400,7746
11566,8952,2614,1358,337300,7747
9542,8105,1437,1412,413900,7748
1431,1158,273,1810,646500,7750
5996,5709,287,2059,521100,7751
15493,9796,5697,1467,281100,7753
2106,1856,250,1193,379600,7755
1734,836,898,999,456300,7756
2137,1759,378,1096,425300,7757
1571,1349,222,1568,320600,7758
3320,2805,515,1464,847200,7760
3801,2406,1395,1405,593900,7762
2472,1871,601,1300,398900,7764
8034,4007,4027,1308,281700,7801
1182,1029,153,1098,292700,7803
33,33,0,-,-,7820
3319,3034,285,1387,299100,7821
281,244,37,-,321500,7822
3301,2385,916,881,230700,7823
3368,2935,433,1232,314000,7825
2360,1969,391,1317,308700,7826
1692,1144,548,1154,215300,7827
5714,2760,2954,1054,303000,7828
2407,2245,162,1642,460300,7830
1464,1235,229,1224,297000,7832
27,13,14,-,281300,7833
6938,6098,840,1603,382900,7834
4521,3066,1455,1399,399800,7836
1397,1066,331,1303,300500,7838
11805,7739,4066,1063,280200,7840
24,24,0,-,266700,7842
4555,4039,516,1346,235600,7843
33,16,17,-,225000,7846
518,410,108,1307,291400,7847
1539,1320,219,1183,321500,7848
3406,3088,318,1503,316500,7849
2259,1973,286,1134,279000,7850
27,27,0,-,241700,7851
1419,1047,372,1165,365900,7852
4334,4083,251,1785,461800,7853
1953,1449,504,1514,298500,7856
1497,750,747,1132,265400,7857
10025,7575,2450,1140,276100,7860
1590,1330,260,1194,251700,7863
772,653,119,1228,279200,7865
8100,6854,1246,1306,338800,7866
9020,6712,2308,1284,503900,7869
8,0,8,-,-,7870
6989,6366,623,1062,385700,7871
3088,2846,242,1617,252000,7874
3385,3230,155,1377,375500,7876
324,293,31,-,331800,7878
43,43,0,-,-,7880
4,4,0,-,-,7881
5344,4058,1286,988,252300,7882
3886,2526,1360,1316,280100,7885
8277,5729,2548,1475,796400,7901
9719,8083,1636,1898,645300,7920
3960,3184,776,1823,377200,7921
4116,3800,316,1648,584600,7922
2786,2295,491,1653,669100,7924
32,32,0,-,-,7926
1415,1066,349,2027,461400,7927
6624,5445,1179,1729,762700,7928
2799,2646,153,1321,646700,7930
1112,878,234,2019,1036800,7931
3983,2835,1148,2125,605200,7932
1235,1089,146,1736,416700,7933
557,457,100,2100,717500,7934
172,139,33,-,616200,7935
3909,3540,369,1435,495600,7936
0,0,0,-,-,7939
5507,3875,1632,1562,659800,7940
3055,2811,244,1848,707700,7945
1023,1003,20,-,531700,7946
7115,5875,1240,1907,449200,7950
17001,10768,6233,1509,544700,7960
0,0,0,-,-,7961
67,67,0,-,(X),7970
4045,3369,676,1408,571400,7974
231,231,0,-,1479200,7976
203,120,83,1162,480600,7977
156,149,7,-,501700,7979
810,565,245,1489,425300,7980
3521,3081,440,2080,461600,7981
403,334,69,1707,150900,8001
8499,5415,3084,1284,229900,8002
10704,9568,1136,1476,301900,8003
3981,3379,602,1354,195900,8004
8846,7639,1207,1422,246400,8005
253,222,31,1194,727800,8006
2094,1340,754,791,192900,8007
3339,3003,336,1193,741200,8008
4579,3840,739,978,221200,8009
4541,2785,1756,1087,167700,8010
33,33,0,-,(X),8011
14861,10089,4772,1085,206800,8012
238,178,60,1163,179400,8014
7303,5577,1726,1071,171400,8015
11771,8623,3148,1037,236000,8016
364,291,73,1654,256400,8019
888,783,105,1093,260700,8020
17933,9519,8414,956,149300,8021
3512,3445,67,1352,307800,8022
190,126,64,1491,95400,8023
779,722,57,1559,214100,8026
2048,1697,351,1065,187100,8027
6541,4474,2067,973,195500,8028
1855,1395,460,700,175700,8029
4750,3249,1501,1031,127600,8030
4444,2900,1544,805,168800,8031
6365,4789,1576,1055,394000,8033
6878,5584,1294,1247,243000,8034
2925,2335,590,952,278500,8035
2174,2087,87,1129,285700,8036
8628,6635,1993,1139,231900,8037
40,24,16,723,225000,8038
29,29,0,-,(X),8039
363,318,45,-,380700,8041
43,43,0,-,226600,8042
10986,7352,3634,1137,300900,8043
1028,784,244,786,166700,8045
10359,8586,1773,1551,162300,8046
4457,3211,1246,1115,293300,8048
2167,1595,572,943,170700,8049
9431,7847,1584,1496,269400,8050
4631,3651,980,1190,171900,8051
8262,3960,4302,1100,186100,8052
17210,13042,4168,1346,275500,8053
17216,13900,3316,1445,253900,8054
9933,8447,1486,1376,350400,8055
1516,1467,49,878,358400,8056
7283,6092,1191,1127,483800,8057
2079,1675,404,953,171800,8059
8845,6445,2400,1142,231600,8060
945,761,184,1175,258300,8061
5155,4638,517,815,329900,8062
1072,843,229,1032,160200,8063
0,0,0,-,-,8064
3186,2371,815,1181,171200,8065
3417,1898,1519,894,129400,8066
602,526,76,1158,214400,8067
2777,1702,1075,930,216500,8068
4614,2548,2066,966,157300,8069
5234,3948,1286,960,164000,8070
3633,2789,844,991,188500,8071
98,94,4,-,213500,8072
130,130,0,-,318800,8073
0,0,0,-,-,8074
10380,7599,2781,1137,224800,8075
6868,5922,946,1438,271800,8077
3086,2233,853,861,173000,8078
4026,2395,1631,893,168800,8079
12555,11184,1371,1357,255900,8080
16413,13614,2799,1243,206200,8081
3614,2669,945,926,185400,8083
2601,1967,634,846,187500,8084
6627,5694,933,1441,282400,8085
3039,2213,826,1201,217900,8086
9979,8214,1765,1265,224700,8087
9382,8657,725,1206,261100,8088
1610,1309,301,981,189500,8089
2996,2650,346,1128,188700,8090
1975,1321,654,936,180600,8091
1311,1100,211,1569,276400,8092
3892,2404,1488,918,156200,8093
14373,12001,2372,1059,198400,8094
103,103,0,-,(X),8095
13714,9804,3910,1097,190600,8096
1116,1023,93,1274,194600,8097
3382,2628,754,1013,259500,8098
2414,542,1872,650,84000,8102
4703,2073,2630,961,85700,8103
8666,2749,5917,856,70300,8104
8745,4158,4587,886,90600,8105
4062,2749,1313,821,212500,8106
5189,3005,2184,936,193700,8107
7389,5002,2387,1142,244100,8108
8251,6174,2077,886,184800,8109
5740,4425,1315,979,137800,8110
4033,2761,1272,1247,207700,8201
862,781,81,984,973500,8202
4391,3027,1364,1245,364000,8203
7753,5974,1779,992,290500,8204
9965,7331,2634,1206,215500,8205
6266,5190,1076,1342,279900,8210
132,119,13,1146,769900,8212
5135,3825,1310,1093,207100,8215
0,0,0,-,-,8217
2572,2154,418,1427,294500,8221
1701,1510,191,1064,293900,8223
166,141,25,572,254900,8224
3055,2668,387,1454,235500,8225
5660,3524,2136,1021,575500,8226
2117,1810,307,1027,318200,8230
6187,3763,2424,1081,160300,8232
14376,12592,1784,1035,226100,8234
0,0,0,-,-,8240
353,327,26,1538,299400,8241
1290,1048,242,991,231500,8242
983,816,167,1144,631000,8243
4617,2503,2114,974,228100,8244
87,87,0,-,211900,8246
435,359,76,1206,1144200,8247
80,80,0,-,(X),8248
4124,3143,981,1246,182900,8251
6204,4092,2112,885,337100,8260
2955,2336,619,1062,259300,8270
13801,8828,4973,1016,163200,8302
725,672,53,1667,153200,8310
701,499,202,1146,172100,8311
2926,2253,673,1028,177500,8312
157,136,21,-,123100,8314
135,112,23,-,204200,8316
474,451,23,1292,225800,8317
4434,3937,497,991,212900,8318
439,431,8,-,235900,8319
0,0,0,-,-,8320
80,65,15,-,160600,8321
3501,3164,337,1279,206700,8322
368,302,66,1413,198000,8323
123,84,39,939,166700,8324
572,420,152,929,190600,8326
148,143,5,-,148700,8327
500,421,79,936,176000,8328
73,62,11,-,188500,8329
10558,7667,2891,1312,194000,8330
13360,8909,4451,972,156000,8332
235,211,24,967,273100,8340
996,444,552,819,174100,8341
1715,1564,151,1382,263800,8343
1874,1467,407,1091,186900,8344
318,256,62,778,158300,8345
298,264,34,-,175600,8346
124,67,57,1099,209100,8348
823,723,100,1023,155700,8349
352,291,61,-,218600,8350
174,128,46,979,158600,8352
194,140,54,861,151900,8353
14988,8803,6185,969,158800,8360
6286,5294,992,1070,193400,8361
15633,4279,11354,844,198200,8401
3285,2468,817,1072,465000,8402
559,496,63,1795,679300,8403
4274,2551,1723,1100,291600,8406
2294,2118,176,1129,387500,8501
3646,2900,746,1837,645800,8502
6866,5136,1730,1105,264900,8505
1578,1563,15,-,568200,8510
259,240,19,1094,257100,8511
4004,2353,1651,1191,446000,8512
1718,1502,216,1218,392600,8514
1894,1731,163,1473,412500,8515
2222,1682,540,975,192800,8518
9437,6632,2805,1223,277200,8520
1935,1651,284,1537,443100,8525
20012,17283,2729,1294,323500,8527
70,58,12,-,300000,8528
3211,2340,871,1218,361000,8530
2126,1867,259,1260,338500,8533
4941,4479,462,1254,477100,8534
1799,1678,121,1448,594700,8535
8056,3683,4373,1380,425100,8536
16741,11223,5518,1587,592600,8540
1612,555,1057,1428,463400,8542
6594,5592,1002,1550,604900,8550
1769,1642,127,1684,467300,8551
247,188,59,1492,461200,8553
1505,1270,235,893,173500,8554
292,242,50,591,256100,8555
2312,2031,281,1591,678800,8558
1975,1791,184,1240,449700,8559
1300,1151,149,1781,373400,8560
16,16,0,-,-,8561
1786,1113,673,966,240700,8562
405,10,395,803,-,8608
4588,1237,3351,974,91300,8609
11221,7243,3978,1060,194200,8610
8015,2675,5340,1076,99800,8611
13154,6242,6912,850,163700,8618
8695,6111,2584,1072,250700,8619
4361,3504,857,1117,277400,8620
3940,2536,1404,1205,258600,8628
3898,2605,1293,1141,130900,8629
8044,4939,3105,1076,189700,8638
887,10,877,1897,-,8640
1156,3,1153,1870,-,8641
11978,8150,3828,1400,279300,8648
7328,6289,1039,1271,289500,8690
5910,4925,985,1583,378800,8691
24256,11867,12389,1350,283400,8701
255,250,5,-,472100,8720
7646,6427,1219,1213,267300,8721
3714,3162,552,1585,242100,8722
12605,10195,2410,1211,273100,8723
16862,14555,2307,1325,270100,8724
1857,1686,171,1780,600500,8730
7856,6951,905,1363,257900,8731
643,527,116,1460,393900,8732
823,545,278,1723,203000,8733
3062,2723,339,1177,300700,8734
1686,1492,194,1220,628500,8735
4800,3907,893,1338,559300,8736
470,448,22,1391,989000,8738
838,598,240,1633,252700,8740
942,893,49,1618,300600,8741
9611,7525,2086,1482,393000,8742
1431,1269,162,1458,812300,8750
1846,809,1037,1309,420400,8751
1301,1026,275,1221,571200,8752
23284,18390,4894,1340,282100,8753
10056,8598,1458,1234,274400,8755
16988,15107,1881,1275,151500,8757
3346,2997,349,1323,300900,8758
18791,16419,2372,1103,105600,8759
2659,2151,508,1610,391800,8801
1465,1301,164,1253,385700,8802
994,908,86,1340,294000,8804
4367,2604,1763,1181,292500,8805
13106,10705,2401,1666,447700,8807
7,7,0,-,-,8808
1953,1470,483,1307,338100,8809
2747,2377,370,1665,369100,8810
4683,3866,817,1333,346900,8812
16240,13290,2950,1312,376800,8816
15596,8605,6991,1419,303100,8817
13268,9727,3541,1339,458800,8820
91,78,13,-,246400,8821
11674,9212,2462,1333,388700,8822
3682,2547,1135,1833,258600,8823
4133,3755,378,1132,410500,8824
1634,1336,298,1199,358700,8825
2166,1662,504,1116,364800,8826
1702,1484,218,1102,367100,8827
857,687,170,1586,268400,8828
1530,1236,294,1413,251500,8829
6039,4170,1869,1528,291500,8830
19763,17324,2439,1347,324400,8831
834,192,642,1248,230600,8832
3283,2827,456,1709,464500,8833
3789,2447,1342,1266,251100,8835
1319,1296,23,-,605500,8836
6334,3433,2901,1197,309500,8837
5876,4722,1154,1526,370900,8840
13367,11535,1832,1344,394400,8844
4882,3722,1160,1314,303500,8846
3000,2718,282,1182,354600,8848
3059,2594,465,1238,353600,8850
6510,4092,2418,1466,378200,8852
1762,1334,428,1182,519400,8853
16609,10976,5633,1430,307800,8854
14623,9876,4747,1144,343700,8857
30,30,0,-,-,8858
7638,5141,2497,1135,295300,8859
17086,5857,11229,1169,247400,8861
4400,3095,1305,1185,289900,8863
11655,7535,4120,938,190400,8865
1815,1698,117,1125,536100,8867
2712,1707,1005,1431,332600,8869
7152,4514,2638,1162,293000,8872
18939,12924,6015,1414,321500,8873
8134,5860,2274,1257,354100,8876
9407,5785,3622,1175,274300,8879
1605,980,625,1262,242600,8880
5374,3583,1791,1155,277600,8882
3275,2711,564,888,284300,8884
2327,1945,382,1373,330000,8886
560,387,173,1591,189900,8887
3689,3343,346,1590,436300,8889
0,0,0,-,-,8890
14329,2782,11547,1343,242200,8901
14869,8853,6016,1444,302000,8902
5690,2345,3345,1287,358400,8904
11639,3161,8478,1989,575900,10001
33348,4524,28824,882,578300,10002
27487,8210,19277,2030,913200,10003
1574,487,1087,2851,847500,10004
4252,662,3590,2918,1332100,10005
1745,162,1583,2824,817300,10006
2781,1055,1726,3423,1682200,10007
29770,2039,27731,1485,659300,10009
16050,4086,11964,2295,729900,10010
29762,10294,19468,2000,926600,10011
12470,2073,10397,2027,1192300,10012
11558,3327,8231,1512,"2,000,000+",10013
18786,5897,12889,2281,943400,10014
28390,8608,19782,2327,746900,10016
10157,3740,6417,2218,607300,10017
4712,451,4261,2784,932700,10018
23146,4248,18898,2169,846600,10019
0,0,0,-,-,10020
23739,9309,14430,1913,1138700,10021
17892,8694,9198,2259,868600,10022
32755,12899,19856,2173,883700,10023
28675,10297,18378,1849,1121600,10024
43456,10481,32975,1428,972000,10025
14527,2554,11973,992,644800,10026
22937,3239,19698,1026,672400,10027
24941,8164,16777,2081,1175100,10028
30115,1867,28248,886,799900,10029
11891,1245,10646,905,500500,10030
21191,2205,18986,1150,333400,10031
20243,1352,18891,1109,413400,10032
19548,2003,17545,1240,457800,10033
15462,1396,14066,1159,344100,10034
12999,1070,11929,770,437600,10035
15455,1613,13842,1965,809200,10036
9109,632,8477,1047,356800,10037
9780,2531,7249,2051,607100,10038
10631,1355,9276,859,395800,10039
16002,1545,14457,1228,351400,10040
4622,566,4056,2145,602000,10044
16742,5734,11008,2143,1139900,10065
2850,701,2149,3075,1628000,10069
14145,6107,8038,1999,778300,10075
0,0,0,-,-,10103
0,0,0,-,-,10110
0,0,0,-,-,10111
0,0,0,-,-,10112
0,0,0,-,-,10115
0,0,0,-,-,10119
31920,9902,22018,1962,919300,10128
0,0,0,-,-,10152
0,0,0,-,-,10153
0,0,0,-,-,10154
671,0,671,3009,-,10162
0,0,0,-,-,10165
0,0,0,-,-,10167
0,0,0,-,-,10168
0,0,0,-,-,10169
0,0,0,-,-,10170
0,0,0,-,-,10171
0,0,0,-,-,10172
0,0,0,-,-,10173
0,0,0,-,-,10174
0,0,0,-,-,10177
0,0,0,-,-,10199
0,0,0,-,-,10271
0,0,0,-,-,10278
0,0,0,-,-,10279
4588,1115,3473,2890,720300,10280
2439,205,2234,3084,"2,000,000+",10282
14063,6252,7811,1168,409300,10301
6017,3468,2549,1168,356500,10302
8029,4651,3378,958,304600,10303
14564,7735,6829,1074,423200,10304
14931,9813,5118,1195,409500,10305
20215,14423,5792,1195,449500,10306
5110,3967,1143,1203,582300,10307
10675,8922,1753,1245,450600,10308
11052,8746,2306,1235,541600,10309
8304,5039,3265,1061,410800,10310
0,0,0,-,-,10311
21530,18018,3512,1215,470800,10312
31294,22966,8328,1199,431200,10314
18140,2308,15832,931,161800,10451
25432,846,24586,1044,306000,10452
26802,943,25859,1028,441300,10453
12790,696,12094,673,373500,10454
14023,1032,12991,796,291800,10455
29255,1780,27475,927,368000,10456
23749,1554,22195,1060,378300,10457
26349,1180,25169,1121,340900,10458
15688,1371,14317,920,348400,10459
19776,1894,17882,951,384100,10460
19086,5673,13413,1244,440000,10461
29345,6485,22860,1210,211800,10462
27458,8454,19004,1191,277900,10463
2024,1274,750,1365,476400,10464
15560,8707,6853,1259,434300,10465
22891,8593,14298,1138,392900,10466
35178,3972,31206,1140,349900,10467
24631,2111,22520,1148,192100,10468
22014,10599,11415,1261,418900,10469
5747,2254,3493,1258,404100,10470
8620,4338,4282,1488,340700,10471
21303,2894,18409,1065,417900,10472
20624,5895,14729,890,373000,10473
3613,234,3379,1015,364400,10474
18271,7180,11091,946,33400,10475
399,390,9,-,606000,10501
1859,1587,272,1238,617400,10502
106,106,0,-,575700,10503
2473,2252,221,2370,1030300,10504
267,173,94,1316,757500,10505
1862,1722,140,2308,947400,10506
1945,988,957,1381,573300,10507
6589,5012,1577,1313,347300,10509
3483,2881,602,1599,663600,10510
830,634,196,1494,371800,10511
9069,7425,1644,1169,309600,10512
4019,3762,257,1976,952100,10514
2094,1482,612,1433,426700,10516
161,130,31,1478,410800,10517
512,472,40,-,780400,10518
94,94,0,-,(X),10519
5086,3070,2016,1338,505800,10520
3685,2232,1453,1631,582900,10522
2768,1558,1210,1918,422200,10523
1439,1245,194,1775,450000,10524
650,576,74,1098,525700,10526
279,279,0,-,627500,10527
4472,2594,1878,1921,674700,10528
5795,4656,1139,1708,403100,10530
1664,1433,231,1226,492700,10532
2555,2020,535,1836,653200,10533
268,80,188,1244,296700,10535
3537,3136,401,2074,728700,10536
727,668,59,-,274100,10537
5964,4726,1238,1578,931600,10538
8821,7595,1226,1238,378600,10541
7594,4481,3113,1637,605500,10543
0,0,0,-,-,10545
432,386,46,3189,648400,10546
2565,1884,681,1381,341300,10547
1206,939,267,1411,354600,10548
5702,3722,1980,1371,566500,10549
13308,3273,10035,1177,353600,10550
8286,4726,3560,1284,358500,10552
3320,1712,1608,1303,376500,10553
1734,1422,312,1781,601000,10560
10058,5627,4431,1421,416000,10562
9072,4501,4571,1252,298700,10566
6894,6221,673,1664,398700,10567
4220,3385,835,1405,635400,10570
12500,6577,5923,1450,501300,10573
1864,1592,272,2110,920800,10576
825,728,97,3132,1159900,10577
268,219,49,1799,464500,10578
3144,2826,318,1173,398100,10579
5935,4475,1460,1898,1105400,10580
13702,11882,1820,1931,846600,10583
1055,845,210,1209,337300,10588
3774,3323,451,2506,463200,10589
2557,2347,210,1890,590100,10590
8628,4659,3969,1394,545400,10591
1587,1318,269,1288,602100,10594
2232,1572,660,1585,594800,10595
620,305,315,1361,294900,10596
326,326,0,-,976500,10597
10378,9207,1171,1376,428800,10598
5327,1597,3730,1569,306400,10601
6729,4385,2344,1485,403000,10603
3852,2189,1663,1683,654000,10604
6777,5117,1660,1582,605900,10605
5604,2254,3350,1551,525400,10606
2079,1791,288,1676,521500,10607
21624,6643,14981,1194,350100,10701
6988,3638,3350,1272,342400,10703
12307,6942,5365,1332,375200,10704
13572,4355,9217,1123,406300,10705
3268,2363,905,1653,657300,10706
4094,2609,1485,1756,562300,10707
9175,6812,2363,1543,454600,10708
3621,2893,728,1536,600400,10709
10204,7098,3106,1356,429100,10710
14179,5346,8833,1318,457300,10801
3899,3097,802,1728,734500,10803
5053,4697,356,1676,671500,10804
7740,2737,5003,1418,334200,10805
8659,6318,2341,1232,399500,10901
23,0,23,-,-,10910
0,0,0,-,-,10911
1619,1597,22,-,499500,10913
91,91,0,-,398900,10914
39,39,0,-,-,10915
1265,1151,114,2047,346200,10916
624,472,152,1454,333300,10917
3994,3302,692,1362,305700,10918
508,448,60,-,244800,10919
3012,2546,466,1441,431300,10920
1404,1092,312,1078,270100,10921
548,421,127,1698,245500,10922
2623,1669,954,1363,348400,10923
4615,3102,1513,1178,321200,10924
1833,1424,409,1320,277800,10925
1393,816,577,1307,191000,10926
3612,1575,2037,1296,261000,10927
1869,853,1016,1108,226300,10928
2797,2562,235,(X),321000,10930
335,237,98,1356,321700,10931
24,24,0,-,-,10932
224,224,0,-,277800,10933
17356,10273,7083,1120,212500,10940
4687,3288,1399,1248,256900,10941
12765,8735,4030,1177,308400,10950
9245,4715,4530,1308,494500,10952
50,50,0,-,(X),10953
8614,6120,2494,1530,396300,10954
10083,9069,1014,1241,484000,10956
865,732,133,1008,286300,10958
6143,3008,3135,1513,469900,10960
1777,1473,304,910,478500,10962
823,688,135,1608,237100,10963
573,371,202,(X),533900,10964
5500,4312,1188,1353,432000,10965
1172,800,372,1411,611500,10968
538,339,199,2092,306500,10969
3475,2569,906,1722,321900,10970
824,582,242,1113,260600,10973
1097,836,261,1435,324400,10974
167,125,42,1489,184600,10975
661,346,315,656,482000,10976
15122,7468,7654,1220,369000,10977
125,125,0,-,266800,10979
4610,3864,746,1377,365100,10980
1897,1777,120,2160,448400,10983
875,814,61,1738,369600,10984
16,16,0,-,-,10985
599,542,57,1350,459400,10986
1385,1113,272,1369,442700,10987
320,278,42,980,192300,10988
3435,2908,527,1730,394900,10989
7283,5831,1452,1171,328000,10990
3165,2576,589,886,276100,10992
1513,839,674,1219,241000,10993
2555,2334,221,1298,480400,10994
814,4,810,3119,-,10996
860,749,111,1236,300300,10998
9131,7298,1833,1502,482300,11001
12042,9771,2271,1648,372600,11003
4862,3735,1127,1248,457600,11004
1522,1398,124,2508,394300,11005
7827,6498,1329,1331,432900,11010
1958,1712,246,(X),890300,11020
7468,5023,2445,1703,595900,11021
3021,2449,572,2442,807300,11023
2143,1799,344,1448,1298200,11024
5962,5196,766,1543,1133000,11030
12945,11569,1376,1453,538600,11040
0,0,0,-,-,11042
11047,7260,3787,1974,749800,11050
2507,1157,1350,1312,359600,11096
11772,2012,9760,1271,755100,11101
14039,1966,12073,1490,602400,11102
16607,2478,14129,1465,654700,11103
11540,1825,9715,1421,396800,11104
15532,4004,11528,1538,679900,11105
17004,3043,13961,1380,434200,11106
2560,388,2172,2875,473600,11109
25664,9376,16288,2000,750500,11201
27447,10810,16637,1172,413400,11203
24480,9407,15073,1217,687900,11204
15198,3139,12059,1209,612300,11205
29525,3207,26318,912,516000,11206
32005,7478,24527,1063,399800,11207
29806,7353,22453,1137,417300,11208
30483,10706,19777,1362,661500,11209
21925,10052,11873,1166,491800,11210
37381,5934,31447,1427,766700,11211
31443,4682,26761,923,394200,11212
24163,3350,20813,1076,622800,11213
31512,10372,21140,1198,626300,11214
29182,10967,18215,1914,957500,11215
23048,4718,18330,1160,685600,11216
16797,4973,11824,1743,945000,11217
24909,8310,16599,1381,596600,11218
26390,6826,19564,1245,770700,11219
29399,6774,22625,1213,650900,11220
28918,5873,23045,1160,561200,11221
16689,3430,13259,1670,698800,11222
27532,9908,17624,1172,630700,11223
18064,5132,12932,701,316800,11224
23133,3273,19860,1206,652500,11225
36009,4531,31478,1197,470900,11226
15285,8670,6615,1316,713200,11228
30764,14313,16451,1160,524700,11229
30653,8658,21995,1245,662700,11230
15265,4094,11171,1623,1021900,11231
8784,2014,6770,1329,546300,11232
26987,6120,20867,1075,571300,11233
32185,21328,10857,1299,492500,11234
32065,12979,19086,1161,520500,11235
32442,15589,16853,1274,470900,11236
16582,1530,15052,1323,511500,11237
23310,6667,16643,1461,702000,11238
6362,174,6188,796,377300,11239
0,0,0,-,-,11351
20006,7771,12235,1344,421000,11354
27354,8673,18681,1287,500500,11355
7712,3507,4205,1475,555500,11356
14846,11097,3749,1610,599000,11357
13114,7354,5760,1514,643300,11358
0,0,0,-,-,11359
8567,5866,2701,1880,503000,11360
10606,6125,4481,1659,588600,11361
7068,5613,1455,1757,529500,11362
2649,1831,818,1748,798000,11363
13205,9599,3606,1582,506900,11364
15764,7444,8320,1390,596300,11365
4191,3004,1187,1574,647900,11366
14644,6935,7709,1238,378000,11367
29095,6182,22913,1423,465300,11368
11482,5449,6033,1336,471700,11369
8809,3998,4811,1539,540500,11370
0,0,0,-,-,11371
24793,7378,17415,1316,263800,11372
31351,8449,22902,1373,473900,11373
19483,6816,12667,1349,288900,11374
32272,16072,16200,1566,360100,11375
31455,9101,22354,1380,428200,11377
12411,6413,5998,1402,544700,11378
13528,8030,5498,1353,563100,11379
34937,10740,24197,1294,487400,11385
6022,5038,984,1377,389000,11411
10871,8032,2839,1278,380200,11412
12339,9016,3323,1502,405500,11413
10654,7582,3072,1514,503100,11414
8250,3046,5204,1397,305500,11415
7134,2997,4137,1355,442900,11416
9450,5358,4092,1334,437100,11417
11371,4794,6577,1357,446900,11418
12357,6839,5518,1366,426500,11419
13474,8947,4527,1395,420800,11420
12228,6792,5436,1396,406300,11421
9620,6302,3318,1593,410200,11422
9793,5842,3951,1237,430100,11423
0,0,0,-,-,11424
0,0,0,-,-,11425
6191,4697,1494,1502,477600,11426
7739,4505,3234,1275,455700,11427
5620,3683,1937,1377,424200,11428
7318,5187,2131,1331,379300,11429
0,0,0,-,-,11430
18362,6629,11733,1317,509100,11432
10394,4380,6014,1071,371100,11433
20731,10226,10505,1135,371200,11434
18486,6432,12054,1327,336700,11435
5454,3707,1747,1420,362400,11436
0,0,0,-,-,11451
7238,4753,2485,1526,443100,11501
2362,2277,85,1724,570900,11507
892,794,98,2429,726300,11509
10657,8947,1710,1606,363800,11510
1704,1155,549,1609,476300,11514
2255,1572,683,1607,523000,11516
3952,3215,737,2028,422900,11518
13456,9063,4393,1364,313100,11520
9365,8500,865,2231,694100,11530
9709,5076,4633,1683,468000,11542
4204,3724,480,1810,844000,11545
295,202,93,1637,500000,11547
419,301,118,1451,558900,11548
0,0,0,-,-,11549
16572,7455,9117,1292,314300,11550
7163,6126,1037,1692,390900,11552
6031,4478,1553,1327,301700,11553
12318,10633,1685,1901,388000,11554
0,0,0,-,-,11556
2363,2143,220,1449,511300,11557
3088,2266,822,1493,387500,11558
2737,2206,531,1652,778300,11559
2301,1747,554,1692,681600,11560
16199,9676,6523,1660,473200,11561
8238,6131,2107,1680,410900,11563
3191,3010,181,1243,435500,11565
10981,10400,581,2116,484600,11566
913,836,77,1574,1718800,11568
536,419,117,1871,812100,11569
9945,7040,2905,1421,587100,11570
10219,8898,1321,1256,442300,11572
4282,2901,1381,1423,289700,11575
4501,4050,451,1929,888500,11576
4114,3630,484,1628,693800,11577
1954,1410,544,1645,648500,11579
12728,10495,2233,1511,370700,11580
6773,5667,1106,1603,421600,11581
14084,10676,3408,1543,406700,11590
3553,2989,564,1736,534900,11596
3764,3339,425,1805,604100,11598
19607,4841,14766,1074,431300,11691
6249,2183,4066,847,349200,11692
4512,2141,2371,935,313100,11693
7956,4010,3946,1212,622700,11694
1520,1469,51,(X),530400,11697
8663,5528,3135,1311,314900,11701
5141,3982,1159,1678,426500,11702
5511,4423,1088,1726,335600,11703
12955,9497,3458,1499,335700,11704
2631,2056,575,1748,442700,11705
19458,13945,5513,1350,318300,11706
2410,1993,417,1388,539600,11709
11363,10044,1319,1792,442600,11710
3273,2183,1090,2132,319100,11713
7831,6877,954,1788,392100,11714
1607,1363,244,1682,378800,11715
3676,2755,921,1623,388000,11716
13800,9704,4096,1243,278300,11717
1086,988,98,1265,498200,11718
1038,839,199,1317,387000,11719
8977,7663,1314,2057,330900,11720
2302,2100,202,1481,592600,11721
9789,6351,3438,1471,254600,11722
955,892,63,3214,1030600,11724
9675,8752,923,1665,457700,11725
6343,4081,2262,1472,292400,11726
11242,6998,4244,1692,296000,11727
9233,7492,1741,1557,351100,11729
4461,4004,457,1586,402700,11730
10022,8763,1259,1664,454500,11731
1442,1029,413,2228,627800,11732
5701,5371,330,2041,480500,11733
11062,8928,2134,1621,372700,11735
5226,4471,755,1831,340400,11738
444,425,19,-,657000,11739
3345,2603,742,635,495800,11740
9210,7360,1850,1753,358200,11741
4518,3597,921,1700,334500,11742
15143,12932,2211,1800,561000,11743
21259,17495,3764,1615,461300,11746
7092,6231,861,2392,603600,11747
974,856,118,1815,313200,11749
5161,4238,923,1495,371500,11751
2987,2610,377,1657,348900,11752
4077,3576,501,1766,703100,11753
6612,5439,1173,1341,427400,11754
4093,3379,714,1785,381100,11755
13459,12263,1196,1796,352200,11756
15141,11621,3520,1427,341100,11757
18171,16240,1931,1430,440600,11758
7385,7156,229,2296,442100,11762
9347,7513,1834,1602,293200,11763
4100,3869,231,1288,426900,11764
276,230,46,1708,"2,000,000+",11765
4323,4040,283,1676,447600,11766
4745,4239,506,1370,452100,11767
7823,6576,1247,1670,612100,11768
3256,2829,427,1585,410600,11769
34,34,0,-,733300,11770
3480,2760,720,1457,726600,11771
16736,10375,6361,1394,293600,11772
8115,6569,1546,1573,340600,11776
3596,2718,878,1620,517000,11777
4268,3634,634,1429,277900,11778
12954,9782,3172,1440,332800,11779
5213,4605,608,1678,481200,11780
5421,4423,998,1747,427200,11782
7102,6411,691,1869,422100,11783
8039,6653,1386,1568,296600,11784
1886,1768,118,1917,419700,11786
11926,10416,1510,1342,462100,11787
5560,4510,1050,1868,459000,11788
2728,2424,304,1407,284900,11789
4702,4234,468,2303,454400,11790
8119,7484,635,1759,655100,11791
3077,2885,192,1105,428900,11792
10414,9808,606,1433,433600,11793
0,0,0,-,-,11794
7997,7574,423,1250,415100,11795
1253,1038,215,1485,393100,11796
3001,2616,385,2209,863000,11797
3970,2779,1191,1904,297200,11798
12796,10890,1906,1702,393100,11801
9543,8897,646,1883,493100,11803
1666,1502,164,298,550800,11804
9911,7070,2841,1335,305300,11901
599,482,117,2350,1250000,11930
17,17,0,-,-,11931
425,364,61,1244,1027000,11932
2574,2206,368,1493,348000,11933
2439,2111,328,1332,395000,11934
1316,1205,111,1785,492400,11935
6530,5291,1239,1682,791300,11937
462,415,47,1717,490000,11939
1918,1461,457,1762,392700,11940
783,564,219,1418,510800,11941
1592,1376,216,1793,478500,11942
1814,1178,636,1330,452400,11944
5210,3730,1480,1654,438600,11946
81,81,0,-,349000,11947
509,476,33,-,554800,11948
4897,4227,670,1508,409100,11949
4903,3868,1035,1610,233400,11950
4600,3308,1292,1664,188500,11951
1883,1490,393,1443,496500,11952
5151,3794,1357,1626,271700,11953
1734,1361,373,1342,792400,11954
1500,736,764,1657,339900,11955
167,120,47,1604,589300,11956
353,324,29,1575,645200,11957
237,224,13,-,623200,11958
383,314,69,1667,940200,11959
301,268,33,-,718400,11960
5182,4417,765,1422,251400,11961
165,160,5,-,"2,000,000+",11962
2832,2323,509,1850,824600,11963
862,766,96,1245,718200,11964
267,224,43,-,767600,11965
7814,6396,1418,1925,251900,11967
4359,3226,1133,1780,834500,11968
150,129,21,-,365800,11970
2660,2322,338,1372,509800,11971
398,331,67,950,508100,11972
0,0,0,-,-,11973
164,143,21,-,1551500,11975
1019,922,97,2635,1693200,11976
882,735,147,(X),706400,11977
1314,1000,314,1759,598700,11978
1643,1399,244,2031,298300,11980
8,8,0,-,-,12007
201,194,7,-,234400,12008
2882,2265,617,1001,258400,12009
11735,7404,4331,721,113900,12010
1019,778,241,864,184200,12015
130,124,6,-,241200,12017
2787,2379,408,1017,202700,12018
5678,4444,1234,957,270400,12019
12623,9505,3118,1049,212400,12020
386,315,71,1625,126900,12022
833,778,55,(X),181200,12023
26,26,0,-,-,12024
2202,1770,432,755,149100,12025
1441,1227,214,1048,254400,12027
342,317,25,-,195100,12028
414,340,74,1208,280600,12029
58,41,17,566,120800,12031
366,334,32,827,143800,12032
3084,2438,646,896,212500,12033
326,265,61,802,98400,12035
92,81,11,-,142000,12036
1711,1245,466,870,228300,12037
53,53,0,-,93700,12040
194,194,0,-,165400,12041
92,59,33,-,157300,12042
2981,1797,1184,745,158800,12043
156,120,36,575,156900,12045
341,311,30,-,211700,12046
8277,4151,4126,831,162000,12047
1511,1042,469,720,182300,12051
615,488,127,679,174700,12052
1426,1216,210,1236,213700,12053
6716,5156,1560,1132,267400,12054
792,703,89,781,237900,12056
862,758,104,723,173100,12057
720,577,143,885,193800,12058
665,616,49,745,219800,12059
582,498,84,(X),269000,12060
3763,2562,1201,1115,264500,12061
666,567,99,990,164700,12062
120,120,0,-,267800,12063
194,125,69,680,116300,12064
17390,11796,5594,1077,261000,12065
794,672,122,756,154600,12066
570,486,84,972,192300,12067
1211,931,280,641,126400,12068
60,41,19,-,103300,12069
662,588,74,850,112200,12070
118,99,19,(X),152500,12071
954,739,215,818,100400,12072
1206,1090,116,646,210900,12074
1167,981,186,830,231300,12075
630,547,83,750,137800,12076
2430,1870,560,1024,287400,12077
9649,6075,3574,687,89100,12078
1515,1332,183,713,170000,12083
2067,494,1573,1156,251600,12084
197,33,164,974,210700,12085
750,660,90,698,164800,12086
395,363,32,-,149600,12087
64,64,0,-,152800,12089
2371,1601,770,805,148500,12090
326,255,71,644,106700,12092
702,577,125,702,147400,12093
899,829,70,713,185200,12094
4988,3208,1780,716,106100,12095
1034,850,184,1051,252400,12106
147,120,27,675,223300,12108
7707,5716,1991,1110,232200,12110
106,73,33,-,(X),12115
855,670,185,950,117000,12116
1436,1161,275,801,144000,12117
5865,3814,2051,867,218400,12118
254,224,30,1288,201100,12120
723,671,52,-,203300,12121
1979,1620,359,725,127100,12122
2122,1709,413,809,178400,12123
213,204,9,-,193000,12124
651,493,158,973,187100,12125
336,256,80,-,214800,12130
48,42,6,-,125000,12131
117,92,25,-,149500,12132
1422,1218,204,782,162700,12134
379,352,27,-,356400,12136
614,522,92,1064,190800,12137
1372,1180,192,733,163200,12138
77,70,7,-,150000,12139
634,558,76,935,226800,12140
2131,1329,802,853,171900,12143
8608,5406,3202,937,168600,12144
182,167,15,-,207000,12147
1812,1536,276,2625,299600,12148
938,680,258,701,157400,12149
304,291,13,-,174300,12150
363,289,74,1053,202000,12151
325,325,0,-,252000,12153
1044,868,176,703,190000,12154
726,567,159,700,120900,12155
403,335,68,685,284200,12156
1666,1356,310,730,165200,12157
2553,2190,363,946,210200,12158
3317,2471,846,1004,339600,12159
342,312,30,540,131000,12160
34,19,15,-,-,12161
85,77,8,-,202100,12164
66,49,17,-,350000,12165
527,471,56,638,104200,12166
1134,770,364,578,146800,12167
802,613,189,917,164600,12168
166,148,18,-,207100,12169
1817,1536,281,1218,215000,12170
126,91,35,1051,153500,12172
710,539,171,898,181800,12173
114,69,45,1005,159400,12174
247,221,26,881,149400,12175
127,127,0,-,142700,12176
250,208,42,-,93200,12177
21143,10031,11112,875,169200,12180
6189,3523,2666,773,143100,12182
1078,359,719,868,119700,12183
2642,2124,518,916,225100,12184
798,714,84,800,185600,12185
2521,2142,379,934,250600,12186
199,199,0,-,159100,12187
4730,3032,1698,863,211300,12188
7946,3439,4507,831,158600,12189
266,241,25,944,147800,12190
604,550,54,643,178700,12192
788,771,17,-,172700,12193
66,66,0,-,(X),12194
112,60,52,861,208300,12195
1308,1151,157,769,236300,12196
932,781,151,700,123300,12197
2919,2498,421,967,191400,12198
3993,1050,2943,715,107200,12202
13201,6709,6492,963,196500,12203
3329,893,2436,953,181700,12204
11367,7726,3641,1051,192700,12205
5996,1682,4314,857,120400,12206
933,78,855,353,(X),12207
9660,4405,5255,960,190400,12208
4560,2444,2116,895,152600,12209
4497,1058,3439,785,158200,12210
4283,3795,488,1518,279100,12211
0,0,0,-,-,12222
10496,7855,2641,946,179800,12302
10826,7997,2829,818,171100,12303
8581,5401,3180,855,128100,12304
2342,359,1983,676,123200,12305
9526,7030,2496,895,163000,12306
2275,730,1545,816,77400,12307
5195,2342,2853,813,134900,12308
11031,9059,1972,1003,235200,12309
14401,7765,6636,992,183800,12401
1380,1202,178,1205,257300,12404
263,191,72,802,221100,12405
438,294,144,734,173900,12406
90,84,6,-,206300,12407
328,271,57,1125,399100,12409
281,250,31,828,214000,12410
160,160,0,-,218600,12411
298,174,124,930,180700,12412
1186,653,533,868,152100,12413
3884,2471,1413,887,180400,12414
99,96,3,-,208800,12416
242,165,77,1042,99800,12417
151,145,6,-,124500,12418
213,112,101,934,213000,12419
204,163,41,-,264000,12420
189,173,16,-,(X),12421
117,117,0,-,196500,12422
466,380,86,810,157700,12423
139,107,32,917,200700,12424
144,133,11,-,246400,12427
2363,1491,872,922,157200,12428
71,37,34,-,-,12429
484,407,77,597,208600,12430
563,367,196,1113,243600,12431
240,150,90,1099,200000,12432
201,171,30,-,296100,12433
275,184,91,575,90000,12434
120,70,50,1000,231000,12435
178,170,8,-,190400,12436
34,34,0,-,(X),12438
158,135,23,818,180500,12439
949,712,237,1201,256400,12440
14,14,0,-,275000,12441
379,255,124,240,243200,12442
1506,1393,113,1510,237000,12443
216,199,17,792,227100,12444
1948,1486,462,1005,175000,12446
251,218,33,-,250000,12448
1178,754,424,1058,170900,12449
39,39,0,-,-,12450
583,472,111,888,143100,12451
70,65,5,-,172100,12452
116,94,22,-,343400,12453
111,98,13,-,227400,12454
927,600,327,759,171700,12455
210,183,27,1313,134000,12456
455,323,132,755,263200,12457
916,611,305,768,117800,12458
105,105,0,-,(X),12459
83,75,8,-,185200,12460
827,600,227,820,279000,12461
493,381,112,625,157800,12463
424,303,121,732,221000,12464
82,77,5,-,271200,12465
950,787,163,967,199700,12466
439,390,49,690,155200,12468
338,316,22,-,156900,12469
202,125,77,838,143400,12470
146,29,117,1336,-,12471
707,438,269,991,187700,12472
375,365,10,-,194600,12473
506,354,152,811,154400,12474
137,127,10,-,(X),12475
7394,5283,2111,981,203600,12477
375,325,50,-,169800,12480
606,530,76,1019,251900,12481
243,138,105,622,28200,12482
177,74,103,(X),(X),12483
1071,870,201,1165,251500,12484
430,316,114,937,230600,12485
514,417,97,1446,227000,12486
1208,861,347,1150,209000,12487
151,134,17,-,175700,12489
0,0,0,-,-,12490
705,653,52,1281,250900,12491
163,149,14,-,254200,12492
144,45,99,964,173400,12493
318,253,65,-,274700,12494
168,142,26,-,483300,12495
624,503,121,754,227600,12496
2335,1940,395,1170,285900,12498
1028,662,366,978,279800,12501
427,344,83,1431,312300,12502
339,245,94,1224,284400,12503
24,13,11,-,-,12504
68,65,3,-,497400,12507
7152,3849,3303,1166,242800,12508
49,20,29,-,-,12512
263,194,69,-,195900,12513
1077,927,150,956,317300,12514
621,383,238,980,216100,12515
803,626,177,1109,218800,12516
243,169,74,853,402300,12517
2235,1432,803,1297,305100,12518
1159,806,353,1258,324300,12520
509,442,67,1076,225700,12521
2131,1646,485,1021,205300,12522
682,472,210,853,255200,12523
6064,4176,1888,1338,276700,12524
1034,769,265,1049,254500,12525
1586,1190,396,998,255200,12526
37,23,14,-,-,12527
5148,3519,1629,1066,240500,12528
1016,725,291,1028,257100,12529
67,21,46,-,-,12530
1230,1019,211,1357,286100,12531
8578,7749,829,1218,340200,12533
7371,4361,3010,849,178900,12534
5096,3613,1483,1008,230300,12538
2695,2465,230,1408,322600,12540
2263,1479,784,969,257600,12542
1232,735,497,1103,174300,12543
2005,1011,994,1137,435000,12545
1142,748,394,1268,278700,12546
1074,812,262,1057,236300,12547
590,369,221,1071,211900,12548
3753,2923,830,1199,269700,12549
18197,10484,7713,1125,232700,12550
9430,6762,2668,1177,249000,12553
6365,4065,2300,1095,296500,12561
2437,1961,476,1207,298000,12563
2508,1841,667,991,322600,12564
567,279,288,753,160400,12565
3675,2797,878,900,248300,12566
1226,921,305,1019,259700,12567
4065,2925,1140,1416,259100,12569
2481,2315,166,1198,350700,12570
3955,3027,928,1072,291100,12571
3769,2703,1066,1013,353500,12572
89,84,5,-,356900,12574
654,616,38,-,343900,12575
439,366,73,1338,330600,12577
802,650,152,1180,293500,12578
1590,1081,509,1094,264500,12580
778,579,199,1060,283700,12581
1368,1234,134,1313,353500,12582
893,555,338,1288,240000,12583
274,264,10,-,329700,12585
4190,2920,1270,1107,222400,12586
4804,3897,907,981,253900,12589
12876,9172,3704,1258,281400,12590
460,275,185,828,280600,12592
1443,1060,383,933,236200,12594
15544,6441,9103,1054,212300,12601
15243,11463,3780,1135,247900,12603
5,5,0,-,-,12604
4394,1847,2547,793,117500,12701
499,404,95,695,185500,12719
82,30,52,-,(X),12720
2087,1664,423,997,210100,12721
84,84,0,-,(X),12722
723,545,178,856,216900,12723
149,115,34,-,(X),12724
90,73,17,-,243800,12725
511,437,74,934,168000,12726
768,482,286,1020,172300,12729
381,268,113,926,171700,12732
274,116,158,948,153600,12733
388,300,88,773,170300,12734
67,67,0,-,(X),12736
734,603,131,881,182900,12737
180,137,43,886,180100,12738
648,518,130,1071,217800,12740
136,96,40,669,150000,12741
51,24,27,597,250000,12742
136,101,35,1571,192700,12743
70,36,34,-,134400,12745
413,314,99,1109,207900,12746
470,320,150,858,172400,12747
763,599,164,777,173700,12748
185,67,118,643,(X),12749
95,70,25,1223,(X),12750
343,157,186,961,152500,12751
117,85,32,631,178900,12752
2507,1238,1269,756,122000,12754
1776,1274,502,978,161700,12758
460,284,176,797,108300,12759
212,185,27,925,114700,12760
166,94,72,(X),(X),12762
297,230,67,780,136400,12763
752,582,170,663,183900,12764
401,329,72,832,172700,12765
172,152,20,-,(X),12766
9,9,0,-,170800,12767
334,230,104,927,153900,12768
85,62,23,-,148900,12769
91,80,11,-,157700,12770
5413,3532,1881,927,187600,12771
816,665,151,1132,211000,12775
859,691,168,803,157900,12776
353,304,49,1286,215500,12777
172,130,42,1261,112500,12778
746,223,523,823,193100,12779
925,755,170,1178,164600,12780
95,87,8,-,(X),12781
632,509,123,871,179500,12783
36,22,14,-,-,12784
351,260,91,1171,152500,12785
209,132,77,919,185700,12786
153,132,21,-,138700,12787
740,526,214,871,167300,12788
837,388,449,755,112700,12789
1872,1423,449,950,165000,12790
325,210,115,824,209700,12791
120,104,16,-,151800,12792
6443,3238,3205,806,146900,12801
3367,2278,1089,896,171200,12803
10585,7689,2896,985,213500,12804
207,207,0,-,317200,12808
1379,1187,192,767,155500,12809
290,260,30,675,116200,12810
32,32,0,-,-,12811
26,24,2,-,122500,12812
586,429,157,920,317100,12814
443,401,42,698,227300,12815
2013,1482,531,794,165600,12816
938,825,113,695,202400,12817
143,117,26,(X),104700,12819
178,116,62,986,126700,12821
2324,1778,546,813,138500,12822
151,135,16,-,(X),12823
459,392,67,1235,283000,12824
1413,1175,238,926,158400,12827
3670,2796,874,855,122400,12828
6519,4972,1547,1125,229600,12831
2676,1771,905,678,118600,12832
1711,1444,267,928,213700,12833
2467,1869,598,737,175400,12834
1045,883,162,827,165300,12835
292,265,27,813,204600,12836
325,292,33,918,124400,12837
260,214,46,723,129200,12838
5251,2984,2267,846,136300,12839
62,53,9,-,334600,12841
279,206,73,516,122800,12842
221,194,27,-,159100,12843
122,108,14,-,(X),12844
1981,1548,433,938,262400,12845
1234,1006,228,957,169700,12846
115,105,10,825,247700,12847
186,186,0,-,120200,12849
1139,996,143,1442,232600,12850
112,106,6,625,120000,12851
205,190,15,625,169300,12852
501,406,95,905,140200,12853
93,79,14,595,108900,12855
26,26,0,-,256300,12856
208,168,40,883,116300,12857
19,19,0,-,(X),12858
954,826,128,1302,175800,12859
234,164,70,-,112500,12860
321,276,45,907,160800,12861
5,5,0,-,-,12862
263,216,47,873,188600,12863
22,22,0,-,-,12864
1614,1329,285,812,124000,12865
15706,9555,6151,1053,285000,12866
394,301,93,691,183800,12870
1639,1253,386,861,180600,12871
15,15,0,-,162500,12872
313,302,11,-,163100,12873
84,79,5,-,589800,12874
322,281,41,790,138100,12878
2048,1501,547,823,125000,12883
126,97,29,944,105500,12884
1820,1395,425,733,144700,12885
80,67,13,-,103900,12886
2021,1347,674,803,97700,12887
13231,7199,6032,738,135500,12901
646,373,273,1159,133200,12903
626,547,79,488,90100,12910
12,12,0,-,-,12911
824,590,234,662,121100,12912
570,460,110,625,164700,12913
351,275,76,698,79200,12914
791,589,202,666,88200,12916
522,447,75,697,105300,12917
885,797,88,857,143100,12918
1207,941,266,675,107500,12919
1021,746,275,685,88600,12920
926,768,158,852,136000,12921
22,22,0,-,(X),12922
243,192,51,625,77200,12923
51,21,30,-,-,12924
840,671,169,581,89900,12926
110,100,10,-,(X),12927
755,573,182,700,118000,12928
373,243,130,643,99100,12929
300,264,36,767,76700,12930
558,439,119,630,137900,12932
3,3,0,-,-,12933
401,301,100,729,79600,12934
580,459,121,746,124300,12935
206,176,30,(X),163600,12936
651,504,147,755,77300,12937
108,87,21,1396,125800,12939
555,465,90,1008,166000,12941
375,301,74,(X),232300,12942
100,55,45,1653,251900,12943
1748,1303,445,720,105400,12944
190,190,0,-,189900,12945
2359,1328,1031,792,245000,12946
344,263,81,742,97500,12950
227,138,89,763,49200,12952
4745,3342,1403,688,100600,12953
167,158,9,-,96000,12955
373,312,61,909,79100,12956
844,600,244,744,81200,12957
829,590,239,485,97300,12958
592,549,43,-,101200,12959
510,386,124,1089,139700,12960
136,100,36,-,84300,12961
2352,1858,494,877,152600,12962
48,25,23,-,165600,12964
209,176,33,629,86100,12965
1248,1024,224,797,73000,12966
417,355,62,494,68300,12967
185,170,15,-,83700,12969
130,81,49,1136,153100,12970
2318,1944,374,762,142100,12972
76,71,5,-,106900,12973
524,370,154,710,98300,12974
159,114,45,802,176700,12975
95,91,4,-,222900,12976
38,38,0,-,-,12977
100,34,66,-,-,12978
1048,625,423,598,140900,12979
605,485,120,654,75500,12980
1052,911,141,720,100600,12981
3428,1906,1522,692,167600,12983
576,507,69,1140,87300,12985
2522,1759,763,611,125900,12986
155,136,19,-,150000,12987
425,395,30,700,149000,12989
2176,1685,491,744,107700,12992
616,551,65,892,121600,12993
910,705,205,759,113000,12996
525,422,103,888,202500,12997
163,96,67,871,58300,12998
45,41,4,-,126000,13020
16562,10059,6503,667,121200,13021
0,0,0,-,-,13024
612,456,156,711,149000,13026
13052,9629,3423,819,151200,13027
556,395,161,932,159900,13028
2874,2186,688,987,148100,13029
1637,1311,326,707,162300,13030
6145,4953,1192,867,149100,13031
5295,3901,1394,738,112100,13032
1372,1181,191,694,120300,13033
774,676,98,625,124600,13034
3147,2454,693,819,219600,13035
3164,2421,743,744,124100,13036
3245,2604,641,728,128200,13037
6590,5597,993,832,166700,13039
990,773,217,759,89500,13040
3846,3497,349,1118,142900,13041
1042,859,183,1039,92700,13042
937,873,64,775,108900,13044
10747,6307,4440,684,110000,13045
73,0,73,740,-,13051
677,546,131,575,99300,13052
1848,1443,405,766,158400,13053
636,432,204,722,130400,13054
6467,4853,1614,777,116400,13057
1126,985,141,792,122800,13060
458,419,39,1080,164400,13061
77,77,0,-,(X),13062
653,533,120,817,134700,13063
11,11,0,-,350000,13064
5214,4063,1151,940,204400,13066
2331,1683,648,882,143000,13068
9280,6291,2989,695,84600,13069
353,266,87,672,98700,13071
268,228,40,667,83700,13072
2676,1957,719,769,126400,13073
1703,1433,270,742,83100,13074
895,879,16,-,96600,13076
2539,1832,707,696,116000,13077
3816,3111,705,936,179100,13078
1392,1109,283,675,112200,13080
439,349,90,722,151700,13081
1758,1418,340,714,135300,13082
615,493,122,593,105900,13083
1677,1243,434,929,158000,13084
96,96,0,-,292500,13087
10247,6055,4192,853,122900,13088
11998,8734,3264,888,146500,13090
1003,868,135,685,115000,13092
891,685,206,608,98700,13101
9,0,9,-,-,13102
162,140,22,-,(X),13103
5911,4779,1132,865,227300,13104
2500,2091,409,732,179700,13108
932,859,73,683,163000,13110
612,560,52,646,90000,13111
722,681,41,-,133700,13112
90,73,17,820,98500,13113
2454,1910,544,651,94800,13114
92,80,12,-,105300,13115
1409,1174,235,758,137000,13116
95,68,27,904,86300,13117
2131,1683,448,637,103800,13118
726,651,75,638,86900,13120
399,337,62,536,154200,13122
82,82,0,-,106300,13123
39,34,5,-,83600,13124
13647,8604,5043,721,98600,13126
1269,1073,196,722,108800,13131
1426,1218,208,868,102800,13132
35,26,9,-,(X),13134
2663,1887,776,657,114100,13135
189,168,21,396,66800,13136
0,0,0,-,-,13138
1726,1446,280,753,84300,13140
214,151,63,875,99600,13141
2435,1650,785,714,100200,13142
1060,878,182,752,87100,13143
615,475,140,853,70100,13144
826,633,193,675,93400,13145
849,706,143,856,79000,13146
459,367,92,766,109700,13147
4580,3093,1487,735,97200,13148
3375,2756,619,778,264000,13152
83,63,20,-,168800,13153
283,217,66,608,75300,13155
910,797,113,657,87400,13156
364,263,101,945,129000,13157
594,427,167,678,97100,13158
2031,1703,328,810,161000,13159
802,584,218,627,121400,13160
214,168,46,-,133500,13162
160,132,28,771,130600,13163
892,831,61,739,156500,13164
4306,2975,1331,671,88600,13165
2214,1805,409,719,109300,13166
1119,996,123,880,108600,13167
2264,111,2153,671,103800,13202
6957,1954,5003,693,117900,13203
8027,2427,5600,731,69100,13204
7266,2764,4502,729,79200,13205
7758,4148,3610,740,89700,13206
5148,3123,2025,855,85400,13207
8560,3690,4870,704,84000,13208
5632,4050,1582,731,114100,13209
7559,2375,5184,762,121100,13210
2624,1643,981,852,84300,13211
8839,6473,2366,792,114200,13212
3090,2244,846,793,158200,13214
5659,4625,1034,893,198100,13215
6276,5175,1101,812,126100,13219
3478,2212,1266,715,152300,13224
0,0,0,-,-,13290
43,43,0,-,234400,13301
621,523,98,788,78400,13302
481,420,61,905,159000,13303
685,537,148,840,157600,13304
106,94,12,-,159400,13305
1357,1097,260,819,102800,13308
2230,1683,547,574,95200,13309
180,164,16,-,106100,13310
214,155,59,825,220200,13312
191,122,69,635,77100,13313
221,198,23,-,69000,13314
521,480,41,1088,112500,13315
2583,1933,650,674,112200,13316
1340,946,394,763,107400,13317
438,401,37,725,120100,13318
322,126,196,806,76900,13319
907,722,185,921,161600,13320
567,303,264,695,44000,13321
353,262,91,659,117800,13322
3958,2752,1206,958,153500,13323
896,756,140,720,92600,13324
419,372,47,1034,97500,13325
2392,1719,673,817,263200,13326
780,625,155,550,120800,13327
557,435,122,681,129100,13328
1599,1189,410,617,81200,13329
117,117,0,-,267500,13331
879,644,235,806,103700,13332
27,27,0,-,123800,13333
449,430,19,-,147600,13334
610,506,104,591,114500,13335
265,218,47,-,320000,13337
501,396,105,756,123500,13338
2530,1979,551,620,89300,13339
3064,2365,699,632,111700,13340
61,61,0,-,(X),13341
86,82,4,-,121400,13342
691,582,109,744,109300,13343
74,62,12,-,86700,13345
1662,1186,476,839,188900,13346
529,445,84,566,153700,13348
4246,2274,1972,651,91500,13350
49,49,0,-,(X),13352
17,12,5,-,158300,13353
1227,1138,89,585,128100,13354
300,191,109,783,103400,13355
4733,3051,1682,608,81800,13357
127,118,9,563,276700,13360
354,308,46,725,104400,13361
48,32,16,-,(X),13362
862,690,172,954,109000,13363
45,45,0,-,58800,13364
3572,2419,1153,596,89800,13365
3365,2328,1037,659,135800,13367
515,402,113,708,95400,13368
664,553,111,522,114000,13402
1624,1406,218,888,186300,13403
80,57,23,527,90700,13404
285,254,31,789,112500,13406
2103,1574,529,590,92500,13407
880,724,156,576,115900,13408
885,723,162,704,93500,13409
88,72,16,493,68900,13410
1392,1080,312,610,88000,13411
6658,4889,1769,799,163700,13413
30,17,13,-,(X),13415
867,686,181,564,108300,13416
1571,646,925,743,110500,13417
94,83,11,-,71400,13418
559,444,115,620,424200,13420
5355,3251,2104,685,104800,13421
898,670,228,692,125800,13424
914,688,226,638,91400,13425
617,423,194,453,113500,13428
696,614,82,821,133600,13431
758,556,202,714,85700,13433
83,69,14,625,97300,13435
26,21,5,-,171900,13436
189,174,15,-,93800,13437
1588,1355,233,768,117600,13438
1618,1216,402,712,119300,13439
16981,10495,6486,717,100500,13440
0,0,0,-,-,13441
39,27,12,-,164600,13450
1732,1294,438,624,82500,13452
283,236,47,664,87200,13454
1666,1416,250,734,135600,13456
891,598,293,750,146500,13459
1763,1138,625,617,104500,13460
1296,948,348,601,133100,13461
478,370,108,639,90000,13464
148,107,41,767,168800,13468
366,310,56,-,124400,13469
291,276,15,704,78400,13470
1251,991,260,832,95500,13471
112,112,0,-,(X),13472
226,215,11,963,99300,13473
23,13,10,-,137500,13475
1363,974,389,816,142200,13476
557,491,66,688,138800,13477
1088,834,254,621,108300,13478
1381,969,412,603,103000,13480
98,53,45,713,87600,13483
67,67,0,-,(X),13484
428,374,54,803,79700,13485
323,238,85,730,104900,13486
50,32,18,688,120800,13488
235,200,35,675,95300,13489
606,471,135,839,139300,13490
1404,1082,322,649,102800,13491
4966,3929,1037,651,136000,13492
658,600,58,911,81600,13493
123,110,13,-,147900,13494
954,700,254,675,96200,13495
14350,6629,7721,663,96400,13501
12961,7610,5351,673,94500,13502
15635,7796,7839,830,140700,13601
106,0,106,1361,-,13602
3552,12,3540,1353,-,13603
1909,1291,618,717,143600,13605
1105,740,365,793,133600,13606
813,563,250,765,126900,13607
542,408,134,766,112100,13608
1069,704,365,916,147600,13612
958,695,263,756,100100,13613
108,87,21,-,56800,13614
421,279,142,672,146300,13615
835,327,508,1163,93000,13616
3399,2321,1078,751,122100,13617
793,663,130,651,139000,13618
4046,2418,1628,935,130400,13619
790,621,169,615,120000,13620
197,161,36,1018,55700,13621
948,762,186,1042,124000,13622
18,15,3,-,(X),13623
1964,1417,547,1009,163300,13624
848,721,127,800,122000,13625
916,663,253,1050,138000,13626
80,52,28,917,107500,13628
491,429,62,688,98000,13630
115,88,27,(X),80000,13633
1609,1312,297,697,137300,13634
399,251,148,744,77100,13635
108,76,32,(X),123300,13636
1723,487,1236,1202,155900,13637
90,40,50,989,116700,13638
81,70,11,-,64000,13639
187,181,6,-,247500,13640
44,44,0,-,187500,13641
3547,2371,1176,720,90100,13642
0,0,0,-,-,13643
1037,817,220,639,84600,13646
30,17,13,-,142500,13647
822,699,123,642,89000,13648
612,522,90,(X),151400,13650
100,79,21,1125,428800,13651
730,575,155,608,68700,13652
863,719,144,543,82400,13654
1323,1003,320,492,127800,13655
1090,958,132,748,129500,13656
789,642,147,632,88900,13658
197,167,30,828,105300,13659
726,549,177,645,88500,13660
619,508,111,843,118200,13661
7190,4816,2374,717,81900,13662
179,144,35,956,95600,13664
340,235,105,843,124700,13665
105,76,29,1538,(X),13666
1113,734,379,742,74200,13667
1391,1018,373,678,80000,13668
6104,4320,1784,611,76400,13669
205,184,21,765,65600,13670
347,251,96,668,83700,13672
857,503,354,671,128400,13673
36,5,31,-,-,13674
28,28,0,-,-,13675
5228,3232,1996,734,112700,13676
70,59,11,-,-,13677
116,46,70,469,-,13678
706,604,102,1085,130200,13679
535,446,89,822,101200,13680
297,263,34,669,85200,13681
321,285,36,(X),164100,13682
473,413,60,611,79600,13684
1087,593,494,999,237300,13685
251,179,72,1150,115800,13687
322,249,73,461,67000,13690
1127,863,264,969,125500,13691
45,45,0,-,392100,13692
207,156,51,1172,155500,13693
643,483,160,770,115800,13694
45,45,0,-,243200,13695
55,55,0,-,-,13696
891,778,113,570,71300,13697
1210,971,239,587,101300,13730
450,406,44,845,213500,13731
2896,2503,393,666,132400,13732
2007,1583,424,711,100100,13733
874,707,167,591,119800,13734
748,638,110,924,88300,13736
348,321,27,658,139400,13739
207,161,46,950,227200,13740
1344,1212,132,543,98300,13743
510,443,67,730,120600,13744
831,765,66,831,96300,13746
1407,1233,174,663,112500,13748
366,237,129,699,123300,13750
70,52,18,-,56800,13751
308,262,46,847,165000,13752
1697,1185,512,773,164800,13753
1473,1038,435,676,112800,13754
555,419,136,656,107200,13755
213,165,48,699,88800,13756
471,418,53,825,138400,13757
18735,12204,6531,719,122300,13760
66,49,17,-,(X),13774
634,547,87,633,137900,13775
230,183,47,585,137000,13776
186,126,60,700,111200,13777
2264,1717,547,622,123800,13778
473,421,52,-,88900,13780
291,242,49,608,172100,13782
1028,791,237,558,117600,13783
69,47,22,871,78300,13784
201,156,45,950,148700,13786
1408,1026,382,674,87200,13787
419,302,117,703,155300,13788
7738,4323,3415,736,87300,13790
12,12,0,-,(X),13794
1507,1068,439,682,91700,13795
544,445,99,768,159800,13796
777,692,85,750,94500,13797
537,466,71,621,78500,13801
144,140,4,-,112500,13802
1547,1265,282,653,100100,13803
202,162,40,514,108700,13804
74,62,12,-,151900,13806
504,409,95,650,174700,13807
657,514,143,663,132200,13808
727,532,195,587,76400,13809
519,424,95,647,129500,13810
1786,1441,345,613,92200,13811
935,731,204,617,94800,13812
281,213,68,-,116000,13813
5265,3517,1748,630,84900,13815
7521,4607,2914,831,147300,13820
1411,1102,309,723,130000,13825
13,13,0,-,-,13826
5034,3744,1290,613,121100,13827
2028,1736,292,667,91600,13830
252,226,26,731,50000,13832
1790,1554,236,672,101000,13833
44,44,0,-,-,13834
535,405,130,633,91000,13835
2116,1240,876,640,82000,13838
488,441,47,670,91400,13839
240,185,55,708,101000,13841
152,138,14,-,152300,13842
777,685,92,731,99500,13843
265,216,49,(X),81300,13844
69,20,49,-,-,13845
111,111,0,-,142400,13846
12,3,9,-,-,13847
1652,1351,301,613,95200,13849
8968,7125,1843,892,147200,13850
2804,1756,1048,597,121000,13856
106,80,26,1047,96500,13859
21,10,11,-,-,13860
133,115,18,-,153100,13861
1687,1401,286,658,100000,13862
247,206,41,443,76100,13863
466,353,113,929,84200,13864
2428,2059,369,585,106100,13865
8156,4859,3297,611,108200,13901
0,0,0,-,-,13902
7844,5213,2631,654,101100,13903
3725,2576,1149,655,86100,13904
11311,5525,5786,698,103300,13905
3883,3063,820,744,136300,14001
4111,3363,748,779,155200,14004
696,571,125,746,114900,14005
4221,3485,736,756,99500,14006
518,422,96,(X),105400,14008
2300,1779,521,607,104600,14009
2551,1848,703,600,118400,14011
894,737,157,609,106800,14012
762,657,105,775,89100,14013
9657,6081,3576,717,100000,14020
661,592,69,644,87800,14024
1216,983,233,662,176200,14025
291,213,78,655,170800,14026
564,496,68,833,101600,14028
609,508,101,826,132200,14030
4015,3033,982,683,214500,14031
2663,2331,332,995,275300,14032
947,826,121,628,212800,14033
824,707,117,623,96000,14034
15,15,0,-,(X),14035
2091,1771,320,790,121300,14036
396,332,64,524,161100,14037
45,29,16,519,83000,14039
816,726,90,691,141700,14040
112,79,33,(X),77900,14041
1570,1129,441,615,87700,14042
10611,7490,3121,750,117200,14043
2600,2246,354,742,117900,14047
6284,4038,2246,616,68100,14048
7668,6807,861,1413,246000,14051
6598,5553,1045,732,198600,14052
561,464,97,710,112600,14054
633,587,46,496,158100,14055
3143,2743,400,570,160600,14057
756,623,133,717,112700,14058
4074,3760,314,675,212400,14059
184,176,8,920,75800,14060
138,99,39,765,85500,14061
1239,1043,196,656,92900,14062
5269,3654,1615,642,126500,14063
744,625,119,554,108800,14065
452,392,60,611,78400,14066
2018,1627,391,643,110700,14067
2828,2022,806,1029,219800,14068
368,294,74,405,185500,14069
2002,1393,609,622,82500,14070
7862,6359,1503,915,181900,14072
17805,13250,4555,772,154500,14075
1738,1506,232,550,161000,14080
1259,962,297,686,112700,14081
174,141,33,689,161300,14082
2476,2396,80,1058,169600,14085
12379,10321,2058,716,181500,14086
372,339,33,548,99600,14091
4696,3765,931,860,162000,14092
20406,14594,5812,626,111800,14094
1140,986,154,830,90600,14098
703,631,72,775,106700,14101
487,449,38,613,190900,14102
4380,3033,1347,661,83900,14103
1794,1404,390,642,101200,14105
2184,1825,359,585,103400,14108
0,0,0,-,-,14109
1275,990,285,593,119700,14111
0,0,0,-,-,14112
263,202,61,588,120200,14113
18742,13485,5257,668,124200,14120
1430,1110,320,580,97900,14125
295,209,86,784,98200,14126
11889,9345,2544,892,208700,14127
577,457,120,598,98000,14129
71,48,23,688,48000,14130
2064,1814,250,987,148200,14131
2474,2182,292,548,150300,14132
37,32,5,-,85000,14134
75,47,28,-,102500,14135
2044,1595,449,681,89700,14136
800,641,159,643,80800,14138
943,791,152,724,178600,14139
3227,2313,914,594,125700,14141
476,387,89,704,111800,14143
690,570,120,577,137800,14145
18815,13592,5223,765,110400,14150
734,569,165,656,138000,14167
23,3,20,-,-,14168
118,91,27,-,(X),14169
964,821,143,640,164700,14170
859,680,179,623,109300,14171
1244,1026,218,669,120200,14172
187,109,78,(X),95000,14173
2197,1869,328,713,148100,14174
6033,1312,4721,647,136500,14201
1650,377,1273,544,350000,14202
908,0,908,729,-,14203
4103,1453,2650,495,68800,14204
9029,5634,3395,599,64600,14206
9362,3241,6121,640,55300,14207
4349,1837,2512,725,43800,14208
3880,1065,2815,721,190000,14209
5954,2650,3304,681,62500,14210
9189,3792,5397,695,38100,14211
4649,2215,2434,610,59800,14212
8882,3035,5847,717,69300,14213
8039,3539,4500,767,152400,14214
15959,7790,8169,723,54400,14215
10733,5291,5442,770,128100,14216
10576,6835,3741,681,112100,14217
8246,4460,3786,608,84200,14218
5067,3216,1851,730,114000,14219
9961,6603,3358,686,83400,14220
22660,16882,5778,1146,191600,14221
6676,2188,4488,790,223500,14222
9790,7635,2155,771,119200,14223
17440,13437,4003,749,135900,14224
14837,10519,4318,718,93500,14225
12322,8848,3474,840,142300,14226
10802,7144,3658,826,116300,14227
9022,4629,4393,914,160200,14228
2,0,2,-,-,14261
5630,2170,3460,586,53200,14301
0,0,0,-,-,14302
2711,1189,1522,670,49600,14303
12643,9507,3136,678,84700,14304
6683,3912,2771,659,71400,14305
4695,3260,1435,610,91100,14411
2868,2137,731,789,140200,14414
64,52,12,-,86700,14415
1438,1109,329,738,110000,14416
543,477,66,976,141200,14418
7022,4460,2562,776,132300,14420
936,812,124,764,103900,14422
1890,1460,430,739,124500,14423
11733,7899,3834,833,173700,14424
4485,3184,1301,980,145600,14425
871,665,206,654,86500,14427
3259,2768,491,912,149600,14428
2343,1845,498,754,107400,14432
1473,1203,270,756,83200,14433
1227,1093,134,873,138700,14435
4001,2981,1020,655,89300,14437
156,112,44,923,89000,14441
3484,1982,1502,845,97400,14445
16937,12835,4102,916,187800,14450
3269,1699,1570,752,158600,14454
7671,4620,3051,725,104000,14456
213,192,21,650,109100,14462
2730,2290,440,759,100700,14464
715,603,112,564,118000,14466
4014,2690,1324,883,143800,14467
6762,5575,1187,907,137200,14468
2598,2170,428,711,143000,14469
3320,2644,676,660,92600,14470
1195,1112,83,1034,131700,14471
3427,2783,644,772,227800,14472
88,74,14,-,272200,14475
840,659,181,735,117700,14476
737,714,23,-,115800,14477
286,276,10,-,205700,14478
123,85,38,626,76500,14479
325,175,150,856,138400,14480
789,559,230,774,98200,14481
3357,2331,1026,778,105000,14482
1810,1327,483,665,137700,14485
138,138,0,-,116700,14486
2212,1784,428,834,158000,14487
2777,2022,755,637,74500,14489
4002,3275,727,755,154400,14502
789,610,179,865,85300,14504
2091,1828,263,699,118900,14505
483,483,0,-,228400,14506
543,469,74,723,122000,14507
1818,1087,731,680,80100,14510
118,104,14,-,137900,14511
1972,1651,321,683,142100,14512
5769,3782,1987,657,94100,14513
2519,1729,790,852,152200,14514
930,808,122,807,99800,14516
1238,886,352,552,91500,14517
4856,4111,745,760,154600,14519
1035,802,233,666,98100,14521
4006,2759,1247,709,108600,14522
972,849,123,652,111700,14525
8059,6694,1365,873,170800,14526
5120,3707,1413,660,130700,14527
66,43,23,-,125600,14529
2266,1681,585,591,83800,14530
1784,1286,498,713,118600,14532
789,607,182,720,114200,14533
12149,10933,1216,1132,247700,14534
251,195,56,600,71500,14536
61,40,21,-,83300,14537
71,71,0,-,85000,14539
939,688,251,886,135600,14541
25,20,5,-,75000,14542
1238,1110,128,903,173500,14543
869,725,144,564,159400,14544
72,66,6,-,85000,14545
2046,1371,675,943,131800,14546
1549,1288,261,699,106900,14548
14,10,4,-,-,14549
707,567,140,575,81500,14550
2154,1658,496,681,80400,14551
488,424,64,912,139200,14555
6961,5575,1386,849,154800,14559
832,752,80,746,116300,14560
1090,949,141,710,127900,14561
5796,4549,1247,1322,238400,14564
2134,1952,182,766,136600,14568
2667,1694,973,562,100800,14569
502,478,24,-,84900,14571
2185,1658,527,694,91100,14572
20307,15755,4552,941,181900,14580
61,61,0,-,33300,14585
4244,3083,1161,1122,168200,14586
51,43,8,-,91000,14588
2930,2333,597,649,125100,14589
2066,1585,481,521,90300,14590
661,556,105,683,106700,14591
67,67,0,-,157200,14592
1273,0,1273,515,-,14604
4600,878,3722,666,55500,14605
11409,6438,4971,803,106300,14606
9256,1467,7789,772,168400,14607
5149,930,4219,720,69500,14608
17769,10907,6862,815,90500,14609
6773,3845,2928,851,153900,14610
6866,2353,4513,778,59700,14611
14528,10702,3826,821,139700,14612
4729,1771,2958,759,66600,14613
68,0,68,(X),-,14614
7062,3602,3460,807,91100,14615
12032,8659,3373,828,99400,14616
9465,8218,1247,840,125800,14617
8224,6333,1891,959,190900,14618
5585,2947,2638,944,74400,14619
11483,3727,7756,825,134500,14620
12782,4309,8473,736,58000,14621
5410,4234,1176,841,110400,14622
8924,4918,4006,927,116700,14623
14023,11418,2605,892,126700,14624
4404,3810,594,1017,169200,14625
12474,8908,3566,922,135800,14626
0,0,0,-,-,14627
16792,10093,6699,595,72300,14701
2555,1988,567,645,101000,14706
96,87,9,-,53400,14707
61,58,3,-,42000,14708
595,481,114,566,80500,14709
1326,1181,145,813,89200,14710
801,568,233,544,70000,14711
1479,1166,313,658,129500,14712
190,161,29,829,76000,14714
1130,867,263,576,56500,14715
902,572,330,556,67000,14716
282,236,46,540,85400,14717
877,721,156,695,99400,14718
1382,1103,279,536,83100,14719
363,156,207,654,40200,14720
59,40,19,-,46200,14721
139,124,15,-,632700,14722
445,370,75,710,83500,14723
891,735,156,755,106000,14724
590,451,139,641,67100,14726
2146,1802,344,671,73800,14727
359,316,43,-,97800,14728
359,298,61,531,92400,14729
678,558,120,631,207000,14731
52,52,0,-,71000,14732
1707,1066,641,573,73100,14733
1179,811,368,564,78000,14735
115,78,37,(X),122900,14736
1731,1334,397,651,74000,14737
1539,1241,298,510,87500,14738
1173,860,313,641,51100,14739
521,426,95,738,79900,14740
842,713,129,743,119500,14741
81,70,11,-,97100,14742
752,616,136,650,73300,14743
430,279,151,760,110900,14744
932,768,164,487,77700,14747
324,211,113,535,81800,14748
1927,1374,553,679,107000,14750
116,116,0,-,79700,14752
454,363,91,529,59800,14753
260,215,45,571,57500,14754
1212,979,233,543,85500,14755
102,102,0,-,90300,14756
1383,1091,292,659,101400,14757
7953,4686,3267,622,77500,14760
696,578,118,629,86700,14767
412,343,69,571,90800,14769
1133,894,239,637,83800,14770
1450,1040,410,557,78200,14772
69,53,16,650,46600,14774
958,734,224,586,69300,14775
259,216,43,722,73300,14777
0,0,0,-,-,14778
2698,1511,1187,607,70100,14779
720,612,108,550,83700,14781
903,672,231,650,73600,14782
146,125,21,429,69700,14783
313,232,81,705,73800,14784
2121,1575,546,611,95500,14787
110,28,82,425,(X),14788
2192,1688,504,610,84200,14801
393,105,288,759,115300,14802
453,298,155,645,117000,14803
614,519,95,616,82000,14804
411,347,64,788,111300,14805
843,668,175,668,63700,14806
1219,943,276,690,95600,14807
219,179,40,723,68000,14808
1042,785,257,723,78000,14809
5153,3215,1938,591,81000,14810
1184,1049,135,609,87400,14812
1038,769,269,566,67800,14813
707,602,105,903,149800,14814
400,341,59,698,116800,14815
163,152,11,-,140200,14816
987,841,146,796,143400,14817
825,671,154,846,110500,14818
287,219,68,821,82500,14819
306,253,53,607,81000,14820
1264,1095,169,777,91900,14821
485,348,137,759,71400,14822
1465,1098,367,667,80700,14823
225,200,25,778,85800,14824
355,287,68,762,86600,14825
865,700,165,654,87900,14826
58,58,0,-,(X),14827
8618,5490,3128,693,108500,14830
393,378,15,761,103100,14836
2135,1517,618,690,108600,14837
833,794,39,807,97400,14838
293,248,45,610,93600,14839
1422,1128,294,635,159300,14840
376,339,37,-,161700,14841
417,407,10,-,121300,14842
5432,3372,2060,618,74600,14843
8704,6714,1990,849,135800,14845
336,277,59,664,83700,14846
1027,819,208,713,103400,14847
24182,10625,13557,1032,216000,14850
0,0,0,-,-,14853
7,7,0,-,-,14854
289,236,53,468,95400,14855
85,59,26,-,50800,14856
645,502,143,793,95800,14858
365,308,57,341,91100,14859
526,430,96,587,89500,14860
587,516,71,802,87100,14861
494,456,38,820,117400,14864
1176,732,444,559,87300,14865
2298,1664,634,808,121400,14867
510,371,139,548,109600,14869
4261,2738,1523,822,108200,14870
2124,1872,252,776,123600,14871
307,237,70,634,93400,14872
1097,932,165,576,88400,14873
115,100,15,850,87500,14874
191,151,40,595,94400,14877
252,224,28,734,121000,14878
954,756,198,742,84200,14879
605,507,98,680,61800,14880
130,32,98,929,-,14881
1589,1202,387,995,184300,14882
1510,1150,360,918,115900,14883
104,93,11,-,74800,14884
303,257,46,644,89200,14885
2991,2394,597,831,174100,14886
646,537,109,744,100100,14889
1896,1365,531,630,115600,14891
3343,2276,1067,643,95300,14892
6,6,0,-,-,14893
562,481,81,646,74600,14894
4266,2674,1592,584,71600,14895
370,304,66,519,67500,14897
610,494,116,707,85400,14898
5477,2472,3005,665,68100,14901
3073,2056,1017,712,98600,14903
6493,3763,2730,689,69000,14904
3946,2683,1263,775,119500,14905
13046,9922,3124,653,119000,15001
5218,3234,1984,643,83300,15003
117,67,50,-,86000,15004
4091,3429,662,623,153500,15005
144,106,38,-,66000,15006
119,108,11,-,128900,15007
6495,4595,1900,554,160400,15009
11225,7672,3553,649,118000,15010
6466,4938,1528,691,119000,15012
1378,905,473,682,74500,15014
496,472,24,229,271100,15015
7304,5234,2070,791,155600,15017
292,277,15,-,80600,15018
732,575,157,670,94900,15019
128,64,64,731,66700,15020
3096,2516,580,710,121800,15021
4307,3034,1273,586,87200,15022
3673,2993,680,737,129200,15024
6886,4907,1979,791,114100,15025
1289,1142,147,753,173500,15026
977,779,198,490,127800,15027
73,63,10,575,55000,15028
496,304,192,761,56800,15030
318,156,162,948,91200,15031
1934,1265,669,564,54000,15033
885,587,298,470,61400,15034
1020,527,493,682,70600,15035
4625,3844,781,721,106300,15037
130,59,71,-,86900,15038
3447,2705,742,878,145400,15042
799,680,119,(X),158200,15043
10256,9445,811,1154,232600,15044
1989,1211,778,596,56500,15045
1026,874,152,850,124500,15046
23,23,0,-,-,15047
440,302,138,649,102600,15049
914,815,99,696,149400,15050
171,132,39,739,75000,15051
1448,1341,107,783,109800,15052
48,33,15,-,88100,15053
196,123,73,679,71500,15054
695,464,231,910,165300,15055
519,292,227,695,77800,15056
5608,4877,731,802,192300,15057
1535,876,659,507,77400,15059
285,201,84,589,106900,15060
5160,3853,1307,651,121700,15061
3571,2514,1057,598,75800,15062
4512,3533,979,631,113900,15063
160,115,45,920,85800,15064
4884,3406,1478,667,94300,15065
5413,3443,1970,600,94200,15066
973,696,277,676,78200,15067
16583,11350,5233,619,115100,15068
4354,3304,1050,939,143200,15071
102,48,54,-,68600,15072
3827,2455,1372,652,95600,15074
90,39,51,-,-,15075
433,253,180,804,87700,15076
62,46,16,588,60000,15077
174,90,84,623,(X),15078
218,168,50,825,84500,15081
59,59,0,-,117200,15082
404,340,64,595,107100,15083
4394,2797,1597,654,75800,15084
3337,2715,622,711,151500,15085
152,73,79,(X),263200,15086
92,76,16,-,150900,15087
220,146,74,775,54700,15088
2647,2095,552,578,116400,15089
8366,6747,1619,1357,300200,15090
9886,8004,1882,950,203400,15101
12242,9692,2550,862,163400,15102
3800,1695,2105,483,35700,15104
8904,5430,3474,760,107300,15106
17118,11967,5151,870,168800,15108
2311,1013,1298,592,38600,15110
1516,715,801,616,64000,15112
5970,5314,656,752,165300,15116
8324,5286,3038,671,79800,15120
8651,6494,2157,665,90000,15122
2908,2232,676,775,137900,15126
4391,3292,1099,871,149800,15129
3921,2951,970,762,101000,15131
9572,4982,4590,599,48600,15132
2889,2327,562,665,71300,15133
2242,1733,509,718,122900,15135
9409,5877,3532,652,109100,15136
4492,3116,1376,656,77600,15137
3095,1976,1119,838,173500,15139
1554,756,798,546,59600,15140
543,437,106,966,620800,15142
7716,6084,1632,923,282800,15143
1889,1295,594,712,90500,15144
3270,1473,1797,510,70300,15145
12532,8147,4385,891,132400,15146
8245,5558,2687,733,88000,15147
1161,467,694,586,48300,15148
6253,3435,2818,846,107400,15201
9516,4797,4719,683,114800,15202
4821,2186,2635,992,161600,15203
3677,2497,1180,789,63200,15204
10198,5837,4361,814,110200,15205
13501,5319,8182,781,134000,15206
5037,3177,1860,608,83000,15207
4382,2077,2305,670,137800,15208
5536,4067,1469,715,130600,15209
11074,6440,4634,744,55200,15210
5489,2619,2870,895,86200,15211
12790,6647,6143,698,89800,15212
9286,2349,6937,879,120100,15213
6142,3824,2318,727,93900,15214
5525,3669,1856,741,203800,15215
10548,6311,4237,773,104700,15216
11953,6052,5901,953,259400,15217
6818,3834,2984,725,110500,15218
5201,1450,3751,604,75600,15219
8013,4925,3088,900,149400,15220
15367,7630,7737,728,94700,15221
1956,351,1605,1593,272000,15222
3124,2013,1111,690,101300,15223
5206,1967,3239,783,98400,15224
581,297,284,682,83900,15225
6153,4383,1770,809,89800,15226
12143,8412,3731,682,106700,15227
7339,5301,2038,832,225100,15228
6267,4642,1625,785,134600,15229
6257,1526,4731,1022,315800,15232
1161,593,568,745,96700,15233
6439,4282,2157,739,118300,15234
14806,11409,3397,818,90300,15235
12277,9492,2785,830,138200,15236
18001,13847,4154,941,187000,15237
5373,4088,1285,814,293400,15238
8546,6993,1553,918,139200,15239
7477,6509,968,1249,263000,15241
5713,4872,841,1048,178700,15243
0,0,0,-,-,15260
0,0,0,-,-,15290
20162,13552,6610,660,145100,15301
137,106,31,263,114600,15310
581,471,110,701,166900,15311
1397,1174,223,663,143900,15312
145,136,9,(X),107000,15313
1622,1142,480,388,120200,15314
353,293,60,817,52200,15315
42,28,14,525,63000,15316
14819,12014,2805,867,224700,15317
2229,1577,652,493,115200,15320
657,601,56,660,192100,15321
894,772,122,672,70200,15322
1745,1311,434,620,144200,15323
288,202,86,723,64700,15324
170,66,104,-,84700,15325
559,496,63,798,63500,15327
540,435,105,762,157600,15329
2085,1917,168,711,196000,15330
321,204,117,636,79200,15331
3562,3108,454,649,133200,15332
935,787,148,463,92300,15333
62,57,5,-,74400,15334
242,168,74,619,128100,15337
642,551,91,578,87500,15338
604,479,125,645,169200,15340
319,251,68,462,120900,15341
2054,1550,504,768,155000,15342
681,550,131,628,101500,15344
647,490,157,654,79100,15345
237,208,29,624,55500,15346
219,219,0,-,156000,15347
131,99,32,730,106400,15348
794,629,165,640,115100,15349
189,124,65,739,60000,15350
489,252,237,669,(X),15351
327,257,70,563,98800,15352
10,10,0,-,112500,15353
692,574,118,446,99100,15357
397,297,100,719,84700,15358
62,35,27,598,87900,15359
680,586,94,629,177800,15360
20,20,0,-,90000,15361
352,274,78,617,116100,15362
354,194,160,780,134500,15363
312,255,57,688,121100,15364
91,80,11,-,67800,15366
2948,2691,257,1129,359800,15367
118,97,21,-,45000,15368
4657,3045,1612,644,114100,15370
627,499,128,701,151300,15376
265,220,45,564,135700,15377
38,10,28,-,-,15378
49,42,7,917,100000,15379
253,185,68,553,92500,15380
13688,8557,5131,575,98000,15401
341,288,53,-,75600,15410
325,260,65,636,136400,15411
173,146,27,670,87600,15412
291,234,57,505,63800,15413
3551,2461,1090,536,80400,15417
1847,887,960,469,99300,15419
123,53,70,620,(X),15420
12,12,0,-,-,15421
65,45,20,-,13000,15422
856,715,141,605,108500,15423
895,680,215,529,85900,15424
7954,5625,2329,582,88000,15425
473,387,86,834,99800,15427
730,602,128,670,89000,15428
78,54,24,628,103900,15429
109,92,17,-,65000,15430
1778,1418,360,605,78700,15431
184,129,55,667,69500,15432
374,357,17,-,(X),15433
113,83,30,669,57700,15434
221,156,65,786,(X),15435
1015,737,278,617,94300,15436
828,647,181,767,158100,15437
751,658,93,730,85200,15438
191,165,26,-,101400,15440
701,652,49,680,75200,15442
95,95,0,-,(X),15443
182,94,88,-,(X),15444
1031,783,248,673,98100,15445
148,148,0,-,154200,15446
17,17,0,-,-,15447
73,40,33,-,(X),15448
149,108,41,-,34800,15449
65,47,18,-,72700,15450
391,321,70,745,90600,15451
63,63,0,-,-,15454
113,75,38,-,67900,15455
1053,762,291,598,88200,15456
1018,719,299,655,77400,15458
607,414,193,550,117400,15459
39,26,13,-,54000,15460
1517,1004,513,587,68200,15461
147,147,0,-,23400,15462
0,0,0,-,-,15463
614,517,97,578,103800,15464
203,157,46,575,64100,15466
63,44,19,833,52300,15467
936,691,245,714,77000,15468
864,697,167,744,95400,15469
332,283,49,431,121400,15470
110,39,71,-,153800,15472
1737,1349,388,552,121900,15473
782,564,218,672,71800,15474
380,285,95,530,75400,15475
45,45,0,-,11400,15476
351,263,88,626,80100,15477
2513,1872,641,600,94800,15478
859,646,213,533,117300,15479
726,539,187,653,81900,15480
175,155,20,575,49700,15482
198,140,58,578,90800,15483
91,68,23,-,65000,15484
904,751,153,553,107400,15486
154,114,40,-,67100,15489
351,273,78,-,86600,15490
74,58,16,-,(X),15492
6449,4464,1985,562,124000,15501
48,39,9,-,268800,15502
0,0,0,-,-,15510
108,108,0,-,59500,15520
734,620,114,688,97300,15521
4934,3700,1234,650,150100,15522
2059,1662,397,576,108500,15530
1655,1307,348,465,87100,15531
76,62,14,-,47600,15532
606,459,147,652,110300,15533
376,310,66,577,117700,15534
832,749,83,675,156200,15535
187,165,22,397,155900,15536
3201,2481,720,573,111800,15537
303,266,37,600,134500,15538
248,187,61,730,88200,15539
94,81,13,-,156300,15540
1413,1239,174,652,111900,15541
435,393,42,475,79600,15542
88,88,0,-,58100,15544
1176,927,249,563,103900,15545
135,109,26,-,81300,15546
187,159,28,(X),104000,15547
715,570,145,606,114500,15550
357,308,49,596,118600,15551
2221,1735,486,528,89200,15552
1044,854,190,634,113900,15554
51,45,6,-,42500,15555
1397,1140,257,564,104400,15557
871,655,216,534,107000,15558
845,734,111,686,144500,15559
68,56,12,1063,79100,15560
66,56,10,1100,126500,15561
59,46,13,664,138500,15562
1200,1042,158,610,103800,15563
31,25,6,-,94500,15564
24523,17508,7015,660,157300,15601
1487,1333,154,503,133700,15610
187,162,25,825,(X),15611
128,128,0,-,(X),15612
5866,4810,1056,608,124000,15613
101,95,6,-,86800,15615
22,22,0,-,-,15616
138,103,35,733,86600,15617
1120,887,233,604,87800,15618
398,206,192,688,79600,15620
35,0,35,-,-,15621
652,527,125,330,149000,15622
299,270,29,-,118200,15623
192,98,94,1310,85500,15624
57,57,0,-,-,15625
2337,1777,560,660,152300,15626
2691,2083,608,656,95800,15627
228,167,61,575,(X),15628
349,238,111,536,57200,15629
458,325,133,637,79800,15631
3618,2765,853,685,187400,15632
98,82,16,-,99700,15633
204,162,42,770,64600,15634
113,84,29,-,157500,15635
1465,1315,150,871,233200,15636
729,592,137,969,94300,15637
178,85,93,1038,86300,15638
946,735,211,631,155500,15639
194,166,28,-,98300,15640
210,179,31,575,86300,15641
18077,15451,2626,717,162200,15642
8124,6036,2088,635,114600,15644
83,78,5,-,86000,15646
57,57,0,-,(X),15647
11295,8398,2897,602,135800,15650
159,122,37,761,113400,15655
4309,3380,929,603,119100,15656
3986,3236,750,717,164500,15658
161,141,20,-,119400,15660
250,126,124,630,84700,15661
79,79,0,-,-,15662
201,157,44,497,131300,15663
578,403,175,969,134000,15665
6981,5416,1565,658,112000,15666
5323,4865,458,800,220300,15668
1573,1317,256,655,155400,15670
324,287,37,-,146500,15671
1583,1076,507,612,170400,15672
546,440,106,604,92700,15673
425,335,90,908,87800,15675
154,69,85,606,128100,15676
180,155,25,710,115200,15677
163,104,59,430,107100,15678
1295,1133,162,538,129500,15679
52,48,4,-,66300,15680
1972,1617,355,555,102000,15681
3483,2550,933,558,102200,15683
278,199,79,433,70600,15684
378,320,58,675,113600,15686
473,398,75,495,143300,15687
348,269,79,589,72300,15688
153,79,74,-,(X),15689
3819,2630,1189,637,78800,15690
44,44,0,-,-,15691
458,425,33,-,124200,15692
59,15,44,-,-,15693
134,123,11,-,105600,15695
164,129,35,688,79400,15696
1351,882,469,627,101900,15697
341,296,45,-,66600,15698
13471,7704,5767,746,140500,15701
110,101,9,-,85600,15710
187,144,43,679,76300,15711
60,48,12,-,54400,15712
92,79,13,-,95600,15713
2074,1612,462,499,69200,15714
235,159,76,622,67100,15715
260,158,102,477,79400,15716
4326,3392,934,621,110300,15717
81,59,22,775,75600,15721
1009,882,127,481,88600,15722
17,17,0,-,-,15723
854,702,152,609,77500,15724
579,497,82,523,117100,15725
81,54,27,869,76700,15727
1434,1029,405,546,67800,15728
635,500,135,547,78100,15729
21,21,0,-,87500,15730
245,125,120,737,84200,15731
673,599,74,632,105800,15732
48,40,8,-,81800,15733
109,80,29,-,80000,15734
325,247,78,585,121000,15736
43,43,0,-,37200,15737
104,88,16,-,60000,15738
148,108,40,771,68300,15739
31,24,7,-,77500,15741
362,312,50,656,71100,15742
52,46,6,-,59400,15744
99,75,24,820,53900,15745
45,15,30,(X),75000,15746
754,590,164,645,146300,15747
2746,2256,490,635,99300,15748
133,22,111,727,-,15750
28,0,28,643,-,15752
214,199,15,644,83200,15753
166,154,12,-,65300,15754
94,67,27,642,61200,15756
634,511,123,556,78000,15757
1047,876,171,596,95500,15759
43,41,2,-,52500,15760
43,31,12,-,134900,15761
339,311,28,725,129300,15762
74,66,8,-,146900,15764
690,562,128,642,125000,15765
5792,4291,1501,574,92000,15767
58,56,2,-,85000,15770
341,313,28,561,89400,15771
575,459,116,594,77300,15772
185,176,9,-,72500,15773
1277,1039,238,693,107800,15774
287,277,10,-,68700,15775
25,25,0,-,65000,15776
65,65,0,-,59500,15777
58,40,18,775,45700,15778
95,95,0,-,82900,15779
52,49,3,-,61700,15780
27,27,0,-,118800,15781
50,26,24,625,48000,15783
28,28,0,-,80000,15784
8068,5976,2092,571,105600,15801
58,57,1,-,128400,15821
649,544,105,534,84900,15823
2204,1538,666,569,98300,15824
3897,2865,1032,573,101000,15825
67,48,19,598,37900,15827
148,132,16,(X),113600,15828
492,385,107,608,127000,15829
147,132,15,525,71700,15832
1936,1309,627,582,70800,15834
827,613,214,640,83200,15840
149,139,10,-,46600,15841
1433,1093,340,490,56200,15845
1342,1183,159,495,106700,15846
87,61,26,397,81700,15847
363,308,55,643,98300,15848
502,432,70,729,70300,15849
2806,2154,652,551,84600,15851
2801,2017,784,489,81800,15853
368,334,34,638,105600,15856
5430,4145,1285,599,109700,15857
495,432,63,478,97100,15860
57,54,3,-,75000,15861
87,76,11,-,56700,15863
731,623,108,607,91400,15864
603,388,215,608,68900,15865
74,61,13,825,87500,15866
583,500,83,553,75400,15868
560,482,78,481,83300,15870
2149,649,1500,403,26600,15901
5272,3170,2102,547,56600,15902
6407,4633,1774,705,125800,15904
9023,6844,2179,647,96900,15905
5176,3525,1651,453,47400,15906
2237,1796,441,565,87900,15909
338,301,37,808,120900,15920
73,73,0,-,67300,15921
68,56,12,-,89100,15922
611,516,95,595,77100,15923
456,374,82,580,64200,15924
64,45,19,960,64200,15925
1062,918,144,521,85300,15926
429,381,48,-,67600,15927
989,777,212,870,133500,15928
53,29,24,-,87500,15929
55,45,10,-,73200,15930
3645,2604,1041,639,155400,15931
86,86,0,-,105400,15934
1039,890,149,655,93400,15935
625,544,81,590,91600,15936
315,278,37,-,90800,15937
966,809,157,643,85200,15938
529,413,116,614,163400,15940
871,840,31,-,119600,15942
1607,1300,307,494,64600,15943
1342,1123,219,576,107800,15944
66,66,0,-,65700,15945
2789,2252,537,508,89400,15946
265,157,108,608,69200,15948
248,227,21,765,77200,15949
168,143,25,-,(X),15951
558,374,184,572,125300,15952
81,53,28,-,73400,15953
979,758,221,589,89600,15954
1110,994,116,556,79700,15955
1098,848,250,567,64800,15956
263,242,21,-,103800,15957
838,718,120,671,125400,15958
245,197,48,667,43300,15960
323,278,45,675,82400,15961
61,51,10,775,72500,15962
4610,3475,1135,607,89900,15963
17721,11898,5823,654,145000,16001
6016,5206,810,908,181400,16002
443,371,72,758,106000,16020
153,115,38,575,78600,16022
1927,1291,636,805,162000,16023
81,60,21,963,123600,16024
2117,1787,330,623,152900,16025
97,78,19,913,156300,16027
886,614,272,557,88400,16028
307,263,44,700,96900,16029
140,81,59,546,86500,16030
2450,1892,558,769,167400,16033
715,567,148,540,151000,16034
43,34,9,-,75000,16035
106,77,29,645,93000,16036
1747,1432,315,753,207600,16037
1427,1197,230,673,123600,16038
371,296,75,629,125000,16040
805,647,158,621,97800,16041
553,312,241,745,70500,16045
5833,4766,1067,1172,281900,16046
74,49,25,511,126300,16048
1313,1066,247,620,92200,16049
632,546,86,700,94500,16050
1323,1133,190,766,111800,16051
1004,836,168,775,149400,16052
1674,1484,190,754,203700,16053
165,146,19,675,103400,16054
3300,2932,368,851,172500,16055
2048,1535,513,606,172100,16056
4745,2839,1906,677,161400,16057
3130,2675,455,1459,232200,16059
1053,959,94,623,131600,16061
3117,1972,1145,753,173600,16063
10742,8996,1746,1195,262500,16066
13635,9221,4414,571,78000,16101
2380,1895,485,644,82500,16102
6584,5080,1504,742,130200,16105
128,116,12,-,116700,16110
455,374,81,567,106900,16111
652,489,163,642,93800,16112
142,132,10,-,161500,16113
242,220,22,-,113200,16114
1316,1160,156,675,137500,16115
1118,953,165,619,102000,16116
7107,5332,1775,688,93100,16117
792,649,143,552,117800,16120
2041,1348,693,674,60600,16121
835,719,116,532,188500,16123
757,620,137,543,111900,16124
7156,5397,1759,560,95200,16125
5418,3935,1483,638,136600,16127
818,708,110,564,107100,16130
282,250,32,967,104300,16131
114,81,33,-,115400,16132
600,520,80,756,124400,16133
1690,1393,297,682,103500,16134
332,223,109,657,74600,16136
4442,3602,840,613,127700,16137
29,19,10,-,-,16140
772,675,97,525,86000,16141
2133,1602,531,598,164800,16142
1425,1298,127,624,119400,16143
1064,845,219,563,124900,16145
5995,3278,2717,582,59500,16146
7135,5184,1951,776,132900,16148
3012,2196,816,668,104400,16150
37,27,10,525,83800,16151
1070,804,266,600,112500,16153
1197,1135,62,640,111900,16154
25,8,17,-,-,16155
1116,980,136,672,142800,16156
1397,1162,235,523,95900,16157
1749,1364,385,587,130000,16159
434,318,116,710,80800,16160
395,261,134,579,53300,16161
7919,5537,2382,597,106300,16201
405,376,29,692,83900,16210
56,46,10,-,65000,16211
137,119,18,690,63400,16212
67,47,20,(X),66100,16213
3888,1667,2221,609,131200,16214
42,35,7,-,122900,16217
447,372,75,943,113700,16218
864,729,135,503,90900,16222
69,40,29,-,77800,16223
517,427,90,569,86200,16224
3423,2390,1033,592,88500,16226
197,176,21,688,81500,16228
2055,1545,510,723,143600,16229
167,116,51,625,76700,16230
1698,1325,373,568,102800,16232
432,381,51,675,135300,16233
500,430,70,592,126000,16235
87,76,11,-,96000,16236
171,107,64,550,108700,16238
666,512,154,684,84700,16239
612,480,132,499,100900,16240
1937,1385,552,545,84400,16242
75,63,12,-,52500,16244
92,84,8,-,55000,16245
99,77,22,672,70800,16246
1294,905,389,584,81900,16248
818,637,181,519,127300,16249
112,82,30,(X),48300,16250
37,34,3,-,62700,16253
1404,1153,251,656,111700,16254
653,543,110,692,89900,16255
522,426,96,495,103800,16256
886,530,356,669,89600,16258
775,646,129,539,88300,16259
150,130,20,-,164300,16260
1061,831,230,652,113100,16262
148,148,0,-,55500,16263
6541,4660,1881,549,65700,16301
248,200,48,733,108300,16311
3,3,0,-,-,16312
729,607,122,571,65200,16313
2095,1765,330,597,119200,16314
2398,1875,523,646,123100,16316
605,511,94,628,86000,16317
481,410,71,427,110100,16319
42,30,12,-,(X),16321
67,52,15,542,67800,16322
6798,4986,1812,584,78900,16323
169,159,10,625,150500,16326
1188,1002,186,848,102700,16327
38,31,7,788,70600,16328
221,206,15,-,80400,16329
27,27,0,-,104200,16331
26,11,15,628,71700,16332
118,105,13,-,39700,16333
105,94,11,850,120800,16334
11556,7428,4128,617,105100,16335
827,737,90,389,95700,16340
774,678,96,575,80300,16341
860,739,121,731,79800,16342
146,133,13,-,71200,16343
203,154,49,632,50300,16344
1488,1289,199,542,122500,16345
1467,1105,362,592,90000,16346
897,702,195,427,66000,16347
1052,888,164,569,102600,16350
704,534,170,489,84200,16351
102,90,12,725,57800,16352
1245,1072,173,504,88800,16353
4566,2873,1693,576,83200,16354
541,439,102,547,98500,16360
50,50,0,-,122500,16361
497,433,64,630,111900,16362
482,373,109,608,124500,16364
7929,5519,2410,590,92800,16365
112,101,11,-,61900,16370
1359,991,368,578,83400,16371
190,136,54,500,38900,16372
1316,1029,287,608,102500,16373
816,694,122,554,105400,16374
1745,1329,416,526,100200,16401
316,281,35,813,78400,16402
2220,1744,476,622,102000,16403
1227,1014,213,655,89700,16404
285,244,41,963,87600,16405
1312,1018,294,626,120500,16406
4305,2851,1454,728,89200,16407
625,564,61,744,107300,16410
596,502,94,786,101400,16411
4295,2593,1702,712,159700,16412
3281,2823,458,623,175200,16415
91,91,0,-,40900,16416
3096,2401,695,564,118400,16417
248,214,34,580,74600,16420
987,819,168,475,142300,16421
85,77,8,-,82500,16422
1704,1330,374,667,104700,16423
1974,1659,315,659,95200,16424
1568,1377,191,793,143000,16426
89,72,17,465,89500,16427
4960,3558,1402,667,139700,16428
2029,1762,267,622,114700,16433
929,742,187,650,96600,16434
714,585,129,698,108100,16435
234,202,32,575,116100,16436
3141,2449,692,589,94000,16438
392,342,50,663,136500,16440
3812,3312,500,690,156100,16441
1077,955,122,719,136600,16442
509,397,112,684,105700,16443
0,0,0,-,-,16444
1311,11,1300,370,-,16501
7071,2516,4555,648,73500,16502
5889,2026,3863,645,47100,16503
6641,4478,2163,730,85500,16504
7486,5275,2211,745,142000,16505
9755,6767,2988,875,160800,16506
4077,1108,2969,664,60200,16507
6939,4705,2234,670,91500,16508
11931,8501,3430,771,147600,16509
9742,7553,2189,696,110100,16510
4652,3126,1526,664,119700,16511
0,0,0,-,-,16546
0,0,0,-,-,16563
13427,9313,4114,587,96700,16601
12257,8406,3851,613,89700,16602
1020,859,161,661,133400,16611
586,519,67,600,110400,16613
37,22,15,-,85000,16616
1189,941,248,619,97500,16617
124,115,9,-,53000,16619
123,110,13,692,105900,16620
301,246,55,636,125000,16621
69,69,0,-,108700,16622
188,153,35,515,133900,16623
83,61,22,(X),122300,16624
1515,1103,412,587,98900,16625
884,728,156,588,71200,16627
1852,1328,524,565,99900,16630
28,28,0,-,(X),16631
58,58,0,-,68600,16633
116,94,22,600,88700,16634
4950,3768,1182,760,154700,16635
291,278,13,633,102500,16636
1017,773,244,642,110100,16637
18,12,6,750,137500,16638
607,526,81,575,78100,16639
355,325,30,609,95500,16640
1061,882,179,623,76100,16641
63,59,4,675,87500,16645
1011,816,195,613,82400,16646
314,258,56,525,160800,16647
6103,4422,1681,782,169400,16648
787,625,162,588,117500,16650
1524,1148,376,493,84000,16651
5838,4084,1754,539,133600,16652
634,532,102,670,130800,16655
508,446,62,760,66600,16656
541,486,55,733,148500,16657
124,89,35,650,98400,16659
349,289,60,638,55800,16661
2387,1745,642,608,150600,16662
703,633,70,770,140700,16664
121,77,44,675,123200,16665
1187,989,198,534,81600,16666
528,428,100,616,105300,16667
1509,1176,333,442,85000,16668
916,653,263,637,130400,16669
28,23,5,-,111300,16670
194,172,22,604,91300,16671
103,64,39,545,57300,16672
2134,1592,542,661,118000,16673
271,243,28,781,77500,16674
115,115,0,-,88600,16677
1125,863,262,621,94100,16678
347,262,85,625,77900,16679
175,151,24,850,91900,16680
47,14,33,-,-,16682
174,142,32,725,165900,16683
72,55,17,-,138800,16685
5179,3961,1218,619,125300,16686
180,173,7,-,148400,16689
124,106,18,754,129200,16691
268,222,46,703,72700,16692
1548,1168,380,550,108600,16693
75,72,3,-,68900,16694
383,325,58,625,125400,16695
0,0,0,-,-,16699
7376,5009,2367,583,77000,16701
497,421,76,646,73000,16720
52,37,15,654,55000,16724
53,39,14,-,(X),16725
210,202,8,-,69100,16726
69,66,3,-,(X),16727
19,19,0,-,42500,16728
335,270,65,598,62900,16729
42,42,0,-,70900,16730
1175,909,266,557,65700,16731
168,144,24,(X),74500,16732
103,93,10,-,78500,16733
90,90,0,-,53900,16734
2732,1996,736,590,73800,16735
570,486,84,564,75600,16738
458,357,101,477,64000,16740
1699,1248,451,702,81700,16743
147,126,21,-,77100,16744
219,185,34,725,78400,16745
523,416,107,531,81500,16746
1081,883,198,517,85100,16748
1589,1289,300,637,88700,16749
168,118,50,600,82200,16750
17192,6733,10459,958,251500,16801
9,0,9,-,-,16802
10289,4588,5701,987,256400,16803
374,327,47,642,170100,16820
80,68,12,-,(X),16821
802,652,150,642,116600,16822
10884,7957,2927,754,168300,16823
104,63,41,-,66000,16825
216,181,35,678,137500,16826
1629,1270,359,1053,240900,16827
1974,1633,341,1007,189000,16828
259,221,38,650,115500,16829
5966,3901,2065,559,87600,16830
196,160,36,708,176800,16832
2220,1720,500,616,81800,16833
65,65,0,-,86200,16834
80,61,19,563,114100,16835
461,417,44,773,100800,16836
49,49,0,-,60900,16837
735,638,97,634,83500,16838
216,207,9,-,65700,16839
234,210,24,-,63100,16840
2215,1775,440,722,145500,16841
244,169,75,-,38100,16843
1118,986,132,805,161600,16844
303,268,35,538,86000,16845
154,133,21,-,82100,16847
162,131,31,739,98100,16848
146,133,13,-,134100,16849
310,279,31,-,176000,16851
118,95,23,(X),144800,16852
113,48,65,731,156000,16853
356,283,73,758,142900,16854
131,131,0,-,(X),16855
1499,1307,192,769,99700,16858
200,170,30,443,108100,16859
189,150,39,-,153100,16860
110,101,9,363,59800,16861
287,234,53,775,95000,16863
813,759,54,1048,186300,16865
3848,2709,1139,510,96700,16866
152,136,16,-,167200,16868
2459,2168,291,750,263000,16870
20,16,4,-,60000,16871
433,330,103,765,137900,16872
557,479,78,546,120100,16874
1624,1220,404,777,208100,16875
131,112,19,732,76000,16876
720,606,114,698,170700,16877
833,756,77,635,97500,16878
106,86,20,742,80000,16879
825,723,102,839,83700,16881
140,112,28,603,156000,16882
4218,3223,995,756,146900,16901
165,150,15,775,104600,16911
719,500,219,577,110600,16912
784,639,145,733,133300,16914
2261,1749,512,704,120200,16915
500,404,96,615,133100,16917
864,592,272,602,80000,16920
221,186,35,738,117200,16921
788,568,220,565,92900,16922
600,430,170,624,137100,16923
1213,1002,211,818,113400,16925
312,254,58,850,161100,16926
262,208,54,625,83000,16927
523,382,141,643,94700,16928
962,715,247,692,109700,16929
487,376,111,785,137500,16930
265,210,55,950,177100,16932
2684,1726,958,711,145100,16933
541,483,58,608,148000,16935
754,628,126,725,109900,16936
95,73,22,-,53000,16937
295,238,57,844,144200,16938
169,111,58,850,95600,16939
131,80,51,482,93300,16940
35,33,2,-,76300,16941
300,254,46,785,95700,16942
205,174,31,738,133300,16943
979,715,264,788,102400,16946
1873,1432,441,632,136300,16947
598,437,161,555,117700,16948
1426,1034,392,570,94600,16950
238,177,61,346,144900,17002
4164,3253,911,748,173400,17003
1655,1182,473,542,127100,17004
159,118,41,720,107100,17005
377,295,82,708,155700,17006
2156,1981,175,1002,229400,17007
833,604,229,627,85000,17009
40,0,40,-,-,17010
13658,9518,4140,913,187900,17011
13880,8389,5491,840,167900,17013
8088,7139,949,874,207000,17015
284,114,170,2209,142800,17016
730,580,150,733,129200,17017
1697,1394,303,818,178700,17018
6938,5663,1275,748,206300,17019
3675,2831,844,757,160500,17020
400,291,109,586,135200,17021
10800,7417,3383,905,182100,17022
1361,974,387,627,133300,17023
729,591,138,725,175400,17024
6804,5091,1713,821,181400,17025
1375,1188,187,530,181800,17026
192,141,51,1118,174600,17027
1391,1239,152,807,189300,17028
155,125,30,-,63600,17029
340,263,77,661,105500,17030
3227,2624,603,585,158000,17032
6528,3691,2837,899,240000,17033
1060,610,450,711,96000,17034
335,265,70,518,137500,17035
8852,6350,2502,984,212500,17036
335,276,59,1025,163300,17037
3131,2416,715,842,167100,17038
5,5,0,-,-,17039
963,803,160,803,167900,17040
38,38,0,-,216100,17041
14560,9966,4594,793,163400,17042
2934,1431,1503,827,141100,17043
9013,5595,3418,614,91500,17044
1266,988,278,544,152400,17045
11696,7311,4385,652,132200,17046
932,652,280,647,154000,17047
1432,1052,380,686,102300,17048
1128,878,250,788,135300,17049
14262,10899,3363,1050,241200,17050
1858,1471,387,565,113700,17051
617,516,101,605,89600,17052
2107,1601,506,906,162800,17053
15202,10692,4510,961,190500,17055
37,37,0,-,80800,17056
8950,6151,2799,813,139100,17057
714,508,206,556,117300,17058
2937,2123,814,573,147500,17059
498,420,78,620,84500,17060
2952,2211,741,658,127300,17061
1512,1315,197,630,162800,17062
1277,997,280,649,94000,17063
278,258,20,927,270100,17064
1616,1221,395,690,159000,17065
2358,1621,737,487,76800,17066
5274,4105,1169,817,166100,17067
1634,1279,355,871,156200,17068
61,35,26,675,134400,17069
6715,4941,1774,820,171100,17070
71,55,16,625,70600,17071
18,0,18,-,-,17072
1934,1491,443,882,168500,17073
2884,2158,726,658,156000,17074
53,42,11,675,49300,17075
34,25,9,-,-,17076
34,14,20,-,-,17077
8738,6138,2600,878,182900,17078
104,95,9,725,113000,17080
155,123,32,-,155000,17081
1431,1049,382,608,139200,17082
15,4,11,-,-,17083
1692,1391,301,752,152700,17084
853,651,202,592,145000,17086
1051,849,202,796,168000,17087
343,270,73,936,167400,17088
2238,1957,281,699,161500,17090
384,247,137,1092,150300,17093
1078,825,253,492,136700,17094
365,284,81,718,73300,17097
961,753,208,594,82300,17098
480,352,128,695,75500,17099
1390,65,1325,751,145800,17101
4325,1270,3055,746,139300,17102
4333,1960,2373,767,82200,17103
7833,3242,4591,747,76900,17104
10236,5281,4955,895,153600,17109
10090,6372,3718,954,156100,17110
12363,8638,3725,917,166600,17111
14128,11295,2833,979,192700,17112
3986,2305,1681,834,111800,17113
0,0,0,-,-,17120
9951,5267,4684,794,161400,17201
11852,9544,2308,870,186400,17202
66,57,9,-,171900,17210
173,153,20,688,155100,17211
280,242,38,571,171700,17212
254,201,53,617,152300,17213
538,267,271,701,165300,17214
91,65,26,438,168100,17215
61,34,27,1025,120000,17217
162,138,24,-,123000,17219
129,83,46,(X),177500,17220
225,167,58,830,105400,17221
4304,3598,706,767,183900,17222
133,90,43,593,163600,17223
798,662,136,711,162100,17224
7216,5454,1762,885,207100,17225
467,355,112,589,136300,17228
527,465,62,756,116000,17229
2197,1579,618,619,147100,17233
203,100,103,914,229400,17235
3099,2267,832,800,171700,17236
625,509,116,788,140100,17237
646,550,96,667,165000,17238
87,81,6,-,127700,17239
1154,945,209,868,197400,17240
4477,3554,923,814,164600,17241
673,525,148,593,104100,17243
889,720,169,978,166700,17244
71,58,13,-,158300,17246
206,45,161,1198,-,17247
146,131,15,792,78300,17249
66,34,32,-,-,17250
66,55,11,-,162500,17251
1419,1159,260,833,150600,17252
116,101,15,550,83000,17253
0,0,0,-,-,17254
441,371,70,696,116800,17255
55,35,20,-,-,17256
10687,6398,4289,821,171300,17257
491,372,119,769,109200,17260
0,0,0,-,-,17261
498,434,64,731,142700,17262
253,234,19,-,177700,17263
927,767,160,570,116400,17264
212,179,33,927,125500,17265
205,154,51,805,173900,17266
1069,876,193,760,167500,17267
11494,7888,3606,737,165100,17268
74,74,0,-,190700,17270
105,83,22,-,156800,17271
182,164,18,-,13200,17272
1476,1294,182,967,161900,17301
1028,819,209,972,169800,17302
1087,898,189,836,177500,17304
119,83,36,1131,145600,17306
2241,1541,700,817,193300,17307
833,704,129,755,170700,17309
88,62,26,746,154200,17311
4343,2945,1398,823,155500,17313
2112,1624,488,808,166000,17314
10275,8368,1907,850,152200,17315
3013,2599,414,843,183000,17316
315,242,73,777,133500,17317
131,77,54,(X),112500,17318
4066,3131,935,1009,173600,17319
2946,2595,351,856,213400,17320
859,748,111,867,235700,17321
2216,1851,365,1284,179400,17322
1599,1327,272,627,175300,17324
10437,7533,2904,810,216100,17325
2927,2386,541,875,219800,17327
859,776,83,934,250300,17329
19553,14217,5336,816,176500,17331
2761,2224,537,888,235300,17339
4259,3308,951,795,204500,17340
0,0,0,-,-,17343
1493,908,585,865,156900,17344
3073,2196,877,787,138800,17345
2319,1981,338,841,168500,17347
2823,2452,371,951,248600,17349
4649,3578,1071,955,167900,17350
461,378,83,851,225300,17352
1380,1210,170,851,191600,17353
82,49,33,825,170800,17355
8387,6165,2222,816,170800,17356
2270,1952,318,942,196800,17360
2215,1763,452,832,210900,17361
5086,4315,771,708,182300,17362
3606,3194,412,1013,210800,17363
1446,1302,144,620,161600,17364
958,775,183,619,207800,17365
2221,1828,393,756,140700,17366
2971,2219,752,903,146100,17368
1875,1629,246,846,157700,17370
138,115,23,1089,157800,17371
1577,1202,375,727,200700,17372
6453,1982,4471,734,64300,17401
13795,9429,4366,931,172500,17402
14514,9396,5118,802,152900,17403
13810,9836,3974,790,134200,17404
8939,6756,2183,992,159000,17406
815,747,68,1038,180700,17407
8924,7139,1785,966,166500,17408
1770,1149,621,829,158600,17501
1115,927,188,923,172400,17502
603,367,236,667,312700,17505
38,0,38,-,-,17507
133,133,0,-,230900,17508
1306,935,371,905,224700,17509
6908,4702,2206,757,132500,17512
1789,1489,300,760,215000,17516
5913,4710,1203,849,195900,17517
457,352,105,1154,196800,17518
2091,1522,569,865,225000,17519
1769,1509,260,1021,168000,17520
12586,8907,3679,847,178700,17522
1915,1405,510,998,223900,17527
1519,985,534,796,261600,17529
1102,919,183,687,183400,17532
569,371,198,895,281500,17535
860,732,128,933,249500,17536
2447,2175,272,954,233100,17538
3243,2164,1079,887,201800,17540
16217,11646,4571,1019,216700,17543
8170,6419,1751,934,193100,17545
2560,1966,594,787,159700,17547
405,154,251,953,174000,17550
3625,2331,1294,1041,173900,17551
8005,5756,2249,943,172000,17552
3186,1966,1220,886,182000,17554
2210,1787,423,784,240700,17555
5082,3113,1969,959,220600,17557
2144,1811,333,1029,162700,17560
1367,990,377,888,219700,17562
1261,991,270,988,208700,17563
1042,903,139,1087,229100,17565
4142,3084,1058,930,205800,17566
1983,1860,123,920,193100,17569
96,19,77,-,-,17570
1277,862,415,744,207900,17572
43,43,0,-,-,17576
2555,2096,459,786,189900,17578
2081,1673,408,917,218000,17579
324,265,59,700,193100,17581
767,695,72,853,222400,17582
3728,2567,1161,1569,198700,17584
20088,14538,5550,1048,221400,17601
18974,9911,9063,882,159100,17602
24685,14143,10542,861,150900,17603
211,32,179,(X),-,17606
17736,10349,7387,731,122800,17701
4550,3198,1352,739,131400,17702
719,445,274,682,105600,17721
14,12,2,-,158300,17723
2028,1336,692,575,134000,17724
37,32,5,-,216700,17727
1994,1783,211,744,143000,17728
34,31,3,-,81000,17729
55,0,55,-,-,17730
100,95,5,-,427800,17731
2456,1946,510,641,151700,17737
15,15,0,-,143800,17739
4812,3551,1261,701,136700,17740
21,11,10,-,79200,17742
1263,1012,251,661,114400,17744
7122,4382,2740,656,120500,17745
1053,870,183,734,141300,17747
124,115,9,-,50200,17748
141,101,40,814,86500,17749
38,38,0,-,135000,17750
2736,2289,447,684,127200,17751
1738,1219,519,794,134500,17752
4934,3997,937,726,171000,17754
4527,3593,934,645,147700,17756
394,353,41,914,144500,17758
281,245,36,732,80800,17760
229,190,39,821,145600,17762
123,102,21,-,108800,17763
936,682,254,443,50700,17764
421,333,88,663,143300,17765
73,68,5,-,89400,17767
142,122,20,(X),150000,17768
1297,1123,174,754,149800,17771
877,714,163,591,146400,17772
505,394,111,667,147400,17774
134,107,27,525,166300,17776
2865,2075,790,632,147600,17777
44,40,4,-,85000,17778
20,12,8,-,-,17779
6991,4494,2497,588,108000,17801
836,691,145,650,149800,17810
482,371,111,663,117500,17812
739,566,173,834,129000,17813
1884,1561,323,699,151300,17814
11423,7158,4265,719,155100,17815
2301,1864,437,648,144400,17820
7495,5450,2045,725,167400,17821
0,0,0,-,-,17822
472,372,100,625,153900,17823
1634,1336,298,777,174400,17824
277,203,74,714,138900,17827
77,69,8,950,100800,17829
802,674,128,688,122500,17830
322,291,31,625,68500,17832
1751,1267,484,486,79300,17834
95,75,20,639,98400,17835
91,87,4,-,159700,17836
6411,3908,2503,702,184900,17837
138,111,27,-,59400,17840
1782,1497,285,640,103900,17841
3314,2607,707,650,137100,17842
4029,3055,974,700,151600,17844
793,628,165,678,144400,17845
1471,1164,307,708,169300,17846
5118,3602,1516,678,121100,17847
285,200,85,657,(X),17850
3611,2503,1108,547,44200,17851
1174,926,248,663,156000,17853
398,339,59,788,126800,17855
1472,1235,237,689,156600,17856
3272,2389,883,702,132500,17857
1216,1081,135,758,140500,17859
1045,874,171,780,171000,17860
24,20,4,-,139300,17861
199,100,99,698,127600,17862
734,619,115,723,150100,17864
53,38,15,908,79400,17865
3240,2433,807,616,63600,17866
67,49,18,(X),168300,17867
466,346,120,753,165900,17868
5271,3758,1513,754,152400,17870
4431,2774,1657,541,57200,17872
823,504,319,531,148300,17876
513,429,84,710,170000,17878
50,43,7,771,110200,17880
628,504,124,570,77300,17881
93,58,35,669,80000,17884
51,35,16,-,106300,17885
331,230,101,498,104400,17886
164,164,0,-,(X),17887
114,99,15,-,80700,17888
1004,862,142,786,173900,17889
9884,6815,3069,637,87700,17901
145,129,16,-,84100,17920
2894,2205,689,476,86300,17921
1936,1663,273,893,157500,17922
188,148,40,495,55900,17923
178,115,63,691,87100,17925
705,490,215,692,103100,17929
176,130,46,663,70000,17930
2287,1695,592,714,78700,17931
27,16,11,-,-,17933
192,161,31,656,31400,17934
619,510,109,633,30500,17935
321,266,55,706,91600,17936
958,818,140,640,117300,17938
330,269,61,561,158600,17941
67,67,0,-,117000,17943
84,63,21,775,92100,17944
91,89,2,-,57000,17945
108,100,8,-,28200,17946
2085,1501,584,611,32100,17948
88,83,5,-,33500,17949
101,101,0,-,97000,17951
94,78,16,542,(X),17952
217,160,57,661,63100,17953
1909,1246,663,588,58600,17954
178,155,23,705,87500,17957
604,493,111,507,49300,17959
1563,1378,185,688,170700,17960
3033,2378,655,668,161000,17961
3634,2861,773,644,144900,17963
289,229,60,491,141800,17964
866,650,216,703,72300,17965
1038,927,111,607,119000,17967
110,94,16,633,93300,17968
1360,906,454,618,65900,17970
4375,3366,1009,648,116200,17972
135,104,31,-,83300,17974
2746,1735,1011,588,37300,17976
86,41,45,534,122500,17978
95,95,0,-,157600,17979
1245,1059,186,559,86100,17980
997,773,224,551,68800,17981
158,110,48,806,71700,17982
626,476,150,595,117300,17983
495,453,42,1125,153700,17985
2074,1788,286,1293,192000,18011
6526,4886,1640,920,183500,18013
4403,3654,749,938,186400,18014
10966,5931,5035,896,153200,18015
0,0,0,-,-,18016
14919,10221,4698,1011,226700,18017
13708,7090,6618,938,164000,18018
7470,6505,965,1147,244500,18020
335,225,110,683,131400,18030
3355,2445,910,1403,230900,18031
3840,2291,1549,727,153400,18032
2663,2243,420,1187,281500,18034
57,57,0,-,185400,18035
4673,4175,498,848,267400,18036
2983,2421,562,897,183600,18037
1108,919,189,922,219000,18038
6072,5463,609,1009,241700,18040
2054,1643,411,924,230600,18041
15421,8481,6940,936,143600,18042
10075,8430,1645,1113,230300,18045
12,12,0,-,-,18046
7362,5297,2065,969,198700,18049
1303,1148,155,1416,313700,18051
11020,6675,4345,953,177900,18052
954,796,158,956,220800,18053
1599,1413,186,873,290800,18054
4968,3773,1195,1032,197900,18055
304,300,4,-,25400,18056
3684,3230,454,866,175600,18058
409,400,9,-,261100,18059
9771,8172,1599,1176,238800,18062
253,204,49,-,215200,18063
9091,7182,1909,897,239800,18064
2175,1939,236,1040,259700,18066
7552,5895,1657,908,194900,18067
0,0,0,-,-,18068
2927,2586,341,1143,276100,18069
363,258,105,1169,219400,18070
4110,3256,854,722,143500,18071
2407,1641,766,876,171600,18072
3272,2875,397,911,263500,18073
2224,2038,186,1172,269900,18074
1232,882,350,765,195300,18076
954,779,175,1116,320600,18077
2694,2251,443,1060,275000,18078
190,149,41,-,131900,18079
4663,3654,1009,713,173800,18080
81,81,0,-,(X),18081
185,119,66,964,195700,18083
346,314,32,1125,227100,18085
172,144,28,-,191100,18086
250,74,176,1069,168800,18087
3252,2882,370,789,188100,18088
2277,1576,701,885,204100,18091
1218,1077,141,1025,303900,18092
1559,171,1388,605,81700,18101
15458,5178,10280,853,90300,18102
17807,11735,6072,936,163000,18103
16391,12184,4207,1094,214500,18104
0,0,0,-,-,18105
2840,2362,478,1189,224200,18106
6281,3299,2982,934,128300,18109
0,0,0,-,-,18195
9852,5311,4541,686,85000,18201
4494,2809,1685,747,124400,18202
2892,2466,426,1334,162900,18210
576,512,64,777,250000,18211
68,60,8,-,117500,18212
742,694,48,675,137700,18214
433,323,110,636,87800,18216
1011,705,306,580,47300,18218
642,487,155,785,164900,18219
174,174,0,-,54200,18220
199,199,0,-,100300,18221
3495,3145,350,1181,169900,18222
82,55,27,-,(X),18223
2469,1875,594,708,82300,18224
70,70,0,-,29000,18225
3444,2769,675,833,167000,18229
38,25,13,825,85000,18230
233,134,99,725,84400,18231
1635,1051,584,596,47500,18232
212,181,31,-,120700,18234
7629,5956,1673,730,172600,18235
1378,937,441,691,85400,18237
131,42,89,781,-,18239
1571,1169,402,769,94800,18240
278,168,110,831,80900,18241
90,76,14,-,108300,18242
187,157,30,696,85900,18244
141,139,2,-,123100,18245
75,48,27,-,37000,18246
221,176,45,848,115300,18248
1519,1358,161,969,197200,18249
1168,853,315,752,104500,18250
32,0,32,-,-,18251
4536,3041,1495,639,88900,18252
396,308,88,833,95600,18254
1769,1520,249,833,132100,18255
167,148,19,-,140300,18256
9401,6735,2666,1028,181000,18301
6058,5066,992,1259,157400,18302
570,466,104,829,155400,18321
836,643,193,892,203600,18322
33,33,0,-,425000,18323
3248,2662,586,1388,134000,18324
981,806,175,854,189400,18325
1637,1236,401,786,159600,18326
268,127,141,1051,199500,18327
2576,2335,241,1229,152100,18328
2717,2480,237,1357,180300,18330
331,255,76,744,181100,18331
1033,840,193,1039,182600,18332
110,39,71,-,189400,18333
1638,1285,353,1077,159600,18334
291,277,14,-,153500,18335
1576,1083,493,865,194600,18336
5006,4194,812,1085,223200,18337
44,44,0,-,240600,18340
201,107,94,-,164700,18342
1650,1299,351,1028,223300,18343
1226,787,439,877,157100,18344
772,653,119,991,163400,18346
1189,1100,89,783,168200,18347
70,70,0,-,(X),18349
712,587,125,752,259700,18350
194,144,50,891,157900,18351
421,263,158,1250,206400,18352
4007,3562,445,988,200100,18353
294,270,24,-,228200,18354
531,428,103,1075,197400,18355
50,50,0,-,192300,18356
50,39,11,-,-,18357
10134,7091,3043,920,202600,18360
451,378,73,1589,174200,18370
279,243,36,-,172000,18371
953,755,198,852,207400,18372
2899,2400,499,751,148100,18403
1030,880,150,858,198900,18405
5822,3769,2053,591,98300,18407
8815,7056,1759,944,210400,18411
53,3,50,1179,-,18413
2031,1789,242,837,199300,18414
517,470,47,781,199400,18415
448,404,44,588,200000,18417
1746,1438,308,723,170500,18419
26,18,8,-,(X),18420
2032,1467,565,673,123300,18421
1996,1739,257,1033,160200,18424
540,522,18,1375,166900,18425
1887,1574,313,916,161100,18426
60,0,60,-,-,18427
4823,4011,812,1064,203300,18428
7,5,2,-,-,18430
4926,3521,1405,738,168300,18431
2659,2149,510,661,156900,18433
1605,1127,478,697,135900,18434
284,257,27,-,249600,18435
5057,4390,667,1112,199100,18436
97,78,19,575,169600,18437
523,510,13,-,215900,18438
194,135,59,598,170800,18439
120,81,39,594,111000,18441
192,175,17,-,174200,18443
5177,4422,755,788,197500,18444
903,779,124,879,182500,18445
1453,1199,254,658,159100,18446
4366,3055,1311,690,156200,18447
241,203,38,-,285500,18451
2203,1594,609,601,142000,18452
472,405,67,807,182100,18453
7,7,0,-,-,18454
35,33,2,-,141100,18455
201,128,73,780,191400,18456
68,52,16,-,196400,18457
1282,1026,256,1125,216000,18458
22,22,0,-,(X),18459
116,94,22,-,184600,18460
174,162,12,713,123700,18461
155,130,25,775,156300,18462
88,76,12,975,170000,18463
538,461,77,906,230700,18464
620,524,96,682,171700,18465
5161,3992,1169,1286,134000,18466
141,99,42,-,212500,18469
907,727,180,636,196100,18470
269,234,35,(X),294200,18471
1565,1238,327,801,173400,18472
245,172,73,765,112500,18473
556,33,523,491,88600,18503
8331,4909,3422,723,107100,18504
8316,4409,3907,688,105200,18505
1985,1570,415,729,158000,18507
4981,2737,2244,742,95600,18508
4593,2456,2137,708,129100,18509
4533,1958,2575,734,117700,18510
5250,3381,1869,766,139700,18512
2150,1432,718,698,112100,18517
3746,2583,1163,692,137100,18518
2107,1164,943,624,122800,18519
115,103,12,1375,338400,18602
7983,5685,2298,689,117100,18603
1497,1293,204,1019,125400,18610
6155,4944,1211,728,179200,18612
1148,885,263,523,158400,18614
687,535,152,787,163400,18615
252,199,53,661,132400,18616
709,331,378,524,75300,18617
1600,1262,338,974,166300,18618
108,96,12,1313,122800,18619
2031,1828,203,787,131400,18621
82,64,18,-,130000,18622
1038,811,227,692,149400,18623
261,213,48,1604,286800,18624
239,179,60,619,217300,18625
193,176,17,447,185400,18626
100,86,14,-,93500,18628
683,566,117,675,158100,18629
1195,871,324,789,159600,18630
551,452,99,759,137100,18631
190,163,27,593,86600,18632
5720,3420,2300,669,87800,18634
1701,1261,440,622,129600,18635
541,474,67,688,114900,18636
7184,4916,2268,713,116100,18640
2762,2174,588,643,103400,18641
1859,1377,482,726,127500,18642
5428,3773,1655,690,133700,18643
2963,2228,735,679,140700,18644
3733,2285,1448,707,84300,18651
39,39,0,-,152100,18653
2511,2121,390,638,152300,18655
845,712,133,691,188800,18656
4848,3739,1109,740,161900,18657
1338,1145,193,697,162100,18660
2382,1993,389,825,153400,18661
940,88,852,597,164500,18701
15783,8269,7514,705,86000,18702
13664,7844,5820,746,125000,18704
6484,4121,2363,668,92900,18705
7049,4836,2213,595,85600,18706
6122,5540,582,607,184500,18707
3566,2862,704,745,171600,18708
1367,854,513,606,87900,18709
3408,2564,844,730,157100,18801
2339,1751,588,435,131200,18810
683,616,67,922,193200,18812
54,39,15,746,128100,18814
61,58,3,-,110000,18816
77,56,21,906,132100,18817
558,485,73,733,166900,18818
512,296,216,676,115000,18821
1557,1092,465,745,106300,18822
100,38,62,656,88900,18823
555,413,142,850,144400,18824
53,45,8,-,116300,18825
733,633,100,852,185400,18826
143,92,51,840,138600,18828
322,267,55,731,151100,18829
311,260,51,879,124300,18830
507,440,67,917,130300,18831
685,525,160,688,141200,18832
799,652,147,695,138100,18833
1450,1212,238,784,148800,18834
1169,950,219,765,130100,18837
4728,3252,1476,689,125900,18840
87,74,13,-,138300,18842
87,80,7,-,100000,18843
725,541,184,764,174400,18844
118,112,6,1042,153800,18845
322,281,41,944,185800,18846
2292,1735,557,666,113600,18847
3748,2541,1207,731,149100,18848
810,672,138,1118,147800,18850
295,241,54,769,139800,18851
1605,1287,318,691,159600,18853
486,412,74,733,129800,18854
10234,6936,3298,1250,409700,18901
7202,6426,776,1548,465900,18902
53,53,0,-,-,18912
57,23,34,-,-,18913
7328,6410,918,1296,359400,18914
273,250,23,788,246800,18915
864,425,439,1047,297600,18917
162,144,18,-,281900,18920
320,317,3,-,348400,18923
2232,2083,149,(X),467300,18925
2874,2736,138,1104,411000,18929
1089,1005,84,1031,355400,18930
189,162,27,-,331700,18932
0,0,0,-,-,18935
12,12,0,-,-,18936
6005,5005,1000,1404,570900,18938
10688,9021,1667,1607,432200,18940
1269,1000,269,1062,384900,18942
9149,7055,2094,1146,292300,18944
2300,2117,183,1065,413000,18947
80,80,0,-,679700,18950
13521,10613,2908,967,243300,18951
3175,3048,127,1750,425500,18954
594,445,149,1025,226300,18955
4934,3876,1058,1180,267100,18960
211,182,29,1108,281100,18962
4955,3750,1205,891,269300,18964
14094,11949,2145,1391,341300,18966
5750,3980,1770,995,256600,18969
302,201,101,950,240800,18970
1504,1197,307,1105,366000,18972
16043,11750,4293,1300,294800,18974
7055,5627,1428,1273,371100,18976
1524,1472,52,2042,571400,18977
211,168,43,1220,454200,18980
6358,5054,1304,1080,246900,19001
12338,9657,2681,1214,395400,19002
5221,3375,1846,1169,294300,19003
3832,3115,717,1362,474500,19004
7799,6191,1608,1128,386100,19006
7900,4380,3520,856,194200,19007
7197,6163,1034,1142,339200,19008
271,169,102,918,441700,19009
7406,4844,2562,1417,592000,19010
2267,1998,269,890,233500,19012
12318,4619,7699,801,68100,19013
7566,6443,1123,963,234300,19014
6315,4732,1583,1017,164300,19015
109,109,0,-,397900,19017
9193,5790,3403,966,159700,19018
21776,12770,9006,1082,258900,19020
3667,2554,1113,980,203000,19021
1370,634,736,918,103600,19022
7247,4053,3194,966,100900,19023
1967,1679,288,1946,401400,19025
11938,8024,3914,959,189500,19026
8245,5118,3127,968,274900,19027
1520,939,581,873,144300,19029
4491,3300,1191,966,244300,19030
1897,1368,529,1159,336600,19031
2354,1810,544,1254,118300,19032
3039,2362,677,1058,203200,19033
1960,1639,321,1293,473400,19034
1419,1215,204,1446,785500,19035
5265,3833,1432,1013,141000,19036
11058,9161,1897,1087,274700,19038
7815,5761,2054,1095,268600,19040
2371,1464,907,1490,572700,19041
1044,624,420,956,190000,19043
6516,4305,2211,1179,258500,19044
7097,5111,1986,1018,314300,19046
12928,9459,3469,1198,336000,19047
10791,6718,4073,868,148000,19050
9494,7511,1983,1068,290600,19053
6217,4549,1668,1128,233100,19054
4722,4150,572,1304,201800,19055
5403,3944,1459,1066,256400,19056
6242,4575,1667,1153,213700,19057
3731,3581,150,1089,410900,19060
7583,4978,2605,944,172900,19061
13975,9810,4165,1113,356900,19063
8517,7785,732,1144,287500,19064
1812,1585,227,1980,649900,19066
19511,15300,4211,1243,353600,19067
2707,2093,614,885,221200,19070
3971,2987,984,1363,469400,19072
7797,6323,1474,1616,400200,19073
2072,1604,468,868,166200,19074
2693,2313,380,1036,293700,19075
2504,1622,882,938,177200,19076
4440,3121,1319,877,182500,19078
3325,2238,1087,998,112900,19079
3361,2817,544,990,255400,19081
13623,6631,6992,894,116400,19082
13228,11493,1735,1029,294600,19083
1825,1692,133,1973,808000,19085
4308,3874,434,1082,303800,19086
12212,9369,2843,1444,486800,19087
7170,5119,2051,1111,247400,19090
1749,1018,731,660,176500,19094
3084,1402,1682,1462,304000,19095
5494,4268,1226,1422,483600,19096
2807,736,2071,1987,389300,19102
14610,5138,9472,1460,439300,19103
15436,2975,12461,879,107200,19104
6183,2742,3441,1637,457100,19106
6631,1219,5412,1152,301800,19107
0,0,0,-,-,19109
24021,13233,10788,906,171500,19111
0,0,0,-,-,19112
51,30,21,-,160900,19113
12834,7722,5112,991,190600,19114
13595,7867,5728,936,234300,19115
12670,7342,5328,877,235500,19116
4270,2026,2244,1317,473700,19118
12056,7610,4446,917,229600,19119
22987,13317,9670,915,96100,19120
12258,3763,8495,694,82800,19121
5906,2517,3389,713,144300,19122
6452,2103,4349,1107,312200,19123
22178,11641,10537,877,95200,19124
9187,5676,3511,914,170600,19125
5764,3712,2052,887,138600,19126
2186,955,1231,1360,223600,19127
15264,9151,6113,1171,231500,19128
4551,2434,2117,1141,197300,19129
12382,5188,7194,1296,339500,19130
17741,7753,9988,911,100600,19131
13447,7046,6401,758,47100,19132
8676,3868,4808,681,52000,19133
19976,10308,9668,845,80300,19134
11478,7163,4315,895,112000,19135
12237,7514,4723,855,150600,19136
2944,2141,803,923,130700,19137
11344,7839,3505,895,107900,19138
16014,6945,9069,805,79400,19139
18284,8368,9916,772,60900,19140
12479,5929,6550,790,95200,19141
9538,5005,4533,919,79800,19142
25254,12818,12436,827,82900,19143
16933,6174,10759,822,117400,19144
18161,10918,7243,883,155000,19145
16128,8006,8122,985,225000,19146
16296,8763,7533,1147,312000,19147
19495,12847,6648,941,167300,19148
18541,11244,7297,1066,126100,19149
9820,7289,2531,965,157300,19150
11969,7829,4140,954,123500,19151
12772,8043,4729,919,190800,19152
5241,3157,2084,1040,135600,19153
12081,9877,2204,1097,197000,19154
2722,2046,676,1310,378900,19301
979,757,222,919,229600,19310
2900,2202,698,1209,338800,19311
4347,3664,683,1236,585600,19312
43,33,10,-,225000,19316
3703,3260,443,1626,447500,19317
78,56,22,-,-,19319
19246,14138,5108,1081,224300,19320
1913,1651,262,1193,285500,19330
2847,1871,976,1301,531100,19333
17505,13795,3710,1170,319300,19335
6715,4214,2501,1332,349000,19341
7513,5413,2100,1830,415100,19342
2961,2579,382,1524,374900,19343
4255,3178,1077,1170,228100,19344
8,8,0,-,-,19345
8264,5820,2444,1121,373500,19348
3974,3444,530,1396,379000,19350
2742,2477,265,1034,328700,19352
8963,6766,2197,1457,436100,19355
191,96,95,1072,150000,19358
2059,1699,360,853,209500,19362
5729,4025,1704,889,243300,19363
2610,1960,650,945,210700,19365
34,12,22,-,-,19367
654,324,330,1382,209900,19372
959,931,28,-,518100,19373
269,101,168,1225,313100,19374
36,0,36,-,-,19375
19571,14298,5273,1312,364800,19380
19984,14093,5891,1258,384200,19382
0,0,0,-,-,19383
4865,3798,1067,984,288100,19390
15903,6993,8910,1063,170400,19401
17823,12819,5004,1283,268700,19403
2465,1271,1194,875,198000,19405
9924,6293,3631,1207,290400,19406
7130,5584,1546,1700,409000,19422
4946,4463,483,1424,456500,19425
12079,10557,1522,1399,335700,19426
7443,4235,3208,1352,290400,19428
52,52,0,-,191700,19435
370,35,335,1470,232500,19436
303,303,0,-,836400,19437
9129,7188,1941,1251,321800,19438
7135,4884,2251,1009,281500,19440
0,0,0,-,-,19442
4337,3444,893,1478,372800,19444
21709,14176,7533,1210,299700,19446
615,412,203,998,204600,19453
11110,8527,2583,1285,297200,19454
277,277,0,-,287700,19456
79,40,39,-,-,19457
16410,11901,4509,1107,278700,19460
5820,4464,1356,1248,320200,19462
17823,12274,5549,865,166000,19464
6489,5113,1376,1080,274400,19465
10032,7182,2850,1195,248000,19468
17,0,17,-,-,19472
6014,5205,809,1024,307500,19473
302,242,60,-,232000,19474
4163,3090,1073,769,259500,19475
11,11,0,-,-,19477
244,39,205,2283,268500,19492
431,247,184,712,171800,19501
532,406,126,1048,178200,19503
1912,1718,194,988,258400,19504
1225,953,272,905,208300,19505
2707,2413,294,820,211300,19506
1227,1024,203,857,198900,19507
6228,5414,814,887,177900,19508
2782,2370,412,1046,189200,19510
77,77,0,-,186300,19511
6981,5183,1798,827,193000,19512
5367,4467,900,1017,225700,19518
14,0,14,-,-,19519
2331,1816,515,849,284200,19520
5621,4781,840,840,180300,19522
143,143,0,-,171100,19523
5284,4761,523,1145,289100,19525
4579,3563,1016,747,144000,19526
1316,1052,264,1011,222400,19529
4782,3212,1570,900,178400,19530
2345,1930,415,828,194000,19533
816,553,263,734,182900,19534
15,15,0,-,-,19535
234,133,101,823,142000,19536
15,15,0,-,-,19538
1658,1361,297,1110,213400,19539
4380,3772,608,809,218200,19540
1576,1353,223,823,211300,19541
0,0,0,-,-,19542
2073,1711,362,950,252700,19543
27,22,5,-,118300,19544
230,218,12,-,172800,19545
1566,1262,304,1224,223800,19547
102,69,33,761,87700,19549
163,76,87,587,125000,19550
1927,1614,313,853,181600,19551
196,147,49,619,157600,19554
1414,1103,311,793,157800,19555
129,97,32,911,132000,19559
3159,2534,625,1135,138500,19560
1134,700,434,694,147300,19562
54,21,33,-,182500,19564
3345,2599,746,931,172800,19565
1950,1473,477,802,153500,19567
11958,4408,7550,707,68600,19601
6649,2516,4133,647,50800,19602
8158,4010,4148,868,69300,19604
7542,6396,1146,980,145700,19605
12942,10418,2524,930,167200,19606
9542,6082,3460,939,149600,19607
7974,6475,1499,1156,213000,19608
3852,2980,872,838,154800,19609
6320,4575,1745,1156,220200,19610
3926,2112,1814,731,112900,19611
14115,11090,3025,1334,265400,19701
19298,12262,7036,1178,223700,19702
6047,3236,2811,938,201000,19703
723,530,193,1023,187800,19706
5726,5162,564,1613,403400,19707
12015,10483,1532,1220,310400,19709
9,9,0,-,-,19710
18983,12443,6540,1057,288300,19711
12036,7700,4336,978,203700,19713
0,0,0,-,-,19716
0,0,0,-,-,19717
21289,14626,6663,998,188100,19720
368,325,43,1479,330300,19730
94,94,0,-,163400,19731
33,9,24,-,-,19732
91,56,35,1292,-,19733
3749,3436,313,1496,298900,19734
9,0,9,-,-,19735
0,0,0,-,-,19736
6218,1555,4663,825,138100,19801
10282,5504,4778,935,150300,19802
8442,7324,1118,1285,332500,19803
6991,5077,1914,1012,191400,19804
15465,8466,6999,945,172800,19805
5039,2803,2236,961,283500,19806
3058,2227,831,1227,718600,19807
15272,12398,2874,1055,244000,19808
5984,3930,2054,1072,229100,19809
10029,8108,1921,1055,315500,19810
13354,7131,6223,1009,178900,19901
0,0,0,-,-,19902
11699,7829,3870,1019,197600,19904
1170,1052,118,1144,564900,19930
112,102,10,-,162500,19931
3279,2558,721,738,206200,19933
5116,4080,1036,1254,222400,19934
103,86,17,-,(X),19936
3099,2661,438,1122,218500,19938
2422,2210,212,1105,253300,19939
1839,1352,487,816,165300,19940
970,753,217,1042,170800,19941
4515,3655,860,1123,196600,19943
346,285,61,1105,645500,19944
2705,1872,833,1052,238400,19945
1577,1268,309,988,170600,19946
5804,4102,1702,928,210400,19947
2519,2010,509,912,195800,19950
712,624,88,1000,293300,19951
3956,2867,1089,793,201200,19952
1450,1190,260,853,208000,19953
576,467,109,615,207400,19954
28,12,16,1000,187500,19955
5794,4285,1509,867,172300,19956
10085,8434,1651,1282,313600,19958
2464,1967,497,806,184200,19960
3695,2971,724,996,193800,19962
7463,5222,2241,866,198000,19963
442,340,102,744,218700,19964
10727,8390,2337,837,178800,19966
301,226,75,1258,263100,19967
3850,2932,918,1069,261500,19968
3332,2532,800,1272,327900,19970
6064,4865,1199,1083,372000,19971
8933,6359,2574,905,176000,19973
3769,2866,903,925,309700,19975
8182,6277,1905,966,218300,19977
205,164,41,963,196200,19979
17917,6254,11663,1567,552300,20001
24343,10350,13993,1300,495600,20002
11912,5725,6187,1747,657800,20003
1135,524,611,2426,492000,20004
8351,1798,6553,1727,500400,20005
748,55,693,1612,249100,20006
11985,6407,5578,1796,868500,20007
15495,5887,9608,1802,751500,20008
26682,9286,17396,1675,564100,20009
12826,4178,8648,1284,507400,20010
24371,13292,11079,1089,410100,20011
5765,3562,2203,1214,577700,20012
6445,4471,1974,1724,913400,20015
14011,9188,4823,1919,850000,20016
7518,4066,3452,1263,381900,20017
7666,4363,3303,849,380400,20018
22620,7850,14770,890,224200,20019
21084,5949,15135,979,254200,20020
7043,2942,4101,1381,334300,20024
14235,2850,11385,951,218700,20032
3828,1398,2430,1781,391900,20036
7088,2327,4761,1992,626100,20037
0,0,0,-,-,20045
0,0,0,-,-,20052
0,0,0,-,-,20053
0,0,0,-,-,20057
0,0,0,-,-,20064
4673,4187,486,2365,487700,20105
1977,1698,279,1268,359900,20106
12649,5705,6944,1424,234600,20109
14103,9381,4722,1331,284600,20110
9858,7160,2698,1415,294900,20111
8119,7562,557,2208,418500,20112
2397,1820,577,1080,387800,20115
1140,771,369,1051,540500,20117
2,0,2,-,-,20118
1492,1191,301,1199,351800,20119
13852,10606,3246,1705,440500,20120
9997,6166,3831,1674,354100,20121
4863,4451,412,2387,646300,20124
203,203,0,-,823100,20129
72,72,0,-,433300,20130
5303,4327,976,1334,467400,20132
1187,1023,164,1025,324600,20135
8910,7607,1303,2253,393500,20136
402,353,49,1488,459100,20137
103,55,48,-,341700,20139
2060,1757,303,1778,413500,20141
405,364,41,-,665800,20143
461,392,69,(X),817200,20144
20576,14527,6049,1714,457400,20147
11999,9675,2324,1930,552800,20148
6857,5572,1285,1563,469800,20151
8701,7473,1228,2099,508500,20152
10753,9151,1602,2008,422500,20155
1438,1303,135,1208,520000,20158
12141,8848,3293,1630,323000,20164
11387,9111,2276,1848,459100,20165
3495,2052,1443,1743,347100,20166
7207,6530,677,2394,484300,20169
13342,8910,4432,1786,436200,20170
16455,10180,6275,1806,570100,20171
10670,8129,2541,1391,454300,20175
16100,12009,4091,1482,454900,20176
2270,2014,256,1872,433600,20180
2494,2314,180,1922,416200,20181
245,121,124,-,652000,20184
5542,3887,1655,1162,350500,20186
5408,4847,561,1485,395100,20187
8522,4027,4495,1643,430100,20190
11528,7777,3751,1519,458100,20191
5680,3997,1683,1822,613700,20194
618,582,36,-,652900,20197
967,683,284,771,516000,20198
0,0,0,-,-,20202
0,0,0,-,-,20204
0,0,0,-,-,20228
0,0,0,-,-,20230
0,0,0,-,-,20240
0,0,0,-,-,20245
0,0,0,-,-,20260
0,0,0,-,-,20307
322,28,294,1632,-,20317
0,0,0,-,-,20319
0,0,0,-,-,20373
0,0,0,-,-,20390
0,0,0,-,-,20405
0,0,0,-,-,20418
0,0,0,-,-,20427
0,0,0,-,-,20506
0,0,0,-,-,20510
0,0,0,-,-,20520
0,0,0,-,-,20535
0,0,0,-,-,20540
0,0,0,-,-,20551
0,0,0,-,-,20553
0,0,0,-,-,20560
0,0,0,-,-,20565
0,0,0,-,-,20566
0,0,0,-,-,20593
8498,6693,1805,1725,272700,20601
9738,6107,3631,1326,230100,20602
10731,8125,2606,1796,289500,20603
193,143,50,(X),212500,20606
3464,3276,188,1157,351400,20607
284,241,43,1036,319000,20608
443,345,98,953,286000,20609
439,398,41,866,335200,20611
217,191,26,-,299100,20612
4753,4189,564,1522,329700,20613
165,165,0,-,359000,20615
1975,1740,235,1234,249800,20616
333,308,25,-,359200,20617
250,237,13,-,249100,20618
4298,2803,1495,1564,290800,20619
503,429,74,1589,270200,20620
411,350,61,1575,266700,20621
1580,1373,207,1023,347400,20622
855,777,78,2645,296700,20623
476,415,61,1388,281100,20624
269,230,39,1163,286100,20625
147,108,39,-,433300,20626
100,88,12,-,(X),20628
111,82,29,-,540800,20629
125,125,0,-,352300,20630
118,106,12,-,238000,20632
2636,1634,1002,1278,260500,20634
3483,3080,403,1288,320700,20636
1749,1570,179,921,380900,20637
4604,4253,351,1672,414900,20639
3862,3000,862,1280,237200,20640
362,304,58,1954,323000,20645
6613,5341,1272,1163,335300,20646
5004,3841,1163,847,366300,20650
8960,4843,4117,1228,256100,20653
6911,5764,1147,1608,241200,20657
368,275,93,1259,251900,20658
7804,6845,959,1435,297100,20659
25,0,25,-,-,20660
1070,997,73,1061,299000,20662
1151,885,266,1454,249800,20664
212,136,76,(X),287100,20667
393,17,376,1811,-,20670
343,280,63,1574,442900,20674
602,522,80,2484,296400,20675
1389,1090,299,1533,366700,20676
772,738,34,-,389000,20677
4335,3131,1204,1061,321500,20678
481,334,147,1311,341500,20680
424,301,123,1065,296500,20684
2159,1923,236,1537,332800,20685
71,71,0,-,-,20686
184,128,56,-,396300,20687
944,428,516,1951,426300,20688
538,532,6,-,354400,20689
255,237,18,-,436200,20690
584,485,99,-,382000,20692
470,383,87,(X),348000,20693
2220,1982,238,1482,310200,20695
0,0,0,-,-,20701
8790,5585,3205,1397,265800,20705
12194,7906,4288,1386,251200,20706
12024,7123,4901,1393,272900,20707
9784,3647,6137,1313,297300,20708
3686,874,2812,1129,187500,20710
2382,2004,378,976,70000,20711
3618,901,2717,1072,263300,20712
1850,1107,743,1583,268700,20714
8724,7963,761,2120,289200,20715
8224,5904,2320,1684,267000,20716
7193,6665,528,2288,360000,20720
9359,8225,1134,2008,361200,20721
1778,1269,509,1072,195300,20722
10952,7390,3562,1659,367300,20723
6587,4109,2478,1732,280100,20724
3357,2549,808,1645,321400,20732
1051,890,161,1810,316100,20733
12463,11008,1455,1786,262900,20735
3121,2876,245,1750,435100,20736
5891,2859,3032,1130,219800,20737
9132,4302,4830,1420,256200,20740
0,0,0,-,-,20742
14123,8816,5307,1179,189700,20743
18552,14524,4028,1421,274000,20744
10684,4452,6232,1167,207100,20745
10998,4623,6375,1239,198300,20746
14675,7922,6753,1162,198200,20747
14646,8137,6509,1202,224900,20748
925,829,96,1207,364000,20751
2333,2139,194,2592,441700,20754
2674,43,2631,2004,222500,20755
215,168,47,1221,358100,20758
1268,1179,89,"3,500+",619000,20759
897,0,897,2233,-,20762
804,311,493,1507,309000,20763
1705,1380,325,1216,288100,20764
250,155,95,(X),373200,20765
2126,1975,151,1167,385200,20769
10183,4460,5723,1400,172400,20770
15882,13088,2794,1743,277400,20772
16488,12922,3566,1723,275600,20774
1214,1112,102,1397,505700,20776
1160,1134,26,-,638000,20777
701,647,54,-,471400,20778
516,497,19,-,518900,20779
3810,2187,1623,1141,250100,20781
11447,4802,6645,1316,259500,20782
13301,5821,7480,1226,225500,20783
9840,5922,3918,1263,213100,20784
13629,6832,6797,1245,211600,20785
3307,2500,807,1389,290000,20794
101,94,7,3125,827400,20812
12657,7031,5626,1857,669600,20814
13107,8411,4696,1945,936800,20815
6210,5098,1112,2095,902100,20816
12985,10750,2235,2016,841100,20817
754,704,50,2417,843800,20818
8662,7681,981,1507,467700,20832
2547,2322,225,2431,560600,20833
1917,1728,189,1559,484600,20837
91,86,5,-,607100,20838
32,15,17,-,-,20839
2956,2705,251,2629,585000,20841
630,550,80,876,527100,20842
18413,11208,7205,1868,566100,20850
4969,2845,2124,1665,340900,20851
20076,9167,10909,1807,485100,20852
9848,8336,1512,1216,438400,20853
16808,15298,1510,2773,895800,20854
4925,4209,716,1906,462800,20855
842,561,281,1609,679400,20860
581,581,0,-,676600,20861
106,84,22,-,723700,20862
4569,3570,999,1762,306700,20866
290,260,30,-,685300,20868
5242,4476,766,2260,442100,20871
4225,3692,533,1549,372700,20872
21905,14570,7335,1592,292000,20874
8574,5830,2744,1693,344600,20876
12298,5378,6920,1420,333300,20877
22765,16084,6681,1714,536500,20878
8264,5724,2540,1508,289300,20879
225,206,19,1775,471400,20880
4443,4210,233,1750,560900,20882
11929,8381,3548,1435,271900,20886
7056,5662,1394,1619,572500,20895
310,293,17,-,729000,20896
127,0,127,801,-,20899
12441,8600,3841,1403,400500,20901
16627,10492,6135,1586,358000,20902
7202,2476,4726,1385,336800,20903
20584,11184,9400,1517,387000,20904
5824,5272,552,1777,467800,20905
24849,15854,8995,1588,300700,20906
19429,6649,12780,1604,517900,20910
9513,4087,5426,1165,443400,20912
9182,5964,3218,967,216700,21001
614,0,614,1725,-,21005
11106,9195,1911,1300,246400,21009
73,0,73,1731,-,21010
7505,6378,1127,1667,396900,21012
1716,1693,23,-,427300,21013
13948,10985,2963,1140,299800,21014
9808,8277,1531,1535,322000,21015
2805,1936,869,1341,200800,21017
1231,1039,192,1338,368700,21028
3519,3219,300,2654,661400,21029
10174,4833,5341,1126,383800,21030
0,0,0,-,-,21031
3291,3010,281,980,398600,21032
1243,1077,166,878,252000,21034
2779,2661,118,3052,619400,21035
773,663,110,(X),726500,21036
7708,6605,1103,2018,388500,21037
8726,5995,2731,1030,162900,21040
13358,11840,1518,1539,565800,21042
16148,10887,5261,1545,459900,21043
17303,9969,7334,1628,384000,21044
14847,10694,4153,1421,340600,21045
6355,4402,1953,1622,363300,21046
4089,3718,371,1097,380500,21047
3797,3566,231,931,352000,21048
6358,5638,720,1326,339000,21050
100,100,0,-,351300,21051
104,88,16,1400,263200,21052
1141,1074,67,1344,369900,21053
3842,3365,477,1708,366800,21054
76,76,0,-,"2,000,000+",21056
1493,1320,173,2069,443200,21057
12364,8936,3428,1127,244000,21060
21264,11206,10058,1198,234400,21061
225,225,0,-,356100,21071
5524,4694,830,964,278000,21074
10413,7432,2981,1605,319300,21075
6059,4308,1751,1900,361500,21076
174,174,0,-,281900,21077
7595,5343,2252,1011,285200,21078
186,164,22,-,383300,21082
2559,2461,98,1154,378600,21084
6317,5212,1105,1160,253500,21085
1877,1831,46,1229,385700,21087
3654,3084,570,1280,298100,21090
15326,12241,3085,1202,349900,21093
3839,3353,486,974,301700,21102
1660,1573,87,-,473400,21104
9,9,0,-,-,21105
6218,5115,1103,1511,394600,21108
1594,1418,176,1130,563300,21111
12656,8310,4346,1724,297100,21113
9784,7570,2214,1718,359400,21114
22608,12222,10386,1335,274500,21117
2540,2322,218,1110,429600,21120
21805,19019,2786,1485,299300,21122
4987,4414,573,1375,348300,21128
103,45,58,1043,(X),21130
2482,2394,88,893,548300,21131
862,789,73,1168,329000,21132
11325,7519,3806,1085,226500,21133
12362,8910,3452,1142,278400,21136
1278,1123,155,2046,470900,21140
11344,8536,2808,1392,340300,21144
9300,8577,723,1453,488400,21146
2218,1647,571,1195,388200,21152
136,131,5,-,1552900,21153
2131,1742,389,1095,338700,21154
1003,807,196,1367,326400,21155
170,162,8,-,308800,21156
13693,9813,3880,967,296900,21157
7449,5917,1532,1302,305200,21158
903,712,191,1038,334200,21160
1894,1717,177,1267,384500,21161
1309,1174,135,1138,353500,21162
2458,2264,194,1399,459800,21163
9173,999,8174,1027,194400,21201
8011,1627,6384,886,213100,21202
7442,3732,3710,1451,431000,21204
5206,1642,3564,832,52600,21205
19587,11853,7734,905,155700,21206
18617,11265,7352,1017,181200,21207
14630,9374,5256,1298,251700,21208
11872,6967,4905,1166,281600,21209
5458,3211,2247,1214,416800,21210
7985,3916,4069,1097,191500,21211
13137,8558,4579,966,275100,21212
11072,5921,5151,1042,100000,21213
8052,5964,2088,892,177100,21214
22314,11099,11215,914,125200,21215
10416,5312,5104,932,93000,21216
14895,4479,10416,811,117400,21217
18738,8829,9909,914,150300,21218
3423,2906,517,981,244700,21219
14886,10088,4798,1075,193800,21220
15989,9234,6755,904,192000,21221
20783,13846,6937,988,146500,21222
8826,3068,5758,885,71000,21223
19534,11389,8145,1170,184100,21224
12016,5598,6418,815,167600,21225
2721,1815,906,952,221200,21226
12304,7641,4663,1059,211200,21227
18568,13143,5425,1241,296200,21228
17832,10087,7745,929,130200,21229
14688,8217,6471,1294,228700,21230
7576,2699,4877,1055,267000,21231
29170,18130,11040,1152,209000,21234
15344,10684,4660,1178,237300,21236
11579,7290,4289,1115,219200,21237
11617,6512,5105,1030,145800,21239
0,0,0,-,-,21240
13791,6862,6929,1200,202200,21244
0,0,0,-,-,21250
0,0,0,-,-,21251
0,0,0,-,-,21252
8056,5111,2945,1171,296500,21286
16040,9992,6048,1575,413200,21401
279,19,260,2194,-,21402
12741,7947,4794,1526,419700,21403
176,176,0,-,870800,21405
7348,6432,916,1832,388500,21409
16599,11145,5454,610,120900,21502
863,651,212,958,209300,21520
582,468,114,528,94500,21521
39,39,0,-,156600,21522
97,90,7,-,79500,21523
229,175,54,856,157400,21524
218,175,43,(X),120400,21529
727,592,135,775,159700,21530
920,679,241,664,164500,21531
5804,3598,2206,676,153700,21532
1493,1102,391,587,160200,21536
207,188,19,685,72900,21538
945,671,274,574,87600,21539
41,27,14,663,31900,21540
632,470,162,592,273700,21541
292,203,89,579,72500,21542
63,63,0,-,117300,21543
795,690,105,650,97600,21545
5746,4015,1731,657,160400,21550
676,556,120,521,126800,21555
693,652,41,778,141200,21557
1036,951,85,(X),183400,21561
1248,955,293,629,88400,21562
10151,6407,3744,1021,300900,21601
224,189,35,1074,319700,21607
130,102,28,750,189300,21610
221,211,10,-,590100,21612
7427,4014,3413,820,185900,21613
3630,3018,612,1073,377900,21617
2337,1835,502,1511,311600,21619
4994,3484,1510,746,245600,21620
272,256,16,975,185000,21622
628,442,186,1176,301300,21623
65,49,16,-,296100,21624
1073,896,177,1065,263400,21625
109,87,22,-,243800,21626
15,15,0,-,37500,21627
285,222,63,1178,(X),21628
3583,2582,1001,1058,207300,21629
984,880,104,1057,219200,21631
2458,1521,937,854,166100,21632
103,74,29,-,400000,21634
926,676,250,947,247600,21635
399,306,93,(X),195600,21636
1829,1537,292,981,380500,21638
1576,1012,564,705,180300,21639
557,505,52,867,205200,21640
30,18,12,975,225000,21641
2007,1518,489,948,174400,21643
41,5,36,-,-,21644
346,290,56,717,337300,21645
101,90,11,-,420000,21647
104,88,16,-,193200,21648
519,360,159,887,161700,21649
44,27,17,-,168100,21650
1021,856,165,1039,210700,21651
97,68,29,1597,575000,21652
32,27,5,-,296900,21653
543,392,151,1165,465600,21654
1849,1475,374,1100,203800,21655
281,214,67,(X),244400,21657
1457,1290,167,1750,359200,21658
590,461,129,1051,197900,21659
1341,910,431,926,212600,21660
1150,871,279,904,248800,21661
266,208,58,1396,396200,21662
1421,1063,358,1068,457400,21663
257,201,56,850,138900,21664
145,128,17,-,410000,21665
4211,3766,445,1400,360900,21666
112,101,11,-,408600,21667
661,514,147,775,231700,21668
90,76,14,-,347100,21669
380,356,24,-,325300,21671
83,77,6,-,(X),21672
1352,908,444,1026,326900,21673
88,80,8,-,(X),21675
193,137,56,1166,286300,21676
192,173,19,1611,289900,21677
725,643,82,1347,244400,21678
191,191,0,-,283200,21679
15230,9356,5874,1169,275100,21701
15157,9214,5943,1307,265800,21702
12399,7836,4563,1481,242700,21703
4955,4222,733,1458,390200,21704
0,0,0,-,-,21705
1788,1417,371,1772,405300,21710
299,227,72,733,168400,21711
3670,2950,720,835,239100,21713
32,32,0,-,350000,21714
1962,1303,659,972,169800,21716
10,10,0,-,-,21717
61,40,21,875,311100,21718
504,390,114,822,181900,21719
1981,1749,232,825,229400,21722
238,200,38,-,567600,21723
1670,1263,407,787,249100,21727
340,321,19,-,219400,21733
325,181,144,725,149700,21734
584,491,93,-,752100,21737
1110,1092,18,-,686300,21738
23232,12631,10601,774,170100,21740
13134,8074,5060,1040,220200,21742
0,0,0,-,-,21746
1522,1063,459,606,151200,21750
2137,1957,180,1343,419700,21754
2104,1907,197,1125,350700,21755
1356,1149,207,1073,298000,21756
1180,854,326,1213,277400,21757
1745,1513,232,1235,248900,21758
85,76,9,-,342900,21762
242,174,68,544,180000,21766
528,167,361,910,157900,21767
3998,3515,483,1194,365400,21769
1857,1790,67,1491,373400,21770
9929,9008,921,1409,395000,21771
1949,1788,161,880,330500,21773
4269,3925,344,1706,346600,21774
1862,1542,320,1000,311200,21776
534,474,60,1625,310400,21777
340,313,27,-,245600,21778
317,280,37,-,359000,21779
551,413,138,1100,218000,21780
0,0,0,-,-,21781
1659,1403,256,1011,218800,21782
3263,2730,533,949,221800,21783
13507,11761,1746,1099,364400,21784
3962,3277,685,1103,268200,21787
4702,3674,1028,951,246800,21788
35,30,5,-,372700,21790
2049,1532,517,949,280400,21791
3588,2892,696,1197,284400,21793
929,846,83,3347,655300,21794
3762,2524,1238,924,211300,21795
2915,2698,217,1652,548200,21797
814,642,172,1320,300800,21798
10671,6338,4333,862,189500,21801
0,0,0,-,-,21802
14688,7848,6840,1065,163900,21804
206,152,54,-,236500,21810
8991,7309,1682,1247,254600,21811
841,767,74,-,257100,21813
278,149,129,-,344200,21814
2131,1340,791,536,117000,21817
416,355,61,811,105600,21821
852,700,152,976,171900,21822
58,54,4,-,(X),21824
1922,1332,590,1116,160900,21826
285,233,52,589,176200,21829
1272,1039,233,977,165500,21830
325,212,113,847,261500,21835
1031,841,190,1100,167300,21837
634,541,93,819,165700,21838
192,114,78,-,287900,21840
345,258,87,923,198300,21841
5257,3798,1459,1038,297600,21842
1318,1160,158,843,165700,21849
1011,806,205,942,164600,21850
2738,1683,1055,740,162300,21851
3616,1867,1749,729,162700,21853
284,246,38,-,225000,21856
375,301,74,845,142600,21861
124,11,113,-,-,21862
1780,1269,511,754,183100,21863
261,220,41,-,150900,21864
233,222,11,-,(X),21865
19,19,0,-,(X),21866
20,20,0,-,-,21867
341,277,64,814,173400,21869
842,673,169,634,149400,21871
234,188,46,1052,223300,21872
864,669,195,969,164600,21874
2358,1602,756,1087,165600,21875
0,0,0,-,-,21890
6729,4936,1793,1050,249800,21901
0,0,0,-,-,21902
2230,1260,970,864,234600,21903
2588,2168,420,796,237200,21904
3703,2776,927,948,253700,21911
333,299,34,-,288900,21912
327,155,172,740,170800,21913
213,156,57,940,229500,21914
1168,933,235,965,248400,21915
0,0,0,-,-,21916
931,814,117,1153,242100,21917
1320,1198,122,950,252600,21918
1334,1187,147,1261,247800,21919
132,124,8,-,208600,21920
15662,10971,4691,1023,236000,21921
58,42,16,-,470000,21930
19229,12906,6323,1558,497000,22003
14697,11908,2789,1941,456100,22015
6024,5204,820,2138,342400,22025
4702,2731,1971,1472,271900,22026
657,625,32,-,795500,22027
19299,11751,7548,1771,496900,22030
11817,5924,5893,1870,506400,22031
9619,8204,1415,2188,544400,22032
15274,9453,5821,1781,455000,22033
0,0,0,-,-,22035
5860,5572,288,3457,772900,22039
10661,4611,6050,1453,358700,22041
11883,7721,4162,1676,447900,22042
9347,5218,4129,1794,569600,22043
5736,2527,3209,1330,542600,22044
6284,4486,1798,1484,663200,22046
2854,298,2556,2527,501800,22060
5804,5530,274,3056,1048200,22066
11098,7673,3425,1812,438000,22079
10624,8860,1764,2804,944400,22101
10028,5605,4423,1822,792600,22102
6740,5743,997,1815,711300,22124
350,248,102,2048,321200,22125
1523,57,1466,1732,164800,22134
8853,5365,3488,1823,396800,22150
5504,4609,895,2035,414400,22151
10258,8257,2001,2011,427500,22152
10243,8515,1728,2186,479400,22153
3198,1548,1650,1021,381300,22172
8535,6346,2189,1917,627700,22180
5282,4070,1212,2038,683300,22181
8973,6910,2063,2024,812500,22182
0,0,0,-,-,22185
21104,12074,9030,1463,261800,22191
19540,14290,5250,1677,303900,22192
23238,17279,5959,1608,275900,22193
17372,6284,11088,1991,619900,22201
12191,3160,9031,1988,618800,22202
11070,3747,7323,2023,545100,22203
21237,8441,12796,1452,443500,22204
6775,5004,1771,1566,723900,22205
10338,4846,5492,1828,419200,22206
11393,9143,2250,1811,854200,22207
6894,2271,4623,1791,602200,22209
93,0,93,1896,-,22211
1354,1004,350,2600,642100,22213
0,0,0,-,-,22214
5218,3430,1788,1507,683800,22301
8456,4196,4260,1680,425400,22302
6736,3081,3655,1637,350500,22303
20988,8596,12392,1504,338700,22304
6196,2344,3852,1455,577500,22305
11598,5106,6492,1372,405400,22306
4417,3451,966,1763,504000,22307
4587,4179,408,2887,640600,22308
11349,7381,3968,1370,375700,22309
11485,8923,2562,1923,419400,22310
7679,1241,6438,1455,478700,22311
11147,5401,5746,1588,422500,22312
16214,7898,8316,1907,626000,22314
10614,7598,3016,2036,443800,22315
10080,3473,6607,1058,317900,22401
10170,8088,2082,1450,268300,22405
7775,5727,2048,1194,332500,22406
19407,14049,5358,1348,243800,22407
9315,6813,2502,1340,255900,22408
1175,817,358,961,191300,22427
160,83,77,-,169900,22432
106,106,0,-,166900,22433
1072,885,187,540,136500,22435
376,287,89,824,167700,22436
346,336,10,-,118600,22437
85,78,7,-,137500,22438
3441,2354,1087,913,220700,22443
147,0,147,1637,-,22448
704,485,219,847,165800,22454
628,507,121,883,133600,22460
610,560,50,-,110200,22469
2219,1933,286,535,248500,22473
227,190,37,778,188200,22476
490,297,193,862,315900,22480
1555,1127,428,661,236600,22482
8232,6120,2112,1056,282500,22485
408,359,49,-,161500,22488
1918,1526,392,989,192700,22503
85,85,0,-,248300,22504
5105,4461,644,1247,252600,22508
6,6,0,-,-,22509
629,518,111,1072,291700,22511
969,761,208,729,201800,22514
2211,1709,502,937,194700,22520
202,125,77,686,"10,000-",22529
10,10,0,-,-,22530
1002,842,160,1182,198500,22534
183,130,53,787,255300,22535
56,56,0,-,153400,22538
1268,1028,240,727,336100,22539
727,621,106,1123,203200,22542
6225,5097,1128,1250,184000,22546
45,15,30,-,-,22548
6859,5884,975,1244,226300,22551
4478,3510,968,1469,287200,22553
16791,12650,4141,1526,319700,22554
8669,6849,1820,1537,303500,22556
2379,1652,727,830,167800,22560
975,894,81,1016,222400,22567
2212,1626,586,770,156900,22572
660,544,116,1078,249000,22576
1078,863,215,857,292700,22578
28,28,0,-,-,22579
1940,1551,389,1011,180400,22580
11127,5128,5999,946,210700,22601
10157,8019,2138,1064,237500,22602
5366,4158,1208,1068,213300,22603
674,603,71,628,244000,22610
3332,2358,974,1000,327700,22611
888,713,175,1225,339500,22620
248,232,16,-,188100,22623
958,771,187,1095,254400,22624
1442,1230,212,1238,212900,22625
274,222,52,968,434200,22627
11866,8708,3158,907,215300,22630
779,686,93,445,227600,22637
202,179,23,-,582100,22639
275,206,69,1029,477100,22640
149,144,5,-,185300,22641
1561,1445,116,995,199800,22642
53,35,18,-,840300,22643
919,764,155,767,193100,22644
1513,1218,295,738,230800,22645
93,93,0,-,497700,22646
342,283,59,550,189700,22650
474,459,15,-,254000,22652
488,440,48,-,270800,22654
7222,5453,1769,1080,214100,22655
996,798,198,1133,261400,22656
4310,2988,1322,941,192100,22657
748,648,100,825,190700,22660
586,362,224,(X),287600,22663
3513,2351,1162,747,213000,22664
11670,7725,3945,1045,227600,22701
367,302,65,-,225000,22709
14,14,0,-,-,22711
2621,1952,669,1224,248000,22712
538,441,97,(X),266800,22713
378,343,35,819,252800,22714
638,475,163,(X),263500,22715
488,380,108,989,487000,22716
276,224,52,-,244600,22718
168,130,38,730,306600,22719
348,342,6,-,383100,22720
116,105,11,-,284200,22722
13,13,0,-,-,22723
781,735,46,1883,329400,22724
215,188,27,1097,197900,22726
1947,1324,623,839,237400,22727
1162,973,189,957,343100,22728
35,35,0,-,(X),22729
22,22,0,-,-,22730
17,0,17,-,-,22731
106,106,0,-,215500,22732
549,442,107,1081,309900,22733
1122,809,313,1107,220300,22734
777,701,76,1363,315700,22735
256,243,13,-,207700,22736
917,707,210,1094,279300,22737
446,261,185,788,398900,22738
578,432,146,1050,339200,22740
29,29,0,-,331000,22741
671,557,114,(X),271300,22742
128,103,25,-,(X),22743
537,360,177,766,368600,22747
111,72,39,-,475000,22749
12716,5777,6939,928,239800,22801
10803,5424,5379,758,184700,22802
3,3,0,-,-,22807
268,208,60,626,212300,22810
177,168,9,-,161300,22811
3102,2098,1004,812,196400,22812
3345,2652,693,674,174200,22815
106,95,11,-,(X),22820
2094,1664,430,671,201700,22821
2521,1936,585,648,205200,22824
4136,3277,859,734,168300,22827
707,550,157,844,154700,22830
366,271,95,727,186400,22831
525,435,90,1130,208600,22832
419,373,46,532,224300,22834
4629,3190,1439,722,191100,22835
1721,1388,333,947,237400,22840
1195,949,246,789,240700,22841
2042,1429,613,772,166500,22842
894,705,189,701,202400,22843
1960,1279,681,749,200900,22844
0,0,0,-,-,22845
740,576,164,1013,310600,22846
384,340,44,744,228400,22847
1871,1456,415,752,152300,22849
313,242,71,950,205400,22850
2329,1524,805,670,162000,22851
1795,1114,681,734,158900,22853
13997,8123,5874,1086,313900,22901
9684,4929,4755,1041,260700,22902
14316,6344,7972,1049,346200,22903
39,0,39,1080,-,22904
7014,4480,2534,1203,306100,22911
1700,1302,398,576,251000,22920
811,623,188,721,177200,22922
1879,1382,497,1288,291400,22923
174,159,15,-,240600,22931
2990,2237,753,1114,313000,22932
342,208,134,1393,114200,22935
1735,1533,202,950,367600,22936
645,475,170,933,146900,22937
720,442,278,913,225000,22938
1940,1214,726,1073,247700,22939
411,269,142,1212,282600,22940
3362,2545,817,875,238200,22942
103,76,27,-,246000,22943
97,78,19,-,(X),22946
1843,1364,479,989,535500,22947
60,60,0,-,(X),22948
517,341,176,(X),151800,22949
886,673,213,903,199800,22952
1010,774,236,(X),459700,22958
497,424,73,944,282600,22959
3864,2372,1492,756,179500,22960
6017,4901,1116,1386,216000,22963
67,46,21,-,93000,22964
729,580,149,1148,245300,22967
3562,3066,496,643,237300,22968
453,400,53,786,218100,22969
631,444,187,(X),216200,22971
132,98,34,-,(X),22972
2641,1826,815,930,214500,22973
1984,1659,325,1114,299200,22974
171,50,121,681,(X),22976
13131,8668,4463,808,169300,22980
0,0,0,-,-,22989
3762,3082,680,683,179700,23002
329,296,33,-,89500,23004
5914,3850,2064,967,235100,23005
2387,2073,314,1263,207900,23009
444,389,55,-,268900,23011
1547,1306,241,857,252800,23015
118,118,0,-,547900,23021
539,442,97,1316,169800,23022
161,141,20,-,(X),23023
3246,2799,447,1026,193900,23024
65,65,0,-,(X),23025
459,391,68,-,153600,23027
1988,1635,353,802,155400,23030
116,96,20,-,218000,23032
558,435,123,1258,284900,23035
729,577,152,1005,178800,23038
490,420,70,750,277100,23039
1697,1286,411,781,129700,23040
740,582,158,903,378800,23043
40,40,0,-,(X),23045
662,519,143,944,271500,23047
291,283,8,-,266000,23050
314,229,85,973,304900,23055
136,93,43,-,166300,23056
12013,8906,3107,1398,362200,23059
12832,10054,2778,1140,249000,23060
7997,6657,1340,883,230100,23061
1011,586,425,817,218300,23062
1720,1393,327,863,207900,23063
61,32,29,-,(X),23064
824,698,126,1028,186600,23065
234,186,48,-,224500,23066
170,155,15,-,192600,23068
1069,896,173,988,249400,23069
224,224,0,-,384000,23070
680,621,59,1070,333200,23071
4604,3587,1017,892,216000,23072
3994,2271,1723,946,142900,23075
320,260,60,-,243600,23076
174,141,33,735,230700,23079
738,577,161,811,140900,23083
694,618,76,1106,184000,23084
195,164,31,-,110700,23085
1162,1103,59,1089,188000,23086
1944,1621,323,1090,259300,23089
136,116,20,-,124400,23091
201,181,20,-,223700,23092
4834,3622,1212,852,167600,23093
1075,1000,75,1183,287800,23102
1947,1835,112,1183,497200,23103
320,153,167,1157,174600,23106
109,82,27,-,214100,23108
1132,855,277,688,220400,23109
260,178,82,1111,176600,23110
14112,11274,2838,1080,228200,23111
17817,13733,4084,1224,227800,23112
9284,7693,1591,1213,398600,23113
6640,5415,1225,1327,274200,23114
91,65,26,-,102900,23115
9742,8635,1107,1226,286400,23116
3403,2822,581,1032,239000,23117
168,154,14,-,380000,23119
2190,2069,121,877,357200,23120
635,527,108,728,113900,23123
1323,1116,207,809,242300,23124
37,28,9,-,-,23125
97,61,36,886,(X),23126
440,362,78,867,284700,23128
150,102,48,-,475000,23129
45,45,0,-,295000,23130
154,154,0,-,237800,23138
9062,7819,1243,975,249800,23139
2301,2008,293,777,222500,23140
2396,2073,323,1103,235100,23141
1192,1064,128,883,328500,23146
866,619,247,862,182100,23148
1100,778,322,806,204200,23149
4741,3569,1172,947,159700,23150
450,374,76,868,210000,23153
666,544,122,1011,163600,23156
0,0,0,-,-,23160
83,75,8,-,141300,23161
58,30,28,-,-,23163
2248,1867,381,1614,289000,23168
520,422,98,763,169100,23169
0,0,0,-,-,23173
867,630,237,548,242900,23175
214,214,0,-,162500,23176
182,133,49,950,149400,23177
151,147,4,-,158100,23180
2331,1671,660,870,208300,23181
17314,12012,5302,1136,319000,23185
0,0,0,-,-,23187
16538,11909,4629,1192,304800,23188
2598,2292,306,966,263400,23192
1764,194,1570,838,212500,23219
13236,4128,9108,975,238200,23220
7561,3593,3968,1009,333600,23221
9432,5161,4271,890,122300,23222
20464,8970,11494,858,147000,23223
13122,4846,8276,838,110700,23224
17976,7375,10601,873,195200,23225
6904,4960,1944,1209,294700,23226
11707,5906,5801,792,225500,23227
14924,7373,7551,989,166300,23228
12706,8827,3879,949,275700,23229
2601,1520,1081,948,179300,23230
13930,9249,4681,936,173600,23231
11608,7753,3855,1270,312800,23233
15393,8973,6420,944,154700,23234
12637,9369,3268,1194,214700,23235
9779,8357,1422,1194,202400,23236
7769,5809,1960,947,162600,23237
10898,6735,4163,1099,268100,23238
0,0,0,-,-,23250
7584,2463,5121,1054,190200,23294
488,349,139,728,165100,23301
95,31,64,-,-,23302
502,383,119,-,183000,23303
82,82,0,-,-,23304
360,269,91,1036,209400,23306
252,185,67,-,(X),23307
769,644,125,875,87000,23308
1978,1419,559,685,162300,23310
58,17,41,-,-,23313
2846,2062,784,1205,262800,23314
613,536,77,842,240600,23315
178,103,75,916,182200,23316
21742,13052,8690,1300,241800,23320
12457,9277,3180,1150,253000,23321
19525,16802,2723,1588,322100,23322
12470,9937,2533,1096,233400,23323
8675,4091,4584,911,160100,23324
6662,4228,2434,1103,193100,23325
1402,1095,307,889,251700,23336
242,170,72,-,170300,23337
241,159,82,911,(X),23347
1508,923,585,685,118500,23350
83,48,35,135,380000,23354
488,325,163,1314,195800,23356
278,200,78,-,213900,23357
16,16,0,-,-,23358
352,187,165,731,124700,23359
73,73,0,-,-,23389
193,193,0,-,67900,23395
28,28,0,-,-,23398
105,88,17,695,(X),23401
449,423,26,(X),228500,23405
204,109,95,-,76800,23407
14,6,8,-,-,23408
40,16,24,-,(X),23409
1101,858,243,622,142700,23410
386,260,126,687,201100,23413
40,40,0,-,139600,23414
648,432,216,749,123000,23415
169,91,78,-,(X),23416
1692,1156,536,694,212300,23417
344,205,139,590,166800,23418
1078,638,440,750,118900,23420
1757,1162,595,687,109100,23421
103,85,18,-,269200,23422
146,127,19,963,145300,23423
77,48,29,-,78000,23426
109,86,23,650,106900,23427
6887,5457,1430,885,259400,23430
482,404,78,1025,314600,23432
487,430,57,1188,314500,23433
17410,10822,6588,950,206000,23434
9888,7902,1986,1258,271100,23435
400,378,22,-,341700,23436
1594,1338,256,805,199000,23437
716,595,121,959,238900,23438
212,207,5,-,90600,23440
58,17,41,832,-,23441
588,434,154,567,96200,23442
19798,9740,10058,1183,415400,23451
22468,13891,8577,1180,237500,23452
12081,8118,3963,1198,230100,23453
22421,13944,8477,1228,282900,23454
19527,11833,7694,1276,272000,23455
16900,14699,2201,1756,316400,23456
1589,1321,268,984,347700,23457
255,0,255,1616,-,23459
0,0,0,-,-,23460
0,0,0,-,-,23461
24340,12984,11356,1253,201900,23462
26863,19071,7792,1309,245300,23464
157,124,33,814,112000,23480
73,43,30,-,160500,23486
2230,1710,520,823,177300,23487
75,61,14,-,-,23488
7667,4053,3614,1049,193200,23502
13566,5468,8098,961,187300,23503
7505,2450,5055,733,170900,23504
12170,4237,7933,933,216500,23505
3497,1312,2185,1179,395900,23507
6039,2938,3101,1092,309400,23508
5014,2933,2081,1033,167500,23509
3214,697,2517,1120,386600,23510
122,4,118,1609,-,23511
11585,5758,5827,970,157300,23513
2348,532,1816,956,213900,23517
11756,6351,5405,1022,205000,23518
2562,1120,1442,781,159100,23523
0,0,0,-,-,23551
10595,5663,4932,884,191900,23601
15415,9021,6394,1085,207700,23602
1363,548,815,1133,197700,23603
714,16,698,1459,(X),23604
5611,2599,3012,911,145200,23605
11267,5538,5729,990,244900,23606
8640,3222,5418,766,119100,23607
16779,8511,8268,1011,195400,23608
180,0,180,2395,-,23651
5495,3400,2095,980,159100,23661
4617,3786,831,1154,308100,23662
5023,2787,2236,1038,145400,23663
3948,2618,1330,1086,209900,23664
1283,11,1272,1539,-,23665
20809,11618,9191,1004,197400,23666
15969,9532,6437,982,195300,23669
1331,760,571,751,243300,23690
36,12,24,1647,-,23691
7332,5936,1396,1298,312000,23692
8503,6324,2179,1410,342400,23693
1396,1249,147,1796,342700,23696
9176,6178,2998,967,165000,23701
4471,1973,2498,922,134300,23702
9814,6378,3436,1095,204300,23703
7426,2924,4502,877,155300,23704
5870,2676,3194,882,170400,23707
0,0,0,-,-,23708
0,0,0,-,-,23709
1160,29,1131,1468,226400,23801
14567,7605,6962,844,136900,23803
7536,4461,3075,942,150100,23805
0,0,0,-,-,23806
696,601,95,663,108400,23821
2752,1606,1146,789,118100,23824
503,283,220,646,102300,23827
126,83,43,650,177100,23828
459,371,88,437,155200,23829
401,349,52,(X),191900,23830
13157,9042,4115,1134,214000,23831
11119,9692,1427,1203,208000,23832
937,768,169,802,190700,23833
9803,6439,3364,927,175500,23834
4656,3581,1075,1336,222900,23836
1864,1131,733,736,196600,23837
5500,5150,350,1099,315400,23838
271,235,36,768,167300,23839
828,708,120,529,134400,23840
1353,1044,309,772,143500,23841
2431,2100,331,1093,207500,23842
298,228,70,(X),151100,23843
293,182,111,838,81400,23844
178,170,8,-,195000,23845
349,332,17,-,160100,23846
5277,3015,2262,692,101700,23847
339,286,53,-,116200,23850
5349,3121,2228,776,165700,23851
274,220,54,-,93800,23856
268,239,29,-,112800,23857
10613,6085,4528,853,135900,23860
812,642,170,790,192600,23866
771,613,158,688,124300,23867
1998,1201,797,500,89300,23868
883,723,160,790,138500,23872
442,313,129,928,112500,23874
3814,2691,1123,1062,208800,23875
187,163,24,-,204700,23876
400,290,110,604,171200,23878
268,210,58,527,77100,23879
782,495,287,714,173100,23881
842,681,161,634,130500,23882
1014,860,154,843,177600,23883
28,28,0,-,168800,23884
1035,857,178,979,199200,23885
244,193,51,-,154600,23887
927,505,422,814,150700,23888
213,144,69,707,100000,23889
1270,808,462,859,142100,23890
2,2,0,-,-,23891
140,105,35,-,107600,23893
177,148,29,-,185800,23894
260,196,64,(X),165000,23897
762,712,50,-,219500,23898
124,96,28,810,151900,23899
5723,3173,2550,801,149600,23901
0,0,0,-,-,23909
249,214,35,-,151800,23915
1258,968,290,399,121800,23917
1101,991,110,886,191500,23919
1496,1102,394,833,105800,23920
884,623,261,615,123800,23921
992,664,328,775,140400,23922
974,782,192,589,119600,23923
2309,1671,638,516,108200,23924
1847,1529,318,620,184400,23927
2144,1652,492,776,141200,23930
221,206,15,-,93300,23934
2279,1810,469,632,141800,23936
763,478,285,602,93000,23937
108,66,42,-,64400,23938
484,475,9,-,114700,23942
37,37,0,-,-,23943
1571,1070,501,712,102000,23944
1497,946,551,546,118500,23947
1240,935,305,774,98300,23950
71,71,0,-,86900,23952
636,551,85,711,108300,23954
1240,943,297,737,138800,23958
476,350,126,437,98900,23959
666,586,80,925,144300,23960
261,200,61,-,89000,23962
72,63,9,-,67100,23963
408,310,98,561,87600,23964
1051,752,299,641,160900,23966
460,321,139,567,88700,23967
313,266,47,732,118900,23968
3272,2037,1235,753,122400,23970
1674,1213,461,649,108000,23974
61,18,43,-,-,23976
198,36,162,961,1000000,24011
12631,7277,5354,701,140300,24012
2972,1559,1413,715,82400,24013
7984,5271,2713,787,170400,24014
7241,4206,3035,729,169700,24015
3907,1141,2766,708,128700,24016
9234,5057,4177,737,112100,24017
16141,11133,5008,895,219800,24018
10849,8729,2120,930,176000,24019
9,0,9,-,-,24020
1308,1070,238,494,131500,24053
2627,2041,586,576,82700,24054
5391,3931,1460,558,88800,24055
121,106,15,-,138500,24058
332,249,83,-,225300,24059
17919,6861,11058,905,278500,24060
1657,1376,281,731,173600,24064
2728,2242,486,902,188900,24065
1981,1676,305,840,154800,24066
984,778,206,736,141500,24067
779,651,128,805,108300,24069
568,473,95,699,230300,24070
532,401,131,496,187800,24072
12871,8738,4133,775,180300,24073
461,308,153,595,215900,24076
447,357,90,714,157000,24077
3236,2125,1111,628,111400,24078
934,710,224,619,125000,24079
82,62,20,-,153900,24082
1029,855,174,902,259500,24083
4593,3325,1268,631,129500,24084
816,742,74,-,123300,24085
86,52,34,-,78400,24086
1687,1392,295,660,98800,24087
1565,1157,408,646,125100,24088
1139,858,281,644,85300,24089
1783,1574,209,946,255500,24090
2758,2169,589,544,165200,24091
1223,943,280,620,128100,24092
78,54,24,700,179700,24093
1871,1590,281,906,164200,24095
2623,2255,368,779,233600,24101
745,670,75,402,132400,24102
1547,1185,362,935,240800,24104
190,122,68,-,(X),24105
13580,8907,4673,583,95400,24112
742,538,204,738,111600,24120
4388,3805,583,860,265900,24121
761,747,14,-,135600,24122
1857,1396,461,682,87700,24124
1796,1409,387,529,151800,24127
782,683,99,577,146800,24128
11,11,0,-,-,24130
26,0,26,-,-,24131
256,113,143,399,109000,24132
1209,1002,207,542,88400,24133
2228,1661,567,574,103500,24134
1496,1125,371,590,120700,24136
1211,1002,209,543,176300,24137
629,509,120,-,162300,24138
264,264,0,-,128600,24139
8560,4814,3746,713,158700,24141
0,0,0,-,-,24142
543,415,128,400,115200,24147
3401,2739,662,579,101100,24148
1389,1167,222,598,210200,24149
315,293,22,-,88200,24150
8230,5535,2695,642,137900,24151
14726,10724,4002,834,177400,24153
214,199,15,-,138200,24161
835,575,260,661,158200,24162
665,528,137,504,118900,24165
188,156,32,-,97100,24167
73,41,32,-,220800,24168
3531,2579,952,511,100200,24171
1113,1000,113,677,118500,24174
3545,3101,444,789,229300,24175
698,614,84,714,333300,24176
7420,5321,2099,685,165300,24179
1910,1668,242,679,207500,24184
327,266,61,-,130300,24185
7410,4001,3409,651,115400,24201
4933,4244,689,659,123400,24202
7386,4912,2474,592,136000,24210
4352,3540,812,623,193300,24211
1092,712,380,567,55100,24216
161,134,27,-,58300,24217
4022,2736,1286,632,106200,24219
191,174,17,-,80000,24220
283,246,37,(X),76200,24221
2474,1876,598,533,88000,24224
728,658,70,480,65400,24225
608,466,142,653,70800,24226
2867,2243,624,537,74500,24228
3522,2421,1101,549,76200,24230
1378,937,441,617,111900,24236
444,341,103,683,38500,24237
107,107,0,-,67200,24239
862,687,175,463,134600,24243
2446,1829,617,344,77300,24244
426,259,167,388,82600,24245
242,159,83,-,82800,24246
1081,830,251,434,75200,24248
556,508,48,(X),77500,24250
3490,2930,560,530,98600,24251
1376,934,442,402,79600,24256
810,628,182,534,88500,24258
2308,1862,446,551,83800,24260
2506,1747,759,526,83200,24263
293,225,68,(X),45400,24265
3593,2690,903,516,121100,24266
126,118,8,-,47100,24269
302,222,80,-,82800,24270
1055,699,356,497,93900,24271
219,150,69,(X),68800,24272
2861,1713,1148,558,83200,24273
2231,1512,719,475,70700,24277
1809,1465,344,622,86900,24279
298,296,2,-,154400,24280
1029,790,239,577,73500,24281
265,178,87,470,29700,24282
829,574,255,411,94400,24283
857,593,264,561,110000,24290
231,131,100,-,92400,24292
3877,2809,1068,658,111300,24293
5925,3895,2030,557,111100,24301
780,606,174,640,88400,24311
927,675,252,775,107600,24312
330,234,96,480,50700,24313
649,483,166,814,107400,24314
1283,980,303,502,98000,24315
8,8,0,-,-,24316
1589,1246,343,591,99700,24317
404,384,20,-,117200,24318
2705,1938,767,616,98100,24319
72,41,31,-,91300,24322
285,212,73,986,95000,24323
827,648,179,495,170700,24324
366,289,77,(X),114500,24325
510,457,53,-,102500,24326
812,629,183,508,114900,24328
1396,1069,327,480,84800,24330
7398,5193,2205,565,95700,24333
2169,1676,493,674,102700,24340
3871,2845,1026,512,114300,24343
662,555,107,666,157400,24347
1819,1285,534,444,98300,24348
491,433,58,556,80700,24350
281,179,102,461,59500,24351
384,325,59,-,113200,24352
6199,4014,2185,572,90100,24354
2242,1698,544,659,108700,24360
1936,1625,311,683,107500,24361
574,503,71,392,100500,24363
250,222,28,-,113700,24366
2009,1579,430,557,119400,24368
2562,1969,593,489,78800,24370
278,213,65,541,108600,24374
590,392,198,449,93300,24375
102,82,20,-,76300,24377
570,493,77,578,89300,24378
998,796,202,419,132700,24380
1766,1516,250,541,114000,24381
6194,3978,2216,602,148300,24382
15010,9663,5347,772,182100,24401
57,57,0,-,-,24411
40,24,16,-,-,24412
59,48,11,-,257100,24413
34,34,0,-,-,24415
3474,2190,1284,700,116300,24416
1649,1306,343,642,229900,24421
2665,1913,752,515,103600,24422
6020,4768,1252,620,96000,24426
680,435,245,529,116400,24430
914,861,53,-,138600,24431
146,146,0,-,143800,24432
36,36,0,-,(X),24433
821,679,142,633,276300,24435
456,402,54,-,280400,24437
511,379,132,555,113400,24439
1112,873,239,1026,177400,24440
2586,1873,713,717,168800,24441
58,46,12,-,(X),24442
1160,870,290,483,96600,24445
148,124,24,807,65900,24448
5680,3771,1909,759,238500,24450
54,46,8,-,112500,24457
212,205,7,-,151400,24458
265,265,0,-,213300,24459
655,528,127,398,170600,24460
118,100,18,-,(X),24464
674,516,158,484,210400,24465
729,685,44,506,224800,24467
519,422,97,684,201200,24471
853,635,218,610,225000,24472
328,305,23,-,188000,24473
172,122,50,560,71000,24474
125,125,0,-,216900,24476
4125,3058,1067,832,196800,24477
484,409,75,1010,212800,24479
1750,1481,269,822,170200,24482
259,218,41,-,92300,24483
481,288,193,873,178500,24484
62,62,0,-,125000,24485
1490,1083,407,1109,182800,24486
107,82,25,-,(X),24487
10304,4904,5400,697,109100,24501
16372,8828,7544,844,155100,24502
7749,5634,2115,819,245300,24503
3856,2148,1708,638,109900,24504
2209,1507,702,721,130200,24517
906,721,185,521,104500,24520
4162,3292,870,656,162400,24521
3860,3018,842,686,153400,24522
7955,5640,2315,677,160400,24523
475,410,65,484,96700,24526
1207,904,303,570,117000,24527
1316,1008,308,581,104100,24528
666,475,191,761,140200,24529
559,372,187,578,102200,24530
3526,2677,849,582,108000,24531
675,510,165,497,86800,24534
71,71,0,-,215900,24536
1805,1611,194,536,149900,24538
78,39,39,568,(X),24539
13465,8476,4989,624,98200,24540
12330,6995,5335,606,106800,24541
1758,1320,438,690,99400,24549
2973,2543,430,703,166000,24550
8514,7362,1152,748,240100,24551
762,546,216,691,90300,24553
1658,1181,477,612,136000,24554
1011,675,336,643,128300,24555
1271,1028,243,815,230700,24556
3412,2614,798,498,90300,24557
2769,2114,655,763,110300,24558
133,118,15,-,153800,24562
2474,1880,594,588,96400,24563
430,316,114,479,95000,24565
461,389,72,493,78700,24566
412,273,139,588,104400,24569
11,0,11,-,-,24570
822,638,184,629,145500,24571
6316,4609,1707,713,141400,24572
1666,1379,287,811,165500,24574
2028,1562,466,528,81600,24577
418,331,87,830,191500,24578
701,578,123,883,117200,24579
219,152,67,-,96300,24580
0,0,0,-,-,24581
2217,1799,418,825,120200,24586
3261,2825,436,639,144100,24588
857,714,143,509,128800,24589
3268,2464,804,773,190200,24590
5642,3729,1913,549,120500,24592
660,517,143,688,150200,24593
603,423,180,685,116600,24594
37,11,26,-,-,24595
486,384,102,425,103200,24597
701,492,209,626,118800,24598
295,203,92,877,119600,24599
33,33,0,-,(X),24601
445,416,29,-,72100,24602
404,393,11,-,56500,24603
182,72,110,522,(X),24604
3807,3021,786,529,96200,24605
82,71,11,-,(X),24606
158,105,53,-,77100,24607
3101,2371,730,606,90000,24609
98,98,0,-,(X),24612
256,233,23,-,69200,24613
3144,2355,789,653,78500,24614
1304,1087,217,(X),61600,24620
352,290,62,529,56900,24622
134,134,0,-,67600,24628
2812,1955,857,623,89000,24630
724,469,255,677,66400,24631
207,191,16,-,65700,24634
215,121,94,369,52700,24635
1436,1262,174,633,131700,24637
1383,1011,372,584,62800,24639
2541,1668,873,612,93500,24641
247,228,19,-,55800,24646
1204,913,291,644,88000,24649
2406,1793,613,526,114000,24651
1362,1119,243,534,77700,24656
199,134,65,717,(X),24657
8601,6015,2586,565,66300,24701
610,464,146,635,124500,24712
70,53,17,-,82600,24714
176,134,42,570,63800,24715
224,214,10,-,(X),24716
61,61,0,-,(X),24719
20,10,10,580,53300,24724
93,93,0,-,132400,24726
96,69,27,-,(X),24729
97,83,14,-,(X),24731
335,246,89,686,50000,24733
209,170,39,336,44000,24736
27,27,0,-,-,24737
99,64,35,415,(X),24738
12996,9389,3607,611,102600,24740
1092,845,247,584,68500,24747
1533,1099,434,460,45200,24801
285,226,59,519,36500,24808
228,167,61,-,42600,24811
187,162,25,-,31200,24813
287,216,71,520,28100,24815
114,102,12,-,(X),24816
310,241,69,571,51800,24817
407,385,22,-,37200,24818
224,186,38,630,(X),24822
188,159,29,-,43800,24823
34,34,0,-,(X),24826
638,551,87,-,30400,24827
337,265,72,495,29200,24828
42,40,2,-,32500,24830
84,84,0,-,42500,24831
102,83,19,-,67700,24834
188,156,32,625,23500,24836
665,553,112,539,57400,24839
39,39,0,-,75400,24843
854,673,181,450,48400,24844
145,66,79,-,(X),24845
71,71,0,-,51000,24846
120,83,37,-,29200,24847
95,55,40,-,22300,24848
143,135,8,-,(X),24849
399,329,70,-,52700,24850
165,165,0,-,55000,24851
248,141,107,518,54100,24853
105,41,64,642,-,24854
376,303,73,514,80400,24857
193,193,0,-,80400,24860
102,45,57,-,(X),24861
189,172,17,380,51000,24862
109,97,12,-,44500,24866
129,76,53,-,43000,24867
505,401,104,542,33900,24868
149,116,33,-,55400,24869
1121,863,258,511,59800,24870
123,102,21,-,30600,24871
292,250,42,608,28100,24872
166,123,43,-,(X),24873
1224,906,318,669,82800,24874
199,147,52,-,(X),24878
235,198,37,-,27000,24879
96,96,0,-,38000,24880
134,104,30,-,24000,24881
146,127,19,-,40500,24882
125,98,27,-,24800,24884
7,7,0,-,-,24887
50,50,0,-,42500,24888
610,409,201,515,32200,24892
141,111,30,-,49300,24894
73,73,0,-,(X),24898
4191,2879,1312,780,161900,24901
1907,1416,491,615,86400,24910
293,245,48,725,86100,24915
280,234,46,-,87900,24916
559,414,145,570,115300,24918
168,113,55,425,64200,24920
146,108,38,571,150000,24924
311,235,76,678,110100,24925
108,87,21,-,86400,24927
496,410,86,-,153800,24931
195,163,32,(X),121100,24934
268,247,21,-,106000,24935
700,577,123,-,154500,24938
544,477,67,563,86700,24941
176,155,21,-,175600,24944
152,133,19,-,97600,24945
619,522,97,539,136100,24946
577,469,108,(X),124800,24951
1623,1326,297,635,111300,24954
163,163,0,-,200400,24957
32,32,0,-,-,24962
1790,1402,388,568,110600,24963
624,537,87,481,100800,24966
1995,1399,596,586,93300,24970
100,84,16,-,101200,24974
455,422,33,-,120300,24976
218,177,41,-,132500,24977
376,262,114,-,88900,24981
1106,915,191,409,101300,24983
119,75,44,-,(X),24984
2336,1583,753,651,86500,24986
270,242,28,-,81700,24991
13,13,0,-,-,25002
1178,855,323,802,84200,25003
63,51,12,-,67300,25005
240,205,35,-,76300,25007
47,13,34,-,-,25008
444,404,40,663,67000,25009
399,341,58,592,102700,25011
1880,1242,638,681,74200,25015
190,169,21,-,58500,25019
143,69,74,805,(X),25021
83,63,20,-,(X),25022
263,195,68,(X),61800,25024
56,56,0,-,76500,25025
155,146,9,-,84400,25028
106,106,0,-,70500,25030
363,250,113,667,55600,25031
741,640,101,576,87100,25033
529,459,70,(X),46100,25035
273,225,48,-,41700,25036
390,290,100,642,44800,25039
180,143,37,684,105100,25040
698,538,160,518,87100,25043
97,82,15,-,(X),25044
2223,1692,531,588,80800,25045
146,82,64,566,20000,25047
22,22,0,-,(X),25048
178,93,85,494,58500,25049
88,58,30,-,75000,25051
1654,1095,559,578,97500,25053
102,87,15,-,53300,25054
146,135,11,-,45500,25057
185,140,45,613,(X),25059
176,159,17,-,48300,25060
269,261,8,-,54700,25061
67,67,0,-,61300,25062
687,536,151,609,77400,25063
4441,2918,1523,741,88400,25064
370,311,59,805,85600,25067
766,609,157,583,117400,25070
4914,3786,1128,811,108300,25071
193,163,30,-,(X),25075
148,66,82,497,(X),25076
463,442,21,-,113500,25081
544,400,144,609,(X),25082
258,253,5,-,63000,25083
350,213,137,599,65000,25085
264,213,51,694,99600,25086
72,72,0,-,27800,25088
68,31,37,-,-,25090
50,50,0,-,25800,25093
99,81,18,656,55400,25102
61,32,29,-,49300,25103
191,110,81,332,80000,25106
223,151,72,467,74700,25107
252,237,15,-,87800,25108
174,144,30,-,95700,25109
196,95,101,783,155200,25110
270,241,29,-,44300,25111
0,0,0,-,-,25112
336,289,47,-,95600,25113
259,192,67,-,72200,25114
92,68,24,-,27200,25115
364,306,58,663,53200,25118
144,75,69,555,66100,25119
256,216,40,-,(X),25121
1449,1164,285,651,78400,25123
526,515,11,-,82800,25124
272,224,48,-,76200,25125
35,26,9,-,-,25126
1456,978,478,629,101900,25130
80,61,19,-,17500,25132
379,230,149,243,121800,25133
185,147,38,-,64000,25134
724,339,385,452,77600,25136
156,156,0,-,112500,25139
468,359,109,581,56800,25140
70,51,19,-,69500,25141
180,149,31,-,76600,25142
3558,2522,1036,704,94800,25143
106,106,0,-,45000,25148
102,88,14,-,66400,25149
146,134,12,-,40900,25152
350,282,68,-,76300,25154
62,34,28,-,-,25156
2171,1844,327,791,118200,25159
44,44,0,-,32400,25160
120,80,40,(X),106800,25161
202,152,50,600,87800,25162
475,336,139,476,100900,25164
243,200,43,531,86600,25165
898,820,78,-,106800,25168
226,149,77,615,85000,25169
120,97,23,-,43900,25173
155,155,0,-,39600,25174
10449,7746,2703,693,91700,25177
23,23,0,-,-,25180
634,573,61,565,67200,25181
0,0,0,-,-,25183
0,0,0,-,-,25185
413,213,200,361,68600,25186
352,306,46,-,(X),25187
157,108,49,536,61700,25193
12,0,12,-,-,25201
433,371,62,623,104300,25202
55,7,48,-,-,25203
82,53,29,440,(X),25204
203,203,0,-,69500,25205
142,133,9,-,24700,25206
392,323,69,516,53700,25208
565,313,252,512,48800,25209
45,37,8,-,-,25211
2288,1949,339,532,155600,25213
177,154,23,-,57300,25214
551,471,80,574,79100,25234
305,270,35,-,58800,25235
718,563,155,501,89200,25239
563,506,57,1077,144400,25241
286,240,46,575,96400,25243
229,204,25,-,35000,25244
294,239,55,-,121800,25245
229,152,77,628,66800,25247
1115,1003,112,-,166100,25248
186,159,27,-,72300,25251
477,391,86,-,113800,25252
805,718,87,383,83900,25253
207,173,34,-,79500,25259
703,526,177,517,81200,25260
138,83,55,-,82900,25261
429,429,0,-,118200,25262
122,97,25,-,68000,25264
627,521,106,534,81400,25265
378,213,165,(X),87300,25266
301,267,34,-,71400,25267
311,264,47,-,59500,25268
355,312,43,950,88200,25270
3762,2603,1159,570,121700,25271
671,618,53,-,86100,25275
3155,2310,845,408,88700,25276
214,214,0,-,133000,25285
625,547,78,617,78400,25286
316,299,17,-,55400,25287
1494,309,1185,623,133300,25301
6837,4438,2399,695,98800,25302
3262,2284,978,689,129600,25303
3824,2315,1509,695,174800,25304
0,0,0,-,-,25305
2724,1855,869,699,80800,25306
5683,4089,1594,602,100200,25309
4903,2509,2394,669,98900,25311
6288,4553,1735,640,92200,25312
5227,3733,1494,768,137800,25313
6630,5214,1416,854,205600,25314
1415,890,525,606,75300,25315
2591,2029,562,702,96800,25320
5742,2650,3092,828,141400,25401
4908,4162,746,1067,200800,25403
8280,5625,2655,904,150200,25404
4699,3309,1390,1017,155600,25405
5379,3711,1668,707,168800,25411
3076,2515,561,1056,162100,25413
6698,4963,1735,877,223900,25414
3792,2998,794,911,190600,25419
1530,1302,228,917,127500,25420
803,529,274,668,166000,25422
4997,4014,983,1021,199000,25425
4929,4085,844,925,163700,25427
4144,3558,586,1198,157100,25428
2961,2165,796,810,191700,25430
158,94,64,-,84600,25431
46,26,20,-,73100,25432
1132,605,527,628,132800,25434
158,90,68,383,(X),25437
2605,1633,972,897,156600,25438
600,482,118,832,187500,25442
2585,1779,806,920,268800,25443
160,63,97,-,(X),25444
486,447,39,-,211600,25446
425,345,80,-,89700,25501
572,404,168,616,73800,25502
277,231,46,-,62000,25503
5073,3432,1641,781,133800,25504
144,88,56,-,137500,25505
1791,1221,570,415,55200,25506
366,246,120,500,105600,25507
3882,2995,887,586,96600,25508
1924,1677,247,762,113400,25510
348,264,84,800,(X),25511
430,309,121,-,66500,25512
1440,1092,348,468,70500,25514
938,719,219,568,82100,25515
933,717,216,528,70800,25517
524,411,113,-,49500,25520
322,255,67,707,99800,25521
1108,823,285,480,101300,25523
1144,994,150,575,73600,25524
8514,6844,1670,776,180800,25526
370,345,25,-,71500,25529
2278,1737,541,451,83700,25530
140,81,59,-,(X),25534
1124,899,225,1006,115500,25535
777,648,129,906,99600,25537
101,37,64,-,"10,000-",25540
3516,2732,784,648,129500,25541
1918,1638,280,742,138600,25545
468,393,75,-,112800,25547
3800,2982,818,477,89400,25550
750,608,142,634,46300,25555
579,481,98,-,37500,25557
674,579,95,-,105500,25559
3140,2648,492,894,186200,25560
580,468,112,698,77900,25564
280,238,42,-,56100,25565
390,367,23,-,67400,25567
2623,1936,687,523,69900,25570
783,518,265,720,98000,25571
456,386,70,-,113800,25573
1983,1333,650,542,80400,25601
366,298,68,-,82000,25606
381,285,96,240,81400,25607
525,469,56,517,45200,25608
365,221,144,772,93300,25611
290,277,13,-,115900,25617
863,633,230,583,56600,25621
109,109,0,-,(X),25624
464,330,134,820,79700,25625
269,204,65,100-,84400,25628
309,253,56,600,60700,25630
258,162,96,-,48500,25632
254,226,28,(X),31200,25634
557,413,144,525,89400,25635
339,278,61,503,74000,25637
459,395,64,-,72500,25638
244,213,31,618,57600,25639
162,127,35,-,56000,25644
442,376,66,613,68600,25646
412,301,111,536,73800,25647
583,459,124,-,114200,25649
204,204,0,-,84200,25650
317,291,26,-,66300,25651
458,337,121,697,64800,25652
195,131,64,850,84700,25653
103,85,18,-,76400,25654
2694,1807,887,575,82100,25661
253,153,100,-,57300,25666
324,285,39,-,(X),25669
2325,1870,455,647,76000,25670
526,387,139,687,70600,25671
168,115,53,-,(X),25672
1150,905,245,533,78200,25674
462,379,83,523,65200,25676
693,504,189,304,69500,25678
202,180,22,-,82400,25688
109,93,16,-,63800,25690
502,324,178,601,67600,25692
34,22,12,-,-,25696
61,53,8,-,(X),25699
10510,5610,4900,600,117600,25701
3185,1861,1324,570,79600,25702
2141,480,1661,681,64700,25703
7047,4815,2232,648,88500,25704
9186,5756,3430,692,116800,25705
14387,9728,4659,642,106800,25801
118,96,22,-,58700,25810
66,53,13,-,-,25811
739,630,109,539,79100,25812
2431,1826,605,629,145000,25813
265,214,51,-,81700,25817
143,70,73,-,159000,25818
224,164,60,-,70000,25820
904,708,196,618,83900,25823
1040,871,169,703,107500,25825
88,88,0,-,82400,25826
1020,903,117,804,105100,25827
507,461,46,656,88300,25831
1622,1505,117,(X),141500,25832
281,215,66,-,57900,25836
115,80,35,-,61300,25837
212,139,73,-,130500,25839
3240,2597,643,680,95200,25840
255,222,33,-,112000,25841
361,245,116,-,(X),25843
537,472,65,-,66400,25844
329,271,58,(X),59300,25845
130,77,53,-,176500,25846
195,96,99,479,127100,25848
192,111,81,-,52700,25849
50,0,50,-,-,25853
416,416,0,-,93100,25854
28,0,28,-,-,25855
78,46,32,-,55000,25857
76,59,17,-,328000,25862
150,140,10,-,(X),25864
472,343,129,752,108400,25865
136,136,0,-,(X),25868
31,31,0,-,-,25870
242,182,60,508,128600,25871
337,209,128,814,89500,25873
202,181,21,-,74600,25875
41,41,0,-,164200,25876
432,394,38,-,74400,25878
271,152,119,625,26500,25879
2572,1739,833,610,77500,25880
990,820,170,576,62700,25882
4773,3537,1236,621,80700,25901
57,52,5,-,(X),25902
113,105,8,-,(X),25904
127,127,0,-,99900,25906
38,26,12,-,-,25907
35,19,16,-,-,25908
14,14,0,-,-,25911
113,88,25,-,(X),25913
138,52,86,495,50000,25915
49,25,24,-,(X),25916
827,707,120,473,59200,25917
1810,1453,357,643,130900,25918
104,42,62,-,(X),25920
879,553,326,728,56600,25921
115,91,24,-,123200,25922
183,155,28,-,(X),25928
30,30,0,-,-,25932
15,8,7,-,"10,000-",25936
458,430,28,-,77800,25938
92,92,0,-,26600,25942
2733,2096,637,619,77400,25951
317,243,74,594,64600,25958
1546,1145,401,563,74000,25962
404,312,92,434,106500,25969
437,287,150,783,167600,25971
132,96,36,573,(X),25972
1032,859,173,560,75300,25976
47,47,0,-,58100,25977
295,204,91,577,54700,25978
301,289,12,-,158500,25979
276,244,32,605,67000,25981
701,470,231,595,72000,25984
183,168,15,-,65000,25985
204,144,60,529,110200,25989
18153,12500,5653,573,109300,26003
245,209,36,648,51000,26030
772,466,306,449,64500,26031
185,114,71,465,108300,26032
1299,1068,231,495,108500,26033
2021,1396,625,640,84000,26034
1023,838,185,582,91400,26035
204,204,0,-,205200,26036
2778,2094,684,570,85900,26037
1251,987,264,647,139000,26038
338,263,75,(X),182400,26039
837,587,250,681,66600,26040
6628,4984,1644,571,90700,26041
2546,2035,511,584,92200,26047
639,444,195,660,46800,26050
798,659,139,548,87700,26055
65,65,0,-,125500,26056
1026,881,145,689,106800,26059
792,675,117,643,116600,26060
9463,6601,2862,645,89800,26062
3649,2728,921,530,83900,26070
228,112,116,500,99700,26074
214,199,15,490,53300,26075
12523,7550,4973,617,86800,26101
7346,5285,2061,653,102300,26104
5242,3973,1269,621,125000,26105
586,515,71,521,119700,26133
400,280,120,539,93700,26134
305,274,31,-,59400,26136
306,267,39,-,51800,26137
53,53,0,-,54000,26138
119,98,21,-,64000,26141
989,684,305,548,64000,26142
1869,1547,322,537,88500,26143
420,320,100,405,86900,26146
993,741,252,579,66700,26147
100,80,20,-,82700,26148
1035,788,247,470,85900,26149
2416,1821,595,606,132900,26150
262,195,67,-,86300,26151
50,13,37,-,-,26152
3431,2704,727,529,93400,26155
1152,895,257,577,81700,26159
439,360,79,384,70900,26160
90,60,30,-,57900,26161
3166,2332,834,615,94300,26164
437,382,55,504,69000,26167
277,242,35,-,112500,26169
2246,1898,348,659,104400,26170
1358,1003,355,661,87700,26175
208,152,56,-,59400,26178
1009,827,182,395,100600,26180
2469,2263,206,716,141700,26181
802,709,93,730,94200,26184
2482,1913,569,651,134300,26187
7511,5580,1931,595,113300,26201
229,219,10,-,81100,26202
56,36,20,-,-,26203
1294,993,301,557,84500,26205
1293,878,415,466,47700,26206
369,353,16,(X),60600,26208
118,40,78,481,347100,26209
63,63,0,-,(X),26215
151,52,99,754,58700,26217
1023,878,145,675,116300,26218
167,167,0,-,82300,26222
57,57,0,-,(X),26224
19,19,0,-,-,26228
86,68,18,-,(X),26230
461,400,61,-,75000,26234
0,0,0,-,-,26236
188,133,55,-,87200,26237
334,251,83,442,67900,26238
6173,3902,2271,552,115400,26241
1740,1400,340,588,85000,26250
1385,1023,362,573,137800,26253
161,110,51,358,119400,26254
330,310,20,936,93200,26257
107,51,56,-,"10,000-",26259
581,453,128,593,149600,26260
1145,847,298,486,40600,26261
122,103,19,-,117400,26263
266,229,37,571,85000,26264
31,14,17,-,-,26266
145,116,29,-,(X),26267
39,32,7,-,400000,26268
419,313,106,538,108400,26269
324,275,49,500,88500,26270
151,139,12,-,102000,26271
301,258,43,500,112200,26273
250,140,110,503,57700,26275
91,91,0,-,(X),26276
254,247,7,-,80100,26278
752,639,113,446,65000,26280
0,0,0,-,-,26282
646,577,69,(X),113200,26283
200,200,0,-,61700,26285
1304,1038,266,436,80400,26287
1699,1248,451,472,72000,26288
25,25,0,-,368200,26291
339,265,74,525,95700,26292
242,185,57,878,63600,26293
357,348,9,-,75500,26294
62,50,12,-,104800,26296
39,39,0,-,63600,26298
12294,8305,3989,628,82900,26301
336,267,69,403,97500,26320
232,196,36,575,57700,26321
162,93,69,688,46300,26323
111,81,30,475,56100,26325
32,32,0,-,-,26327
5797,4525,1272,789,185000,26330
510,368,142,444,73600,26335
470,430,40,535,73600,26337
277,192,85,385,72300,26338
44,44,0,-,275000,26339
135,128,7,-,94100,26342
125,119,6,-,(X),26343
336,303,33,(X),65000,26346
806,661,145,606,83600,26347
32,32,0,-,(X),26348
36,27,9,-,(X),26349
1271,798,473,557,91900,26351
4385,3450,935,477,82900,26354
102,98,4,-,30200,26361
1312,972,340,596,81000,26362
18,6,12,-,-,26366
333,229,104,632,63700,26369
368,304,64,515,151800,26372
501,430,71,-,115500,26374
223,180,43,-,34400,26376
213,203,10,-,66900,26377
1494,1148,346,739,146700,26378
364,349,15,-,32600,26384
1451,1194,257,585,105200,26385
898,668,230,753,76800,26386
129,129,0,-,91700,26404
386,270,116,514,88600,26405
1102,925,177,785,151300,26408
396,315,81,-,74000,26410
322,281,41,-,82700,26411
274,237,37,-,58400,26412
1423,1122,301,465,75500,26415
2927,2026,901,512,106500,26416
428,332,96,446,72400,26419
98,72,26,-,58700,26421
213,108,105,(X),84300,26422
134,108,26,-,71100,26424
515,448,67,444,56200,26425
2657,2195,462,540,87300,26426
122,117,5,625,109900,26430
2391,1823,568,535,87400,26431
74,40,34,-,(X),26435
43,14,29,-,-,26436
222,166,56,320,46500,26437
163,109,54,-,(X),26438
427,341,86,629,105000,26440
96,96,0,-,83300,26443
1446,1305,141,636,81200,26444
540,434,106,528,79500,26447
437,396,41,625,59500,26448
299,261,38,763,76800,26451
3614,2315,1299,549,87900,26452
1271,1091,180,524,89100,26456
7749,5076,2673,686,148900,26501
14082,4729,9353,763,176700,26505
11615,8627,2988,799,193900,26508
726,533,193,680,90300,26519
338,329,9,-,164500,26520
86,78,8,390,91000,26521
2188,1693,495,579,160400,26525
795,439,356,629,102300,26534
2259,1675,584,596,125100,26537
1020,852,168,643,96600,26541
907,726,181,471,86600,26542
46,26,20,-,-,26543
985,785,200,585,112200,26547
16822,12450,4372,699,115800,26554
516,411,105,705,105900,26559
72,62,10,-,41100,26560
206,149,57,416,67100,26562
124,90,34,-,53300,26563
254,182,72,915,73900,26568
1282,1083,199,534,89800,26570
794,647,147,644,66500,26571
143,127,16,-,40900,26572
248,209,39,560,65900,26574
316,234,82,655,96300,26575
94,94,0,-,90300,26576
351,274,77,458,54200,26581
1933,1631,302,645,78400,26582
224,214,10,-,125000,26585
85,85,0,-,-,26586
180,180,0,-,95500,26587
1056,858,198,633,117000,26588
291,195,96,629,113200,26590
535,464,71,1042,80000,26591
1831,1375,456,559,84900,26601
363,332,31,-,56700,26610
61,41,20,-,(X),26611
113,96,17,-,76900,26615
125,125,0,-,84700,26617
180,131,49,-,(X),26619
346,246,100,533,83300,26621
514,403,111,509,89700,26623
1202,879,323,456,80800,26624
113,70,43,-,114700,26627
112,85,27,-,114200,26629
130,99,31,-,61600,26631
179,136,43,-,95600,26636
68,52,16,-,(X),26638
4269,3203,1066,534,90900,26651
165,114,51,-,51400,26656
121,108,13,-,82400,26660
468,450,18,-,109900,26662
250,231,19,-,82300,26676
476,404,72,(X),154000,26678
880,724,156,784,135100,26679
112,82,30,-,(X),26680
591,522,69,-,86300,26681
37,37,0,-,(X),26684
239,159,80,468,(X),26690
163,114,49,-,(X),26691
2331,1428,903,512,105300,26704
394,325,69,465,106300,26705
159,136,23,500,77000,26707
953,582,371,602,118500,26710
1043,601,442,589,180400,26711
259,85,174,-,18000,26714
326,262,64,-,129700,26716
520,251,269,431,103700,26717
1185,708,477,522,156200,26719
35,24,11,-,-,26720
435,190,245,526,153600,26722
5119,2927,2192,525,111800,26726
76,76,0,-,(X),26731
253,253,0,-,85900,26739
581,411,170,446,163400,26743
342,169,173,372,37700,26750
2606,1567,1039,577,126200,26753
362,278,84,472,126700,26755
2490,1505,985,520,122700,26757
257,143,114,-,171300,26761
794,364,430,552,111000,26763
1548,1188,360,533,87200,26764
234,128,106,559,77500,26767
449,380,69,(X),114000,26801
525,357,168,781,72100,26802
268,234,34,419,75000,26804
1136,874,262,531,131400,26807
365,70,295,622,(X),26808
125,118,7,-,252800,26810
655,564,91,496,135100,26812
179,126,53,(X),100000,26814
287,252,35,(X),123800,26815
162,124,38,-,245500,26817
274,252,22,-,117900,26818
240,107,133,-,160900,26823
704,553,151,509,160400,26833
2473,1649,824,567,110000,26836
199,150,49,-,159800,26845
2426,1774,652,582,124700,26847
785,620,165,723,119400,26851
320,197,123,531,89400,26852
241,212,29,557,121600,26855
116,32,84,-,(X),26865
394,342,52,617,93300,26866
292,231,61,395,103100,26884
5548,4866,682,844,245700,27006
827,736,91,644,130500,27007
1003,927,76,-,164300,27009
2254,1799,455,585,120800,27011
10041,8438,1603,864,206400,27012
2440,1679,761,685,116200,27013
304,221,83,771,75500,27014
664,516,148,479,126300,27016
3546,2447,1099,563,117000,27017
3075,2383,692,590,136600,27018
1714,1379,335,525,121000,27019
2588,2147,441,520,126100,27020
7075,5440,1635,680,120300,27021
625,537,88,527,87800,27022
4903,4356,547,748,199800,27023
1091,813,278,539,104900,27024
4316,3481,835,546,119200,27025
1836,1037,799,553,86400,27027
9813,7332,2481,649,132800,27028
15540,11010,4530,611,108100,27030
4420,3924,496,881,167900,27040
3231,2430,801,623,131800,27041
252,192,60,652,122900,27042
2690,2164,526,558,144200,27043
3542,2687,855,652,132400,27045
914,746,168,466,85900,27046
397,335,62,100-,112100,27047
3465,2794,671,588,99900,27048
1538,1178,360,720,138600,27050
3062,2347,715,787,120900,27051
4332,3213,1119,638,118500,27052
1169,952,217,597,144300,27053
778,661,117,719,89400,27054
5532,4163,1369,625,132800,27055
8542,3072,5470,630,126300,27101
16080,8243,7837,753,149500,27103
12816,7403,5413,739,241300,27104
14511,7268,7243,689,94500,27105
19215,10345,8870,746,181200,27106
16803,11458,5345,713,125100,27107
0,0,0,-,-,27109
0,0,0,-,-,27110
14658,10174,4484,795,130400,27127
32,12,20,1031,61700,27201
8511,4090,4421,599,104200,27203
12666,9810,2856,706,124100,27205
1387,1182,205,746,123400,27207
728,653,75,811,139400,27208
1258,912,346,556,82400,27209
519,420,99,525,94400,27212
4157,3224,933,770,157800,27214
17519,10347,7172,776,151900,27215
13686,8660,5026,734,102600,27217
1270,739,531,624,81500,27229
720,585,135,855,172500,27231
1265,1155,110,831,142000,27233
1693,1282,411,2469,253300,27235
3303,2578,725,634,122600,27239
681,565,116,506,79000,27242
1742,1562,180,765,183900,27243
4369,3072,1297,909,168600,27244
1719,1189,530,653,89100,27248
5120,4018,1102,747,139400,27249
977,835,142,543,139400,27252
11978,8171,3807,690,136100,27253
2572,2041,531,801,120500,27258
8786,3377,5409,660,81000,27260
8546,4528,4018,740,160000,27262
8615,5662,2953,678,116500,27263
19560,13144,6416,854,158200,27265
9418,7079,2339,878,227200,27278
1197,935,262,694,171700,27281
6451,4851,1600,1021,181700,27282
1239,1061,178,731,162100,27283
20951,14918,6033,734,165500,27284
9727,5987,3740,609,87800,27288
618,506,112,709,106800,27291
15156,10196,4960,644,117600,27292
14927,11074,3853,670,142200,27295
4036,3112,924,621,124700,27298
2036,1514,522,612,113400,27299
3288,2912,376,864,153000,27301
11437,7905,3532,817,166800,27302
723,581,142,630,94400,27305
2640,2105,535,611,87800,27306
2386,2164,222,723,316600,27310
1450,1196,254,539,75300,27311
8229,6616,1613,829,269900,27312
2572,2196,376,816,147000,27313
511,473,38,-,135000,27314
892,692,200,480,104300,27315
2504,1850,654,677,113800,27316
6316,4542,1774,619,120000,27317
15840,10606,5234,643,113400,27320
2403,1939,464,567,93200,27325
1348,960,388,550,113200,27326
14011,8593,5418,719,141800,27330
10859,8032,2827,866,147900,27332
68,0,68,-,-,27340
2247,1817,430,687,81700,27341
585,413,172,847,95900,27343
6584,4331,2253,691,123200,27344
2434,2005,429,448,125700,27349
2612,2156,456,630,130000,27350
948,787,161,558,120800,27355
1532,993,539,513,77200,27356
2863,2407,456,684,142900,27357
5279,4704,575,772,282000,27358
18360,12410,5950,609,117400,27360
5298,4412,886,591,128800,27370
3320,2215,1105,497,113600,27371
3663,3062,601,785,214400,27376
3207,2364,843,905,165800,27377
1977,1331,646,518,99700,27379
7487,2867,4620,672,100600,27401
7906,4177,3729,781,167100,27403
18106,8556,9550,681,105000,27405
22956,12853,10103,737,122600,27406
19745,8979,10766,781,135300,27407
8206,5932,2274,786,210100,27408
7968,3156,4812,770,128700,27409
23816,15186,8630,857,204000,27410
11931,8337,3594,812,205600,27455
6562,5002,1560,712,147500,27501
11695,8999,2696,1145,271300,27502
1194,1113,81,942,286500,27503
5263,3149,2114,760,126700,27504
2199,1575,624,712,127600,27505
573,485,88,574,160400,27507
568,351,217,552,84400,27508
1472,864,608,796,131800,27509
6932,1969,4963,893,270300,27510
13155,8581,4574,898,213500,27511
16682,10390,6292,1004,269800,27513
10613,4886,5727,993,402100,27514
14064,9118,4946,986,341500,27516
10642,7344,3298,1002,370200,27517
8257,5536,2721,1076,369500,27518
16156,12272,3884,1184,361300,27519
14129,10377,3752,956,149600,27520
2284,1599,685,661,109900,27521
4369,3382,987,885,147300,27522
4102,2607,1495,1005,332000,27523
4320,2847,1473,648,119600,27524
5293,4067,1226,671,134000,27525
15145,12304,2841,891,202300,27526
6311,5283,1028,1090,208200,27527
16647,11660,4987,911,168700,27529
15530,8536,6994,613,125800,27530
0,0,0,-,-,27531
13170,7017,6153,846,132600,27534
6139,2712,3427,616,104600,27536
9091,6759,2332,675,95000,27537
7486,6267,1219,1047,264000,27539
11026,9707,1319,1162,243100,27540
1581,1248,333,1014,156300,27541
3313,2119,1194,603,107100,27542
1820,1258,562,655,98300,27544
8908,6283,2625,883,158100,27545
6457,4086,2371,759,125600,27546
9461,7042,2419,686,112100,27549
841,632,209,868,143800,27551
602,444,158,675,107100,27553
233,136,97,698,85400,27555
106,67,39,609,(X),27556
2464,1661,803,624,92800,27557
875,714,161,746,181100,27559
10269,4861,5408,1081,266100,27560
667,524,143,800,217600,27562
2102,1421,681,499,79300,27563
9543,6319,3224,666,119600,27565
260,120,140,816,131300,27568
2842,2062,780,719,105700,27569
1709,1430,279,697,244200,27571
3008,2680,328,866,173700,27572
4333,1898,2435,601,108600,27573
5667,4598,1069,660,111100,27574
5977,3702,2275,750,110300,27576
8394,5061,3333,734,136400,27577
1344,1154,190,755,155500,27581
67,46,21,650,88500,27582
2507,2125,382,610,124700,27583
20773,16174,4599,974,265200,27587
3002,1992,1010,641,87500,27589
7086,5433,1653,771,141800,27591
5356,4586,770,861,159700,27592
5933,4772,1161,813,167500,27596
8363,5958,2405,855,142300,27597
3441,942,2499,751,231200,27601
19075,12133,6942,902,189100,27603
17248,9613,7635,888,160700,27604
2739,897,1842,879,340600,27605
17724,6458,11266,876,230800,27606
8375,4208,4167,887,347600,27607
4815,3287,1528,887,492000,27608
14576,7468,7108,905,238300,27609
24248,14347,9901,868,145300,27610
16851,8810,8041,973,279000,27612
18030,12252,5778,941,296700,27613
12242,9190,3052,1167,353600,27614
17778,12172,5606,945,275400,27615
17421,11193,6228,947,171400,27616
7922,3982,3940,1098,245300,27617
9146,2655,6491,680,180800,27701
17268,10820,6448,928,154200,27703
14042,7638,6404,836,141900,27704
19670,8924,10746,863,228900,27705
20168,8770,11398,888,209100,27707
345,270,75,-,202300,27709
8166,7403,763,1176,196500,27712
21415,12223,9192,966,208200,27713
8091,4197,3894,659,83300,27801
7902,4794,3108,680,138200,27803
11788,6957,4831,793,129800,27804
1384,1045,339,631,83100,27805
923,669,254,562,86200,27806
2497,1644,853,695,97500,27807
937,782,155,502,158600,27808
1737,1279,458,616,90300,27809
1657,1196,461,583,88900,27810
1236,815,421,487,87400,27812
268,164,104,773,83600,27813
760,699,61,-,89000,27814
814,614,200,641,85100,27816
2537,1876,661,654,112900,27817
602,416,186,606,(X),27818
142,103,39,765,67900,27819
1226,829,397,642,96300,27820
117,64,53,526,63800,27821
3344,2637,707,661,117300,27822
3012,1940,1072,638,70900,27823
706,444,262,799,127600,27824
32,22,10,829,68800,27825
355,308,47,-,39400,27826
17,11,6,-,102100,27827
3230,1899,1331,593,125800,27828
774,541,233,542,96100,27829
1919,1395,524,742,89100,27830
1309,938,371,807,57500,27831
1166,737,429,663,61300,27832
22098,9407,12691,714,104400,27834
2299,1882,417,793,168000,27837
1271,945,326,933,84200,27839
188,127,61,619,66800,27840
20,16,4,-,42500,27841
710,556,154,811,290500,27842
501,358,143,826,58500,27843
1182,853,329,578,74100,27844
980,768,212,601,100900,27845
1220,880,340,471,87600,27846
326,137,189,534,67200,27847
514,345,169,600,84400,27849
3241,2473,768,757,156200,27850
2046,1549,497,613,92100,27851
1169,881,288,660,87500,27852
157,132,25,-,101600,27853
2232,1345,887,579,84200,27855
6395,4698,1697,553,121500,27856
475,358,117,633,72600,27857
22050,10451,11599,766,159200,27858
893,587,306,908,85600,27860
32,28,4,-,61300,27861
317,249,68,635,135200,27862
4421,3125,1296,773,120400,27863
1855,1178,677,634,78300,27864
696,659,37,-,88100,27865
274,143,131,838,74200,27866
912,649,263,748,56100,27869
11015,6471,4544,683,94600,27870
1636,1068,568,538,74100,27871
162,112,50,550,62900,27872
189,128,61,730,83000,27873
1734,1153,581,641,79300,27874
188,188,0,-,82900,27875
699,532,167,537,86500,27876
819,468,351,675,77800,27878
109,88,21,(X),133800,27879
1316,1031,285,639,134200,27880
35,21,14,-,(X),27881
2730,1781,949,723,94200,27882
1333,991,342,600,89600,27883
419,419,0,-,85000,27884
451,371,80,665,69100,27885
8210,4970,3240,626,83800,27886
902,630,272,713,82500,27888
10651,7026,3625,672,125800,27889
1032,524,508,564,97500,27890
1911,1479,432,680,86300,27891
5736,3890,1846,614,90700,27892
15303,7270,8033,680,97100,27893
8229,5605,2624,855,162600,27896
772,341,431,416,61300,27897
14466,9039,5427,861,158700,27909
4437,2831,1606,650,84800,27910
492,357,135,1269,244500,27915
224,209,15,-,219100,27916
325,160,165,882,130500,27917
362,281,81,864,210600,27919
519,378,141,860,266300,27920
1811,1436,375,1268,213600,27921
444,395,49,658,81600,27922
207,117,90,638,286100,27923
1021,917,104,675,79200,27924
1402,1031,371,710,99700,27925
607,520,87,1011,129700,27926
392,267,125,1375,432500,27927
841,618,223,925,72000,27928
524,502,22,-,302800,27929
5064,3188,1876,732,138200,27932
635,483,152,694,160300,27935
509,405,104,1280,249600,27936
1513,1253,260,889,158400,27937
552,400,152,790,112900,27938
927,668,259,1014,169100,27939
209,203,6,-,287900,27941
387,304,83,975,75900,27942
211,178,33,-,472400,27943
4987,3906,1081,715,163000,27944
509,448,61,1086,153600,27946
564,465,99,1104,257100,27947
4741,2866,1875,1097,251400,27948
3163,2581,582,1184,383200,27949
799,673,126,867,180500,27950
481,268,213,775,136800,27953
2664,1847,817,784,268800,27954
101,85,16,-,340900,27956
652,570,82,-,77000,27957
3701,3209,492,1047,242800,27958
1224,750,474,1294,341500,27959
225,157,68,-,388800,27960
3070,2029,1041,588,84400,27962
336,198,138,964,332300,27964
287,218,69,1108,166700,27965
371,306,65,1051,209000,27966
116,92,24,533,44400,27967
154,8,146,623,-,27968
1280,906,374,689,86200,27970
90,68,22,-,366700,27972
476,363,113,841,189200,27973
502,394,108,1131,155600,27974
1321,1251,70,1523,214100,27976
80,65,15,-,315200,27978
668,482,186,634,116800,27979
841,733,108,-,120100,27980
599,376,223,938,157300,27981
42,42,0,-,-,27982
3456,2396,1060,639,78800,27983
131,71,60,932,163400,27985
499,321,178,589,82500,27986
10811,7186,3625,633,124000,28001
418,345,73,769,130800,28006
239,186,53,547,60000,28007
528,370,158,744,85900,28009
8228,5875,2353,725,155300,28012
4924,3062,1862,663,101000,28016
0,0,0,-,-,28017
2310,1899,411,679,127000,28018
0,0,0,-,-,28019
831,744,87,504,77700,28020
5311,4199,1112,695,111300,28021
5265,4035,1230,725,145300,28023
18673,12659,6014,794,146200,28025
20845,14666,6179,853,178100,28027
10692,7173,3519,1104,237100,28031
1293,777,516,821,128200,28032
1145,1032,113,762,102000,28033
6492,4525,1967,669,118900,28034
5275,4039,1236,968,360500,28036
7321,5956,1365,814,282300,28037
39,22,17,-,66300,28039
3005,2201,804,643,102800,28040
8234,4974,3260,583,96800,28043
12048,6386,5662,754,93900,28052
14481,7328,7153,760,124900,28054
11801,9404,2397,772,152100,28056
1178,911,267,750,109100,28071
407,293,114,876,153300,28072
2033,1354,679,662,77000,28073
5607,5029,578,1213,239200,28075
201,77,124,502,139600,28076
171,111,60,620,83900,28077
20184,15122,5062,1108,248600,28078
11114,9245,1869,1102,184500,28079
2882,2341,541,687,132000,28080
9788,5863,3925,812,122700,28081
9156,5847,3309,786,117500,28083
9914,6789,3125,657,107100,28086
1209,773,436,808,128700,28088
24,23,1,-,160400,28089
3153,2419,734,544,91900,28090
902,695,207,542,79800,28091
14602,10472,4130,628,131600,28092
2137,1630,507,628,154100,28097
1353,900,453,672,116100,28098
324,247,77,735,137900,28101
40,36,4,-,75000,28102
3931,2720,1211,746,150500,28103
10507,9559,948,1135,284400,28104
16079,11689,4390,975,212800,28105
2548,2148,400,644,176200,28107
38,20,18,-,-,28108
76,33,43,533,111900,28109
17704,12483,5221,806,164700,28110
9141,6715,2426,794,148600,28112
2967,2296,671,687,93700,28114
12374,9152,3222,795,171200,28115
13798,10149,3649,1042,343500,28117
1139,807,332,583,52300,28119
8148,6201,1947,717,146100,28120
2328,1876,452,762,166100,28124
840,720,120,481,202700,28125
2571,1973,598,620,131800,28127
2968,2205,763,666,111400,28128
2234,1793,441,695,137900,28129
1034,732,302,785,109000,28133
4253,2264,1989,952,160200,28134
1821,1168,653,644,66800,28135
1263,1017,246,581,152000,28137
3538,2601,937,681,110600,28138
7747,5994,1753,575,116100,28139
9445,4913,4532,703,120400,28144
10610,7903,2707,723,148500,28146
8890,5887,3003,737,132700,28147
11209,7346,3863,654,110000,28150
9254,6258,2996,694,113600,28152
1285,726,559,644,95500,28159
1533,945,588,630,93200,28160
2022,1461,561,703,150800,28163
5484,4373,1111,679,161600,28164
3417,2671,746,796,160500,28166
943,756,187,705,94900,28167
3874,3323,551,611,120000,28168
49,26,23,715,75000,28169
4379,2674,1705,690,90800,28170
15313,13589,1724,1099,328900,28173
2719,1903,816,727,137500,28174
6235,2058,4177,1206,227600,28202
6987,2480,4507,1088,411900,28203
2850,844,2006,1029,332800,28204
19236,7673,11563,783,159900,28205
4386,1422,2964,734,86100,28206
3809,3042,767,1021,778200,28207
13028,4320,8708,758,87900,28208
10391,5584,4807,877,276200,28209
20070,11173,8897,889,246800,28210
12284,7289,4995,971,372900,28211
15419,5101,10318,800,114200,28212
14440,7210,7230,809,133600,28213
13097,9892,3205,1062,122800,28214
19821,11961,7860,853,128800,28215
18585,10998,7587,984,118900,28216
9901,3204,6697,867,100900,28217
15884,10766,5118,981,301300,28226
19170,13371,5799,917,147500,28227
0,0,0,-,-,28244
14471,5276,9195,1008,148500,28262
28201,17461,10740,1076,159500,28269
12842,9371,3471,1056,286100,28270
13277,7091,6186,989,150000,28273
24814,17848,6966,1250,283800,28277
8173,6009,2164,1105,210500,28278
0,0,0,-,-,28280
0,0,0,-,-,28282
6824,2596,4228,652,91000,28301
12874,6484,6390,794,138000,28303
14563,8386,6177,906,113800,28304
2813,1535,1278,774,182700,28305
15529,9658,5871,815,151100,28306
4985,29,4956,1162,161900,28307
20,0,20,-,-,28308
0,0,0,-,-,28310
13777,6998,6779,829,150000,28311
7293,4972,2321,688,118300,28312
21943,10176,11767,920,127300,28314
4721,2599,2122,756,141900,28315
1833,1472,361,609,111300,28318
3798,2412,1386,640,77200,28320
1190,890,300,799,160100,28323
164,100,64,679,62000,28325
6432,3825,2607,1173,133000,28326
5622,4628,994,749,159000,28327
10115,6298,3817,607,98900,28328
218,144,74,-,71100,28330
191,109,82,636,93600,28332
4040,2526,1514,731,72600,28333
9735,6256,3479,647,103300,28334
4316,2577,1739,663,93800,28337
1978,1232,746,658,75100,28338
2682,1910,772,687,92800,28339
4005,2685,1320,522,65300,28340
1424,1037,387,631,71600,28341
70,59,11,831,115800,28342
530,265,265,652,77700,28343
1169,877,292,663,81300,28344
4892,3034,1858,587,66100,28345
434,254,180,628,65000,28347
11819,7912,3907,830,138500,28348
1422,1096,326,740,95600,28349
80,80,0,-,256500,28350
1549,1196,353,647,64200,28351
9308,5477,3831,612,84700,28352
1768,1320,448,877,157200,28356
1239,937,302,622,90400,28357
13446,7471,5975,633,79800,28358
4846,3407,1439,624,81500,28360
495,396,99,711,58500,28363
5028,3528,1500,553,65900,28364
6469,4308,2161,620,82100,28365
1982,1488,494,637,86600,28366
35,14,21,573,75700,28367
1008,731,277,587,61600,28369
2185,1393,792,827,94900,28371
4505,2636,1869,558,74100,28372
1019,725,294,764,131400,28373
7891,6717,1174,1561,293900,28374
53,43,10,-,96400,28375
13878,8939,4939,862,152700,28376
4159,2447,1712,539,68100,28377
10587,6645,3942,595,87000,28379
2618,1943,675,678,78500,28382
2874,2056,818,534,62700,28383
4208,2989,1219,564,61500,28384
1122,920,202,(X),93400,28385
1912,1325,587,613,61800,28386
6518,3958,2560,746,228300,28387
8296,3609,4687,843,116200,28390
1983,1634,349,745,118200,28391
678,483,195,668,96500,28392
582,379,203,401,89000,28393
2022,1356,666,682,176800,28394
915,665,250,618,139100,28395
1121,868,253,654,76500,28396
3003,1683,1320,567,78100,28398
851,618,233,600,83500,28399
10023,3350,6673,783,147800,28401
16674,5153,11521,824,235400,28403
12858,7404,5454,990,189600,28405
12342,10181,2161,1209,248600,28409
13470,10817,2653,1116,230100,28411
16139,9386,6753,875,191100,28412
1282,783,499,771,105100,28420
487,370,117,664,101300,28421
2941,2247,694,838,158900,28422
955,769,186,762,72700,28423
28,15,13,709,137500,28424
4022,2724,1298,721,119000,28425
2568,1392,1176,1175,293600,28428
3057,2373,684,762,160800,28429
655,448,207,423,54300,28430
2671,1826,845,565,81700,28431
824,564,260,596,89900,28432
2064,1523,541,582,75500,28433
610,453,157,585,96700,28434
968,854,114,662,96400,28435
731,574,157,774,106700,28436
768,583,185,508,77300,28438
755,490,265,533,68300,28439
1532,997,535,522,77400,28441
683,523,160,612,86600,28442
6964,5754,1210,916,202500,28443
747,657,90,514,70100,28444
2823,1850,973,1149,180700,28445
612,532,80,586,154400,28447
483,366,117,-,(X),28448
856,623,233,1208,371600,28449
943,705,238,823,174200,28450
11998,8983,3015,905,156800,28451
320,135,185,726,55400,28452
1252,813,439,652,76400,28453
772,550,222,1065,115100,28454
658,527,131,492,(X),28455
1490,1279,211,700,86300,28456
3535,2534,1001,794,114900,28457
2473,1534,939,606,80300,28458
3553,2114,1439,1196,208300,28460
7637,5982,1655,933,249400,28461
5185,3863,1322,691,160200,28462
3233,1972,1261,584,81200,28463
786,573,213,710,80500,28464
3145,2208,937,903,281600,28465
4520,2971,1549,585,119800,28466
4761,4196,565,977,186400,28467
2174,1826,348,780,258900,28468
2773,2180,593,955,264800,28469
4598,3217,1381,736,139800,28470
7609,5185,2424,587,87900,28472
1672,1434,238,683,100000,28478
2273,1722,551,734,173800,28479
1172,637,535,1307,732900,28480
8122,3876,4246,604,83100,28501
8520,5829,2691,753,109400,28504
846,572,274,685,63300,28508
612,480,132,813,182000,28510
290,226,64,825,167300,28511
1593,1094,499,856,356100,28512
4171,2475,1696,687,91300,28513
862,556,306,590,77100,28515
5023,3464,1559,767,183800,28516
3224,2245,979,656,112500,28518
127,80,47,941,160300,28519
161,143,18,-,109000,28520
892,669,223,789,84600,28521
1098,704,394,683,69800,28523
131,131,0,-,129200,28524
1056,633,423,671,89900,28525
1080,757,323,590,78900,28526
528,427,101,574,100900,28527
307,254,53,-,119000,28528
954,711,243,708,133800,28529
2681,1618,1063,683,88400,28530
607,513,94,1055,222300,28531
8525,4033,4492,1069,145800,28532
18,0,18,-,-,28533
39,19,20,-,-,28537
886,624,262,714,84300,28538
5815,3853,1962,967,143200,28539
17862,9577,8285,794,151400,28540
1832,13,1819,1154,-,28543
2066,525,1541,996,88300,28544
17123,8863,8260,920,155700,28546
1885,0,1885,1322,-,28547
5776,4199,1577,732,91000,28551
60,52,8,-,132700,28552
152,152,0,-,141900,28553
80,45,35,-,38800,28554
1822,1248,574,748,137700,28555
509,411,98,988,164800,28556
6474,4153,2321,782,225200,28557
11130,7437,3693,753,153900,28560
15762,10411,5351,927,184100,28562
9178,6575,2603,772,157600,28570
1205,976,229,1006,278200,28571
2362,1816,546,703,85600,28572
969,682,287,644,107500,28573
5839,4073,1766,914,143400,28574
259,216,43,904,267400,28575
141,123,18,-,156700,28577
1874,1280,594,549,75900,28578
233,225,8,-,165100,28579
4062,2688,1374,583,91400,28580
86,86,0,-,53000,28581
824,768,56,-,204500,28582
85,55,30,681,76400,28583
4702,3441,1261,926,231800,28584
1570,1140,430,591,90800,28585
2900,2179,721,552,79000,28586
166,79,87,612,69200,28587
107,46,61,-,112500,28589
9351,6732,2619,839,164600,28590
1817,1278,539,1186,364900,28594
19218,12237,6981,669,151300,28601
11146,7299,3847,668,125000,28602
2759,1992,767,797,233200,28604
1559,1138,421,974,349400,28605
728,663,65,(X),109200,28606
12438,5705,6733,825,245000,28607
2384,1937,447,750,117200,28609
3558,2866,692,713,98700,28610
445,246,199,909,91500,28611
4589,3375,1214,615,98400,28612
8754,6075,2679,667,128900,28613
801,715,86,943,86600,28615
174,83,91,(X),151400,28616
1216,858,358,465,163200,28617
876,719,157,829,173300,28618
550,308,242,583,89400,28619
4053,2786,1267,678,108800,28621
878,731,147,600,113900,28622
812,664,148,674,135000,28623
723,500,223,537,91400,28624
14045,10559,3486,684,140000,28625
1038,862,176,924,214500,28626
492,320,172,675,125000,28627
139,94,45,1088,84800,28628
7,7,0,-,-,28629
7486,5693,1793,632,106000,28630
313,253,60,721,153500,28631
1932,1472,460,568,109700,28634
1656,1271,385,624,86100,28635
1903,1509,394,534,120100,28636
648,429,219,625,114700,28637
4454,2968,1486,617,112700,28638
1914,1192,722,574,171200,28640
2381,1583,798,507,105400,28642
1649,1397,252,547,108500,28643
447,404,43,-,129300,28644
18302,12610,5692,586,104900,28645
256,213,43,-,(X),28646
49,41,8,-,(X),28647
428,399,29,-,(X),28649
4131,3251,880,779,117100,28650
2680,1884,796,543,108900,28651
31,31,0,-,-,28652
1486,1255,231,(X),115500,28654
20885,14951,5934,608,113300,28655
4124,3319,805,649,132100,28657
9849,6879,2970,652,121600,28658
8165,5515,2650,581,111600,28659
882,731,151,734,152600,28660
0,0,0,-,-,28662
234,220,14,-,163000,28663
1053,890,163,551,156900,28665
133,35,98,905,-,28666
174,123,51,715,75000,28667
138,133,5,-,249400,28668
1104,751,353,595,74900,28669
1260,1073,187,489,108100,28670
206,125,81,656,139200,28671
0,0,0,-,-,28672
2162,1784,378,856,229100,28673
2854,2075,779,605,144600,28675
1530,1139,391,701,123200,28676
12578,8032,4546,709,113700,28677
2030,1496,534,486,111700,28678
817,532,285,767,144500,28679
9588,7196,2392,593,123100,28681
554,414,140,642,539600,28682
740,630,110,616,99300,28683
916,724,192,873,178800,28684
705,593,112,697,104500,28685
593,497,96,550,135300,28689
3686,2761,925,396,127100,28690
1651,1368,283,816,201800,28692
614,511,103,776,133900,28693
3452,2478,974,650,160800,28694
5125,3894,1231,595,145200,28697
830,679,151,725,168800,28698
1450,1242,208,536,202000,28701
223,184,39,744,164100,28702
8154,5233,2921,964,200700,28704
2854,2173,681,519,143900,28705
40,40,0,-,(X),28707
279,207,72,-,250500,28708
934,719,215,660,177200,28709
5417,3313,2104,739,202400,28711
7955,5756,2199,657,196600,28712
3446,2520,926,613,140700,28713
6931,5219,1712,626,139600,28714
9971,7102,2869,739,175400,28715
7121,5297,1824,658,145700,28716
805,630,175,805,459000,28717
156,140,16,-,160800,28718
2910,2081,829,572,106200,28719
42,16,26,638,250000,28720
4437,3041,1396,655,150300,28721
2716,1765,951,721,177600,28722
3305,1540,1765,586,208600,28723
8,4,4,-,-,28725
1315,726,589,697,110400,28726
1395,1157,238,1108,178300,28729
3564,2811,753,803,231500,28730
3367,2606,761,690,191500,28731
6965,5293,1672,924,187400,28732
21,21,0,-,-,28733
11993,8589,3404,716,151700,28734
103,81,22,-,(X),28735
424,294,130,842,297400,28736
8993,6743,2250,725,225000,28739
533,418,115,414,116100,28740
1894,1454,440,953,426900,28741
1039,908,131,(X),208800,28742
965,657,308,538,112700,28743
284,247,37,-,287600,28745
1121,891,230,568,258800,28746
896,771,125,663,171400,28747
4661,3599,1062,709,146100,28748
0,0,0,-,-,28749
1598,1336,262,819,203700,28751
11961,7994,3967,577,100300,28752
4837,3537,1300,690,153300,28753
2994,2213,781,635,170600,28754
1905,1518,387,674,179500,28756
128,115,13,738,396200,28757
2740,2332,408,651,221700,28759
2896,2281,615,675,95300,28761
2688,2066,622,580,99600,28762
1225,902,323,659,183100,28763
489,382,107,830,163600,28766
3009,2375,634,716,210900,28768
3060,2507,553,549,117700,28771
479,462,17,496,89100,28772
1216,1017,199,880,257800,28773
709,597,112,937,362500,28774
155,113,42,-,167600,28775
3611,2810,801,605,140100,28777
4282,2839,1443,734,147200,28778
6986,5121,1865,653,168000,28779
393,324,69,-,113400,28781
3056,2424,632,796,190400,28782
646,348,298,607,145700,28783
3091,2439,652,785,203400,28785
9609,6699,2910,746,159600,28786
7808,6290,1518,758,203900,28787
2173,1583,590,794,150400,28789
1342,1118,224,810,160300,28790
6551,5041,1510,761,191900,28791
13483,8310,5173,714,145000,28792
6511,2433,4078,695,263600,28801
13862,7488,6374,953,215800,28803
8257,5310,2947,901,280700,28804
8483,5066,3417,801,198200,28805
16570,9822,6748,842,163900,28806
2151,1700,451,557,104900,28901
585,459,126,638,163500,28902
3649,2691,958,675,146900,28904
1124,978,146,573,120800,28905
7159,5761,1398,690,156600,28906
445,437,8,-,135300,28909
794,578,216,428,80800,29001
2576,2067,509,663,72100,29003
3801,2677,1124,612,85800,29006
1017,838,179,627,78200,29009
4229,2967,1262,588,71400,29010
687,524,163,566,113800,29014
553,408,145,494,61500,29015
6612,5520,1092,1095,221400,29016
1238,944,294,607,81600,29018
9190,6593,2597,679,118400,29020
867,645,222,617,120800,29030
493,403,90,597,73300,29031
1761,1244,517,737,73700,29032
5290,3255,2035,854,114200,29033
7663,7000,663,1060,271900,29036
391,211,180,600,112100,29037
869,661,208,711,75100,29038
1293,1047,246,577,81900,29039
3418,2571,847,683,113900,29040
2079,1363,716,447,61200,29042
2040,1639,401,719,77300,29044
8693,6795,1898,1014,151400,29045
56,50,6,-,(X),29046
1426,1160,266,547,97400,29047
1872,1525,347,604,78000,29048
279,233,46,(X),91800,29051
786,558,228,585,56800,29052
6715,4937,1778,770,69400,29053
3622,3042,580,705,161900,29054
1618,1260,358,721,61400,29055
783,553,230,569,65300,29056
1719,1277,442,726,101700,29058
2217,1554,663,625,72700,29059
5369,4229,1140,913,109100,29061
70,19,51,-,-,29062
12653,10540,2113,1124,154400,29063
231,207,24,-,84800,29065
3568,2601,967,593,89300,29067
1933,1305,628,672,66500,29069
5845,4831,1014,650,113600,29070
20116,15519,4597,975,207600,29072
15865,12311,3554,846,122400,29073
26,26,0,-,222200,29074
1224,988,236,654,175600,29075
5738,4733,1005,601,115200,29078
10,7,3,-,-,29079
1146,909,237,429,57900,29080
551,419,132,638,82500,29081
203,150,53,433,73800,29082
1115,902,213,605,88000,29101
6922,5018,1904,626,92400,29102
537,403,134,594,80700,29104
455,330,125,603,73000,29105
1331,1075,256,563,56000,29107
6941,4540,2401,670,81600,29108
605,458,147,702,53800,29111
1682,1243,439,655,70700,29112
625,480,145,578,54800,29113
713,543,170,453,68600,29114
10794,5902,4892,659,79300,29115
0,0,0,-,-,29117
6332,4697,1635,733,139200,29118
24,13,11,-,115600,29122
2922,2395,527,728,75100,29123
1006,696,310,738,56900,29125
959,879,80,660,125400,29126
3542,2929,613,727,179400,29127
1786,1569,217,667,84300,29128
1040,653,387,704,99700,29129
2663,2052,611,766,186600,29130
431,357,74,743,93800,29133
3350,2467,883,734,86400,29135
927,720,207,618,64100,29137
3855,2505,1350,655,89700,29138
1923,1419,504,660,107300,29142
355,263,92,933,51400,29145
660,551,109,575,64100,29146
0,0,0,-,-,29147
3052,2203,849,414,104700,29148
16448,8898,7550,715,113400,29150
343,0,343,1086,-,29152
5811,4173,1638,807,85600,29153
10707,7930,2777,894,127500,29154
3136,2511,625,731,95300,29160
4136,2896,1240,646,87100,29161
1053,757,296,671,85500,29162
736,512,224,639,71900,29163
1710,1372,338,613,64100,29164
326,272,54,485,81700,29166
1183,874,309,714,58900,29168
10660,5703,4957,798,129300,29169
8116,5931,2185,828,129000,29170
3573,2614,959,819,93500,29172
169,124,45,-,(X),29175
1335,1036,299,589,55900,29178
5406,3808,1598,646,103000,29180
7726,2199,5527,965,155500,29201
160,110,50,1688,277100,29202
14588,7477,7111,762,87900,29203
8037,4187,3850,761,136600,29204
10841,5273,5568,753,248600,29205
7904,5195,2709,887,226500,29206
12,4,8,-,-,29207
0,0,0,-,-,29208
12928,7819,5109,870,138200,29209
16194,6231,9963,773,119700,29210
11668,8276,3392,932,163600,29212
20704,11392,9312,939,140700,29223
0,0,0,-,-,29225
15580,11229,4351,1180,163500,29229
12804,7338,5466,752,130600,29301
6840,5066,1774,694,143800,29302
8830,4102,4728,628,80900,29303
6251,2803,3448,640,95800,29306
8217,4997,3220,715,132500,29307
8860,6894,1966,820,135900,29316
182,179,3,-,31800,29320
1130,853,277,762,63600,29321
3031,2475,556,623,135400,29322
5365,4001,1364,655,99800,29323
103,86,17,-,35800,29324
5325,3325,2000,671,86300,29325
78,34,44,619,(X),29329
3075,1986,1089,638,80400,29330
58,58,0,-,45200,29331
1079,921,158,534,81300,29332
160,128,32,-,56200,29333
4880,3347,1533,808,137500,29334
1648,1360,288,623,79400,29335
0,0,0,-,-,29338
7839,5614,2225,616,76500,29340
7331,4775,2556,629,125200,29341
104,82,22,-,74200,29346
10984,9090,1894,748,128600,29349
520,422,98,766,50600,29351
1718,1288,430,525,77900,29353
434,393,41,680,87300,29355
3362,2759,603,590,137100,29356
8002,5329,2673,615,85900,29360
257,161,96,768,27400,29364
3679,3254,425,827,139800,29365
0,0,0,-,-,29368
5134,4280,854,921,166000,29369
308,268,40,840,89400,29370
1635,1204,431,548,74000,29372
66,66,0,-,30700,29373
1254,1013,241,787,136800,29374
25,16,9,-,(X),29375
2860,2256,604,751,143400,29376
353,208,145,587,57600,29377
59,7,52,956,-,29378
7722,5355,2367,603,73300,29379
1873,1467,406,674,76000,29384
2821,2016,805,679,99900,29385
5131,3648,1483,708,97100,29388
4102,1888,2214,1496,917600,29401
8607,3027,5580,878,304200,29403
348,0,348,1288,-,29404
9793,4289,5504,794,108100,29405
11550,4179,7371,863,115300,29406
15201,8201,7000,931,225600,29407
19,0,19,825,-,29409
7336,4389,2947,944,180900,29410
16430,11521,4909,1125,252300,29412
15808,10060,5748,1086,202100,29414
9672,4715,4957,866,136400,29418
7831,5233,2598,978,171400,29420
0,0,0,-,-,29423
0,0,0,-,-,29424
546,454,92,864,122300,29426
1000,862,138,728,268200,29429
2316,1866,450,729,112200,29431
1110,938,172,481,74700,29432
189,147,42,919,126800,29434
1559,1367,192,697,82200,29435
1660,1425,235,772,81300,29436
902,789,113,818,111500,29437
1179,1076,103,868,288600,29438
1038,597,441,1012,572900,29439
9945,7343,2602,646,118900,29440
20105,12390,7715,1005,153300,29445
320,278,42,-,91700,29446
887,639,248,716,86100,29448
3527,2945,582,946,200400,29449
1263,1070,193,959,120200,29450
1918,1549,369,1634,783400,29451
136,78,58,545,(X),29452
501,378,123,663,105900,29453
8569,6720,1849,1046,277700,29455
10558,7218,3340,1020,135400,29456
883,767,116,(X),167100,29458
12443,9560,2883,807,158700,29461
19912,12973,6939,1281,367800,29464
11778,9692,2086,1424,359500,29466
771,504,267,561,86100,29468
455,366,89,615,230700,29469
1749,1404,345,838,129200,29470
546,454,92,625,85900,29471
2829,2317,512,770,118600,29472
1034,939,95,577,81500,29474
980,778,202,662,77500,29475
2414,1878,536,689,86300,29477
2463,1828,635,544,108600,29479
658,531,127,479,64800,29481
808,683,125,2093,1110000,29482
25819,17786,8033,927,156500,29483
18029,12458,5571,1052,180700,29485
1085,958,127,781,309300,29487
8442,5433,3009,718,89600,29488
4497,3140,1357,1470,461600,29492
46,39,7,-,98300,29493
17847,10975,6872,724,155800,29501
9953,7168,2785,738,151200,29505
7269,4337,2932,613,97600,29506
3965,3057,908,654,78200,29510
1983,1495,488,685,121000,29511
6316,3974,2342,572,64000,29512
358,250,108,684,68400,29516
394,338,56,-,89000,29518
123,108,15,-,59000,29519
5897,3673,2224,547,83400,29520
760,470,290,543,61600,29525
15375,10933,4442,785,153300,29526
9193,6262,2931,716,122000,29527
1028,802,226,545,65200,29530
7959,5077,2882,609,81200,29532
6067,3597,2470,520,66600,29536
2050,1639,411,685,68100,29540
3227,2523,704,753,109300,29541
182,140,42,-,72800,29543
1915,1411,504,743,102300,29544
593,534,59,812,91100,29545
1074,732,342,695,62300,29546
934,741,193,653,48500,29547
12343,8328,4015,624,95900,29550
3449,2810,639,588,73200,29554
2084,1565,519,660,81700,29555
4605,2998,1607,543,68800,29556
4900,3015,1885,620,75000,29560
1115,719,396,485,58100,29563
317,257,60,475,46000,29564
2641,1916,725,533,62900,29565
7577,5609,1968,814,159800,29566
223,122,101,(X),30000,29567
5275,4130,1145,941,150400,29568
5964,4564,1400,719,94700,29569
1440,1056,384,384,50600,29570
5484,3715,1769,495,80500,29571
4278,2811,1467,809,261200,29572
4545,3231,1314,465,74100,29574
7878,5673,2205,838,188400,29575
12490,10235,2255,986,185000,29576
12177,6106,6071,847,152200,29577
13310,8394,4916,954,180300,29579
480,405,75,627,57700,29580
1805,1306,499,497,83500,29581
8006,5447,2559,842,252400,29582
2083,1650,433,518,67700,29583
1005,712,293,663,59100,29584
6136,4878,1258,1056,317100,29585
15571,10744,4827,880,160800,29588
866,719,147,495,49800,29590
1960,1391,569,560,69900,29591
435,373,62,374,42400,29592
766,570,196,472,61400,29593
61,44,17,-,55000,29594
959,682,277,688,62400,29596
4857,1786,3071,635,251900,29601
13800,8469,5331,748,140300,29605
15772,7817,7955,856,169700,29607
11728,7072,4656,669,159000,29609
10850,6066,4784,671,80000,29611
0,0,0,-,-,29613
78,12,66,488,-,29614
16023,8633,7390,788,204400,29615
10110,5897,4213,668,113800,29617
5096,3937,1159,488,94900,29620
15926,11035,4891,731,160700,29621
5763,3046,2717,590,70600,29624
11674,7635,4039,703,129100,29625
4987,3824,1163,730,117100,29626
6374,4711,1663,601,94200,29627
921,651,270,576,58600,29628
5726,2841,2885,677,125500,29630
5204,2368,2836,815,198900,29631
99,0,99,887,-,29634
598,540,58,-,143500,29635
1214,994,220,757,84800,29638
393,294,99,638,141700,29639
11656,8497,3159,696,107400,29640
11463,9163,2300,761,165800,29642
1018,884,134,(X),158700,29643
7285,5499,1786,739,118200,29644
3505,2770,735,696,84400,29645
10534,6020,4514,631,91600,29646
9985,6746,3239,705,137300,29649
13001,8843,4158,891,206300,29650
16843,12305,4538,701,148100,29651
1784,1444,340,568,112400,29653
4066,3297,769,593,94200,29654
2824,2347,477,594,77800,29655
5822,4562,1260,719,96600,29657
128,128,0,-,85600,29658
48,17,31,554,73800,29659
2247,1459,788,595,91100,29661
5916,3841,2075,846,148500,29662
868,725,143,559,159300,29664
45,18,27,-,-,29665
2768,2218,550,714,87500,29666
100,83,17,375,98600,29667
4396,3357,1039,599,101500,29669
3738,2518,1220,601,126500,29670
6873,5535,1338,649,112500,29671
5073,3956,1117,905,239600,29672
10144,7135,3009,733,134400,29673
2594,2288,306,703,236200,29676
8995,5938,3057,673,121800,29678
10298,7955,2343,948,160500,29680
18132,15285,2847,973,200200,29681
1356,1175,181,658,108300,29682
34,34,0,-,-,29683
1686,1447,239,572,82600,29684
533,483,50,-,170500,29685
280,250,30,-,112500,29686
16058,11576,4482,739,140200,29687
1756,1561,195,803,188200,29689
7287,5614,1673,714,136400,29690
4249,2936,1313,599,114700,29691
1949,1404,545,665,60300,29692
5592,4279,1313,554,111400,29693
1778,1236,542,842,134300,29696
4970,3858,1112,673,111200,29697
3490,2260,1230,654,70700,29702
1594,1280,314,549,159300,29704
7519,5289,2230,570,85500,29706
8935,8151,784,1175,245900,29707
10249,8458,1791,1154,275100,29708
2352,1802,550,568,81300,29709
11851,9422,2429,920,172500,29710
817,563,254,848,129600,29712
1127,808,319,640,77900,29714
10232,7810,2422,883,179200,29715
466,395,71,602,110000,29717
1482,1127,355,480,82000,29718
16315,11409,4906,645,111700,29720
19,0,19,531,-,29724
752,628,124,845,114900,29726
570,477,93,546,43300,29727
4012,2557,1455,646,82500,29728
853,715,138,636,87500,29729
21052,11981,9071,787,122900,29730
22133,14978,7155,833,159200,29732
0,0,0,-,-,29733
774,687,87,394,81700,29741
944,800,144,563,95700,29742
416,384,32,-,122100,29743
10676,8160,2516,785,140800,29745
10212,6519,3693,727,114500,29801
15268,12371,2897,860,184800,29803
2312,1958,354,586,117100,29805
1074,755,319,669,89700,29809
1848,1162,686,529,58400,29810
4260,3039,1221,653,80400,29812
477,307,170,659,66400,29816
1774,1338,436,539,63000,29817
582,421,161,519,70700,29819
506,412,94,465,106700,29821
2585,1841,744,547,114200,29824
41,30,11,660,73800,29826
1225,727,498,606,45600,29827
491,267,224,317,67800,29828
3614,2733,881,578,132100,29829
1500,1181,319,618,77700,29831
1995,1283,712,574,92800,29832
724,450,274,575,72000,29834
3155,2391,764,498,123600,29835
254,236,18,733,52000,29836
240,223,17,-,200700,29838
89,75,14,-,59600,29840
12964,8765,4199,697,129600,29841
3242,2323,919,547,74300,29842
544,481,63,675,64000,29843
54,48,6,-,143800,29844
428,332,96,517,55200,29845
1660,1332,328,661,77200,29847
269,234,35,519,86700,29848
64,53,11,545,96500,29849
172,101,71,-,34700,29850
2766,2019,747,665,82000,29851
2538,1905,633,535,68700,29853
1079,887,192,679,85700,29856
5540,4866,674,668,169600,29860
0,0,0,-,-,29899
5518,3212,2306,860,224200,29902
0,0,0,-,-,29904
12,0,12,-,-,29905
7447,3323,4124,966,129000,29906
4618,3546,1072,1288,239400,29907
9014,8090,924,1233,270600,29909
13367,8757,4610,1149,233300,29910
742,646,96,720,75800,29911
0,0,0,-,-,29912
215,165,50,-,395600,29915
554,436,118,778,91700,29916
1531,1159,372,580,71000,29918
4001,3290,711,833,175700,29920
100,81,19,475,47000,29921
413,349,64,(X),35400,29922
242,231,11,-,47400,29923
1493,1065,428,626,99600,29924
10237,7686,2551,1044,407400,29926
2832,1592,1240,798,119500,29927
8061,5962,2099,1115,512500,29928
430,387,43,830,74800,29929
112,100,12,-,100000,29932
343,305,38,-,83600,29934
1479,620,859,917,171800,29935
4842,3549,1293,787,88500,29936
144,118,26,810,45000,29939
1522,1237,285,870,107500,29940
293,205,88,(X),(X),29941
162,111,51,-,176300,29943
1993,1406,587,586,81500,29944
1756,1438,318,719,84600,29945
2682,1588,1094,716,271700,30002
20690,14826,5864,1198,347700,30004
12284,8362,3922,1234,360000,30005
10372,5643,4729,912,123300,30008
6129,3485,2644,1203,240400,30009
4752,3770,982,970,118600,30011
8816,4835,3981,842,105900,30012
8923,5952,2971,914,155900,30013
13109,7953,5156,833,127800,30014
17006,12738,4268,1067,106000,30016
7275,6095,1180,1288,210000,30017
12934,11284,1650,1624,190500,30019
7372,1737,5635,834,109700,30021
23528,16844,6684,1191,331400,30022
21406,18580,2826,1390,272100,30024
3260,2493,767,834,161200,30025
7121,6013,1108,1086,204500,30028
11171,6587,4584,940,332600,30030
16641,7932,8709,860,86900,30032
12916,7242,5674,1046,245000,30033
15414,9905,5509,952,93200,30034
7255,3987,3268,951,91700,30035
14840,8321,6519,952,115600,30038
13954,11019,2935,1229,136400,30039
19335,16056,3279,1194,246500,30040
19085,16051,3034,1137,293900,30041
26482,18944,7538,1136,168600,30043
27595,16607,10988,1104,140000,30044
9864,8426,1438,1367,160000,30045
11982,6853,5129,877,117700,30046
19501,14915,4586,1058,169200,30047
19346,15571,3775,1106,152500,30052
3976,3124,852,847,158000,30054
870,720,150,1080,153600,30055
816,655,161,710,136600,30056
19053,11601,7452,1052,100000,30058
12200,5081,7119,870,113200,30060
23405,18333,5072,1127,251300,30062
17579,14224,3355,1098,220800,30064
19945,15583,4362,1249,201900,30066
20059,8155,11904,965,268900,30067
12050,9818,2232,1093,339900,30068
139,22,117,666,(X),30070
7115,3335,3780,909,134200,30071
339,255,84,838,140400,30072
19997,15954,4043,1102,331400,30075
16254,9721,6533,1033,258100,30076
11117,8465,2652,1086,166200,30078
1041,529,512,714,133700,30079
25054,10455,14599,953,209500,30080
10553,6814,3739,1046,212600,30082
18849,9489,9360,869,94900,30083
13263,8873,4390,925,176200,30084
13194,10944,2250,1303,156100,30087
9184,5405,3779,984,98700,30088
13168,6535,6633,933,283400,30092
18115,5458,12657,901,106300,30093
11357,8903,2454,1012,143300,30094
25261,10758,14503,1034,171200,30096
14641,10726,3915,1281,353700,30097
19446,15278,4168,1084,191300,30101
13058,9693,3365,966,143600,30102
5449,3638,1811,753,110800,30103
1428,1089,339,749,87100,30104
814,603,211,743,145200,30105
7789,4302,3487,904,115100,30106
4863,4038,825,889,172000,30107
3017,2064,953,654,94700,30108
4837,3125,1712,687,111800,30110
2326,1882,444,644,98200,30113
18220,12643,5577,841,217900,30114
12758,10751,2007,1087,227300,30115
7795,5448,2347,895,117700,30116
13567,6315,7252,726,111800,30117
0,0,0,-,-,30118
14040,8872,5168,799,134800,30120
7749,3993,3756,867,116300,30121
8900,4346,4554,972,99800,30122
1097,797,300,510,126000,30124
8256,5322,2934,665,108600,30125
14472,10334,4138,977,177200,30126
20739,17433,3306,1131,160500,30127
11995,8863,3132,871,157000,30132
14771,10319,4452,919,105400,30134
20784,15788,4996,993,144600,30135
554,379,175,749,113100,30137
1598,1043,555,603,104100,30139
7630,5916,1714,1053,130900,30141
8297,6393,1904,849,207600,30143
19342,10825,8517,1106,167900,30144
2586,2276,310,925,142700,30145
1767,1183,584,640,93400,30147
222,181,41,725,(X),30148
22,0,22,-,-,30149
14894,10957,3937,1100,212100,30152
6710,4586,2124,702,91300,30153
16103,12583,3520,1100,120900,30157
13171,7336,5835,641,119200,30161
0,0,0,-,-,30164
14800,9015,5785,707,115200,30165
9312,4435,4877,859,86200,30168
1077,867,210,700,93100,30170
1183,1022,161,666,122600,30171
2070,1434,636,703,123000,30173
2284,1827,457,885,129100,30175
2605,1915,690,617,104100,30176
439,329,110,860,106200,30177
1212,1062,150,830,135300,30178
6148,4607,1541,887,93000,30179
12487,9427,3060,899,123300,30180
927,713,214,787,92100,30182
1703,1427,276,950,204000,30183
2653,2103,550,1122,162300,30184
1352,1023,329,739,123800,30185
2986,2534,452,1099,152200,30187
20519,16279,4240,1191,169800,30188
13157,10260,2897,1118,196600,30189
4526,2877,1649,628,114500,30204
1121,964,157,808,222100,30205
919,790,129,1043,113100,30206
11088,6736,4352,869,131900,30213
10679,8826,1853,1027,179000,30214
11799,10331,1468,1095,224400,30215
748,558,190,1108,94000,30216
3538,2491,1047,773,89900,30217
688,580,108,929,85500,30218
1715,1178,537,1003,113600,30220
1639,1072,567,574,100200,30222
12628,7327,5301,761,106500,30223
9125,5910,3215,824,124200,30224
12484,9112,3372,1042,122800,30228
3115,2195,920,823,99600,30230
7520,5684,1836,762,121200,30233
686,370,316,765,86000,30234
15830,8672,7158,885,109600,30236
11572,7027,4545,966,82100,30238
10461,6389,4072,730,131600,30240
8607,4374,4233,831,107900,30241
7506,6375,1131,1103,142500,30248
50,15,35,-,-,30250
1014,623,391,778,100700,30251
13469,11313,2156,1267,165100,30252
18600,11003,7597,1008,141000,30253
867,772,95,725,113900,30256
1647,1419,228,783,139200,30257
993,829,164,804,151600,30258
1038,857,181,1092,166600,30259
8650,4317,4333,868,81600,30260
20607,12910,7697,883,164100,30263
12258,9617,2641,1069,187800,30265
3176,2253,923,841,118400,30268
12708,9226,3482,1194,274400,30269
4807,3624,1183,1089,91900,30273
12042,5287,6755,853,72200,30274
0,0,0,-,-,30275
5171,4371,800,1025,199300,30276
7863,6642,1221,986,206800,30277
23372,15488,7884,991,121300,30281
21,15,6,-,126600,30284
191,191,0,-,124700,30285
8924,5439,3485,671,84500,30286
2919,2380,539,792,84200,30288
31,19,12,800,265600,30289
3021,2529,492,874,229800,30290
7758,3341,4417,831,88600,30291
1997,1796,201,729,163800,30292
1066,861,205,754,63600,30293
13384,10861,2523,983,117800,30294
1565,1217,348,676,136100,30295
8722,5726,2996,1132,85600,30296
8087,3417,4670,802,54900,30297
1095,214,881,723,155200,30303
10823,6480,4343,1153,458800,30305
10877,5980,4897,1095,509500,30306
8724,4591,4133,1085,391700,30307
10019,3016,7003,1065,230600,30308
12896,5787,7109,1130,283600,30309
10396,4087,6309,871,79800,30310
13290,5378,7912,793,99700,30311
11263,3514,7749,974,189400,30312
2071,680,1391,922,176400,30313
7264,2330,4934,821,81400,30314
11297,3791,7506,773,88100,30315
12381,7491,4890,989,165100,30316
5087,3351,1736,887,225800,30317
20222,8015,12207,986,167200,30318
18472,10242,8230,1264,398300,30319
0,0,0,-,-,30322
14214,5302,8912,1124,295100,30324
3004,1125,1879,1521,272400,30326
9315,7206,2109,1319,800900,30327
14995,8377,6618,1137,350300,30328
11713,3124,8589,1066,272200,30329
22121,10303,11818,890,140100,30331
0,0,0,-,-,30332
0,0,0,-,-,30334
217,0,217,961,-,30336
5148,1357,3791,743,171000,30337
13452,8369,5083,1198,402200,30338
11176,3253,7923,1101,299500,30339
9883,4155,5728,905,170800,30340
13031,5895,7136,998,237200,30341
12478,6085,6393,1045,514200,30342
12496,5258,7238,924,88800,30344
9651,5053,4598,1078,352500,30345
3223,287,2936,1323,224800,30346
24081,13831,10250,871,115700,30349
16149,5722,10427,985,422300,30350
6005,1908,4097,876,85800,30354
5147,2880,2267,898,248800,30360
1680,585,1095,1504,230300,30363
4888,3124,1764,597,69800,30401
654,455,199,713,93700,30410
817,586,231,502,51000,30411
32,29,3,-,(X),30412
716,554,162,665,56700,30413
2299,1757,542,770,118600,30415
3932,2569,1363,606,87400,30417
504,392,112,474,59100,30420
1560,1276,284,508,56100,30421
88,31,57,814,86100,30423
561,480,81,486,75900,30425
335,251,84,(X),63300,30426
3798,2614,1184,593,113300,30427
1057,632,425,475,52900,30428
78,38,40,-,112500,30429
1946,1284,662,606,75400,30434
4448,2848,1600,568,71300,30436
31,16,15,-,(X),30438
3908,2367,1541,540,88600,30439
737,514,223,516,72500,30441
2987,1888,1099,505,52400,30442
1129,669,460,499,62100,30445
564,451,113,685,72700,30446
18,18,0,-,62900,30448
36,28,8,600,(X),30449
926,586,340,908,85800,30450
17,10,7,-,(X),30451
553,495,58,721,83100,30452
2468,1440,1028,533,47700,30453
222,162,60,-,92900,30454
203,152,51,737,72600,30455
679,527,152,417,72100,30456
2434,1668,766,459,70300,30457
15827,5516,10311,779,135000,30458
0,0,0,-,-,30460
4912,3209,1703,739,149600,30461
31,17,14,575,55500,30464
4552,3150,1402,535,86000,30467
194,171,23,432,110300,30470
1741,1135,606,503,63400,30471
1022,819,203,532,82600,30473
6710,4162,2548,579,98400,30474
0,0,0,-,-,30475
1103,632,471,469,47700,30477
9288,3917,5371,757,127200,30501
7755,3603,4152,844,144200,30504
15341,11653,3688,974,195700,30506
8259,5928,2331,822,124900,30507
2297,1795,502,598,99300,30510
1322,1007,315,632,141000,30511
7617,6008,1609,591,187500,30512
4406,3339,1067,649,165500,30513
704,587,117,724,69400,30516
4069,3338,731,1091,181400,30517
15669,11544,4125,1016,175300,30518
12953,10203,2750,1150,186200,30519
1690,1169,521,675,108300,30520
1817,1508,309,513,107200,30521
420,391,29,-,184700,30522
4882,3939,943,761,159100,30523
2926,2081,845,709,144900,30525
1558,1228,330,1044,196400,30527
9131,6654,2477,693,142700,30528
3453,2083,1370,768,109900,30529
2204,1807,397,768,122200,30530
3713,2437,1276,624,130400,30531
9439,5955,3484,847,168000,30533
9948,7531,2417,965,183200,30534
2406,1751,655,717,138400,30535
3238,2543,695,723,166000,30536
677,461,216,545,217300,30537
970,841,129,685,104900,30538
6809,5090,1719,673,121300,30540
640,535,105,835,120800,30541
11576,8784,2792,987,173200,30542
1439,1136,303,862,109800,30543
331,207,124,797,168900,30545
2860,2306,554,634,180800,30546
1154,914,240,606,101000,30547
6178,5590,588,1124,229800,30548
8068,6182,1886,773,158900,30549
721,578,143,904,256100,30552
2819,1818,1001,635,129800,30553
2760,2137,623,867,132100,30554
906,543,363,460,127600,30555
1691,1399,292,561,97300,30557
2132,1555,577,754,102500,30558
1853,1540,313,856,166200,30559
1652,1401,251,655,178100,30560
430,315,115,655,73300,30562
2101,1732,369,714,116200,30563
1265,937,328,825,158800,30564
1498,1305,193,705,137200,30565
2916,1937,979,876,127700,30566
1157,883,274,788,170800,30567
898,573,325,686,159700,30568
1866,1504,362,851,196700,30571
475,432,43,525,143000,30572
74,62,12,-,298400,30573
307,158,149,588,113800,30575
960,805,155,850,151900,30576
8071,5690,2381,563,104400,30577
0,0,0,-,-,30581
1666,1265,401,725,168700,30582
8300,2722,5578,730,101100,30601
0,0,0,-,-,30602
14642,5113,9529,790,156400,30605
16450,7418,9032,797,176100,30606
3434,2146,1288,759,139700,30607
0,0,0,-,-,30609
475,341,134,813,162000,30619
4017,3372,645,1035,124600,30620
1658,1442,216,937,262000,30621
3880,2706,1174,948,186500,30622
93,93,0,-,111100,30623
1250,920,330,627,78800,30624
981,718,263,829,188200,30625
877,728,149,521,84700,30627
2435,1783,652,746,136800,30628
1710,1240,470,760,101900,30629
866,633,233,534,132500,30630
726,535,191,526,70600,30631
3107,2194,913,721,121300,30633
669,559,110,550,82200,30634
6146,4079,2067,603,83700,30635
691,612,79,1313,165500,30641
4694,3382,1312,642,326600,30642
6546,4676,1870,574,113300,30643
2472,1636,836,672,133700,30646
1265,928,337,619,103200,30648
4079,3158,921,881,181700,30650
8297,4791,3506,745,133600,30655
5579,4514,1065,851,157900,30656
431,290,141,671,84200,30660
3384,2186,1198,575,105600,30662
1153,939,214,670,184900,30663
20,19,1,-,35500,30664
31,12,19,705,(X),30665
3042,2304,738,870,132600,30666
363,306,57,964,88300,30667
747,591,156,562,79600,30668
1264,831,433,679,76200,30669
3102,2165,937,628,99200,30673
6147,5052,1095,899,217800,30677
615,487,128,476,111100,30678
13052,8846,4206,892,122400,30680
2605,1945,660,876,133600,30683
13656,8479,5177,668,119000,30701
12214,8050,4164,628,94600,30705
6179,4580,1599,659,116300,30707
107,75,32,-,85700,30708
2356,1860,496,533,141400,30710
1321,1068,253,626,79000,30711
9718,5286,4432,672,151500,30720
17106,10857,6249,663,99200,30721
1613,1333,280,676,146000,30725
0,0,0,-,-,30726
7511,5439,2072,635,93600,30728
707,498,209,625,54000,30730
1081,763,318,493,97500,30731
742,546,196,695,97400,30733
1136,922,214,719,79500,30734
1994,1457,537,634,90500,30735
14740,12153,2587,699,143300,30736
1616,1331,285,925,131000,30738
1702,1516,186,637,158800,30739
3039,2366,673,732,153400,30740
12097,7783,4314,678,87200,30741
3011,1507,1504,690,108300,30742
521,380,141,669,112100,30746
5880,3851,2029,560,80600,30747
1319,1080,239,886,279300,30750
26,26,0,-,(X),30751
3557,2709,848,661,111100,30752
2521,1823,698,675,51900,30753
3150,2309,841,755,112700,30755
69,31,38,-,107400,30756
755,555,200,822,75000,30757
1971,1641,330,622,172700,30802
289,235,54,625,63800,30803
957,648,309,647,89400,30805
49,26,23,778,56900,30807
1580,1202,378,580,96500,30808
14006,11462,2544,1400,222400,30809
750,533,217,476,66100,30810
0,0,0,-,-,30812
11385,8510,2875,1096,159800,30813
2959,2405,554,678,111600,30814
13406,9578,3828,940,103200,30815
745,476,269,628,80900,30816
3243,2429,814,579,117200,30817
308,235,73,-,65900,30818
477,360,117,658,49700,30820
333,245,88,600,47800,30821
293,207,86,-,(X),30822
628,510,118,433,48500,30823
6490,3913,2577,599,106600,30824
1590,1081,509,486,64000,30828
5049,3459,1590,488,86800,30830
1337,669,668,499,78200,30833
6401,1971,4430,605,56400,30901
261,231,30,-,170200,30903
9949,4698,5251,664,108200,30904
1127,0,1127,1177,-,30905
19966,11735,8231,792,82300,30906
18775,13368,5407,935,145900,30907
17136,8306,8830,817,145600,30909
0,0,0,-,-,30912
1050,773,277,435,58400,31001
1040,823,217,445,66100,31002
69,57,12,(X),67900,31003
6177,4808,1369,955,150100,31005
1820,1190,630,560,47200,31006
390,321,69,475,46500,31007
6997,5104,1893,866,132600,31008
571,436,135,642,70800,31009
340,257,83,516,91500,31011
587,396,191,451,51600,31012
4397,3300,1097,606,82000,31014
8150,4717,3433,603,99200,31015
533,406,127,(X),54200,31016
663,568,95,539,69500,31017
487,355,132,569,75300,31018
832,607,225,594,90400,31019
806,646,160,725,59000,31020
10306,6174,4132,562,100300,31021
533,411,122,544,118600,31022
5860,3673,2187,585,73800,31023
8089,5864,2225,657,151500,31024
539,506,33,704,136400,31025
3673,2270,1403,622,52800,31027
1962,1199,763,952,161000,31028
5834,4027,1807,694,129700,31029
6224,3890,2334,627,94000,31030
2182,1662,520,607,74000,31031
5028,3981,1047,834,143600,31032
918,676,242,769,84600,31033
474,380,94,625,82100,31035
4349,2725,1624,638,120400,31036
1222,731,491,496,48300,31037
332,285,47,584,170800,31038
0,0,0,-,-,31039
379,243,136,446,62300,31041
581,497,84,620,78700,31042
1098,727,371,457,58700,31044
35,18,17,-,(X),31045
1166,1108,58,714,152900,31046
4092,3430,662,980,184900,31047
650,530,120,532,76100,31049
425,346,79,769,(X),31050
87,49,38,273,53800,31051
3184,2842,342,1013,142800,31052
613,476,137,789,63500,31054
2469,1417,1052,573,61100,31055
774,593,181,655,85900,31057
614,540,74,657,70200,31058
963,734,229,607,64000,31060
15469,8340,7129,674,106900,31061
9,0,9,-,-,31062
1927,1050,877,556,71600,31063
3554,2428,1126,782,104700,31064
321,234,87,564,68400,31065
506,467,39,-,127100,31066
112,105,7,-,35800,31067
1392,832,560,558,59900,31068
6911,4695,2216,721,135400,31069
372,268,104,450,71500,31070
480,356,124,496,63300,31071
538,381,157,504,65800,31072
990,768,222,660,76600,31075
1376,1063,313,566,59800,31076
561,385,176,486,47900,31077
1190,757,433,653,67000,31078
882,657,225,486,85900,31079
100,64,36,-,53200,31081
3799,2636,1163,504,85900,31082
124,84,40,588,40000,31083
29,9,20,-,(X),31084
393,320,73,812,107100,31085
2850,2238,612,630,67000,31087
19595,13188,6407,874,133300,31088
1697,1084,613,619,74100,31089
244,183,61,521,66000,31090
1380,879,501,305,62000,31091
2721,1673,1048,581,90600,31092
11424,5788,5636,745,93500,31093
450,326,124,576,98800,31094
2318,1573,745,513,65700,31096
470,336,134,910,102700,31097
944,0,944,1077,-,31098
3408,757,2651,551,89700,31201
11954,5487,6467,698,94200,31204
9551,4153,5398,693,59500,31206
3,3,0,-,-,31207
12893,7520,5373,874,197500,31210
6289,3751,2538,673,99700,31211
0,0,0,-,-,31213
5641,4493,1148,738,153400,31216
6272,3951,2321,641,70100,31217
5129,3280,1849,861,149400,31220
1674,695,979,727,117800,31301
3099,2436,663,936,136600,31302
801,653,148,744,115100,31303
0,0,0,-,-,31304
2521,1592,929,598,112400,31305
383,368,15,-,108600,31307
2676,1964,712,916,114100,31308
308,193,115,(X),95600,31309
5546,4480,1066,911,154800,31312
15513,7437,8076,892,122300,31313
0,0,0,-,-,31314
2431,17,2414,1171,(X),31315
3461,2332,1129,631,120300,31316
214,189,25,-,(X),31318
3463,2621,842,904,132800,31320
2573,1951,622,726,121400,31321
8854,5727,3127,1180,171200,31322
548,433,115,738,83800,31323
7628,5184,2444,1240,228500,31324
6792,4762,2030,991,164300,31326
147,147,0,-,-,31327
1356,945,411,1219,355700,31328
3007,2217,790,853,122700,31329
2593,2350,243,660,103700,31331
8272,2397,5875,885,246000,31401
11293,5282,6011,893,111200,31404
13780,7219,6561,963,173500,31405
13425,7690,5735,952,169900,31406
4035,2682,1353,986,169700,31407
3359,1276,2083,814,103100,31408
0,0,0,-,-,31409
9909,7295,2614,1121,238200,31410
3625,3433,192,1697,456100,31411
4442,1800,2642,766,83400,31415
21062,10481,10581,947,157900,31419
5894,3327,2567,628,81300,31501
7974,5454,2520,628,77800,31503
3537,2427,1110,584,63700,31510
962,824,138,400,83200,31512
6017,4064,1953,495,73900,31513
5414,4041,1373,546,99700,31516
224,193,31,452,84600,31518
1348,992,356,528,80400,31519
8781,3999,4782,723,89600,31520
7300,5180,2120,1221,341500,31522
5062,4141,921,866,149500,31523
0,0,0,-,-,31524
10649,6010,4639,800,129300,31525
322,207,115,930,450000,31527
323,279,44,292,64500,31532
5918,3309,2609,562,94600,31533
4057,2938,1119,553,77700,31535
2941,2288,653,705,86600,31537
5136,3880,1256,491,72300,31539
1111,783,328,544,75000,31542
1618,1370,248,340,60700,31543
285,205,80,602,68500,31544
5687,3622,2065,665,82100,31545
2314,1612,702,572,112200,31546
80,0,80,1011,-,31547
7668,4912,2756,921,142800,31548
997,539,458,573,42100,31549
305,164,141,-,(X),31550
400,265,135,490,53100,31551
347,347,0,-,56800,31552
1796,1420,376,493,76200,31553
1801,1434,367,552,58600,31554
925,811,114,650,100100,31555
20,8,12,-,(X),31556
1035,789,246,793,85700,31557
7602,3838,3764,941,166200,31558
1068,777,291,543,84700,31560
135,110,25,-,-,31561
696,584,112,483,74900,31562
581,477,104,595,59400,31563
765,664,101,1028,162900,31565
1357,1274,83,-,61700,31566
255,207,48,-,113400,31567
369,326,43,(X),81600,31568
2030,1552,478,693,127900,31569
11740,4740,7000,647,80800,31601
13208,5874,7334,791,138000,31602
7658,4579,3079,962,158300,31605
1271,1045,226,636,85800,31606
3798,2476,1322,681,105800,31620
725,596,129,425,74000,31622
26,20,6,-,(X),31623
414,356,58,490,81400,31624
574,410,164,604,103800,31625
1344,991,353,690,106100,31626
109,63,46,633,112500,31627
245,177,68,713,121600,31629
166,96,70,380,40500,31630
214,170,44,711,48900,31631
3837,2946,891,757,121300,31632
2198,1511,687,468,62500,31634
2140,1141,999,603,76000,31635
3541,2407,1134,648,144600,31636
1214,925,289,662,70400,31637
425,178,247,547,59200,31638
3855,2874,981,503,86700,31639
629,469,160,713,120600,31641
1606,1079,527,508,73900,31642
3464,2363,1101,587,91800,31643
2146,1554,592,634,103400,31645
1261,824,437,748,59500,31647
415,234,181,656,31000,31648
443,370,73,954,152300,31649
1208,811,397,510,66000,31650
0,0,0,-,-,31698
0,0,0,-,-,31699
7864,2482,5382,612,73400,31701
11274,5569,5705,660,72500,31705
10990,4311,6679,731,111400,31707
5910,3201,2709,649,98500,31709
328,256,72,(X),76000,31711
414,296,118,517,68500,31712
2279,1521,758,585,73800,31714
970,757,213,522,79500,31716
3429,2022,1407,562,68300,31719
175,63,112,626,87600,31720
7651,5615,2036,868,159600,31721
152,126,26,534,65300,31722
3609,2385,1224,592,79700,31730
653,553,100,666,139200,31733
395,224,171,632,148900,31735
830,572,258,627,94600,31738
159,65,94,796,83100,31743
1016,726,290,589,76000,31744
66,47,19,-,48300,31747
832,591,241,660,75600,31749
6810,4433,2377,611,82400,31750
256,244,12,-,92700,31756
3983,2651,1332,788,143000,31757
8271,5742,2529,927,154000,31763
503,388,115,500,80300,31764
1206,888,318,509,101800,31765
8103,4481,3622,627,77700,31768
1936,1434,502,655,68600,31771
195,182,13,-,84100,31772
1309,933,376,715,88800,31773
2207,1551,656,548,68200,31774
1069,776,293,580,56200,31775
1066,845,221,546,87200,31778
3110,1986,1124,545,72800,31779
792,590,202,618,77900,31780
690,509,181,909,64000,31781
375,363,12,-,85300,31783
288,174,114,693,75600,31784
475,369,106,577,92200,31787
3605,2590,1015,494,85400,31788
470,369,101,839,59800,31789
600,474,126,547,66600,31790
4613,3243,1370,626,76600,31791
9592,5182,4410,715,126600,31792
3125,2249,876,644,133700,31793
9309,4676,4633,568,102700,31794
852,659,193,661,69100,31795
455,361,94,550,83600,31796
345,252,93,-,67300,31798
893,759,134,665,101000,31801
2258,1482,776,473,93200,31803
1978,1844,134,988,216500,31804
1050,694,356,635,62900,31805
1851,1218,633,645,96400,31806
1016,821,195,897,204300,31807
2455,2156,299,1020,219600,31808
81,65,16,-,101800,31810
1914,1554,360,1114,214200,31811
191,150,41,(X),29700,31812
124,95,29,-,(X),31814
746,444,302,553,53100,31815
2014,1056,958,804,76200,31816
3231,2947,284,1564,267300,31820
60,48,12,-,18200,31821
2156,1569,587,727,141200,31822
283,200,83,628,123900,31823
736,615,121,560,42500,31824
974,680,294,501,54100,31825
931,775,156,778,88500,31826
956,683,273,524,55400,31827
362,334,28,-,253200,31829
807,537,270,573,97800,31830
1180,998,182,496,144300,31831
83,65,18,-,48900,31832
3045,1752,1293,744,117500,31833
410,327,83,414,72300,31836
3339,605,2734,529,139700,31901
7670,2563,5107,614,64800,31903
13273,6831,6442,839,158200,31904
3333,19,3314,1403,108800,31905
8827,3819,5008,694,111200,31906
19932,11547,8385,871,110200,31907
14706,7968,6738,1002,158400,31909
10216,8016,2200,1440,222200,32003
2127,1793,334,788,87800,32008
1114,914,200,796,146300,32009
4861,3764,1097,813,130100,32011
6534,5268,1266,840,109300,32024
7466,4203,3263,824,106100,32025
0,0,0,-,-,32026
1694,1386,308,1100,134300,32033
13485,10021,3464,1172,244700,32034
3353,2906,447,769,95200,32038
2379,1899,480,607,135900,32040
8696,6651,2045,785,155300,32043
630,520,110,(X),96700,32044
3230,2494,736,843,111900,32046
2498,1701,797,585,68200,32052
1510,1222,288,793,69000,32053
3338,2338,1000,654,88400,32054
5952,4146,1806,711,96200,32055
1265,1001,264,656,96000,32058
871,683,188,696,85100,32059
8298,6058,2240,680,100200,32060
56,34,22,-,-,32061
957,761,196,820,137600,32062
4306,3377,929,718,122400,32063
2464,1002,1462,633,82200,32064
11884,8612,3272,1152,156900,32065
1983,1513,470,543,111200,32066
17119,13616,3503,1055,136000,32068
1216,826,390,638,72100,32071
98,98,0,-,72700,32072
14768,9473,5295,914,145800,32073
190,19,171,1077,(X),32079
9919,6846,3073,1044,291900,32080
2321,1834,487,1443,338700,32081
13044,10519,2525,1154,425500,32082
573,292,281,339,85600,32083
12457,7320,5137,948,154700,32084
11030,7912,3118,1049,166300,32086
1347,957,390,692,73200,32087
5557,3820,1737,701,84100,32091
10408,8741,1667,1443,239200,32092
1069,891,178,823,78800,32094
2842,1997,845,1330,162500,32095
1032,793,239,630,89600,32096
5588,4354,1234,1039,160500,32097
1043,881,162,808,77900,32102
2816,1953,863,688,84600,32110
2803,2020,783,535,75600,32112
2072,1794,278,682,80000,32113
12951,4117,8834,738,89100,32114
9500,4714,4786,791,76400,32117
8526,5013,3513,836,168000,32118
9465,5856,3609,835,117500,32119
1233,1028,205,1489,211000,32124
12622,9693,2929,961,150400,32127
7288,6382,906,1149,210300,32128
9116,6218,2898,1011,102300,32129
1811,1527,284,946,125600,32130
1695,1253,442,761,148300,32131
2883,2275,608,933,106800,32132
80,80,0,-,(X),32133
3070,2559,511,793,75000,32134
3167,2432,735,969,200300,32136
14895,11810,3085,1098,187500,32137
478,428,50,-,51400,32139
380,380,0,-,82200,32140
7315,6194,1121,974,125600,32141
1777,1467,310,584,79800,32145
79,70,9,-,(X),32147
4068,2968,1100,669,59900,32148
125,125,0,-,148500,32157
15029,12236,2793,914,161900,32159
29581,28485,1096,1617,236900,32162
15228,11650,3578,1091,152800,32164
10763,8015,2748,957,165200,32168
4944,3621,1323,1212,283000,32169
19838,15298,4540,977,166200,32174
6764,5252,1512,973,172100,32176
9762,6341,3421,662,89000,32177
2895,2180,715,671,68100,32179
1292,927,365,636,114800,32180
706,602,104,586,91500,32181
715,517,198,705,88200,32187
2783,2560,223,657,84100,32189
276,214,62,529,119100,32190
438,321,117,335,144600,32193
1249,1107,142,943,147800,32195
1683,217,1466,508,112900,32202
3576,923,2653,863,152600,32204
12710,6163,6547,820,114300,32205
6655,2837,3818,726,74400,32206
14260,7368,6892,786,136100,32207
11940,7199,4741,889,79400,32208
12388,6600,5788,736,66000,32209
22966,12761,10205,893,102700,32210
12036,5859,6177,786,102700,32211
264,0,264,1300,-,32212
15282,7983,7299,894,124500,32216
8049,4431,3618,839,162300,32217
19970,13177,6793,900,133300,32218
3959,3273,686,996,123500,32219
4386,3377,1009,820,125500,32220
9533,7181,2352,1161,136200,32221
3238,2663,575,1285,147500,32222
9483,7746,1737,1084,224500,32223
14486,8539,5947,1129,233900,32224
19452,13815,5637,1102,171200,32225
5807,4784,1023,1621,180600,32226
344,9,335,1354,-,32227
0,0,0,-,-,32228
8958,4890,4068,1023,201700,32233
2326,1807,519,780,104300,32234
21251,13349,7902,921,103200,32244
19020,11136,7884,1102,134800,32246
11933,7500,4433,1156,254300,32250
4557,2590,1967,901,70400,32254
18606,7142,11464,1067,251100,32256
14846,9441,5405,934,164400,32257
10747,7901,2846,1271,193900,32258
13737,11776,1961,1696,283300,32259
2948,1951,997,1143,308500,32266
11006,6152,4854,860,136200,32277
12759,3846,8913,882,138300,32301
19426,9929,9497,990,143200,32303
16999,2331,14668,846,87200,32304
7658,4528,3130,775,93300,32305
10227,5143,5084,966,190300,32308
11919,9510,2409,1071,238800,32309
6543,2931,3612,713,94000,32310
7880,4977,2903,1160,181000,32311
12212,10082,2130,1204,279600,32312
5202,4731,471,1311,225500,32317
1380,1026,354,726,124800,32320
1664,1199,465,561,77200,32321
1306,917,389,688,101400,32322
151,96,55,-,46300,32323
1531,1025,506,605,94400,32324
9176,6925,2251,833,123700,32327
1273,946,327,694,146500,32328
225,146,79,684,87000,32330
1698,1392,306,805,75400,32331
627,398,229,623,55100,32332
4484,3346,1138,694,154200,32333
769,602,167,586,66600,32334
683,639,44,-,83800,32336
3721,2749,972,554,82700,32340
1232,946,286,890,135400,32343
4736,3539,1197,694,150700,32344
723,422,301,861,114800,32346
3028,2515,513,615,76300,32347
3536,2591,945,530,83800,32348
583,529,54,575,83300,32350
6686,4469,2217,676,89000,32351
2179,1660,519,828,87000,32352
120,74,46,(X),110400,32355
61,61,0,-,(X),32356
909,739,170,677,128600,32358
785,550,235,970,130900,32359
64,57,7,-,82600,32361
0,0,0,-,-,32399
9429,4886,4543,815,103900,32401
811,0,811,1305,-,32403
13597,9373,4224,884,142200,32404
12411,6461,5950,865,165400,32405
4048,1883,2165,1091,203200,32407
7041,4311,2730,938,214100,32408
3352,2849,503,757,138600,32409
522,332,190,1175,195700,32410
6079,3796,2283,1008,187700,32413
788,625,163,730,81000,32420
1777,1449,328,734,76000,32421
398,346,52,774,79200,32423
2144,1621,523,638,76500,32424
4583,3473,1110,623,86100,32425
330,261,69,663,72500,32426
439,363,76,550,81700,32427
5517,4280,1237,677,87600,32428
446,425,21,-,72700,32430
1664,1330,334,661,69400,32431
23,23,0,-,-,32432
5753,4199,1554,795,88600,32433
2782,2111,671,608,108200,32435
274,240,34,671,73700,32437
1372,1166,206,690,70100,32438
3186,2286,900,925,178700,32439
2077,1453,624,648,84500,32440
1418,1026,392,520,89600,32442
998,752,246,669,75700,32443
7767,5424,2343,980,182300,32444
481,355,126,579,86300,32445
3705,2642,1063,723,146900,32446
0,0,0,-,-,32447
3943,2603,1340,460,90600,32448
300,263,37,-,67500,32449
1709,1231,478,729,75900,32455
3103,2211,892,948,170200,32456
5481,3648,1833,1201,297700,32459
1368,1101,267,444,84600,32460
9,9,0,-,-,32461
1188,870,318,604,74000,32462
53,30,23,450,81700,32463
1755,1612,143,449,76600,32464
2378,1788,590,760,93800,32465
2124,1757,367,957,115500,32466
4416,2049,2367,743,104300,32501
1278,715,563,785,102500,32502
11888,7236,4652,836,128200,32503
9443,5441,4002,889,149600,32504
10113,5441,4672,836,68800,32505
13631,7636,5995,932,109900,32506
11576,6601,4975,900,137700,32507
450,0,450,1148,-,32508
0,0,0,-,-,32509
0,0,0,-,-,32511
16085,7934,8151,929,134000,32514
13601,10338,3263,1030,114900,32526
51,0,51,-,-,32530
1980,1610,370,921,120800,32531
9783,7981,1802,869,149500,32533
5714,3967,1747,926,108600,32534
1737,1200,537,590,74800,32535
8155,5862,2293,1028,178600,32536
8887,6226,2661,1033,124700,32539
7354,4750,2604,1282,320700,32541
630,3,627,1290,-,32542
312,0,312,1438,-,32544
14434,6993,7441,918,167500,32547
8693,4651,4042,971,155700,32548
3392,2411,981,1160,319200,32550
3573,2488,1085,1250,350700,32561
9401,6993,2408,1023,192600,32563
1019,696,323,986,170000,32564
2147,1862,285,762,104300,32565
13259,9225,4034,1221,196800,32566
1345,1108,237,709,113300,32567
1071,928,143,1375,101400,32568
4720,3154,1566,1079,167500,32569
11375,7683,3692,910,122500,32570
11139,8549,2590,945,158600,32571
1667,1390,277,644,131000,32577
12326,9495,2831,1052,247100,32578
4523,2830,1693,1042,239900,32579
1574,1029,545,1056,191700,32580
8761,6506,2255,1007,124800,32583
7719,2031,5688,764,116000,32601
2064,339,1725,714,269000,32603
9520,6735,2785,1033,171600,32605
9407,4634,4773,1109,197600,32606
11883,4034,7849,836,170400,32607
19355,7270,12085,886,208400,32608
6511,3556,2955,793,93300,32609
5,0,5,-,-,32612
6021,4847,1174,922,173400,32615
395,171,224,912,98500,32616
1542,1248,294,578,120900,32617
3026,2402,624,910,161800,32618
1741,1354,387,657,104300,32619
2036,1735,301,548,71200,32621
440,354,86,585,116100,32622
653,546,107,677,129000,32625
3429,2390,1039,624,88700,32626
1439,1067,372,641,80800,32628
213,213,0,-,238100,32631
20,20,0,-,-,32639
4484,3492,992,742,100200,32640
4509,2740,1769,771,97700,32641
4032,3368,664,904,139700,32643
189,150,39,(X),88300,32648
5723,4447,1276,915,174300,32653
5286,4395,891,900,99000,32656
91,72,19,844,102600,32658
296,256,40,875,73100,32664
2417,1878,539,696,136600,32666
1618,1260,358,710,167200,32667
1824,1431,393,700,117000,32668
4238,3469,769,923,167300,32669
4016,3221,795,639,66900,32680
83,83,0,-,-,32681
50,46,4,-,54200,32683
1992,1373,619,672,117100,32686
196,185,11,-,(X),32692
4365,3279,1086,699,87300,32693
839,601,238,675,79000,32694
4215,3273,942,699,111000,32696
116,8,108,1049,(X),32697
8584,4790,3794,977,130100,32701
1148,608,540,1615,77300,32702
16139,10019,6120,963,121000,32703
14136,9425,4711,1038,123100,32707
14979,11417,3562,1096,199600,32708
896,791,105,842,88500,32709
15292,12749,2543,1121,172300,32712
8014,6857,1157,1067,151500,32713
12872,6700,6172,1040,144400,32714
11395,8051,3344,882,135900,32720
12211,7973,4238,983,128700,32724
15941,12308,3633,1051,111000,32725
7909,5421,2488,786,114900,32726
2287,1198,1089,844,135300,32730
1524,1348,176,876,234100,32732
1807,1551,256,1120,93500,32735
3338,2889,449,850,188000,32736
14892,11515,3377,1059,106700,32738
1431,1133,298,844,106800,32744
14855,9987,4868,1265,248800,32746
7864,6179,1685,1143,170000,32750
8487,6052,2435,1256,237700,32751
3963,3478,485,811,122100,32754
10351,7089,3262,922,165200,32757
1062,775,287,721,150200,32759
8701,5374,3327,1025,90800,32763
1295,1138,157,1022,121600,32764
19005,13265,5740,1271,226400,32765
4678,4151,527,1404,255700,32766
926,688,238,707,82100,32767
17175,10657,6518,1010,149700,32771
9841,6020,3821,908,96000,32773
3644,3111,533,969,164600,32776
8297,6411,1886,917,113400,32778
10263,8426,1837,1324,259400,32779
14871,10118,4753,823,108400,32780
4002,2902,1100,720,119100,32784
10134,6599,3535,953,355000,32789
20171,9542,10629,995,165700,32792
8253,5932,2321,868,89000,32796
1355,1136,219,924,68800,32798
6981,1588,5393,1094,285700,32801
9137,5151,3986,1039,203000,32803
8177,4968,3209,1145,252500,32804
8001,2815,5186,746,90300,32805
11241,6594,4647,964,182500,32806
11363,5100,6263,929,100400,32807
16544,6848,9696,903,74700,32808
9254,4803,4451,880,111600,32809
12484,6333,6151,968,102800,32810
14610,3988,10622,961,71600,32811
14333,7877,6456,994,166500,32812
3023,1517,1506,1541,417200,32814
11812,6544,5268,1106,153700,32817
15559,8711,6848,982,116500,32818
9791,6557,3234,1203,249900,32819
2687,2296,391,1425,198400,32820
7481,3103,4378,1124,149400,32821
21714,8608,13106,942,88100,32822
11835,7989,3846,1224,146700,32824
19966,11842,8124,1090,153700,32825
7547,4194,3353,962,119100,32826
2660,1573,1087,1466,257000,32827
20289,12994,7295,1275,199200,32828
6429,4477,1952,1347,161200,32829
8,2,6,-,-,32830
33,12,21,-,-,32831
6057,3691,2366,1370,248700,32832
3356,2632,724,1258,184100,32833
15955,7275,8680,1137,187600,32835
6318,4127,2191,1082,401200,32836
17736,10002,7734,1253,179300,32837
17921,4707,13214,932,100000,32839
11097,5420,5677,791,99200,32901
5991,4492,1499,1140,264200,32903
10617,8120,2497,1089,159900,32904
9705,5338,4367,798,88900,32905
14835,11421,3414,1048,105000,32907
3481,2717,764,1214,103200,32908
10592,8354,2238,894,110800,32909
5539,3135,2404,815,169100,32920
5964,2623,3341,645,82600,32922
370,0,370,1227,-,32925
8220,6599,1621,870,119900,32926
8885,7150,1735,1040,101700,32927
7070,4362,2708,1003,251800,32931
7194,5927,1267,1045,200900,32934
17259,10706,6553,840,105800,32935
10774,7827,2947,1172,221300,32937
13828,11491,2337,1221,205400,32940
2024,1351,673,721,117600,32948
945,847,98,(X),248600,32949
1525,1378,147,1487,244300,32950
5154,4255,899,1338,282800,32951
8198,6661,1537,1114,206000,32952
9628,6880,2748,864,182400,32953
14734,10965,3769,1020,165400,32955
10676,8571,2105,981,144700,32958
8869,4800,4069,794,116200,32960
9186,6884,2302,819,93500,32962
7200,6596,604,1236,519000,32963
7644,5432,2212,881,102500,32966
7212,4990,2222,849,167100,32967
4900,4482,418,1024,198500,32968
166,114,52,-,99200,32970
4243,3564,679,834,64800,32976
123,89,34,-,380900,33001
6755,3195,3560,1108,168900,33004
19197,10684,8513,1064,144300,33009
14792,4533,10259,897,166100,33010
22854,11232,11622,1031,154300,33012
9484,5599,3885,1012,168900,33013
13538,6218,7320,1098,192600,33014
20631,12344,8287,1201,173100,33015
13963,7799,6164,1183,139200,33016
12756,9527,3229,1341,185800,33018
7089,5188,1901,1490,343600,33019
17857,6083,11774,921,150200,33020
18312,12216,6096,1163,197900,33021
19959,13507,6452,1145,146400,33023
22838,15244,7594,1219,162700,33024
21770,10716,11054,1410,158800,33025
11159,8951,2208,1572,197700,33026
21412,17833,3579,1488,233800,33027
8298,6409,1889,1817,313500,33028
12864,11422,1442,2075,316600,33029
9552,3979,5573,901,121000,33030
2121,1787,334,1369,320900,33031
10836,6716,4120,1158,134000,33032
15011,7496,7515,1170,119900,33033
4917,1853,3064,910,76700,33034
4755,2311,2444,1233,101200,33035
1470,1147,323,1345,622500,33036
4600,3410,1190,1298,350700,33037
66,40,26,-,-,33039
12174,5764,6410,1456,393700,33040
2825,2098,727,1673,433700,33042
1949,1465,484,1296,331900,33043
3305,2015,1290,1158,342500,33050
391,259,132,1556,497600,33051
8862,4531,4331,823,105500,33054
11760,8991,2769,1226,130900,33055
9597,6166,3431,1134,130300,33056
12654,5851,6803,994,171200,33060
12329,8334,3995,1176,286100,33062
21038,15099,5939,1222,118300,33063
19771,13078,6693,1089,121900,33064
17576,8990,8586,1174,206400,33065
8423,6866,1557,1099,91300,33066
8924,6671,2253,1438,388100,33067
14478,8102,6376,1216,119000,33068
10931,5672,5259,1141,128900,33069
2069,1428,641,1283,390600,33070
12515,8469,4046,1380,291900,33071
10221,6157,4064,1422,255400,33073
9796,7858,1938,2191,407200,33076
0,0,0,-,-,33101
275,230,45,-,(X),33109
0,0,0,-,-,33122
19190,5107,14083,896,161300,33125
17319,6224,11095,1064,150000,33126
9112,2817,6295,869,138400,33127
2861,278,2583,716,94400,33128
6501,3160,3341,1492,344800,33129
10661,1560,9101,901,165400,33130
8338,2609,5729,1987,426000,33131
5235,1128,4107,1772,335800,33132
13504,6642,6862,1227,463900,33133
16493,8885,7608,1149,371000,33134
13819,2786,11033,881,220300,33135
4972,868,4104,696,101600,33136
9137,2673,6464,1228,274600,33137
11768,5061,6707,892,329800,33138
20149,6431,13718,1206,376600,33139
9809,5419,4390,1389,490200,33140
16620,5201,11419,1069,279200,33141
17626,4921,12705,807,105400,33142
12122,7220,4902,1167,419900,33143
8519,4865,3654,1125,223700,33144
11296,5215,6081,1255,264400,33145
3756,2991,765,2113,700400,33146
13013,5941,7072,859,104300,33147
4570,3401,1169,2349,914300,33149
8621,3161,5460,772,123300,33150
6367,3289,3078,1595,483100,33154
14240,10111,4129,1333,264200,33155
11229,7899,3330,1369,705600,33156
19806,13305,6501,1003,220700,33157
2191,1981,210,"3,500+",496000,33158
19187,11382,7805,1362,260800,33160
15840,6527,9313,961,163400,33161
13249,7403,5846,988,143500,33162
16574,11383,5191,1214,232900,33165
7595,3783,3812,1086,255300,33166
5497,3055,2442,978,124800,33167
6564,5078,1486,1181,124000,33168
12218,6398,5820,990,145800,33169
3353,1826,1527,1153,171200,33170
12858,6042,6816,1268,111500,33172
11529,8281,3248,1330,245600,33173
9119,5009,4110,1157,182800,33174
15362,11830,3532,1384,227900,33175
17056,11544,5512,1198,321700,33176
14209,10992,3217,1308,166500,33177
13019,6959,6060,1825,313200,33178
15336,10271,5065,1138,110400,33179
15391,10223,5168,1667,328400,33180
7443,3288,4155,1086,174900,33181
3793,3257,536,1720,249700,33182
11882,8271,3611,1324,176500,33183
6411,4832,1579,1304,192200,33184
7708,6619,1089,2103,275100,33185
21822,15607,6215,1424,215900,33186
4534,4095,439,779,242000,33187
7739,4670,3069,932,175900,33189
4085,1965,2120,1123,169700,33190
13827,9273,4554,1291,202500,33193
1428,1307,121,1619,249100,33194
12915,9155,3760,1480,239500,33196
7221,3670,3551,1562,442700,33301
9701,3513,6188,1045,321700,33304
6561,4099,2462,1073,324700,33305
1683,1033,650,961,460400,33306
16135,10628,5507,1150,323700,33308
12543,7567,4976,1131,141100,33309
20932,9227,11705,985,109700,33311
18397,10369,8028,1147,183100,33312
19743,9305,10438,980,82400,33313
8030,3762,4268,1166,133700,33314
5789,3052,2737,1148,207100,33315
5311,2843,2468,1008,493700,33316
12082,9126,2956,1242,230400,33317
18210,12273,5937,1111,88200,33319
20189,14670,5519,1193,126100,33321
16175,12853,3322,1422,115200,33322
6488,4988,1500,1596,232300,33323
18446,10850,7596,1439,175100,33324
9597,7438,2159,1453,223600,33325
11089,7516,3573,1697,310300,33326
6769,5404,1365,2629,444900,33327
9974,8030,1944,1319,284700,33328
4328,3945,383,2214,409200,33330
7163,5891,1272,2037,393600,33331
2862,2475,387,2489,498100,33332
12328,6401,5927,1040,184800,33334
11338,6618,4720,1216,162200,33351
11070,3975,7095,1059,169800,33401
4636,2116,2520,1035,133000,33403
10107,5797,4310,1000,110600,33404
7341,4242,3099,979,175300,33405
8638,5402,3236,1103,141800,33406
10778,4763,6015,914,132100,33407
8792,6350,2442,1167,269600,33408
10808,4878,5930,1076,116900,33409
14783,9826,4957,1350,258700,33410
23580,17366,6214,1210,206600,33411
4845,4190,655,1672,279500,33412
4771,2943,1828,1265,191600,33413
18627,14113,4514,1474,286700,33414
15932,9164,6768,1038,78100,33415
13984,8575,5409,964,62300,33417
16056,12408,3648,1451,328600,33418
9002,5641,3361,1376,138300,33426
13647,9960,3687,1440,199300,33428
6421,2475,3946,621,93300,33430
6751,4617,2134,1540,320700,33431
9816,5355,4461,1302,490600,33432
19585,12583,7002,1561,244800,33433
9877,8003,1874,899,185800,33434
13195,7865,5330,1170,115900,33435
18262,13453,4809,1274,159900,33436
18214,15861,2353,1331,228300,33437
127,112,15,-,75600,33438
6099,4401,1698,741,68800,33440
11189,5603,5586,1069,165000,33441
13845,9947,3898,1394,104700,33442
8271,4571,3700,1128,182400,33444
13440,8863,4577,1344,133100,33445
12111,10502,1609,902,173900,33446
3917,3699,218,1872,377200,33449
9515,7386,2129,890,209500,33455
19951,13741,6210,1405,276900,33458
10997,5095,5902,940,145600,33460
14189,7141,7048,1010,89700,33461
11864,7480,4384,1024,137500,33462
17044,11920,5124,1145,133900,33463
19465,17179,2286,1512,221500,33467
6437,5461,976,1033,288700,33469
7808,7080,728,1629,228300,33470
2005,1385,620,655,75600,33471
8128,7421,707,1442,243300,33472
2691,2393,298,2934,454600,33473
2523,1139,1384,529,84400,33476
7275,5757,1518,1423,347400,33477
4190,3864,326,1762,312600,33478
5560,4850,710,1379,700600,33480
6163,4347,1816,1422,362200,33483
13740,11081,2659,1199,94900,33484
8737,6812,1925,1415,330100,33486
8072,6285,1787,1568,317000,33487
607,329,278,691,92700,33493
9421,8153,1268,1674,331800,33496
4932,4666,266,2616,328000,33498
38,38,0,-,242300,33503
10357,6656,3701,956,134500,33510
20437,9973,10464,1100,155300,33511
3803,3021,782,654,89300,33513
630,448,182,803,98600,33514
197,166,31,625,88600,33521
6528,4626,1902,705,94400,33523
7152,5260,1892,757,122500,33525
4412,3005,1407,827,183200,33527
4622,2770,1852,882,129600,33534
1922,1520,402,548,85100,33538
3703,2685,1018,721,82900,33540
8658,7074,1584,855,67500,33541
9820,7198,2622,825,69500,33542
7933,6448,1485,1244,157500,33543
8365,6034,2331,1314,195900,33544
4746,3689,1057,1284,160600,33545
7133,5883,1250,1591,251500,33547
2369,2035,334,896,286300,33548
6243,4827,1416,995,188500,33549
7376,6524,852,1155,326400,33556
7579,5091,2488,949,285700,33558
6587,4097,2490,965,155600,33559
9354,4806,4548,829,101100,33563
6256,4977,1279,907,123200,33565
6456,4617,1839,866,156500,33566
3439,2527,912,711,148900,33567
8444,6900,1544,1306,169300,33569
8159,5707,2452,819,123200,33570
6238,4981,1257,1473,209100,33572
11639,9532,2107,1742,130800,33573
1638,1468,170,714,163300,33576
16677,9199,7478,1079,147900,33578
8375,6567,1808,1467,156500,33579
9010,6969,2041,998,133500,33584
449,351,98,1314,91300,33585
3969,2525,1444,757,83800,33592
11968,9632,2336,1227,153600,33594
10081,8477,1604,1566,225800,33596
2917,2417,500,752,78900,33597
4343,3177,1166,739,156200,33598
7011,2748,4263,1514,232200,33602
8145,4471,3674,858,123000,33603
14380,7230,7150,850,102600,33604
6805,2787,4018,772,78500,33605
7749,3307,4442,1184,405100,33606
10444,4289,6155,1014,102800,33607
8179,4317,3862,1040,262000,33609
15297,6907,8390,881,82900,33610
14784,7911,6873,1000,170800,33611
17890,6740,11150,763,93900,33612
12815,4099,8716,751,117700,33613
17801,6820,10981,862,113800,33614
17270,9561,7709,945,124900,33615
6017,2596,3421,1040,137800,33616
16781,7055,9726,860,124400,33617
10833,6828,4005,944,227400,33618
11860,5561,6299,994,81600,33619
0,0,0,-,-,33620
551,0,551,1990,-,33621
14999,9999,5000,1075,170100,33624
9382,6320,3062,1149,167000,33625
10560,6826,3734,1315,305800,33626
10574,8124,2450,1076,398400,33629
7122,4510,2612,1076,122400,33634
6565,3797,2768,1144,145200,33635
6164,2818,3346,969,118900,33637
22339,13040,9299,1159,252200,33647
8370,2921,5449,760,263900,33701
13033,8029,5004,899,121600,33702
10039,7482,2557,1012,153600,33703
7215,4723,2492,879,259500,33704
10468,5493,4975,892,132600,33705
8539,5787,2752,1063,334300,33706
12366,8213,4153,963,161200,33707
8392,6041,2351,1036,234500,33708
11613,8378,3235,853,82000,33709
13384,9818,3566,892,145300,33710
6958,4063,2895,1019,120800,33711
9572,4784,4788,883,123100,33712
12352,7667,4685,941,112200,33713
7875,4608,3267,891,64600,33714
3775,3258,517,1452,302800,33715
8515,1440,7075,1067,77900,33716
0,0,0,-,-,33744
8689,4847,3842,929,138300,33755
12577,7381,5196,849,152500,33756
7509,3897,3612,1052,131700,33759
6370,3023,3347,908,112300,33760
8934,7208,1726,860,142500,33761
2773,1949,824,1162,171200,33762
8938,6479,2459,938,91700,33763
11364,7860,3504,966,126400,33764
5739,2633,3106,958,132600,33765
4560,3436,1124,1188,387900,33767
11399,6215,5184,873,132400,33770
13367,6958,6409,898,70800,33771
9931,7107,2824,1081,147700,33772
7309,5131,2178,960,128000,33773
8316,6028,2288,981,157900,33774
5047,4489,558,1378,222800,33776
6752,5244,1508,1070,153800,33777
6207,4939,1268,998,107800,33778
10412,6238,4174,863,104600,33781
9441,7017,2424,1049,112300,33782
2975,1925,1050,1213,339600,33785
753,641,112,2223,579500,33786
12064,6360,5704,762,64800,33801
11849,6993,4856,912,118200,33803
8524,4165,4359,847,71400,33805
10749,7604,3145,929,125200,33809
16776,12794,3982,1001,118200,33810
7517,5058,2459,910,131200,33811
4405,3667,738,1156,155300,33812
11726,9708,2018,1116,170900,33813
5162,2610,2552,684,31500,33815
10140,7163,2977,828,102700,33823
8880,6685,2195,666,74300,33825
865,703,162,935,121700,33827
9001,6138,2863,778,94300,33830
1766,1118,648,594,81700,33834
7637,5553,2084,977,123000,33837
1309,785,524,845,66200,33838
1038,700,338,839,89800,33839
2745,2039,706,740,77500,33841
3453,2857,596,663,73500,33843
11677,7890,3787,797,100100,33844
47,47,0,-,71500,33847
473,79,394,861,(X),33848
327,318,9,-,161000,33849
3078,2066,1012,878,67500,33850
311,254,57,923,89300,33851
8228,6377,1851,687,103800,33852
4081,2137,1944,737,88200,33853
76,69,7,-,(X),33854
7,7,0,-,-,33855
287,0,287,517,-,33856
732,572,160,527,78300,33857
3891,2753,1138,829,95000,33859
7789,5879,1910,925,104400,33860
184,126,58,-,50000,33865
220,220,0,-,93100,33867
3805,3078,727,883,84100,33868
8660,5645,3015,644,76500,33870
7052,5477,1575,909,79400,33872
4325,3047,1278,614,80300,33873
4413,3681,732,829,109500,33875
2018,1815,203,681,94300,33876
201,0,201,661,-,33877
12711,8439,4272,829,87400,33880
12316,8293,4023,757,79500,33881
11487,8593,2894,990,142900,33884
1402,1033,369,788,86400,33890
2986,1687,1299,1140,151400,33896
5937,4039,1898,1276,110300,33897
6433,5104,1329,779,94500,33898
7893,3858,4035,720,124700,33901
10243,7895,2348,742,67900,33903
13046,9327,3719,957,169100,33904
10432,6468,3964,860,99500,33905
8904,3928,4976,834,104300,33907
16753,12084,4669,1202,211900,33908
8085,4777,3308,1043,119500,33909
6864,5718,1146,1074,226200,33912
6701,5541,1160,1258,251900,33913
13997,10121,3876,1102,191900,33914
7449,2691,4758,845,72200,33916
12666,10357,2309,721,78600,33917
13387,9744,3643,1002,154400,33919
1733,1386,347,1043,191700,33920
512,498,14,-,1054500,33921
1492,1189,303,848,168000,33922
37,24,13,-,333300,33924
10296,8447,1849,1350,237400,33928
277,146,131,628,(X),33930
5551,4506,1045,939,273300,33931
5740,3919,1821,691,78400,33935
8005,5057,2948,773,75600,33936
109,36,73,-,-,33944
0,0,0,-,-,33945
977,845,132,1144,308400,33946
3919,3141,778,1082,195900,33947
6916,5428,1488,955,132400,33948
9940,7854,2086,844,236800,33950
12516,8858,3658,848,93200,33952
2542,2229,313,726,188100,33953
3475,2759,716,1067,154100,33954
4083,3748,335,973,185000,33955
1834,1639,195,783,186600,33956
3487,3017,470,1210,664500,33957
382,305,77,-,110100,33960
0,0,0,-,-,33965
3676,2505,1171,919,213700,33966
7895,5702,2193,1028,138500,33967
6611,4207,2404,961,98400,33971
4190,2963,1227,883,89900,33972
3654,694,2960,815,168300,33973
4410,2352,2058,942,94700,33974
4360,2467,1893,993,85000,33976
5455,4073,1382,825,109100,33980
4275,3472,803,1050,163200,33981
3840,3245,595,726,108000,33982
6127,4560,1567,873,159600,33983
11015,7584,3431,1007,141000,33990
6505,4521,1984,1157,170900,33991
7434,4952,2482,1127,149700,33993
0,0,0,-,-,34101
5531,3973,1558,924,745000,34102
5905,4941,964,1287,546800,34103
10073,6452,3621,962,193400,34104
6955,4997,1958,1148,345200,34105
7920,6400,1520,1209,584900,34108
10722,6461,4261,1132,341400,34109
10024,7745,2279,1308,314300,34110
11322,8526,2796,902,157600,34112
6867,4785,2082,988,227400,34113
5964,4860,1104,1191,205500,34114
9025,4849,4176,986,154200,34116
4347,3718,629,1153,182500,34117
11396,8409,2987,1409,343800,34119
8524,6979,1545,1426,205700,34120
6978,5707,1271,1106,405500,34134
16195,12125,4070,1106,220800,34135
149,121,28,-,-,34137
153,94,59,-,(X),34138
267,244,23,1025,(X),34139
162,116,46,-,(X),34140
0,0,0,-,-,34141
5548,2292,3256,686,85400,34142
8254,7112,1142,1491,475300,34145
1831,1575,256,1430,367400,34201
8510,6765,1745,1723,352100,34202
13718,9614,4104,992,158400,34203
12213,6961,5252,841,103000,34205
13904,7844,6060,795,58600,34207
11792,5948,5844,871,133200,34208
14043,10050,3993,1051,172000,34209
7210,4159,3051,948,150200,34210
1867,1683,184,1556,343000,34211
5671,4626,1045,1424,280200,34212
230,196,34,-,(X),34215
587,505,82,1110,387700,34216
2666,1984,682,1151,402600,34217
7081,6389,692,1611,217400,34219
14921,11367,3554,862,122800,34221
5268,4151,1117,920,58900,34222
8413,6676,1737,855,173200,34223
7321,5636,1685,855,123200,34224
3867,3474,393,1743,631400,34228
3402,3059,343,1086,356800,34229
13996,8612,5384,1000,162500,34231
13447,9480,3967,1145,158000,34232
7863,6105,1758,1255,202000,34233
8894,4804,4090,829,94800,34234
6113,4656,1457,1093,173700,34235
6369,3321,3048,947,580700,34236
6895,3303,3592,961,102500,34237
9479,7247,2232,1193,279400,34238
6959,4817,2142,1054,201200,34239
4435,3952,483,1241,337200,34240
5546,4774,772,1304,292100,34241
3958,3262,696,1252,561200,34242
12011,8694,3317,1223,213700,34243
1737,1492,245,(X),265100,34251
9542,6341,3201,657,78400,34266
25,25,0,-,-,34268
1691,1541,150,867,98800,34269
8313,6796,1517,924,222600,34275
9946,7744,2202,1025,146600,34285
7065,5627,1438,1206,122700,34286
10800,7780,3020,852,102300,34287
4042,2995,1047,1040,166800,34288
999,604,395,844,169000,34289
2065,1787,278,999,136500,34291
7355,5386,1969,1203,255900,34292
15693,12707,2986,1074,169000,34293
5758,4130,1628,743,90300,34420
3988,3057,931,746,88900,34428
3364,2607,757,729,111200,34429
3326,2768,558,650,87900,34431
5250,4440,810,857,118300,34432
2277,2082,195,846,112600,34433
3210,2540,670,1157,115600,34434
3375,2788,587,657,81600,34436
6637,5681,956,771,157000,34442
0,0,0,-,-,34445
7713,6876,837,993,128800,34446
4424,3382,1042,592,68100,34448
1206,873,333,617,90200,34449
4891,3721,1170,702,103200,34450
4859,4048,811,759,92400,34452
4214,3493,721,998,99000,34453
4226,3269,957,695,149100,34461
7750,5938,1812,848,136200,34465
7938,4589,3349,757,85400,34470
9736,6233,3503,817,158500,34471
10263,7563,2700,893,85800,34472
6376,4679,1697,978,107500,34473
6624,3247,3377,856,99500,34474
3976,2006,1970,657,74900,34475
9105,8135,970,914,127000,34476
4935,3668,1267,761,87200,34479
6690,5203,1487,731,144500,34480
8710,7693,1017,885,90600,34481
7048,5448,1600,831,131000,34482
1369,1057,312,770,181500,34484
4375,3254,1121,636,55300,34488
11940,10091,1849,885,147800,34491
273,224,49,864,180000,34498
8529,6089,2440,688,89700,34601
2692,2173,519,959,134900,34602
3667,3057,610,712,125400,34604
11559,8814,2745,841,98500,34606
3848,2892,956,928,181900,34607
12469,8870,3599,880,99300,34608
14651,11597,3054,1021,126200,34609
4449,3806,643,669,120400,34610
8098,7159,939,894,87500,34613
2454,2040,414,1126,108200,34614
2247,1933,314,1417,187600,34637
7553,6020,1533,1429,199200,34638
8948,7155,1793,1215,174700,34639
10566,6611,3955,795,78300,34652
13469,8754,4715,871,77400,34653
8459,6580,1879,867,122600,34654
15804,12625,3179,1009,176800,34655
129,89,40,-,46600,34661
14352,10335,4017,867,101700,34667
17946,11872,6074,866,67000,34668
4645,3908,737,960,110000,34669
8189,5801,2388,1037,176900,34677
32,27,5,-,144900,34679
383,383,0,-,343200,34681
12801,9727,3074,994,211500,34683
13438,8476,4962,1144,141200,34684
7150,5257,1893,1212,291800,34685
3067,2666,401,1496,284300,34688
10912,7699,3213,826,159600,34689
5387,3468,1919,890,64600,34690
7813,5462,2351,928,70100,34691
7396,6105,1291,1119,200000,34695
17489,11384,6105,970,151600,34698
880,672,208,776,99200,34705
19068,14692,4376,1160,172300,34711
5909,3145,2764,1022,141600,34714
5066,3882,1184,1016,150800,34715
4264,3254,1010,896,101800,34731
1469,1179,290,1354,221300,34734
4985,3481,1504,1085,140700,34736
975,801,174,1009,193300,34737
207,157,50,-,127700,34739
15041,4903,10138,923,108300,34741
10807,6889,3918,1136,109800,34743
14325,9337,4988,1050,148500,34744
11908,7631,4277,1237,137400,34746
5690,2761,2929,1244,299500,34747
17673,13307,4366,830,127000,34748
1578,1234,344,1044,98400,34753
1229,1015,214,1109,209400,34756
9940,6484,3456,1112,117800,34758
10416,7782,2634,1118,132900,34759
264,203,61,950,158000,34760
13832,9658,4174,1105,168500,34761
184,157,27,-,110600,34762
7775,5102,2673,1014,91000,34769
4447,3851,596,1064,187900,34771
8318,6705,1613,1266,156200,34772
994,616,378,737,130800,34773
6991,5639,1352,807,226200,34785
11313,8333,2980,1476,405500,34786
17507,11915,5592,1028,222300,34787
7554,6372,1182,835,83900,34788
524,441,83,-,237700,34797
1684,1373,311,946,118100,34945
2166,1333,833,790,63000,34946
4053,1601,2452,826,71300,34947
3818,3259,559,900,245700,34949
5838,2189,3649,718,66000,34950
6636,5885,751,736,82500,34951
16844,11893,4951,1049,94400,34952
19975,15551,4424,1275,132900,34953
2205,1453,752,786,75900,34956
10436,7519,2917,992,198200,34957
5622,3545,2077,615,88900,34972
8817,6843,1974,727,94000,34974
1753,997,756,826,158600,34981
9968,6400,3568,884,88400,34982
13718,10951,2767,1149,119100,34983
4983,3970,1013,1184,132900,34984
10308,8513,1795,999,180300,34986
2339,1570,769,1511,226500,34987
11094,9362,1732,1282,288600,34990
7277,4176,3101,901,121400,34994
5352,4452,900,1015,169600,34996
17138,13046,4092,980,180900,34997
4121,3306,815,1061,148500,35004
2909,2150,759,795,91700,35005
1168,932,236,705,86500,35006
8746,7054,1692,931,157400,35007
8026,5228,2798,572,98300,35010
20,0,20,-,-,35013
1529,1272,257,817,79700,35014
6451,4721,1730,583,124000,35016
741,615,126,827,85200,35019
9793,5337,4456,656,67200,35020
8049,6535,1514,895,162400,35022
8842,6867,1975,774,115100,35023
2826,2050,776,575,102300,35031
14,12,2,-,(X),35032
1349,1248,101,584,103900,35033
1027,756,271,(X),73000,35034
414,390,24,-,(X),35035
100,25,75,246,59400,35036
5927,4708,1219,1020,137900,35040
2110,1469,641,553,123700,35042
3306,2990,316,1604,226800,35043
3174,1978,1196,478,102600,35044
5467,4019,1448,636,98500,35045
2060,1472,588,784,120500,35046
1487,1291,196,747,137000,35049
3046,2305,741,613,134100,35051
44,23,21,-,-,35052
1122,987,135,680,140900,35053
1717,1497,220,616,165400,35054
8119,5091,3028,575,117100,35055
4712,3824,888,670,129100,35057
3818,2920,898,535,130500,35058
170,152,18,-,34400,35060
462,314,148,1257,74600,35061
2820,2399,421,627,124400,35062
1442,1127,315,703,59300,35063
4328,2653,1675,728,95000,35064
3357,2471,886,901,131500,35068
107,53,54,625,89600,35070
6270,4969,1301,873,159400,35071
1980,1566,414,580,78100,35072
952,795,157,864,80600,35073
32,32,0,-,-,35074
4678,3478,1200,647,94800,35077
755,622,133,527,126500,35078
3202,2711,491,542,112800,35079
5681,5135,546,1299,172300,35080
0,0,0,-,-,35082
1355,1083,272,759,126600,35083
3218,2460,758,694,87200,35085
741,477,264,616,90600,35087
730,563,167,637,67200,35089
976,876,100,795,173200,35091
5510,4083,1427,721,139300,35094
3126,2604,522,844,113100,35096
706,531,175,711,135100,35097
570,516,54,579,82400,35098
5888,5214,674,838,182300,35111
93,76,17,-,-,35112
2714,2256,458,1095,207900,35114
4944,3268,1676,733,121200,35115
1597,1361,236,775,152100,35116
1993,1764,229,1020,155200,35117
1226,982,244,758,127900,35118
73,73,0,-,80900,35119
5172,4526,646,764,132800,35120
5696,3877,1819,591,115900,35121
9347,7908,1439,1041,167900,35124
3715,2379,1336,649,106700,35125
7855,6839,1016,959,148900,35126
3630,3215,415,1003,151000,35127
4254,2877,1377,706,178900,35128
1271,1055,216,720,79900,35130
1639,1348,291,607,112600,35131
1229,1137,92,583,123200,35133
706,519,187,691,181300,35135
795,599,196,317,83600,35136
74,63,11,-,19000,35139
1307,1154,153,608,150000,35143
3965,3518,447,622,162100,35146
2041,1805,236,1207,162400,35147
1102,759,343,639,93700,35148
205,205,0,-,(X),35149
7326,4664,2662,567,86900,35150
2970,2504,466,589,87200,35151
9808,6628,3180,552,84500,35160
1409,1206,203,659,115500,35171
1038,815,223,495,60100,35172
9623,8557,1066,1046,214800,35173
1976,1661,315,604,119400,35175
390,357,33,508,59900,35176
1489,1319,170,531,83600,35178
3431,2839,592,642,122600,35179
5241,4584,657,613,126100,35180
255,255,0,-,77800,35183
2032,1566,466,763,93800,35184
1909,1560,349,914,168000,35186
9,9,0,-,-,35187
1006,723,283,756,116900,35188
1536,167,1369,630,181900,35203
4657,1734,2923,556,62300,35204
9998,2582,7416,695,151600,35205
6773,3467,3306,742,75800,35206
3383,1824,1559,515,57300,35207
5338,3104,2234,821,74500,35208
12154,5077,7077,846,276700,35209
6177,4304,1873,876,131900,35210
11248,5534,5714,672,74300,35211
5319,2140,3179,543,110600,35212
5513,4172,1341,1113,497000,35213
7023,5309,1714,730,99800,35214
18013,10429,7584,793,101200,35215
14773,7843,6930,928,265600,35216
5281,2905,2376,663,81000,35217
3030,1205,1825,742,61700,35218
2022,1398,624,820,60100,35221
3927,2099,1828,674,215000,35222
4010,3450,560,983,458600,35223
2415,1460,955,823,69000,35224
12998,10419,2579,1092,244700,35226
3975,2458,1517,831,67100,35228
0,0,0,-,-,35229
706,201,505,991,225500,35233
1890,862,1028,573,60100,35234
7986,5725,2261,953,115900,35235
20908,14323,6585,974,328400,35242
7744,4820,2924,1073,330800,35243
12930,8617,4313,997,278600,35244
167,83,84,556,77100,35254
10536,4095,6441,677,106500,35401
7251,3767,3484,815,129800,35404
15937,8815,7122,796,166000,35405
6103,4772,1331,1126,318200,35406
430,347,83,611,105400,35441
1882,1115,767,469,79800,35442
666,389,277,329,58600,35443
1381,1010,371,634,100000,35444
709,517,192,783,113800,35446
1263,939,324,502,77500,35447
1277,1073,204,777,143100,35452
4060,3396,664,748,124500,35453
1118,917,201,657,105600,35456
25,25,0,-,-,35457
205,155,50,739,(X),35458
357,295,62,507,75000,35459
155,84,71,633,83300,35460
776,661,115,561,75500,35461
1783,1246,537,324,75600,35462
550,518,32,-,120500,35463
189,128,61,332,(X),35464
2137,1672,465,459,93700,35466
61,61,0,-,61200,35469
1710,1022,688,577,90800,35470
5934,4010,1924,843,164800,35473
2323,1973,350,717,113300,35474
5333,4586,747,774,176400,35475
2783,1353,1430,759,129800,35476
84,70,14,-,47900,35477
422,387,35,1325,142800,35480
1540,1091,449,399,68300,35481
1308,1104,204,941,113700,35490
3914,2359,1555,610,95400,35501
3344,2592,752,617,86700,35503
5113,3940,1173,611,112600,35504
962,738,224,487,80300,35540
1252,1083,169,628,136500,35541
530,461,69,539,73900,35542
662,542,120,479,59200,35543
272,248,24,660,55100,35544
37,31,6,-,39700,35545
1469,1170,299,359,71700,35546
760,585,175,364,54200,35548
1698,1257,441,361,66500,35549
2169,1327,842,497,59900,35550
374,331,43,311,(X),35552
1705,1331,374,474,81000,35553
429,342,87,(X),57900,35554
4028,2676,1352,486,78600,35555
12,12,0,-,-,35559
1986,1418,568,424,97100,35563
893,638,255,525,71200,35564
5185,3819,1366,516,68400,35565
4480,3429,1051,513,90800,35570
457,368,89,503,66400,35571
363,328,35,-,87800,35572
629,530,99,422,68800,35574
404,322,82,488,65800,35575
1351,940,411,412,73400,35576
13,12,1,-,(X),35577
2273,1792,481,580,74000,35578
1234,1015,219,561,73300,35579
1518,1225,293,566,76400,35580
1988,1537,451,534,76600,35581
1719,1045,674,441,76500,35582
186,147,39,702,51800,35584
543,437,106,776,107400,35585
1837,1337,500,419,62200,35586
492,457,35,-,61300,35587
2070,1357,713,427,70700,35592
922,811,111,448,83700,35593
3161,2148,1013,535,96600,35594
13057,7517,5540,598,96900,35601
12522,8757,3765,609,163900,35603
818,622,196,519,91900,35610
10541,6268,4273,603,112000,35611
7045,6397,648,708,172900,35613
3054,2454,600,573,95700,35614
50,50,0,-,-,35615
1727,1356,371,625,74700,35616
879,653,226,396,74200,35618
1815,1580,235,702,87100,35619
3211,2472,739,580,118600,35620
1137,920,217,612,103800,35621
2906,2324,582,689,103600,35622
14727,7146,7581,567,100600,35630
8591,6988,1603,727,129200,35633
3872,3438,434,701,152000,35634
9228,7003,2225,594,129700,35640
1201,986,215,666,90400,35643
5452,4472,980,686,134200,35645
1715,1336,379,499,80000,35646
420,334,86,906,117900,35647
1206,1017,189,537,104400,35648
49,49,0,-,(X),35649
5695,4345,1350,564,99500,35650
591,513,78,680,93400,35651
3576,2793,783,583,111300,35652
4035,2371,1664,558,93400,35653
3039,2190,849,518,88000,35654
3961,2269,1692,595,89300,35660
6994,5327,1667,653,129300,35661
2979,2505,474,622,110000,35670
866,521,345,579,235500,35671
2585,2135,450,492,103600,35672
2782,2481,301,514,111800,35673
7270,5098,2172,664,101200,35674
597,492,105,(X),100000,35677
2141,1545,596,639,139200,35739
1338,931,407,493,82100,35740
1207,937,270,824,311900,35741
951,627,324,570,85000,35744
84,70,14,675,105000,35745
248,248,0,-,(X),35746
2100,1829,271,541,114300,35747
2469,1991,478,554,169700,35748
7414,6528,886,1154,177300,35749
4740,3884,856,692,111800,35750
93,82,11,-,100000,35751
966,685,281,640,55300,35752
1816,1450,366,540,122600,35754
236,150,86,611,117200,35755
4286,3669,617,916,193600,35756
5102,4353,749,968,176000,35757
17126,11510,5616,897,214200,35758
2694,2253,441,957,183500,35759
1860,1454,406,700,116100,35760
4345,3751,594,781,139900,35761
5757,5293,464,1165,244800,35763
271,193,78,339,113700,35764
1384,1115,269,558,97400,35765
71,55,16,-,(X),35766
4638,3311,1327,536,98600,35768
4025,3101,924,607,133000,35769
1359,939,420,623,98200,35771
1794,1077,717,505,88500,35772
4407,3719,688,925,126300,35773
42,31,11,-,(X),35774
307,218,89,-,(X),35775
1326,1089,237,644,84400,35776
9758,6591,3167,719,234400,35801
9994,5985,4009,781,218200,35802
11155,8944,2211,854,173600,35803
9221,3017,6204,573,75900,35805
8966,4481,4485,870,220900,35806
300,0,300,1271,-,35808
11468,7667,3801,846,86900,35810
10387,8404,1983,849,149000,35811
6639,1578,5061,629,97600,35816
3128,1626,1502,850,217200,35824
0,0,0,-,-,35896
7409,4643,2766,587,104100,35901
7249,4614,2635,613,90900,35903
5490,4140,1350,620,68800,35904
2605,1917,688,562,97600,35905
4103,2572,1531,713,144100,35906
3105,2871,234,780,153800,35907
7102,4711,2391,589,107400,35950
4462,3018,1444,653,94200,35951
2684,2136,548,551,77500,35952
2575,2101,474,620,87300,35953
4607,3300,1307,619,75900,35954
3037,2608,429,666,98600,35956
5429,3418,2011,628,100300,35957
1178,981,197,645,85100,35958
2098,1467,631,612,112300,35959
4384,3448,936,589,117100,35960
2392,1708,684,441,91100,35961
2899,2067,832,588,75100,35962
667,450,217,410,113100,35963
1510,1222,288,538,105500,35966
6202,4027,2175,550,102900,35967
1387,1190,197,656,105100,35968
1884,1491,393,602,97600,35971
413,392,21,-,120100,35972
1463,1148,315,664,68000,35973
466,288,178,363,107100,35974
275,233,42,-,87500,35975
6678,5054,1624,616,154800,35976
2137,1629,508,538,95700,35978
602,466,136,-,78500,35979
1730,1338,392,571,83900,35980
731,618,113,226,83200,35981
1643,1194,449,694,110800,35983
827,706,121,700,128800,35984
2746,2079,667,521,107600,35986
1015,858,157,572,84900,35987
692,593,99,630,106300,35988
1181,951,230,576,78500,35989
35,15,20,-,-,35990
749,554,195,581,52600,36003
624,491,133,608,83100,36005
512,476,36,-,151700,36006
1028,775,253,466,79900,36009
1971,1303,668,503,71900,36010
211,189,22,-,297800,36013
1469,975,494,466,82500,36016
591,467,124,423,56900,36017
390,315,75,730,152600,36020
4234,3592,642,723,168800,36022
2107,1753,354,736,117500,36024
1342,879,463,844,124000,36025
386,343,43,-,116100,36026
6154,3634,2520,619,112800,36027
791,610,181,508,78900,36028
349,333,16,-,224500,36029
159,151,8,-,29200,36030
69,69,0,-,57900,36031
849,605,244,454,70600,36032
1747,1348,399,588,67500,36033
294,259,35,638,49000,36034
712,554,158,722,84200,36035
798,592,206,764,71800,36036
5441,3578,1863,581,89300,36037
25,25,0,-,73900,36038
64,57,7,-,76400,36039
1438,879,559,572,54000,36040
470,391,79,530,80900,36041
546,404,142,633,72100,36042
1391,1151,240,906,145300,36043
617,574,43,675,68000,36046
487,439,48,-,102700,36047
541,396,145,575,61700,36048
2204,1320,884,453,78400,36049
721,557,164,738,63400,36051
207,151,56,620,(X),36052
792,546,246,476,38800,36053
5889,4015,1874,830,133400,36054
3337,3000,337,1208,248100,36064
7418,4559,2859,971,161000,36066
9976,7646,2330,753,128400,36067
976,781,195,651,79600,36069
255,188,67,533,103300,36071
826,669,157,658,89400,36075
4860,3440,1420,547,110600,36078
3839,2571,1268,699,122800,36079
899,718,181,669,175900,36080
6349,3102,3247,547,125100,36081
0,0,0,-,-,36082
3879,2316,1563,540,76100,36083
1322,599,723,638,80300,36088
2638,1735,903,583,64800,36089
1427,1115,312,524,86900,36091
7255,5411,1844,752,124700,36092
3896,3475,421,1267,214100,36093
2977,916,2061,561,76800,36104
4199,2718,1481,725,63800,36105
6490,3613,2877,921,153700,36106
3265,1180,2085,674,67200,36107
7788,4183,3605,578,68200,36108
9992,7507,2485,897,117400,36109
4584,2346,2238,782,61800,36110
4964,3211,1753,820,133600,36111
0,0,0,-,-,36112
244,0,244,1433,-,36113
236,0,236,1255,-,36115
16824,9102,7722,798,106900,36116
21297,12552,8745,913,183100,36117
7462,4284,3178,558,65300,36201
6744,4881,1863,751,130800,36203
212,119,93,679,261400,36205
4551,3315,1236,614,95500,36206
8645,5720,2925,696,134400,36207
1775,1524,251,680,120500,36250
2111,1416,695,430,82200,36251
334,252,82,-,58600,36255
716,614,102,522,91400,36256
555,477,78,483,114600,36258
1564,1109,455,642,103400,36260
531,437,94,463,54300,36262
260,134,126,697,131000,36263
3268,2477,791,514,105000,36264
7438,4489,2949,572,139200,36265
2176,1749,427,407,93800,36266
30,6,24,-,-,36267
2219,1759,460,639,96700,36268
464,364,100,582,93500,36269
2136,1851,285,710,92400,36271
5034,4070,964,489,81000,36272
1320,1012,308,645,138400,36273
4564,3188,1376,591,79900,36274
967,679,288,533,85900,36276
1975,1619,356,716,100000,36277
1693,1221,472,600,133500,36278
1058,911,147,639,120500,36279
1441,1123,318,756,104500,36280
13824,8589,5235,666,106300,36301
11774,6928,4846,640,136200,36303
5981,3922,2059,878,175800,36305
2672,2168,504,516,78100,36310
1002,863,139,607,90500,36311
2459,1861,598,662,89000,36312
85,78,7,-,(X),36313
236,221,15,620,110700,36314
665,531,134,574,138700,36316
136,106,30,425,65600,36317
617,523,94,650,68500,36318
796,632,164,578,83100,36319
1466,1184,282,582,75600,36320
602,474,128,794,88800,36321
3393,2019,1374,626,99000,36322
3050,2157,893,544,88200,36323
13452,8599,4853,758,166900,36330
2244,1519,725,490,82800,36340
605,511,94,567,73000,36343
2303,1761,542,556,76500,36344
3325,2522,803,617,126800,36345
523,426,97,542,78300,36346
2349,1468,881,548,111100,36350
1407,1100,307,660,85900,36351
2006,1511,495,686,137000,36352
780,635,145,554,83600,36353
8067,5412,2655,554,99300,36360
1230,0,1230,1230,-,36362
354,260,94,585,81700,36370
216,130,86,695,109100,36371
232,157,75,412,55500,36373
389,328,61,666,101700,36374
2780,2125,655,591,77100,36375
765,562,203,667,76800,36376
3179,2216,963,521,75700,36401
4306,3029,1277,613,89800,36420
3658,2947,711,592,133000,36421
417,281,136,550,51500,36425
6012,4423,1589,554,91900,36426
1061,880,181,469,64400,36432
122,115,7,-,75800,36435
264,164,100,-,59500,36436
258,179,79,842,111500,36439
1395,1078,317,570,80700,36441
1384,996,388,476,80900,36442
367,202,165,-,59100,36444
1787,1310,477,443,80400,36445
137,70,67,831,46000,36446
1861,1240,621,565,104300,36451
949,738,211,547,77700,36453
15,15,0,-,187500,36454
162,122,40,631,45200,36455
624,490,134,396,58000,36456
3897,2479,1418,536,85400,36460
3776,2724,1052,559,91600,36467
54,22,32,-,-,36470
420,287,133,480,(X),36471
38,35,3,-,(X),36473
1239,1066,173,575,76500,36474
834,680,154,617,59400,36475
28,24,4,-,(X),36476
1907,1286,621,485,65500,36477
666,484,182,656,85600,36480
106,46,60,-,50000,36481
339,179,160,-,30400,36482
160,131,29,-,63900,36483
6268,4318,1950,557,99300,36502
549,403,146,1071,108000,36505
6961,4972,1989,619,118900,36507
616,358,258,675,86500,36509
330,269,61,-,86300,36511
0,0,0,-,-,36512
153,113,40,-,(X),36513
920,737,183,510,94200,36518
1699,1471,228,1043,108300,36521
2372,1749,623,955,104000,36522
866,609,257,783,111000,36523
465,390,75,688,89300,36524
678,517,161,849,122500,36525
11523,7433,4090,1002,179000,36526
5207,3701,1506,1125,263000,36527
544,437,107,1082,197900,36528
92,81,11,-,77000,36529
2597,1877,720,859,150200,36530
11612,8971,2641,1013,227300,36532
11448,8107,3341,755,152700,36535
172,172,0,-,(X),36538
331,253,78,-,(X),36539
272,192,80,-,81200,36540
5172,4504,668,714,110500,36541
5849,3232,2617,891,227300,36542
43,43,0,-,69300,36543
4022,2960,1062,720,90200,36544
3546,2412,1134,578,87500,36545
431,384,47,-,84400,36548
2122,1877,245,731,127800,36549
116,116,0,-,30600,36550
2830,2018,812,966,132700,36551
1279,1058,221,588,109600,36553
301,271,30,875,227200,36555
82,52,30,-,-,36556
1455,1320,135,598,68900,36558
48,48,0,-,(X),36559
1237,922,315,600,80100,36560
2672,1965,707,950,263000,36561
485,443,42,694,85400,36562
9,9,0,-,-,36564
4793,3467,1326,774,135200,36567
27,27,0,-,-,36568
355,278,77,-,103900,36569
5479,3988,1491,845,127900,36571
2399,2127,272,939,145900,36572
368,342,26,-,102800,36574
6617,5281,1336,865,139300,36575
1573,1190,383,979,150700,36576
465,447,18,-,131500,36578
482,424,58,-,93800,36579
2204,1709,495,825,116900,36580
62,46,16,-,-,36581
9184,6564,2620,712,117300,36582
229,206,23,-,(X),36583
311,276,35,-,56800,36584
314,254,60,417,96200,36585
3765,3342,423,736,96600,36587
0,0,0,-,-,36590
515,83,432,563,206800,36602
2782,1113,1669,550,72500,36603
4208,2348,1860,736,160500,36604
10229,6117,4112,744,79600,36605
7836,4343,3493,740,95000,36606
2735,1445,1290,769,99500,36607
14496,8465,6031,808,156200,36608
11028,5129,5899,768,137400,36609
4259,2139,2120,677,49500,36610
2208,1283,925,816,79700,36611
1620,934,686,728,64100,36612
4449,3600,849,832,98500,36613
0,0,0,-,-,36615
0,0,0,-,-,36616
5160,3026,2134,713,74400,36617
6153,4965,1188,762,111700,36618
5740,4487,1253,928,131300,36619
0,0,0,-,-,36688
7555,5291,2264,875,144100,36693
18112,12674,5438,932,181100,36695
8876,5554,3322,602,88700,36701
5137,2434,2703,550,76600,36703
290,223,67,738,55900,36720
131,77,54,-,89200,36722
26,26,0,-,63800,36723
1943,1250,693,416,89100,36726
32,26,6,-,22300,36727
166,144,22,-,84100,36728
3430,2082,1348,480,128600,36732
428,365,63,-,49400,36736
453,378,75,-,58500,36738
546,440,106,514,62100,36740
718,567,151,646,72100,36742
2665,1711,954,422,83300,36744
1405,966,439,588,78000,36748
293,250,43,-,66400,36749
1047,823,224,630,102000,36750
225,133,92,650,39500,36751
691,540,151,646,90000,36752
27,20,7,-,-,36753
198,101,97,-,111800,36754
1779,1381,398,602,82200,36756
682,445,237,704,86000,36758
721,529,192,536,50900,36759
425,385,40,-,80200,36761
107,88,19,(X),83300,36763
510,408,102,778,53200,36765
10,10,0,-,(X),36766
756,551,205,468,51300,36767
348,294,54,683,40500,36768
856,572,284,381,63800,36769
165,138,27,-,104200,36773
350,259,91,767,45100,36775
550,509,41,-,82100,36776
1058,881,177,462,65800,36782
261,208,53,438,58600,36783
2973,1922,1051,482,91200,36784
598,439,159,445,73800,36785
1261,625,636,460,50800,36786
39,39,0,-,61400,36790
422,379,43,-,86800,36792
244,187,57,-,(X),36793
9658,5489,4169,669,153000,36801
6299,4774,1525,769,113400,36804
14326,7066,7260,814,234900,36830
10110,3914,6196,801,101400,36832
0,0,0,-,-,36849
1068,834,234,515,49200,36850
960,739,221,718,87400,36852
3357,2605,752,600,136800,36853
5696,3911,1785,762,87800,36854
567,511,56,628,97500,36855
2035,1660,375,1077,224600,36856
158,141,17,-,116300,36858
22,22,0,-,-,36859
636,528,108,486,54900,36860
1336,1003,333,679,129800,36861
2660,1853,807,553,70200,36862
4915,3032,1883,653,80900,36863
20,12,8,-,62500,36865
1628,1251,377,591,73700,36866
9457,4684,4773,769,132100,36867
7823,4522,3301,704,100300,36869
6694,4680,2014,896,131800,36870
459,379,80,-,85000,36871
3220,2720,500,717,135300,36874
1699,1334,365,812,108600,36875
4869,3386,1483,843,132900,36877
759,612,147,599,150500,36879
222,176,46,-,31700,36901
1788,1222,566,554,75800,36904
838,655,183,639,77800,36907
897,816,81,383,66900,36908
30,21,9,-,-,36910
817,671,146,563,71300,36912
51,51,0,-,40200,36913
240,189,51,485,43600,36915
283,212,71,(X),58200,36916
737,665,72,510,41000,36919
451,419,32,675,52500,36921
180,146,34,-,56700,36922
1220,833,387,435,59100,36925
1885,1639,246,952,234000,37010
958,680,278,731,111700,37012
33117,18103,15014,866,147600,37013
815,703,112,832,410600,37014
6734,5033,1701,926,139800,37015
462,315,147,746,155400,37016
876,647,229,867,60400,37018
228,209,19,-,87200,37019
1810,1546,264,725,134700,37020
2063,1691,372,703,118100,37022
612,502,110,862,138200,37023
1862,1632,230,754,104500,37025
887,803,84,535,111300,37026
18642,16045,2597,1322,456000,37027
327,305,22,-,104000,37028
1943,1621,322,779,218100,37029
2769,1946,823,421,112900,37030
1521,1306,215,1239,142400,37031
1618,1259,359,870,182900,37032
2928,2140,788,596,116000,37033
2488,2165,323,823,144300,37034
1227,1086,141,970,132800,37035
2027,1572,455,681,123200,37036
2259,1975,284,882,142600,37037
17002,9482,7520,831,141700,37040
26195,14227,11968,875,126200,37042
16244,11304,4940,835,176800,37043
1525,1338,187,948,242600,37046
953,713,240,816,118800,37047
2253,1938,315,816,195400,37048
1308,938,370,816,180000,37049
682,545,137,495,89300,37050
1415,1131,284,698,131000,37051
1062,794,268,838,160300,37052
10248,6734,3514,721,139600,37055
359,233,126,717,121100,37057
2867,2188,679,532,123600,37058
438,391,47,(X),83800,37059
851,647,204,758,149800,37060
1926,1346,580,605,93700,37061
4040,3220,820,856,178600,37062
19527,14958,4569,958,319200,37064
16693,10922,5771,854,179700,37066
10084,6493,3591,1317,372100,37067
6793,6163,630,1750,379500,37069
12458,8379,4079,902,172200,37072
5158,4045,1113,796,154500,37073
2657,2018,639,581,112700,37074
23756,17061,6695,987,210500,37075
15720,8448,7272,932,159800,37076
272,220,52,508,88800,37078
773,607,166,652,174800,37079
2895,2370,525,1035,169000,37080
2365,1978,387,1023,192500,37082
5638,3874,1764,543,110400,37083
1633,1436,197,597,210500,37085
10342,7502,2840,1062,124200,37086
15715,10439,5276,793,179000,37087
5011,3929,1082,898,170000,37090
8440,5858,2582,633,102600,37091
650,510,140,640,102700,37095
2241,1736,505,542,78300,37096
939,745,194,454,85000,37097
2135,1659,476,618,85600,37098
2467,1849,618,698,109900,37101
12977,8705,4272,582,96700,37110
16025,7054,8971,798,122700,37115
397,335,62,-,233600,37118
18587,15795,2792,1044,223700,37122
6084,4911,1173,849,171700,37127
16129,10602,5527,1000,179200,37128
19045,13470,5575,927,170700,37129
21191,9334,11857,797,163100,37130
0,0,0,-,-,37132
1130,980,150,731,94400,37134
3516,3274,242,1375,311100,37135
1383,1109,274,691,73500,37137
8933,6960,1973,904,169000,37138
35,30,5,-,67700,37140
457,329,128,1069,164100,37141
641,398,243,663,151200,37142
1378,1133,245,791,178400,37143
1257,1009,248,604,82600,37144
783,616,167,531,97000,37145
2391,1988,403,1081,202200,37146
8139,5883,2256,824,135500,37148
804,739,65,532,149200,37149
1969,1431,538,501,90100,37150
222,185,37,490,146600,37151
1961,1759,202,1063,186000,37153
12303,7645,4658,676,112100,37160
27,18,9,-,(X),37165
5012,3305,1707,546,121400,37166
19398,13492,5906,864,154400,37167
254,241,13,-,120300,37171
10212,7136,3076,780,143800,37172
10801,8221,2580,1127,211200,37174
386,314,72,619,96700,37175
887,716,171,620,93800,37178
3721,3424,297,1533,234400,37179
1211,1007,204,613,121100,37180
515,410,105,(X),120800,37181
1110,923,187,643,125600,37183
2212,1794,418,727,130700,37184
3343,2636,707,611,113600,37185
3179,2368,811,707,108000,37186
2680,2010,670,739,123800,37187
5147,4306,841,994,164500,37188
1258,860,398,778,162500,37189
3484,2511,973,624,141400,37190
1387,1153,234,907,138200,37191
681,267,414,1284,208200,37201
5777,1438,4339,824,235800,37203
5531,3442,2089,1045,358300,37204
10875,7688,3187,1211,443900,37205
10849,5515,5334,746,193200,37206
13591,7689,5902,781,120900,37207
6747,2160,4587,705,115700,37208
14132,6614,7518,907,188000,37209
6536,2088,4448,670,118500,37210
29828,13348,16480,865,162700,37211
6583,2579,4004,1081,433000,37212
0,0,0,-,-,37213
13227,8451,4776,938,142400,37214
9708,7530,2178,1237,510300,37215
7834,5036,2798,856,158700,37216
12273,4670,7603,820,131000,37217
5290,3619,1671,823,128500,37218
856,232,624,1050,275600,37219
2316,2027,289,1417,346700,37220
16446,11468,4978,1093,225800,37221
635,16,619,736,-,37228
0,0,0,-,-,37240
0,0,0,-,-,37243
0,0,0,-,-,37246
517,411,106,622,69500,37301
1548,1155,393,807,278900,37302
9850,6687,3163,581,123700,37303
346,303,43,500,61900,37305
997,776,221,574,106200,37306
2084,1640,444,604,106000,37307
990,828,162,622,135200,37308
826,667,159,763,87800,37309
1836,1526,310,515,161400,37310
10168,4626,5542,644,112800,37311
12632,8202,4430,792,173300,37312
493,419,74,515,83300,37313
44,0,44,-,-,37315
1078,848,230,613,115900,37317
776,542,234,501,89100,37318
7157,4675,2482,580,98900,37321
2960,2380,580,587,96500,37322
11747,9072,2675,742,120800,37323
2109,1335,774,549,97100,37324
606,539,67,693,121100,37325
146,66,80,493,75000,37326
4649,3326,1323,570,132200,37327
477,326,151,574,95100,37328
2240,1842,398,606,104500,37329
3003,2466,537,692,95800,37330
3103,2287,816,588,111200,37331
972,765,207,666,119700,37332
235,164,71,575,73600,37333
9186,6370,2816,611,112200,37334
1004,873,131,725,96700,37335
1669,1343,326,869,167300,37336
570,434,136,504,85100,37337
1401,891,510,582,89400,37338
800,670,130,665,80900,37339
289,222,67,-,102200,37340
4780,4165,615,975,143000,37341
1231,1026,205,540,92000,37342
16556,12385,4171,775,163000,37343
942,708,234,570,97700,37345
3095,2229,866,680,123200,37347
528,397,131,544,99600,37348
744,663,81,1125,557800,37350
122,56,66,1007,-,37351
1194,1003,191,612,154600,37352
1732,1374,358,758,145700,37353
6410,4668,1742,578,113700,37354
9757,6921,2836,693,123400,37355
956,623,333,487,136300,37356
2073,1550,523,534,125400,37357
270,242,28,943,84400,37359
676,629,47,767,132100,37360
505,379,126,696,155000,37361
1178,804,374,716,116400,37362
12988,10637,2351,794,209300,37363
523,456,67,600,66400,37365
338,223,115,495,97800,37366
3528,2677,851,563,109400,37367
376,344,32,575,81600,37369
1699,1430,269,510,139400,37370
1170,986,184,613,133900,37373
769,580,189,619,125000,37374
1173,750,423,1004,213400,37375
148,140,8,-,101700,37376
5935,5006,929,1276,294500,37377
10334,8337,1997,747,151500,37379
2688,1776,912,602,132800,37380
3743,2827,916,585,123800,37381
3212,2853,359,558,113200,37385
1344,1060,284,508,78700,37387
10653,6794,3859,633,116100,37388
653,585,68,594,98800,37391
26,19,7,-,(X),37394
85,25,60,-,-,37396
3886,3024,862,606,112100,37397
5818,4218,1600,515,130000,37398
2002,63,1939,293,377300,37402
1243,465,778,770,194000,37403
4668,2042,2626,726,99600,37404
6945,3585,3360,926,227500,37405
5573,2681,2892,631,84400,37406
3121,1138,1983,694,61700,37407
707,246,461,604,175000,37408
1069,630,439,727,136900,37409
1573,480,1093,501,80100,37410
7537,4450,3087,697,102500,37411
8973,4787,4186,755,114000,37412
10658,5855,4803,769,136800,37415
6290,4116,2174,782,129200,37416
2578,1997,581,710,163800,37419
18961,11736,7225,900,172000,37421
15596,8714,6882,662,134500,37601
15904,8681,7223,693,144700,37604
0,0,0,-,-,37614
8721,6124,2597,674,185100,37615
2028,1698,330,515,115600,37616
5452,4460,992,617,138600,37617
5481,4447,1034,635,123800,37618
15946,11820,4126,621,103000,37620
1506,1345,161,481,108400,37640
3650,2840,810,634,96100,37641
5991,4663,1328,659,118300,37642
14357,9851,4506,562,107200,37643
2020,1533,487,767,125600,37645
5004,3562,1442,619,101500,37650
1762,1455,307,632,121200,37656
477,378,99,607,98300,37657
1933,1543,390,549,88600,37658
11566,9555,2011,729,144300,37659
17617,10727,6890,573,120200,37660
6273,4929,1344,736,157700,37663
11395,8771,2624,589,148400,37664
2591,1708,883,653,87700,37665
256,150,106,365,109700,37680
2397,1877,520,674,120500,37681
7,7,0,-,-,37682
4944,3718,1226,475,112300,37683
3324,2694,630,631,167900,37686
1848,1581,267,447,86100,37687
405,327,78,779,88700,37688
1482,1389,93,(X),110600,37690
322,258,64,563,(X),37691
1914,1531,383,579,116900,37692
743,631,112,623,99000,37694
3074,2169,905,733,117600,37701
1711,1488,223,596,166600,37705
2722,2209,513,559,91200,37708
1414,1130,284,615,117200,37709
369,327,42,563,56300,37710
1859,1496,363,634,94000,37711
528,359,169,673,92600,37713
1790,1254,536,590,89500,37714
271,212,59,(X),54600,37715
10178,7520,2658,645,136800,37716
62,23,39,-,148200,37719
4701,3767,934,783,141900,37721
2380,1755,625,574,108500,37722
410,375,35,619,85600,37723
1153,611,542,579,89400,37724
6432,5338,1094,705,143900,37725
760,680,80,433,93500,37726
1000,823,177,556,81300,37727
511,402,109,625,43800,37729
32,32,0,-,40000,37730
306,290,16,-,119600,37731
101,70,31,-,50700,37732
34,34,0,-,227800,37733
2365,2008,357,636,152200,37737
2598,1728,870,807,171700,37738
2257,1925,332,763,174400,37742
10703,7595,3108,555,116500,37743
7091,4585,2506,552,121100,37745
7083,4807,2276,682,97600,37748
2286,1806,480,569,111900,37752
287,223,64,(X),102600,37753
1840,1356,484,826,120900,37754
1283,923,360,588,85900,37755
1123,768,355,423,60900,37756
3664,2625,1039,607,120600,37757
5022,2813,2209,620,134400,37760
1226,730,496,288,66600,37762
6393,5077,1316,724,148900,37763
3389,2474,915,687,146200,37764
193,175,18,-,107500,37765
7550,5137,2413,528,82800,37766
2185,1490,695,524,81900,37769
974,780,194,641,112800,37770
5877,3980,1897,746,120300,37771
4701,3739,962,890,197500,37772
7849,6317,1532,625,232600,37774
4940,2959,1981,671,189500,37777
1484,1256,228,652,101700,37779
10206,7083,3123,756,161700,37801
12126,9519,2607,789,187100,37803
9005,6673,2332,784,157600,37804
1071,853,218,657,87300,37806
3750,2653,1097,556,98200,37807
842,673,169,607,86300,37809
776,660,116,527,86800,37810
1367,1126,241,677,89600,37811
6777,4224,2553,650,106500,37813
12743,8206,4537,662,133400,37814
2087,1511,576,524,98900,37818
295,192,103,623,70900,37819
2809,2302,507,689,122700,37820
9401,6044,3357,536,97900,37821
3800,2594,1206,469,102400,37825
1793,1401,392,680,88400,37826
772,575,197,677,214700,37828
687,551,136,710,88000,37829
12706,7643,5063,733,150700,37830
3893,3087,806,612,103600,37840
3616,2648,968,542,97100,37841
1490,1201,289,674,142900,37843
230,187,43,-,62500,37845
1877,1321,556,637,101900,37846
926,835,91,475,51500,37847
100,100,0,-,101300,37848
9558,7838,1720,797,153900,37849
24,24,0,-,(X),37851
954,696,258,543,61100,37852
1573,1103,470,809,142800,37853
5561,3875,1686,654,96100,37854
8350,6268,2082,528,98600,37857
1602,1133,469,614,130600,37860
3355,2689,666,493,102000,37861
8642,4646,3996,693,176100,37862
2615,1495,1120,739,170500,37863
8445,6321,2124,748,158600,37865
688,641,47,563,175900,37866
2084,1516,568,380,79700,37869
1971,1586,385,543,90800,37870
3289,2636,653,715,125100,37871
617,478,139,600,93700,37872
1906,1314,592,584,93000,37873
5226,3852,1374,586,101100,37874
11898,8520,3378,778,153500,37876
3461,2786,675,702,130100,37877
275,216,59,606,50000,37878
3989,3007,982,487,102900,37879
1470,1269,201,496,116800,37880
837,690,147,390,85100,37881
1256,957,299,741,169300,37882
2177,1592,585,740,165200,37885
1929,1489,440,825,173100,37886
1890,1400,490,621,96300,37887
1077,924,153,604,84000,37888
2627,1738,889,603,122300,37890
1536,1196,340,589,93500,37891
814,546,268,599,80700,37892
1219,237,982,766,241200,37902
6856,2768,4088,833,169000,37909
10432,5192,5240,747,114800,37912
8139,5051,3088,723,114400,37914
3296,776,2520,464,79900,37915
2718,226,2492,822,110900,37916
12122,5650,6472,716,89100,37917
17398,12197,5201,727,144000,37918
12896,6772,6124,804,263800,37919
17070,10794,6276,753,125500,37920
11967,7221,4746,779,116000,37921
12124,10171,1953,1095,286400,37922
12295,6833,5462,858,179900,37923
4790,3770,1020,710,123800,37924
10767,7621,3146,963,188100,37931
6031,4515,1516,1078,215900,37932
8971,7799,1172,1121,292100,37934
6496,5677,819,763,173000,37938
1666,1076,590,602,88300,38001
12802,10768,2034,1248,218000,38002
3615,3060,555,1117,175800,38004
1832,1276,556,750,98300,38006
22,22,0,-,67900,38007
3256,2186,1070,573,84500,38008
3483,2744,739,816,140000,38011
5535,3157,2378,596,104500,38012
994,678,316,568,90800,38015
17996,10087,7909,994,155200,38016
17295,14282,3013,1119,271500,38017
13633,9390,4243,1070,150400,38018
5943,3604,2339,641,113700,38019
68,49,19,-,64300,38021
2101,1531,570,854,140300,38023
11028,6748,4280,607,100500,38024
2402,2183,219,752,351100,38028
0,0,0,-,-,38029
238,159,79,614,79200,38030
1169,851,318,659,92300,38034
200,25,175,357,77500,38036
686,468,218,700,66700,38037
649,482,167,635,84300,38039
1960,1288,672,621,93300,38040
1017,724,293,559,56800,38041
383,348,35,350,60600,38042
319,276,43,510,79200,38044
26,22,4,-,541700,38046
18,10,8,-,-,38047
1611,1185,426,822,94100,38049
199,119,80,589,67900,38050
1438,1114,324,631,82900,38052
10366,7268,3098,831,125500,38053
23,0,23,1906,-,38054
1408,1100,308,754,159000,38057
3281,2251,1030,838,153100,38058
2858,2111,747,671,105100,38059
3939,3613,326,1024,169400,38060
289,225,64,603,76800,38061
6737,3895,2842,605,83900,38063
1099,828,271,691,214300,38066
545,459,86,688,99500,38067
3941,2644,1297,552,148600,38068
908,720,188,600,74000,38069
142,106,36,-,49300,38070
1353,865,488,660,87600,38075
313,246,67,535,130300,38076
23,23,0,-,-,38077
1158,744,414,457,75100,38079
1090,666,424,502,65800,38080
6740,2098,4642,1126,224600,38103
12631,4230,8401,717,174000,38104
3083,489,2594,601,68500,38105
9606,4844,4762,686,53100,38106
6817,3331,3486,713,81900,38107
6440,2739,3701,767,46500,38108
16263,10353,5910,788,66300,38109
16971,7885,9086,764,95400,38111
6349,2900,3449,721,93500,38112
9746,4611,5135,703,56600,38114
16722,4119,12603,805,87900,38115
14131,7044,7087,798,98500,38116
11587,9264,2323,1083,176700,38117
13338,6676,6662,842,71500,38118
9856,5481,4375,929,168200,38119
6204,4302,1902,971,291400,38120
9534,4888,4646,811,72100,38122
13621,8760,4861,1072,143000,38125
1983,327,1656,531,52300,38126
14827,7322,7505,834,60300,38127
15502,7335,8167,834,82200,38128
0,0,0,-,-,38131
0,0,0,-,-,38132
7324,5652,1672,1163,139800,38133
14660,7229,7431,869,119200,38134
10333,8505,1828,1243,162800,38135
9549,7805,1744,1194,256100,38138
5388,5098,290,2323,362700,38139
7628,5413,2215,1156,92200,38141
0,0,0,-,-,38152
3916,2841,1075,589,92100,38201
782,535,247,578,75700,38220
1376,1090,286,524,81100,38221
1370,1038,332,643,100000,38222
366,310,56,718,83800,38224
2627,2164,463,539,86500,38225
100,95,5,-,56400,38226
1221,833,388,545,80300,38229
1566,1168,398,506,72600,38230
731,587,144,590,75100,38231
772,629,143,521,76700,38232
1071,769,302,488,82800,38233
112,69,43,550,92100,38235
264,253,11,-,89400,38236
6192,3490,2702,573,118600,38237
1014,739,275,607,77100,38240
370,295,75,338,74800,38241
8188,5630,2558,599,101300,38242
1042,891,151,588,87700,38251
421,326,95,649,101900,38253
26,23,3,-,55800,38254
964,693,271,582,70500,38255
1312,1126,186,559,87700,38256
1884,1361,523,489,89600,38257
616,394,222,558,68500,38258
316,223,93,636,77100,38259
1359,990,369,628,85800,38260
6678,4202,2476,573,95600,38261
13096,7091,6005,664,81400,38301
19193,12818,6375,863,144900,38305
2298,1847,451,476,85800,38310
432,380,52,484,114900,38311
1041,791,250,635,88800,38313
1365,1101,264,595,75700,38315
1350,1092,258,578,76800,38316
1028,791,237,606,62300,38317
195,131,64,-,55500,38318
4417,3250,1167,575,87800,38320
848,584,264,583,105100,38321
1117,938,179,843,97300,38326
180,122,58,483,80000,38327
216,187,29,569,85400,38328
1353,1091,262,598,87600,38329
1739,1299,440,582,75100,38330
545,478,67,(X),77300,38332
197,190,7,-,85100,38333
657,563,94,708,89300,38334
479,351,128,642,81300,38337
242,202,40,706,77100,38339
4540,3247,1293,633,107800,38340
950,775,175,575,91800,38341
573,458,115,545,57400,38342
6180,4547,1633,600,90100,38343
3261,2532,729,526,89800,38344
958,689,269,800,107400,38345
140,81,59,-,(X),38347
509,457,52,729,75000,38348
6900,4866,2034,571,95800,38351
172,124,48,-,116900,38352
2145,1762,383,1044,152500,38355
1063,858,205,669,85800,38356
1052,703,349,566,103500,38357
4432,3205,1227,622,99100,38358
127,105,22,467,84600,38359
384,316,68,686,103100,38361
406,343,63,1071,86400,38362
2380,1773,607,538,86300,38363
13,0,13,-,-,38365
803,664,139,731,124700,38366
1089,882,207,808,83600,38367
687,579,108,582,67900,38368
721,578,143,534,80400,38369
315,257,58,564,67900,38370
452,350,102,604,95500,38371
6434,4814,1620,560,98200,38372
891,614,277,461,84600,38374
3511,2476,1035,595,88500,38375
105,96,9,-,(X),38376
545,466,79,601,94600,38379
256,207,49,582,102300,38380
595,363,232,625,78800,38381
3909,2564,1345,583,89900,38382
140,115,25,-,128700,38387
816,569,247,627,86600,38388
351,273,78,509,90800,38390
407,320,87,700,84700,38391
270,258,12,-,83200,38392
21064,13852,7212,680,134800,38401
646,522,124,629,92900,38425
1033,794,239,613,99800,38449
1014,850,164,419,83800,38450
1822,1455,367,681,140400,38451
514,480,34,-,78900,38452
152,148,4,-,(X),38453
506,399,107,682,105100,38454
56,48,8,390,137500,38455
1508,1294,214,595,111500,38456
282,238,44,568,100000,38457
222,169,53,544,73000,38459
523,425,98,746,85700,38460
496,461,35,772,116800,38461
3896,3012,884,551,88700,38462
1093,889,204,524,79300,38463
8849,6141,2708,563,96400,38464
1865,1582,283,630,99700,38468
1659,1343,316,525,93100,38469
182,152,30,625,130400,38471
1072,906,166,567,103000,38472
468,351,117,646,82400,38473
3192,2323,869,626,93600,38474
211,177,34,-,121900,38475
520,422,98,921,309200,38476
1132,897,235,532,110800,38477
6720,4514,2206,611,113700,38478
406,285,121,544,82100,38481
660,527,133,670,149500,38482
2185,1805,380,559,112600,38483
2702,2106,596,461,79300,38485
365,304,61,758,95800,38486
387,186,201,595,171000,38487
934,793,141,565,119100,38488
16450,8325,8125,610,150100,38501
433,406,27,-,159500,38504
0,0,0,-,-,38505
10762,8516,2246,681,149700,38506
593,537,56,561,70800,38541
0,0,0,-,-,38542
236,204,32,360,87500,38543
2580,1981,599,644,121300,38544
472,383,89,623,89900,38545
651,584,67,-,124700,38547
239,186,53,588,122200,38548
1685,1339,346,438,89600,38549
1633,1111,522,464,102200,38551
108,91,17,-,146900,38552
973,785,188,715,98000,38553
517,408,109,516,80300,38554
7897,4981,2916,604,143200,38555
4904,3629,1275,458,88200,38556
4195,3764,431,976,210200,38558
493,444,49,611,98000,38559
497,422,75,545,93800,38560
2607,2036,571,462,88200,38562
1129,791,338,593,117400,38563
164,153,11,-,109200,38564
560,449,111,546,103100,38565
301,301,0,-,121100,38567
894,750,144,537,81700,38568
147,126,21,-,91300,38569
3866,2740,1126,518,105800,38570
5217,4293,924,571,127600,38571
4546,3933,613,680,106600,38572
932,752,180,575,140400,38573
3239,2474,765,540,99400,38574
482,410,72,572,126000,38575
403,363,40,-,129200,38577
71,62,9,-,130600,38578
373,287,86,603,105600,38579
596,487,109,(X),129800,38580
1508,1222,286,624,80800,38581
648,603,45,-,134500,38582
8940,7015,1925,604,96900,38583
1370,1168,202,515,86500,38585
568,492,76,565,102100,38587
389,311,78,234,142700,38588
106,58,48,-,(X),38589
893,698,195,490,70200,38601
1222,1076,146,663,78400,38603
5397,3942,1455,706,101400,38606
1290,999,291,598,59800,38610
6289,4993,1296,733,106100,38611
7144,3543,3601,592,65400,38614
278,193,85,311,56200,38617
4107,3219,888,694,96400,38618
2000,1368,632,582,63500,38619
1363,1192,171,757,61400,38620
596,408,188,638,55800,38621
246,160,86,529,38900,38622
141,101,40,-,28500,38623
351,253,98,511,76200,38625
650,388,262,455,112500,38626
374,268,106,738,47200,38627
627,593,34,375,82500,38629
135,112,23,-,29500,38630
388,197,191,453,57000,38631
9396,7742,1654,904,169500,38632
871,713,158,597,63100,38633
5427,4111,1316,607,78900,38635
9467,5697,3770,964,94700,38637
440,198,242,300,37300,38639
801,678,123,611,158300,38641
725,687,38,-,73700,38642
913,531,382,584,53900,38643
92,75,17,713,48300,38644
534,263,271,541,75600,38645
1212,838,374,594,67900,38646
332,275,57,-,109600,38647
1384,1006,378,603,72800,38650
2775,2531,244,769,180200,38651
6269,4229,2040,698,95300,38652
17177,13790,3387,1070,176400,38654
15032,8537,6495,820,179900,38655
852,768,84,944,71600,38658
771,676,95,645,74500,38659
777,666,111,(X),89200,38661
4636,3386,1250,560,84300,38663
1196,173,1023,713,(X),38664
867,714,153,1032,69600,38665
2322,1600,722,631,65400,38666
5184,3540,1644,709,130000,38668
356,275,81,682,45500,38670
13269,7887,5382,935,111600,38671
4167,3604,563,1609,191600,38672
198,162,36,790,(X),38673
331,281,50,-,62500,38674
2304,1227,1077,637,81600,38676
58,0,58,494,-,38677
2219,1454,765,810,136500,38680
2264,1762,502,396,54100,38683
435,391,44,-,84100,38685
8784,4637,4147,620,81800,38701
0,0,0,-,-,38702
4743,2596,2147,693,69700,38703
4,4,0,-,-,38704
285,217,68,442,52100,38720
376,261,115,575,58600,38721
146,62,84,565,45000,38722
16,16,0,-,-,38723
296,152,144,508,45000,38725
179,122,57,567,28100,38726
674,403,271,751,106000,38730
81,8,73,-,-,38731
6834,3763,3071,590,102100,38732
163,139,24,663,81300,38736
1036,473,563,491,63800,38737
86,0,86,205,-,38738
115,70,45,579,51300,38740
349,243,106,(X),37700,38744
62,32,30,-,65000,38745
175,64,111,405,32800,38746
1486,914,572,555,64100,38748
14,5,9,-,-,38749
4046,2480,1566,629,71800,38751
487,312,175,449,103800,38753
552,317,235,506,63800,38754
2390,1407,983,618,72300,38756
378,317,61,661,81300,38759
349,213,136,613,58300,38760
760,424,336,494,60200,38761
874,462,412,346,72400,38762
129,77,52,(X),68300,38764
19,0,19,-,-,38765
12,12,0,-,-,38767
39,18,21,-,-,38768
744,376,368,473,66200,38769
971,472,499,547,69400,38771
43,38,5,-,63300,38772
1219,747,472,539,70100,38773
837,492,345,426,66200,38774
531,304,227,515,60500,38778
106,58,48,181,83000,38781
11098,6776,4322,689,114300,38801
6656,4258,2398,677,141700,38804
4721,3479,1242,610,87500,38821
3266,2296,970,564,99500,38824
2086,1634,452,949,100500,38826
1119,805,314,520,87000,38827
1566,1227,339,590,79100,38828
6761,4919,1842,557,78500,38829
1107,817,290,535,64600,38833
11564,7623,3941,610,87300,38834
512,446,66,-,72400,38838
1129,761,368,670,76800,38841
4322,3225,1097,640,87000,38843
87,85,2,-,62500,38844
923,708,215,623,68400,38846
1226,1035,191,442,61900,38847
291,277,14,-,70400,38848
2221,1810,411,617,94400,38849
1128,847,281,512,58900,38850
3059,2250,809,546,65600,38851
3573,2693,880,547,86200,38852
1810,1347,463,654,90800,38855
801,783,18,286,81000,38856
1284,1060,224,577,131000,38857
2793,2035,758,528,71500,38858
298,247,51,534,64200,38859
2046,1451,595,544,54300,38860
878,723,155,607,101200,38862
6972,5300,1672,600,88500,38863
611,495,116,683,64900,38864
1852,1580,272,526,80700,38865
4906,3604,1302,512,143500,38866
2053,1638,415,596,71000,38868
143,63,80,775,108900,38869
1078,861,217,562,94900,38870
647,585,62,725,103100,38871
1166,973,193,530,61300,38873
542,417,125,532,83100,38876
1169,942,227,585,57200,38878
383,138,245,593,106500,38879
6245,4450,1795,587,95800,38901
121,100,21,-,68800,38913
231,150,81,668,56400,38914
1594,1106,488,487,69400,38915
2169,1409,760,489,67000,38916
1279,1024,255,556,80600,38917
211,166,45,-,68400,38920
1215,867,348,445,73700,38921
1424,1111,313,461,61600,38922
506,457,49,-,78800,38923
307,227,80,444,58200,38924
1023,787,236,632,72700,38925
337,293,44,-,41100,38927
37,16,21,384,27500,38928
469,422,47,-,65000,38929
8827,4945,3882,535,77000,38930
741,601,140,810,78700,38940
1514,593,921,609,66900,38941
84,84,0,-,(X),38943
161,103,58,444,(X),38944
22,0,22,-,-,38945
127,78,49,675,44200,38946
246,201,45,-,42400,38947
1069,937,132,504,43000,38948
62,47,15,-,-,38949
121,114,7,-,(X),38950
462,398,64,804,48600,38951
215,125,90,720,73000,38952
209,177,32,-,133100,38953
459,227,232,584,46000,38954
209,169,40,(X),82800,38957
11,11,0,-,-,38958
214,167,47,-,85800,38961
27,27,0,-,110300,38962
1516,1061,455,582,51000,38963
51,14,37,515,-,38964
3429,2497,932,520,81700,38965
232,155,77,683,56300,38966
2640,1992,648,504,84300,38967
2104,1076,1028,545,59400,39038
648,482,166,673,88900,39039
1466,1093,373,587,60500,39040
1366,1029,337,487,81400,39041
13017,10516,2501,899,152400,39042
1461,1364,97,593,81100,39044
447,436,11,-,83800,39045
9207,5756,3451,692,153400,39046
14552,12119,2433,1185,179700,39047
5791,4212,1579,616,75800,39051
124,71,53,466,34600,39054
9301,6382,2919,915,153800,39056
636,475,161,771,65000,39057
4109,3191,918,745,85600,39059
21,21,0,-,-,39061
179,123,56,594,83100,39062
1248,780,468,574,61300,39063
1547,1241,306,551,80400,39066
607,519,88,616,50500,39067
1889,1094,795,414,61500,39069
2098,1519,579,605,144000,39071
7067,5604,1463,740,119000,39073
5337,3818,1519,606,66400,39074
353,301,52,311,93900,39078
525,347,178,563,48700,39079
487,409,78,-,59300,39082
3492,2495,997,612,76800,39083
597,448,149,769,45600,39086
58,35,23,-,-,39088
5204,3502,1702,563,80500,39090
1186,999,187,655,78600,39092
1407,1118,289,525,88800,39094
2640,1649,991,516,52400,39095
394,298,96,-,44400,39096
197,116,81,441,34600,39097
817,685,132,717,58100,39108
14542,13647,895,1303,248800,39110
3349,2385,964,622,87500,39111
131,68,63,303,55700,39113
3554,2864,690,642,79400,39114
18,7,11,-,-,39115
748,629,119,732,85800,39116
3624,2738,886,664,70600,39117
2416,1905,511,488,72900,39119
11928,7777,4151,585,86200,39120
897,673,224,705,72800,39140
326,253,73,437,41300,39144
1758,1397,361,716,118600,39145
935,700,235,466,60600,39146
509,469,40,-,104600,39149
2157,1431,726,577,62200,39150
460,343,117,569,73300,39152
1576,1286,290,613,72100,39153
3291,2803,488,703,151200,39154
135,135,0,-,(X),39156
10562,5094,5468,971,174800,39157
1329,758,571,517,66100,39159
1124,873,251,544,41400,39160
38,33,5,-,61700,39162
201,132,69,239,63600,39166
0,0,0,-,-,39167
2439,1918,521,638,80900,39168
969,528,441,340,41500,39169
3696,3293,403,682,162200,39170
55,32,23,-,(X),39174
1527,1255,272,763,73100,39175
564,415,149,387,95000,39176
29,24,5,-,(X),39177
498,374,124,-,101200,39179
12684,8203,4481,697,98500,39180
5596,3602,1994,636,111700,39183
1444,1068,376,468,77900,39189
2679,2298,381,607,84500,39191
534,388,146,683,66300,39192
0,0,0,-,-,39193
5889,3274,2615,567,67600,39194
276,13,263,929,-,39201
3469,1140,2329,686,166100,39202
1977,876,1101,613,49600,39203
6280,2546,3734,710,70400,39204
9810,4621,5189,765,100300,39206
11117,6747,4370,798,112500,39208
9748,4697,5051,718,64100,39209
10262,6542,3720,939,161600,39211
11351,7328,4023,848,88900,39212
8656,4762,3894,628,60200,39213
1518,718,800,671,190700,39216
0,0,0,-,-,39217
2608,1593,1015,880,120900,39218
3227,1535,1692,954,194600,39232
0,0,0,-,-,39269
4729,3547,1182,1061,133700,39272
10233,5790,4443,655,75100,39301
8130,5609,2521,770,147500,39305
6296,3738,2558,651,66100,39307
0,0,0,-,-,39309
710,625,85,786,128800,39320
526,504,22,-,74000,39322
509,457,52,719,56500,39323
2272,2022,250,546,111800,39325
295,198,97,673,68600,39326
1393,1058,335,592,97500,39327
1597,1175,422,500,65200,39328
915,837,78,625,99200,39330
610,517,93,589,67800,39332
1152,1063,89,939,63800,39335
404,311,93,-,70400,39336
721,617,104,367,100700,39337
1362,1094,268,588,56800,39338
6276,4195,2081,591,80200,39339
2415,1660,755,522,59100,39341
529,175,354,826,95600,39342
2650,1973,677,535,73200,39345
888,699,189,570,77100,39346
694,579,115,535,49700,39347
329,269,60,-,43200,39348
9070,6367,2703,614,77800,39350
213,185,28,-,82600,39352
625,485,140,760,80100,39354
2613,2125,488,533,69900,39355
218,166,52,-,56100,39356
686,482,204,282,43800,39358
108,84,24,725,126100,39359
1517,1309,208,545,70700,39360
723,592,131,(X),49500,39361
1011,870,141,466,63900,39362
768,563,205,587,47200,39363
1280,1112,168,-,77100,39364
2649,2050,599,539,72500,39365
574,500,74,-,49500,39366
5618,4667,951,506,71500,39367
16838,7234,9604,675,90800,39401
16115,9984,6131,885,185200,39402
0,0,0,-,-,39406
1134,830,304,536,72600,39421
2208,1787,421,637,69900,39422
990,901,89,384,71500,39423
617,508,109,523,84500,39425
6221,5265,956,896,137400,39426
658,575,83,558,65700,39427
3263,2524,739,645,69200,39428
6264,4570,1694,649,85800,39429
4936,3867,1069,670,89200,39437
1783,1508,275,610,78300,39439
7513,4088,3425,611,75800,39440
7956,6424,1532,547,95200,39443
1541,1184,357,526,79000,39451
9050,7637,1413,715,104600,39452
3684,2899,785,602,83200,39455
445,383,62,498,131000,39456
1330,1134,196,633,88200,39459
235,211,24,-,101600,39461
507,408,99,501,87300,39462
807,733,74,654,113800,39464
7376,5315,2061,850,131400,39465
10391,7235,3156,762,104300,39466
4645,3599,1046,744,102000,39470
2343,1616,727,534,87300,39474
4278,3174,1104,810,150500,39475
2702,2351,351,577,84900,39476
273,230,43,542,84200,39477
845,660,185,-,56900,39478
2066,1718,348,830,79900,39479
1072,886,186,647,102900,39480
694,587,107,721,83100,39481
3281,2771,510,739,146200,39482
2430,2068,362,567,63700,39483
8539,3547,4992,807,89200,39501
18342,11764,6578,833,138100,39503
7675,3610,4065,847,136600,39507
6617,4140,2477,775,137000,39520
3378,2786,592,1205,157500,39525
3536,1529,2007,727,111800,39530
7397,2377,5020,778,136900,39531
13118,8535,4583,855,164300,39532
0,0,0,-,-,39534
3824,1671,2153,941,106800,39540
6024,4155,1869,848,111000,39553
3200,2818,382,767,102100,39556
6763,4235,2528,987,139100,39560
791,633,158,1051,124400,39561
6137,5094,1043,721,110700,39562
5223,3519,1704,774,87000,39563
13848,10038,3810,965,144300,39564
6396,5466,930,879,150900,39565
4482,2533,1949,707,115700,39567
5146,4077,1069,804,165500,39571
597,546,51,705,86600,39572
2741,2331,410,646,110900,39573
4737,4013,724,876,136100,39574
2390,1264,1126,711,133400,39576
3393,2496,897,730,105100,39577
4137,1975,2162,762,95500,39581
8903,6179,2724,633,88700,39601
2339,1999,340,743,85500,39629
388,194,194,506,71200,39630
1364,1024,340,438,69700,39631
414,318,96,411,69300,39633
78,78,0,-,(X),39635
1353,956,397,610,48400,39638
1585,1297,288,780,91700,39641
497,388,109,909,(X),39643
2016,1833,183,654,84400,39645
426,387,39,-,155800,39647
8389,4829,3560,610,80600,39648
2817,2073,744,684,72900,39652
1229,1036,193,488,72700,39653
2154,1635,519,556,88000,39654
349,349,0,-,77700,39656
710,582,128,595,74600,39657
1159,841,318,547,57200,39661
527,477,50,-,76100,39662
1060,826,234,733,81300,39663
763,602,161,(X),58100,39664
422,359,63,558,94800,39665
3453,2808,645,548,96400,39666
4707,4081,626,423,90700,39667
197,165,32,-,72300,39668
1714,1419,295,536,50400,39669
5456,2560,2896,554,90400,39701
8621,5741,2880,819,109000,39702
5602,3006,2596,830,153800,39705
4377,3080,1297,558,73800,39730
1517,990,527,403,77600,39735
105,61,44,460,65500,39736
96,96,0,-,109800,39737
953,691,262,559,75600,39739
1956,1665,291,1059,142100,39740
473,415,58,864,66700,39741
622,519,103,525,62100,39743
2319,1584,735,463,70500,39744
278,207,71,706,58300,39745
1299,1059,240,549,110100,39746
867,687,180,552,59200,39747
933,687,246,636,65200,39750
644,595,49,496,86400,39751
1187,975,212,533,76600,39752
313,251,62,-,73900,39755
808,591,217,778,77300,39756
16263,8253,8010,723,154300,39759
0,0,0,-,-,39760
0,0,0,-,-,39762
1117,943,174,(X),82900,39766
254,224,30,-,54800,39767
846,734,112,596,82800,39769
39,32,7,-,81800,39771
660,497,163,670,60200,39772
6399,4305,2094,651,85200,39773
648,593,55,530,73200,39776
791,558,233,558,59600,39813
680,437,243,673,69200,39815
3724,2124,1600,566,92500,39817
4487,2621,1866,691,136600,39819
2985,1968,1017,590,82800,39823
204,159,45,(X),71500,39824
612,257,355,595,127400,39825
159,101,58,610,97000,39826
1487,848,639,688,143400,39827
5558,2882,2676,761,108600,39828
955,767,188,572,127500,39834
183,116,67,-,85700,39836
2489,1672,817,595,91300,39837
2050,1133,917,602,57100,39840
257,193,64,673,74100,39841
2968,1694,1274,589,84100,39842
3044,2256,788,660,76000,39845
805,455,350,357,65700,39846
845,437,408,380,75000,39851
1002,765,237,690,69700,39854
422,334,88,450,80900,39859
516,294,222,554,(X),39861
495,403,92,563,57700,39862
161,136,25,430,67600,39866
159,138,21,-,83200,39867
856,587,269,398,76700,39870
128,110,18,763,55900,39877
35,22,13,1021,85000,39885
633,467,166,447,88400,39886
1298,935,363,716,102200,39897
846,738,108,1564,188100,40003
11152,8265,2887,715,138600,40004
1899,1532,367,666,113600,40006
67,58,9,-,(X),40007
1312,1049,263,719,130500,40008
469,391,78,556,83800,40009
176,141,35,-,350400,40010
879,640,239,701,104400,40011
181,161,20,-,84200,40012
2012,1703,309,803,145700,40013
6864,6027,837,834,255200,40014
1497,938,559,669,115800,40019
51,44,7,-,88300,40020
304,283,21,966,239300,40022
1640,1635,5,-,305800,40023
16,16,0,-,714300,40025
1859,1685,174,1225,265500,40026
6954,5550,1404,759,206900,40031
4907,3417,1490,548,99600,40033
81,46,35,-,(X),40036
1095,961,134,601,100400,40037
189,140,49,485,95000,40040
155,0,155,689,-,40041
1456,1013,443,788,99200,40045
758,696,62,-,144200,40046
7630,6673,957,691,164500,40047
0,0,0,-,-,40048
0,0,0,-,-,40049
617,329,288,637,116600,40050
1620,1207,413,601,107300,40051
231,148,83,554,102800,40052
737,587,150,1012,188000,40055
1252,1144,108,1174,173900,40056
1356,952,404,783,111900,40057
42,19,23,729,89400,40058
6561,5962,599,1328,380500,40059
433,327,106,608,120700,40060
135,125,10,-,89800,40062
6,6,0,-,-,40063
10844,6804,4040,793,166500,40065
1879,1428,451,849,206000,40067
776,605,171,739,160800,40068
3157,2387,770,545,101400,40069
139,139,0,-,179500,40070
5294,4214,1080,615,172000,40071
537,385,152,686,104500,40075
968,773,195,631,158200,40076
158,147,11,-,174400,40077
947,845,102,825,72500,40078
504,412,92,716,84700,40104
861,668,193,762,135200,40107
4329,3201,1128,672,135700,40108
698,595,103,889,136900,40109
6,0,6,-,-,40110
604,454,150,345,56600,40111
229,226,3,-,84900,40115
881,736,145,950,140900,40117
3419,2431,988,759,91900,40118
716,576,140,617,108900,40119
2227,17,2210,1168,-,40121
164,100,64,-,115000,40140
936,763,173,770,90100,40142
2217,1697,520,530,91700,40143
637,567,70,529,153300,40144
250,199,51,584,77000,40145
1538,1095,443,638,80300,40146
1444,1084,360,685,122300,40150
237,230,7,-,116100,40152
446,164,282,608,68700,40155
241,227,14,-,82400,40157
9153,4739,4414,665,118400,40160
86,66,20,-,543800,40161
2231,1779,452,774,176200,40162
12308,9509,2799,748,154200,40165
148,105,43,325,69700,40170
136,128,8,-,48600,40171
5376,4201,1175,738,137000,40175
376,360,16,-,83100,40176
561,388,173,652,83400,40177
191,117,74,1025,87400,40178
2641,165,2476,521,469400,40202
8986,1309,7677,484,82700,40203
7139,3446,3693,774,168400,40204
10529,7806,2723,732,238700,40205
9629,4910,4719,705,173900,40206
13764,9410,4354,912,263900,40207
5739,1586,4153,721,85300,40208
175,57,118,803,92100,40209
5868,2218,3650,556,64400,40210
9056,3920,5136,673,70000,40211
6838,3149,3689,731,61300,40212
6883,4174,2709,717,107800,40213
17951,9605,8346,685,120100,40214
8141,3641,4500,735,75600,40215
16888,10643,6245,640,107300,40216
5942,3781,2161,733,129300,40217
13646,7011,6635,698,123800,40218
15777,8753,7024,669,120800,40219
14204,8916,5288,826,159500,40220
9649,5809,3840,870,235600,40222
8880,6457,2423,945,248000,40223
6179,5287,892,750,147300,40228
13767,10610,3157,871,121000,40229
0,0,0,-,-,40231
12296,8521,3775,1031,238500,40241
4556,3099,1457,950,179100,40242
4462,3247,1215,994,194200,40243
11502,9695,1807,1101,306200,40245
10328,7758,2570,828,117600,40258
14076,10732,3344,786,115400,40272
106,20,86,954,-,40280
14117,10725,3392,861,166400,40291
14857,11610,3247,815,187800,40299
235,164,71,631,70000,40310
2902,2086,816,498,85000,40311
2329,1590,739,523,76000,40312
1385,773,612,639,82100,40313
69,69,0,-,59400,40316
1204,878,326,515,77800,40322
16228,11471,4757,764,163800,40324
400,358,42,1050,114200,40328
7815,5541,2274,572,133200,40330
24,24,0,-,-,40334
5163,3583,1580,539,73700,40336
2014,1603,411,577,91600,40337
0,0,0,-,-,40339
8297,6373,1924,723,136800,40342
296,226,70,570,(X),40346
1061,739,322,838,176000,40347
256,120,136,611,89100,40348
43,43,0,-,77500,40350
7179,4540,2639,606,121200,40351
8154,4952,3202,654,122400,40353
15775,10130,5645,793,160900,40356
239,204,35,-,46800,40358
2624,1797,827,490,94400,40359
2401,1775,626,620,73200,40360
7162,4397,2765,695,141100,40361
0,0,0,-,-,40363
926,746,180,586,188200,40370
1164,877,287,579,77600,40371
939,709,230,719,147800,40372
676,513,163,582,77100,40374
0,0,0,-,-,40376
1311,834,477,694,127700,40379
2375,1673,702,584,78800,40380
8661,6054,2607,716,187800,40383
1035,733,302,720,83200,40385
878,719,159,479,79600,40387
2402,1402,1000,629,147600,40390
14055,9002,5053,700,142600,40391
1042,789,253,573,59400,40402
9229,6342,2887,654,123800,40403
0,0,0,-,-,40404
1591,1120,471,539,72500,40409
1838,1469,369,470,84100,40419
9282,5991,3291,634,140900,40422
74,18,56,-,-,40434
2088,1711,377,535,87800,40437
809,570,239,709,90800,40440
576,396,180,(X),77100,40442
5461,4106,1355,626,136000,40444
363,276,87,456,64400,40445
3447,2612,835,501,62300,40447
21,0,21,-,-,40448
3691,2831,860,469,83100,40456
404,311,93,542,44600,40460
1318,853,465,647,139000,40461
443,392,51,729,83800,40464
820,496,324,577,108000,40468
628,461,167,580,54400,40472
21895,12195,9700,643,155300,40475
98,95,3,-,115200,40481
4509,3111,1398,576,104000,40484
919,734,185,328,69500,40486
1430,1149,281,735,75300,40489
12376,6963,5413,799,304900,40502
12335,7773,4562,825,167500,40503
11022,4159,6863,622,138000,40504
11122,6201,4921,649,110700,40505
0,0,0,-,-,40506
1181,236,945,537,292900,40507
9776,2226,7550,678,107600,40508
14559,8615,5944,901,212700,40509
352,280,72,864,376700,40510
12035,7457,4578,771,143100,40511
4241,3289,952,1085,326100,40513
5759,4883,876,1106,187400,40514
14077,9323,4754,921,204100,40515
1157,828,329,910,161100,40516
16168,6211,9957,773,127800,40517
21279,13439,7840,688,137900,40601
0,0,0,-,-,40604
12016,7821,4195,548,95200,40701
2148,1659,489,596,59800,40729
1286,976,310,629,76900,40734
408,296,112,-,53000,40737
1096,780,316,516,93000,40740
8826,5680,3146,578,104700,40741
98,48,50,-,122200,40743
6976,5255,1721,669,105500,40744
1152,948,204,632,57200,40759
205,155,50,475,48300,40763
6173,3700,2473,572,66300,40769
538,380,158,579,54400,40771
195,153,42,-,59600,40801
957,641,316,576,53100,40806
180,150,30,681,57600,40807
18,18,0,-,110000,40808
586,454,132,580,49600,40810
259,220,39,-,57000,40813
566,464,102,538,35300,40815
13,7,6,-,-,40816
46,40,6,-,(X),40818
294,279,15,-,68800,40819
196,145,51,956,27000,40820
1793,1202,591,408,48300,40823
229,136,93,483,46100,40824
252,200,52,553,60900,40826
268,215,53,-,52500,40827
1318,908,410,497,49900,40828
136,93,43,-,(X),40829
126,98,28,-,43800,40830
2241,1293,948,390,74300,40831
93,74,19,-,(X),40840
99,94,5,-,62900,40843
64,40,24,-,(X),40844
281,268,13,-,41900,40845
115,76,39,-,32600,40847
123,104,19,-,41600,40849
444,244,200,448,59200,40854
346,252,94,683,50700,40855
327,289,38,-,46500,40856
133,133,0,-,(X),40858
232,213,19,-,61300,40862
231,213,18,-,24400,40863
165,133,32,479,68100,40865
442,364,78,330,52400,40868
160,136,24,-,138500,40870
806,615,191,545,52900,40873
210,151,59,-,37300,40874
419,300,119,571,33700,40902
257,208,49,573,75800,40903
4555,2508,2047,551,78600,40906
92,52,40,500,50900,40913
104,52,52,444,46000,40914
342,249,93,578,88300,40915
141,94,47,-,75300,40921
223,143,80,425,62200,40923
117,91,26,-,38600,40927
1043,752,291,610,62100,40935
142,94,48,-,52300,40939
240,215,25,-,57000,40940
109,57,52,431,(X),40941
264,204,60,764,81200,40943
80,80,0,-,(X),40946
285,207,78,-,82400,40949
338,210,128,465,88800,40953
217,151,66,-,(X),40958
6703,5036,1667,469,57100,40962
13,0,13,-,-,40964
5612,3238,2374,513,74400,40965
488,352,136,540,42100,40972
3510,2545,965,341,54600,40977
47,41,6,-,42100,40979
175,138,37,-,30600,40982
163,123,40,-,(X),40983
194,134,60,-,28100,40988
28,28,0,-,29100,40995
128,106,22,525,(X),40997
5922,5027,895,846,164500,41001
915,653,262,552,94000,41002
924,641,283,661,87500,41003
1664,1244,420,539,95600,41004
8175,6272,1903,919,172000,41005
1609,1268,341,579,115300,41006
1415,1173,242,811,166900,41007
2750,1517,1233,627,104900,41008
1281,1128,153,698,104800,41010
11140,4741,6399,673,157400,41011
3086,1304,1782,726,83200,41014
8204,5665,2539,726,111000,41015
2443,1499,944,733,105400,41016
15035,10992,4043,738,183900,41017
10347,6901,3446,816,115100,41018
2139,1293,846,729,120300,41030
6096,4071,2025,559,114500,41031
705,655,50,835,115100,41033
433,334,99,553,83300,41034
3674,2643,1031,658,133300,41035
1108,848,260,449,80900,41039
2799,2049,750,545,95300,41040
2843,1967,876,491,100400,41041
20325,12905,7420,850,145800,41042
679,580,99,639,154800,41043
316,279,37,579,86300,41044
514,337,177,713,113400,41045
430,334,96,739,89100,41046
4845,3942,903,1105,206600,41048
863,691,172,593,102500,41049
9507,7756,1751,954,160300,41051
28,28,0,-,-,41052
658,533,125,620,140100,41055
5560,3556,2004,543,99000,41056
917,776,141,623,160500,41059
13,13,0,-,-,41062
1144,1025,119,678,150100,41063
822,641,181,530,98300,41064
8488,4152,4336,697,111400,41071
2641,1833,808,670,113400,41073
2099,1259,840,761,89700,41074
6561,4613,1948,739,193200,41075
7164,5349,1815,851,160000,41076
608,506,102,943,151400,41080
471,344,127,631,101700,41083
262,144,118,841,77700,41085
1209,1026,183,739,99000,41086
5823,5356,467,1700,234900,41091
1158,999,159,833,159700,41092
1014,932,82,534,54200,41093
5001,3824,1177,933,180400,41094
1269,670,599,613,112800,41095
2294,1691,603,774,123800,41097
747,644,103,694,105000,41098
0,0,0,-,-,41099
7881,4777,3104,613,93700,41101
7987,6090,1897,662,105200,41102
629,614,15,-,108400,41121
475,350,125,517,83200,41124
4036,3136,900,590,116100,41129
139,139,0,-,55000,41132
70,51,19,-,(X),41135
3319,2288,1031,689,88300,41139
786,657,129,608,59300,41141
50,37,13,-,-,41142
5587,4222,1365,562,86900,41143
3799,3065,734,615,89300,41144
167,82,85,662,(X),41146
264,213,51,246,50700,41149
170,129,41,403,47900,41159
5068,4161,907,552,70900,41164
398,309,89,635,67500,41166
1058,994,64,-,84900,41168
2294,1677,617,563,122600,41169
1494,1118,376,403,73200,41171
401,202,199,508,85000,41174
2132,1731,401,633,85300,41175
3056,2217,839,322,66300,41179
442,381,61,663,52700,41180
560,492,68,595,97000,41183
934,744,190,546,72700,41189
108,97,11,-,(X),41201
284,220,64,608,56300,41203
208,175,33,-,79200,41204
223,202,21,-,37500,41214
406,301,105,527,55000,41216
737,596,141,539,52100,41219
958,846,112,713,60000,41222
1877,1318,559,488,91300,41224
103,103,0,-,79100,41226
4442,3403,1039,496,79600,41230
452,283,169,695,80300,41231
319,254,65,676,61200,41232
175,175,0,-,93900,41234
331,307,24,-,73000,41238
2962,1751,1211,538,92500,41240
409,321,88,339,36800,41250
163,156,7,-,137500,41254
416,306,110,529,101400,41255
909,798,111,785,80100,41256
140,125,15,-,101600,41257
333,199,134,359,115700,41260
599,392,207,367,88700,41262
182,100,82,286,71000,41263
115,96,19,-,119400,41264
718,570,148,777,74200,41265
316,233,83,383,53200,41267
184,175,9,-,82200,41268
115,115,0,-,71200,41271
220,135,85,(X),(X),41274
2397,1558,839,500,52000,41301
2741,2071,670,437,71000,41311
1889,1430,459,350,67700,41314
66,57,9,-,"10,000-",41317
468,389,79,447,56100,41332
4478,3244,1234,472,49100,41339
497,403,94,613,34400,41348
332,257,75,473,81900,41352
168,130,38,-,53900,41360
226,149,77,472,68300,41365
6,6,0,-,-,41366
37,37,0,-,57400,41367
134,117,17,-,62100,41385
18,18,0,-,(X),41390
9,9,0,-,-,41397
127,101,26,613,81100,41408
67,67,0,-,"10,000-",41421
488,356,132,535,80700,41425
230,176,54,-,42000,41464
4520,3267,1253,476,55900,41465
3670,2676,994,505,75400,41472
9635,6079,3556,636,104000,41501
239,149,90,494,93200,41503
331,234,97,627,74500,41512
220,169,51,-,76100,41513
1312,767,545,766,68500,41514
29,29,0,-,(X),41517
533,443,90,602,110100,41519
2094,1753,341,464,55400,41522
111,103,8,-,55000,41524
48,48,0,-,73800,41526
321,245,76,760,138100,41527
351,252,99,-,62800,41528
448,393,55,850,72100,41531
111,84,27,-,29300,41534
203,169,34,-,94200,41535
2088,1555,533,549,56400,41537
27,18,9,-,-,41538
671,561,110,582,64700,41539
120,93,27,-,32800,41540
206,155,51,-,(X),41543
390,322,68,555,63600,41544
90,62,28,-,32500,41547
331,253,78,215,72100,41548
1105,921,184,555,53800,41553
431,356,75,541,55000,41554
363,285,78,538,77200,41555
707,565,142,579,79600,41557
284,225,59,743,33800,41558
147,131,16,-,51900,41559
152,88,64,-,(X),41560
1195,886,309,597,66300,41562
162,157,5,-,48200,41563
453,334,119,591,96100,41564
284,267,17,-,49300,41566
86,77,9,-,43200,41567
350,280,70,-,33300,41568
167,136,31,498,32500,41571
1508,1239,269,617,67400,41572
411,356,55,900,75200,41601
210,168,42,-,83700,41602
430,411,19,-,58600,41603
202,193,9,-,65200,41604
253,241,12,-,81700,41605
308,268,40,-,36800,41606
196,157,39,538,(X),41607
27,20,7,-,28000,41612
215,157,58,-,(X),41615
334,233,101,769,71300,41616
186,152,34,524,86700,41619
156,87,69,-,97400,41621
118,85,33,-,120500,41622
518,378,140,618,63500,41630
455,374,81,-,47600,41631
246,185,61,-,42400,41632
1285,759,526,617,118200,41635
378,325,53,-,36100,41636
457,341,116,714,59400,41640
286,172,114,575,134300,41642
56,53,3,-,(X),41643
528,351,177,520,(X),41645
581,355,226,525,81500,41647
1079,732,347,400,73300,41649
203,147,56,383,61500,41650
4738,2962,1776,503,93000,41653
428,327,101,-,51400,41655
143,127,16,-,58800,41659
195,171,24,-,36800,41660
182,89,93,-,32500,41663
337,174,163,663,47100,41666
262,219,43,-,49200,41667
293,204,89,509,40800,41669
6898,4752,2146,541,77500,41701
178,143,35,-,(X),41712
48,48,0,-,-,41713
87,70,17,-,53200,41714
409,351,58,(X),41600,41719
216,188,28,492,38000,41721
613,492,121,(X),68300,41722
502,418,84,470,63100,41723
69,56,13,-,(X),41725
296,284,12,-,80000,41727
40,0,40,-,-,41729
443,321,122,496,43200,41731
96,43,53,581,31800,41735
29,29,0,-,142700,41739
335,259,76,465,70800,41740
81,70,11,-,75500,41745
269,190,79,-,128100,41746
1300,930,370,493,41700,41749
131,125,6,-,60500,41751
97,71,26,-,28100,41754
128,100,28,-,80600,41759
10,10,0,-,-,41760
58,58,0,-,46100,41762
242,153,89,533,83200,41763
305,266,39,-,48200,41764
36,36,0,-,63800,41766
81,59,22,-,(X),41772
533,416,117,609,51300,41773
938,673,265,537,67400,41774
38,19,19,-,-,41775
504,394,110,482,46000,41776
388,279,109,(X),46000,41777
329,283,46,484,(X),41804
173,149,24,-,97100,41810
190,186,4,-,(X),41812
348,277,71,-,48300,41815
60,55,5,-,(X),41817
136,85,51,-,53200,41819
310,282,28,-,43700,41821
815,547,268,291,58600,41822
445,326,119,525,(X),41824
213,176,37,-,43900,41825
459,396,63,-,60000,41826
300,263,37,-,49800,41828
446,378,68,556,75700,41831
115,69,46,-,163200,41832
106,86,20,-,47500,41833
308,222,86,-,75600,41834
306,214,92,822,59100,41835
317,201,116,575,49000,41836
322,249,73,725,65900,41837
175,162,13,-,(X),41838
543,365,178,475,52100,41839
450,339,111,600,48200,41840
313,284,29,-,40200,41843
463,339,124,339,39900,41844
79,44,35,-,(X),41845
186,181,5,-,48500,41847
8,8,0,-,-,41848
74,18,56,-,-,41849
248,150,98,-,79400,41855
3262,2243,1019,555,59200,41858
155,120,35,-,92900,41859
25,22,3,-,(X),41861
355,292,63,525,58000,41862
12363,8017,4346,634,141100,42001
11872,7630,4242,582,106500,42003
926,859,67,477,115600,42020
667,486,181,576,57900,42021
44,44,0,-,273100,42022
1016,810,206,552,77900,42023
625,462,163,500,85000,42024
7948,6302,1646,585,114000,42025
943,828,115,467,137500,42027
265,227,38,-,59700,42028
2320,1666,654,607,99900,42029
1236,906,330,538,50800,42031
64,47,17,907,51900,42032
308,274,34,673,104500,42035
505,475,30,481,103600,42036
7,0,7,-,-,42037
2031,1559,472,427,127700,42038
724,624,100,(X),79600,42039
462,399,63,821,129200,42040
2065,1277,788,493,73700,42041
1174,1065,109,675,166900,42044
932,641,291,674,106300,42045
73,73,0,-,178100,42047
893,625,268,917,77000,42048
716,558,158,483,116900,42049
1190,748,442,435,47300,42050
1148,1005,143,489,101300,42051
1988,1820,168,701,116300,42053
367,367,0,-,151300,42054
1074,1000,74,(X),154800,42055
872,660,212,595,107700,42056
876,722,154,628,93500,42058
29,17,12,-,-,42060
31,31,0,-,-,42061
3384,2674,710,493,75500,42064
9171,6296,2875,577,88300,42066
268,222,46,(X),77100,42069
11644,6475,5169,584,122000,42071
526,481,45,614,95300,42076
762,615,147,450,74600,42078
503,440,63,-,121000,42079
865,736,129,475,73400,42081
822,624,198,(X),133300,42082
162,117,45,-,101800,42083
100,25,75,579,39600,42084
302,255,47,686,60400,42085
1664,1328,336,582,138500,42086
896,776,120,723,96600,42087
936,787,149,738,78900,42088
20950,10178,10772,666,108900,42101
37,37,0,-,(X),42102
8027,5363,2664,770,179400,42103
12657,7511,5146,721,167200,42104
1048,738,310,525,74100,42120
1561,1377,184,935,172500,42122
343,279,64,533,85300,42123
30,14,16,-,-,42124
2539,1643,896,560,97200,42127
2755,2101,654,474,84500,42129
33,23,10,-,(X),42130
634,507,127,492,82100,42133
6557,4035,2522,643,115000,42134
432,332,100,617,61200,42140
12430,8244,4186,604,108800,42141
98,87,11,-,43900,42151
116,71,45,802,66300,42153
303,219,84,534,83200,42154
67,67,0,-,93800,42156
102,63,39,-,84100,42157
500,442,58,692,110600,42159
498,380,118,728,78400,42160
53,10,43,-,-,42163
6347,4627,1720,607,98500,42164
963,830,133,635,79700,42166
3342,2375,967,553,76200,42167
492,435,57,713,114900,42170
2927,2261,666,677,114400,42171
927,625,302,619,90400,42202
188,153,35,803,121500,42204
2081,1581,500,604,112800,42206
608,490,118,532,90000,42207
1612,1274,338,495,80000,42210
5597,4571,1026,567,115300,42211
190,160,30,573,111900,42214
507,465,42,582,111400,42215
1354,1039,315,663,90800,42217
2513,1925,588,555,85200,42220
4339,19,4320,1108,-,42223
222,177,45,-,108500,42232
1002,571,431,621,93300,42234
253,220,33,732,110200,42236
16853,9118,7735,653,115100,42240
102,76,26,785,73000,42254
1789,1480,309,614,79000,42256
368,331,37,592,73000,42259
4322,3120,1202,533,92600,42261
3039,862,2177,862,94400,42262
433,336,97,547,89700,42265
763,495,268,589,135100,42266
218,193,25,(X),93100,42273
1050,783,267,558,129800,42274
301,171,130,540,74600,42275
6114,3814,2300,567,91700,42276
132,97,35,-,65000,42280
147,147,0,-,69800,42285
442,285,157,734,105700,42286
17633,11331,6302,641,112500,42301
15368,10443,4925,646,115900,42303
2939,2029,910,528,92800,42320
60,50,10,-,42000,42321
28,28,0,-,-,42322
315,250,65,720,93100,42323
506,459,47,183,77000,42324
859,719,140,473,78000,42325
174,163,11,-,83900,42326
1507,1263,244,438,109400,42327
558,485,73,618,87600,42328
3290,2387,903,477,73800,42330
28,24,4,-,26000,42332
482,333,149,560,73500,42333
750,626,124,525,60000,42337
48,48,0,-,83100,42338
292,247,45,343,79100,42339
706,545,161,438,55900,42343
430,329,101,-,50600,42344
4219,3377,842,556,95000,42345
2338,1860,478,483,87400,42347
2001,1555,446,537,114000,42348
481,440,41,(X),50300,42349
549,432,117,547,75200,42350
1431,1162,269,547,102700,42351
832,634,198,638,82200,42352
102,73,29,486,52800,42354
750,665,85,738,95500,42355
0,0,0,-,-,42356
216,191,25,-,91200,42361
2022,1831,191,751,144600,42366
267,208,59,588,73100,42367
406,380,26,-,115200,42368
104,76,28,525,43000,42369
0,0,0,-,-,42370
207,196,11,-,97800,42371
694,578,116,470,83300,42372
111,97,14,-,154900,42374
2266,1831,435,643,96100,42376
1028,890,138,764,115900,42378
1076,752,324,526,66100,42404
1261,1027,234,497,86400,42406
2617,1901,716,475,62700,42408
939,693,246,548,74100,42409
600,333,267,604,45100,42410
654,559,95,513,91100,42411
1278,1143,135,807,139900,42413
15800,9414,6386,614,108900,42420
10891,7296,3595,609,100600,42431
418,326,92,(X),113100,42436
3104,2291,813,582,94700,42437
349,273,76,726,56600,42440
623,485,138,581,86300,42441
1193,983,210,533,80700,42442
4522,3102,1420,532,98600,42445
1604,1153,451,491,55700,42450
341,257,84,687,59000,42451
861,705,156,568,117800,42452
229,187,42,834,(X),42453
1132,727,405,647,90600,42455
563,465,98,448,97200,42456
376,357,19,-,114000,42458
1665,1164,501,471,69400,42459
543,346,197,482,57000,42461
344,287,57,795,109100,42462
48,44,4,-,38800,42463
739,636,103,519,69300,42464
7279,4272,3007,564,81300,42501
9401,6462,2939,642,142600,42503
204,156,48,-,80600,42516
1190,1022,168,644,84100,42518
1200,1007,193,598,51100,42519
561,430,131,467,81200,42528
331,195,136,634,88700,42533
4025,3147,878,484,77800,42539
265,256,9,-,(X),42541
2446,1920,526,637,98000,42544
1924,1482,442,521,112700,42553
223,173,50,-,56100,42565
249,240,9,-,85400,42566
2394,1827,567,467,68600,42567
3835,2869,966,528,66000,42602
35,35,0,-,60500,42603
2081,1493,588,514,90800,42629
45,45,0,-,-,42631
7583,5287,2296,479,79700,42633
530,383,147,500,34100,42634
1281,855,426,503,74500,42635
72,0,72,-,-,42638
4967,3649,1318,511,85300,42642
1519,1080,439,472,61600,42647
1165,825,340,624,60400,42649
1601,1124,477,598,58700,42653
19699,12624,7075,760,158800,42701
554,460,94,625,98000,42712
637,541,96,718,79200,42713
94,94,0,-,96300,42715
625,527,98,590,99700,42716
2713,1939,774,454,63700,42717
9517,6228,3289,580,93500,42718
1313,1039,274,540,82800,42721
230,219,11,-,94300,42722
1585,1279,306,672,153300,42724
1969,1529,440,492,95500,42726
6080,4369,1711,500,85300,42728
603,440,163,666,98900,42729
53,53,0,-,(X),42731
753,616,137,759,86600,42732
486,399,87,516,89600,42733
720,645,75,918,128900,42740
212,173,39,718,66800,42741
3705,2831,874,523,75300,42743
798,631,167,578,75000,42746
3267,2311,956,672,108900,42748
1973,1311,662,502,83600,42749
238,216,22,-,66000,42753
5997,4166,1831,523,98800,42754
1053,813,240,658,84700,42757
40,33,7,-,51800,42758
139,66,73,-,(X),42762
232,166,66,570,81100,42764
2486,1758,728,426,84200,42765
1022,774,248,595,119500,42776
414,377,37,-,71100,42782
964,713,251,608,90200,42784
138,138,0,-,160100,42788
1035,894,141,1532,176200,43001
1567,1378,189,1289,158000,43002
930,725,205,696,122300,43003
9074,6488,2586,865,156600,43004
43,22,21,-,78800,43005
223,187,36,792,(X),43006
1042,662,380,655,59300,43008
713,578,135,1029,164300,43009
130,84,46,638,83500,43010
2651,2265,386,674,173100,43011
469,409,60,694,132200,43013
1295,855,440,562,117000,43014
19238,13467,5771,855,174000,43015
13978,7790,6188,1072,255100,43016
14255,10315,3940,1111,310000,43017
3358,2674,684,719,126800,43019
3643,3515,128,1603,352300,43021
1089,826,263,630,189700,43022
3997,3415,582,962,262000,43023
2325,1742,583,656,163000,43025
21992,16030,5962,856,184200,43026
3079,2576,503,917,144000,43028
161,112,49,823,168200,43029
49,0,49,-,-,43030
4755,3846,909,780,182300,43031
60,28,32,-,-,43032
155,82,73,818,100000,43033
8695,6983,1712,951,264500,43035
107,59,48,675,84500,43036
173,75,98,526,83700,43037
11133,8084,3049,840,168000,43040
1959,1568,391,780,129000,43044
633,525,108,773,152300,43045
1482,1130,352,763,176400,43046
11309,7122,4187,701,120300,43050
8467,6354,2113,1218,301600,43054
24665,14925,9740,684,121500,43055
6915,5202,1713,833,139800,43056
961,694,267,670,113200,43060
1489,1317,172,1031,207600,43061
10143,8037,2106,1038,168300,43062
4921,4021,900,652,222200,43064
14113,12458,1655,1030,302000,43065
560,502,58,969,164900,43066
422,393,29,-,116800,43067
21206,11971,9235,863,134600,43068
39,39,0,-,63800,43070
805,659,146,982,127800,43071
2092,1795,297,715,114300,43072
4253,3541,712,1087,219200,43074
3623,2786,837,864,138800,43076
115,71,44,680,95000,43077
8407,5680,2727,676,124300,43078
1866,1462,404,660,134600,43080
23195,14504,8691,994,176600,43081
11316,10087,1229,1195,282600,43082
298,268,30,1019,118100,43084
10211,7376,2835,1009,220200,43085
141,111,30,528,75400,43101
1664,1249,415,744,154400,43102
4014,3081,933,730,156100,43103
2922,2255,667,901,184100,43105
640,373,267,669,85600,43106
1165,854,311,866,115100,43107
40,27,13,1083,94400,43109
13253,8531,4722,890,157200,43110
131,104,27,-,63900,43111
1486,1223,263,677,212900,43112
8980,5943,3037,744,144900,43113
522,383,139,563,107200,43115
466,406,60,1201,174700,43116
35,35,0,-,(X),43117
9943,7004,2939,840,135800,43119
23044,16441,6603,891,148600,43123
5403,3362,2041,843,128800,43125
159,101,58,760,108200,43126
56,56,0,-,101700,43127
873,542,331,659,90500,43128
23375,14753,8622,735,133300,43130
1729,1292,437,581,133100,43135
195,105,90,832,170700,43136
637,558,79,1250,109200,43137
7480,5311,2169,571,104900,43138
7645,5013,2632,783,147000,43140
69,35,34,683,80800,43142
2213,1611,602,640,121500,43143
166,115,51,528,45200,43144
607,437,170,661,115600,43145
3243,2858,385,1048,156900,43146
13664,11356,2308,1018,187600,43147
795,533,262,801,140500,43148
1067,846,221,627,143100,43149
811,679,132,563,151000,43150
68,53,15,1016,85500,43151
291,194,97,573,89400,43152
341,288,53,786,152800,43153
1139,848,291,789,149400,43154
991,815,176,867,145400,43155
82,73,9,556,81800,43156
217,142,75,854,90000,43157
102,98,4,-,53500,43158
9143,5326,3817,695,108800,43160
2595,1972,623,731,133900,43162
730,500,230,850,115500,43164
11508,2080,9428,858,203700,43201
9707,3205,6502,851,176800,43202
3429,822,2607,623,86400,43203
15560,7550,8010,855,98300,43204
5205,1791,3414,690,102800,43205
9783,4491,5292,854,97100,43206
17185,9933,7252,821,84600,43207
11566,6527,5039,790,206000,43209
279,0,279,599,-,43210
8079,3022,5057,762,57500,43211
9693,3749,5944,861,269500,43212
13916,4688,9228,771,97700,43213
12323,7878,4445,823,211200,43214
8170,1728,6442,920,254700,43215
767,25,742,850,28300,43217
10867,4936,5931,795,82800,43219
11857,6536,5321,864,257600,43220
13150,9659,3491,1018,239600,43221
1307,442,865,719,54200,43222
8524,4006,4518,734,79000,43223
16274,7866,8408,678,86500,43224
8841,4483,4358,777,80300,43227
21228,9185,12043,773,110700,43228
20011,8149,11862,763,120000,43229
22120,14496,7624,985,169200,43230
7812,4202,3610,847,126800,43231
17430,7233,10197,737,93000,43232
17941,9405,8536,962,211900,43235
1826,877,949,1105,184300,43240
20046,12993,7053,685,89300,43302
1297,1104,193,902,114600,43310
7721,5091,2630,726,123500,43311
1128,1028,100,783,128500,43314
2517,1960,557,699,123500,43315
2416,1721,695,613,113600,43316
44,42,2,-,75000,43317
1758,1272,486,677,125600,43318
421,410,11,-,95100,43319
695,505,190,717,113500,43320
124,87,37,941,84200,43321
157,103,54,600,75700,43322
304,235,69,735,112200,43323
1182,1021,161,813,143400,43324
5161,3506,1655,582,92900,43326
41,32,9,415,64000,43330
2247,1740,507,676,86800,43331
715,474,241,843,97300,43332
293,261,32,-,112500,43333
2334,1855,479,699,134400,43334
0,0,0,-,-,43336
398,382,16,850,130900,43337
3790,2988,802,617,128300,43338
588,489,99,813,114500,43340
472,368,104,836,102100,43341
1216,993,223,787,124100,43342
464,334,130,508,90000,43343
2116,1616,500,668,126700,43344
264,244,20,750,115200,43345
553,465,88,645,116700,43347
758,443,315,563,84400,43348
4578,3074,1504,604,105000,43351
449,390,59,892,135600,43356
1589,1322,267,563,146500,43357
1025,866,159,586,123500,43358
286,221,65,594,103000,43359
673,543,130,754,182400,43360
13512,6482,7030,648,163300,43402
0,0,0,-,-,43403
698,466,232,770,92300,43406
263,262,1,-,111200,43407
126,119,7,1075,81100,43408
4058,3033,1025,645,99100,43410
1895,1579,316,764,147100,43412
562,499,63,725,107400,43413
1075,890,185,592,134300,43416
12535,8957,3578,628,107600,43420
1884,1579,305,727,125600,43430
1610,1250,360,713,114700,43431
421,401,20,-,117400,43432
10,10,0,-,-,43433
41,25,16,-,68300,43434
500,415,85,538,123500,43435
183,132,51,803,103000,43437
76,71,5,-,282800,43438
27,20,7,-,62200,43439
2403,1981,422,748,171000,43440
455,370,85,855,102500,43442
734,630,104,664,144900,43443
442,422,20,-,138300,43445
69,66,3,-,257100,43446
1422,1270,152,690,128600,43447
3286,2642,644,774,123900,43449
1341,1088,253,967,150300,43450
371,278,93,682,134800,43451
6138,4519,1619,662,141500,43452
254,189,65,536,372500,43456
502,416,86,572,96800,43457
164,125,39,788,100800,43458
2817,2032,785,652,134500,43460
425,314,111,690,104900,43462
9,9,0,-,-,43463
412,315,97,1262,123200,43464
2366,1715,651,731,98000,43465
891,702,189,763,112100,43466
32,26,6,-,58000,43467
116,79,37,-,97100,43468
1141,900,241,638,142200,43469
319,231,88,780,87500,43501
2407,1810,597,645,133200,43502
500,455,45,1146,158300,43504
38,22,16,625,90000,43505
6312,4636,1676,632,108700,43506
400,345,55,975,119400,43511
11269,8297,2972,681,110200,43512
3213,2759,454,601,134300,43515
1046,830,216,797,89000,43516
1485,1212,273,611,103500,43517
1047,868,179,694,91500,43518
80,52,28,-,67300,43519
1205,867,338,558,78000,43521
1142,1014,128,675,147400,43522
0,0,0,-,-,43523
459,372,87,668,98600,43524
437,379,58,(X),158200,43525
2234,1636,598,587,98500,43526
811,687,124,719,86600,43527
6284,4641,1643,838,166900,43528
87,62,25,713,51800,43529
57,0,57,(X),-,43531
1499,1315,184,750,131900,43532
637,507,130,678,115600,43533
625,533,92,623,91600,43534
326,298,28,820,111800,43535
181,175,6,-,124200,43536
10951,8036,2915,761,162400,43537
638,540,98,477,148000,43540
66,60,6,1100,65700,43541
1283,1205,78,-,232700,43542
3185,2413,772,629,83700,43543
5795,4415,1380,678,116400,43545
133,133,0,-,171300,43547
258,231,27,541,103900,43548
497,403,94,663,108400,43549
15048,10300,4748,863,182600,43551
74,57,17,-,114000,43553
1102,756,346,711,97200,43554
103,69,34,-,114000,43555
725,588,137,799,102100,43556
907,743,164,624,112800,43557
5011,4323,688,705,142000,43558
11931,9209,2722,794,179300,43560
184,132,52,733,129200,43565
2910,2414,496,1019,173900,43566
4916,3597,1319,659,122000,43567
1184,997,187,652,92000,43569
1278,948,330,591,94200,43570
2573,2255,318,643,191200,43571
4282,578,3704,328,33100,43604
10120,4785,5335,615,43600,43605
9959,5380,4579,675,118600,43606
9595,4722,4873,668,55500,43607
5213,3194,2019,743,46500,43608
9045,4176,4869,614,48700,43609
1758,921,837,671,54600,43610
7855,5350,2505,600,83200,43611
11888,6845,5043,678,70700,43612
13461,9066,4395,698,90600,43613
13737,7885,5852,683,110800,43614
17856,9665,8191,726,98200,43615
8553,5965,2588,620,129600,43616
2688,2276,412,960,194400,43617
3187,2485,702,788,113200,43619
2562,652,1910,504,71700,43620
9242,5524,3718,648,115200,43623
22880,14166,8714,627,104100,43701
15,0,15,-,-,43711
2932,2289,643,520,99100,43713
755,663,92,545,99300,43716
69,49,20,650,78800,43717
1288,1109,179,563,98900,43718
983,754,229,463,97000,43719
463,367,96,735,131600,43720
20,20,0,-,-,43721
136,120,16,-,56400,43722
1901,1105,796,599,76700,43723
2888,2344,544,604,83300,43724
8085,5571,2514,581,101200,43725
452,362,90,874,96900,43727
423,311,112,567,66000,43728
897,783,114,542,77600,43730
2195,1546,649,485,73700,43731
723,637,86,381,115800,43732
23,23,0,-,-,43733
590,431,159,751,94200,43734
205,122,83,638,76200,43735
29,26,3,-,54400,43736
55,33,22,596,73800,43738
772,695,77,815,133900,43739
164,134,30,784,97800,43740
587,426,161,814,164600,43746
374,322,52,917,82000,43747
1000,742,258,566,82100,43748
1033,893,140,839,81800,43749
76,76,0,-,71300,43750
694,516,178,492,122900,43754
534,454,80,963,111300,43755
2363,1608,755,524,93000,43756
1263,972,291,580,84300,43758
34,26,8,570,46700,43759
784,707,77,621,156000,43760
24,24,0,-,-,43761
1891,1394,497,642,127600,43762
3142,2079,1063,565,88900,43764
711,504,207,714,71800,43766
516,461,55,1118,132800,43767
135,103,32,775,85500,43768
706,597,109,750,76300,43771
692,560,132,629,70000,43772
1179,991,188,563,99000,43773
1688,1263,425,466,75600,43777
511,427,84,675,112700,43778
418,407,11,(X),79500,43779
720,628,92,610,120300,43780
299,238,61,588,47000,43782
1743,1395,348,581,158500,43783
13,12,1,-,35000,43786
1113,972,141,534,86200,43787
316,237,79,464,111900,43788
2245,1716,529,535,83600,43793
349,313,36,(X),88500,43802
856,659,197,490,154000,43804
24,24,0,-,23100,43805
309,225,84,497,81300,43811
7791,5266,2525,550,91000,43812
1602,1234,368,679,109000,43821
1776,1389,387,702,119200,43822
1273,1014,259,388,114600,43824
2494,2012,482,636,149800,43830
2894,2145,749,636,94300,43832
64,58,6,575,66300,43836
721,585,136,581,107300,43837
489,432,57,744,129600,43840
104,89,15,-,(X),43842
437,386,51,775,124000,43843
1384,1123,261,598,108300,43844
1882,1534,348,642,89700,43845
999,816,183,706,78500,43901
24,24,0,-,-,43902
916,766,150,494,93700,43903
95,57,38,-,(X),43905
3548,2369,1179,502,80800,43906
2422,1863,559,595,88000,43907
549,470,79,627,77600,43908
1302,1146,156,802,99100,43910
2927,2059,868,475,80000,43912
668,401,267,437,64200,43913
27,27,0,-,-,43914
593,493,100,597,101300,43915
1297,1171,126,627,77500,43917
9374,6018,3356,574,81900,43920
108,47,61,-,-,43925
119,74,45,532,43300,43926
48,38,10,-,(X),43927
33,33,0,-,-,43928
367,284,83,914,95300,43930
89,68,21,-,139300,43931
289,260,29,575,50400,43932
807,627,180,575,84800,43933
179,156,23,-,54100,43934
3778,2485,1293,509,77000,43935
2285,1835,450,498,71000,43938
227,201,26,1150,65400,43939
125,125,0,-,63100,43940
1061,873,188,472,84400,43942
1321,1070,251,715,78500,43943
983,778,205,529,106100,43944
1196,852,344,524,84500,43945
943,715,228,574,94300,43946
2296,1807,489,602,88200,43947
247,198,49,338,61000,43948
5786,4354,1432,666,138900,43950
59,33,26,-,86900,43951
7375,4255,3120,559,81200,43952
4906,3353,1553,692,110200,43953
147,85,62,640,50700,43961
29,27,2,-,66300,43962
588,385,203,646,78200,43963
3879,2852,1027,633,87100,43964
0,0,0,-,-,43967
2641,1775,866,514,82600,43968
23,23,0,-,-,43970
522,327,195,512,76300,43971
71,71,0,-,(X),43972
859,636,223,618,87100,43973
32,30,2,-,62500,43974
740,622,118,707,93500,43976
1010,738,272,629,80700,43977
190,132,58,809,61500,43983
50,40,10,-,72700,43985
746,578,168,616,83800,43986
933,722,211,589,87100,43988
8124,6955,1169,821,147100,44001
1743,1277,466,462,101700,44003
13638,8248,5390,626,88300,44004
658,555,103,531,147700,44010
7955,6311,1644,1149,248900,44011
8962,7152,1810,1111,217700,44012
7380,5190,2190,704,125700,44017
2253,1768,485,770,169800,44021
6890,5686,1204,1314,337200,44022
6432,5784,648,1331,285100,44023
9091,7644,1447,703,208800,44024
4403,4093,310,959,213600,44026
3216,2787,429,961,175100,44028
6132,4335,1797,594,95800,44030
573,548,25,-,110500,44032
26728,16158,10570,716,99600,44035
12230,10535,1695,1018,160400,44039
1166,1117,49,1563,418700,44040
5876,4360,1516,639,110600,44041
4254,3683,571,982,166100,44044
144,96,48,817,126500,44045
658,618,40,856,163500,44046
3395,2630,765,659,127400,44047
970,759,211,688,104400,44048
98,81,17,642,87900,44049
2419,2036,383,820,169900,44050
11402,6137,5265,662,78800,44052
7686,5117,2569,641,134400,44053
5093,3886,1207,927,126400,44054
7768,4294,3474,657,69100,44055
4424,4031,393,1105,187900,44056
7379,5666,1713,836,125700,44057
25319,20830,4489,879,164600,44060
4131,2946,1185,679,168500,44062
648,596,52,1058,171300,44064
1696,1345,351,888,203200,44065
8278,6620,1658,969,185500,44067
13282,9853,3429,853,144800,44070
1832,1582,250,683,266600,44072
3754,2510,1244,758,159700,44074
1760,1250,510,681,121600,44076
21769,15331,6438,770,154400,44077
48,18,30,836,-,44080
2541,2254,287,994,167700,44081
469,398,71,805,140000,44082
1454,1284,170,789,145200,44084
1224,1094,130,(X),116600,44085
977,861,116,1023,160200,44086
7951,5796,2155,1007,207700,44087
6643,5048,1595,833,137100,44089
4177,3041,1136,708,163100,44090
7592,5237,2355,755,126200,44092
594,535,59,730,117000,44093
15837,10041,5796,838,177100,44094
14146,10577,3569,771,120200,44095
679,664,15,-,148500,44099
0,0,0,-,-,44101
18238,5865,12373,659,60700,44102
6973,2048,4925,573,53000,44103
9204,2441,6763,453,51600,44104
15546,7705,7841,672,50900,44105
11129,3334,7795,704,125200,44106
24641,10908,13733,698,131100,44107
9644,4503,5141,668,59300,44108
16999,8054,8945,650,74000,44109
8989,3087,5902,605,54400,44110
16927,9953,6974,687,82000,44111
10077,4044,6033,591,65200,44112
9057,2198,6859,734,150600,44113
3456,344,3112,786,78000,44114
3402,254,3148,475,88200,44115
8999,6543,2456,798,207600,44116
4865,2013,2852,659,92000,44117
15694,9444,6250,882,144600,44118
5297,3247,2050,800,78500,44119
16314,7051,9263,708,96400,44120
13717,9475,4242,847,100600,44121
13553,9100,4453,1100,221300,44122
7727,4163,3564,710,78200,44123
16986,11143,5843,880,149100,44124
11674,8292,3382,807,79400,44125
7256,5345,1911,693,143900,44126
2042,792,1250,633,30100,44127
12759,7040,5719,785,73300,44128
11709,8338,3371,746,102700,44129
21765,13883,7882,741,123900,44130
8181,7678,503,1074,172400,44131
6650,3136,3514,801,84100,44132
12685,9030,3655,789,189300,44133
15935,12274,3661,771,109500,44134
11992,7386,4606,702,80600,44135
10255,7407,2848,822,190500,44136
9508,6098,3410,809,74700,44137
8850,6972,1878,909,153800,44138
8608,7318,1290,1124,265500,44139
6016,5519,497,895,210600,44140
5419,4591,828,1408,248900,44141
7565,5840,1725,855,111500,44142
10957,7610,3347,754,180900,44143
9426,5664,3762,692,93600,44144
13766,10301,3465,1029,226900,44145
13232,7451,5781,746,103100,44146
7486,6040,1446,817,215600,44147
7198,6662,536,1113,192100,44149
2611,2084,527,771,168300,44201
7660,6193,1467,1378,230600,44202
16010,11378,4632,688,101400,44203
17047,13226,3821,823,162800,44212
705,558,147,597,169500,44214
917,721,196,748,141500,44215
3568,3309,259,809,144300,44216
1568,1227,341,705,117100,44217
13489,7444,6045,768,108500,44221
7502,5705,1797,808,144000,44223
15653,10847,4806,892,168300,44224
3319,2820,499,671,136200,44230
3227,2689,538,692,138800,44231
2812,2762,50,-,295500,44233
1361,1118,243,746,180900,44234
629,537,92,(X),159000,44235
9048,7811,1237,1708,287600,44236
15779,7981,7798,767,146500,44240
6681,4602,2079,936,147300,44241
0,0,0,-,-,44243
404,354,50,1042,88200,44250
377,312,65,997,214900,44251
1139,1002,137,1037,185800,44253
1931,1425,506,596,128700,44254
3121,2431,690,803,152300,44255
23322,18551,4771,864,196400,44256
5095,4273,822,748,145300,44260
2055,1602,453,616,159200,44262
1057,834,223,1063,220900,44264
0,0,0,-,-,44265
13101,8960,4141,698,120100,44266
3298,2510,788,647,115300,44270
1824,1498,326,884,153500,44272
2701,2354,347,761,166100,44273
76,48,28,-,152800,44274
1146,966,180,740,164200,44275
665,532,133,760,158700,44276
6881,5387,1494,706,154500,44278
1739,1550,189,768,226200,44280
11692,8545,3147,808,171800,44281
14,14,0,-,-,44285
2372,2213,159,877,304000,44286
2726,2226,500,707,117700,44287
1359,802,557,694,101300,44288
6049,3590,2459,745,81100,44301
2667,1033,1634,530,86000,44302
3554,2166,1388,658,146400,44303
1481,216,1265,710,68100,44304
9619,5321,4298,683,72600,44305
8892,4434,4458,657,64700,44306
3217,1047,2170,572,59300,44307
298,8,290,531,-,44308
9691,4382,5309,674,70000,44310
3119,701,2418,648,46100,44311
13266,9712,3554,744,96800,44312
11587,6966,4621,740,143900,44313
8220,4317,3903,710,64900,44314
9664,7260,2404,772,138900,44319
8649,4803,3846,676,77000,44320
5942,4355,1587,999,207000,44321
7459,5831,1628,1077,230200,44333
1135,958,177,786,146100,44401
1140,901,239,595,122100,44402
1699,1526,173,692,102100,44403
668,547,121,499,109300,44404
3452,2297,1155,625,65700,44405
8686,7206,1480,684,168900,44406
4512,3255,1257,660,143400,44408
7514,5990,1524,680,128700,44410
777,628,149,832,118500,44411
996,784,212,807,152800,44412
3091,2377,714,615,88300,44413
629,524,105,547,128200,44417
556,487,69,512,153900,44418
6704,4662,2042,607,91500,44420
910,662,248,628,112100,44423
6527,5094,1433,638,93000,44425
671,539,132,775,104200,44427
1173,974,199,560,105000,44428
1094,774,320,786,119600,44429
1437,1179,258,585,75400,44430
1927,1560,367,726,107000,44431
4359,3237,1122,664,101200,44432
1438,1176,262,622,100700,44436
1732,1326,406,722,94300,44437
1799,1195,604,650,67600,44438
20,20,0,-,152300,44439
1869,1457,412,566,120300,44440
663,605,58,661,117400,44441
1640,1364,276,548,115900,44442
757,656,101,753,135900,44443
4350,2909,1441,664,103000,44444
1297,1104,193,545,121000,44445
8846,5174,3672,631,78000,44446
441,386,55,639,137900,44449
758,600,158,677,111100,44450
1218,985,233,779,147800,44451
1124,802,322,679,167400,44452
392,338,54,-,142400,44454
607,510,97,582,87200,44455
10912,7650,3262,629,112100,44460
1521,1362,159,737,132700,44470
4384,3087,1297,624,71500,44471
1575,1340,235,899,110500,44473
4462,3662,800,555,112900,44481
11064,7007,4057,603,86100,44483
9932,6904,3028,642,115100,44484
7086,3934,3152,620,49500,44485
361,183,178,671,75200,44490
951,874,77,838,155600,44491
24,24,0,-,-,44493
4095,2341,1754,686,32400,44502
401,0,401,236,-,44503
1810,879,931,687,62000,44504
7606,4503,3103,526,73200,44505
901,574,327,543,14000,44506
1982,858,1124,642,19700,44507
5185,3013,2172,648,48500,44509
1026,406,620,533,16900,44510
8433,6108,2325,631,83400,44511
15047,9840,5207,624,112400,44512
9455,7648,1807,760,137500,44514
11899,7324,4575,597,95700,44515
13546,8866,4680,632,92600,44601
2169,1725,444,600,144600,44606
64,57,7,-,(X),44607
1005,798,207,633,124100,44608
1668,1337,331,593,121600,44609
86,33,53,-,-,44610
666,542,124,630,120900,44611
2152,1600,552,715,142400,44612
846,582,264,688,87300,44613
4977,3872,1105,683,142100,44614
4235,3147,1088,615,109700,44615
2341,1783,558,584,157400,44618
574,477,97,580,157300,44620
1867,1185,682,614,88200,44621
7538,5416,2122,723,119100,44622
1538,1194,344,523,187000,44624
594,362,232,759,119700,44625
1249,1063,186,734,117900,44626
1663,1410,253,555,207500,44627
396,353,43,829,115700,44628
933,726,207,689,103400,44629
3619,2871,748,730,155100,44632
977,796,181,754,162300,44633
837,666,171,735,143400,44634
1163,797,366,633,116800,44637
594,478,116,628,148300,44638
69,54,15,850,90000,44640
7912,6092,1820,724,137900,44641
1183,1026,157,759,115300,44643
1816,1382,434,538,120500,44644
873,734,139,775,150700,44645
18372,12501,5871,693,126500,44646
7403,5703,1700,707,101800,44647
245,187,58,530,107500,44651
15,15,0,-,-,44652
225,114,111,689,80000,44653
5675,4139,1536,538,170600,44654
1247,1016,231,664,95000,44656
4030,3012,1018,641,116400,44657
55,33,22,621,89000,44659
82,61,21,625,63800,44661
3657,3007,650,705,117100,44662
10235,6682,3553,675,115100,44663
1045,891,154,824,161000,44666
5434,3917,1517,712,130700,44667
511,444,67,782,151400,44669
158,138,20,-,84800,44670
131,108,23,-,75400,44671
2065,1144,921,778,71200,44672
934,799,135,844,115800,44675
1795,1489,306,650,120500,44676
917,667,250,716,134600,44677
50,50,0,-,-,44678
1863,1333,530,789,134400,44680
2503,1855,648,588,152900,44681
366,256,110,685,94300,44682
3376,2280,1096,617,71100,44683
10145,8443,1702,772,168100,44685
9,0,9,-,-,44687
1300,952,348,582,106000,44688
187,156,31,653,116700,44689
46,31,15,-,160200,44690
17596,11633,5963,646,138600,44691
28,28,0,-,68600,44693
650,550,100,525,107700,44695
98,77,21,664,211400,44697
299,234,65,645,98200,44699
550,15,535,250,-,44702
3793,1474,2319,603,63300,44703
1535,802,733,499,57300,44704
7210,3913,3297,602,67600,44705
6984,4938,2046,674,93900,44706
3816,1915,1901,436,75000,44707
10670,7187,3483,783,115300,44708
8225,4805,3420,661,113300,44709
4166,2329,1837,669,72300,44710
3803,2406,1397,708,92900,44714
5216,3518,1698,696,228700,44718
16184,11783,4401,767,158200,44720
5353,4494,859,731,148400,44721
2298,1931,367,733,111800,44730
339,292,47,603,120400,44802
480,379,101,444,115700,44804
12793,8566,4227,673,117100,44805
963,699,264,734,87100,44807
149,149,0,-,111500,44809
4972,3827,1145,633,111400,44811
2937,2352,585,690,118000,44813
1033,886,147,776,143800,44814
253,201,52,644,78900,44815
36,36,0,-,-,44816
611,550,61,667,109000,44817
959,753,206,541,85100,44818
7563,5099,2464,646,93400,44820
1061,941,120,777,118600,44822
1547,1234,313,669,143400,44824
19,19,0,-,73000,44825
616,544,72,(X),130300,44826
2804,1937,867,594,80100,44827
12,12,0,-,-,44828
7798,5702,2096,575,78000,44830
7147,5033,2114,614,86700,44833
872,585,287,737,99600,44836
1630,1271,359,595,116700,44837
98,85,13,738,92100,44838
5258,4111,1147,782,166000,44839
1195,974,221,718,140700,44840
234,175,59,675,89300,44841
2173,1509,664,613,106400,44842
944,703,241,657,128900,44843
216,177,39,713,86100,44844
1067,766,301,931,166200,44846
1554,1186,368,703,130900,44847
881,685,196,728,103500,44849
7,7,0,-,-,44850
1830,1397,433,683,107000,44851
490,427,63,703,132900,44853
672,494,178,682,86600,44854
450,378,72,1044,111500,44855
83,78,5,-,78000,44856
9194,6320,2874,632,125600,44857
500,414,86,689,139700,44859
30,25,5,-,67500,44861
1349,1091,258,611,128300,44864
1309,969,340,629,90100,44865
726,601,125,809,133600,44866
866,717,149,639,132800,44867
17279,10593,6686,657,106200,44870
115,84,31,758,92500,44874
5678,3822,1856,636,99700,44875
1097,882,215,660,107600,44878
976,862,114,1132,146300,44880
9,9,0,-,-,44881
1119,903,216,763,100700,44882
11013,7519,3494,656,102600,44883
415,365,50,629,103800,44887
2602,2138,464,822,157600,44889
4274,2747,1527,588,101600,44890
0,0,0,-,-,44901
1695,805,890,537,46000,44902
9982,6973,3009,621,111600,44903
5760,4158,1602,672,142400,44904
4685,3393,1292,630,81400,44905
7198,4622,2576,640,86100,44906
6445,3971,2474,548,87000,44907
218,100,118,771,69200,45001
4910,3655,1255,750,207600,45002
283,198,85,634,95000,45003
11927,8274,3653,762,127300,45005
23393,16842,6551,798,174200,45011
20374,15043,5331,737,133800,45013
17757,11280,6477,836,143400,45014
4675,3073,1602,763,88700,45015
7056,5860,1196,736,141500,45030
134,97,37,1013,97500,45032
145,80,65,1018,57600,45033
396,364,32,-,217600,45034
12321,8810,3511,810,187100,45036
8432,6705,1727,1125,185800,45039
18578,14922,3656,1125,231900,45040
21,0,21,-,-,45041
10478,7664,2814,834,130000,45042
19356,11538,7818,753,139300,45044
3165,2232,933,907,155500,45050
6,0,6,-,-,45051
1546,1365,181,661,217400,45052
1199,1170,29,-,254600,45053
1020,884,136,946,228800,45054
7823,3802,4021,802,190700,45056
309,204,105,781,109600,45062
972,925,47,775,159300,45064
1895,1364,531,797,171900,45065
8222,7217,1005,984,220400,45066
4980,3508,1472,899,127400,45067
4188,3411,777,863,198700,45068
18248,14505,3743,1047,204100,45069
83,59,24,725,69600,45070
965,572,393,499,84100,45101
8807,6240,2567,801,143400,45102
12097,8504,3593,726,153700,45103
4518,3247,1271,664,131900,45106
3358,2555,803,794,121800,45107
117,103,14,-,134400,45111
20,12,8,-,85000,45112
1346,1101,245,798,159900,45113
51,43,8,-,-,45115
1343,1053,290,851,119100,45118
1178,829,349,607,115500,45120
3483,2413,1070,519,119000,45121
3899,3194,705,792,127200,45122
3340,2117,1223,626,90800,45123
1348,1221,127,669,111100,45130
108,71,37,733,71000,45131
92,61,31,625,80800,45132
9449,6711,2738,646,104600,45133
1778,1246,532,561,125300,45135
19422,15368,4054,967,210800,45140
1379,1035,344,735,119100,45142
1862,1242,620,525,82900,45144
0,0,0,-,-,45145
524,343,181,812,134400,45146
29,29,0,-,141300,45147
516,389,127,837,87300,45148
12606,9221,3385,753,162700,45150
4029,3387,642,822,190300,45152
629,502,127,1064,133600,45153
3159,2441,718,694,107100,45154
105,76,29,716,71600,45155
26,13,13,694,(X),45156
3546,2982,564,674,151400,45157
123,81,42,625,96100,45158
1165,769,396,748,105100,45159
404,103,301,542,113400,45160
959,757,202,723,156300,45162
87,61,26,675,66900,45164
49,49,0,-,76800,45166
1514,1060,454,611,98000,45167
540,420,120,650,107400,45168
1783,1154,629,643,88000,45169
2442,2052,390,764,126600,45171
42,31,11,-,66300,45172
760,718,42,2042,484000,45174
3140,2311,829,644,126300,45176
8945,5463,3482,699,130100,45177
7233,1675,5558,829,316300,45202
1434,236,1198,248,164900,45203
2814,971,1843,641,63400,45204
7191,2545,4646,648,69000,45205
5934,1748,4186,579,182600,45206
2217,970,1247,671,81800,45207
8908,5433,3475,860,314700,45208
5508,2214,3294,719,209900,45209
16177,7951,8226,646,103300,45211
10015,4805,5210,662,118400,45212
5462,3285,2177,629,142900,45213
3313,605,2708,561,62400,45214
12429,7008,5421,756,137300,45215
4113,2014,2099,646,84100,45216
2761,1469,1292,663,94400,45217
1452,1050,402,908,116100,45218
5727,1168,4559,752,114700,45219
6587,1998,4589,673,238900,45220
5561,2321,3240,643,102600,45223
8889,5358,3531,638,107300,45224
3650,540,3110,457,60000,45225
2423,1475,948,765,257700,45226
8181,4210,3971,759,121300,45227
5715,1670,4045,531,109600,45229
11538,8342,3196,685,157300,45230
16425,10626,5799,776,100300,45231
2458,476,1982,351,74500,45232
5448,4593,855,613,190800,45233
10864,6747,4117,883,138200,45236
8787,3922,4865,686,99100,45237
18593,10696,7897,618,117900,45238
11464,7151,4313,711,112100,45239
10320,6317,4003,903,116600,45240
9556,7266,2290,855,202700,45241
8802,6909,1893,1096,270000,45242
5510,4888,622,1101,310600,45243
10161,8135,2026,859,221500,45244
8095,5354,2741,834,162700,45245
5706,3014,2692,892,133300,45246
8961,7112,1849,821,192400,45247
9607,8321,1286,774,137600,45248
5284,3467,1817,1122,288200,45249
8316,6088,2228,855,111500,45251
1863,1759,104,1229,211800,45252
8411,6026,2385,891,183600,45255
56,39,17,-,-,45301
1365,1150,215,726,162000,45302
854,642,212,629,85000,45303
2747,2177,570,636,117900,45304
4208,3444,764,924,174400,45305
946,750,196,691,142600,45306
105,73,32,833,69600,45307
1588,1284,304,669,113900,45308
5251,3975,1276,696,143500,45309
100,98,2,-,103800,45310
2380,1901,479,694,113100,45311
543,474,69,953,176700,45312
1468,1016,452,680,180800,45314
1658,1381,277,631,165700,45315
55,34,21,930,118800,45316
316,275,41,-,131700,45317
2140,1605,535,676,140200,45318
138,100,38,700,130000,45319
5976,4242,1734,707,112400,45320
365,271,94,710,93400,45321
8631,6708,1923,741,110400,45322
2329,1772,557,738,122100,45323
16873,8488,8385,771,112500,45324
909,788,121,776,142700,45325
356,311,45,888,131600,45326
3632,2903,729,831,148000,45327
206,134,72,783,70500,45328
352,273,79,713,92200,45330
9874,6376,3498,604,104300,45331
282,172,110,713,90000,45332
400,373,27,767,147000,45333
850,615,235,774,100600,45334
2498,1955,543,869,139000,45335
52,37,15,1094,143800,45336
667,572,95,817,177500,45337
1921,1592,329,722,122500,45338
565,368,197,722,124600,45339
198,180,18,944,141100,45340
1554,1232,322,683,72600,45341
15734,9849,5885,829,136600,45342
6108,4712,1396,805,103400,45344
2569,1627,942,698,91200,45345
840,680,160,775,106500,45346
1789,1338,451,641,107200,45347
320,247,73,822,94400,45348
118,76,42,975,104800,45349
35,31,4,-,91000,45350
99,92,7,725,128100,45351
75,50,25,547,71400,45352
89,67,22,689,64100,45353
248,192,56,663,96200,45354
10318,6735,3583,683,89500,45356
132,106,26,583,92400,45358
666,552,114,781,124500,45359
173,120,53,708,75600,45360
124,91,33,775,87500,45361
524,458,66,569,122000,45362
612,542,70,793,173000,45363
11872,7537,4335,680,118300,45365
1834,1347,487,574,117200,45368
1310,1020,290,742,157700,45369
922,869,53,828,217400,45370
7457,5727,1730,757,167600,45371
168,108,60,733,84500,45372
14130,9296,4834,731,145700,45373
6202,4239,1963,639,138400,45377
119,106,13,594,75000,45378
1813,1485,328,581,150800,45380
2108,1702,406,697,115900,45381
449,340,109,769,92100,45382
3058,2304,754,814,119600,45383
48,41,7,-,151000,45384
15359,10978,4381,687,130500,45385
2424,1762,662,773,226500,45387
267,247,20,-,145900,45388
222,167,55,843,76900,45389
1298,866,432,479,77500,45390
4716,1645,3071,576,61100,45402
6117,2901,3216,669,55000,45403
4025,1802,2223,639,58700,45404
8010,3114,4896,631,61100,45405
9069,4879,4190,608,60800,45406
3078,1771,1307,788,137700,45409
6795,3009,3786,653,66900,45410
8758,5498,3260,695,105100,45414
5335,3589,1746,745,121100,45415
2252,1461,791,828,64600,45416
12742,6101,6641,608,52300,45417
661,550,111,730,110200,45418
6480,4647,1833,678,152800,45419
11687,6400,5287,661,84500,45420
19453,13586,5867,868,112100,45424
6648,3134,3514,689,82700,45426
0,0,0,-,-,45428
11541,7923,3618,798,141300,45429
2912,2394,518,1058,169900,45430
11419,5638,5781,1008,125200,45431
6162,4509,1653,795,120600,45432
640,24,616,1218,-,45433
4416,3994,422,1036,194000,45434
4092,2171,1921,816,80400,45439
9186,6065,3121,840,163300,45440
8238,4838,3400,770,101900,45449
12710,9390,3320,857,212600,45458
12408,8785,3623,863,185300,45459
6152,5273,879,686,154000,45502
14179,8784,5395,675,107300,45503
6921,4525,2396,738,110300,45504
8073,4175,3898,599,71100,45505
5484,2887,2597,663,71800,45506
20538,14201,6337,672,112500,45601
2196,1623,573,658,86700,45612
1222,991,231,804,86300,45613
1776,1488,288,585,99300,45614
530,417,113,541,58800,45616
77,49,28,-,-,45617
5,4,1,-,(X),45618
2967,2138,829,758,97500,45619
522,427,95,1065,80900,45620
151,98,53,738,54700,45621
70,70,0,-,(X),45622
1222,940,282,594,106300,45623
0,0,0,-,-,45624
1723,1330,393,626,126100,45628
1149,861,288,608,103500,45629
50,50,0,-,67500,45630
5938,4366,1572,615,101700,45631
745,535,210,652,76500,45634
60,60,0,-,84600,45636
8357,5968,2389,573,85100,45638
6380,4392,1988,706,100700,45640
0,0,0,-,-,45642
1730,1374,356,729,108800,45644
1325,1227,98,676,84400,45645
132,120,12,-,(X),45646
834,697,137,646,77700,45647
4618,3536,1082,553,99300,45648
140,113,27,-,67300,45650
2237,1673,564,587,90400,45651
1517,1152,365,546,107800,45652
1731,1380,351,588,122100,45653
369,314,55,850,88600,45654
2655,1708,947,606,84200,45656
893,599,294,805,79500,45657
868,707,161,673,88400,45658
982,657,325,594,79300,45659
3124,2202,922,624,97100,45660
2783,2022,761,543,97600,45661
11808,6418,5390,517,75500,45662
2395,1800,595,514,78600,45663
3965,3151,814,823,132600,45669
171,94,77,1114,56400,45671
515,459,56,-,109600,45672
142,71,71,694,78300,45673
155,82,73,384,128900,45674
511,441,70,755,95900,45678
1008,747,261,637,89500,45679
4611,3214,1397,615,114600,45680
702,605,97,728,96900,45681
946,763,183,493,78800,45682
782,617,165,541,87700,45684
414,247,167,515,110300,45685
1275,1068,207,684,69800,45686
211,175,36,-,78100,45688
5627,3576,2051,681,102800,45690
3405,2268,1137,571,83700,45692
3138,1975,1163,540,96100,45693
4541,3616,925,612,134800,45694
277,259,18,582,38200,45695
526,430,96,-,128300,45696
1949,1553,396,612,107200,45697
174,133,41,530,85000,45698
11005,5016,5989,731,149200,45701
2246,1752,494,655,125900,45710
430,366,64,689,151300,45711
4196,2975,1221,605,108600,45714
1000,786,214,551,107100,45715
168,140,28,(X),81200,45716
483,245,238,653,49000,45719
23,23,0,-,-,45721
1363,1119,244,754,91500,45723
709,675,34,-,119200,45724
178,103,75,483,94600,45727
449,398,51,880,119900,45729
1717,1166,551,672,85200,45732
196,141,55,(X),82500,45734
717,627,90,608,143400,45735
186,134,52,807,67900,45740
442,362,80,484,53000,45741
1200,995,205,682,148100,45742
546,513,33,538,136300,45743
929,829,100,810,93600,45744
500,390,110,308,112100,45745
184,151,33,382,50200,45746
11374,7724,3650,619,111900,45750
1378,961,417,511,55400,45760
660,568,92,593,83800,45761
3184,1826,1358,637,89600,45764
445,388,57,-,153100,45766
1171,876,295,469,96700,45767
652,591,61,376,108700,45768
2721,2064,657,520,95800,45769
209,185,24,-,48800,45770
1388,1098,290,554,84200,45771
824,680,144,798,88900,45772
98,68,30,-,117600,45773
485,370,115,816,91200,45775
271,193,78,624,54700,45776
339,274,65,825,107400,45778
240,189,51,586,79300,45779
1355,604,751,711,118200,45780
139,87,52,532,48100,45782
1168,1037,131,430,116300,45784
1366,1187,179,523,106900,45786
15,15,0,-,-,45787
474,454,20,-,112500,45788
57,57,0,-,38100,45789
8329,4777,3552,613,78300,45801
6088,3202,2886,577,55700,45804
9402,5704,3698,721,106200,45805
4588,3710,878,743,124600,45806
4610,3682,928,651,134000,45807
156,104,52,729,72300,45808
49,41,8,-,(X),45809
2698,1785,913,710,117400,45810
737,521,216,663,76300,45812
1451,1132,319,588,96000,45813
1107,914,193,591,132300,45814
163,123,40,600,99500,45816
2436,1862,574,620,147100,45817
121,70,51,822,77300,45819
174,145,29,657,85800,45820
549,485,64,777,96300,45821
8068,5857,2211,667,130200,45822
155,121,34,594,135800,45826
695,634,61,975,141300,45827
2396,1902,494,556,138700,45828
2311,1985,326,727,116200,45830
1278,1158,120,592,109200,45831
1175,1027,148,603,102500,45832
4225,3296,929,655,106400,45833
225,208,17,-,105000,45835
583,491,92,617,84500,45836
8,8,0,-,90000,45838
23235,15452,7783,685,134300,45840
310,238,72,756,161100,45841
1487,1210,277,676,103100,45843
1298,1140,158,683,157100,45844
1064,949,115,568,176300,45845
1408,1193,215,634,138300,45846
440,365,75,828,87400,45849
1270,1105,165,630,120700,45850
225,189,36,588,102700,45851
538,424,114,631,170700,45853
187,140,47,631,90000,45854
77,75,2,-,76500,45855
1914,1514,400,702,116800,45856
1171,895,276,709,123800,45858
159,113,46,633,59300,45859
746,644,102,587,164600,45860
53,43,10,-,71700,45861
602,473,129,641,86000,45862
402,349,53,819,86800,45863
66,55,11,550,89000,45864
1800,1515,285,618,162600,45865
103,69,34,663,71000,45866
350,293,57,643,101200,45867
254,240,14,1018,95600,45868
1777,1445,332,593,165600,45869
67,36,31,-,67500,45870
732,556,176,690,144000,45871
1562,1027,535,590,81900,45872
834,683,151,658,73900,45873
879,711,168,574,84700,45874
4331,3413,918,678,159000,45875
295,256,39,578,153600,45876
815,642,173,717,129900,45877
2594,1859,735,563,89800,45879
1006,813,193,515,89300,45880
569,486,83,847,150800,45881
1077,875,202,704,92000,45882
1256,947,309,727,173500,45883
62,23,39,-,-,45884
5120,3507,1613,674,116900,45885
240,172,68,493,56400,45886
1619,1335,284,670,96200,45887
103,54,49,778,81400,45888
482,475,7,775,142600,45889
221,183,38,783,93500,45890
6112,4262,1850,614,101700,45891
230,192,38,1115,100000,45894
7123,5406,1717,600,129300,45895
826,718,108,904,116100,45896
69,25,44,-,-,45897
475,449,26,630,86100,45898
95,89,6,-,57000,45899
4275,3208,1067,668,89000,46001
6901,5389,1512,820,101700,46011
7572,5063,2509,729,97400,46012
8099,5323,2776,684,81500,46013
7376,3302,4074,649,40100,46016
2431,1985,446,633,89800,46017
1242,1005,237,752,138500,46030
830,616,214,736,144600,46031
17456,11786,5670,1089,281500,46032
12790,11762,1028,1154,303300,46033
2748,2340,408,816,162800,46034
407,324,83,738,84900,46035
4550,3090,1460,711,77100,46036
13041,11106,1935,1188,263300,46037
15820,12032,3788,1057,178500,46038
244,204,40,688,99300,46039
3840,3213,627,751,172100,46040
8436,5929,2507,664,94800,46041
1118,879,239,725,90400,46044
27,27,0,-,182200,46045
53,0,53,-,-,46047
725,586,139,929,96800,46048
312,269,43,613,78900,46049
623,539,84,813,105300,46050
1220,930,290,741,121600,46051
9066,6351,2715,690,122900,46052
3502,3163,339,1139,182000,46055
899,796,103,644,113200,46056
379,223,156,664,99900,46057
778,622,156,713,110900,46058
13869,9666,4203,926,167900,46060
12040,9773,2267,856,184100,46062
133,109,24,715,63800,46063
5063,3955,1108,829,147500,46064
1143,925,218,755,146300,46065
1090,950,140,759,126000,46068
2772,2018,754,795,152600,46069
914,772,142,626,96200,46070
1356,1037,319,770,117100,46071
3903,2913,990,697,109500,46072
10244,8246,1998,989,241300,46074
1498,1129,369,1318,164600,46075
706,562,144,679,87900,46076
9516,7882,1634,1165,338100,46077
59,40,19,1018,87500,46103
388,336,52,589,113100,46104
803,576,227,810,107600,46105
2343,1791,552,953,163500,46106
4808,2890,1918,720,93400,46107
186,153,33,-,154200,46110
123,72,51,805,67100,46111
12681,10124,2557,961,161900,46112
5165,4063,1102,925,129000,46113
763,515,248,560,124800,46115
243,233,10,-,152500,46117
1864,1535,329,1009,163400,46118
2171,1628,543,632,132000,46120
2179,1899,280,691,149700,46121
5629,4232,1397,786,160600,46122
11751,9841,1910,1021,176000,46123
2781,1771,1010,693,96600,46124
24,19,5,-,-,46125
1994,1727,267,861,150400,46126
139,112,27,634,116000,46127
694,576,118,863,118400,46128
941,789,152,532,155200,46130
11343,7442,3901,843,124400,46131
247,213,34,745,107400,46133
6241,4372,1869,679,121000,46135
14717,10596,4121,826,147100,46140
11254,8561,2693,746,160400,46142
19496,12810,6686,878,158000,46143
83,63,20,-,(X),46144
32,24,8,-,61100,46146
1403,1166,237,805,145200,46147
2020,1602,418,635,108200,46148
882,757,125,815,164400,46149
251,228,23,-,101500,46150
11328,8291,3037,735,143600,46151
29,25,4,-,-,46155
615,489,126,647,84800,46156
1370,1204,166,862,144400,46157
8653,6755,1898,749,148200,46158
2280,1870,410,902,151700,46160
1051,838,213,668,131300,46161
178,142,36,-,118800,46162
4219,3873,346,820,191300,46163
1631,1421,210,908,144500,46164
537,457,80,731,172100,46165
870,569,301,747,104200,46166
2030,1869,161,1103,185100,46167
11774,8798,2976,934,157300,46168
610,528,82,(X),97100,46171
980,686,294,848,113800,46172
4576,3032,1544,636,92800,46173
205,135,70,818,58100,46175
10795,7063,3732,721,108600,46176
290,241,49,829,146000,46180
1623,1359,264,1221,169700,46181
539,470,69,921,114600,46182
62,62,0,-,-,46183
4518,3919,599,1094,110300,46184
633,495,138,902,146700,46186
12166,5058,7108,713,66700,46201
8697,2106,6591,831,186300,46202
14208,7562,6646,767,75100,46203
3222,545,2677,984,260500,46204
11473,5265,6208,757,130100,46205
8918,3900,5018,741,111600,46208
10150,4873,5277,799,116800,46214
1072,319,753,874,158200,46216
12015,9146,2869,893,130300,46217
11522,5433,6089,778,58300,46218
14661,8375,6286,779,97200,46219
16312,10321,5991,873,192100,46220
9339,6075,3264,768,96500,46221
12112,5364,6748,756,58800,46222
14345,4851,9494,690,95300,46224
2685,1266,1419,759,62800,46225
17395,8215,9180,753,84200,46226
23279,10133,13146,739,116000,46227
5801,4495,1306,844,138300,46228
10198,5871,4327,771,107300,46229
3557,3218,339,1361,116400,46231
9562,7841,1721,1150,138700,46234
11513,5815,5698,683,98300,46235
9836,8405,1431,1217,168000,46236
15283,10250,5033,862,131600,46237
9434,7879,1555,926,136700,46239
9230,4434,4796,869,204600,46240
10979,6191,4788,745,75500,46241
8900,4109,4791,878,174100,46250
14802,6442,8360,757,112500,46254
10188,7087,3101,780,179500,46256
3703,3564,139,1168,179400,46259
13197,6474,6723,819,167700,46260
11039,5182,5857,817,131600,46268
2680,2377,303,1249,257600,46278
3036,2037,999,1134,158500,46280
111,111,0,-,(X),46290
293,251,42,791,455900,46301
4949,3870,1079,873,167600,46303
9276,7261,2015,887,169800,46304
22587,18655,3932,950,187700,46307
4835,4069,766,847,144900,46310
7608,6956,652,981,196300,46311
10106,4503,5603,663,77600,46312
6807,4509,2298,808,133400,46319
5159,2158,3001,728,68000,46320
8659,7342,1317,915,207500,46321
9441,7437,2004,955,151100,46322
8226,5585,2641,840,89700,46323
8286,5328,2958,911,89900,46324
3721,2364,1357,818,79600,46327
356,292,64,936,147000,46340
3687,3091,596,709,162500,46341
12165,9258,2907,828,127600,46342
103,72,31,833,102400,46345
564,385,179,703,69200,46346
1739,1517,222,794,162900,46347
431,364,67,863,107800,46348
1274,1014,260,734,158100,46349
17164,12272,4892,682,134100,46350
5987,5085,902,924,173800,46356
17858,11323,6535,703,109300,46360
414,295,119,783,144900,46365
2166,1729,437,579,98700,46366
14832,10698,4134,855,137300,46368
1420,1234,186,782,157600,46371
5209,5093,116,1092,254100,46373
399,345,54,(X),122500,46374
9269,7318,1951,885,213700,46375
130,86,44,825,101900,46376
170,115,55,-,85600,46377
123,84,39,-,68600,46379
46,37,9,-,142000,46381
761,734,27,-,139200,46382
15109,10242,4867,838,177600,46383
14471,12177,2294,1026,187700,46385
1168,1052,116,929,147500,46390
2048,1742,306,693,174800,46391
2957,2457,500,719,155400,46392
117,94,23,-,114100,46393
4642,3044,1598,788,111300,46394
2580,1022,1558,639,54500,46402
5532,3016,2516,670,99900,46403
6704,4088,2616,731,67900,46404
3968,2714,1254,828,83100,46405
3783,2037,1746,764,58300,46406
4915,1873,3042,670,56100,46407
5998,3612,2386,734,72300,46408
2926,1313,1613,861,60500,46409
15165,9212,5953,895,127600,46410
1318,1035,283,717,92800,46501
101,101,0,-,91200,46502
1415,1136,279,589,112000,46504
3507,2640,867,646,145800,46506
3466,2881,585,808,139500,46507
57,48,9,-,74200,46508
1365,1165,200,641,121300,46510
1717,1297,420,749,125700,46511
15722,11049,4673,743,114100,46514
11793,6436,5357,698,100800,46516
8387,5290,3097,666,117100,46517
839,702,137,773,105300,46524
11463,7718,3745,719,121500,46526
8231,6198,2033,742,148600,46528
10848,9854,994,1185,195400,46530
573,481,92,975,109200,46531
788,665,123,721,102100,46532
4307,3429,878,685,96200,46534
1376,1055,321,730,124400,46536
192,158,34,684,78300,46537
1506,1324,182,732,161400,46538
771,677,94,656,91600,46539
3581,3143,438,792,163700,46540
1445,1131,314,570,123300,46542
989,780,209,709,226000,46543
12549,8170,4379,709,101800,46544
10507,4965,5542,686,104000,46545
4102,3119,983,601,160300,46550
2695,2230,465,632,147800,46552
1072,958,114,514,138000,46553
1975,1519,456,709,140700,46554
1208,828,380,726,150000,46555
251,1,250,655,-,46556
4944,4326,618,943,136400,46561
1972,1505,467,766,118900,46562
8785,6699,2086,681,121500,46563
2261,1868,393,847,214900,46565
3825,3101,724,690,168600,46567
398,326,72,500,133000,46570
1421,1122,299,527,245400,46571
1281,1045,236,638,141700,46573
3164,2716,448,676,111500,46574
8375,6305,2070,673,121000,46580
4652,3512,1140,816,140100,46582
1670,1053,617,733,141300,46590
44,44,0,-,33300,46595
2510,478,2032,452,85200,46601
3814,2201,1613,749,44900,46613
12563,9157,3406,611,121200,46614
6005,4058,1947,712,82600,46615
2308,1219,1089,815,72800,46616
3789,2536,1253,886,117300,46617
7428,5345,2083,731,72500,46619
9961,6811,3150,732,103000,46628
2547,2190,357,858,127800,46635
6451,4160,2291,777,122000,46637
3167,2583,584,657,118300,46701
997,834,163,603,109100,46702
6742,4770,1972,675,129100,46703
22,5,17,-,-,46704
619,426,193,424,83100,46705
7526,5870,1656,653,124400,46706
1594,1323,271,657,132500,46710
2454,1769,685,572,123000,46711
5811,4400,1411,585,109800,46714
1897,1450,447,692,89300,46721
2973,2469,504,565,138700,46723
9286,7616,1670,645,133800,46725
472,397,75,705,132600,46730
216,158,58,772,190600,46731
1140,642,498,817,90900,46732
7469,5843,1626,532,112100,46733
3031,2637,394,660,140500,46737
3069,2154,915,708,86700,46738
1300,1040,260,578,110700,46740
1490,1255,235,629,133200,46741
1378,1097,281,725,160600,46742
719,588,131,916,136100,46743
797,667,130,678,165500,46745
1487,1174,313,655,116600,46746
1215,1066,149,738,127900,46747
1953,1822,131,874,159900,46748
10415,7819,2596,655,96900,46750
6178,4316,1862,622,108100,46755
149,136,13,-,98800,46759
579,465,114,694,94400,46760
3869,2977,892,661,146200,46761
687,568,119,572,166500,46763
419,387,32,886,144600,46764
1764,1610,154,940,170300,46765
275,200,75,-,106800,46766
2677,1905,772,630,96300,46767
1072,944,128,615,121400,46770
0,0,0,-,-,46771
866,794,72,613,147500,46772
1283,1100,183,717,107500,46773
6327,4761,1566,761,108900,46774
555,464,91,(X),102400,46776
2454,2122,332,625,115200,46777
921,757,164,615,116300,46779
329,328,1,-,112200,46781
2340,2083,257,773,168200,46783
882,703,179,730,134200,46784
574,482,92,650,123000,46785
66,66,0,-,65000,46786
1423,1194,229,610,104700,46787
1109,985,124,721,168100,46788
398,349,49,815,131600,46791
1545,1110,435,882,107800,46792
1517,1262,255,586,107100,46793
599,475,124,543,124500,46794
2328,1901,427,781,147300,46795
1481,1311,170,806,120600,46797
643,568,75,582,128800,46798
84,69,15,788,(X),46799
4566,1505,3061,594,51100,46802
3472,1534,1938,566,42400,46803
11720,8413,3307,810,146100,46804
8730,4771,3959,615,79100,46805
8526,4755,3771,690,48900,46806
5898,3836,2062,710,79200,46807
7835,4742,3093,607,76400,46808
3773,2248,1525,543,82700,46809
4233,3853,380,875,266200,46814
10454,7530,2924,727,115100,46815
7576,3823,3753,570,79800,46816
7582,6356,1226,826,126300,46818
3782,2751,1031,699,99900,46819
12076,7569,4507,756,115300,46825
14020,10252,3768,736,115700,46835
7743,7187,556,1127,198900,46845
16014,10931,5083,612,84400,46901
15381,10153,5228,662,96800,46902
1163,796,367,618,110000,46910
476,378,98,848,89800,46911
434,393,41,590,121100,46913
585,448,137,625,82900,46914
287,224,63,581,111400,46915
734,654,80,652,111900,46917
972,724,248,626,102900,46919
350,289,61,920,103100,46920
8,8,0,-,-,46922
3194,2589,605,673,106500,46923
680,578,102,839,102300,46926
1803,1425,378,704,87100,46928
1221,907,314,625,96200,46929
36,27,9,638,97500,46930
72,39,33,945,67000,46931
1429,1221,208,717,101300,46932
2549,1683,866,683,80100,46933
2346,1957,389,534,114300,46936
1177,936,241,753,80200,46938
763,672,91,558,71200,46939
1014,836,178,775,103900,46940
415,365,50,594,81900,46941
63,36,27,545,59500,46943
34,13,21,-,-,46946
10564,7552,3012,612,76800,46947
291,269,22,635,89600,46950
717,642,75,544,86500,46951
8574,5902,2672,650,91200,46952
8652,5576,3076,639,66100,46953
223,150,73,521,54700,46957
211,188,23,-,91600,46958
187,167,20,-,75000,46959
411,328,83,775,91700,46960
62,52,10,-,(X),46961
3638,2426,1212,681,107100,46962
54,30,24,617,77500,46967
58,46,12,-,(X),46968
8627,5956,2671,654,80700,46970
625,537,88,832,100600,46974
5751,4391,1360,611,101900,46975
846,708,138,725,86300,46978
1734,1503,231,626,131300,46979
917,789,128,729,97400,46982
119,93,26,-,151200,46984
555,422,133,771,97600,46985
750,662,88,(X),93500,46986
295,240,55,628,115700,46987
346,305,41,663,92800,46988
1343,993,350,616,139600,46989
321,321,0,-,113100,46990
742,614,128,663,66100,46991
6876,5084,1792,622,87700,46992
1026,870,156,644,96500,46994
2783,2153,630,655,90400,46996
74,66,8,-,42200,46998
4227,3158,1069,753,140600,47001
417,205,212,643,81400,47003
4350,3250,1100,709,174400,47006
146,102,44,-,254500,47010
241,218,23,-,96100,47011
4003,3096,907,592,136800,47012
326,279,47,672,123600,47016
135,117,18,-,162500,47017
1674,1336,338,738,143200,47018
538,349,189,894,145600,47020
1146,1081,65,780,193400,47022
556,469,87,832,87900,47023
1191,955,236,694,106000,47024
8403,6512,1891,725,161600,47025
567,416,151,605,109800,47030
2118,1715,403,744,121900,47031
1131,910,221,960,123400,47032
55,38,17,553,96000,47034
163,122,41,-,83700,47035
345,309,36,777,172900,47036
1790,1284,506,654,115400,47037
656,469,187,713,151500,47038
2102,1582,520,698,135400,47040
2250,1926,324,685,164000,47041
1673,1317,356,529,116400,47042
2079,1443,636,718,114700,47043
2464,2096,368,641,182600,47060
2907,2211,696,679,91200,47102
16,16,0,-,-,47104
1636,1431,205,800,145800,47106
822,660,162,525,82700,47108
183,132,51,-,148500,47110
5453,4067,1386,706,142900,47111
6464,4864,1600,665,131500,47112
133,96,37,1292,150800,47114
884,726,158,371,128100,47115
307,240,67,-,78800,47116
1518,1419,99,626,116900,47117
1380,1125,255,380,79600,47118
3952,3812,140,1114,233300,47119
317,223,94,813,103500,47120
3789,3363,426,748,196100,47122
52,52,0,-,(X),47123
1350,1195,155,898,189800,47124
590,530,60,923,87000,47125
1496,1237,259,854,124100,47126
8217,4512,3705,746,101200,47129
17544,12137,5407,750,124000,47130
552,497,55,921,128600,47135
1653,1536,117,904,159500,47136
502,435,67,482,119400,47137
1722,1477,245,695,106700,47138
878,618,260,623,90000,47140
609,542,67,669,151100,47141
391,354,37,526,90400,47142
1081,987,94,806,173800,47143
731,627,104,719,94100,47145
442,300,142,720,158300,47147
19346,12087,7259,710,128400,47150
13,11,2,-,128100,47160
1245,1073,172,918,133400,47161
311,208,103,628,105300,47162
690,641,49,635,122500,47163
1389,1032,357,538,107100,47164
2366,1869,497,657,107200,47165
557,525,32,-,110200,47166
5739,4235,1504,606,104500,47167
5325,3610,1715,735,99600,47170
5891,4819,1072,947,159000,47172
334,308,26,-,81000,47175
425,415,10,-,124800,47177
16850,11076,5774,852,126900,47201
10404,7910,2494,751,151700,47203
2104,1545,559,701,128800,47220
643,507,136,699,90100,47223
218,155,63,918,152100,47224
87,54,33,710,63300,47226
750,662,88,738,120100,47227
1176,952,224,669,84200,47229
632,515,117,902,104800,47230
442,381,61,719,89000,47231
996,915,81,935,127500,47232
577,512,65,689,122800,47234
525,463,62,620,89000,47235
8170,5680,2490,739,120000,47240
1863,1357,506,686,99400,47243
292,238,54,950,93300,47244
1697,1320,377,750,114700,47246
55,44,11,(X),75000,47247
9238,6407,2831,673,115600,47250
643,544,99,608,88400,47260
67,48,19,850,80000,47263
680,609,71,686,120000,47264
7764,5558,2206,683,91200,47265
228,228,0,-,116200,47270
776,569,207,768,105100,47272
609,561,48,1049,117800,47273
11546,8234,3312,714,119400,47274
314,283,31,-,100800,47280
583,496,87,544,151100,47281
119,89,30,706,98600,47282
1180,917,263,653,103700,47283
11493,7373,4120,642,58100,47302
10112,5238,4874,700,76000,47303
12888,8316,4572,776,114400,47304
1692,591,1101,582,52300,47305
4,0,4,-,-,47306
1682,1281,401,612,83400,47320
69,55,14,738,61900,47324
214,192,22,-,83000,47325
625,536,89,459,91400,47326
1799,1289,510,641,83400,47327
2210,1739,471,827,110300,47330
9039,6165,2874,648,81500,47331
1334,1082,252,757,91700,47334
310,241,69,553,71400,47335
1433,1048,385,610,65100,47336
71,52,19,669,75000,47337
1092,863,229,722,82500,47338
259,230,29,520,108300,47339
1205,1020,185,664,82400,47340
833,640,193,719,92500,47341
1254,1008,246,552,94900,47342
38,27,11,1042,76300,47344
518,415,103,790,114200,47345
1607,1320,287,632,99000,47346
4042,3044,998,611,65900,47348
131,105,26,667,76800,47351
364,306,58,864,92300,47352
2344,1750,594,659,106300,47353
435,340,95,712,100000,47354
1156,922,234,595,82100,47355
2168,1779,389,660,118000,47356
466,365,101,689,87700,47357
406,315,91,895,88500,47358
1239,886,353,568,76900,47359
527,477,50,488,109500,47360
70,63,7,-,82500,47361
10902,7399,3503,617,83400,47362
45,45,0,-,88800,47367
1207,914,293,595,87300,47368
551,432,119,592,64600,47369
4860,3605,1255,568,84300,47371
874,672,202,524,65100,47373
18767,12008,6759,614,89800,47374
726,543,183,545,79300,47380
56,35,21,617,68300,47381
80,60,20,575,46700,47382
1080,829,251,696,98300,47383
712,613,99,700,82900,47384
604,497,107,700,95000,47385
518,470,48,1037,124000,47386
251,197,54,736,91900,47387
131,110,21,613,87000,47388
2151,1464,687,543,65400,47390
522,472,50,743,136000,47393
3396,2392,1004,588,81100,47394
2824,2303,521,670,130300,47396
17055,9289,7766,931,211500,47401
13570,7744,5826,808,137100,47403
9061,4568,4493,787,145500,47404
3,3,0,-,-,47405
0,0,0,-,-,47406
9712,3549,6163,811,173900,47408
32,22,10,-,-,47420
11265,8502,2763,642,104300,47421
3599,2970,629,565,110600,47424
440,356,84,-,86100,47427
3550,2829,721,774,138000,47429
535,479,56,-,101200,47431
1936,1381,555,631,87300,47432
1548,1132,416,727,115800,47433
18,18,0,-,-,47434
609,512,97,618,117900,47436
0,0,0,-,-,47437
1826,1424,402,633,63600,47438
3691,2734,957,549,78400,47441
481,359,122,753,82300,47443
4317,3295,1022,604,89300,47446
3126,2331,795,924,169700,47448
177,135,42,433,106600,47449
476,375,101,421,90800,47451
1832,1441,391,606,95300,47452
180,156,24,-,131300,47453
3039,2308,731,558,84600,47454
0,0,0,-,-,47455
472,415,57,930,116400,47456
47,47,0,-,74300,47457
0,0,0,-,-,47458
1500,1198,302,652,123400,47459
4497,3556,941,676,118700,47460
1732,1492,240,646,116700,47462
89,62,27,338,68800,47464
260,228,32,625,94700,47465
15,15,0,-,-,47467
484,421,63,-,164500,47468
722,588,134,536,89600,47469
715,563,152,815,108200,47470
929,745,184,406,91500,47471
6734,4551,2183,611,98000,47501
1558,1048,510,541,56500,47512
945,768,177,463,103200,47513
108,100,8,-,81800,47514
341,329,12,-,139500,47515
543,430,113,370,112200,47516
192,176,16,725,131100,47519
1262,839,423,549,86100,47520
249,234,15,-,176500,47521
109,57,52,581,51100,47522
1286,985,301,539,108800,47523
155,142,13,619,60000,47524
129,111,18,-,105700,47525
769,607,162,833,107700,47527
200,165,35,730,53200,47528
447,314,133,603,73100,47529
345,345,0,-,125200,47531
1812,1505,307,615,140700,47532
181,128,53,-,76200,47535
0,0,0,-,-,47536
313,265,48,639,107900,47537
517,384,133,700,95500,47541
3520,2606,914,561,120500,47542
8171,5995,2176,614,151400,47546
293,282,11,-,136500,47550
327,317,10,-,134400,47551
72,72,0,-,143100,47552
3233,2459,774,570,111600,47553
572,436,136,578,94700,47557
1250,1089,161,569,181900,47558
522,378,144,383,86000,47561
1604,1204,400,531,109000,47562
640,541,99,(X),99200,47564
2282,1848,434,550,86100,47567
321,247,74,494,70400,47568
66,66,0,-,213200,47574
453,358,95,651,193400,47575
90,68,22,-,88900,47576
479,464,15,-,122000,47577
302,255,47,775,77400,47578
991,845,146,533,165600,47579
118,111,7,-,195200,47580
1599,1391,208,505,84800,47581
83,68,15,567,72500,47584
188,164,24,-,83100,47585
4557,3621,936,624,101400,47586
273,200,73,581,86400,47588
263,238,25,463,170200,47590
10371,6480,3891,646,90300,47591
52,42,10,-,(X),47596
394,322,72,675,90000,47597
1334,1045,289,792,83200,47598
5552,4647,905,660,114200,47601
1940,1556,384,845,101200,47610
486,442,44,370,89000,47611
358,291,67,625,85200,47612
1023,935,88,542,120000,47613
541,389,152,559,81800,47615
128,121,7,-,50600,47616
605,505,100,677,132300,47619
5045,3988,1057,632,121900,47620
13192,10594,2598,817,164100,47630
692,564,128,735,124400,47631
1223,949,274,697,139000,47633
886,776,110,717,87100,47634
2264,1690,574,676,109800,47635
505,388,117,719,103500,47637
1521,1334,187,664,163000,47638
1476,1319,157,587,193300,47639
391,360,31,-,86800,47640
1821,1403,418,670,111300,47648
568,519,49,738,75700,47649
21,15,6,550,75000,47654
2042,1479,563,595,82100,47660
1269,1119,150,656,108400,47665
662,600,62,712,75700,47666
4786,3333,1453,664,100600,47670
53,41,12,700,82100,47683
199,60,139,581,234400,47708
8063,4217,3846,625,86700,47710
12871,9749,3122,742,116700,47711
10422,6904,3518,720,118900,47712
4579,1898,2681,620,60900,47713
13515,7842,5673,724,85600,47714
12729,6032,6697,745,130200,47715
7045,5869,1176,793,138400,47720
6008,5544,464,1095,182500,47725
13044,7606,5438,688,113100,47802
8116,5227,2889,789,103700,47803
4537,2696,1841,666,65600,47804
4757,3566,1191,690,101600,47805
5044,1542,3502,634,46900,47807
0,0,0,-,-,47809
399,314,85,675,83200,47832
511,454,57,640,94100,47833
7583,5535,2048,662,96500,47834
13,13,0,-,-,47836
450,383,67,(X),90800,47837
687,561,126,725,91500,47838
683,544,139,577,103100,47840
807,664,143,569,90000,47841
4165,3073,1092,512,76300,47842
199,186,13,-,89500,47846
379,316,63,549,85000,47847
705,615,90,539,69200,47848
162,146,16,-,67900,47849
981,766,215,611,83000,47850
55,23,32,656,87000,47853
341,291,50,518,84200,47854
136,107,29,663,53700,47855
178,149,29,824,66000,47857
277,230,47,(X),120700,47858
403,356,47,(X),88000,47859
112,89,23,618,46800,47860
208,181,27,525,100300,47861
548,429,119,634,71400,47862
90,66,24,-,72200,47863
64,60,4,-,"10,000-",47865
189,171,18,-,86700,47866
1207,951,256,639,102500,47868
46,35,11,-,-,47869
74,63,11,594,74100,47871
2731,2091,640,513,108800,47872
1424,1215,209,632,75200,47874
0,0,0,-,-,47876
1442,1118,324,555,69500,47879
32,32,0,-,-,47880
162,99,63,643,69700,47881
3331,2108,1223,684,89100,47882
57,51,6,-,48300,47884
3479,2662,817,682,83900,47885
1959,429,1530,621,118300,47901
6912,2947,3965,753,83900,47904
16996,10411,6585,780,139300,47905
22791,9366,13425,874,173000,47906
0,0,0,-,-,47907
16022,10140,5882,775,124700,47909
21,20,1,-,45000,47916
177,132,45,681,71400,47917
2441,1671,770,591,88500,47918
845,756,89,738,141900,47920
440,322,118,675,64300,47921
530,349,181,639,86500,47922
1342,1078,264,725,118500,47923
54,54,0,-,56900,47924
88,79,9,-,55200,47925
344,287,57,678,89400,47926
804,653,151,732,70300,47928
242,206,36,542,99200,47929
471,335,136,719,118600,47930
2107,1660,447,654,97200,47932
10906,7418,3488,640,115100,47933
497,416,81,788,130800,47940
519,364,155,882,110900,47941
304,247,57,700,79800,47942
361,115,246,1006,167100,47943
1375,965,410,643,86200,47944
806,610,196,668,98400,47946
548,362,186,626,81100,47948
622,525,97,636,86800,47949
291,187,104,860,110100,47950
914,585,329,693,90600,47951
1180,997,183,656,87000,47952
901,718,183,737,124500,47954
372,260,112,650,93800,47955
734,554,180,610,104200,47957
89,74,15,-,55800,47958
1052,772,280,650,86800,47959
6240,4815,1425,684,113400,47960
752,580,172,721,99200,47963
61,50,11,-,72500,47964
203,169,34,933,84100,47965
181,161,20,425,46500,47966
261,196,65,893,84000,47967
284,263,21,858,111400,47968
72,45,27,825,57300,47969
833,595,238,748,99900,47970
774,579,195,672,89700,47971
478,353,125,730,84000,47974
275,177,98,715,96900,47975
786,575,211,669,105400,47977
4095,2986,1109,657,133100,47978
428,357,71,700,98200,47980
308,243,65,1069,191500,47981
67,58,9,656,55600,47982
154,100,54,-,73300,47983
1544,1237,307,765,84100,47987
520,386,134,755,88700,47989
694,547,147,666,90100,47990
482,315,167,785,72500,47991
580,532,48,-,152600,47992
1487,1146,341,756,114100,47993
164,133,31,675,82400,47994
594,439,155,666,97300,47995
59,47,12,650,82500,47997
5311,4087,1224,795,131100,48001
1233,1163,70,1065,165800,48002
2224,1947,277,817,158900,48003
1980,1761,219,751,176700,48005
1477,1342,135,845,138900,48006
8835,6678,2157,1270,410700,48009
1498,1203,295,742,114400,48014
3694,1895,1799,512,60700,48015
5472,3786,1686,826,126600,48017
12258,8306,3952,1035,58300,48021
933,859,74,922,133300,48022
1975,1560,415,1065,156400,48023
5706,5094,612,1248,317300,48025
6181,4455,1726,695,111500,48026
1281,1132,149,838,139000,48027
550,512,38,1039,270800,48028
6958,3928,3030,912,50300,48030
829,755,74,857,133100,48032
7601,2943,4658,963,87300,48033
7092,1535,5557,996,132100,48034
14516,8493,6023,833,99000,48035
9238,6697,2541,711,107100,48036
19056,12504,6552,865,152800,48038
3169,2472,697,754,104400,48039
4208,3387,821,695,113000,48040
1665,1367,298,768,150300,48041
9661,9344,317,1410,217500,48042
6636,3966,2670,591,76000,48043
18328,16558,1770,1155,214600,48044
11086,7690,3396,816,152100,48045
15262,12245,3017,847,164800,48047
2453,1953,500,969,112100,48048
2083,1819,264,727,120600,48049
722,641,81,961,201700,48050
5971,4785,1186,915,136500,48051
2830,2346,484,952,173200,48054
6056,4601,1455,706,126600,48059
16334,9286,7048,705,82100,48060
3504,2700,804,860,147000,48062
1450,1235,215,805,170900,48063
1403,1295,108,731,182300,48064
3952,3360,592,904,201400,48065
19819,12456,7363,873,63200,48066
12313,7976,4337,1023,169600,48067
1109,1017,92,1770,247300,48069
2457,2380,77,2214,275300,48070
12855,7830,5025,794,79700,48071
6573,5335,1238,1106,150800,48072
16067,11022,5045,844,163700,48073
3665,3217,448,780,113100,48074
9159,5367,3792,917,102100,48075
9934,7156,2778,1045,118400,48076
4864,4045,819,706,155600,48079
10652,7375,3277,915,89600,48080
8953,7391,1562,843,104000,48081
7176,5989,1187,1000,92500,48082
9061,5609,3452,895,168400,48083
6396,2960,3436,1052,260000,48084
8294,7574,720,1443,229600,48085
9375,7978,1397,829,108500,48088
11875,6814,5061,887,53500,48089
11849,8220,3629,804,62100,48091
10512,7939,2573,867,105900,48092
9882,7397,2485,792,100300,48093
6812,5576,1236,1117,223800,48094
1853,1682,171,906,286100,48095
1556,1443,113,1149,179900,48096
1949,1555,394,683,101900,48097
7061,6265,796,1175,308200,48098
10580,9017,1563,886,95500,48101
22935,14980,7955,1132,263700,48103
15521,6029,9492,1122,255700,48104
14972,7026,7946,1074,291100,48105
10903,5594,5309,868,214900,48108
0,0,0,-,-,48109
16493,11427,5066,851,124800,48111
7620,7180,440,1034,225000,48114
10766,8729,2037,884,207500,48116
3698,3302,396,739,147800,48117
5196,4042,1154,971,217500,48118
2264,816,1448,959,112700,48120
4136,2489,1647,792,54300,48122
12479,9846,2633,938,105400,48124
7551,5820,1731,931,65000,48125
12783,7161,5622,975,93000,48126
13095,9469,3626,964,103100,48127
3976,3369,607,1254,123600,48128
5489,4737,752,1132,278300,48130
2884,2136,748,762,141100,48131
2267,1882,385,643,104500,48133
7628,6008,1620,740,148200,48134
10320,8412,1908,964,80500,48135
1860,1771,89,1051,170700,48137
4035,3562,473,1048,243600,48138
91,65,26,-,(X),48139
1257,1160,97,738,175100,48140
9451,4887,4564,738,49100,48141
0,0,0,-,-,48143
3959,3482,477,1080,162800,48144
1288,1104,184,890,144500,48145
14366,10061,4305,812,58700,48146
10351,8603,1748,1137,133400,48150
12350,9820,2530,906,172000,48152
14498,12974,1524,931,164600,48154
652,460,192,568,108300,48157
2932,2515,417,807,197900,48158
931,838,93,942,133600,48159
4495,3585,910,900,155700,48160
10193,7431,2762,759,99200,48161
11371,7909,3462,745,123700,48162
3093,2800,293,1019,186100,48164
2595,1977,618,1133,186500,48165
4100,3560,540,995,131400,48166
9102,6406,2696,1030,242700,48167
7831,7016,815,1286,368200,48168
7972,7110,862,890,189200,48169
16144,12117,4027,830,246300,48170
4610,3746,864,775,127100,48173
11307,7978,3329,792,71000,48174
8123,6813,1310,828,245700,48176
102,61,41,1095,151600,48177
11932,10277,1655,843,216300,48178
1311,1039,272,968,152600,48179
23742,15553,8189,793,72500,48180
8583,7312,1271,832,152400,48182
17386,12798,4588,707,128300,48183
6792,3842,2950,684,64700,48184
20824,11233,9591,778,97900,48185
12899,8868,4031,860,84200,48186
17371,12470,4901,905,192700,48187
14134,11415,2719,1165,201300,48188
5466,4421,1045,907,160300,48189
30,30,0,-,272700,48190
1305,1057,248,993,156900,48191
10625,7763,2862,728,84800,48192
5956,3833,2123,712,117600,48193
12499,7989,4510,798,84900,48195
24965,12439,12526,858,159600,48197
15886,8729,7157,778,89500,48198
7288,638,6650,529,128800,48201
7445,1959,5486,607,64400,48202
9889,4310,5579,631,38900,48203
9483,4725,4758,719,31800,48204
12887,6499,6388,872,31900,48205
6693,3015,3678,704,43000,48206
11263,2680,8583,745,60500,48207
3967,1211,2756,638,61900,48208
10198,4920,5278,628,35700,48209
9270,4649,4621,725,30000,48210
2135,957,1178,740,31300,48211
11160,6200,4960,662,34500,48212
8762,4340,4422,696,28200,48213
9491,3527,5964,632,44900,48214
4792,2140,2652,751,48800,48215
2286,869,1417,578,49600,48216
2965,1691,1274,762,44900,48217
2769,1581,1188,681,34100,48218
18311,10544,7767,810,46400,48219
10531,6008,4523,838,95900,48220
14414,9528,4886,812,63800,48221
9135,5044,4091,784,54000,48223
14224,8256,5968,912,42900,48224
5499,3308,2191,996,64600,48225
3582,371,3211,966,159400,48226
14743,8599,6144,813,43800,48227
18542,9642,8900,834,31400,48228
3473,1986,1487,719,40500,48229
6458,4882,1576,991,280400,48230
0,0,0,-,-,48233
12140,7099,5041,776,38400,48234
17294,10049,7245,873,50400,48235
11518,10284,1234,1222,220600,48236
11494,6511,4983,983,78800,48237
11064,5534,5530,735,41600,48238
13509,10468,3041,1047,63700,48239
6555,4822,1733,1125,58000,48240
0,0,0,-,-,48242
0,0,0,-,-,48243
5512,4763,749,1243,388900,48301
6242,5477,765,944,389200,48302
6411,5554,857,1217,306500,48304
9827,8940,887,847,334600,48306
17393,11017,6376,1045,204200,48307
10760,8666,2094,1164,233300,48309
14828,10842,3986,955,148100,48310
13152,9258,3894,788,139300,48312
13090,9284,3806,901,147300,48313
8326,6099,2227,980,178600,48314
10100,8687,1413,978,229200,48315
10215,7965,2250,933,196700,48316
11388,6430,4958,889,142400,48317
2129,1385,744,865,145700,48320
12229,9009,3220,1556,230600,48322
6472,5769,703,1592,293400,48323
6326,5657,669,1154,263200,48324
9107,4360,4747,970,116900,48326
9512,6200,3312,736,131800,48327
10914,6511,4403,751,106200,48328
9681,8213,1468,1140,134500,48329
8487,6490,1997,1245,244300,48331
7950,4787,3163,1132,191800,48334
10535,4464,6071,961,216300,48335
10871,7444,3427,827,149400,48336
10016,4103,5913,745,48200,48340
6786,3458,3328,804,61200,48341
6904,2695,4209,701,52000,48342
9144,6773,2371,932,168700,48346
8294,7846,448,1304,252800,48348
2625,2422,203,1071,197900,48350
2363,2028,335,924,172700,48353
3239,2873,366,779,169800,48356
3069,2814,255,938,171200,48357
3212,2424,788,863,182400,48359
4259,3594,665,937,222300,48360
5731,4464,1267,926,179700,48362
1937,1817,120,1368,277400,48363
1640,1504,136,1190,224600,48367
658,592,66,1234,301300,48370
8612,7336,1276,904,183300,48371
4849,4389,460,1832,367800,48374
8874,6039,2835,1189,206100,48375
7662,3488,4174,936,200400,48377
2621,2532,89,1578,240900,48380
5165,3888,1277,765,218200,48381
7864,7302,562,1239,232300,48382
4751,4336,415,1109,190600,48383
6885,5946,939,908,172600,48386
9952,7535,2417,1023,160500,48390
7174,4090,3084,649,165300,48393
0,0,0,-,-,48397
593,530,63,850,98200,48401
27,27,0,-,-,48411
2161,1947,214,813,144800,48412
2921,2219,702,635,95400,48413
1024,885,139,860,102400,48414
3599,3103,496,714,116400,48415
1783,1453,330,615,108200,48416
1055,962,93,838,93800,48417
1534,1352,182,708,133700,48418
1025,853,172,594,94700,48419
8506,6927,1579,651,103700,48420
2317,2125,192,902,111400,48421
2503,1938,565,702,85700,48422
13333,8916,4417,650,118700,48423
375,303,72,600,98400,48426
1099,852,247,647,85500,48427
1825,1548,277,889,185500,48428
3330,2512,818,646,99400,48429
14161,10961,3200,885,165400,48430
280,253,27,958,95900,48432
10227,8760,1467,678,113400,48433
27,25,2,-,76300,48434
740,656,84,686,98100,48435
1404,1276,128,771,130000,48436
263,189,74,(X),58600,48437
2595,2334,261,1106,183700,48438
18777,13320,5457,756,137300,48439
63,52,11,-,(X),48440
1652,1324,328,439,89600,48441
8023,6364,1659,980,140600,48442
3303,2398,905,760,119200,48444
542,468,74,668,80800,48445
11723,9152,2571,722,120600,48446
1110,962,148,692,92100,48449
2123,1804,319,611,116700,48450
5325,4679,646,736,156300,48451
1796,1376,420,553,88600,48453
448,386,62,725,89800,48454
3047,2667,380,934,194500,48455
334,288,46,691,94600,48456
2982,2597,385,734,97300,48457
8065,5528,2537,714,55100,48458
838,735,103,578,119500,48460
2980,2557,423,777,119000,48461
4720,4238,482,1035,190800,48462
1888,1681,207,721,105900,48463
771,683,88,613,115900,48464
272,220,52,711,107900,48465
579,503,76,578,79500,48466
1142,974,168,515,118100,48467
626,561,65,616,88800,48468
510,408,102,459,124300,48469
319,265,54,775,97200,48470
2113,1499,614,584,82700,48471
632,542,90,869,98200,48472
8538,7384,1154,748,116900,48473
976,815,161,608,104000,48475
280,216,64,882,75900,48476
185,2,183,573,-,48502
11188,6206,4982,627,44600,48503
11147,6317,4830,775,39000,48504
8590,5063,3527,674,27400,48505
11475,7677,3798,671,46500,48506
13058,7804,5254,674,54400,48507
3708,3294,414,883,75800,48509
3093,2013,1080,775,72200,48519
3693,2033,1660,708,38300,48529
8147,4813,3334,725,85000,48532
0,0,0,-,-,48551
0,0,0,-,-,48553
0,0,0,-,-,48554
14537,9120,5417,639,48200,48601
11590,7596,3994,670,49800,48602
11850,7329,4521,772,119900,48603
4221,2960,1261,774,77000,48604
617,292,325,457,38800,48607
4933,4340,593,698,120400,48609
1328,1180,148,724,88800,48610
2633,2226,407,792,116400,48611
3912,3252,660,592,93200,48612
448,373,75,785,92500,48613
543,467,76,796,91800,48614
1232,951,281,609,80600,48615
2936,2424,512,666,100100,48616
3457,2543,914,592,102300,48617
2224,1758,466,574,91200,48618
231,217,14,675,77900,48619
522,373,149,563,96600,48621
2521,2088,433,694,93200,48622
4792,4210,582,1042,151700,48623
6814,5659,1155,567,97900,48624
5891,4787,1104,576,66300,48625
2308,1950,358,716,134200,48626
69,69,0,-,150700,48627
828,726,102,704,118900,48628
3614,2795,819,692,97100,48629
9,9,0,-,-,48630
1710,1537,173,770,117100,48631
2205,1931,274,706,84800,48632
87,79,8,-,(X),48633
1841,1612,229,650,109900,48634
756,679,77,718,86800,48635
494,472,22,460,87000,48636
1305,1127,178,708,102300,48637
5729,3759,1970,717,113300,48638
13162,9782,3380,701,138200,48640
12918,9273,3645,748,138000,48642
1685,1358,327,637,77900,48647
568,522,46,741,101800,48649
2769,2383,386,656,91500,48650
2464,2155,309,563,100800,48651
647,593,54,663,109100,48652
4533,3871,662,649,102700,48653
992,833,159,483,90300,48654
2457,2091,366,658,102800,48655
1916,1561,355,609,60800,48656
3283,2847,436,725,127600,48657
2042,1559,483,561,84900,48658
1073,908,165,570,86900,48659
4556,3554,1002,661,100200,48661
569,509,60,945,96900,48662
0,0,0,-,-,48667
566,472,94,769,71200,48701
1440,1208,232,579,99300,48703
255,216,39,525,78900,48705
16400,12971,3429,708,93900,48706
11147,7758,3389,573,75600,48708
0,0,0,-,-,48710
447,397,50,583,86600,48720
208,205,3,-,103400,48721
1410,1256,154,683,87600,48722
4870,3725,1145,626,90200,48723
160,151,9,-,74100,48724
1152,917,235,586,104000,48725
2280,1909,371,639,91000,48726
453,404,49,826,90000,48727
169,154,15,-,137500,48728
607,544,63,813,96600,48729
1989,1523,466,578,98800,48730
659,498,161,612,86100,48731
4857,3449,1408,620,113100,48732
739,625,114,730,83500,48733
3206,2376,830,702,167900,48734
423,358,65,561,78800,48735
585,507,78,617,74300,48737
664,613,51,666,141600,48738
1839,1584,255,671,86700,48739
1098,913,185,645,108800,48740
762,621,141,657,99600,48741
750,658,92,550,96200,48742
30,30,0,-,75000,48743
1823,1456,367,819,89800,48744
547,459,88,541,70700,48745
3203,2851,352,689,107000,48746
593,549,44,644,122800,48747
784,697,87,644,86100,48748
432,377,55,657,81700,48749
4015,3061,954,563,78000,48750
353,325,28,519,75700,48754
1408,1139,269,688,113600,48755
2039,1682,357,682,59200,48756
1570,1313,257,596,110900,48757
1370,1120,250,569,77500,48759
500,442,58,685,90400,48760
499,402,97,441,76100,48761
500,493,7,-,108200,48762
2050,1762,288,688,95100,48763
313,272,41,667,73800,48765
541,477,64,822,80400,48766
777,685,92,606,85300,48767
3617,2783,834,601,98600,48768
762,620,142,549,74200,48770
4848,3138,1710,585,85100,48801
644,535,109,639,99000,48806
309,258,51,713,89600,48807
2256,1858,398,836,153500,48808
3980,3075,905,596,94200,48809
1236,920,316,561,94300,48811
8062,6076,1986,757,134100,48813
844,727,117,775,122000,48815
28,28,0,-,85300,48816
2492,1661,831,757,100100,48817
993,801,192,735,91600,48818
925,829,96,925,152300,48819
6469,5219,1250,829,181900,48820
2368,2193,175,723,159100,48821
1061,1021,40,868,157900,48822
20108,8239,11869,862,170200,48823
0,0,0,-,-,48825
5837,4787,1050,849,135000,48827
1226,881,345,654,82100,48829
1313,1068,245,700,99400,48831
502,473,29,817,92400,48832
791,668,123,600,103200,48834
953,852,101,813,148800,48835
4877,4049,828,851,149100,48836
7808,6100,1708,706,151800,48837
6903,5192,1711,730,102900,48838
5816,3654,2162,710,164700,48840
333,267,66,803,92900,48841
8628,6123,2505,821,138000,48842
16369,12294,4075,898,189900,48843
350,289,61,565,88500,48845
5991,4277,1714,690,89300,48846
2427,1779,648,701,95200,48847
2830,2538,292,793,147500,48848
2199,1742,457,815,115300,48849
1551,1282,269,603,89500,48850
905,758,147,714,104300,48851
52,39,13,719,52900,48852
278,213,65,511,82700,48853
7009,5185,1824,869,157400,48854
5505,4874,631,996,184200,48855
335,251,84,731,90400,48856
962,853,109,842,110000,48857
16985,8215,8770,715,127100,48858
532,384,148,668,89800,48860
625,514,111,642,116200,48861
8556,5548,3008,877,199700,48864
669,500,169,768,84200,48865
1770,1496,274,650,111600,48866
11174,7983,3191,627,91600,48867
44,44,0,-,78200,48870
744,637,107,758,131900,48871
2874,2276,598,766,113900,48872
625,566,59,638,111200,48873
53,52,1,-,53000,48874
3767,3176,591,824,143300,48875
1580,1217,363,719,110400,48876
969,811,158,630,78800,48877
581,491,90,656,114500,48878
6912,5414,1498,722,142800,48879
2479,1820,659,577,84900,48880
2106,1696,410,544,135000,48881
2761,2271,490,674,119600,48883
1749,1403,346,651,87500,48884
354,270,84,611,87800,48885
879,765,114,614,85300,48886
2518,2010,508,703,89900,48888
519,436,83,647,102200,48889
808,670,138,750,114800,48890
1095,939,156,522,89300,48891
1640,1377,263,846,124400,48892
2066,1849,217,836,110900,48893
652,589,63,550,156600,48894
4443,3654,789,785,179900,48895
66,51,15,817,80700,48896
553,409,144,1026,122200,48897
10560,6862,3698,743,82600,48906
15569,8478,7091,788,74900,48910
15713,8227,7486,697,87800,48911
7640,3543,4097,750,86500,48912
3427,1963,1464,782,72500,48915
14534,8275,6259,785,130900,48917
0,0,0,-,-,48921
1740,107,1633,633,123800,48933
8728,4445,4283,681,83400,49001
8340,5793,2547,601,128900,49002
6067,4680,1387,845,105900,49004
9995,3924,6071,738,118400,49006
4401,1215,3186,662,60200,49007
6519,3932,2587,686,145000,49008
17971,11944,6027,758,181700,49009
6867,5298,1569,777,108300,49010
793,690,103,635,94300,49011
1310,1116,194,705,158700,49012
1895,1432,463,608,84200,49013
8061,5952,2109,677,104900,49014
10890,7355,3535,776,109400,49015
8557,6007,2550,678,96800,49017
2490,2138,352,681,107500,49021
12520,6861,5659,604,88300,49022
11604,7723,3881,790,155800,49024
978,882,96,627,98100,49026
77,65,12,600,152500,49027
2373,1844,529,616,92600,49028
565,478,87,776,101400,49029
830,698,132,688,88200,49030
3022,2328,694,663,131800,49031
1142,959,183,607,113700,49032
639,589,50,881,185800,49033
977,886,91,669,123000,49034
8480,6248,2232,674,103500,49036
9017,4910,4107,631,64700,49037
3674,2771,903,766,129800,49038
1370,976,394,639,97300,49040
1863,1503,360,576,96500,49042
928,675,253,723,80800,49043
2033,1531,502,768,95900,49045
3070,2556,514,673,148600,49046
5704,4321,1383,615,97100,49047
10083,6450,3633,723,98100,49048
638,553,85,689,157600,49050
1024,973,51,950,136300,49051
360,316,44,675,111300,49052
2549,2109,440,585,134200,49053
2332,1967,365,707,112500,49055
1328,1102,226,842,94800,49056
2296,1726,570,632,83100,49057
7525,5868,1657,756,109400,49058
709,584,125,780,189900,49060
627,553,74,(X),115900,49061
1391,1040,351,607,127000,49064
2385,1882,503,720,138400,49065
250,220,30,668,85600,49066
1564,1338,226,804,119700,49067
5899,4369,1530,684,128400,49068
933,802,131,445,125400,49070
3318,2991,327,772,173400,49071
1225,1050,175,719,136100,49072
1764,1306,458,761,96900,49073
63,9,54,375,-,49074
40,21,19,-,33000,49075
1345,1046,299,728,129200,49076
3481,2766,715,580,119600,49078
4997,3830,1167,681,125000,49079
5955,4523,1432,686,140400,49080
2308,1825,483,704,98200,49082
2753,2288,465,690,209900,49083
6,0,6,-,-,49084
9818,7362,2456,771,174100,49085
2302,1992,310,660,169300,49087
1196,1072,124,1245,174800,49088
631,551,80,664,78400,49089
5779,4073,1706,642,142700,49090
7510,5358,2152,666,107300,49091
807,657,150,772,95100,49092
7134,5260,1874,649,106700,49093
1685,1368,317,587,78200,49094
813,684,129,773,196400,49095
1198,1033,165,798,111900,49096
3983,3335,648,725,146400,49097
2266,1752,514,610,103000,49098
2129,1602,527,633,98600,49099
1248,1103,145,735,122400,49101
537,447,90,992,129600,49102
3283,2101,1182,670,150900,49103
0,0,0,-,-,49104
1884,1486,398,671,167800,49106
4223,3105,1118,538,117200,49107
1263,1058,205,731,122100,49111
3670,3134,536,768,148400,49112
729,613,116,673,99200,49113
172,172,0,-,(X),49115
170,161,9,-,295300,49116
1712,1312,400,855,265000,49117
32,28,4,-,85300,49119
14410,11019,3391,668,97600,49120
832,679,153,679,190000,49125
572,463,109,832,117600,49126
4406,3459,947,810,184400,49127
1675,1326,349,731,136600,49128
215,180,35,746,352200,49129
753,602,151,695,168900,49130
15432,11426,4006,709,128900,49201
8791,4251,4540,696,64500,49202
15201,9820,5381,762,87700,49203
908,723,185,698,116700,49220
14711,10139,4572,712,98100,49221
5122,3613,1509,632,70900,49224
472,389,83,647,87900,49227
2228,1833,395,813,113600,49228
1229,1045,184,753,139500,49229
4254,3540,714,807,157300,49230
918,746,172,673,123300,49232
1031,929,102,1018,127500,49233
1022,920,102,685,176500,49234
814,654,160,643,102800,49235
1803,1602,201,845,139300,49236
1093,968,125,731,124800,49237
668,511,157,779,120600,49238
3545,3098,447,746,182600,49240
883,801,82,676,126900,49241
5587,3640,1947,602,93900,49242
1755,1295,460,630,95700,49245
1255,1145,110,443,163700,49246
2317,1862,455,766,93700,49247
343,287,56,883,90900,49248
1626,1468,158,712,138600,49249
2249,1842,407,673,91200,49250
2316,1963,353,761,118800,49251
1021,761,260,617,90100,49252
1399,1264,135,845,171300,49253
1236,853,383,838,87300,49254
661,532,129,729,83800,49255
1567,1215,352,736,84400,49256
844,748,96,908,86600,49259
128,110,18,-,47700,49261
495,375,120,716,76300,49262
19,19,0,-,-,49263
815,753,62,850,130300,49264
2051,1769,282,639,165600,49265
1217,1039,178,753,102400,49266
1566,1259,307,723,165500,49267
373,325,48,720,107100,49268
2329,1999,330,774,109000,49269
2084,1824,260,920,155100,49270
785,648,137,758,97100,49271
961,890,71,673,154200,49272
1413,1120,293,702,92300,49274
378,318,60,1027,113700,49276
1263,1102,161,829,123300,49277
261,222,39,907,114900,49279
261,188,73,949,(X),49282
1214,979,235,729,134100,49283
1141,926,215,731,106300,49284
2073,1758,315,811,139800,49285
5999,4582,1417,728,123700,49286
749,692,57,954,172400,49287
534,440,94,625,68000,49288
74,60,14,756,72500,49289
6518,6152,366,1338,291300,49301
2753,2534,219,789,207000,49302
368,311,57,612,108700,49303
1591,1184,407,527,71200,49304
866,733,133,548,85100,49305
3701,3535,166,894,174200,49306
6812,4139,2673,603,121500,49307
698,588,110,678,74600,49309
1041,911,130,780,104400,49310
144,120,24,588,67500,49312
7516,6661,855,833,186800,49315
7529,6462,1067,967,188300,49316
506,431,75,670,124800,49318
5943,5173,770,654,126500,49319
7,3,4,-,-,49320
6470,3984,2486,689,141100,49321
493,376,117,780,108700,49322
3116,2902,214,906,161200,49323
585,526,59,850,114800,49325
1601,1430,171,761,117300,49326
2987,2375,612,684,109000,49327
1366,1211,155,836,143800,49328
2974,2548,426,749,100900,49329
1867,1687,180,670,119200,49330
6101,5116,985,779,160800,49331
1217,985,232,590,90100,49332
3960,3386,574,856,148900,49333
139,127,12,-,151700,49335
1565,1316,249,738,88200,49336
4960,4113,847,691,103700,49337
620,529,91,664,87500,49338
871,787,84,738,119300,49339
1176,1022,154,538,95200,49340
11937,10747,1190,808,181800,49341
727,608,119,643,106100,49342
2030,1676,354,675,112400,49343
1423,1203,220,834,153800,49344
4877,3859,1018,715,132100,49345
2265,2010,255,832,164000,49346
470,398,72,742,98900,49347
4403,3444,959,760,148100,49348
3041,2519,522,658,81900,49349
5497,2856,2641,882,157700,49401
592,524,68,700,84400,49402
869,830,39,859,176400,49403
3194,2599,595,628,130600,49404
625,561,64,606,94300,49405
397,352,45,1179,289500,49406
3669,2982,687,714,133400,49408
908,704,204,709,89300,49410
634,563,71,875,112000,49411
4121,3409,712,635,118100,49412
2479,2270,209,828,146500,49415
11990,9490,2500,742,150700,49417
10474,7608,2866,720,160100,49418
2617,2447,170,898,178200,49419
2261,1623,638,665,93400,49420
2217,1870,347,565,81000,49421
15972,10897,5075,771,129800,49423
16856,12401,4455,787,150400,49424
1164,893,271,719,96400,49425
11493,10159,1334,837,172800,49426
9808,8117,1691,915,146800,49428
7438,5122,2316,683,132300,49431
12,12,0,-,-,49434
1384,1280,104,1043,169000,49435
692,605,87,569,128600,49436
2681,2194,487,636,118600,49437
499,85,414,527,82100,49440
15319,11031,4288,717,98100,49441
14705,9555,5150,636,69300,49442
10024,6949,3075,639,79800,49444
7924,7017,907,724,122700,49445
887,822,65,556,110800,49446
1320,1169,151,856,157700,49448
1175,1048,127,636,197700,49449
1081,745,336,614,84000,49450
2081,1781,300,683,117400,49451
747,649,98,771,77800,49452
1066,872,194,626,268300,49453
1683,1368,315,638,110700,49454
1782,1303,479,669,100400,49455
7820,5861,1959,771,171400,49456
3920,3481,439,744,109400,49457
36,36,0,-,121200,49458
443,365,78,669,79200,49459
2821,2661,160,1048,180900,49460
3453,2766,687,599,131400,49461
9817,8334,1483,758,158900,49464
14588,5624,8964,761,101600,49503
15512,9551,5961,735,107200,49504
13108,8211,4897,782,110500,49505
11927,8913,3014,902,181900,49506
12282,6813,5469,834,84200,49507
15578,9051,6527,786,130900,49508
9799,6648,3151,678,87000,49509
7146,2963,4183,809,152900,49512
11532,6285,5247,743,114300,49519
11203,8679,2524,773,159600,49525
8583,5967,2616,758,152200,49534
3721,1974,1747,732,133200,49544
12314,8427,3887,847,226100,49546
11454,8060,3394,772,78800,49548
8363,6239,2124,716,93100,49601
110,85,25,686,68500,49611
496,428,68,713,155900,49612
304,267,37,1125,162500,49613
1117,1009,108,636,133900,49614
1745,1454,291,695,167400,49615
714,514,200,686,114900,49616
1413,1269,144,841,154600,49617
306,275,31,1010,86900,49618
476,426,50,933,105900,49619
911,724,187,956,115000,49620
1236,1089,147,765,198200,49621
1062,866,196,689,129200,49622
417,376,41,775,80400,49623
557,501,56,611,89200,49625
173,154,19,632,73400,49626
94,84,10,-,271400,49627
98,81,17,813,104900,49628
1069,797,272,687,229300,49629
657,578,79,575,263400,49630
2360,1825,535,516,94100,49631
465,374,91,645,87400,49632
1465,1267,198,712,90300,49633
38,38,0,-,63300,49634
1620,1324,296,700,174500,49635
230,204,26,611,593100,49636
1092,1015,77,1046,134800,49637
367,323,44,523,79700,49638
829,699,130,729,92600,49639
640,568,72,740,154300,49640
316,248,68,289,65600,49642
2398,2058,340,913,130700,49643
848,765,83,795,97500,49644
691,630,61,745,82600,49645
3496,2580,916,712,96900,49646
885,856,29,587,273500,49648
2299,2031,268,887,125000,49649
1277,1173,104,542,148400,49650
3195,2606,589,753,98900,49651
812,697,115,837,244600,49653
373,301,72,853,396100,49654
1100,953,147,713,95500,49655
571,488,83,680,74500,49656
1336,1075,261,628,119000,49657
2718,2287,431,676,81300,49659
5709,4301,1408,655,110400,49660
2172,1794,378,677,97100,49663
832,741,91,727,220300,49664
1614,1333,281,571,84900,49665
20,20,0,-,-,49666
205,167,38,625,65000,49667
1336,1035,301,716,87700,49668
961,865,96,705,287500,49670
19,19,0,-,196600,49674
465,406,59,659,166500,49675
1480,1293,187,698,131600,49676
2727,1986,741,570,84200,49677
503,463,40,610,84100,49679
704,565,139,726,96300,49680
1734,1358,376,714,235300,49682
784,645,139,641,93400,49683
15805,11776,4029,885,182000,49684
13622,10103,3519,833,180600,49686
966,841,125,646,107300,49688
675,556,119,590,74300,49689
2631,2120,511,957,200500,49690
430,279,151,622,146200,49701
339,274,65,759,97700,49705
1826,1570,256,687,117400,49706
9855,7269,2586,560,91500,49707
1588,1417,171,566,87700,49709
190,171,19,1063,156400,49710
3310,2637,673,703,151700,49712
716,649,67,838,137800,49713
1162,964,198,488,119600,49715
339,317,22,875,149400,49716
109,88,21,-,402700,49717
331,297,34,638,111400,49718
688,508,180,579,152800,49719
3906,3030,876,647,167600,49720
6176,4895,1281,595,106400,49721
118,70,48,630,132700,49722
427,350,77,863,125000,49724
365,314,51,(X),139500,49725
554,480,74,552,157500,49726
2831,2344,487,619,113800,49727
122,111,11,650,107000,49728
554,452,102,679,109400,49729
752,667,85,672,108500,49730
904,744,160,734,106700,49733
7955,6181,1774,697,125900,49735
242,224,18,-,89300,49736
4169,3245,924,690,95800,49738
3121,2700,421,900,217700,49740
329,312,17,675,98100,49743
387,353,34,719,94400,49744
541,452,89,421,113400,49745
1531,1283,248,485,101200,49746
842,723,119,675,124500,49747
57,50,7,-,90000,49748
1821,1448,373,559,143100,49749
881,792,89,938,114600,49751
264,189,75,382,79400,49752
855,778,77,604,111800,49753
811,682,129,647,124500,49755
1664,1440,224,683,83300,49756
296,124,172,487,391700,49757
752,702,50,556,106100,49759
284,267,17,1038,116900,49760
316,275,41,929,109800,49762
77,47,30,-,52800,49764
1763,1540,223,562,81600,49765
958,737,221,619,93600,49766
169,152,17,-,111800,49768
678,478,200,813,91500,49769
7236,4971,2265,780,170400,49770
894,764,130,588,115400,49774
55,45,10,-,103100,49775
809,704,105,447,89100,49776
842,812,30,1143,149200,49777
2114,1695,419,517,82400,49779
676,589,87,910,106600,49780
1852,1181,671,579,118500,49781
269,241,28,635,190800,49782
7862,5062,2800,607,100100,49783
1052,438,614,633,81900,49788
128,112,16,-,100000,49791
158,134,24,573,125000,49793
918,724,194,663,85900,49795
183,121,62,758,273400,49796
964,867,97,704,88400,49799
4776,3835,941,660,95600,49801
2733,2061,672,669,70300,49802
95,93,2,-,125800,49805
271,270,1,-,165900,49806
1251,1116,135,615,129800,49807
120,105,15,-,114900,49808
388,333,55,519,90800,49812
569,489,80,714,85300,49814
207,194,13,-,64700,49815
232,207,25,525,108500,49816
222,214,8,(X),121400,49817
409,400,9,-,136200,49818
10,10,0,-,118800,49819
115,85,30,505,89400,49820
571,521,50,617,107400,49821
103,78,25,590,122600,49822
139,121,18,-,105900,49825
99,89,10,-,124400,49826
389,331,58,475,103400,49827
7590,5276,2314,527,90200,49829
292,264,28,825,92100,49831
105,105,0,-,161100,49833
108,94,14,575,103800,49834
396,360,36,893,105000,49835
426,347,79,578,115500,49836
4007,3389,618,545,104500,49837
247,205,42,845,133700,49838
184,153,31,570,128800,49839
333,311,22,675,99500,49840
2910,1796,1114,619,113800,49841
416,354,62,436,82000,49847
59,57,2,-,104900,49848
5163,4260,903,518,88400,49849
57,45,12,492,62500,49852
557,493,64,616,109000,49853
2628,2048,580,578,88300,49854
12739,7410,5329,667,165200,49855
5694,4137,1557,542,88800,49858
233,222,11,625,120000,49861
1676,1376,300,548,112300,49862
63,60,3,-,46200,49863
46,31,15,-,56900,49864
3100,2426,674,564,124600,49866
1850,1328,522,595,66500,49868
1519,1238,281,763,77800,49870
185,170,15,700,60700,49871
74,72,2,-,80000,49872
56,45,11,-,77000,49873
422,312,110,469,92500,49874
362,348,14,-,81700,49876
16,14,2,-,(X),49877
1517,1337,180,633,119100,49878
446,382,64,542,92400,49879
478,428,50,575,86500,49880
162,146,16,-,92100,49881
41,32,9,375,76700,49883
180,155,25,-,(X),49884
851,764,87,657,149700,49885
258,226,32,819,85200,49886
1099,944,155,595,101200,49887
304,281,23,533,111600,49891
853,770,83,708,151500,49892
795,718,77,622,115500,49893
273,254,19,-,113900,49894
267,226,41,842,162500,49895
585,416,169,459,109900,49896
164,137,27,1336,50700,49901
51,48,3,-,43000,49902
61,43,18,280,61700,49903
597,553,44,522,116100,49905
730,545,185,408,91900,49908
175,154,21,404,75600,49910
1250,975,275,490,54200,49911
471,423,48,360,86500,49912
2952,2274,678,557,67700,49913
265,234,31,616,48300,49915
1090,893,197,652,132500,49916
92,89,3,-,50800,49917
60,50,10,420,211500,49918
84,80,4,-,78600,49919
1844,1568,276,550,96500,49920
160,107,53,(X),58300,49921
323,228,95,720,115100,49922
218,180,38,433,75500,49925
180,160,20,688,49100,49927
110,107,3,-,51900,49929
2704,1635,1069,623,111200,49930
3331,1506,1825,696,128000,49931
331,263,68,619,61800,49934
2968,2439,529,494,68700,49935
3510,2622,888,536,66600,49938
28,28,0,-,53300,49942
1134,915,219,522,100400,49945
1747,1474,273,538,81700,49946
310,294,16,-,148100,49947
251,233,18,614,62100,49948
603,534,69,375,108800,49950
45,37,8,-,89400,49952
1363,1152,211,402,71100,49953
155,151,4,-,57700,49955
412,396,16,-,114100,49958
131,102,29,497,48300,49959
66,57,9,344,57500,49960
52,51,1,-,91300,49961
80,78,2,-,100000,49962
404,294,110,495,70700,49963
142,137,5,-,154200,49965
250,236,14,-,87100,49967
980,784,196,483,63900,49968
614,524,90,518,166900,49969
105,102,3,-,128300,49970
191,173,18,575,41400,49971
234,190,44,933,171400,50001
629,466,163,600,102800,50002
2700,2163,537,761,190800,50003
335,303,32,875,88300,50005
625,514,111,561,87400,50006
198,195,3,-,169800,50007
393,301,92,545,54400,50008
6586,4882,1704,754,163600,50009
13549,7060,6489,743,167700,50010
0,0,0,-,-,50011
7,0,7,-,-,50012
11817,3988,7829,819,216200,50014
585,448,137,540,88200,50020
9870,6969,2901,929,173200,50021
3804,2566,1238,576,93100,50022
11137,8500,2637,771,187100,50023
1444,1222,222,582,58400,50025
305,277,28,575,79600,50026
140,113,27,650,61900,50027
615,476,139,884,120400,50028
279,228,51,555,54400,50029
32,32,0,-,-,50032
12,10,2,-,60000,50033
147,121,26,515,81300,50034
1994,1592,402,886,180600,50035
6859,5046,1813,631,118000,50036
68,68,0,-,117500,50038
212,144,68,716,159200,50039
36,36,0,-,47000,50041
147,104,43,583,77500,50042
429,349,80,505,85800,50044
482,414,68,854,159600,50046
2208,1807,401,706,148100,50047
341,270,71,438,75000,50048
2805,2168,637,478,83900,50049
300,227,73,569,58500,50050
161,139,22,438,71900,50051
78,68,10,-,48300,50052
1217,953,264,574,122700,50054
363,298,65,754,152900,50055
537,423,114,748,128100,50056
86,86,0,-,70000,50057
797,626,171,529,90700,50058
986,793,193,451,83200,50060
674,588,86,(X),308700,50061
258,252,6,-,91600,50062
967,784,183,908,167700,50063
46,31,15,850,(X),50064
262,173,89,368,69300,50065
146,105,41,690,93600,50066
98,78,20,363,68900,50067
116,105,11,-,74400,50068
462,382,80,658,131400,50069
635,522,113,825,121800,50070
412,339,73,546,55900,50071
1042,866,176,836,158600,50072
430,325,105,530,146100,50073
201,187,14,-,311300,50074
308,259,49,677,103000,50075
710,586,124,508,67700,50076
61,51,10,925,43800,50078
32,32,0,-,(X),50101
34,34,0,-,80000,50102
172,144,28,794,60000,50103
56,43,13,475,98100,50104
429,340,89,658,174000,50105
481,397,84,450,99000,50106
461,356,105,592,67200,50107
202,149,53,469,50800,50108
1115,994,121,577,219800,50109
4063,3384,679,1015,188500,50111
4406,3009,1397,671,141700,50112
1107,759,348,571,92400,50115
81,78,3,-,77500,50116
63,58,5,-,110700,50117
399,363,36,738,113900,50118
201,157,44,621,139600,50119
111,102,9,-,103100,50120
574,452,122,663,89000,50122
355,288,67,343,67300,50123
1440,1128,312,662,169500,50124
7367,5416,1951,719,165200,50125
2766,1964,802,569,98600,50126
9,9,0,-,-,50127
143,118,25,578,104000,50128
2205,1656,549,586,95400,50129
673,490,183,680,109800,50130
7671,5705,1966,1037,235600,50131
155,128,27,608,74300,50132
186,138,48,442,46700,50133
244,190,54,744,166200,50134
716,577,139,737,93900,50135
162,131,31,480,67300,50136
4772,3575,1197,559,110900,50138
577,491,86,610,112100,50139
1078,649,429,464,103300,50140
240,144,96,803,101300,50141
396,306,90,685,104500,50142
212,156,56,376,175000,50143
1045,650,395,466,76500,50144
147,138,9,(X),110000,50146
201,188,13,367,62200,50147
200,185,15,525,84300,50148
423,339,84,613,117600,50149
435,339,96,533,75300,50150
243,212,31,645,76000,50151
343,293,50,575,119200,50153
180,124,56,496,112500,50154
147,110,37,733,74000,50155
1723,1367,356,773,128900,50156
296,207,89,575,78300,50157
11569,8023,3546,651,104300,50158
185,123,62,655,106000,50160
839,734,105,685,152500,50161
548,447,101,656,117000,50162
386,235,151,546,65100,50163
243,213,30,313,88600,50164
14,12,2,-,212500,50165
606,508,98,644,131600,50166
238,192,46,550,131900,50167
302,225,77,934,124200,50168
1051,762,289,643,158800,50169
1141,861,280,609,141600,50170
1133,873,260,585,133600,50171
311,217,94,440,115100,50173
569,474,95,590,78700,50174
3424,2505,919,662,128000,50201
142,105,37,429,79500,50206
954,760,194,680,113500,50207
7868,5392,2476,673,105100,50208
632,558,74,860,158500,50210
4543,3380,1163,846,172600,50211
1357,1104,253,659,111300,50212
2755,1806,949,681,95900,50213
267,217,50,-,177800,50214
1080,940,140,688,212700,50216
285,214,71,577,58900,50217
57,54,3,-,67500,50218
5053,3516,1537,790,182300,50219
3235,2104,1131,714,95000,50220
202,173,29,-,167900,50222
224,160,64,421,76300,50223
1214,934,280,599,122600,50225
1978,1705,273,962,251800,50226
7,5,2,-,(X),50227
947,781,166,764,134300,50228
315,286,29,845,215000,50229
437,349,88,419,100900,50230
78,60,18,642,82700,50231
199,167,32,765,142300,50232
573,472,101,603,99000,50233
284,246,38,555,153200,50234
162,123,39,608,71900,50235
625,557,68,598,158400,50236
1156,1062,94,656,203500,50237
462,383,79,460,83600,50238
48,40,8,575,57500,50239
1035,851,184,809,172700,50240
138,103,35,581,135600,50242
91,83,8,775,98500,50243
682,565,117,770,161300,50244
308,238,70,463,93300,50246
814,625,189,618,119100,50247
1797,1262,535,638,165000,50248
470,375,95,702,100200,50249
990,755,235,704,87500,50250
507,384,123,718,125000,50251
91,77,14,-,(X),50252
115,89,26,-,87000,50254
40,40,0,-,28300,50255
242,213,29,490,94700,50256
404,306,98,751,110500,50257
398,321,77,631,71900,50258
830,733,97,817,174900,50261
170,144,26,-,76700,50262
7000,5589,1411,1025,193500,50263
179,151,28,-,60800,50264
13954,9134,4820,841,179500,50265
11252,6157,5095,943,213000,50266
412,309,103,435,55600,50268
265,192,73,863,77000,50271
44,40,4,-,27900,50272
3351,2255,1096,818,162300,50273
173,132,41,569,93000,50274
262,211,51,575,78800,50275
948,735,213,692,153600,50276
227,147,80,581,76600,50277
357,305,52,605,106900,50278
3330,403,2927,716,123900,50309
12950,8558,4392,812,137900,50310
5705,2899,2806,668,134500,50311
7293,4423,2870,730,164700,50312
6543,4949,1594,803,98800,50313
4029,1530,2499,702,88500,50314
14040,8960,5080,754,109500,50315
5673,3303,2370,783,87900,50316
14251,10171,4080,785,105500,50317
0,0,0,-,-,50319
7425,5039,2386,794,144700,50320
3370,2052,1318,757,187000,50321
13524,10138,3386,828,170100,50322
4108,3946,162,1612,287400,50323
2086,1536,550,964,176700,50324
6109,4594,1515,833,234500,50325
4115,3192,923,887,192700,50327
13377,8958,4419,622,106300,50401
179,149,30,450,84100,50420
1361,1029,332,514,88100,50421
1223,1018,205,528,86800,50423
628,515,113,552,71300,50424
16,14,2,-,81700,50426
3938,3086,852,597,154700,50428
218,168,50,447,57700,50430
123,99,24,479,56000,50431
109,82,27,413,48600,50432
88,82,6,-,83000,50433
193,142,51,475,90400,50434
253,209,44,609,78000,50435
2549,1894,655,545,106100,50436
1590,1300,290,568,126000,50438
134,107,27,600,56700,50439
249,213,36,475,79600,50440
2262,1535,727,572,86500,50441
136,114,22,613,116200,50444
254,209,45,429,136600,50446
516,408,108,448,66300,50447
316,270,46,600,93500,50448
241,172,69,516,50000,50449
1209,880,329,519,102500,50450
232,187,45,475,53000,50451
312,242,70,578,87700,50452
245,183,62,575,96100,50453
53,53,0,-,53600,50454
161,150,11,(X),107400,50455
729,536,193,525,80200,50456
152,131,21,619,70600,50457
871,738,133,569,97900,50458
1247,973,274,572,109100,50459
102,90,12,-,189300,50460
2383,1912,471,554,110600,50461
264,199,65,(X),99800,50464
117,91,26,445,46800,50465
686,615,71,461,105500,50466
33,28,5,531,108900,50467
645,522,123,455,136500,50468
684,595,89,417,128200,50469
108,77,31,483,37500,50470
361,261,100,627,83600,50471
907,788,119,563,108800,50472
104,79,25,378,95600,50473
667,540,127,540,83400,50475
371,325,46,408,87900,50476
163,130,33,759,92000,50477
378,321,57,603,62900,50478
287,214,73,544,67400,50479
424,375,49,531,62000,50480
419,332,87,715,157300,50482
298,262,36,552,73200,50483
186,158,28,450,52500,50484
11263,7216,4047,582,85600,50501
435,345,90,600,69800,50510
3220,2454,766,607,109300,50511
652,510,142,560,85600,50514
113,92,21,391,48300,50515
272,249,23,558,96800,50516
415,310,105,553,94800,50517
156,128,28,667,166200,50518
253,187,66,391,69500,50519
61,56,5,-,72500,50520
61,53,8,-,98500,50521
288,251,37,483,61100,50522
323,244,79,446,76000,50523
259,217,42,407,106300,50524
1420,1037,383,615,83100,50525
110,94,16,-,50000,50527
169,133,36,650,75000,50528
343,282,61,679,74700,50529
496,378,118,494,85800,50530
110,89,21,-,104400,50531
437,342,95,520,80900,50532
1622,1177,445,616,61400,50533
433,295,138,527,82200,50535
1913,1419,494,531,91500,50536
235,185,50,526,79800,50538
239,206,33,429,58600,50539
399,317,82,496,55100,50540
351,272,79,419,62300,50541
451,347,104,528,74500,50542
636,515,121,604,90800,50543
204,171,33,392,63400,50544
97,91,6,-,86100,50545
128,101,27,582,52300,50546
2516,1660,856,583,109900,50548
38,27,11,-,46900,50551
759,538,221,490,62600,50554
123,102,21,756,51400,50556
346,220,126,605,74700,50557
293,250,43,530,67600,50558
143,103,40,707,62800,50559
231,169,62,527,42500,50560
203,164,39,422,41300,50561
230,174,56,572,59600,50562
1176,883,293,523,90200,50563
228,185,43,543,47900,50565
168,139,29,580,88100,50566
101,98,3,-,87300,50567
631,510,121,479,86500,50568
338,249,89,538,67000,50569
94,66,28,867,75700,50570
178,149,29,669,82500,50571
19,13,6,-,37500,50573
971,778,193,540,69400,50574
501,415,86,485,58300,50575
137,114,23,389,105600,50576
177,146,31,(X),53000,50577
316,238,78,635,44800,50578
1053,775,278,493,73100,50579
394,287,107,520,64600,50581
111,79,32,496,56900,50582
1296,974,322,638,75700,50583
463,368,95,473,79000,50585
155,105,50,692,104900,50586
4494,2819,1675,597,117200,50588
428,344,84,613,71100,50590
119,108,11,413,61400,50591
26,24,2,-,41400,50593
111,85,26,528,91800,50594
3885,2554,1331,637,92700,50595
572,383,189,560,102800,50597
365,301,64,399,81000,50598
163,136,27,477,78300,50599
1084,865,219,460,84400,50601
715,554,161,638,93500,50602
263,231,32,367,69300,50603
730,612,118,602,106800,50604
78,47,31,627,52500,50605
385,297,88,618,96300,50606
194,138,56,499,155000,50607
181,159,22,608,89500,50609
177,152,25,425,95000,50611
139,122,17,-,287500,50612
15719,10379,5340,760,172900,50613
4520,3041,1479,550,101000,50616
942,730,212,523,108800,50619
20,12,8,-,23000,50620
672,537,135,619,137200,50621
1326,1133,193,582,175600,50622
719,625,94,571,169700,50624
425,341,84,572,69100,50625
714,604,110,579,159800,50626
1340,1018,322,609,84400,50627
557,405,152,525,63000,50628
857,693,164,547,133800,50629
882,692,190,601,87000,50630
421,369,52,613,83900,50632
175,135,40,814,49000,50633
344,262,82,538,143200,50634
675,521,154,671,98200,50635
826,684,142,578,84800,50636
1400,1074,326,505,111600,50638
632,484,148,705,99500,50641
186,157,29,775,129600,50642
1107,919,188,724,171400,50643
3577,2755,822,650,128100,50644
453,378,75,440,75800,50645
721,592,129,544,186800,50647
1662,1411,251,522,154400,50648
252,211,41,575,91700,50650
1403,1082,321,658,137700,50651
45,37,8,742,63000,50652
213,175,38,575,69600,50653
190,130,60,446,148300,50654
320,246,74,436,83900,50655
1028,856,172,476,116700,50658
2352,1711,641,613,119400,50659
579,499,80,610,154600,50660
3030,2143,887,566,68300,50662
17,17,0,-,-,50664
1211,973,238,566,138300,50665
370,318,52,589,108000,50666
305,287,18,600,162500,50667
512,458,54,595,129300,50668
1080,842,238,528,124000,50669
853,647,206,483,146200,50670
88,68,20,-,83300,50671
214,156,58,675,76700,50672
69,61,8,788,88500,50673
1497,1243,254,543,110400,50674
983,713,270,738,117200,50675
869,721,148,526,110600,50676
4380,3391,989,623,167900,50677
553,471,82,555,89200,50680
188,171,17,450,95000,50681
648,565,83,625,119600,50682
12738,8591,4147,667,136800,50701
8542,5725,2817,695,102400,50702
7757,4696,3061,647,72700,50703
3439,2526,913,679,104400,50707
4034,2805,1229,583,88400,50801
723,514,209,613,87700,50830
925,725,200,611,63800,50833
50,50,0,-,(X),50835
177,135,42,429,65800,50836
142,119,23,506,62500,50837
18,18,0,-,22000,50839
244,190,54,706,57800,50840
1196,892,304,437,90500,50841
40,35,5,(X),72500,50842
255,173,82,570,85800,50843
308,224,84,575,69200,50845
475,395,80,527,78600,50846
37,35,2,-,36900,50847
202,161,41,750,56000,50848
1140,843,297,550,87100,50849
926,502,424,594,83000,50851
306,234,72,531,79000,50853
955,698,257,529,78700,50854
123,91,32,752,101300,50857
318,255,63,400,93800,50858
279,210,69,689,70000,50859
128,119,9,394,84700,50860
142,124,18,925,72200,50861
59,56,3,-,67500,50862
114,79,35,483,54200,50863
891,621,270,494,67700,50864
1014,771,243,588,103200,51001
1160,863,297,637,109000,51002
697,579,118,533,123600,51003
510,362,148,533,79100,51004
623,506,117,566,82100,51005
498,363,135,513,56900,51006
254,235,19,671,120900,51007
48,42,6,525,86400,51008
93,80,13,525,47900,51009
203,152,51,846,73100,51010
24,20,4,-,40000,51011
2917,1987,930,511,84900,51012
213,196,17,666,93500,51014
528,463,65,613,80300,51016
169,130,39,513,83300,51018
323,235,88,392,79900,51019
244,194,50,481,67000,51020
328,262,66,594,98100,51022
1275,1026,249,452,83800,51023
706,599,107,708,186300,51024
859,674,185,447,90400,51025
364,333,31,675,96000,51026
435,336,99,617,104100,51027
815,633,182,583,125700,51028
161,154,7,475,53700,51029
641,569,72,531,181400,51030
5087,3864,1223,552,138200,51031
218,182,36,538,73600,51033
830,669,161,565,87300,51034
750,575,175,603,94600,51035
211,194,17,817,136800,51036
159,133,26,392,79000,51037
716,646,70,683,149100,51038
947,775,172,594,122900,51039
1548,930,618,559,82400,51040
2301,1869,432,645,158000,51041
87,64,23,533,93300,51044
712,593,119,637,98200,51046
320,285,35,492,76800,51047
264,179,85,421,71500,51048
224,183,41,336,61700,51049
990,794,196,656,117900,51050
42,28,14,332,35000,51051
347,289,58,613,123700,51052
451,398,53,575,65700,51053
1760,1471,289,794,191400,51054
567,402,165,565,124600,51055
192,168,24,496,125000,51056
415,328,87,600,81500,51058
259,191,68,287,53900,51060
235,171,64,763,88300,51061
215,194,21,717,140900,51062
505,369,136,624,90100,51063
445,14,431,460,-,51101
6117,3754,2363,678,74500,51103
8381,5574,2807,749,117300,51104
3565,1754,1811,551,57900,51105
10439,7345,3094,708,107600,51106
2139,1767,372,758,122000,51108
1234,831,403,727,90300,51109
72,0,72,676,-,51111
2631,1656,975,577,142400,51201
136,126,10,585,94200,51230
135,114,21,433,63300,51231
370,307,63,575,79600,51232
434,360,74,609,110800,51234
406,338,68,672,118000,51235
707,541,166,588,76800,51237
437,402,35,688,104600,51238
1107,910,197,644,142000,51239
697,556,141,702,145000,51240
653,596,57,590,171100,51241
88,78,10,580,110500,51242
406,295,111,756,61200,51243
30,30,0,-,56000,51244
450,335,115,533,76200,51245
1412,1157,255,457,115000,51246
1747,1325,422,752,149000,51247
746,618,128,543,99200,51248
1358,992,366,556,91700,51249
2684,1997,687,654,185200,51250
5489,3999,1490,601,116600,51301
594,370,224,708,153900,51331
191,150,41,(X),92900,51333
3011,2287,724,601,86300,51334
395,324,71,625,91700,51338
26,15,11,525,(X),51341
479,359,120,461,81100,51342
133,85,48,673,99400,51343
200,118,82,508,79100,51345
1002,810,192,564,80500,51346
590,440,150,626,133900,51347
212,193,19,408,77100,51350
1998,1527,471,621,166700,51351
484,453,31,450,69300,51354
400,313,87,800,280400,51355
263,193,70,493,64200,51357
529,401,128,583,87700,51358
3899,3010,889,642,180300,51360
62,54,8,750,76700,51363
301,196,105,675,70000,51364
109,105,4,-,90400,51365
164,132,32,544,66900,51366
5120,3663,1457,554,127100,51401
302,268,34,594,115100,51430
186,162,24,550,58500,51431
225,178,47,538,77300,51433
296,240,56,539,95500,51436
451,373,78,519,62500,51439
135,125,10,-,99600,51440
197,142,55,596,93700,51441
3222,2295,927,562,106500,51442
731,577,154,545,107000,51443
90,73,17,713,82100,51444
1265,907,358,327,86600,51445
241,183,58,438,55900,51446
86,75,11,(X),97500,51447
240,206,34,554,77200,51448
922,712,210,509,79300,51449
718,592,126,541,134000,51450
45,36,9,575,33100,51451
304,264,40,513,48200,51453
616,462,154,425,81800,51454
1023,740,283,526,84500,51455
635,535,100,488,77500,51458
31,27,4,-,43600,51459
487,393,94,585,79900,51461
406,325,81,569,80200,51462
232,183,49,(X),112500,51463
322,281,41,492,77800,51465
347,296,51,410,85200,51466
284,269,15,494,99200,51467
13734,8590,5144,778,96400,51501
14700,10260,4440,739,163200,51503
1488,1092,396,902,98000,51510
105,94,11,-,57100,51520
786,624,162,628,115200,51521
162,122,40,500,61200,51523
444,367,77,688,124800,51525
605,575,30,975,215700,51526
154,120,34,585,89000,51527
336,241,95,498,72900,51528
755,580,175,526,85700,51529
412,323,89,575,120000,51530
315,258,57,488,118800,51531
259,206,53,767,80000,51532
376,289,87,626,101200,51533
3321,2603,718,666,166000,51534
722,600,122,540,87000,51535
164,153,11,775,91400,51536
2905,2300,605,633,106800,51537
168,122,46,738,92200,51540
130,117,13,-,94200,51541
351,318,33,-,207700,51542
209,163,46,458,81000,51543
388,312,76,681,99400,51544
126,108,18,644,34100,51545
1079,878,201,693,115900,51546
143,122,21,638,162500,51548
184,138,46,513,99100,51549
65,59,6,625,69400,51550
646,528,118,723,160500,51551
127,101,26,588,79300,51552
391,324,67,575,148200,51553
76,76,0,-,90500,51554
2139,1553,586,638,112200,51555
181,139,42,950,113700,51556
347,254,93,678,122500,51557
229,197,32,518,65000,51558
682,545,137,725,162900,51559
866,603,263,627,129900,51560
496,425,71,879,126100,51561
146,134,12,-,114200,51562
278,197,81,717,101300,51563
214,164,50,475,95300,51564
208,147,61,814,106500,51565
3027,1959,1068,645,77000,51566
389,288,101,642,134100,51570
220,185,35,811,147500,51571
177,132,45,460,58000,51572
448,362,86,618,97600,51573
651,541,110,769,181700,51575
707,606,101,656,199500,51576
511,358,153,735,96800,51577
37,29,8,-,83100,51578
984,708,276,591,116200,51579
2464,1785,679,580,85700,51601
98,77,21,-,71900,51630
131,104,27,794,68800,51631
2657,1948,709,525,88800,51632
183,153,30,513,57900,51636
85,70,15,613,43000,51637
597,486,111,592,75000,51638
368,268,100,641,93300,51639
664,479,185,585,84400,51640
111,101,10,-,79500,51645
313,254,59,514,71400,51646
53,53,0,-,46500,51647
78,65,13,-,140200,51648
132,113,19,625,87500,51649
165,144,21,915,46700,51650
683,501,182,596,97300,51652
549,393,156,639,117000,51653
212,193,19,535,151600,51654
31,28,3,-,38900,51656
17587,10827,6760,675,123100,52001
6141,4588,1553,889,190000,52002
5424,4618,806,781,163400,52003
152,106,46,663,82300,52030
2091,1668,423,669,143600,52031
609,515,94,(X),167100,52032
1280,983,297,604,145900,52033
485,436,49,558,118800,52035
477,412,65,555,118800,52037
206,169,37,(X),108700,52038
411,405,6,-,228600,52039
2251,1910,341,541,158100,52040
649,593,56,486,133100,52041
653,534,119,429,113400,52042
989,782,207,596,94000,52043
53,32,21,-,134400,52044
932,780,152,617,165000,52045
783,681,102,625,165300,52046
228,159,69,587,89700,52047
143,129,14,-,122600,52048
593,474,119,659,95600,52049
278,218,60,725,127100,52050
1297,1036,261,493,124800,52052
394,344,50,413,131700,52053
401,315,86,833,133600,52054
3151,2374,777,576,112400,52057
3759,2685,1074,549,99800,52060
409,302,107,650,127200,52064
456,401,55,600,120700,52065
34,32,2,-,55000,52066
1516,1291,225,742,226200,52068
680,515,165,538,107500,52069
439,353,86,731,139200,52070
113,108,5,-,88000,52072
433,373,60,1088,228000,52073
150,133,17,463,141900,52074
920,679,241,535,96900,52076
164,103,61,588,102300,52077
399,375,24,430,150300,52078
348,319,29,736,152000,52079
5303,3965,1338,589,167000,52101
840,583,257,594,128800,52132
235,211,24,725,131000,52133
153,131,22,628,69200,52134
345,295,50,544,95500,52135
2406,1882,524,619,126900,52136
269,204,65,444,60800,52140
642,483,159,550,99700,52141
531,363,168,654,109000,52142
510,451,59,632,143800,52144
491,445,46,600,133100,52146
472,387,85,489,86300,52147
894,703,191,584,126600,52151
385,331,54,377,106400,52154
488,432,56,495,103800,52155
298,253,45,688,115400,52156
799,621,178,539,125200,52157
148,94,54,484,100000,52158
1101,936,165,739,109200,52159
511,410,101,392,120300,52160
602,505,97,557,123100,52161
1270,800,470,631,96400,52162
141,106,35,475,75800,52163
91,79,12,581,95800,52164
344,276,68,396,153200,52165
57,51,6,713,79500,52166
106,89,17,613,79300,52168
181,142,39,508,86800,52169
222,189,33,488,136300,52170
370,288,82,398,116500,52171
2508,1922,586,513,101800,52172
1590,1183,407,517,98500,52175
497,429,68,602,117100,52201
385,341,44,550,168100,52202
834,697,137,526,173500,52203
3131,2316,815,562,137700,52205
830,746,84,443,199500,52206
189,153,36,562,105400,52207
1294,973,321,531,95700,52208
412,293,119,827,139100,52209
285,235,50,625,150200,52210
1065,786,279,678,108300,52211
92,88,4,-,62000,52212
1597,1352,245,701,175500,52213
1380,1166,214,617,165300,52214
273,261,12,-,158900,52215
617,442,175,609,114500,52216
192,177,15,(X),102000,52217
681,523,158,733,138700,52218
69,53,16,738,86500,52219
177,167,10,-,138700,52220
96,84,12,(X),106000,52221
293,239,54,665,82000,52222
579,497,82,621,158800,52223
798,692,106,550,116700,52224
155,131,24,600,79400,52225
1092,975,117,666,197000,52227
1105,1028,77,930,211700,52228
303,262,41,793,111800,52229
109,97,12,535,87500,52231
75,55,20,700,84200,52232
2994,1890,1104,758,141300,52233
311,185,126,966,144900,52235
219,210,9,-,185700,52236
573,454,119,613,109500,52237
14334,7318,7016,939,160700,52240
7817,4323,3494,793,188700,52241
0,0,0,-,-,52242
9076,5887,3189,871,199500,52245
9730,4152,5578,800,223500,52246
2011,1506,505,607,165300,52247
710,554,156,674,108400,52248
482,379,103,675,122300,52249
263,229,34,391,71100,52251
1182,1048,134,704,182500,52253
341,243,98,619,87200,52254
532,406,126,640,101100,52255
119,116,3,-,200000,52257
1491,1080,411,564,113800,52301
15559,12010,3549,658,152100,52302
261,220,41,644,145300,52305
740,618,122,587,116300,52306
53,19,34,-,-,52307
91,77,14,275,76100,52308
157,120,37,463,184100,52309
2731,2184,547,565,140100,52310
51,34,17,547,73300,52312
174,137,37,616,135900,52313
1829,1566,263,692,196900,52314
453,388,65,570,139600,52315
638,519,119,631,98200,52316
6629,4701,1928,1032,191600,52317
445,371,74,1057,105100,52318
509,367,142,658,95600,52320
250,197,53,663,106500,52321
1197,1112,85,609,139300,52322
438,328,110,650,68400,52323
767,675,92,861,181500,52324
403,351,52,341,160900,52325
237,179,58,625,91500,52326
1237,964,273,832,200300,52327
1022,988,34,-,241000,52328
351,283,68,633,133000,52329
331,244,87,924,123700,52330
805,679,126,683,175200,52332
2386,2079,307,814,267000,52333
73,69,4,-,155200,52334
303,265,38,606,74200,52335
907,773,134,625,142200,52336
342,242,100,777,91400,52337
1239,1094,145,1066,297600,52338
1594,1072,522,628,83700,52339
1057,725,332,953,171600,52340
372,325,47,573,245600,52341
1171,859,312,761,92600,52342
557,457,100,525,148200,52345
370,291,79,511,126800,52346
730,546,184,560,100000,52347
29,29,0,-,61700,52348
3001,2387,614,576,122000,52349
511,481,30,603,211300,52351
627,537,90,599,148500,52352
3861,2493,1368,734,106700,52353
153,146,7,-,183500,52354
139,125,14,463,78800,52355
999,849,150,542,145100,52356
1537,1305,232,675,157500,52358
128,98,30,-,62000,52359
1836,1343,493,483,159000,52361
370,331,39,825,85500,52362
1013,262,751,533,101400,52401
16592,11621,4971,751,139100,52402
9834,7530,2304,622,140400,52403
15950,10079,5871,661,123700,52404
10386,7553,2833,742,139800,52405
2516,2493,23,945,280800,52411
12182,8748,3434,613,79900,52501
429,342,87,534,93300,52530
2453,1734,719,605,97600,52531
596,446,150,765,80300,52533
113,94,19,742,68300,52534
398,336,62,555,70000,52535
439,389,50,457,128800,52536
2552,2022,530,577,100900,52537
587,461,126,617,91800,52540
217,177,40,1043,87200,52542
102,85,17,-,114400,52543
3292,2112,1180,523,80500,52544
41,38,3,-,46400,52548
251,233,18,575,51800,52549
210,174,36,454,57500,52550
256,233,23,-,78400,52551
314,250,64,621,118300,52552
786,658,128,567,89500,52553
609,445,164,582,67100,52554
147,134,13,790,66000,52555
5294,3307,1987,633,107200,52556
0,0,0,-,-,52557
200,174,26,-,130000,52560
340,243,97,569,93500,52561
665,434,231,685,72200,52563
748,657,91,317,83300,52565
82,77,5,-,42500,52566
329,265,64,708,84600,52567
276,247,29,838,104900,52569
294,263,31,567,60300,52570
655,583,72,583,86800,52571
471,333,138,720,70200,52572
50,50,0,-,112500,52573
350,288,62,625,66300,52574
225,209,16,415,95000,52576
6251,4209,2042,592,105000,52577
171,150,21,235,74400,52580
161,149,12,-,106900,52581
165,156,9,-,71900,52583
169,126,43,(X),72200,52584
385,265,120,956,85700,52585
193,113,80,633,63600,52586
8,8,0,-,-,52588
435,339,96,489,64800,52590
1334,1047,287,519,89400,52591
43,35,8,575,83600,52593
152,119,33,1035,76300,52594
174,94,80,627,82400,52595
12416,8889,3527,649,95500,52601
176,141,35,-,144600,52619
330,268,62,551,81700,52620
329,255,74,827,100400,52621
758,625,133,583,130900,52623
119,107,12,-,83800,52624
1014,785,229,570,122900,52625
570,489,81,500,72000,52626
5406,4140,1266,597,81900,52627
221,151,70,718,58500,52630
5244,3491,1753,545,70700,52632
336,284,52,655,150900,52635
952,767,185,580,99300,52637
194,168,26,827,111800,52638
798,622,176,558,96300,52639
576,504,72,585,102000,52640
4498,3031,1467,615,116000,52641
154,111,43,826,109200,52644
1269,1108,161,675,95300,52645
117,107,10,617,133200,52646
85,66,19,558,80000,52647
344,282,62,558,75600,52649
341,266,75,-,134200,52650
273,230,43,431,80600,52651
1384,1083,301,621,113400,52653
632,474,158,506,101200,52654
1965,1496,469,642,102900,52655
1066,905,161,609,121700,52656
24,18,6,-,100000,52657
387,360,27,540,144400,52658
573,434,139,531,90600,52659
75,75,0,-,67200,52660
33,27,6,538,87500,52701
362,281,81,-,129300,52720
294,248,46,795,95800,52721
14424,11170,3254,821,185700,52722
1815,1759,56,748,199700,52726
166,124,42,-,214700,52727
442,377,65,598,99000,52728
340,283,57,641,128100,52729
2162,1799,363,679,114100,52730
318,266,52,571,106000,52731
11749,8055,3694,621,93300,52732
151,131,20,654,76300,52737
1359,928,431,608,97000,52738
246,180,66,817,75700,52739
3099,2370,729,560,156700,52742
271,201,70,816,126300,52745
386,279,107,934,170900,52746
911,697,214,710,150600,52747
3560,2661,899,639,191900,52748
380,363,17,763,148900,52749
202,197,5,642,161900,52750
390,357,33,810,149400,52751
188,154,34,675,93000,52752
2178,1793,385,690,221200,52753
549,498,51,631,114900,52754
817,593,224,711,175900,52755
704,619,85,782,219700,52756
57,54,3,-,96300,52757
85,65,20,(X),134000,52758
173,158,15,-,107700,52760
11794,8523,3271,771,126600,52761
150,136,14,438,133300,52765
419,365,54,657,160900,52766
76,76,0,-,(X),52767
593,484,109,770,172400,52768
274,206,68,630,155600,52769
2070,1666,404,599,134600,52772
951,741,210,599,143900,52773
37,28,9,655,92500,52774
1444,1036,408,717,123100,52776
513,403,110,690,102000,52777
1721,1229,492,601,142400,52778
536,4,532,555,-,52801
3845,2397,1448,654,74600,52802
9182,5601,3581,731,117700,52803
10829,7652,3177,724,114600,52804
10972,7070,3902,747,134200,52806
6700,3039,3661,675,234700,52807
757,645,112,823,174400,53001
977,796,181,814,206300,53002
29,29,0,-,171900,53003
1226,966,260,805,199600,53004
7580,6793,787,1439,267900,53005
709,562,147,947,185300,53006
896,465,431,659,163900,53007
3000,2522,478,763,187300,53010
904,781,123,808,180500,53011
7121,5461,1660,831,263700,53012
1276,1024,252,650,179800,53013
3189,2452,737,667,155500,53014
995,883,112,683,162900,53015
138,102,36,700,111700,53016
2208,2138,70,1319,309600,53017
3014,2353,661,971,330600,53018
743,658,85,806,171100,53019
1636,1260,376,653,197600,53020
1834,1465,369,765,214400,53021
7601,5910,1691,1008,238700,53022
532,470,62,825,186900,53023
6602,4875,1727,868,220200,53024
8743,6597,2146,782,202900,53027
7667,5903,1764,875,331800,53029
3,3,0,-,-,53031
1791,1370,421,825,136300,53032
1941,1915,26,883,262100,53033
731,502,229,812,161600,53034
926,788,138,863,169100,53035
999,826,173,924,228100,53036
3880,3105,775,832,204000,53037
1594,1207,387,895,201900,53038
1620,1146,474,687,164800,53039
2984,2347,637,870,220000,53040
2902,2400,502,504,150500,53042
961,839,122,1018,216200,53044
8409,6967,1442,1348,298300,53045
489,395,94,758,167700,53046
21,18,3,-,196900,53047
1246,778,468,715,152300,53048
910,847,63,475,192700,53049
2759,1986,773,731,147700,53050
14666,11039,3627,934,224800,53051
645,567,78,530,167600,53057
1424,960,464,1075,340200,53058
677,554,123,694,234500,53059
2161,1660,501,674,130900,53061
602,527,75,853,165500,53063
915,746,169,667,170300,53065
13331,10335,2996,888,262400,53066
301,281,20,-,255400,53069
1908,1642,266,655,163400,53070
10449,7643,2806,1095,260500,53072
5978,4344,1634,672,168400,53073
5283,3555,1728,808,189000,53074
1312,995,317,712,185100,53075
1174,1023,151,1059,309200,53076
722,609,113,973,238000,53078
561,473,88,603,154300,53079
2283,1691,592,703,201000,53080
17973,10828,7145,622,109600,53081
7954,6108,1846,749,159700,53083
4772,3420,1352,647,155700,53085
3227,2631,596,912,229400,53086
201,140,61,658,123400,53088
7001,5665,1336,952,263500,53089
8544,6602,1942,818,179900,53090
804,665,139,703,147200,53091
8796,7128,1668,977,317400,53092
746,640,106,738,186500,53093
7539,5042,2497,708,159500,53094
11515,8177,3338,779,196900,53095
1997,1885,112,1081,345700,53097
4467,3183,1284,870,160200,53098
1450,1324,126,915,234300,53103
2052,1729,323,920,218900,53104
11214,8568,2646,913,197600,53105
1223,1140,83,750,194300,53108
7720,4315,3405,754,150400,53110
971,689,282,888,162100,53114
6198,4163,2035,797,163600,53115
2826,2365,461,1141,278700,53118
1964,1794,170,979,255000,53119
4045,3143,902,818,215600,53120
7455,5392,2063,823,185500,53121
2295,2169,126,1375,354600,53122
755,670,85,964,344400,53125
2643,2165,478,1009,228900,53126
3101,2423,678,1001,159800,53128
5859,3910,1949,876,199100,53129
3208,1930,1278,1015,222800,53130
13110,10173,2937,956,226300,53132
642,541,101,1152,198000,53137
1190,1074,116,896,199000,53139
11789,5667,6122,786,128500,53140
11732,8706,3026,929,168200,53142
8697,5032,3665,839,124400,53143
9851,5587,4264,793,164000,53144
3077,2855,222,1150,233400,53146
6622,4410,2212,832,200300,53147
7335,6039,1296,840,263800,53149
9451,8031,1420,941,269500,53150
13639,9945,3694,1082,233000,53151
861,738,123,856,248100,53153
14027,8394,5633,963,208800,53154
1193,934,259,737,178800,53156
6015,4903,1112,1060,203000,53158
229,215,14,-,165800,53167
3273,2635,638,1091,172600,53168
846,603,243,864,191200,53170
8454,5111,3343,753,155900,53172
2674,2019,655,979,154100,53177
1125,856,269,797,193400,53178
2257,1953,304,963,174100,53179
2743,2104,639,884,187900,53181
3308,2544,764,779,194300,53182
1084,881,203,1046,288700,53183
1643,1018,625,805,193400,53184
6990,5892,1098,915,232100,53185
13748,7740,6008,842,189500,53186
14095,9202,4893,861,212200,53188
9789,7812,1977,938,253000,53189
6438,3034,3404,735,190000,53190
1278,921,357,981,259200,53191
91,91,0,-,139000,53192
43,33,10,-,134400,53195
15320,3308,12012,856,225300,53202
762,153,609,1131,244900,53203
13070,3530,9540,722,75700,53204
3482,1030,2452,596,73800,53205
8566,3087,5479,778,56100,53206
16646,9798,6848,833,151500,53207
12289,4195,8094,724,135200,53208
18254,8687,9567,791,95900,53209
9678,3815,5863,814,101300,53210
14531,5959,8572,940,290800,53211
13327,3876,9451,783,116500,53212
11440,6659,4781,895,217600,53213
15800,7969,7831,803,132100,53214
19403,8338,11065,743,105400,53215
12843,5956,6887,786,93200,53216
11526,8945,2581,1138,303000,53217
14037,6771,7266,825,86100,53218
15543,9419,6124,719,138500,53219
11689,6530,5159,805,158400,53220
15492,9196,6296,804,143600,53221
11247,7939,3308,779,139800,53222
12516,6901,5615,823,122300,53223
7924,3979,3945,888,141000,53224
9592,3945,5647,849,121600,53225
8151,5307,2844,960,217900,53226
10649,5322,5327,786,154100,53227
6330,3631,2699,982,190600,53228
4615,116,4499,618,93300,53233
4638,2299,2339,710,149800,53235
0,0,0,-,-,53295
12977,9302,3675,800,157700,53402
10527,5879,4648,726,116400,53403
5300,2513,2787,681,113700,53404
9865,6697,3168,812,120100,53405
11002,8057,2945,776,174600,53406
48,48,0,-,-,53501
983,695,288,776,177200,53502
794,627,167,728,170900,53503
822,620,202,646,139300,53504
178,148,30,1050,194100,53505
458,346,112,631,101000,53506
865,709,156,689,210300,53507
2074,1656,418,975,204300,53508
609,439,170,616,137500,53510
18861,12196,6665,730,96700,53511
946,768,178,773,207500,53515
910,773,137,817,177000,53516
692,574,118,793,227100,53517
581,480,101,667,114100,53518
2636,2000,636,670,138800,53520
1364,1201,163,966,234700,53521
415,341,74,625,140600,53522
1994,1582,412,868,219400,53523
1488,1074,414,766,150300,53525
268,212,56,691,122500,53526
3698,3092,606,1033,249100,53527
2259,1732,527,831,271700,53528
877,658,219,919,249400,53529
1806,1303,503,681,126500,53530
1707,1363,344,828,222900,53531
5567,4278,1289,913,219900,53532
2935,2182,753,746,159700,53533
5024,3789,1235,786,162000,53534
3352,2505,847,779,174600,53536
241,187,54,718,109600,53537
7529,5623,1906,791,168200,53538
95,90,5,-,76700,53540
339,272,67,389,125000,53541
677,559,118,550,130000,53543
325,261,64,648,163500,53544
9656,5956,3700,744,127800,53545
12284,9128,3156,758,136100,53546
7304,4919,2385,750,128800,53548
3895,2443,1452,736,163700,53549
437,387,50,855,170400,53550
3331,2223,1108,821,174400,53551
219,181,38,606,101900,53553
434,335,99,629,117700,53554
3480,2907,573,785,233400,53555
1090,844,246,660,121400,53556
181,140,41,675,139600,53557
4641,3656,985,932,246600,53558
2219,1711,508,844,187800,53559
1444,1137,307,761,222700,53560
695,612,83,775,271400,53561
10907,6593,4314,900,328700,53562
4332,3408,924,767,170600,53563
1957,1482,475,652,175000,53565
6400,4149,2251,660,139500,53566
449,371,78,638,137500,53569
1101,813,288,640,169500,53570
110,110,0,-,189800,53571
4045,2810,1235,882,248300,53572
1328,991,337,681,109600,53573
1517,1288,229,825,196900,53574
5846,4520,1326,790,244800,53575
910,657,253,757,144200,53576
566,461,105,678,181000,53577
2466,1850,616,977,214300,53578
655,547,108,860,160600,53579
235,179,56,575,100700,53580
4519,3064,1455,536,122600,53581
429,356,73,681,159800,53582
2277,1592,685,761,198400,53583
874,558,316,646,155900,53585
946,696,250,533,109900,53586
465,374,91,675,108200,53587
1702,1277,425,699,180000,53588
8120,6117,2003,884,209700,53589
14574,9031,5543,986,223200,53590
8252,6187,2065,1050,304300,53593
2074,1639,435,755,163400,53594
6564,5108,1456,1018,286600,53597
1093,695,398,898,238000,53598
39,20,19,579,92900,53599
19,19,0,-,-,53702
14409,2182,12227,924,281100,53703
20344,10975,9369,892,175900,53704
11440,5632,5808,885,287100,53705
85,0,85,1615,-,53706
19472,12411,7061,939,245800,53711
10078,2650,7428,801,169100,53713
7202,4173,3029,889,166800,53714
4889,774,4115,1195,237000,53715
8158,5686,2472,868,196800,53716
5898,2949,2949,959,268100,53717
5480,3682,1798,1200,216600,53718
13162,6839,6323,1005,222000,53719
2287,812,1475,995,433800,53726
0,0,0,-,-,53792
401,341,60,446,93600,53801
23,19,4,-,85000,53802
544,439,105,624,107500,53803
536,423,113,400,107600,53804
2059,1452,607,629,109600,53805
738,589,149,473,108700,53806
1889,1489,400,705,145700,53807
480,340,140,682,139600,53808
1565,1184,381,640,114400,53809
162,134,28,383,130000,53810
1234,971,263,646,153100,53811
2398,1740,658,523,138900,53813
274,231,43,635,152700,53816
70,50,20,488,81100,53817
5070,2887,2183,804,161400,53818
1053,881,172,569,142100,53820
3386,2312,1074,573,122900,53821
199,140,59,575,131300,53825
480,358,122,506,110300,53826
93,77,16,1025,101000,53827
5750,3647,2103,731,146500,53901
1219,831,388,599,96100,53910
551,406,145,981,189600,53911
8561,5254,3307,711,151700,53913
9153,6285,2868,750,134800,53916
998,843,155,588,150100,53919
174,157,17,908,164500,53920
402,321,81,619,174500,53922
713,606,107,667,157600,53923
573,447,126,656,153200,53924
3218,2352,866,748,176100,53925
441,377,64,481,153800,53926
47,34,13,1181,88000,53928
1060,776,284,667,129400,53929
509,397,112,688,140900,53930
92,69,23,630,117500,53931
990,684,306,920,186000,53932
1160,878,282,708,162300,53933
1764,1503,261,690,113600,53934
112,81,31,708,128900,53935
507,428,79,827,97400,53936
343,272,71,550,170300,53937
95,84,11,731,92000,53939
1167,1026,141,782,175000,53941
400,280,120,660,153400,53943
837,670,167,751,128900,53944
1883,1432,451,582,157900,53946
65,52,13,439,113800,53947
3164,2334,830,679,121400,53948
2522,2056,466,692,144100,53949
1853,1469,384,696,117200,53950
880,696,184,656,145900,53951
1365,1107,258,775,136300,53952
102,64,38,680,65600,53953
2792,2331,461,763,174700,53954
2324,1842,482,733,200500,53955
1180,901,279,711,144100,53956
5458,3867,1591,721,150300,53959
1409,1106,303,811,176200,53960
294,253,41,788,165200,53961
4842,3550,1292,694,131400,53963
1433,1106,327,760,141700,53964
3937,2804,1133,701,168500,53965
953,750,203,545,103800,53968
104,75,29,319,156900,53969
3400,2671,729,709,151000,54001
2561,1741,820,848,166700,54002
358,332,26,960,216900,54003
944,722,222,694,135700,54004
1188,951,237,636,146400,54005
312,257,55,677,154600,54006
485,384,101,571,160400,54007
931,725,206,847,165300,54009
22,0,22,687,-,54010
2556,2015,541,683,186100,54011
1301,1005,296,808,161600,54013
827,747,80,821,182200,54014
1261,998,263,849,164900,54015
12046,9368,2678,984,252000,54016
6239,4707,1532,835,171900,54017
2820,2141,679,779,171500,54020
2392,1935,457,846,229800,54021
8101,4994,3107,773,207300,54022
1418,1189,229,982,205700,54023
2097,1524,573,722,154800,54024
2529,2036,493,836,179000,54025
687,536,151,684,170600,54026
368,351,17,960,194700,54027
896,679,217,816,160600,54028
567,567,0,-,236800,54082
1052,969,83,725,172900,54101
413,357,56,443,124500,54102
203,190,13,(X),115900,54103
563,529,34,639,121000,54104
1830,1559,271,671,163200,54106
1357,1106,251,686,146400,54107
2004,1583,421,623,134600,54110
932,748,184,717,153900,54111
996,805,191,575,115500,54112
1352,1229,123,841,155200,54113
2465,2060,405,627,133100,54114
16599,11044,5555,826,184400,54115
258,182,76,733,130800,54119
94,88,6,-,150000,54120
1364,1151,213,513,155800,54121
100,96,4,-,143200,54123
1540,1187,353,580,109500,54124
306,237,69,404,79700,54125
1321,1082,239,719,176100,54126
19,6,13,-,-,54127
702,582,120,594,111900,54128
1291,1112,179,608,161900,54129
9886,7276,2610,756,155900,54130
880,635,245,470,96800,54135
2687,1878,809,740,133300,54136
433,412,21,-,142900,54137
418,359,59,625,164600,54138
1239,1061,178,709,139400,54139
3609,2526,1083,796,137100,54140
919,856,63,610,175400,54141
6697,4459,2238,654,89300,54143
645,589,56,600,156800,54149
355,164,191,507,45600,54150
1450,1280,170,499,86900,54151
2995,2259,736,618,114600,54153
2386,1795,591,579,143200,54154
2276,1916,360,587,173800,54155
642,548,94,658,100000,54156
2448,1733,715,643,115700,54157
598,573,25,1025,156500,54159
105,79,26,715,131300,54160
1237,1009,228,611,132900,54161
3331,2725,606,712,167000,54162
2860,2103,757,681,167200,54165
7282,5010,2272,621,131100,54166
965,912,53,(X),223900,54169
1396,1186,210,655,164100,54170
1303,1283,20,-,220100,54171
1512,1285,227,969,213100,54173
1230,987,243,556,122200,54174
458,397,61,671,204900,54175
1379,1109,270,520,122600,54177
1107,817,290,788,166200,54180
2228,1675,553,532,118100,54201
715,591,124,745,263600,54202
702,582,120,645,191000,54204
842,734,108,608,160900,54205
71,61,10,-,124200,54207
2380,1957,423,641,176100,54208
600,514,86,705,253800,54209
436,347,89,713,275400,54210
126,106,20,500,380000,54211
471,435,36,743,333900,54212
486,397,89,670,129000,54213
99,67,32,633,132500,54214
2649,2191,458,581,124500,54216
2698,2271,427,714,174200,54217
17068,11813,5255,625,116100,54220
633,572,61,550,178600,54227
1092,927,165,616,131300,54228
1676,1432,244,799,186500,54229
1771,1582,189,604,157400,54230
311,222,89,517,116300,54232
777,605,172,730,260300,54234
7976,6035,1941,671,167000,54235
6295,4669,1626,612,107800,54241
963,791,172,665,156300,54245
394,336,58,679,263200,54246
921,807,114,607,152600,54247
9121,6211,2910,688,143200,54301
12724,6443,6281,658,110300,54302
11666,5626,6040,623,113500,54303
12709,7512,5197,662,125500,54304
0,0,0,-,-,54307
13077,8967,4110,785,179700,54311
13783,11669,2114,823,190700,54313
12916,8415,4501,697,133500,54401
10074,6844,3230,647,138700,54403
1138,804,334,585,112500,54405
1328,1087,241,625,167300,54406
591,540,51,708,170500,54407
425,375,50,719,117400,54408
5768,3952,1816,595,97600,54409
800,740,60,556,139300,54410
1899,1628,271,679,143000,54411
776,664,112,596,157600,54412
52,39,13,436,127100,54413
1253,1026,227,548,136400,54414
717,578,139,473,87900,54416
20,12,8,-,105000,54417
399,340,59,658,127000,54418
442,358,84,658,152000,54420
1204,842,362,569,111100,54421
387,306,81,573,115800,54422
880,808,72,643,179700,54423
728,674,54,654,156900,54424
794,578,216,622,108300,54425
1578,1365,213,624,141700,54426
436,362,74,710,134700,54427
556,483,73,589,138300,54428
48,33,15,704,88100,54430
717,611,106,440,116800,54433
903,778,125,594,144000,54435
789,664,125,681,117200,54436
1164,867,297,515,121200,54437
1237,1090,147,679,157800,54440
331,305,26,(X),176600,54441
430,387,43,645,174700,54442
872,729,143,476,168800,54443
1127,850,277,592,99400,54446
226,178,48,650,110300,54447
1632,1408,224,650,170700,54448
11191,7683,3508,593,147600,54449
181,100,81,503,60800,54450
5063,3822,1241,553,132400,54451
7998,6004,1994,610,118300,54452
541,424,117,658,122100,54454
6567,5473,1094,849,162300,54455
2563,2000,563,618,110500,54456
3580,3047,533,691,121400,54457
39,29,10,590,137500,54458
578,481,97,614,111000,54459
1011,805,206,517,91000,54460
155,141,14,706,120800,54462
313,274,39,633,204200,54463
308,295,13,-,164800,54465
1207,980,227,513,129200,54466
5650,3492,2158,757,165600,54467
679,562,117,800,103500,54469
931,683,248,551,123200,54470
662,612,50,783,177100,54471
1014,875,139,695,157300,54473
1647,1179,468,694,122700,54474
606,531,75,575,134900,54475
7778,4868,2910,736,139600,54476
1573,1359,214,588,127400,54479
539,374,165,625,114000,54480
11456,6290,5166,650,125600,54481
3611,3089,522,753,168000,54482
1963,1618,345,601,151300,54484
136,112,24,-,147500,54485
1008,792,216,523,109900,54486
4553,3603,950,641,164500,54487
389,328,61,546,118300,54488
599,519,80,509,129800,54489
375,311,64,522,126000,54490
738,637,101,600,114300,54491
256,244,12,550,128000,54493
11709,9315,2394,684,115800,54494
3440,2129,1311,577,90700,54495
845,692,153,611,109200,54498
1224,911,313,567,120100,54499
8145,6489,1656,751,138200,54501
551,491,60,531,124800,54511
406,337,69,877,244100,54512
188,167,21,569,113600,54513
860,708,152,580,142500,54514
224,201,23,575,97800,54515
59,56,3,-,225000,54517
581,520,61,806,237100,54519
1765,1159,606,459,132800,54520
3799,2816,983,691,183200,54521
414,240,174,446,137500,54524
127,83,44,392,66800,54525
364,311,53,450,91200,54526
453,360,93,479,84600,54527
467,441,26,775,193400,54529
367,344,23,654,78300,54530
644,601,43,542,223800,54531
1158,873,285,437,76300,54534
110,96,14,719,49100,54536
229,216,13,425,112200,54537
1495,983,512,532,172700,54538
499,443,56,656,183600,54539
494,377,117,453,181700,54540
463,366,97,433,112900,54541
207,189,18,-,95000,54542
452,387,65,825,300900,54545
530,411,119,471,95700,54546
680,545,135,524,189300,54547
2080,1767,313,759,240000,54548
291,261,30,625,78800,54550
2056,1559,497,479,108100,54552
553,430,123,692,172000,54554
2340,1813,527,665,139500,54555
590,436,154,454,91200,54556
496,457,39,925,336900,54557
1041,788,253,745,216700,54558
327,224,103,397,107800,54559
216,182,34,965,186800,54560
13,13,0,-,(X),54561
807,722,85,544,245200,54562
305,262,43,742,111300,54563
233,226,7,-,109500,54564
43,41,2,-,65000,54565
557,454,103,450,111900,54566
2359,1765,594,682,164500,54568
19637,10777,8860,745,144700,54601
6356,3584,2772,643,120400,54603
706,535,171,564,161000,54610
440,326,114,622,105500,54611
1892,1316,576,727,138800,54612
786,688,98,650,113400,54613
1203,915,288,661,147500,54614
4063,2904,1159,606,126200,54615
1033,796,237,638,124300,54616
854,675,179,814,136800,54618
1247,998,249,706,141000,54619
475,406,69,614,172700,54621
967,799,168,442,130800,54622
797,693,104,647,165900,54623
626,554,72,553,137900,54624
126,80,46,550,147500,54625
511,409,102,610,122100,54626
787,619,168,605,155000,54627
435,343,92,596,136400,54628
1107,896,211,643,164800,54629
1667,1240,427,648,157100,54630
717,604,113,570,113500,54631
458,411,47,812,156900,54632
1606,1237,369,595,128800,54634
744,603,141,628,130400,54635
5386,4275,1111,857,186200,54636
78,48,30,613,82900,54637
603,476,127,463,133600,54638
925,752,173,587,118800,54639
1,1,0,-,-,54641
794,600,194,733,154400,54642
4,4,0,-,-,54643
553,454,99,779,162300,54644
32,19,13,(X),51300,54645
1516,1213,303,832,111700,54646
558,461,97,697,123200,54648
9466,7084,2382,796,168400,54650
487,391,96,560,128000,54651
379,305,74,612,125400,54652
325,235,90,769,136300,54653
49,36,13,-,97100,54654
711,572,139,560,151900,54655
7053,4772,2281,765,125800,54656
163,130,33,683,116700,54657
1029,823,206,641,168700,54658
522,371,151,608,120100,54659
6537,3945,2592,780,140500,54660
1469,1110,359,676,176700,54661
637,507,130,659,113900,54664
3493,2580,913,626,129800,54665
1111,813,298,790,147600,54666
1798,1433,365,645,143400,54667
3009,2398,611,786,176400,54669
566,457,109,780,144800,54670
15849,9293,6556,736,170500,54701
17407,10299,7108,761,137600,54703
2921,1992,929,764,153200,54720
539,448,91,706,134500,54721
1424,971,453,671,143300,54722
542,407,135,648,157800,54723
2784,2208,576,670,145100,54724
1156,901,255,600,125800,54725
677,551,126,640,116600,54726
1957,1561,396,680,144800,54727
2586,2016,570,664,145700,54728
13350,8974,4376,741,157300,54729
1940,1573,367,735,156600,54730
260,204,56,633,92200,54731
1167,859,308,621,118900,54732
460,368,92,684,115100,54733
315,285,30,719,145800,54734
1603,1254,349,578,134700,54736
222,156,66,928,150000,54737
1159,959,200,596,175400,54738
1752,1336,416,837,165100,54739
804,634,170,613,134800,54740
626,511,115,500,123500,54741
1651,1367,284,644,151900,54742
882,809,73,644,178700,54745
297,218,79,720,105100,54746
1120,718,402,638,122600,54747
594,517,77,548,142100,54748
491,411,80,650,149700,54749
419,377,42,758,160100,54750
9357,5509,3848,713,156500,54751
745,543,202,620,114000,54754
2955,2198,757,670,145500,54755
434,337,97,520,145700,54756
1333,1121,212,633,150800,54757
1864,1464,400,672,127700,54758
625,510,115,524,151800,54759
90,58,32,660,135700,54760
469,341,128,639,148600,54761
510,392,118,668,114100,54762
437,377,60,625,130600,54763
25,22,3,-,55000,54765
573,500,73,719,116000,54766
1325,1083,242,707,163900,54767
1804,1253,551,543,118800,54768
241,216,25,575,204300,54769
823,658,165,544,137900,54770
1518,1140,378,576,116100,54771
395,306,89,625,125000,54772
1295,968,327,547,133600,54773
2978,2226,752,645,144600,54801
539,405,134,677,98100,54805
4957,3336,1621,648,117400,54806
935,787,148,639,163800,54810
2052,1373,679,689,105900,54812
261,219,42,600,156300,54813
1115,784,331,513,165700,54814
1031,853,178,724,156700,54817
1140,906,234,655,99700,54819
325,284,41,665,142700,54820
683,620,63,666,179400,54821
1865,1409,456,802,132200,54822
958,705,253,731,150300,54824
302,265,37,836,153200,54826
111,107,4,-,148400,54827
342,248,94,575,150000,54828
2271,1672,599,603,141100,54829
1532,1370,162,621,165700,54830
220,161,59,600,164900,54832
427,349,78,542,113100,54835
372,319,53,1029,152500,54836
1506,1196,310,579,129000,54837
597,535,62,425,192000,54838
134,114,20,(X),126600,54839
1989,1527,462,647,128900,54840
129,112,17,754,83300,54841
54,48,6,-,122900,54842
4987,3610,1377,648,173000,54843
146,131,15,307,167400,54844
62,59,3,-,89200,54845
228,206,22,575,94400,54846
1042,898,144,659,173000,54847
2522,1747,775,651,101200,54848
862,750,112,720,169100,54849
104,94,10,-,200000,54850
1720,1336,384,662,158600,54853
389,341,48,769,140800,54854
262,243,19,680,153800,54855
634,547,87,629,137800,54856
27,18,9,-,-,54857
730,525,205,595,118500,54858
777,630,147,718,138500,54859
61,23,38,(X),162500,54861
143,129,14,525,101400,54862
536,462,74,860,169000,54864
220,204,16,525,121300,54865
143,121,22,494,84100,54867
6890,4796,2094,596,142700,54868
722,656,66,890,180800,54870
1354,991,363,580,138700,54871
1285,929,356,614,121600,54872
1320,1130,190,615,173200,54873
1509,1389,120,948,145200,54874
510,407,103,708,113800,54875
702,550,152,750,160800,54876
12922,7697,5225,695,118400,54880
599,524,75,704,147800,54888
1140,792,348,601,135900,54889
1543,1159,384,627,153100,54891
1756,1375,381,603,160900,54893
467,368,99,633,148800,54895
696,579,117,644,122800,54896
13556,6659,6897,688,115900,54901
10093,6261,3832,638,110200,54902
8831,6769,2062,714,188600,54904
902,791,111,620,123700,54909
10449,6272,4177,664,133000,54911
7697,5565,2132,820,235600,54913
12847,7839,5008,697,139400,54914
15962,11341,4621,677,160200,54915
471,423,48,700,110000,54921
546,427,119,625,126300,54922
3741,2532,1209,609,130100,54923
229,190,39,750,186700,54927
148,141,7,-,114600,54928
3740,2964,776,608,111100,54929
674,576,98,653,138400,54930
92,79,13,-,134300,54931
504,477,27,700,185900,54932
107,75,32,809,84300,54933
97,61,36,-,111800,54934
17958,10690,7268,664,123300,54935
7323,5912,1411,862,174000,54937
1673,1490,183,669,180100,54940
1140,892,248,638,183600,54941
3233,2955,278,781,217500,54942
823,707,116,546,121600,54943
3125,2666,459,681,195400,54944
1572,1243,329,596,150300,54945
0,0,0,-,-,54946
1106,1042,64,834,168200,54947
107,85,22,738,122800,54948
1393,1097,296,594,134700,54949
1240,1004,236,587,121100,54950
10809,7296,3513,688,129500,54952
18053,12885,5168,726,152700,54956
1189,1087,102,667,151500,54960
5734,4211,1523,641,136200,54961
471,409,62,675,145300,54962
2724,2076,648,642,168800,54963
415,340,75,991,206600,54964
561,493,68,756,168600,54965
761,599,162,628,130000,54966
161,122,39,325,76000,54967
1205,981,224,675,121300,54968
1272,943,329,649,107400,54970
4314,2935,1379,671,130700,54971
561,484,77,683,159800,54974
548,493,55,772,182900,54977
551,499,52,863,163700,54979
76,45,31,678,129700,54980
6283,4327,1956,720,147800,54981
2937,2265,672,684,138400,54982
1735,1373,362,720,142600,54983
1348,1098,250,709,148000,54984
0,0,0,-,-,54985
2051,1725,326,585,190200,54986
1180,1138,42,1500,395300,55001
1013,724,289,906,191700,55003
1434,1339,95,1645,188400,55005
1459,1083,376,811,118600,55006
938,852,86,772,129000,55007
5558,4213,1345,901,160700,55008
3129,2554,575,724,214300,55009
3533,3433,100,1370,219700,55011
701,610,91,1000,215000,55012
2773,2320,453,716,249700,55013
9850,8510,1340,1039,208400,55014
11708,10136,1572,1131,206700,55016
290,254,36,1188,171400,55017
382,361,21,825,274500,55018
737,661,76,1092,187700,55019
1214,1137,77,1563,287300,55020
10826,7608,3218,699,164800,55021
11528,10222,1306,1048,209800,55024
8900,6923,1977,948,235700,55025
173,167,6,-,222400,55026
1058,902,156,856,204800,55027
31,31,0,-,87500,55029
515,447,68,863,138000,55030
802,687,115,775,262800,55031
1188,1101,87,658,209800,55032
11810,9272,2538,828,204200,55033
32,25,7,765,49000,55036
2080,1452,628,668,122200,55037
7333,6474,859,1229,243400,55038
4764,3889,875,803,161100,55040
3282,2723,559,875,171500,55041
3093,2889,204,928,375000,55042
1435,1262,173,1060,213200,55043
16589,14525,2064,1123,286400,55044
2902,2582,320,713,191900,55045
1816,1544,272,976,195000,55046
1097,1009,88,1156,356300,55047
899,803,96,656,156000,55049
3725,2794,931,737,136400,55051
815,683,132,646,152200,55052
367,355,12,970,214700,55053
879,728,151,1216,250000,55054
1430,904,526,737,174400,55055
5013,4264,749,834,172500,55056
8003,5803,2200,746,221400,55057
11467,8472,2995,735,152400,55060
3720,2919,801,706,141200,55063
410,354,56,1152,241800,55065
7868,5390,2478,712,163400,55066
9890,8589,1301,1098,215000,55068
1812,1337,475,729,164500,55069
2651,2252,399,908,164200,55070
2115,1644,471,863,158000,55071
1432,985,447,743,129500,55072
1250,1149,101,(X),285200,55073
817,694,123,1067,163000,55074
8366,5600,2766,822,159600,55075
8820,6620,2200,1004,183500,55076
4878,2928,1950,971,326600,55077
2919,2687,232,917,194600,55079
903,838,65,1200,214800,55080
13525,10490,3035,1101,293800,55082
629,531,98,779,177700,55084
166,140,26,900,175900,55085
143,125,18,-,111000,55087
621,573,48,1143,361600,55088
705,660,45,825,279900,55089
161,147,14,1396,122800,55090
4011,3379,632,1239,199800,55092
4209,858,3351,1019,148400,55101
8884,3522,5362,802,171100,55102
4908,1811,3097,662,148400,55103
17190,8561,8629,813,187400,55104
11113,7300,3813,876,296000,55105
17916,9850,8066,827,129400,55106
5326,2949,2377,784,160100,55107
6166,2953,3213,901,240300,55108
13077,8507,4570,867,179400,55109
15776,12512,3264,944,209300,55110
0,0,0,-,-,55111
16928,11470,5458,869,207800,55112
17272,10877,6395,897,220900,55113
1669,340,1329,988,196700,55114
3263,2749,514,918,304900,55115
11341,5784,5557,889,268300,55116
16044,8695,7349,823,171000,55117
11767,7928,3839,865,210200,55118
15271,9701,5570,861,152500,55119
1820,1446,374,1095,282500,55120
3638,1727,1911,995,190900,55121
12815,8985,3830,980,222200,55122
9378,7350,2028,1105,289200,55123
19413,15164,4249,1127,213100,55124
16479,12603,3876,1295,257200,55125
10981,8965,2016,1137,233700,55126
7416,6350,1066,1169,248200,55127
11461,8649,2812,1005,185000,55128
7580,6109,1471,1523,333600,55129
5327,1887,3440,733,133900,55130
76,42,34,1083,172500,55150
0,0,0,-,-,55155
3554,3087,467,1010,186200,55301
2800,2371,429,871,207500,55302
17399,12898,4501,938,192400,55303
15492,14431,1061,1220,243800,55304
9266,5186,4080,1139,278900,55305
6638,4234,2404,1060,221000,55306
1304,953,351,531,136400,55307
3003,2318,685,992,197400,55308
6077,5483,594,858,174000,55309
599,522,77,566,89700,55310
12682,10850,1832,1397,327800,55311
658,559,99,762,117300,55312
8403,6388,2015,919,197500,55313
478,395,83,636,121000,55314
1640,1532,108,954,283900,55315
8608,7242,1366,1110,198800,55316
7402,6292,1110,1147,313900,55317
9690,6730,2960,980,235900,55318
1901,1752,149,1114,213800,55319
1880,1579,301,791,185900,55320
1801,1340,461,725,172000,55321
1152,995,157,853,247700,55322
521,446,75,907,238200,55324
1693,1413,280,714,202200,55325
1321,1265,56,1028,253900,55327
3172,2748,424,740,249700,55328
828,604,224,652,123200,55329
13098,10682,2416,1000,199500,55330
6808,5643,1165,883,450000,55331
728,554,174,719,91400,55332
362,285,77,478,69500,55333
1226,886,340,611,112000,55334
627,522,105,642,97800,55335
3176,2518,658,696,146300,55336
18212,11750,6462,970,205900,55337
417,392,25,975,154100,55338
391,326,65,850,175000,55339
2360,2196,164,1397,363100,55340
1049,1009,40,675,257900,55341
826,671,155,707,102200,55342
11313,5164,6149,983,212200,55343
7144,2358,4786,1143,214600,55344
8931,7291,1640,1082,297700,55345
6297,5602,695,1391,295300,55346
11001,9839,1162,1471,344900,55347
1507,1167,340,790,173000,55349
7552,5448,2104,735,150500,55350
3225,2514,711,949,253600,55352
1281,1139,142,683,186400,55353
1016,862,154,516,160300,55354
3897,3010,887,693,147500,55355
2088,1663,425,933,501000,55356
1133,1053,80,754,290900,55357
1953,1627,326,955,197500,55358
2390,2045,345,811,311000,55359
900,807,93,1305,202500,55360
6889,5420,1469,950,180600,55362
1645,1368,277,863,154200,55363
6097,4812,1285,826,304600,55364
189,159,30,506,83900,55366
394,341,53,719,186900,55367
912,585,327,531,189500,55368
13800,11202,2598,1165,212400,55369
338,318,20,713,205600,55370
6184,4951,1233,828,165600,55371
11215,9612,1603,1188,288800,55372
2024,1608,416,862,198300,55373
4760,4059,701,1315,266300,55374
1481,1334,147,1223,269400,55375
5365,4798,567,1331,214800,55376
9577,8389,1188,1105,254700,55378
14312,11035,3277,1061,215500,55379
846,671,175,743,150100,55381
1401,1285,116,931,215700,55382
987,229,758,987,332600,55384
519,415,104,613,109400,55385
2374,2113,261,876,371300,55386
4803,3911,892,864,250500,55387
2272,1823,449,687,179800,55388
952,805,147,532,151700,55389
961,828,133,1024,172800,55390
6432,5207,1225,1046,490500,55391
1140,883,257,591,142900,55395
867,674,193,706,108700,55396
1042,843,199,800,183800,55397
5235,4394,841,970,177300,55398
4876,2095,2781,1371,301100,55401
322,0,322,1339,-,55402
10463,2196,8267,793,238500,55403
12060,1877,10183,707,174100,55404
7558,2709,4849,802,329700,55405
15103,10362,4741,852,191500,55406
14431,7669,6762,897,176900,55407
15294,3709,11585,879,236600,55408
4889,3064,1825,981,210400,55409
8307,6551,1756,1158,353400,55410
9413,3699,5714,934,123900,55411
8148,4942,3206,923,120500,55412
6289,2511,3778,934,197600,55413
9973,2036,7937,857,240700,55414
1278,631,647,942,314000,55415
15446,8350,7096,1079,289000,55416
11047,8928,2119,936,222200,55417
13217,8855,4362,897,187400,55418
10667,8376,2291,1023,297900,55419
9255,6077,3178,899,182800,55420
11262,6743,4519,883,153600,55421
12417,8669,3748,997,184500,55422
15106,9539,5567,854,182400,55423
3442,3139,303,1141,589900,55424
4039,1992,2047,932,190100,55425
11677,7059,4618,957,213500,55426
9579,6675,2904,894,205400,55427
11748,6777,4971,881,161700,55428
10232,5414,4818,816,140500,55429
8036,5041,2995,957,130000,55430
8075,5564,2511,1056,225300,55431
12389,7967,4422,895,163900,55432
13570,9432,4138,984,159400,55433
10994,9111,1883,947,160200,55434
6620,3178,3442,1135,216800,55435
5379,4307,1072,1279,414800,55436
7866,5581,2285,967,248300,55437
7527,5693,1834,1127,269300,55438
3448,3030,418,1108,460400,55439
7760,4512,3248,1020,286700,55441
5620,4260,1360,1313,289400,55442
10803,8260,2543,981,214200,55443
5132,4255,877,951,172200,55444
3638,3247,391,1490,179200,55445
8438,6270,2168,1236,323300,55446
8613,6679,1934,1128,297700,55447
10541,8842,1699,1134,177800,55448
9243,8076,1167,1332,229700,55449
0,0,0,-,-,55450
3091,323,2768,603,138700,55454
0,0,0,-,-,55455
35,33,2,-,293800,55601
95,83,12,-,129700,55602
255,243,12,-,155100,55603
1556,1282,274,595,260200,55604
287,112,175,679,100000,55605
115,105,10,-,256900,55606
59,56,3,-,158300,55607
119,119,0,-,171300,55609
443,256,187,514,241100,55612
117,109,8,-,198400,55613
1259,1072,187,655,112600,55614
134,91,43,695,173800,55615
3187,2392,795,684,163200,55616
201,189,12,1300,169600,55702
347,317,30,539,131500,55703
485,385,100,440,133200,55704
1431,1210,221,472,88300,55705
830,664,166,563,73400,55706
1348,1159,189,683,157300,55707
478,333,145,803,74600,55708
1762,1477,285,698,159400,55709
497,492,5,-,189100,55710
190,166,24,613,145200,55711
226,206,20,779,144400,55712
493,385,108,380,82800,55713
153,124,29,681,63200,55716
103,95,8,-,191300,55717
1231,1028,203,667,172100,55718
2347,1803,544,488,89600,55719
6585,4871,1714,638,143400,55720
1390,1247,143,735,194700,55721
457,361,96,685,127100,55722
1065,908,157,544,141300,55723
354,337,17,675,151800,55724
72,68,4,(X),412500,55725
427,315,112,882,179300,55726
2834,2244,590,564,152800,55731
606,572,34,940,117900,55732
1613,1474,139,911,200900,55733
2790,2053,737,594,98200,55734
763,670,93,769,163600,55735
679,566,113,427,119600,55736
217,202,15,1000,107600,55738
1484,1283,201,567,110000,55741
146,140,6,-,171600,55742
8510,6263,2247,619,162500,55744
7693,5554,2139,558,95800,55746
645,470,175,585,129700,55748
206,188,18,788,143100,55749
880,770,110,771,67300,55750
637,579,58,640,121200,55751
179,175,4,-,141100,55752
420,368,52,964,64600,55753
180,167,13,-,161800,55756
392,330,62,788,152000,55757
61,53,8,(X),62200,55758
1520,1209,311,627,173700,55760
271,245,26,-,135400,55763
243,172,71,332,80700,55764
357,322,35,613,112700,55765
19,13,6,-,(X),55766
1552,1070,482,713,131700,55767
1325,862,463,490,139400,55768
1053,853,200,789,142200,55769
748,588,160,639,102800,55771
59,21,38,784,(X),55772
593,543,50,863,173700,55775
1451,1346,105,1050,197900,55779
54,41,13,734,123200,55780
317,314,3,-,301500,55781
208,187,21,647,78700,55782
940,822,118,835,161500,55783
46,46,0,-,97500,55784
81,75,6,-,153100,55785
125,103,22,481,93800,55786
239,204,35,777,158900,55787
964,746,218,854,206700,55790
4763,2932,1831,509,87700,55792
225,200,25,900,139100,55793
560,479,81,769,144600,55795
565,526,39,1203,161400,55797
235,205,30,694,127600,55798
1377,406,971,449,278800,55802
6986,6048,938,972,193500,55803
5781,5002,779,1032,179200,55804
4797,1481,3316,678,117500,55805
4179,1817,2362,679,102700,55806
4361,2942,1419,647,113000,55807
2528,1721,807,663,108700,55808
3601,3095,506,733,152700,55810
10318,7054,3264,870,187200,55811
3428,1727,1701,780,199000,55812
0,0,0,-,-,55814
21272,14375,6897,893,166900,55901
9448,6897,2551,939,245500,55902
9824,7076,2748,722,138900,55904
0,0,0,-,-,55905
7293,5884,1409,694,201900,55906
503,420,83,399,123300,55909
540,444,96,588,164800,55910
11324,7660,3664,708,105600,55912
1387,1170,217,713,138400,55917
452,377,75,481,109400,55918
446,367,79,669,141400,55919
2506,2201,305,878,189700,55920
1930,1536,394,589,153300,55921
316,255,61,431,87700,55922
1801,1402,399,741,187100,55923
531,455,76,575,139300,55924
372,350,22,1018,168800,55925
285,221,64,436,147000,55926
1499,1164,335,615,138100,55927
461,385,76,867,166300,55929
154,135,19,625,113600,55931
803,677,126,575,175800,55932
88,66,22,775,104500,55933
1261,1032,229,597,169500,55934
379,318,61,713,178100,55935
708,567,141,664,121900,55936
809,595,214,600,120900,55939
1009,844,165,780,162100,55940
382,309,73,788,156600,55941
1295,1101,194,803,148800,55943
2743,2263,480,634,156200,55944
537,474,63,950,171400,55945
1272,1017,255,779,160900,55946
3159,2561,598,628,185400,55947
753,601,152,498,169300,55949
63,51,12,-,84300,55950
603,476,127,775,103300,55951
897,658,239,540,160000,55952
355,297,58,563,117000,55953
583,470,113,655,94500,55954
941,855,86,832,246500,55955
755,635,120,683,187300,55956
251,209,42,808,160900,55957
843,741,102,671,125800,55959
1234,1153,81,920,292500,55960
171,139,32,800,101900,55961
307,254,53,691,150900,55962
2029,1570,459,810,200200,55963
1720,1381,339,578,146000,55964
1055,830,225,614,129300,55965
340,324,16,775,177900,55967
56,44,12,1000,145800,55968
428,325,103,811,172900,55969
377,329,48,683,130100,55970
1233,935,298,639,158100,55971
1683,1303,380,618,172200,55972
123,110,13,1021,163100,55973
875,681,194,469,113000,55974
1799,1454,345,546,127500,55975
2982,2351,631,829,162700,55976
82,66,16,-,158300,55977
350,280,70,619,171400,55979
1871,1408,463,678,163400,55981
188,170,18,642,134400,55982
609,481,128,575,152000,55983
749,600,149,663,133500,55985
13538,8867,4671,605,147000,55987
357,292,65,542,110300,55990
541,445,96,758,235200,55991
1952,1483,469,593,178000,55992
17980,10419,7561,728,162900,56001
6210,4572,1638,736,170300,56003
9155,6619,2536,601,99900,56007
586,510,76,544,118800,56009
481,407,74,388,130800,56010
2994,2616,378,737,193700,56011
1974,1443,531,502,96300,56013
321,232,89,718,76000,56014
385,331,54,600,97900,56016
645,549,96,813,191300,56017
371,309,62,560,104100,56019
50,50,0,-,60000,56020
408,351,57,744,182600,56021
33,33,0,-,22500,56022
217,176,41,600,78500,56023
1086,848,238,995,165200,56024
224,205,19,663,102100,56025
734,648,86,663,149500,56026
400,327,73,800,56600,56027
514,445,69,938,223100,56028
302,259,43,575,93500,56029
5333,3742,1591,610,121200,56031
125,109,16,525,51500,56032
155,139,16,625,60600,56033
228,192,36,1125,178300,56034
145,129,16,-,113700,56035
774,678,96,650,113200,56036
614,570,44,625,169100,56037
413,323,90,520,116900,56039
447,389,58,739,149200,56041
270,231,39,475,112100,56042
217,186,31,559,112500,56043
830,658,172,649,163300,56044
321,266,55,694,113700,56045
32,25,7,-,88300,56046
68,54,14,563,102600,56047
1552,1345,207,651,147600,56048
660,533,127,652,188400,56050
341,268,73,486,50900,56051
354,293,61,868,224100,56052
377,318,59,550,133000,56054
1543,1271,272,606,155400,56055
32,32,0,-,57700,56056
1512,1173,339,636,158200,56057
2445,1917,528,668,155700,56058
183,146,37,533,76700,56060
1250,934,316,595,105000,56062
1130,922,208,736,268400,56063
1020,812,208,595,128300,56065
455,392,63,497,107800,56068
1822,1527,295,625,150100,56069
4150,3466,684,845,226700,56071
900,754,146,558,121300,56072
7059,5450,1609,611,139900,56073
778,640,138,626,162500,56074
97,89,8,625,58800,56075
169,140,29,936,122900,56078
271,221,50,770,140800,56080
2411,1705,706,553,97800,56081
4473,3009,1464,827,172700,56082
386,342,44,292,84500,56083
2138,1685,453,610,120200,56085
1271,1019,252,572,96300,56087
804,610,194,638,92900,56088
76,52,24,488,50000,56089
280,219,61,785,124000,56090
148,126,22,521,110700,56091
4811,3519,1292,570,144600,56093
1206,907,299,669,175500,56096
1647,1243,404,540,94800,56097
907,688,219,562,85200,56098
2474,1926,548,565,101100,56101
793,666,127,495,96800,56110
172,149,23,631,79200,56111
115,96,19,763,88300,56113
138,116,22,675,82500,56114
468,394,74,621,111000,56115
239,205,34,470,136200,56116
121,93,28,708,86800,56117
144,124,20,500,110700,56118
407,339,68,538,105500,56119
453,373,80,663,69400,56120
258,207,51,525,65800,56121
238,174,64,592,81300,56122
225,206,19,738,84400,56123
40,36,4,-,36100,56125
176,144,32,638,59400,56127
795,684,111,725,119000,56128
282,249,33,558,77300,56129
1047,811,236,612,101000,56131
223,189,34,569,165300,56132
194,151,43,482,97500,56134
469,373,96,413,75400,56136
451,341,110,597,77100,56137
347,277,70,587,110800,56138
177,149,28,519,98300,56139
26,25,1,-,61000,56140
123,110,13,467,80000,56141
446,342,104,503,80300,56142
1961,1356,605,520,110900,56143
502,412,90,698,87400,56144
244,203,41,620,57300,56145
18,18,0,-,65000,56146
61,56,5,-,127800,56147
566,435,131,494,111000,56149
1131,940,191,544,96700,56150
338,311,27,525,104500,56151
601,496,105,454,82800,56152
95,92,3,-,67000,56153
159,142,17,1025,83300,56155
2537,1790,747,641,134700,56156
319,286,33,728,138300,56157
182,153,29,508,95000,56158
1144,872,272,675,72700,56159
88,80,8,-,61700,56160
150,130,20,475,75700,56161
108,106,2,-,79200,56162
2457,1693,764,518,93700,56164
158,139,19,1028,103900,56165
94,83,11,625,73600,56166
286,209,77,529,73200,56167
367,305,62,669,106100,56168
280,237,43,664,115100,56169
226,187,39,583,79400,56170
747,569,178,825,91900,56171
1407,1123,284,494,96000,56172
153,130,23,683,125000,56173
138,107,31,625,60700,56174
1193,923,270,447,82500,56175
461,362,99,558,72100,56176
19,19,0,-,(X),56177
697,570,127,592,104800,56178
508,351,157,511,82600,56180
469,385,84,572,86800,56181
551,460,91,500,69300,56183
243,194,49,632,78600,56185
158,128,30,436,86700,56186
4887,3179,1708,630,123800,56187
9106,5606,3500,655,148700,56201
82,71,11,838,77500,56207
975,647,328,540,65400,56208
960,800,160,617,127500,56209
3,3,0,-,-,56210
206,169,37,513,76300,56211
217,185,32,735,70300,56212
312,245,67,592,74700,56214
1979,1397,582,555,97800,56215
247,220,27,883,106500,56216
232,213,19,600,92500,56218
368,279,89,450,42600,56219
1288,964,324,574,99300,56220
275,223,52,508,81800,56221
738,569,169,634,98600,56222
576,449,127,504,85200,56223
155,139,16,-,101400,56224
304,243,61,803,81300,56225
94,82,12,-,98200,56226
84,79,5,-,121600,56227
407,325,82,666,76400,56228
719,530,189,624,154000,56229
337,294,43,688,85100,56230
182,152,30,785,133300,56231
1024,790,234,537,82700,56232
222,194,28,558,111400,56235
148,132,16,758,101500,56236
250,213,37,426,77900,56237
209,192,17,425,123100,56239
404,326,78,484,93500,56240
1639,1214,425,667,121500,56241
684,511,173,685,127300,56243
518,399,119,573,111400,56244
219,178,41,600,83300,56245
350,290,60,402,79200,56248
134,114,20,494,83800,56249
400,308,92,590,140400,56251
496,399,97,575,103100,56252
432,377,55,769,150800,56253
151,131,20,492,80600,56255
1139,884,255,571,77900,56256
200,174,26,475,55000,56257
5958,3516,2442,607,150600,56258
325,268,57,725,85000,56260
283,216,67,709,73200,56262
214,181,33,525,95700,56263
884,729,155,744,106900,56264
3267,2292,975,569,105600,56265
654,546,108,521,85400,56266
2634,1627,1007,606,156200,56267
377,304,73,562,75300,56270
473,387,86,687,108700,56271
1958,1678,280,832,201600,56273
53,51,2,-,68300,56274
135,127,8,-,73500,56276
1301,962,339,554,104800,56277
1260,949,311,500,109200,56278
473,403,70,796,158100,56279
212,175,37,610,106700,56280
242,212,30,735,122000,56281
539,437,102,657,114800,56282
2710,2015,695,601,103400,56283
896,704,192,565,96700,56284
467,381,86,348,69000,56285
24,22,2,-,60000,56287
1890,1648,242,698,237200,56288
267,247,20,(X),225700,56289
211,184,27,525,117400,56291
216,177,39,562,78500,56292
450,364,86,502,101900,56293
34,34,0,-,56700,56294
134,108,26,575,72500,56295
916,754,162,539,73500,56296
351,273,78,573,93200,56297
11305,6245,5060,805,173900,56301
11033,6601,4432,689,136000,56303
6075,3113,2962,681,142700,56304
1999,1598,401,694,170100,56307
10744,7681,3063,740,196300,56308
483,407,76,735,160400,56309
1974,1790,184,672,196100,56310
253,222,31,738,120500,56311
883,738,145,738,156000,56312
40,25,15,(X),49000,56313
484,423,61,833,159800,56314
639,587,52,542,177800,56315
559,468,91,659,123000,56316
480,446,34,700,209300,56318
571,501,70,743,169300,56319
3135,2689,446,692,194300,56320
0,0,0,-,-,56321
245,187,58,483,90500,56323
447,396,51,500,214100,56324
86,70,16,782,110000,56325
613,515,98,550,134800,56326
292,280,12,(X),209100,56327
53,41,12,675,104200,56328
2679,2322,357,539,166000,56329
651,583,68,857,156100,56330
672,617,55,650,180200,56331
525,491,34,909,225900,56332
2537,1979,558,689,164900,56334
93,85,8,-,96800,56335
639,581,58,573,206900,56336
702,656,46,764,172900,56338
503,382,121,506,122300,56339
885,789,96,639,167600,56340
1218,1008,210,650,169700,56342
397,346,51,567,156800,56343
6203,4662,1541,663,142000,56345
2666,2052,614,591,119900,56347
332,279,53,775,139200,56349
245,228,17,1109,126900,56350
2224,1798,426,784,153100,56352
3298,2602,696,711,141900,56353
575,524,51,619,200900,56354
189,158,31,910,160700,56355
126,103,23,771,117400,56356
397,378,19,959,191900,56357
1234,1051,183,915,150700,56358
1478,966,512,704,135100,56359
1592,1305,287,733,159100,56360
925,755,170,677,132300,56361
2396,1961,435,565,156900,56362
56,30,26,950,125000,56363
2006,1631,375,707,163200,56364
2497,2276,221,806,174400,56367
1694,1553,141,608,206100,56368
267,145,122,667,142000,56369
60,57,3,-,128100,56371
1130,951,179,656,170500,56373
2980,2371,609,728,180700,56374
339,306,33,638,159100,56375
148,139,9,125,129900,56376
6780,4932,1848,936,184200,56377
3233,2314,919,536,169100,56378
6567,4545,2022,646,155800,56379
1008,819,189,527,144300,56381
566,468,98,553,159300,56382
150,75,75,595,102000,56384
362,302,60,806,123600,56385
283,214,69,544,166300,56386
3124,1224,1900,803,142400,56387
49,47,2,-,82300,56389
12054,8354,3700,691,163700,56401
3109,2189,920,910,173800,56425
4235,3451,784,644,177300,56431
807,677,130,717,163000,56433
75,64,11,675,110700,56434
1209,1031,178,806,150900,56435
25,18,7,-,121900,56436
537,421,116,608,92900,56437
1123,984,139,519,134400,56438
559,449,110,417,95900,56440
1584,1097,487,740,122500,56441
1115,957,158,649,361700,56442
637,590,47,838,188200,56443
1359,1205,154,563,224800,56444
641,538,103,483,112500,56446
523,473,50,814,210800,56447
155,145,10,-,251700,56448
714,677,37,1045,203300,56449
463,375,88,842,156700,56450
974,792,182,633,239800,56452
338,312,26,685,117800,56453
697,510,187,706,124400,56455
14,11,3,638,137500,56456
133,104,29,725,200000,56458
1339,1174,165,800,169500,56461
1734,1354,380,569,137100,56464
865,791,74,931,249700,56465
1384,1078,306,626,146700,56466
1024,918,106,814,191800,56467
2077,1856,221,823,272000,56468
494,471,23,825,162300,56469
4644,3511,1133,536,179600,56470
3018,2486,532,659,191700,56472
1430,1188,242,918,167900,56473
1712,1340,372,648,141400,56474
658,548,110,548,128300,56475
1006,829,177,636,123800,56477
2146,1617,529,484,121600,56479
870,751,119,566,116900,56481
2765,2054,711,564,109100,56482
1554,1121,433,662,174900,56484
7213,5393,1820,732,182900,56501
916,692,224,462,84900,56510
793,684,109,603,204700,56511
1432,1228,204,622,140900,56514
1389,1164,225,669,245800,56515
110,99,11,279,87500,56516
125,106,19,883,82000,56517
122,108,14,850,136400,56518
123,97,26,750,86900,56519
1749,1187,562,407,116100,56520
311,274,37,700,131700,56521
214,190,24,944,74100,56522
215,160,55,500,103100,56523
308,280,28,750,224000,56524
53,53,0,-,102500,56525
324,293,31,388,118800,56527
714,645,69,680,197600,56528
1643,1152,491,701,157100,56529
873,675,198,515,88400,56531
119,104,15,356,119400,56533
508,442,66,746,166100,56534
522,428,94,535,162500,56535
192,172,20,367,109500,56536
7955,5500,2455,643,144600,56537
823,658,165,715,116700,56540
10,6,4,-,-,56541
1234,896,338,550,118100,56542
104,86,18,850,110700,56543
2046,1705,341,636,175100,56544
294,255,39,650,89500,56545
96,94,2,-,146400,56546
979,917,62,608,173300,56547
311,239,72,683,88900,56548
1700,1396,304,778,183100,56549
183,168,15,479,84600,56550
936,749,187,566,141000,56551
148,142,6,500,104200,56552
119,112,7,-,115500,56553
1048,921,127,594,199800,56554
425,319,106,625,101400,56556
1050,734,316,515,95400,56557
15653,10077,5576,729,161000,56560
26,26,0,-,75000,56565
188,95,93,323,53900,56566
1383,1006,377,579,129500,56567
60,48,12,-,45800,56568
556,404,152,360,113400,56569
496,456,40,881,169900,56570
743,640,103,867,212800,56571
2211,1756,455,590,167700,56572
2592,2028,564,720,182000,56573
92,83,9,-,83600,56574
281,230,51,530,144000,56575
299,261,38,719,187500,56576
7,7,0,-,-,56577
320,290,30,(X),255600,56578
456,391,65,667,112700,56579
433,420,13,650,158800,56580
115,100,15,610,54300,56581
49,43,6,-,55000,56583
609,490,119,636,80300,56584
437,353,84,694,114900,56585
795,713,82,675,190000,56586
596,513,83,627,199000,56587
249,224,25,525,169700,56588
821,626,195,632,123000,56589
157,138,19,725,86700,56590
54,48,6,300,58800,56591
189,167,22,605,83400,56592
9,6,3,-,-,56593
178,155,23,550,159100,56594
12760,8786,3974,691,160900,56601
1830,1335,495,605,115500,56621
1131,909,222,637,141800,56623
148,84,64,718,45000,56626
150,112,38,405,55000,56627
739,609,130,742,169900,56628
81,79,2,-,159200,56629
801,610,191,554,113200,56630
1617,1111,506,499,100600,56633
645,520,125,476,121800,56634
1936,1547,389,548,150400,56636
97,86,11,775,150000,56637
199,174,25,817,172700,56639
125,106,19,(X),167300,56641
346,287,59,341,99200,56644
172,138,34,525,112500,56646
342,311,31,775,142000,56647
4406,3446,960,548,103500,56649
302,247,55,334,102000,56650
230,189,41,675,122700,56651
186,173,13,744,135400,56652
565,454,111,704,99400,56653
55,40,15,938,98300,56654
758,635,123,415,252700,56655
128,122,6,-,227100,56657
0,0,0,-,-,56658
25,19,6,-,170800,56659
121,103,18,1563,83600,56660
388,331,57,538,106600,56661
288,268,20,625,234100,56662
80,80,0,-,92200,56663
263,123,140,513,59800,56666
258,236,22,(X),155600,56667
43,27,16,-,168800,56668
161,134,27,1150,141700,56669
419,249,170,530,90200,56670
933,423,510,597,65100,56671
938,776,162,543,175400,56672
302,274,28,(X),97600,56673
703,642,61,538,130000,56676
510,468,42,658,119900,56678
76,71,5,-,157500,56680
124,99,25,625,119100,56681
290,278,12,(X),187500,56683
131,111,20,392,117000,56684
52,48,4,-,142900,56685
407,392,15,-,73700,56686
23,22,1,-,95000,56687
69,64,5,-,125000,56688
5422,3929,1493,604,118900,56701
257,205,52,526,90700,56710
22,10,12,-,-,56711
398,332,66,455,85300,56713
504,424,80,513,95000,56714
152,125,27,247,96900,56715
3615,2449,1166,575,108800,56716
13,11,2,-,43000,56720
4052,2777,1275,699,166200,56721
163,135,28,726,123400,56722
381,307,74,573,164000,56723
78,68,10,-,81000,56724
400,363,37,618,101700,56725
664,523,141,558,106400,56726
321,268,53,578,112100,56727
570,482,88,517,91300,56728
60,58,2,-,43300,56729
34,28,6,625,(X),56731
465,299,166,476,75800,56732
208,194,14,610,68400,56733
221,183,38,558,56300,56734
315,264,51,500,77700,56735
481,425,56,496,200700,56736
370,310,60,429,93500,56737
561,495,66,548,107800,56738
6,6,0,-,-,56741
366,309,57,550,72100,56742
233,204,29,663,110200,56744
296,235,61,633,96900,56748
954,791,163,456,111700,56750
2242,1755,487,652,123400,56751
218,186,32,740,95000,56754
42,37,5,-,54400,56755
258,236,22,1000,110100,56756
450,366,84,467,58500,56757
189,158,31,(X),86900,56758
127,112,15,(X),89100,56759
158,123,35,807,96900,56760
190,168,22,775,106700,56761
1038,765,273,581,102000,56762
2161,1596,565,654,113200,56763
676,511,165,508,110700,57001
408,336,72,565,136100,57002
695,619,76,721,156500,57003
1310,1026,284,579,137300,57004
3952,3034,918,826,187900,57005
9356,5044,4312,661,162400,57006
217,209,8,-,196600,57010
442,334,108,535,116200,57012
1776,1299,477,557,141500,57013
581,471,110,406,87300,57014
312,286,26,825,113100,57015
282,262,20,477,170300,57016
658,444,214,535,163500,57017
563,478,85,692,134900,57018
511,462,49,1314,164800,57020
117,104,13,-,187500,57021
1749,1407,342,673,154200,57022
178,154,24,709,82500,57024
1110,867,243,764,137900,57025
496,358,138,661,113600,57026
38,35,3,-,88300,57027
1371,929,442,514,98000,57028
889,605,284,566,82300,57029
1121,943,178,617,165900,57030
286,213,73,542,96100,57031
2162,1897,265,751,186100,57032
1780,1499,281,792,190300,57033
296,231,65,415,103100,57034
526,462,64,720,163800,57035
299,256,43,800,73600,57036
370,291,79,425,118500,57037
571,540,31,617,163400,57038
1294,996,298,769,136300,57039
149,129,20,792,68300,57040
60,60,0,-,79100,57041
3554,2434,1120,498,129500,57042
591,432,159,659,85900,57043
443,364,79,424,65000,57045
248,201,47,(X),71300,57046
112,62,50,625,66700,57047
401,347,54,438,124700,57048
2598,1699,899,826,219300,57049
72,65,7,542,114100,57050
114,81,33,515,55000,57051
100,72,28,383,74400,57052
790,632,158,643,140400,57053
229,202,27,825,102500,57054
411,382,29,-,219000,57055
73,65,8,-,(X),57057
900,689,211,644,109600,57058
609,488,121,400,55800,57059
33,26,7,-,62900,57061
506,399,107,625,84800,57062
370,305,65,538,67200,57063
1855,1531,324,758,187200,57064
178,126,52,650,86000,57065
632,460,172,500,73800,57066
162,145,17,753,174600,57067
583,514,69,598,153000,57068
4509,2058,2451,681,136200,57069
659,428,231,579,89500,57070
1211,908,303,681,161300,57071
244,210,34,721,97100,57072
324,252,72,634,88000,57073
450,396,54,692,203600,57075
132,100,32,737,111000,57076
531,482,49,678,140800,57077
7551,4900,2651,580,131900,57078
13656,9528,4128,697,145400,57103
11016,4153,6863,602,104400,57104
9291,6001,3290,754,143800,57105
17596,10861,6735,761,161800,57106
3415,2630,785,772,151600,57107
7657,5491,2166,883,269700,57108
5445,3675,1770,766,200800,57110
0,0,0,-,-,57117
0,0,0,-,-,57197
10890,7235,3655,623,150500,57201
795,616,179,497,127500,57212
215,194,21,(X),151200,57213
28,27,1,-,62900,57214
460,399,61,666,105400,57216
101,92,9,-,77100,57217
157,139,18,-,125700,57218
232,185,47,575,69000,57219
273,193,80,632,102200,57220
272,217,55,434,86000,57221
524,440,84,623,117200,57223
82,69,13,558,76500,57224
824,575,249,527,73100,57225
898,716,182,415,121300,57226
189,173,16,-,108000,57227
798,642,156,343,92900,57231
144,124,20,340,(X),57232
72,49,23,-,57100,57233
529,439,90,680,96500,57234
357,310,47,693,110900,57235
20,19,1,-,21900,57236
280,219,61,423,121000,57237
235,164,71,526,145500,57238
133,118,15,-,145000,57239
325,246,79,654,112900,57241
108,97,11,-,176800,57242
309,257,52,625,90500,57243
36,36,0,-,90000,57245
63,62,1,-,65000,57246
115,96,19,-,280000,57247
411,333,78,486,133600,57248
455,336,119,448,89400,57249
61,43,18,-,115600,57251
2090,1623,467,551,113100,57252
177,138,39,525,50000,57255
42,41,1,-,53000,57256
236,156,80,510,87100,57257
84,74,10,-,54400,57258
212,168,44,488,93800,57259
373,299,74,696,104900,57260
130,113,17,308,63000,57261
1794,1022,772,510,91900,57262
226,183,43,458,83400,57263
96,65,31,707,(X),57264
95,83,12,-,106900,57265
272,209,63,425,77700,57266
207,180,27,575,81300,57268
169,138,31,518,124200,57269
316,167,149,502,57100,57270
99,62,37,721,72700,57271
71,57,14,425,62500,57272
483,357,126,456,72900,57273
1279,888,391,511,83900,57274
446,377,69,478,119800,57276
317,251,66,420,80500,57278
442,374,68,470,90800,57279
7993,4933,3060,641,135900,57301
459,392,67,638,116300,57311
212,169,43,661,69500,57312
569,433,136,432,64900,57313
361,256,105,524,65000,57314
452,377,75,450,67900,57315
256,158,98,480,48500,57317
417,322,95,446,83200,57319
172,135,37,519,96300,57321
144,120,24,-,(X),57322
111,80,31,463,33500,57323
162,130,32,375,156000,57324
1301,905,396,542,138000,57325
435,340,95,651,76500,57328
98,76,22,754,111100,57329
236,199,37,425,73800,57330
178,150,28,397,130400,57331
278,224,54,430,90000,57332
344,278,66,643,108800,57334
155,107,48,606,82000,57335
58,49,9,-,(X),57337
382,126,256,543,39700,57339
106,78,28,286,106800,57340
75,60,15,-,77300,57341
219,203,16,418,74700,57342
84,69,15,(X),88500,57344
489,399,90,559,73500,57345
18,13,5,-,(X),57346
214,163,51,717,75000,57348
648,498,150,(X),68400,57349
6399,4028,2371,548,96800,57350
309,266,43,348,98300,57353
444,341,103,611,77200,57355
553,371,182,480,53000,57356
24,24,0,-,107500,57358
300,225,75,525,105900,57359
51,5,46,369,-,57361
1018,630,388,469,90300,57362
426,333,93,681,87400,57363
17,12,5,-,-,57364
276,234,42,540,110400,57365
961,710,251,583,88000,57366
85,55,30,610,156300,57367
462,350,112,641,85500,57368
975,741,234,526,99600,57369
295,236,59,609,81900,57370
61,41,20,-,(X),57371
186,176,10,775,122900,57373
103,94,9,344,60000,57374
339,287,52,575,51000,57375
458,383,75,469,45100,57376
23,23,0,-,72500,57379
1214,773,441,516,80800,57380
256,188,68,540,102600,57381
622,457,165,546,75000,57382
313,243,70,621,55500,57383
391,282,109,703,106300,57384
522,393,129,482,80900,57385
81,71,10,708,102500,57386
13371,8728,4643,608,144200,57401
42,39,3,-,(X),57420
42,25,17,-,56900,57421
141,86,55,813,83300,57422
120,112,8,-,(X),57424
29,29,0,-,110600,57426
307,275,32,-,136400,57427
294,240,54,408,53000,57428
49,35,14,(X),41300,57429
881,672,209,467,100900,57430
159,147,12,-,100800,57432
146,113,33,809,137500,57433
231,184,47,(X),104700,57434
118,100,18,525,67100,57435
186,163,23,400,58200,57436
579,460,119,518,56800,57437
581,417,164,510,78600,57438
30,30,0,-,-,57439
164,102,62,400,56400,57440
291,263,28,529,87200,57441
782,591,191,520,78900,57442
862,711,151,697,147300,57445
166,132,34,-,55800,57446
154,113,41,478,32900,57448
73,68,5,-,221600,57449
287,259,28,518,76100,57450
853,724,129,616,167100,57451
124,110,14,763,50000,57452
224,183,41,469,65500,57454
32,27,5,-,87500,57455
408,259,149,(X),56500,57456
41,41,0,-,116300,57457
155,122,33,-,119000,57460
154,151,3,-,89200,57461
138,126,12,550,165400,57465
84,57,27,-,80600,57466
135,119,16,431,44500,57467
100,82,18,938,60000,57468
1417,935,482,526,76900,57469
43,29,14,784,54500,57470
285,231,54,383,62100,57471
435,332,103,670,64900,57472
68,65,3,-,104200,57473
64,62,2,-,103600,57474
56,51,5,-,102500,57475
178,139,39,600,62300,57476
47,34,13,-,95000,57477
253,210,43,629,167100,57479
120,100,20,-,104200,57481
6857,4498,2359,581,169900,57501
84,52,32,-,53300,57520
93,83,10,-,59400,57521
176,147,29,603,84800,57522
504,341,163,469,68900,57523
336,266,70,558,72000,57528
170,125,45,-,49400,57529
96,88,8,-,56700,57531
1198,962,236,671,132000,57532
934,658,276,479,55800,57533
123,78,45,482,59500,57534
185,125,60,504,61900,57536
55,49,6,-,22700,57537
105,92,13,605,73800,57538
36,34,2,-,158300,57540
66,23,43,543,(X),57541
386,303,83,269,63800,57543
222,168,54,625,68400,57544
64,53,11,-,127500,57547
345,130,215,438,48600,57548
763,500,263,552,58900,57551
207,165,42,725,58100,57552
83,53,30,-,66300,57553
1191,550,641,444,31400,57555
313,189,124,394,59600,57559
100,58,42,367,(X),57560
7,5,2,-,-,57562
103,69,34,-,(X),57563
423,291,132,524,103100,57564
304,130,174,495,66700,57566
596,484,112,611,81400,57567
271,223,48,813,63700,57568
153,137,16,625,81700,57569
562,220,342,422,39500,57570
9,5,4,-,-,57571
450,193,257,418,43500,57572
54,54,0,-,73300,57574
54,44,10,-,58600,57576
318,74,244,514,28300,57577
462,290,172,505,51900,57579
1957,1255,702,585,73200,57580
36,27,9,-,33800,57584
98,76,22,400,31700,57585
1701,996,705,531,77600,57601
211,154,57,530,57100,57620
66,5,61,415,"10,000-",57621
78,20,58,408,(X),57622
313,214,99,606,64500,57623
1268,649,619,492,63600,57625
388,291,97,558,80400,57626
19,19,0,-,118800,57630
141,120,21,523,112500,57631
286,228,58,827,55800,57632
152,109,43,533,78300,57633
37,33,4,-,190600,57634
41,17,24,-,(X),57636
892,638,254,490,67400,57638
91,31,60,385,51300,57639
57,42,15,-,(X),57640
131,93,38,538,28800,57641
599,260,339,413,53800,57642
112,74,38,425,76700,57644
82,66,16,563,62500,57645
115,110,5,-,58800,57646
159,118,41,460,71300,57648
92,73,19,289,(X),57649
10,10,0,-,(X),57650
52,23,29,-,120800,57651
110,77,33,469,(X),57652
244,174,70,405,57500,57656
72,65,7,-,102900,57657
97,47,50,350,19400,57658
40,37,3,-,120800,57660
25,13,12,675,(X),57661
17596,9881,7715,717,133800,57701
14192,10540,3652,866,215800,57702
5470,4545,925,1010,146200,57703
941,4,937,994,-,57706
191,48,143,517,"10,000-",57714
129,78,51,452,(X),57716
3124,2225,899,656,125500,57717
2678,2377,301,754,152900,57718
2590,1713,877,858,137000,57719
282,192,90,483,90800,57720
168,146,22,-,100000,57722
75,67,8,(X),71700,57724
93,64,29,-,225000,57725
2569,1996,573,805,214100,57730
1017,676,341,581,163900,57732
690,574,116,751,58100,57735
31,28,3,-,76700,57738
18,0,18,-,-,57741
795,646,149,1145,191300,57744
966,788,178,609,214600,57745
2421,1699,722,592,143500,57747
119,67,52,542,152500,57748
134,91,43,425,(X),57750
286,222,64,556,189100,57751
457,283,174,500,17900,57752
1713,1276,437,550,104300,57754
40,37,3,-,137500,57755
173,68,105,297,34200,57756
41,41,0,-,(X),57758
69,69,0,-,(X),57759
563,459,104,375,90900,57760
415,341,74,418,130300,57761
302,267,35,605,85000,57762
129,98,31,600,78000,57763
363,243,120,419,21900,57764
155,100,55,414,(X),57766
63,63,0,-,167500,57767
1478,1398,80,1033,194900,57769
1230,560,670,438,20600,57770
402,211,191,431,17800,57772
152,121,31,536,246900,57773
94,85,9,-,100900,57775
0,0,0,-,-,57776
80,56,24,-,82500,57779
48,41,7,-,(X),57780
28,25,3,-,(X),57782
6450,3908,2542,644,198000,57783
4275,2781,1494,542,165400,57785
163,137,26,531,98200,57787
169,116,53,-,266300,57788
444,319,125,546,96500,57790
80,70,10,-,81900,57791
34,34,0,-,196400,57792
943,803,140,625,221300,57793
157,80,77,463,"10,000-",57794
6,0,6,-,-,57799
23,21,2,-,187500,58001
18,18,0,-,55700,58002
94,91,3,-,170300,58004
257,251,6,-,202300,58005
219,153,66,525,119600,58006
47,35,12,-,83600,58007
99,90,9,-,128100,58008
5,5,0,-,-,58009
157,130,27,455,109500,58011
959,738,221,641,160300,58012
57,50,7,-,26700,58013
107,105,2,-,135800,58015
54,52,2,-,105000,58016
140,114,26,456,49100,58017
130,121,9,-,193800,58018
177,132,45,666,157600,58021
663,456,207,593,90600,58027
76,61,15,-,65900,58029
248,195,53,450,79000,58030
212,188,24,-,151800,58031
333,220,113,557,99300,58032
158,122,36,675,85900,58033
114,98,16,(X),50800,58035
118,118,0,-,175000,58036
137,122,15,665,141700,58038
427,285,142,655,89800,58040
675,554,121,511,84100,58041
608,575,33,1370,216300,58042
68,61,7,-,39200,58043
972,673,299,539,129500,58045
323,253,70,588,86400,58046
1328,1141,187,774,257600,58047
200,164,36,606,83800,58048
180,160,20,-,140000,58049
573,492,81,541,200000,58051
242,202,40,573,155000,58052
566,426,140,449,59000,58053
1319,879,440,566,107500,58054
101,93,8,-,72500,58056
44,40,4,-,63300,58057
50,46,4,-,45000,58058
386,309,77,833,153900,58059
513,400,113,650,93700,58060
142,134,8,-,100000,58061
74,51,23,-,119600,58062
123,99,24,709,101400,58063
197,160,37,564,88700,58064
25,23,2,-,32100,58065
118,97,21,247,67500,58067
169,126,43,975,137500,58068
59,53,6,-,81300,58069
200,171,29,398,109100,58071
3714,2351,1363,579,105400,58072
3827,2362,1465,521,106500,58075
0,0,0,-,-,58076
259,235,24,839,158200,58077
12052,8129,3923,751,174800,58078
207,196,11,-,154700,58079
371,314,57,638,94700,58081
13668,6752,6916,609,154900,58102
23357,8375,14982,689,146300,58103
13552,7392,6160,847,230200,58104
0,0,0,-,-,58105
16502,8468,8034,761,176500,58201
0,0,0,-,-,58202
7620,2825,4795,761,139700,58203
674,9,665,1147,-,58204
0,0,0,-,-,58205
194,154,40,588,54100,58210
268,232,36,485,80600,58212
150,119,31,742,134800,58214
47,47,0,-,39800,58216
289,242,47,788,127300,58218
22,22,0,-,164300,58219
1044,787,257,527,100100,58220
141,132,9,342,68400,58222
124,121,3,-,110200,58223
66,24,42,-,94600,58224
441,315,126,483,84500,58225
238,189,49,579,68300,58227
357,248,109,669,112900,58228
49,31,18,725,65000,58229
306,227,79,480,39900,58230
208,168,40,-,48900,58231
106,92,14,-,79400,58233
192,139,53,393,88500,58235
2385,1616,769,486,76800,58237
89,78,11,-,(X),58238
22,22,0,-,110000,58239
466,363,103,485,100200,58240
61,55,6,-,74100,58241
269,231,38,788,75200,58243
79,60,19,-,93300,58244
1124,934,190,484,91900,58249
137,119,18,625,61500,58250
873,614,259,550,106800,58251
266,216,50,396,56900,58254
345,280,65,784,148200,58256
814,506,308,594,95400,58257
120,111,9,(X),136000,58258
190,154,36,392,72000,58259
88,87,1,-,85000,58260
434,373,61,642,90300,58261
40,29,11,-,31800,58262
230,204,26,900,88900,58265
106,95,11,525,68800,58266
565,416,149,541,112400,58267
64,54,10,-,55000,58269
847,602,245,538,81300,58270
328,261,67,500,82600,58271
122,101,21,472,86600,58272
143,117,26,509,87500,58273
404,318,86,531,126600,58274
284,233,51,717,98100,58275
233,174,59,637,65500,58276
144,100,44,346,86700,58277
656,629,27,613,176700,58278
48,48,0,-,(X),58281
694,556,138,481,64400,58282
4354,2654,1700,524,109900,58301
20,20,0,-,26000,58311
2088,1305,783,333,67800,58316
120,114,6,475,49000,58317
1753,1294,459,606,151300,58318
87,61,26,686,61000,58321
8,8,0,-,(X),58323
584,419,165,455,79600,58324
40,25,15,-,109400,58325
152,121,31,-,76800,58327
1060,723,337,336,64000,58329
142,104,38,506,50000,58330
57,53,4,-,(X),58331
157,143,14,469,64300,58332
402,108,294,356,23800,58335
49,44,5,-,(X),58338
19,15,4,-,118800,58339
1258,929,329,426,76300,58341
40,31,9,-,(X),58343
411,304,107,540,98100,58344
71,54,17,-,43600,58345
301,227,74,415,81800,58346
317,239,78,480,74500,58348
205,123,82,423,63600,58351
204,179,25,425,79700,58352
37,28,9,-,53300,58353
32,32,0,-,102800,58355
806,585,221,452,71700,58356
125,90,35,432,46900,58357
101,94,7,-,50000,58361
24,24,0,-,-,58362
27,25,2,-,59000,58363
142,103,39,(X),35900,58365
426,318,108,457,82700,58366
640,413,227,533,77600,58367
1811,1299,512,581,101100,58368
503,427,76,481,64100,58369
378,239,139,439,50600,58370
51,46,5,-,45000,58372
256,187,69,390,64600,58374
129,102,27,1056,60000,58377
99,47,52,425,(X),58379
212,168,44,425,44300,58380
106,94,12,550,77100,58381
78,76,2,-,85000,58382
247,208,39,375,64500,58384
87,70,17,850,74400,58385
80,80,0,-,62000,58386
7736,4922,2814,620,118500,58401
0,0,0,-,-,58402
0,0,0,-,-,58405
531,458,73,628,59000,58413
63,60,3,-,136100,58415
193,148,45,320,59100,58416
150,142,8,-,55200,58418
123,123,0,-,108700,58420
1246,903,343,514,109000,58421
89,73,16,-,72800,58422
39,37,2,-,(X),58423
113,99,14,-,84000,58424
589,408,181,425,86400,58425
73,65,8,-,67200,58426
128,112,16,-,95000,58428
180,137,43,319,79800,58429
42,39,3,-,(X),58430
50,48,2,-,63300,58431
471,377,94,523,89200,58433
804,577,227,416,76700,58436
297,257,40,483,69800,58438
61,51,10,(X),103100,58439
72,62,10,-,53100,58440
139,89,50,444,53700,58441
243,206,37,(X),57400,58442
92,73,19,606,60500,58443
121,102,19,530,40000,58444
45,37,8,-,59300,58445
143,99,44,355,44500,58448
85,71,14,470,93800,58451
12,12,0,-,-,58452
218,158,60,425,50000,58454
168,138,30,325,64000,58455
216,173,43,554,68800,58456
531,384,147,630,87400,58458
101,86,15,440,48300,58460
188,154,34,(X),72000,58461
292,215,77,281,52500,58463
107,92,15,-,44200,58464
167,134,33,700,101100,58466
229,189,40,613,66500,58467
163,142,21,725,107400,58472
1121,811,310,605,103700,58474
78,74,4,-,(X),58475
149,116,33,534,67600,58476
99,77,22,377,63800,58477
72,54,18,430,(X),58478
74,57,17,-,56400,58479
112,87,25,790,65000,58480
101,92,9,-,155800,58481
458,337,121,509,106500,58482
119,98,21,355,62000,58483
25,25,0,-,114600,58484
87,69,18,430,150500,58486
193,163,30,330,63500,58487
111,103,8,233,64400,58488
125,99,26,692,81000,58490
177,159,18,-,73700,58492
139,107,32,(X),69500,58494
595,469,126,504,70100,58495
89,81,8,658,112500,58496
130,103,27,1058,85000,58497
13250,7797,5453,732,179600,58501
11835,8979,2856,834,251400,58503
10543,7896,2647,737,173700,58504
0,0,0,-,-,58505
159,129,30,635,134800,58520
279,234,45,788,228700,58521
1497,1202,295,598,152800,58523
34,28,6,-,58000,58524
187,56,131,474,91400,58528
282,218,64,550,55500,58529
515,402,113,548,113700,58530
180,168,12,-,202000,58531
113,84,29,872,100000,58532
456,370,86,438,77600,58533
280,251,29,488,78600,58535
650,212,438,472,74000,58538
1099,770,329,627,122200,58540
216,182,34,396,76700,58541
110,106,4,-,63800,58542
275,219,56,443,100700,58544
1530,1302,228,733,137400,58545
69,57,12,-,155700,58549
848,642,206,419,87000,58552
10373,7721,2652,771,173400,58554
366,343,23,685,188800,58558
100,100,0,-,178900,58559
99,86,13,425,110700,58560
475,392,83,641,75000,58561
209,181,28,360,77500,58562
778,612,166,637,121500,58563
53,48,5,-,66300,58564
122,109,13,-,149300,58565
52,52,0,-,(X),58566
170,112,58,431,44600,58568
42,36,6,-,99000,58569
144,120,24,810,131300,58570
269,233,36,678,109800,58571
139,127,12,-,170800,58572
299,270,29,400,59000,58573
418,328,90,669,101500,58575
383,314,69,606,125900,58576
855,667,188,660,159000,58577
529,422,107,443,144300,58579
181,163,18,1014,95300,58580
117,90,27,(X),54000,58581
9884,6589,3295,853,215500,58601
58,48,10,-,(X),58620
603,414,189,563,107300,58621
709,551,158,957,143900,58622
1016,762,254,593,154900,58623
135,97,38,-,84100,58625
156,142,14,840,113000,58626
81,77,4,-,83000,58627
199,177,22,1321,119600,58630
449,363,86,523,105300,58631
93,51,42,380,106300,58632
81,67,14,-,255000,58634
334,253,81,675,88800,58636
442,379,63,600,85000,58638
818,586,232,470,150700,58639
574,447,127,653,153400,58640
44,44,0,-,241700,58641
129,122,7,-,123200,58642
91,82,9,-,34600,58643
142,73,69,838,193800,58645
509,410,99,(X),85900,58646
476,410,66,583,139600,58647
185,133,52,858,70400,58649
186,154,32,577,87800,58650
227,165,62,475,111300,58651
505,399,106,1029,127200,58652
264,203,61,521,86800,58653
109,77,32,(X),104200,58654
194,177,17,-,201400,58655
192,161,31,678,143800,58656
13575,8368,5207,839,190900,58701
0,0,0,-,-,58702
8003,5219,2784,965,196200,58703
1634,40,1594,1412,276500,58704
0,0,0,-,-,58705
0,0,0,-,-,58707
270,241,29,607,86400,58710
94,75,19,-,151800,58711
74,52,22,-,113900,58712
14,13,1,-,(X),58713
53,49,4,-,103900,58716
348,297,51,1063,166000,58718
273,178,95,569,108800,58721
552,443,109,1021,196300,58722
104,92,12,(X),121400,58723
106,84,22,(X),119600,58725
128,80,48,900,103600,58727
647,545,102,475,96100,58730
126,101,25,-,136500,58731
136,132,4,-,150000,58733
135,128,7,-,93100,58734
122,121,1,-,158000,58735
261,223,38,650,53400,58736
83,68,15,475,59200,58737
344,246,98,950,163900,58740
261,219,42,673,150700,58741
52,47,5,-,61700,58744
567,444,123,702,116400,58746
62,57,5,(X),(X),58748
285,211,74,823,123500,58750
79,53,26,448,114400,58752
55,26,29,-,50000,58755
87,66,21,509,133300,58756
267,114,153,464,62900,58757
130,129,1,-,76700,58758
352,265,87,433,119300,58759
117,83,34,1167,115600,58760
393,298,95,579,92700,58761
100,73,27,608,73800,58762
1301,704,597,482,119700,58763
157,114,43,1094,87100,58765
103,96,7,-,162500,58768
88,73,15,615,55700,58769
478,299,179,638,98900,58770
266,167,99,1253,122800,58771
64,50,14,438,66000,58772
357,236,121,722,128900,58773
140,34,106,295,151900,58775
70,43,27,1278,(X),58776
88,87,1,-,171600,58778
264,181,83,585,111400,58779
250,221,29,775,162900,58781
160,143,17,425,67000,58782
173,138,35,625,93900,58783
1093,838,255,702,176400,58784
451,402,49,1065,195700,58785
92,75,17,-,110500,58787
593,495,98,371,81600,58788
141,107,34,828,53000,58789
684,470,214,611,173600,58790
145,134,11,-,157300,58792
270,184,86,537,79300,58793
61,46,15,(X),(X),58794
80,58,22,770,66300,58795
10461,6532,3929,918,209400,58801
115,114,1,-,95000,58830
215,186,29,1563,190300,58831
40,37,3,-,103800,58833
120,107,13,-,150500,58835
74,60,14,-,212500,58838
184,157,27,-,227500,58843
88,59,29,-,135900,58844
146,111,35,494,111200,58845
133,109,24,-,277500,58847
362,294,68,948,171000,58849
714,519,195,886,174400,58852
113,48,65,481,125000,58853
1892,1118,774,946,203600,58854
74,52,22,-,168800,58856
671,520,151,750,180100,59001
90,63,27,1025,113800,59002
399,173,226,470,79700,59003
336,257,79,493,62500,59006
68,54,14,560,168200,59007
166,124,42,821,112500,59008
53,42,11,-,157500,59010
1199,854,345,658,183300,59011
78,38,40,963,(X),59012
79,79,0,-,(X),59013
663,473,190,656,171900,59014
167,139,28,680,152700,59015
243,145,98,793,59800,59016
236,195,41,880,240200,59018
1632,1359,273,610,205200,59019
26,25,1,-,265900,59020
440,244,196,550,83100,59022
220,156,64,(X),121400,59024
10,2,8,-,-,59025
85,71,14,-,134800,59026
334,234,100,1028,244800,59027
216,152,64,647,287500,59028
296,239,57,647,99400,59029
618,410,208,597,279600,59030
63,55,8,-,66100,59031
132,108,24,681,95000,59032
113,104,9,-,233300,59033
1714,1029,685,686,97000,59034
59,41,18,-,(X),59035
578,394,184,551,81400,59036
719,610,109,923,185800,59037
295,190,105,559,87800,59038
13,10,3,-,(X),59039
812,657,155,729,173100,59041
787,425,362,501,59800,59043
4281,3353,928,667,180200,59044
173,116,57,750,88000,59046
5120,3773,1347,658,205800,59047
411,298,113,586,65000,59050
82,47,35,538,243800,59052
146,67,79,(X),302500,59053
144,123,21,384,77900,59054
23,12,11,-,"2,000,000+",59055
272,258,14,463,285400,59057
26,16,10,-,250000,59058
76,44,32,521,67500,59059
95,79,16,675,403100,59061
24,19,5,-,-,59062
743,614,129,592,191800,59063
59,32,27,-,(X),59064
49,45,4,-,1113100,59065
174,107,67,375,68500,59066
110,76,34,606,221400,59067
1667,1191,476,851,248400,59068
236,171,65,776,174400,59069
426,328,98,788,256700,59070
65,48,17,-,388900,59071
1753,1277,476,534,148300,59072
156,122,34,615,102100,59074
64,25,39,-,(X),59075
44,25,19,-,(X),59076
29,20,9,-,257100,59077
56,46,10,-,125000,59078
1306,1196,110,775,193500,59079
5,5,0,-,(X),59081
12,7,5,-,206300,59082
82,48,34,-,112500,59085
353,281,72,767,154200,59086
159,130,29,675,74300,59087
512,400,112,763,172500,59088
107,64,43,475,64500,59089
16095,9105,6990,674,156600,59101
20807,13788,7019,857,190700,59102
11575,8358,3217,789,203700,59105
5314,4491,823,1043,316400,59106
1450,927,523,462,99900,59201
69,56,13,-,139600,59211
165,131,34,594,119800,59212
177,109,68,261,88300,59213
34,30,4,-,80000,59214
474,367,107,553,117700,59215
81,37,44,-,(X),59217
340,251,89,675,158200,59218
83,71,12,-,114800,59219
660,448,212,570,170500,59221
66,53,13,(X),69300,59222
155,146,9,-,193800,59223
152,77,75,369,72300,59225
175,138,37,(X),96700,59226
2004,1309,695,502,150900,59230
271,149,122,678,30200,59231
11,9,2,-,212500,59240
199,163,36,561,88800,59241
34,15,19,-,(X),59242
99,64,35,980,165000,59243
13,8,5,-,90000,59244
171,138,33,608,118300,59247
295,238,57,525,100000,59248
83,64,19,450,62900,59250
56,54,2,-,112500,59252
45,43,2,-,154700,59253
987,767,220,654,163500,59254
992,438,554,297,81100,59255
40,25,15,-,316700,59256
21,4,17,-,-,59257
46,38,8,-,137500,59258
158,120,38,444,77000,59259
63,51,12,-,161800,59260
227,179,48,414,87500,59261
263,175,88,600,152700,59262
739,558,181,645,114000,59263
3437,2192,1245,831,202200,59270
117,103,14,-,107100,59274
147,89,58,475,54600,59275
9,9,0,-,-,59276
4723,3254,1469,613,135800,59301
76,66,10,-,30000,59311
7,5,2,-,(X),59312
1016,706,310,607,150000,59313
38,29,9,-,65000,59314
54,48,6,-,88300,59315
520,355,165,558,107000,59317
46,31,15,-,(X),59318
14,9,5,-,168800,59322
834,758,76,676,135500,59323
351,309,42,458,89400,59324
106,99,7,-,(X),59326
1225,865,360,551,169500,59327
3672,2522,1150,557,159700,59330
68,45,23,-,153100,59332
8,8,0,-,(X),59333
72,46,26,575,175000,59336
310,240,70,488,115200,59337
52,45,7,-,181300,59338
64,43,21,-,134400,59339
60,41,19,-,306300,59343
167,131,36,475,85000,59344
145,99,46,688,101300,59347
457,419,38,609,78600,59349
66,58,8,-,105600,59351
448,315,133,665,106100,59353
14,8,6,-,(X),59354
6418,3234,3184,570,142000,59401
10390,8312,2078,692,173700,59404
13125,6992,6133,650,159800,59405
297,177,120,550,173900,59410
158,83,75,278,140800,59411
655,545,110,727,128600,59412
554,299,255,506,86500,59414
233,180,53,525,125000,59416
2362,1339,1023,452,72600,59417
60,33,27,-,343800,59418
46,26,20,467,137500,59419
97,85,12,-,285000,59420
783,599,184,659,213000,59421
1014,674,340,531,144500,59422
32,28,4,-,85000,59424
1398,956,442,582,119100,59425
1475,905,570,589,129800,59427
177,131,46,606,95000,59430
51,41,10,-,75000,59432
247,217,30,595,99700,59433
227,140,87,505,109700,59434
715,547,168,613,154500,59436
76,24,52,-,187500,59440
43,29,14,-,(X),59441
754,478,276,560,130400,59442
225,191,34,-,193400,59443
103,35,68,-,87900,59444
233,162,71,372,84300,59446
110,77,33,490,163800,59447
188,92,96,392,54600,59448
213,149,64,625,166400,59450
104,84,20,-,103300,59451
238,191,47,656,137500,59452
147,127,20,-,118800,59453
108,85,23,870,80800,59454
144,33,111,-,(X),59456
3932,2713,1219,696,126900,59457
86,76,10,-,76700,59460
9,9,0,-,-,59461
63,60,3,-,115600,59462
56,52,4,-,329000,59463
161,128,33,563,119400,59464
24,18,6,-,95000,59465
35,28,7,-,54400,59466
26,25,1,-,187500,59467
235,206,29,1083,168900,59468
73,66,7,-,(X),59469
147,99,48,520,169300,59471
331,227,104,819,100500,59472
1402,858,544,538,135500,59474
166,105,61,480,117300,59477
369,260,109,501,108600,59479
170,142,28,854,154900,59480
234,153,81,833,88300,59482
163,151,12,-,174500,59483
51,29,22,694,152500,59484
208,206,2,-,199400,59485
430,340,90,600,110300,59486
557,450,107,553,153600,59487
130,105,25,500,107100,59489
4973,3377,1596,569,139500,59501
491,344,147,444,110700,59520
1023,468,555,294,65400,59521
613,408,205,520,110800,59522
951,711,240,523,110700,59523
245,157,88,558,67900,59524
90,64,26,-,87500,59525
709,367,342,505,68000,59526
317,154,163,375,53800,59527
85,73,12,-,60700,59528
61,38,23,-,95000,59529
53,46,7,-,53300,59530
160,124,36,-,82000,59531
71,71,0,-,126000,59532
29,16,13,-,(X),59535
4,3,1,-,-,59537
1316,944,372,491,134500,59538
139,110,29,717,68600,59540
62,44,18,275,80000,59542
88,60,28,375,159000,59544
15,5,10,-,-,59545
39,31,8,-,(X),59546
13,12,1,-,(X),59547
13268,7514,5754,740,206600,59601
9603,8113,1490,923,223400,59602
105,78,27,521,112500,59631
747,563,184,656,146500,59632
103,100,3,-,280000,59633
1796,1630,166,1038,317300,59634
2778,2056,722,775,178000,59635
0,0,0,-,-,59636
245,193,52,724,301100,59638
522,452,70,575,164100,59639
57,57,0,-,213500,59640
18,12,6,-,(X),59642
252,184,68,542,159200,59643
1810,1372,438,661,164100,59644
641,474,167,626,133000,59645
84,74,10,-,428600,59647
231,172,59,694,237900,59648
14640,9352,5288,600,125700,59701
11,8,3,-,466700,59703
131,92,39,508,257100,59710
3925,2823,1102,503,133200,59711
95,57,38,1025,182300,59713
7322,5177,2145,858,225000,59714
13319,7095,6224,794,347200,59715
859,514,345,1055,407700,59716
12284,7487,4797,1018,262300,59718
137,134,3,-,583300,59720
187,162,25,775,253800,59721
1849,1265,584,513,108600,59722
49,23,26,-,(X),59724
3447,2181,1266,601,169400,59725
130,109,21,888,214100,59727
181,148,33,619,195800,59728
949,689,260,788,313000,59729
856,599,257,866,432200,59730
60,54,6,475,117900,59731
51,28,23,850,188600,59732
82,59,23,557,210700,59733
128,101,27,-,161600,59735
61,29,32,561,267900,59736
148,132,16,705,105900,59739
111,85,26,-,291300,59740
1673,1361,312,843,243800,59741
71,39,32,-,(X),59743
56,32,24,-,187500,59745
43,39,4,-,275000,59746
98,85,13,-,207600,59747
103,79,24,-,134700,59748
673,535,138,683,224400,59749
159,143,16,-,259600,59750
97,66,31,588,137500,59751
1403,1109,294,765,222300,59752
386,283,103,720,185200,59754
105,81,24,600,163500,59755
0,0,0,-,-,59756
888,446,442,641,248700,59758
1600,1321,279,676,185700,59759
108,64,44,636,226900,59760
142,65,77,475,178100,59761
115,101,14,-,267500,59762
13634,5478,8156,745,225500,59801
8982,4320,4662,729,235500,59802
6435,4767,1668,782,268700,59803
3125,1987,1138,864,293400,59804
7819,5240,2579,841,211100,59808
532,399,133,893,199500,59820
890,692,198,546,222300,59821
647,493,154,974,256900,59823
608,442,166,527,200000,59824
949,714,235,811,225600,59825
281,243,38,538,286100,59826
114,81,33,612,246900,59827
2079,1509,570,601,254400,59828
984,710,274,534,247200,59829
11,0,11,-,-,59830
190,132,58,467,87500,59831
394,278,116,438,164300,59832
1963,1649,314,1007,291100,59833
684,502,182,733,306000,59834
163,134,29,450,222000,59837
6009,3622,2387,712,205800,59840
183,109,74,543,130200,59841
23,23,0,-,178800,59842
88,53,35,708,168800,59843
278,224,54,561,192600,59844
572,362,210,472,107900,59845
485,456,29,-,265200,59846
2099,1814,285,682,226000,59847
54,41,13,(X),181300,59848
71,51,20,-,132500,59851
361,280,81,707,169600,59853
112,78,34,633,255000,59854
422,120,302,592,56700,59855
134,109,25,532,122500,59856
620,445,175,617,214800,59858
1339,1064,275,586,204800,59859
4489,3098,1391,633,226500,59860
52,21,31,-,97500,59863
2490,1637,853,643,182200,59864
1284,951,333,610,175800,59865
342,292,50,733,147400,59866
12,12,0,-,-,59867
742,585,157,678,212700,59868
4125,3192,933,716,245400,59870
92,43,49,-,168000,59871
876,604,272,404,217400,59872
1586,1102,484,770,193300,59873
541,424,117,634,235500,59874
1486,992,494,716,257000,59875
19690,13496,6194,798,213600,59901
209,194,15,-,238100,59910
3371,2710,661,890,313500,59911
5473,4138,1335,786,201100,59912
269,150,119,760,166300,59913
101,70,31,936,450000,59914
198,122,76,661,(X),59915
50,38,12,-,200000,59916
1744,1477,267,788,163300,59917
320,275,45,960,120700,59918
336,238,98,1052,55600,59919
709,599,110,607,254800,59920
1204,818,386,967,318100,59922
4293,3162,1131,571,152300,59923
519,384,135,900,260200,59925
136,53,83,763,240600,59926
129,109,20,779,239300,59927
93,93,0,-,(X),59928
97,69,28,-,239700,59929
353,278,75,826,285200,59930
157,117,40,775,444700,59931
554,501,53,1272,239500,59932
27,25,2,-,219400,59933
231,208,23,556,193800,59934
1677,1364,313,550,178500,59935
188,125,63,638,269300,59936
5572,3835,1737,677,295000,59937
9161,7087,2074,908,199300,60002
19494,15473,4021,1179,327300,60004
12535,8345,4190,1089,294900,60005
13553,10046,3507,1087,258000,60007
8444,5924,2520,1165,213600,60008
16035,14372,1663,1479,518200,60010
3881,3530,351,2057,299900,60012
9081,8078,1003,1209,220300,60013
17140,13479,3661,1128,211300,60014
9485,8260,1225,1582,493100,60015
23394,15708,7686,1042,210800,60016
9947,7095,2852,919,224000,60018
4210,3068,1142,860,137700,60020
1924,1640,284,919,260200,60021
2878,2673,205,1205,874800,60022
14551,11865,2686,1193,406100,60025
5322,3623,1699,1601,569900,60026
137,135,2,-,799300,60029
13949,10598,3351,1026,203300,60030
13787,10206,3581,1163,240500,60031
4297,2738,1559,978,139400,60033
708,536,172,881,168000,60034
11382,9293,2089,1574,532500,60035
1994,874,1120,1162,333600,60040
3704,2978,726,990,166800,60041
3238,2694,544,1276,152300,60042
822,753,69,"3,500+",1135600,60043
3748,2717,1031,1317,466000,60044
7120,6218,902,1708,824100,60045
12081,10272,1809,1151,209100,60046
13866,12823,1043,1242,408400,60047
10453,8734,1719,1225,420000,60048
12048,8690,3358,1048,170200,60050
8967,7246,1721,1160,190000,60051
8216,7668,548,1533,286700,60053
20644,14423,6221,978,288900,60056
12890,9964,2926,1130,233800,60060
9735,6877,2858,1308,322100,60061
15226,12449,2777,1621,496100,60062
4837,2203,2634,840,107700,60064
15156,11487,3669,1159,343200,60067
14085,11583,2502,1203,392600,60068
3513,2846,667,2279,440300,60069
5983,4247,1736,976,250800,60070
1583,1014,569,852,206000,60071
287,230,57,1027,280400,60072
18151,14199,3952,1153,138900,60073
14111,8636,5475,1056,217500,60074
10924,8693,2231,1173,285500,60076
10264,6508,3756,1083,246900,60077
3354,2958,396,1394,268400,60081
3675,3056,619,1666,238500,60083
5941,4501,1440,982,214800,60084
22498,9724,12774,845,101600,60085
9317,5947,3370,983,130400,60087
1088,0,1088,1443,-,60088
16096,12737,3359,1354,294600,60089
14132,8820,5312,1104,172200,60090
9504,8183,1321,1701,628300,60091
6665,6048,617,1478,876600,60093
2485,1863,622,1113,189700,60096
4014,3249,765,1109,137800,60097
12067,8165,3902,949,188200,60098
10541,6529,4012,943,136100,60099
13061,8790,4271,924,227900,60101
11317,9966,1351,1378,240300,60102
14041,12716,1325,1272,256900,60103
6063,4403,1660,1025,118800,60104
6870,3747,3123,972,213800,60106
13343,11299,2044,1509,173100,60107
9214,6610,2604,1212,274400,60108
204,142,62,1076,178300,60109
11172,7923,3249,968,151000,60110
130,120,10,-,254400,60111
1438,1181,257,1011,144100,60112
145,75,70,879,131500,60113
15861,6689,9172,819,158100,60115
6161,4562,1599,1160,245500,60118
3482,3045,437,1245,266700,60119
15114,10131,4983,963,154900,60120
15917,9727,6190,957,160300,60123
7003,6181,822,1978,278100,60124
16505,13297,3208,1425,369400,60126
55,45,10,683,150800,60129
7207,3755,3452,958,220900,60130
6323,4618,1705,833,170600,60131
11272,8619,2653,1108,174700,60133
10293,8507,1786,1307,323800,60134
2604,1728,876,955,183000,60135
2213,2057,156,1204,249300,60136
14147,11218,2929,966,361900,60137
11513,7698,3815,1063,167900,60139
5088,4428,660,1626,199300,60140
0,0,0,-,-,60141
11044,10470,574,1214,229800,60142
3952,2815,1137,1192,288700,60143
32,17,15,832,212500,60144
873,686,187,966,202800,60145
923,728,195,754,152400,60146
20613,15337,5276,1184,239500,60148
621,527,94,675,139300,60150
1579,1253,326,1225,223500,60151
4577,3606,971,928,224200,60152
7410,4366,3044,894,133700,60153
6635,5967,668,1237,216100,60154
3188,2098,1090,874,148200,60155
9924,8623,1301,1372,201900,60156
744,735,9,-,337600,60157
7738,3898,3840,866,170700,60160
2957,1952,1005,983,157400,60162
1773,1452,321,981,161900,60163
6422,4736,1686,841,162000,60164
1305,709,596,1021,126400,60165
11981,7767,4214,1088,207100,60169
4097,2351,1746,875,186500,60171
8994,7080,1914,1171,237500,60172
5832,1760,4072,1243,326500,60173
12797,8894,3903,1030,266100,60174
8140,7788,352,1647,385700,60175
4299,2853,1446,873,183300,60176
7423,6327,1096,1158,203800,60177
8532,5752,2780,928,179400,60178
571,495,76,780,272400,60180
10359,7193,3166,1148,218600,60181
826,787,39,2750,564900,60184
10485,7832,2653,981,234400,60185
9350,6861,2489,1118,324700,60187
15473,10659,4814,1035,234200,60188
12113,8854,3259,1326,356300,60189
4014,3824,190,1601,285800,60190
5289,4304,985,1260,212800,60191
5600,5193,407,1862,329900,60192
15284,11806,3478,1212,246700,60193
7290,5324,1966,1448,206800,60194
2304,767,1537,1160,192500,60195
15722,8789,6933,1307,429500,60201
13541,7280,6261,1140,287200,60202
1594,1469,125,1516,377900,60203
1362,489,873,1599,179800,60301
13804,7978,5826,978,380600,60302
6446,4342,2104,1121,345000,60304
3944,3452,492,1228,556400,60305
3076,2654,422,776,167000,60401
20988,13051,7937,910,168600,60402
7056,4617,2439,1024,153000,60403
5880,5305,575,1336,231100,60404
9131,5046,4085,822,113800,60406
644,511,133,945,134900,60407
2139,1614,525,836,158000,60408
14053,8079,5974,915,100200,60409
4055,3654,401,1423,188700,60410
20142,12511,7631,895,102900,60411
5288,2702,2586,913,156100,60415
3308,2493,815,957,174800,60416
6108,5146,962,1074,174900,60417
7751,5210,2541,1104,95000,60419
2110,1392,718,737,145800,60420
1513,1322,191,935,186800,60421
3456,3150,306,1707,227900,60422
10072,9457,615,1258,291000,60423
915,705,210,813,142800,60424
3248,2481,767,972,130100,60425
10907,4959,5948,828,76600,60426
4482,3202,1280,1148,94000,60428
5544,3825,1719,1281,112500,60429
7582,5864,1718,1148,166000,60430
7257,6358,899,1302,171800,60431
6352,3217,3135,886,105200,60432
5488,3329,2159,958,110300,60433
18082,11342,6740,873,150500,60435
5869,3452,2417,987,111800,60436
69,54,15,585,93300,60437
11123,7943,3180,958,129900,60438
8000,6684,1316,1054,350100,60439
16285,12426,3859,1154,175300,60440
12001,10092,1909,1083,194500,60441
3402,3044,358,1252,223200,60442
7517,6173,1344,1102,155700,60443
670,463,207,889,177800,60444
10186,7751,2435,894,150200,60445
11853,9923,1930,1382,165700,60446
4478,3869,609,1242,188700,60447
8412,7734,678,977,275800,60448
3369,3093,276,1136,195300,60449
8105,5619,2486,868,202000,60450
11334,10016,1318,954,265200,60451
10269,7980,2289,918,185500,60452
21534,17283,4251,1029,189600,60453
5483,4017,1466,890,162800,60455
1925,1543,382,443,110600,60456
4857,3567,1290,898,210900,60457
4890,2690,2200,919,163700,60458
8961,7125,1836,1051,181700,60459
579,439,140,811,112500,60460
1952,1688,264,1730,241300,60461
15349,13339,2010,1068,257600,60462
5461,5185,276,1772,275200,60463
3851,3290,561,1690,367100,60464
6896,5434,1462,1004,187000,60465
8400,5302,3098,1019,80900,60466
9531,9073,458,1904,305000,60467
2047,1663,384,796,199300,60468
1807,1315,492,990,106900,60469
223,187,36,925,136500,60470
5314,3076,2238,1012,149000,60471
1800,836,964,814,71900,60472
7446,6639,807,1446,151700,60473
354,287,67,795,128300,60474
3929,2375,1554,844,103300,60475
1067,818,249,736,115700,60476
15100,11848,3252,1033,202800,60477
5796,4327,1469,1352,130200,60478
241,218,23,628,216700,60479
2125,1796,329,1047,297000,60480
4670,3652,1018,744,170900,60481
4241,2866,1375,876,159300,60482
2483,1380,1103,996,109100,60484
8562,7852,710,1008,259500,60487
5545,5271,274,1919,264100,60490
7883,7319,564,1612,304100,60491
3495,1847,1648,820,152900,60501
8111,6251,1860,1539,275300,60502
4968,4718,250,1679,222000,60503
13108,8664,4444,1250,183600,60504
20551,11581,8970,964,112100,60505
17390,11144,6246,947,163700,60506
10569,8297,2272,1055,283400,60510
617,519,98,1006,238600,60511
789,665,124,-,185200,60512
7001,5245,1756,964,226200,60513
3829,2836,993,944,468600,60514
11507,8615,2892,1029,343000,60515
10867,8593,2274,1216,313800,60516
12597,8571,4026,1104,247000,60517
1498,1045,453,707,132000,60518
6,0,6,-,-,60519
1022,823,199,856,178700,60520
5757,4941,816,1601,820000,60521
4402,3528,874,697,684400,60523
11726,9338,2388,988,329500,60525
5319,3617,1702,991,317300,60526
11444,8762,2682,1193,398900,60527
198,149,49,689,132500,60530
729,594,135,783,168000,60531
11590,7093,4497,1153,292500,60532
3974,2395,1579,951,164200,60534
43,38,5,917,159100,60536
237,210,27,875,180000,60537
9003,7228,1775,1257,168300,60538
0,0,0,-,-,60539
15563,11790,3773,1260,380800,60540
1203,1011,192,746,247400,60541
6072,4807,1265,909,227400,60542
12331,9905,2426,1587,223200,60543
8853,7199,1654,1450,200300,60544
4478,3226,1252,967,138400,60545
5915,4292,1623,894,284500,60546
4378,3373,1005,920,165300,60548
258,175,83,-,144000,60549
591,399,192,760,163300,60550
1485,1176,309,780,205700,60551
1768,1363,405,1011,177100,60552
294,229,65,908,172700,60553
4166,3707,459,1323,266400,60554
5040,4109,931,1338,191600,60555
586,431,155,794,157600,60556
15,15,0,-,-,60557
4390,4207,183,1626,507300,60558
10243,5377,4866,979,272300,60559
7509,6284,1225,1010,232600,60560
9318,7808,1510,1125,294600,60561
14616,8317,6299,1260,314300,60563
12842,11510,1332,1718,415000,60564
13677,12042,1635,1316,367800,60565
6932,6273,659,1934,295400,60585
13430,12753,677,1452,197100,60586
7662,3156,4506,1836,434900,60601
706,244,462,2115,339100,60602
491,234,257,2223,603300,60603
338,145,193,1780,572000,60604
13467,6216,7251,1787,352000,60605
1973,847,1126,1904,364600,60606
12014,5929,6085,1616,341800,60607
25531,8582,16949,812,222100,60608
19284,7883,11401,787,160800,60609
22937,8625,14312,1345,399700,60610
20102,9190,10912,1743,492200,60611
13508,3626,9882,914,242200,60612
26168,10009,16159,1201,307000,60613
33705,14348,19357,1370,498600,60614
19995,5798,14197,982,231700,60615
22344,7648,14696,920,285600,60616
27700,16094,11606,786,126900,60617
35430,15422,20008,1033,320600,60618
25696,10622,15074,852,141400,60619
25453,11782,13671,864,132300,60620
11014,2914,8100,829,98400,60621
23632,8324,15308,1209,421000,60622
24929,8365,16564,781,140400,60623
11863,3034,8829,860,154700,60624
29132,10988,18144,982,309000,60625
22040,5543,16497,874,190500,60626
23268,13082,10186,925,119200,60628
30840,17825,13015,874,141000,60629
20533,12752,7781,990,267600,60630
11493,8876,2617,1156,320500,60631
24130,12608,11522,819,162400,60632
4740,3206,1534,825,122900,60633
25463,18068,7395,960,230700,60634
11303,5343,5960,872,89500,60636
18812,4785,14027,881,171800,60637
19852,15326,4526,916,194500,60638
25405,10719,14686,918,189500,60639
34410,10664,23746,894,270300,60640
24686,12214,12472,911,255000,60641
9224,3421,5803,1349,369400,60642
17845,13618,4227,894,174400,60643
16094,4378,11716,866,160700,60644
15836,7638,8198,983,245200,60645
10679,7784,2895,854,368700,60646
33864,12424,21440,1038,329500,60647
20499,4743,15756,824,151400,60649
19117,8003,11114,912,158700,60651
13109,10851,2258,1018,158000,60652
13621,3339,10282,715,223000,60653
11060,4041,7019,1890,383500,60654
9964,8678,1286,1032,234000,60655
11936,7987,3949,1027,248000,60656
36754,13643,23111,1293,391500,60657
12221,5311,6910,1007,273700,60659
20374,7672,12702,900,209800,60660
5458,1780,3678,1768,328200,60661
8855,6678,2177,967,248400,60706
15475,10349,5126,922,215500,60707
4243,3622,621,1790,365700,60712
11232,8533,2699,981,256300,60714
8308,5398,2910,904,158700,60803
21721,10652,11069,857,126800,60804
7253,5767,1486,947,178500,60805
10293,4470,5823,744,90600,60827
12933,7899,5034,790,112400,60901
166,129,37,770,89600,60910
545,454,91,789,132400,60911
215,140,75,873,89200,60912
531,451,80,636,168100,60913
10111,7493,2618,937,167600,60914
4120,2682,1438,794,112900,60915
188,166,22,788,132300,60917
352,290,62,850,85900,60918
205,156,49,750,81800,60919
61,43,18,920,82800,60920
550,330,220,649,70800,60921
884,729,155,788,117000,60922
712,523,189,493,108600,60924
13,13,0,-,63800,60926
869,622,247,606,142800,60927
315,266,49,673,95800,60928
358,263,95,648,85200,60929
324,240,84,838,120900,60930
213,155,58,610,84800,60931
33,33,0,-,90300,60932
104,95,9,735,83400,60933
107,82,25,348,179200,60934
373,341,32,694,201200,60935
1748,1177,571,573,112700,60936
780,503,277,649,95100,60938
1229,995,234,975,184900,60940
802,585,217,658,163500,60941
2552,1627,925,547,75800,60942
86,83,3,-,73000,60945
178,132,46,663,80000,60946
575,529,46,864,137500,60948
209,139,70,625,100900,60949
4649,3291,1358,861,179900,60950
315,272,43,763,110300,60951
272,243,29,567,66000,60952
985,791,194,547,82600,60953
2294,1766,528,823,146400,60954
731,541,190,738,101800,60955
2236,1786,450,581,98500,60957
845,463,382,677,69800,60958
436,330,106,721,79100,60959
379,283,96,563,80800,60960
331,281,50,1152,98100,60961
212,168,44,914,74500,60962
767,518,249,548,75400,60963
1932,1424,508,707,136100,60964
602,443,159,668,61800,60966
156,135,21,663,101600,60968
23,21,2,-,128800,60969
3135,2306,829,534,86100,60970
206,129,77,913,82400,60973
143,120,23,544,47700,60974
499,425,74,520,131300,61001
754,579,175,663,119000,61006
277,229,48,-,130400,61007
11881,9206,2675,703,130200,61008
3024,2477,547,651,170900,61010
885,805,80,1287,174800,61011
875,670,205,692,139100,61012
219,191,28,528,105300,61013
473,381,92,640,98800,61014
323,305,18,(X),130200,61015
1956,1630,326,745,166200,61016
385,293,92,594,116400,61018
1461,1330,131,936,143300,61019
999,870,129,838,144600,61020
8808,6611,2197,649,114100,61021
947,771,176,614,143300,61024
1847,1446,401,669,150300,61025
7,0,7,-,-,61027
960,678,282,663,137500,61028
948,709,239,666,100800,61030
583,473,110,646,108100,61031
12886,8454,4432,620,85900,61032
2871,2413,458,694,183200,61036
78,78,0,-,113500,61037
407,346,61,(X),207100,61038
348,273,75,1063,122800,61039
520,413,107,480,75800,61041
223,177,46,448,95000,61042
34,20,14,867,112500,61043
81,68,13,-,99400,61044
1196,981,215,498,122900,61046
741,596,145,742,136500,61047
1733,1324,409,547,125700,61048
216,182,34,890,170400,61049
201,171,30,845,81000,61050
702,557,145,538,97900,61051
400,371,29,763,180000,61052
1244,982,262,525,104400,61053
1640,1119,521,567,99500,61054
72,72,0,-,107500,61057
65,57,8,-,79300,61059
630,450,180,517,103800,61060
3057,2218,839,618,153500,61061
760,631,129,529,128700,61062
1613,1274,339,862,129700,61063
1475,1213,262,651,99800,61064
3480,3086,394,1214,144400,61065
284,233,51,546,119100,61067
5611,3697,1914,688,125900,61068
440,348,92,676,135800,61070
6073,4565,1508,657,85100,61071
4379,3551,828,698,160200,61072
7043,5886,1157,975,168400,61073
1910,1328,582,602,77000,61074
437,367,70,661,162500,61075
31,31,0,-,-,61077
574,445,129,548,106200,61078
48,37,11,931,106900,61079
4033,3188,845,667,128000,61080
8599,6218,2381,628,96200,61081
1100,921,179,858,163400,61084
1486,1113,373,550,102100,61085
818,606,212,481,89900,61087
2245,1960,285,658,159700,61088
324,266,58,602,98500,61089
40,40,0,-,93200,61091
7849,3987,3862,693,73300,61101
6473,4122,2351,693,81400,61102
9963,5399,4564,669,85500,61103
7144,2533,4611,664,61300,61104
13200,8742,4458,859,124300,61107
11482,7902,3580,776,98700,61108
10785,6588,4197,696,102500,61109
9704,6716,2988,791,113600,61111
108,0,108,2922,-,61112
6187,4544,1643,926,148300,61114
8633,6652,1981,924,115900,61115
15504,10130,5374,708,97200,61201
563,466,97,678,132000,61230
2253,1589,664,546,99600,61231
579,511,68,(X),127600,61232
599,404,195,630,109500,61234
626,541,85,491,106200,61235
42,33,9,-,101000,61236
1276,1067,209,661,115000,61238
486,227,259,704,100500,61239
2371,2195,176,988,176500,61240
2571,2270,301,565,109200,61241
471,393,78,703,131500,61242
104,88,16,679,107100,61243
9480,6144,3336,621,113100,61244
1003,840,163,664,138400,61250
142,142,0,-,187500,61251
2345,1750,595,590,128000,61252
4271,3524,747,654,158300,61254
797,690,107,775,148700,61256
490,420,70,727,132500,61257
106,90,16,558,55000,61258
470,357,113,758,158400,61259
397,315,82,557,80300,61260
415,302,113,834,86700,61261
499,476,23,(X),160900,61262
264,207,57,663,92500,61263
4718,3699,1019,621,110100,61264
18978,12660,6318,687,112700,61265
2842,2274,568,631,111600,61270
592,463,129,457,85400,61272
1395,1195,200,621,143200,61273
112,89,23,563,105700,61274
1736,1508,228,823,163900,61275
23,23,0,-,92800,61276
1251,978,273,695,88400,61277
130,120,10,575,153100,61278
372,321,51,727,113800,61279
917,822,95,700,153400,61281
3265,2165,1100,637,118400,61282
533,383,150,612,94300,61283
1003,890,113,(X),171600,61284
736,582,154,693,115300,61285
4480,2780,1700,742,87500,61301
1553,1092,461,675,103300,61310
68,55,13,-,157000,61311
171,127,44,880,107500,61312
81,44,37,-,100000,61313
325,246,79,681,71800,61314
88,64,24,592,52500,61315
121,103,18,800,84100,61316
199,147,52,753,82500,61317
307,213,94,1270,113700,61318
437,366,71,608,109400,61319
310,274,36,763,135700,61320
104,86,18,(X),80600,61321
511,356,155,637,67100,61322
29,24,5,-,58600,61323
36,24,12,-,-,61324
357,312,45,746,115800,61325
971,746,225,611,108000,61326
569,446,123,762,161500,61327
8,8,0,-,-,61328
535,438,97,619,106500,61329
542,432,110,734,116400,61330
12,12,0,-,-,61331
48,48,0,-,85700,61332
136,131,5,-,106800,61333
258,223,35,738,90700,61334
222,179,43,725,134000,61335
183,154,29,483,87500,61336
168,124,44,605,90000,61337
143,114,29,588,74000,61338
121,98,23,588,117500,61340
2940,2302,638,685,134100,61341
3303,2391,912,589,127300,61342
140,94,46,544,59000,61344
326,306,20,650,86000,61345
35,35,0,-,65000,61346
1868,1533,335,643,118800,61348
333,273,60,713,93100,61349
9745,6512,3233,726,142000,61350
529,379,150,711,148500,61353
4528,3313,1215,608,120400,61354
4886,3527,1359,593,121300,61356
196,179,17,438,76400,61358
119,104,15,769,81000,61359
1258,965,293,782,162500,61360
470,359,111,653,80400,61361
2460,1737,723,693,107200,61362
111,76,35,472,88500,61363
7921,5958,1963,570,89100,61364
349,244,105,678,126900,61367
526,469,57,692,94200,61368
657,526,131,617,83000,61369
572,436,136,690,120100,61370
61,41,20,(X),92500,61372
803,695,108,721,166500,61373
48,42,6,-,85000,61374
499,491,8,675,149600,61375
1016,746,270,612,113800,61376
637,439,198,681,101300,61377
225,176,49,894,114500,61378
527,435,92,496,92500,61379
14188,8630,5558,571,76500,61401
1467,1068,399,532,72500,61410
134,119,15,-,129800,61411
595,516,79,775,73200,61412
424,363,61,567,97900,61413
330,260,70,562,71000,61414
646,545,101,613,83900,61415
103,63,40,420,37700,61416
129,125,4,-,81600,61417
272,241,31,590,107400,61418
69,58,11,-,73300,61419
536,428,108,604,82400,61420
534,441,93,555,85300,61421
1375,1041,334,332,62200,61422
255,231,24,-,86500,61423
49,26,23,-,105800,61424
117,113,4,-,124700,61425
27,27,0,-,(X),61426
905,739,166,763,75800,61427
409,391,18,-,195400,61428
339,244,95,765,97700,61430
177,137,40,615,55700,61431
237,203,34,633,79500,61432
0,0,0,-,-,61433
1392,1015,377,504,74300,61434
57,57,0,-,91400,61435
385,272,113,650,150700,61436
419,356,63,672,117400,61437
341,272,69,669,99400,61438
118,92,26,713,77100,61439
292,275,17,596,71200,61440
442,366,76,513,82200,61441
321,242,79,337,54100,61442
5807,3916,1891,572,64500,61443
366,321,45,690,81000,61447
1515,1142,373,656,95100,61448
217,192,25,533,75000,61449
792,649,143,503,63300,61450
214,201,13,-,85900,61451
150,131,19,523,62400,61452
296,211,85,543,68600,61453
261,213,48,517,63600,61454
7853,4375,3478,665,105400,61455
380,292,88,588,95000,61458
187,160,27,597,83800,61459
118,90,28,625,75000,61460
4367,3098,1269,517,82700,61462
518,418,100,549,89200,61465
135,105,30,666,123400,61466
407,336,71,607,89400,61467
54,49,5,-,122100,61468
1006,761,245,557,72800,61469
177,160,17,619,55800,61470
42,34,8,-,44400,61471
237,207,30,577,96800,61472
655,499,156,577,75400,61473
93,80,13,-,62000,61474
110,61,49,617,120200,61475
208,157,51,-,75000,61476
250,194,56,766,88500,61477
108,101,7,-,176100,61478
67,47,20,-,(X),61479
513,358,155,581,84700,61480
240,221,19,814,69800,61482
754,617,137,605,80900,61483
318,290,28,546,55900,61484
196,170,26,718,66300,61485
587,452,135,620,94100,61486
419,352,67,550,78300,61488
373,292,81,670,81400,61489
524,390,134,664,89400,61490
973,791,182,581,92200,61491
716,584,132,554,59400,61501
277,204,73,656,113000,61516
1263,1060,203,709,214500,61517
102,82,20,839,70600,61519
6772,4491,2281,606,85800,61520
4542,3500,1042,634,135300,61523
98,80,18,913,80000,61524
3138,2556,582,896,249100,61525
344,333,11,-,214000,61526
1095,892,203,1084,235200,61528
1134,962,172,594,125900,61529
2514,1846,668,609,139400,61530
1261,1088,173,702,107600,61531
201,188,13,708,56300,61532
980,853,127,619,127200,61533
701,606,95,587,120500,61534
528,512,16,-,197100,61535
1195,967,228,656,122700,61536
1119,859,260,619,96000,61537
102,85,17,650,68800,61539
1187,1017,170,518,100400,61540
56,53,3,-,57100,61541
1676,1366,310,505,80300,61542
63,41,22,428,42100,61543
234,210,24,(X),62800,61544
321,232,89,921,109800,61545
1688,1444,244,670,116300,61546
1533,1409,124,875,178900,61547
4295,3597,698,911,201500,61548
7189,5592,1597,809,184800,61550
80,65,15,-,112200,61552
81,70,11,490,58900,61553
17654,12593,5061,652,104400,61554
1156,945,211,800,142200,61559
248,238,10,-,161100,61560
1062,867,195,683,119600,61561
19,19,0,-,-,61562
230,184,46,627,64600,61563
407,345,62,767,75200,61564
590,545,45,695,138300,61565
274,244,30,594,75000,61567
1607,1352,255,726,169700,61568
455,412,43,778,142100,61569
616,477,139,750,109500,61570
9330,7361,1969,726,150800,61571
470,404,66,593,100500,61572
599,111,488,467,221900,61602
6492,3206,3286,689,71000,61603
13398,8440,4958,690,88900,61604
5785,2290,3495,654,40800,61605
2345,921,1424,645,109600,61606
4695,3942,753,770,128600,61607
2277,1585,692,762,83700,61610
10592,8415,2177,677,139000,61611
12893,8252,4641,744,149700,61614
9995,6252,3743,787,190700,61615
2806,1704,1102,673,91700,61616
6,0,6,-,-,61625
15071,7945,7126,697,116700,61701
14099,9929,4170,895,203200,61704
4592,3713,879,770,245800,61705
63,56,7,-,83900,61720
260,169,91,807,102700,61721
188,138,50,737,103800,61722
789,615,174,709,101500,61723
175,158,17,525,83000,61724
545,501,44,678,157200,61725
1012,785,227,756,97800,61726
4093,3085,1008,555,107300,61727
529,388,141,658,107900,61728
391,322,69,575,168100,61729
148,116,32,804,105800,61730
77,77,0,-,120100,61731
752,647,105,633,140300,61732
358,294,64,866,160100,61733
1110,873,237,648,116600,61734
219,193,26,581,175700,61735
652,558,94,830,183200,61736
235,196,39,647,145100,61737
1610,1231,379,765,137800,61738
1964,1436,528,574,112200,61739
686,532,154,642,120000,61740
641,480,161,600,97700,61741
430,365,65,558,206500,61742
93,75,18,596,110200,61743
728,615,113,665,131200,61744
1568,1324,244,763,159500,61745
545,399,146,697,125800,61747
1133,1042,91,639,198900,61748
240,218,22,713,80900,61749
36,36,0,-,115900,61750
55,52,3,-,131300,61751
1720,1432,288,710,142800,61752
1247,1088,159,684,151900,61753
485,383,102,885,116900,61754
1884,1541,343,665,180600,61755
882,720,162,585,87500,61756
655,544,111,729,131900,61759
976,809,167,756,92700,61760
19154,10839,8315,828,162200,61761
5288,3708,1580,609,105200,61764
214,197,17,588,88100,61769
398,299,99,696,102000,61770
332,304,28,1269,112800,61771
123,91,32,470,112000,61772
225,154,71,648,72200,61773
355,326,29,708,106300,61774
149,121,28,595,88200,61775
594,539,55,613,162300,61776
360,315,45,780,106700,61777
360,315,45,425,83600,61778
10902,3639,7263,784,153200,61801
8397,4727,3670,783,119600,61802
115,92,23,675,86400,61810
241,196,45,669,65300,61811
136,121,15,481,95900,61812
775,636,139,690,88000,61813
454,338,116,768,102100,61814
94,69,25,786,102900,61815
210,171,39,738,76500,61816
1028,859,169,781,110600,61817
631,516,115,486,93900,61818
13436,3294,10142,796,125300,61820
13156,7976,5180,870,137100,61821
9652,6827,2825,1121,209500,61822
124,98,26,746,95900,61830
58,47,11,-,101300,61831
14861,8806,6055,654,64600,61832
948,717,231,614,62900,61833
2519,2107,412,692,113800,61834
262,186,76,725,77900,61839
336,285,51,928,234200,61840
557,497,60,623,97100,61841
1252,986,266,817,111700,61842
887,797,90,608,138400,61843
334,293,41,700,96300,61844
106,101,5,-,145300,61845
1982,1528,454,574,67200,61846
448,405,43,640,135300,61847
75,54,21,500,56100,61848
705,595,110,760,111400,61849
201,174,27,617,58100,61850
150,131,19,(X),97600,61851
99,85,14,-,101400,61852
5021,4030,991,1002,186400,61853
577,490,87,708,126600,61854
83,83,0,-,104900,61855
3003,2519,484,837,164500,61856
86,69,17,539,55900,61857
1259,1014,245,657,92200,61858
468,423,45,683,132500,61859
204,160,44,696,150000,61862
317,293,24,734,120400,61863
684,539,145,816,148700,61864
505,398,107,634,87900,61865
5426,2835,2591,674,91600,61866
528,437,91,525,75900,61870
101,99,2,-,134900,61871
366,265,101,682,109000,61872
2295,1945,350,719,161700,61873
3140,1571,1569,856,208700,61874
304,235,69,(X),159800,61875
299,252,47,483,70500,61876
692,572,120,820,143000,61877
716,497,219,579,98700,61878
1479,1277,202,758,145400,61880
294,250,44,588,79500,61882
1731,1344,387,668,76500,61883
458,408,50,605,196100,61884
1552,1130,422,664,95500,61910
1575,1094,481,596,109100,61911
548,459,89,586,89900,61912
653,519,134,745,85600,61913
762,597,165,543,88600,61914
262,215,47,675,61900,61917
362,329,33,700,136600,61919
9315,4857,4458,640,104500,61920
1014,833,181,509,77600,61924
216,197,19,675,95600,61925
330,274,56,628,91700,61928
286,211,75,550,81400,61929
189,151,38,638,80200,61930
461,334,127,619,95400,61931
216,148,68,487,66200,61932
424,304,120,411,70400,61933
70,70,0,-,65000,61936
778,603,175,594,86300,61937
9399,6289,3110,606,86200,61938
105,93,12,538,23800,61940
31,12,19,-,-,61941
492,360,132,574,70300,61942
663,521,142,611,81100,61943
5363,3880,1483,618,78600,61944
61,53,8,625,64200,61949
3280,2395,885,629,110600,61951
2501,1940,561,658,112500,61953
69,53,16,850,49000,61955
1159,886,273,666,89000,61956
879,711,168,708,80100,61957
634,523,111,653,195100,62001
13894,9213,4681,726,89100,62002
231,219,12,640,127300,62006
748,560,188,583,69200,62009
4395,3078,1317,793,140900,62010
84,65,19,529,123800,62011
2467,2175,292,688,139800,62012
229,153,76,717,109700,62013
1705,1430,275,649,105400,62014
162,145,17,569,90600,62015
1635,1217,418,630,95000,62016
287,245,42,681,66200,62017
1412,904,508,807,73200,62018
166,157,9,670,74600,62019
364,350,14,-,164100,62021
428,406,22,-,132500,62022
48,45,3,-,79400,62023
4341,2984,1357,825,93500,62024
12101,9189,2912,945,196400,62025
222,165,57,513,83600,62027
266,210,56,950,120000,62028
45,27,18,568,(X),62030
388,345,43,612,98600,62031
258,246,12,(X),65000,62032
1938,1486,452,592,81700,62033
5341,3784,1557,882,194300,62034
6526,5501,1025,771,136900,62035
304,277,27,742,161400,62036
792,604,188,703,154500,62037
17605,12153,5452,694,84600,62040
877,701,176,610,83400,62044
185,156,29,539,140400,62045
276,225,51,816,185800,62046
746,557,189,495,128000,62047
725,550,175,674,67700,62048
2217,1703,514,617,91100,62049
167,105,62,618,34900,62050
369,331,38,489,92100,62051
5168,3973,1195,672,120700,62052
215,156,59,611,71000,62053
320,257,63,529,(X),62054
4367,3186,1181,591,77200,62056
353,270,83,614,82200,62058
364,120,244,432,32900,62059
1988,944,1044,730,46700,62060
736,584,152,663,156500,62061
3223,2569,654,974,189500,62062
425,376,49,607,113300,62063
32,21,11,-,-,62065
1094,870,224,842,161600,62067
1269,1093,176,700,72900,62069
18,18,0,-,-,62070
456,379,77,641,137700,62074
1359,1074,285,587,74800,62075
39,35,4,-,57000,62076
110,94,16,717,48900,62077
41,36,5,-,33600,62078
96,96,0,-,189300,62079
1025,928,97,537,75400,62080
127,108,19,555,78600,62081
1121,838,283,588,68200,62082
118,107,11,-,141800,62083
648,393,255,715,81000,62084
80,63,17,1094,65000,62085
553,447,106,597,59100,62086
866,538,328,728,66600,62087
3007,2194,813,618,105800,62088
156,121,35,538,71600,62089
466,160,306,728,33400,62090
143,125,18,-,112900,62091
1126,847,279,605,59800,62092
158,117,41,730,53600,62093
383,342,41,552,56300,62094
4770,3268,1502,716,86800,62095
1103,969,134,802,179600,62097
26,26,0,-,(X),62098
2560,757,1803,391,67700,62201
2719,1713,1006,744,57100,62203
3373,1342,2031,445,50100,62204
3582,1865,1717,747,55200,62205
5402,2765,2637,851,48700,62206
3319,1496,1823,553,42700,62207
7233,5274,1959,982,120700,62208
445,381,64,638,118500,62214
585,493,92,699,160300,62215
1029,887,142,783,171200,62216
285,224,61,762,71900,62217
602,557,45,855,187700,62218
378,325,53,773,99100,62219
7769,5048,2721,752,111600,62220
11235,7680,3555,854,158200,62221
7013,5325,1688,837,113600,62223
1327,28,1299,1292,-,62225
12145,7800,4345,774,116500,62226
2430,2105,325,851,143500,62230
2917,2474,443,809,122400,62231
2575,2032,543,742,88800,62232
2756,2069,687,615,95000,62233
13240,8607,4633,808,133100,62234
5147,4189,958,791,194900,62236
1024,928,96,608,97900,62237
231,185,46,(X),53300,62238
2023,1478,545,703,92700,62239
658,566,92,784,59700,62240
467,389,78,619,108200,62241
493,426,67,625,90000,62242
2361,1962,399,821,167400,62243
434,405,29,940,221800,62244
635,561,74,665,160200,62245
3271,2331,940,596,121500,62246
120,90,30,742,114600,62248
6037,4433,1604,745,169700,62249
168,151,17,631,96600,62250
336,248,88,544,91100,62253
2109,1511,598,758,155900,62254
372,301,71,637,138200,62255
1246,992,254,661,100300,62257
3403,2544,859,948,145300,62258
2663,2305,358,785,194800,62260
55,55,0,-,111500,62261
744,660,84,577,87700,62262
2070,1515,555,623,107600,62263
1235,1029,206,684,114100,62264
1653,1368,285,969,141700,62265
92,92,0,-,(X),62266
297,249,48,683,125700,62268
11628,8521,3107,954,183200,62269
835,687,148,704,121400,62271
646,523,123,598,98100,62272
149,87,62,769,107800,62273
2511,1865,646,465,83800,62274
1394,1198,196,720,119900,62275
536,415,121,661,87700,62277
2563,2082,481,697,157900,62278
14,14,0,-,-,62279
139,120,19,-,124000,62280
722,634,88,1076,173000,62281
199,170,29,636,132300,62282
254,224,30,940,107100,62284
1635,1485,150,664,170900,62285
2518,1773,745,603,86300,62286
1183,924,259,585,110700,62288
137,105,32,788,80600,62289
308,222,86,677,74600,62292
1795,1410,385,763,152000,62293
5095,3863,1232,805,183700,62294
565,448,117,1056,160400,62295
175,148,27,-,(X),62297
6199,5166,1033,877,191300,62298
13840,8116,5724,573,92300,62301
7307,6226,1081,646,156600,62305
308,270,38,458,67000,62311
950,739,211,455,66700,62312
116,112,4,-,100000,62313
240,147,93,771,56000,62314
245,219,26,(X),58600,62316
136,110,26,-,90900,62319
740,637,103,299,124200,62320
1761,1309,452,515,92000,62321
96,89,7,-,94400,62323
433,349,84,391,63600,62324
195,157,38,596,149000,62325
1030,814,216,524,77100,62326
752,626,126,546,78500,62330
56,48,8,670,43300,62334
23,21,2,-,46300,62336
408,325,83,443,135400,62338
358,286,72,433,92700,62339
679,548,131,336,71100,62340
1453,1089,364,666,100900,62341
248,201,47,533,62800,62343
32,27,5,-,72700,62344
208,176,32,513,85800,62345
113,87,26,780,72300,62346
947,770,177,592,118000,62347
77,76,1,-,101600,62348
201,172,29,500,90000,62349
747,558,189,559,111200,62351
97,85,12,-,67200,62352
1508,1121,387,524,82300,62353
692,494,198,675,97000,62354
365,329,36,583,59100,62355
222,174,48,333,55000,62356
91,60,31,565,62300,62357
348,310,38,586,106200,62358
78,78,0,-,87700,62359
710,565,145,610,91500,62360
225,169,56,582,80300,62361
182,159,23,258,48800,62362
2471,1755,716,536,92900,62363
253,219,34,588,67800,62365
622,533,89,507,68600,62366
414,300,114,548,49400,62367
175,147,28,729,75400,62370
140,131,9,-,87900,62373
104,91,13,625,55000,62374
179,117,62,1364,108100,62375
482,389,93,500,102600,62376
440,336,104,606,101600,62378
823,689,134,509,74800,62379
136,85,51,281,48100,62380
7620,5649,1971,558,137700,62401
399,337,62,497,88500,62410
1638,1318,320,631,95700,62411
139,119,20,531,86800,62413
741,658,83,582,112300,62414
880,672,208,566,71300,62417
708,576,132,617,75000,62418
157,153,4,-,55900,62419
1892,1434,458,573,79500,62420
276,207,69,717,88600,62421
453,350,103,622,73900,62422
251,200,51,-,83600,62423
840,770,70,800,119500,62424
254,199,55,718,78700,62425
398,345,53,588,71700,62426
626,511,115,665,89100,62427
1306,1053,253,465,78200,62428
422,376,46,625,71700,62431
175,165,10,356,75100,62432
383,337,46,(X),69000,62433
162,139,23,-,86200,62434
225,152,73,496,75000,62436
156,113,43,-,140600,62438
3164,2439,725,533,65200,62439
527,498,29,638,92200,62440
2891,2023,868,663,123600,62441
1076,829,247,567,80100,62442
627,556,71,756,114200,62443
127,103,24,-,122100,62444
394,304,90,567,112500,62445
155,139,16,-,87300,62446
1382,1169,213,536,89500,62447
2351,1927,424,550,92500,62448
1236,1063,173,516,77400,62449
5129,3491,1638,522,87000,62450
877,674,203,552,63400,62451
158,134,24,624,103800,62452
4348,3334,1014,568,85800,62454
788,624,164,433,68600,62458
126,111,15,350,69600,62459
347,294,53,819,67000,62460
300,268,32,669,150500,62461
365,304,61,492,106300,62462
511,424,87,506,83600,62463
373,341,32,442,93600,62465
615,454,161,552,72100,62466
1347,1189,158,578,165100,62467
996,757,239,508,108000,62468
202,186,16,-,105500,62469
3208,2383,825,612,87000,62471
520,484,36,656,85700,62473
412,356,56,743,76400,62474
139,139,0,-,69100,62475
785,669,116,484,64100,62476
413,363,50,650,62200,62477
163,163,0,-,79400,62478
303,254,49,575,150000,62479
207,165,42,550,58200,62480
144,134,10,-,134400,62481
1117,994,123,753,127000,62501
822,589,233,480,78500,62510
124,93,31,-,160200,62512
631,509,122,728,86500,62513
81,76,5,-,72300,62514
462,313,149,498,128700,62515
103,92,11,575,53800,62517
132,103,29,548,110600,62518
32,32,0,-,57800,62519
635,583,52,717,155500,62520
15026,10768,4258,709,95600,62521
6242,3951,2291,622,79600,62522
385,6,379,309,-,62523
14282,8674,5608,649,78600,62526
643,484,159,675,99600,62530
827,664,163,683,103300,62531
35,35,0,-,75000,62532
365,270,95,525,99400,62533
530,387,143,553,91300,62534
1381,1268,113,1303,209700,62535
372,324,48,-,211300,62536
19,19,0,-,104700,62537
146,110,36,709,85600,62538
508,405,103,748,85300,62539
685,499,186,565,75100,62540
23,23,0,-,83100,62541
175,115,60,(X),81900,62543
806,668,138,580,94500,62544
426,377,49,439,98400,62545
530,446,84,608,79900,62546
301,245,56,339,72800,62547
749,652,97,574,107700,62548
2390,1982,408,631,140900,62549
1074,876,198,754,107400,62550
347,275,72,525,90400,62551
184,141,43,(X),89400,62553
644,552,92,648,135700,62554
185,164,21,533,86400,62555
109,93,16,-,76300,62556
3281,2441,840,503,72500,62557
1426,1149,277,731,136600,62558
491,403,88,594,81500,62560
1991,1515,476,771,135500,62561
2184,1916,268,856,184000,62563
3199,2558,641,462,83800,62565
439,366,73,631,88000,62567
6414,4567,1847,663,87500,62568
210,173,37,434,72000,62570
511,476,35,589,68800,62571
219,199,20,550,104600,62572
594,447,147,527,112200,62573
186,150,36,-,122200,62601
94,62,32,585,53000,62610
452,333,119,580,93300,62611
765,614,151,716,94500,62612
1426,1137,289,714,126700,62613
2046,1692,354,652,119800,62615
309,217,92,686,60900,62617
2973,2040,933,602,72200,62618
522,392,130,463,76800,62621
18,10,8,-,-,62622
228,199,29,613,72500,62624
327,303,24,-,144200,62625
3305,2365,940,590,101000,62626
418,343,75,493,72500,62627
323,270,53,708,81500,62628
5143,4209,934,1020,168600,62629
201,187,14,-,87900,62630
119,106,13,-,85200,62631
270,236,34,711,80000,62633
276,181,95,480,94400,62634
233,203,30,721,102600,62635
505,430,75,648,108600,62638
105,98,7,-,66000,62639
1496,1121,375,716,108100,62640
633,535,98,664,95000,62642
189,121,68,688,99600,62643
2258,1693,565,532,78000,62644
180,158,22,546,102200,62649
10464,6827,3637,612,105000,62650
249,172,77,530,57500,62655
7471,4678,2793,625,98400,62656
515,407,108,656,143800,62661
128,112,16,517,66700,62663
1327,989,338,622,77600,62664
611,467,144,536,68900,62665
230,198,32,538,92000,62666
140,111,29,475,74300,62667
559,477,82,486,86300,62668
1199,920,279,716,152600,62670
165,122,43,583,82200,62671
94,81,13,580,58300,62672
238,196,42,679,79600,62673
585,460,125,492,89500,62674
2630,1951,679,575,150500,62675
1009,861,148,740,150700,62677
2231,1802,429,498,80300,62681
328,254,74,586,68700,62682
2082,1796,286,821,196000,62684
775,681,94,685,104100,62685
224,187,37,757,89100,62688
234,180,54,702,75600,62689
1619,1189,430,644,89200,62690
894,676,218,566,79600,62691
790,690,100,696,83400,62692
562,520,42,700,162000,62693
1210,918,292,538,89200,62694
102,84,18,632,89000,62695
617,8,609,633,-,62701
15859,9896,5963,726,80000,62702
12325,7186,5139,723,83700,62703
18717,11320,7397,736,130400,62704
2960,2492,468,786,136200,62707
6635,5644,991,912,229400,62711
4080,3190,890,744,209700,62712
8687,6162,2525,657,66500,62801
367,280,87,530,94300,62803
1412,1146,266,481,73300,62806
345,256,89,577,69500,62807
558,440,118,568,84700,62808
61,53,8,-,76300,62809
327,276,51,480,85500,62810
106,93,13,532,49000,62811
4633,3254,1379,648,70900,62812
744,684,60,608,74100,62814
153,127,26,375,69600,62815
602,480,122,654,70600,62816
220,178,42,612,76500,62817
114,107,7,442,75000,62818
186,141,45,585,44300,62819
69,69,0,-,54100,62820
3243,2329,914,559,81800,62821
1296,904,392,582,56100,62822
739,642,97,375,69400,62823
700,579,121,505,59100,62824
78,63,15,609,48300,62825
531,411,120,604,55700,62827
561,488,73,450,96700,62828
18,5,13,-,-,62829
596,383,213,424,108600,62830
212,186,26,492,115000,62831
3756,2712,1044,462,71000,62832
109,101,8,-,144800,62833
434,353,81,585,42100,62835
233,205,28,711,85800,62836
3948,2990,958,545,78200,62837
649,536,113,548,54100,62838
2600,1922,678,504,81400,62839
51,50,1,-,(X),62841
330,259,71,588,68800,62842
44,39,5,-,63800,62843
852,674,178,411,65600,62844
356,241,115,614,68800,62846
309,192,117,534,74400,62848
858,751,107,564,90100,62849
152,146,6,-,78700,62850
131,100,31,-,82000,62851
47,39,8,425,45000,62852
331,313,18,-,62500,62853
648,533,115,814,68800,62854
173,121,52,670,47900,62856
1254,1036,218,572,78400,62858
2372,1780,592,571,78900,62859
208,179,29,660,79400,62860
44,36,8,-,16700,62861
161,116,45,410,52000,62862
4157,2998,1159,570,79900,62863
10307,6985,3322,606,87300,62864
795,776,19,-,87500,62865
199,149,50,381,45000,62867
566,521,45,542,72400,62868
1155,914,241,450,69700,62869
801,688,113,586,62700,62870
310,251,59,317,67400,62871
413,383,30,(X),74800,62872
189,147,42,650,42500,62874
447,391,56,383,61300,62875
80,76,4,-,84400,62876
218,179,39,558,88300,62877
153,142,11,-,90300,62878
39,31,8,580,(X),62879
212,176,36,(X),76500,62880
4616,3341,1275,577,76800,62881
888,680,208,536,58900,62882
301,266,35,333,92000,62883
1148,849,299,627,76800,62884
362,339,23,-,89000,62885
155,147,8,-,61400,62886
151,114,37,-,125000,62887
803,692,111,572,80300,62888
334,284,50,513,108500,62889
1107,919,188,869,88700,62890
262,231,31,614,50800,62891
121,110,11,(X),86700,62892
357,316,41,619,108100,62893
335,264,71,532,130800,62894
832,693,139,659,84200,62895
5092,3619,1473,494,62500,62896
144,124,20,-,82500,62897
817,768,49,331,105600,62898
701,601,100,390,70400,62899
10174,3225,6949,683,115800,62901
2079,1356,723,770,130100,62902
1046,488,558,643,150000,62903
288,254,34,514,106000,62905
2678,1959,719,391,86400,62906
872,759,113,585,107900,62907
167,131,36,-,63600,62908
1062,913,149,507,65700,62910
464,405,59,595,76000,62912
1269,705,564,245,25600,62914
112,85,27,825,69700,62915
341,299,42,600,103600,62916
1111,809,302,416,63300,62917
3957,2960,997,663,127900,62918
387,320,67,536,62600,62919
1232,1010,222,538,138000,62920
166,102,64,827,35000,62921
1200,1047,153,495,113500,62922
181,159,22,838,68300,62923
1173,752,421,819,83300,62924
892,737,155,592,79000,62926
127,100,27,718,50000,62927
101,71,30,367,(X),62928
2328,1707,621,670,59800,62930
663,548,115,365,98500,62931
677,510,167,611,85900,62932
556,264,292,698,117400,62933
406,312,94,375,54800,62934
677,547,130,522,72600,62935
976,770,206,404,82600,62938
1271,1034,237,675,109300,62939
139,126,13,433,60000,62940
286,218,68,1038,76400,62941
275,206,69,415,51000,62942
183,176,7,-,77000,62943
5385,3662,1723,573,79400,62946
217,217,0,-,113900,62947
5415,3780,1635,592,84200,62948
364,260,104,413,49500,62949
124,116,8,-,59100,62950
2054,1479,575,506,75800,62951
1268,1006,262,550,97300,62952
109,59,50,625,57500,62953
195,169,26,-,74100,62954
344,314,30,633,63000,62956
353,250,103,767,56000,62957
910,677,233,654,135900,62958
11010,7797,3213,675,123300,62959
4621,3234,1387,704,89600,62960
14,14,0,-,(X),62961
15,11,4,-,-,62962
219,113,106,318,28600,62963
575,408,167,441,52400,62964
35,23,12,475,58300,62965
6144,4208,1936,593,93500,62966
118,109,9,-,80800,62967
189,162,27,584,74400,62969
262,214,48,483,69000,62970
445,396,49,-,85700,62972
527,466,61,743,90900,62974
162,102,60,-,87500,62975
178,160,18,(X),76300,62976
259,228,31,673,93300,62977
543,414,129,469,73200,62979
449,362,87,253,51800,62982
601,471,130,649,55600,62983
822,617,205,378,65400,62984
383,375,8,-,112700,62985
402,343,59,(X),84500,62987
527,415,112,458,61200,62988
291,234,57,370,89400,62990
345,203,142,504,53600,62992
247,193,54,680,87700,62994
1582,1212,370,496,91500,62995
204,190,14,-,57300,62996
184,131,53,721,49300,62997
133,104,29,-,54500,62998
650,487,163,571,49900,62999
6154,5389,765,986,537900,63005
13742,11135,2607,845,146900,63010
13948,11541,2407,1153,253900,63011
3785,3366,419,913,146700,63012
633,548,85,-,169200,63013
252,211,41,704,162500,63014
881,749,132,625,127800,63015
2695,2514,181,900,143800,63016
16626,12999,3627,1093,327400,63017
1683,1163,520,818,117300,63019
7615,5784,1831,703,118100,63020
21186,17292,3894,1016,224300,63021
2237,1881,356,776,151900,63023
4631,3970,661,997,244200,63025
16409,13492,2917,782,184300,63026
10199,7827,2372,713,154400,63028
126,77,49,1149,159400,63030
18457,13854,4603,969,100200,63031
17076,11057,6019,907,107600,63033
6538,6125,413,1526,167200,63034
425,376,49,894,91500,63036
1193,958,235,750,128400,63037
2509,2290,219,1146,391200,63038
297,193,104,1091,117200,63039
2910,2506,404,1134,282300,63040
184,174,10,-,160000,63041
8747,4931,3816,816,97000,63042
9133,6146,2987,923,152400,63043
4274,2962,1312,805,159300,63044
0,0,0,-,-,63045
0,0,0,-,-,63047
1221,1021,200,925,153200,63048
6142,5383,759,765,151000,63049
5834,4913,921,821,166900,63050
5146,4099,1047,734,135000,63051
8866,7420,1446,821,167700,63052
21,16,5,-,129200,63053
1005,789,216,776,223400,63055
692,608,84,700,119400,63056
0,0,0,-,-,63057
900,818,82,619,122600,63060
63,63,0,-,158800,63061
1875,1562,313,772,153600,63068
5664,4261,1403,703,190400,63069
3085,2048,1037,725,115900,63070
414,345,69,404,62300,63071
1102,845,257,871,166400,63072
324,309,15,-,748800,63073
6957,3387,3570,738,89600,63074
4551,3136,1415,689,119400,63077
10,10,0,-,-,63079
5420,3396,2024,672,118700,63080
6924,5128,1796,615,156000,63084
343,281,62,668,162500,63087
3898,2360,1538,919,168200,63088
2172,1822,350,931,125800,63089
8767,6193,2574,664,172600,63090
487,435,52,(X),127000,63091
1830,243,1587,990,256900,63101
1074,16,1058,831,-,63102
3981,703,3278,805,159500,63103
9363,3619,5744,764,193900,63104
6459,3684,2775,1081,572800,63105
4642,494,4148,569,113100,63106
4146,1728,2418,708,56500,63107
10330,2861,7469,867,269000,63108
13505,7909,5596,761,162200,63109
7882,3355,4527,751,158300,63110
8498,3261,5237,682,84200,63111
8487,3178,5309,766,147300,63112
4678,1893,2785,727,65600,63113
14743,9217,5526,812,84000,63114
7834,3770,4064,765,59100,63115
19354,10842,8512,692,109600,63116
4380,2337,2043,888,218300,63117
11036,4306,6730,728,108900,63118
13861,10730,3131,910,215500,63119
3306,1713,1593,755,49600,63120
10767,5901,4866,767,75700,63121
16123,13020,3103,1039,280600,63122
22285,16374,5911,743,143900,63123
4403,3183,1220,1054,742100,63124
13577,9719,3858,756,117800,63125
6248,5325,923,909,180700,63126
1862,1335,527,1610,395400,63127
12325,9941,2384,893,212000,63128
21781,16930,4851,788,193900,63129
12601,7605,4996,925,227000,63130
6309,5764,545,1202,491800,63131
5711,3143,2568,930,249900,63132
3237,1250,1987,646,55800,63133
5347,3310,2037,945,71800,63134
8835,5458,3377,911,84400,63135
17548,9107,8441,845,70300,63136
7516,4209,3307,932,67200,63137
7689,3864,3825,723,98000,63138
11204,6361,4843,738,139500,63139
120,17,103,643,(X),63140
8092,6096,1996,1089,389000,63141
5210,2317,2893,654,141400,63143
4131,2798,1333,1127,194600,63144
13805,8189,5616,956,192900,63146
3875,2252,1623,755,68200,63147
0,0,0,-,-,63155
19027,12498,6529,797,158500,63301
18932,13938,4994,930,195700,63303
14687,13061,1626,1223,207600,63304
71,58,13,850,(X),63330
544,486,58,751,296400,63332
281,202,79,764,100600,63333
2626,1895,731,645,107800,63334
548,381,167,518,107400,63336
404,319,85,625,111500,63339
1297,1223,74,777,335800,63341
1595,1168,427,649,133300,63343
611,481,130,586,110100,63344
185,141,44,531,53900,63345
1036,878,158,720,90300,63347
2335,2003,332,991,248100,63348
664,548,116,660,195600,63349
276,256,20,758,98400,63350
588,454,134,850,147000,63351
452,302,150,564,74800,63352
1803,1170,633,661,76200,63353
1941,1563,378,583,170000,63357
473,394,79,705,83300,63359
1849,1215,634,550,107900,63361
2246,1577,669,907,126300,63362
797,607,190,622,104000,63363
18005,14036,3969,898,178300,63366
7730,6004,1726,1015,237300,63367
15596,12844,2752,1153,210600,63368
783,647,136,650,135500,63369
4,4,0,-,-,63370
210,151,59,832,123800,63373
27784,22838,4946,952,170100,63376
880,716,164,831,126000,63377
8229,6251,1978,801,152600,63379
196,186,10,800,123000,63381
1462,1020,442,484,64800,63382
5379,4215,1164,694,136700,63383
726,532,194,526,72200,63384
13117,11287,1830,939,201700,63385
233,176,57,830,90000,63386
22,19,3,-,90800,63387
318,272,46,-,67700,63388
2263,1795,468,832,142000,63389
4142,3221,921,739,156100,63390
8603,5389,3214,619,102700,63401
206,178,28,533,72000,63430
146,105,41,-,114200,63431
168,138,30,-,81300,63432
33,33,0,-,(X),63433
266,156,110,425,102900,63434
1570,1132,438,480,90800,63435
475,363,112,559,80200,63436
625,462,163,448,69600,63437
221,205,16,-,112100,63438
30,24,6,-,160000,63439
468,368,100,485,87900,63440
501,403,98,475,129700,63441
209,178,31,275,77400,63443
1513,1101,412,490,86700,63445
333,258,75,475,78100,63446
452,285,167,311,56500,63447
655,483,172,603,85500,63448
48,36,12,-,86000,63450
71,48,23,-,76700,63451
479,381,98,458,72400,63452
166,127,39,825,96500,63453
298,218,80,805,94800,63454
1794,1302,492,568,86400,63456
118,94,24,755,134100,63457
82,71,11,933,117700,63458
1657,1356,301,679,117300,63459
140,113,27,535,56200,63460
2252,1629,623,588,114100,63461
574,453,121,525,119500,63462
260,198,62,450,88900,63463
15,6,9,-,-,63464
191,162,29,622,75600,63465
10,10,0,-,-,63467
940,655,285,466,70200,63468
460,325,135,561,89600,63469
254,215,39,(X),87700,63471
233,141,92,417,44800,63472
102,97,5,-,87100,63473
188,151,37,400,95600,63474
8140,4344,3796,596,111700,63501
427,349,78,532,83200,63530
174,148,26,375,46000,63531
589,514,75,528,60800,63532
320,280,40,438,81300,63533
320,277,43,425,65000,63534
59,59,0,-,120500,63535
287,229,58,312,88300,63536
748,565,183,505,70400,63537
101,91,10,-,(X),63538
77,65,12,-,82100,63539
67,42,25,488,23000,63540
128,92,36,383,108900,63541
116,88,28,493,50000,63543
344,276,68,497,82900,63544
484,326,158,444,85400,63545
576,469,107,415,106700,63546
210,160,50,(X),74200,63547
524,375,149,621,78100,63548
966,715,251,483,103300,63549
123,105,18,(X),23400,63551
3124,2112,1012,467,95700,63552
1302,953,349,437,70900,63555
1281,919,362,604,83700,63556
94,85,9,-,117000,63557
301,257,44,635,86500,63558
588,501,87,546,77000,63559
118,98,20,550,78200,63560
454,329,125,568,74700,63561
218,170,48,(X),(X),63563
1680,1210,470,487,86200,63565
51,37,14,-,41700,63566
60,36,24,367,98600,63567
6698,4138,2560,569,80200,63601
554,348,206,526,67300,63620
596,410,186,382,95400,63621
348,295,53,(X),89600,63622
275,262,13,575,81500,63623
1660,1298,362,597,82600,63624
150,123,27,-,76300,63625
534,406,128,514,99400,63626
1113,935,178,553,159200,63627
5048,3605,1443,619,115400,63628
542,390,152,413,79400,63629
1305,1202,103,571,54400,63630
392,355,37,694,87300,63631
246,208,38,505,109800,63633
254,184,70,325,61400,63636
633,446,187,589,83700,63637
1132,815,317,561,87400,63638
10613,7009,3604,648,129300,63640
4370,3352,1018,586,90000,63645
560,417,143,534,84900,63648
1554,1084,470,540,85300,63650
505,285,220,710,53900,63653
266,231,35,588,102800,63654
521,404,117,653,76800,63655
154,129,25,475,102500,63656
1174,877,297,513,59300,63660
486,449,37,-,101400,63662
286,149,137,578,70800,63663
3226,2375,851,490,88400,63664
98,89,9,-,92500,63665
55,55,0,-,(X),63666
4456,3447,1009,595,127400,63670
806,697,109,759,111400,63673
79,79,0,-,"10,000-",63674
74,68,6,-,(X),63675
14537,8842,5695,654,147300,63701
3738,1590,2148,722,77900,63703
1348,1054,294,502,93600,63730
332,287,45,722,97000,63732
325,226,99,475,57700,63735
1283,963,320,633,88400,63736
39,31,8,-,-,63738
153,109,44,528,(X),63739
1986,1363,623,499,94800,63740
17,11,6,-,65000,63742
21,21,0,-,162500,63743
49,41,8,-,43000,63744
14,8,6,663,86700,63745
16,10,6,-,-,63746
197,184,13,-,101300,63747
463,421,42,400,124100,63748
0,0,0,-,-,63750
474,408,66,(X),91200,63751
9170,6829,2341,742,157500,63755
97,83,14,-,117200,63758
241,225,16,569,143300,63760
74,46,28,-,121400,63763
2145,1558,587,558,96100,63764
538,475,63,753,119700,63766
276,205,71,593,70200,63767
537,492,45,794,153100,63769
66,66,0,-,82700,63770
972,680,292,562,85500,63771
57,38,19,-,50700,63774
6361,4887,1474,653,124600,63775
2583,1940,643,703,112400,63780
496,468,28,531,126100,63781
135,104,31,373,58600,63782
65,65,0,-,133700,63783
53,48,5,-,51700,63784
345,262,83,759,114300,63785
266,187,79,550,75800,63787
9278,5909,3369,581,95300,63801
117,82,35,425,23300,63820
373,262,111,484,40800,63821
1208,778,430,582,69200,63822
596,368,228,657,67800,63823
60,15,45,796,67000,63824
1645,1167,478,519,85800,63825
16,16,0,-,66300,63826
323,228,95,606,56700,63827
75,52,23,708,33300,63828
448,285,163,490,46900,63829
3042,1499,1543,555,76000,63830
94,68,26,-,(X),63833
2200,1239,961,678,64900,63834
627,383,244,416,37800,63837
161,80,81,703,51300,63839
5673,3855,1818,550,109400,63841
2208,1423,785,434,74900,63845
585,434,151,610,62600,63846
42,27,15,-,-,63847
553,345,208,614,43400,63848
32,29,3,-,75800,63849
1492,769,723,557,56700,63851
494,352,142,590,65100,63852
89,61,28,622,29600,63853
444,340,104,395,73100,63855
5179,3084,2095,487,91000,63857
75,63,12,-,(X),63860
668,408,260,520,54700,63862
2583,1497,1086,575,63000,63863
153,73,80,725,63200,63866
460,351,109,496,66500,63867
302,146,156,595,47400,63868
1356,794,562,528,94700,63869
415,235,180,658,59800,63870
1933,1153,780,470,69800,63873
138,100,38,615,44000,63874
900,660,240,442,55400,63876
1360,776,584,553,69600,63877
63,42,21,729,42000,63878
297,200,97,422,45000,63879
7,7,0,-,-,63880
212,126,86,536,39500,63882
13452,8473,4979,653,98700,63901
0,0,0,-,-,63902
593,435,158,616,75000,63932
1525,1058,467,475,60100,63933
35,35,0,-,-,63934
3747,2857,890,497,83100,63935
323,180,143,603,59000,63936
1067,743,324,552,86000,63937
507,352,155,533,62900,63939
559,441,118,508,71900,63940
133,100,33,-,78300,63941
307,230,77,471,87500,63942
348,272,76,562,66700,63943
753,558,195,498,94800,63944
440,290,150,428,111600,63945
77,44,33,564,64400,63951
212,175,37,525,93700,63952
790,565,225,535,59300,63953
429,265,164,490,42300,63954
78,60,18,-,(X),63955
450,409,41,(X),62100,63956
2394,1705,689,579,70700,63957
1179,999,180,470,100100,63960
681,475,206,497,52000,63961
0,0,0,-,-,63962
304,239,65,388,55900,63964
1245,934,311,407,107400,63965
1115,1029,86,838,60100,63966
658,543,115,505,57800,63967
263,213,50,634,103200,64001
1560,1385,175,771,155300,64011
10030,6864,3166,970,130400,64012
9017,6295,2722,925,142900,64014
11412,8221,3191,841,149700,64015
1707,1243,464,725,113600,64016
172,126,46,675,84600,64017
328,287,41,695,192000,64018
1019,855,164,549,132700,64019
1351,1004,347,602,113200,64020
208,179,29,729,66900,64021
88,77,11,-,69400,64022
6253,4592,1661,696,116500,64024
6126,4211,1915,969,166500,64029
9655,5250,4405,741,106000,64030
2767,2507,260,1006,166000,64034
376,282,94,750,80300,64035
116,90,26,675,48000,64036
2418,1677,741,704,111400,64037
2464,1843,621,631,117000,64040
1445,1333,112,600,186400,64048
9013,4774,4239,668,81600,64050
9098,5445,3653,808,77400,64052
2095,1084,1011,792,60800,64053
1695,973,722,712,71400,64054
14547,10575,3972,842,110100,64055
5977,3987,1990,763,99100,64056
6005,3477,2528,792,150900,64057
2326,1838,488,929,126700,64058
4695,3756,939,860,195300,64060
1264,1138,126,754,160600,64061
2168,1811,357,779,136200,64062
7536,4922,2614,922,147000,64063
6011,4894,1117,1075,243100,64064
10,0,10,625,-,64065
10,5,5,-,(X),64066
2335,1619,716,627,102900,64067
13619,10208,3411,824,163900,64068
1185,997,188,1036,205600,64070
329,293,36,629,80900,64071
99,71,28,842,59700,64072
304,229,75,863,120200,64074
4128,3038,1090,855,142100,64075
3612,2882,730,612,137800,64076
650,525,125,666,117100,64077
3529,3088,441,598,172300,64078
4897,3343,1554,963,210700,64079
4855,3689,1166,859,177200,64080
9205,6931,2274,1127,211700,64081
5038,4513,525,1234,239600,64082
8045,6566,1479,1099,178400,64083
579,561,18,811,146500,64084
3184,2119,1065,620,114300,64085
8137,6170,1967,939,170800,64086
472,396,76,848,158700,64088
4536,3714,822,792,192100,64089
39,28,11,404,75000,64090
0,0,0,-,-,64092
10391,5421,4970,705,150500,64093
375,224,151,494,90000,64096
552,437,115,766,117300,64097
1176,900,276,883,176300,64098
0,0,0,-,-,64101
0,0,0,-,-,64102
2807,374,2433,886,168600,64105
3504,643,2861,726,180000,64106
3847,1391,2456,879,166100,64108
4289,1750,2539,598,106500,64109
6318,3186,3132,762,134700,64110
9583,2243,7340,750,160300,64111
4871,1980,2891,883,287600,64112
4840,4537,303,1593,312900,64113
12190,7663,4527,922,153800,64114
7121,3262,3859,788,147300,64116
5891,3087,2804,752,98700,64117
16932,10320,6612,808,132300,64118
10577,8122,2455,872,123100,64119
144,100,44,875,21700,64120
3271,2016,1255,724,58400,64123
3811,1620,2191,690,57700,64124
614,289,325,734,42400,64125
2207,856,1351,756,46200,64126
6566,2532,4034,684,43000,64127
4731,2080,2651,738,43100,64128
3693,1835,1858,725,73600,64129
8431,4514,3917,773,55700,64130
9967,4902,5065,782,135700,64131
5538,2405,3133,762,59600,64132
14142,9321,4821,844,102200,64133
8307,4488,3819,886,87000,64134
988,365,623,845,141900,64136
4564,2468,2096,800,104600,64137
10144,6182,3962,772,98000,64138
464,399,65,871,277400,64139
2209,1750,459,989,219900,64145
581,469,112,553,141200,64146
165,0,165,498,-,64147
155,155,0,-,427500,64149
1285,395,890,657,178600,64150
10870,6599,4271,863,179400,64151
10373,7801,2572,906,208300,64152
2313,1268,1045,916,168100,64153
4231,2080,2151,972,218700,64154
8214,6232,1982,920,167100,64155
2337,1761,576,1022,226700,64156
5790,5468,322,1207,217900,64157
2090,990,1100,908,205500,64158
149,125,24,867,75200,64161
311,152,159,481,85000,64163
166,83,83,-,269900,64164
26,12,14,-,-,64165
95,95,0,-,312500,64166
131,131,0,-,329000,64167
0,0,0,-,-,64192
598,549,49,665,153600,64401
1070,806,264,519,76600,64402
26,19,7,-,77500,64420
291,250,41,611,110900,64421
88,71,17,-,104500,64422
360,308,52,656,81700,64423
1801,1218,583,565,83300,64424
154,110,44,491,70000,64426
305,209,96,435,89600,64427
338,258,80,520,65500,64428
3898,2229,1669,680,121200,64429
270,201,69,633,105100,64430
174,131,43,604,84700,64431
28,26,2,-,65000,64432
40,35,5,-,49400,64433
190,139,51,585,131900,64434
268,252,16,1278,162000,64436
283,213,70,633,72500,64437
97,89,8,713,146700,64438
594,501,93,718,144600,64439
253,216,37,614,122700,64440
92,90,2,-,109500,64441
322,251,71,622,83400,64442
396,307,89,625,173100,64443
599,513,86,540,146000,64444
137,92,45,579,64300,64445
468,322,146,550,73100,64446
400,345,55,881,140500,64448
193,170,23,755,60000,64449
224,146,78,460,72000,64451
76,59,17,-,69300,64453
928,714,214,794,155900,64454
166,142,24,325,57500,64455
586,436,150,350,56700,64456
91,71,20,850,89000,64457
64,57,7,-,72900,64458
218,218,0,-,127800,64459
344,232,112,570,69100,64461
674,499,175,602,86600,64463
1872,1386,486,734,140200,64465
221,154,67,475,65800,64466
64,46,18,-,78000,64467
5748,2441,3307,629,139300,64468
912,630,282,474,106200,64469
751,491,260,429,94200,64470
172,138,34,400,60000,64471
638,499,139,522,89500,64473
355,251,104,833,92100,64474
138,98,40,553,92500,64475
165,135,30,725,77500,64476
1399,1076,323,686,117500,64477
381,309,72,635,99700,64479
152,130,22,717,210000,64480
464,378,86,545,59500,64481
968,656,312,493,96700,64482
240,180,60,720,106500,64483
362,275,87,673,106600,64484
3217,2349,868,646,112400,64485
241,167,74,513,56500,64486
314,240,74,650,77300,64487
781,516,265,(X),87600,64489
899,663,236,777,124300,64490
839,582,257,545,70800,64491
740,586,154,827,174100,64492
193,177,16,-,117400,64493
345,291,54,375,104200,64494
29,22,7,425,(X),64496
143,136,7,444,131700,64497
170,109,61,579,51600,64498
31,30,1,-,43300,64499
4424,1990,2434,621,76500,64501
4990,3345,1645,755,99200,64503
3955,2717,1238,721,80300,64504
4999,3629,1370,732,115200,64505
9196,5412,3784,724,162300,64506
5004,3404,1600,755,102600,64507
4508,2992,1516,575,104100,64601
180,137,43,625,101400,64620
159,140,19,850,67100,64622
212,179,33,458,62500,64623
631,469,162,651,75100,64624
218,162,56,467,82900,64625
2257,1677,580,517,79500,64628
211,177,34,455,62100,64630
354,296,58,327,58100,64631
247,207,40,494,59700,64632
2042,1404,638,531,83100,64633
211,160,51,733,70800,64635
102,74,28,675,47700,64636
231,195,36,431,107800,64637
203,170,33,773,84300,64638
93,84,9,-,68000,64639
1242,969,273,561,118000,64640
262,206,56,379,77700,64641
426,340,86,708,61000,64642
482,413,69,488,91800,64643
1215,882,333,595,102400,64644
100,82,18,230,187500,64645
123,92,31,308,43600,64646
149,104,45,590,62000,64647
689,531,158,425,98200,64648
253,222,31,353,102300,64649
249,190,59,650,107900,64650
292,220,72,518,98000,64651
178,146,32,688,45700,64652
274,186,88,520,67500,64653
16,16,0,-,45600,64654
150,122,28,-,225600,64655
103,71,32,766,52100,64656
126,89,37,913,89000,64657
1225,854,371,510,80500,64658
327,250,77,575,103600,64659
183,148,35,531,69100,64660
415,287,128,546,73100,64661
208,182,26,788,143000,64664
156,126,30,520,57700,64667
616,490,126,492,81700,64668
416,328,88,600,112500,64670
832,606,226,706,117100,64671
92,78,14,-,62500,64672
918,705,213,448,74900,64673
185,150,35,284,59000,64674
91,83,8,-,50400,64676
264,214,50,460,64300,64679
70,52,18,756,60000,64681
133,119,14,-,41900,64682
3287,2232,1055,575,82600,64683
110,89,21,-,92400,64686
200,180,20,619,74500,64688
226,167,59,449,91900,64689
5669,3710,1959,858,148800,64701
1514,1151,363,688,119900,64720
148,117,31,733,81700,64722
256,224,32,490,81600,64723
804,571,233,498,91300,64724
907,705,202,774,129600,64725
156,125,31,1010,(X),64726
190,145,45,621,80400,64728
2852,1861,991,577,104800,64730
502,394,108,620,121900,64733
638,592,46,763,194600,64734
5811,4170,1641,685,106800,64735
451,389,62,410,75900,64738
323,272,51,600,158300,64739
835,699,136,569,74900,64740
112,102,10,585,(X),64741
947,685,262,723,157100,64742
97,68,29,573,80000,64743
3372,2226,1146,562,84500,64744
99,74,25,811,104400,64745
577,474,103,698,135900,64746
1490,1087,403,683,112900,64747
565,416,149,491,65800,64748
126,93,33,(X),97500,64750
278,208,70,660,92100,64752
966,761,205,592,85000,64755
246,197,49,661,77000,64756
3353,2443,910,550,102300,64759
580,471,109,704,103600,64761
688,461,227,495,65200,64762
608,475,133,525,72600,64763
17,16,1,-,16300,64765
226,177,49,-,131500,64767
214,170,44,505,61700,64769
461,353,108,513,82600,64770
296,253,43,535,66000,64771
5464,3398,2066,634,94000,64772
1588,1137,451,439,85000,64776
231,189,42,525,156300,64778
1001,789,212,475,71800,64779
263,206,57,500,164400,64780
40,30,10,-,38000,64781
286,223,63,525,53600,64783
504,422,82,607,70500,64784
635,486,149,615,90800,64788
285,199,86,552,87500,64790
15032,8297,6735,719,106600,64801
14366,9862,4504,692,121500,64804
282,207,75,475,80600,64830
2296,1681,615,605,94400,64831
255,227,28,1033,86400,64832
33,22,11,-,80000,64833
3506,2602,904,781,128100,64834
665,504,161,771,57600,64835
8553,5654,2899,677,112800,64836
1266,1024,242,534,113100,64840
185,173,12,725,94500,64841
282,180,102,447,66200,64842
1097,816,281,569,69400,64843
1730,1192,538,663,70500,64844
197,77,120,553,62200,64847
283,245,38,813,133100,64848
57,44,13,-,88900,64849
8902,6032,2870,601,100800,64850
1419,796,623,533,88700,64854
909,782,127,1032,108000,64855
1538,1197,341,711,104700,64856
126,108,18,858,85000,64857
30,0,30,-,-,64858
426,353,73,910,107200,64859
594,465,129,577,75100,64861
1067,710,357,595,84700,64862
515,258,257,507,77100,64863
2198,1713,485,739,106300,64865
533,385,148,671,110800,64866
580,416,164,673,53500,64867
5661,3726,1935,704,108300,64870
458,409,49,435,87800,64873
274,138,136,526,82900,64874
165,132,33,424,108800,65001
2516,1816,700,804,173200,65010
695,562,133,633,124400,65011
1377,848,529,576,88600,65013
860,614,246,619,124500,65014
522,465,57,657,149800,65016
441,441,0,-,(X),65017
3018,2086,932,539,122400,65018
5320,3952,1368,678,159600,65020
577,529,48,469,137700,65023
496,439,57,504,108700,65024
273,202,71,575,99400,65025
4452,3273,1179,638,111900,65026
651,610,41,-,112200,65032
186,116,70,(X),109800,65034
694,606,88,450,146800,65035
1995,1618,377,825,174500,65037
1105,1024,81,511,208000,65039
498,463,35,(X),180000,65040
2375,1768,607,583,129700,65041
3986,3058,928,683,131900,65043
447,386,61,438,129700,65046
555,391,164,757,110800,65047
63,63,0,-,103000,65048
2575,1972,603,727,234300,65049
242,205,37,625,172800,65050
1845,1320,525,481,123200,65051
1370,1109,261,714,201200,65052
514,462,52,1336,228400,65053
289,284,5,-,150700,65054
428,345,83,330,123000,65058
254,206,48,(X),122700,65059
313,282,31,758,59800,65061
0,0,0,-,-,65062
1363,1077,286,737,182400,65063
178,167,11,663,168800,65064
2639,1845,794,656,215700,65065
2750,2068,682,566,117600,65066
176,176,0,-,140000,65067
300,216,84,798,140900,65068
319,297,22,1075,114200,65069
639,492,147,705,176700,65072
1150,911,239,540,150700,65074
332,299,33,375,157300,65075
266,256,10,-,135200,65076
232,223,9,-,112900,65077
1373,1074,299,571,79200,65078
1711,1556,155,625,208300,65079
341,311,30,-,169700,65080
1145,805,340,495,88000,65081
409,354,55,621,119400,65082
105,105,0,-,75700,65083
2690,1917,773,624,93200,65084
451,364,87,523,153000,65085
10676,6962,3714,579,154300,65101
16140,10703,5437,628,144900,65109
14742,4545,10197,795,157100,65201
19242,11181,8061,837,146200,65202
23190,13941,9249,773,208200,65203
0,0,0,-,-,65215
322,271,51,555,(X),65230
1270,1015,255,585,84500,65231
111,82,29,655,58400,65232
4283,2863,1420,644,128500,65233
554,415,139,407,68900,65236
339,274,65,775,96400,65237
446,391,55,805,88000,65239
3295,2506,789,631,122800,65240
764,634,130,813,153300,65243
152,137,15,-,(X),65244
52,37,15,-,52500,65246
270,213,57,570,82300,65247
1462,1068,394,773,103700,65248
223,186,37,814,126900,65250
7293,4911,2382,628,119200,65251
701,587,114,486,90200,65254
1462,1222,240,805,154800,65255
670,572,98,572,165600,65256
615,515,100,594,49400,65257
160,127,33,440,109700,65258
917,766,151,571,92500,65259
227,216,11,575,100000,65260
411,275,136,461,57500,65261
334,187,147,677,151200,65262
709,547,162,586,87800,65263
247,191,56,489,165200,65264
5977,4009,1968,626,94500,65265
5897,3937,1960,664,85600,65270
793,522,271,550,94200,65274
1059,808,251,576,87900,65275
595,435,160,571,105600,65276
56,44,12,600,61100,65278
660,585,75,(X),223700,65279
81,57,24,675,28400,65280
1155,914,241,530,77900,65281
79,79,0,-,123200,65282
230,195,35,369,139600,65283
918,776,142,733,156300,65284
265,215,50,653,155100,65285
50,46,4,-,57100,65286
169,153,16,-,132200,65287
13390,8780,4610,689,99900,65301
777,7,770,941,-,65305
25,23,2,-,140600,65320
180,118,62,714,110500,65321
242,214,28,638,133300,65322
355,279,76,613,84400,65323
666,579,87,433,128800,65324
1390,1171,219,577,112100,65325
789,727,62,-,128600,65326
94,73,21,625,85600,65327
164,142,22,-,123900,65329
186,153,33,575,67800,65330
523,438,85,754,112500,65332
281,234,47,600,104200,65333
338,300,38,492,114400,65334
69,53,16,638,83200,65335
2323,1374,949,732,134600,65336
658,411,247,614,95900,65337
1129,848,281,566,97800,65338
288,229,59,575,63700,65339
5897,3733,2164,629,104800,65340
109,88,21,660,76700,65344
187,108,79,680,156500,65345
292,248,44,575,111300,65347
569,452,117,542,99400,65348
966,710,256,521,58300,65349
641,573,68,640,114100,65350
952,720,232,578,80000,65351
284,262,22,632,(X),65354
4781,3866,915,657,110400,65355
1855,1526,329,648,80700,65360
11868,6664,5204,664,124000,65401
22,22,0,-,115000,65436
1140,888,252,542,104100,65438
149,120,29,-,98200,65439
132,126,6,-,87200,65440
2032,1500,532,633,109900,65441
9,9,0,-,-,65443
359,339,20,671,102200,65444
164,147,17,-,96200,65446
110,95,15,-,68200,65449
1095,827,268,581,125700,65452
3220,2323,897,573,119700,65453
270,241,29,-,110400,65456
94,63,31,637,(X),65457
2750,2086,664,658,114100,65459
34,28,6,-,79200,65461
605,532,73,660,106500,65462
423,386,37,475,58400,65463
218,201,17,-,138400,65464
671,512,159,542,105500,65466
139,139,0,-,106000,65468
377,296,81,(X),128200,65470
2490,10,2480,1208,-,65473
123,62,61,-,(X),65479
1693,1127,566,533,113200,65483
59,48,11,-,(X),65484
1197,893,304,619,94600,65486
81,79,2,-,75800,65501
47,31,16,-,108900,65529
394,329,65,-,116400,65534
631,410,221,577,83600,65535
11233,7781,3452,591,102600,65536
36,23,13,-,(X),65541
2073,1412,661,495,79100,65542
134,134,0,-,156500,65543
2189,1438,751,492,91100,65548
1320,1041,279,488,85300,65550
708,598,110,1078,108000,65552
416,364,52,492,76500,65555
2086,1538,548,531,115500,65556
42,42,0,-,(X),65557
3411,2419,992,666,109300,65559
5512,3839,1673,512,88400,65560
110,69,41,-,60400,65564
2075,1626,449,571,106600,65565
280,186,94,643,74500,65566
541,430,111,375,104500,65567
246,222,24,(X),68800,65570
813,639,174,642,101100,65571
316,252,64,565,124600,65580
769,617,152,528,114800,65582
4124,2349,1775,921,155200,65583
4005,1589,2416,896,142300,65584
7,7,0,-,-,65586
1061,806,255,441,79800,65588
101,101,0,-,38500,65589
505,438,67,491,87600,65590
557,444,113,571,114900,65591
293,252,41,575,63100,65601
67,61,6,-,80500,65603
1512,1079,433,642,152600,65604
4622,3378,1244,631,89200,65605
1383,1042,341,471,70700,65606
3779,2704,1075,600,89900,65608
315,251,64,501,91800,65609
2176,1764,412,542,145200,65610
796,520,276,828,206900,65611
593,417,176,734,109100,65612
6742,3935,2807,655,128500,65613
235,187,48,526,113400,65614
10138,5071,5067,727,159700,65616
549,449,100,654,92600,65617
127,127,0,-,(X),65618
2999,2512,487,741,136600,65619
61,61,0,-,154200,65620
3248,2269,979,630,98000,65622
12,11,1,-,45000,65623
790,606,184,(X),136800,65624
2996,2204,792,580,109000,65625
684,499,185,333,91200,65626
251,231,20,-,113000,65627
254,222,32,707,110200,65629
128,127,1,-,356500,65630
1789,1459,330,843,124100,65631
928,670,258,653,108200,65632
1660,1231,429,575,122500,65633
331,257,74,580,107500,65634
261,239,22,619,98600,65635
566,468,98,530,97300,65637
181,147,34,427,67200,65638
338,305,33,-,73500,65640
459,340,119,599,155400,65641
1013,758,255,599,111600,65644
844,686,158,484,96700,65646
844,653,191,618,91500,65647
2372,1912,460,593,133300,65648
573,436,137,630,66500,65649
452,403,49,625,85300,65650
1332,1116,216,648,110500,65652
2405,1686,719,636,102300,65653
70,48,22,230,70000,65654
1475,1020,455,514,92200,65655
1992,1642,350,641,116800,65656
69,51,18,-,92100,65657
720,651,69,477,148100,65658
43,43,0,-,109700,65660
1080,829,251,545,68200,65661
504,425,79,522,75200,65662
880,711,169,470,116000,65663
42,19,23,563,70800,65664
1311,977,334,586,122100,65667
830,617,213,439,93500,65668
716,623,93,714,147000,65669
3581,2077,1504,644,133700,65672
1067,854,213,546,77600,65674
215,184,31,564,133300,65676
1045,672,373,564,118000,65679
621,494,127,848,104800,65680
768,580,188,563,147200,65681
867,616,251,629,83000,65682
259,213,46,381,66900,65685
1946,1604,342,733,166500,65686
1761,1256,505,413,111700,65689
93,74,19,-,135000,65690
518,411,107,542,76200,65692
198,193,5,-,65200,65702
1399,1012,387,407,106300,65704
1632,1069,563,633,90100,65705
5469,3768,1701,588,119200,65706
868,683,185,575,80700,65707
4517,3153,1364,560,128000,65708
399,298,101,456,87400,65710
4029,2682,1347,536,83200,65711
3267,2255,1012,567,119000,65712
927,722,205,515,88200,65713
11453,8077,3376,796,153500,65714
19,2,17,-,-,65715
937,676,261,533,95200,65717
188,168,20,-,86600,65720
11105,7859,3246,814,143000,65721
497,377,120,525,112500,65722
1321,982,339,577,100400,65723
725,596,129,734,87100,65724
1100,919,181,558,149000,65725
177,177,0,-,(X),65727
15,15,0,-,-,65728
146,107,39,-,66800,65729
27,27,0,-,-,65730
134,108,26,-,81100,65731
337,287,50,680,118200,65732
396,338,58,918,130400,65733
1122,901,221,562,97300,65734
55,46,9,-,178300,65735
3366,2639,727,682,168800,65737
6838,4677,2161,770,124100,65738
472,434,38,930,150800,65739
1356,928,428,641,71500,65740
4529,3363,1166,724,177800,65742
65,65,0,-,94200,65744
998,748,250,566,70500,65745
2469,1961,508,495,108600,65746
1662,1373,289,531,137500,65747
172,142,30,-,58400,65752
1983,1460,523,647,123800,65753
337,302,35,-,171900,65754
162,81,81,471,(X),65755
255,197,58,529,151400,65756
2717,2087,630,741,155300,65757
532,430,102,670,85500,65759
282,276,6,-,64200,65760
538,471,67,645,80300,65761
176,148,28,544,77900,65762
559,484,75,791,65900,65764
53,48,5,-,58400,65766
723,597,126,488,78700,65767
123,66,57,394,86300,65768
1078,825,253,736,106100,65769
1172,880,292,695,121100,65770
536,449,87,472,161400,65771
775,632,143,564,84600,65772
210,128,82,517,(X),65773
384,283,101,567,102200,65774
10249,6680,3569,587,113200,65775
171,132,39,-,54600,65777
224,163,61,585,78500,65778
912,751,161,505,96200,65779
3084,2323,761,729,135400,65781
58,58,0,-,73600,65783
9,3,6,-,-,65784
2174,1486,688,640,102600,65785
855,614,241,534,102200,65786
620,535,85,648,195000,65787
121,108,13,-,78300,65788
697,595,102,571,74800,65789
358,334,24,-,171200,65790
1776,1270,506,462,82800,65791
2511,1702,809,450,90200,65793
17787,9850,7937,659,100100,65802
17220,9288,7932,652,96800,65803
17919,10440,7479,699,142100,65804
5125,734,4391,569,65100,65806
23909,11447,12462,738,118000,65807
4558,4094,464,780,234500,65809
9031,6418,2613,827,187100,65810
4714,3260,1454,605,87700,66002
2697,2067,630,856,194000,66006
2129,1769,360,978,196800,66007
84,73,11,-,101600,66008
293,256,37,525,75700,66010
4186,3182,1004,766,184700,66012
733,692,41,-,298600,66013
116,62,54,-,(X),66014
347,273,74,545,71000,66015
91,91,0,-,77700,66016
152,134,18,313,60000,66017
2204,1347,857,727,202100,66018
74,0,74,674,-,66019
527,462,65,827,186700,66020
817,718,99,1071,128800,66021
564,417,147,525,103600,66023
357,235,122,703,58000,66024
2826,1919,907,895,160300,66025
228,214,14,870,182600,66026
1537,27,1510,1648,(X),66027
7850,5537,2313,927,165900,66030
0,0,0,-,-,66031
2100,1475,625,656,99900,66032
291,224,67,529,84800,66033
363,212,151,499,77500,66035
276,251,25,688,87500,66039
1530,1087,443,703,89900,66040
286,251,35,714,81800,66041
324,278,46,608,104600,66042
2989,2166,823,956,170300,66043
10443,4000,6443,740,145200,66044
0,0,0,-,-,66045
7874,3814,4060,819,155600,66046
7979,3880,4099,925,208300,66047
12876,7901,4975,778,135800,66048
11170,6506,4664,982,216100,66049
809,717,92,731,164400,66050
958,812,146,925,169300,66052
2930,2181,749,877,181500,66053
1302,1085,217,783,143100,66054
676,590,86,599,103400,66056
151,117,34,534,63100,66058
395,341,54,396,89900,66060
20695,14671,6024,803,192500,66061
26842,19894,6948,972,204700,66062
2296,1618,678,629,115400,66064
987,747,240,850,117600,66066
6196,4079,2117,748,115400,66067
1009,907,102,846,126900,66070
4787,3691,1096,690,162400,66071
478,449,29,796,121800,66072
969,807,162,765,153000,66073
922,640,282,610,84000,66075
772,648,124,649,148100,66076
403,324,79,688,155300,66078
200,183,17,825,155800,66079
350,270,80,743,105600,66080
3227,2704,523,896,185400,66083
2766,2563,203,1179,337200,66085
3743,2737,1006,796,185100,66086
860,649,211,525,85500,66087
976,748,228,604,116500,66088
1067,801,266,670,117300,66090
62,62,0,-,(X),66091
1466,1232,234,733,157100,66092
253,237,16,525,123600,66093
207,142,65,610,67500,66094
436,332,104,850,88900,66095
512,364,148,544,108900,66097
4631,1918,2713,630,51700,66101
10006,5052,4954,732,67400,66102
6058,2219,3839,759,84300,66103
9300,5585,3715,882,70600,66104
793,448,345,725,43300,66105
8506,5590,2916,745,88400,66106
8000,6666,1334,1096,150100,66109
3594,2672,922,902,99800,66111
5215,2574,2641,808,105900,66112
0,0,0,-,-,66115
0,0,0,-,-,66118
7848,3796,4052,852,148800,66202
8316,4825,3491,807,152200,66203
9042,4740,4302,867,137900,66204
6282,4860,1422,1064,181300,66205
3957,3677,280,1643,353500,66206
5786,4753,1033,1235,243900,66207
9276,7678,1598,1307,218700,66208
8394,5960,2434,1108,350000,66209
8456,4734,3722,1005,218000,66210
2149,1411,738,1178,480600,66211
14674,8732,5942,901,167900,66212
11245,7251,3994,1036,287000,66213
5338,2661,2677,786,180700,66214
10561,6895,3666,957,189700,66215
9092,7489,1603,1006,197200,66216
2235,1232,1003,803,302300,66217
2545,2227,318,1368,227400,66218
4714,2063,2651,1016,231800,66219
2678,2488,190,1059,378600,66220
5490,4210,1280,1088,388900,66221
8445,5609,2836,1176,264200,66223
4048,3754,294,992,427200,66224
4132,3658,474,980,239500,66226
1808,1672,136,1706,217100,66227
729,640,89,668,125000,66401
1196,969,227,658,158400,66402
295,257,38,580,114900,66403
175,131,44,383,151000,66404
221,147,74,330,82300,66406
199,133,66,850,143300,66407
200,156,44,431,89000,66408
1202,1092,110,1180,193600,66409
482,382,100,567,72700,66411
103,94,9,-,97800,66412
740,556,184,620,85100,66413
1092,776,316,544,94000,66414
339,289,50,356,92800,66415
193,174,19,(X),105600,66416
110,92,18,688,100000,66417
196,181,15,(X),148600,66418
189,168,21,(X),101600,66419
128,84,44,846,84000,66422
336,267,69,600,93800,66423
229,183,46,563,77000,66424
181,164,17,455,73300,66425
547,442,105,520,79000,66427
201,181,20,(X),110600,66428
206,206,0,-,135800,66429
243,220,23,625,93500,66431
149,113,36,540,68500,66432
2083,1355,728,502,100700,66434
2318,1656,662,572,121900,66436
108,108,0,-,80000,66438
1146,746,400,519,69000,66439
687,536,151,695,146800,66440
10530,4938,5592,950,133300,66441
3198,26,3172,1212,(X),66442
264,216,48,567,96700,66449
675,534,141,637,114000,66451
120,98,22,783,63000,66501
18246,7063,11183,827,170500,66502
5853,3719,2134,967,227400,66503
36,18,18,-,-,66506
423,387,36,1094,146800,66507
1922,1239,683,547,96800,66508
1080,778,302,728,135200,66509
303,238,65,691,89400,66510
1278,1085,193,691,123800,66512
561,419,142,618,191800,66514
177,148,29,633,82000,66515
141,122,19,(X),73300,66516
812,338,474,821,71900,66517
52,49,3,-,(X),66518
218,189,29,775,122000,66520
722,590,132,620,95000,66521
16,15,1,-,46100,66522
1599,1059,540,579,85700,66523
1014,839,175,862,149300,66524
271,235,36,648,117200,66526
97,66,31,590,105000,66527
390,298,92,577,106000,66528
530,431,99,669,136000,66531
225,192,33,731,80400,66532
597,434,163,805,117500,66533
1538,1072,466,564,110900,66534
1092,908,184,848,153600,66535
1185,895,290,593,144900,66536
487,409,78,728,88500,66537
1435,1157,278,455,119700,66538
1074,894,180,609,159900,66539
203,169,34,336,104900,66540
106,75,31,294,62500,66541
1279,1177,102,-,157300,66542
424,378,46,695,136000,66543
192,163,29,-,71700,66544
481,445,36,950,160700,66546
3023,2277,746,713,168200,66547
382,316,66,620,75500,66548
666,539,127,706,122000,66549
269,192,77,625,56500,66550
234,180,54,707,71600,66552
259,211,48,730,128800,66554
737,138,599,553,(X),66603
9841,5234,4607,699,97800,66604
7213,4767,2446,712,97600,66605
5206,2899,2307,747,79300,66606
3006,1605,1401,616,48400,66607
2168,1313,855,723,55200,66608
3168,1964,1204,640,115000,66609
3447,3271,176,1130,221300,66610
4469,2173,2296,845,104100,66611
1322,233,1089,464,48300,66612
13643,8580,5063,747,139100,66614
1358,872,486,863,156500,66615
2434,1784,650,592,66400,66616
3399,2823,576,806,152300,66617
3411,3000,411,810,153400,66618
873,362,511,981,75600,66619
30,8,22,-,-,66621
0,0,0,-,-,66622
4744,3120,1624,590,85000,66701
301,246,55,604,50000,66710
255,227,28,688,46300,66711
753,518,235,572,73600,66712
2018,1597,421,625,69400,66713
77,75,2,-,(X),66714
209,179,30,625,53300,66716
242,223,19,506,33400,66717
4641,3130,1511,583,68900,66720
440,367,73,578,67000,66724
2458,1753,705,548,85600,66725
0,0,0,-,-,66728
120,97,23,700,43200,66732
804,633,171,630,62100,66733
130,105,25,-,108900,66734
233,198,35,-,90700,66735
1544,1164,380,602,65900,66736
143,127,16,460,59400,66738
1891,1435,456,717,63300,66739
153,142,11,725,72000,66740
72,72,0,-,(X),66741
1519,1054,465,749,79100,66743
106,101,5,-,43600,66746
1007,747,260,535,79600,66748
3180,2158,1022,535,76200,66749
394,351,43,475,44800,66751
453,323,130,435,59600,66753
123,120,3,-,81700,66754
447,341,106,520,53300,66755
356,256,100,581,30300,66756
1350,893,457,593,63200,66757
78,66,12,663,31700,66758
0,0,0,-,-,66760
157,147,10,-,80400,66761
9586,5128,4458,681,92800,66762
1285,917,368,736,109400,66763
180,138,42,497,84400,66767
131,117,14,(X),43600,66769
463,385,78,631,78000,66770
362,312,50,655,98500,66771
113,103,10,-,75400,66772
315,254,61,650,53800,66773
74,64,10,713,134400,66775
443,365,78,609,74900,66776
294,230,64,375,34600,66777
0,0,0,-,-,66778
249,181,68,396,74400,66779
219,204,15,-,55000,66780
452,350,102,818,60000,66781
94,72,22,675,32700,66782
1036,796,240,561,52400,66783
11189,6248,4941,599,95600,66801
79,70,9,-,(X),66830
219,182,37,738,62700,66833
317,250,67,638,88000,66834
496,415,81,550,89700,66835
80,78,2,-,51000,66838
1646,1165,481,579,109900,66839
323,251,72,594,76700,66840
129,87,42,610,58300,66842
108,80,28,-,(X),66843
461,369,92,411,68700,66845
1442,1070,372,569,89000,66846
165,140,25,692,86700,66849
81,56,25,713,(X),66850
273,178,95,512,35700,66851
249,198,51,425,70000,66852
163,138,25,495,33400,66853
365,233,132,694,57000,66854
656,540,116,594,104400,66856
440,318,122,656,91000,66857
225,181,44,582,64700,66858
89,77,12,-,59500,66859
634,480,154,601,69600,66860
1257,1046,211,584,86500,66861
50,38,12,442,64500,66862
20,16,4,-,(X),66863
160,132,28,(X),64200,66864
505,413,92,588,118100,66865
659,459,200,571,66800,66866
324,259,65,525,78700,66868
301,202,99,531,70000,66869
51,42,9,-,33600,66870
564,482,82,547,88600,66871
445,322,123,730,85600,66872
119,115,4,-,78300,66873
2679,1818,861,611,76100,66901
104,104,0,-,43800,66930
69,62,7,-,84300,66932
136,126,10,-,65600,66933
1120,823,297,412,49500,66935
155,144,11,725,37200,66936
328,278,50,410,58800,66937
463,378,85,504,77000,66938
279,225,54,536,58400,66939
154,137,17,625,52500,66940
86,75,11,633,28800,66941
102,70,32,492,65000,66942
227,184,43,466,49100,66943
64,46,18,478,25000,66944
392,330,62,529,77100,66945
52,44,8,-,110900,66946
226,187,39,443,63100,66948
352,275,77,395,56900,66949
337,266,71,432,60000,66951
203,174,29,525,39300,66952
270,207,63,358,72600,66953
44,32,12,-,116700,66955
520,414,106,519,52600,66956
142,120,22,-,21300,66958
133,110,23,725,24300,66959
73,58,15,471,17500,66960
122,101,21,477,71000,66962
82,64,18,-,28300,66963
89,78,11,(X),50000,66964
290,232,58,538,57900,66966
885,703,182,477,70100,66967
758,567,191,419,81900,66968
67,67,0,-,84200,66970
439,393,46,750,200600,67001
5149,4134,1015,1011,173900,67002
1165,877,288,655,63600,67003
306,222,84,627,87200,67004
6298,4017,2281,634,78100,67005
210,160,50,768,63600,67008
355,270,85,572,55500,67009
5287,3523,1764,711,122500,67010
11,11,0,-,-,67012
1048,769,279,769,79700,67013
179,154,25,792,104300,67016
840,689,151,1028,169900,67017
46,39,7,-,81000,67018
409,345,64,558,79200,67019
706,517,189,644,98500,67020
22,17,5,-,77500,67021
681,526,155,504,55300,67022
89,81,8,533,56500,67023
332,237,95,528,42700,67024
1353,1150,203,703,141000,67025
1757,1447,310,683,154700,67026
108,89,19,-,(X),67028
434,310,124,526,61700,67029
903,791,112,1033,166700,67030
922,727,195,517,108300,67031
416,308,108,(X),85500,67035
40,33,7,-,75000,67036
10524,7653,2871,875,157700,67037
243,211,32,486,71200,67038
1277,1031,246,669,116400,67039
105,86,19,-,104200,67041
6346,4059,2287,692,100100,67042
1481,1089,392,512,57900,67045
361,305,56,636,50300,67047
28,28,0,-,(X),67049
606,516,90,684,150900,67050
180,147,33,541,61600,67051
2680,2240,440,996,169300,67052
242,180,62,397,82900,67053
565,329,236,494,162100,67054
57,36,21,-,"10,000-",67055
1074,842,232,594,119300,67056
95,72,23,338,57500,67057
779,597,182,591,81900,67058
383,268,115,446,82800,67059
5152,4052,1100,868,109600,67060
78,68,10,525,(X),67061
1686,1246,440,497,145700,67062
1305,1043,262,576,94100,67063
71,57,14,-,(X),67065
146,141,5,663,92900,67066
631,610,21,875,158300,67067
1674,1155,519,628,84400,67068
454,330,124,541,78500,67070
69,57,12,-,122100,67071
101,61,40,717,49400,67072
123,99,24,479,59800,67073
720,596,124,675,96700,67074
1138,941,197,873,142700,67101
81,74,7,-,110700,67103
1046,731,315,626,82000,67104
84,68,16,-,(X),67105
64,64,0,-,126900,67106
1130,896,234,474,127700,67107
585,460,125,697,98000,67108
170,118,52,544,87100,67109
3066,2630,436,784,128700,67110
84,72,12,-,116700,67111
98,70,28,400,58000,67112
8738,5865,2873,733,105600,67114
649,388,261,562,148400,67117
261,204,57,906,100700,67118
592,457,135,463,93200,67119
566,527,39,-,160400,67120
57,44,13,-,210000,67122
285,212,73,725,80000,67123
3355,2185,1170,634,86700,67124
296,265,31,394,62700,67127
116,91,25,365,40900,67131
150,143,7,-,106800,67132
2324,1893,431,892,147300,67133
136,115,21,688,71000,67134
1215,998,217,797,123400,67135
288,263,25,538,51200,67137
115,107,8,-,77500,67138
309,243,66,656,59000,67140
177,132,45,(X),77300,67142
18,18,0,-,18500,67143
1002,844,158,741,126400,67144
775,615,160,651,87500,67146
3533,2972,561,759,147300,67147
342,331,11,656,201200,67149
19,9,10,-,17900,67150
213,195,18,625,87000,67151
3687,2730,957,647,76400,67152
452,351,101,729,108200,67154
72,47,25,-,(X),67155
5507,3720,1787,663,91600,67156
67,53,14,-,39600,67159
912,39,873,814,278100,67202
13023,6448,6575,663,94000,67203
7810,5844,1966,639,103600,67204
5458,4808,650,926,215500,67205
6969,4658,2311,785,238300,67206
11269,5654,5615,757,131300,67207
7310,4138,3172,757,109400,67208
5160,3829,1331,723,141000,67209
3350,1410,1940,616,123400,67210
8223,3805,4418,653,68900,67211
18142,12273,5869,776,134700,67212
8528,3952,4576,660,65100,67213
6148,2169,3979,582,47800,67214
2010,1877,133,1253,137000,67215
9111,5694,3417,692,67100,67216
11040,7224,3816,729,80700,67217
9643,4617,5026,674,84900,67218
4323,2981,1342,811,90300,67219
5832,3592,2240,728,133100,67220
189,177,12,-,283500,67223
7809,4583,3226,914,191000,67226
91,91,0,-,166000,67227
598,598,0,-,307500,67228
3390,3243,147,1513,278000,67230
108,108,0,-,208800,67232
4006,3831,175,1585,215500,67235
0,0,0,-,-,67260
4997,3366,1631,643,79300,67301
645,500,145,581,89000,67330
76,62,14,504,65000,67332
1178,863,315,681,70200,67333
36,33,3,-,26500,67334
1347,1038,309,679,74100,67335
662,448,214,622,53700,67336
5117,3422,1695,579,65100,67337
164,126,38,668,43500,67340
93,86,7,-,75000,67341
388,335,53,413,82400,67342
331,287,44,663,60700,67344
68,64,4,-,155400,67345
156,139,17,393,81100,67346
199,186,13,841,56200,67347
502,356,146,438,49200,67349
221,209,12,-,69100,67351
243,188,55,661,44000,67352
264,207,57,582,42800,67353
281,201,80,532,83500,67354
66,57,9,675,52300,67355
1083,836,247,538,59000,67356
5117,3268,1849,568,66700,67357
180,142,38,526,46300,67360
849,682,167,667,56100,67361
17,17,0,-,-,67363
166,109,57,576,85000,67364
20715,13340,7375,692,121700,67401
4129,2975,1154,605,121900,67410
487,398,89,631,154200,67416
84,74,10,-,67200,67417
67,64,3,-,56700,67418
1903,1302,601,542,99800,67420
489,430,59,719,121300,67422
137,100,37,608,62000,67423
297,248,49,475,104700,67425
209,157,52,598,56600,67427
605,508,97,714,112200,67428
300,245,55,533,55700,67430
980,703,277,643,145400,67431
2432,1994,438,527,93300,67432
345,300,45,560,58400,67436
565,419,146,438,72600,67437
132,103,29,633,66500,67438
1339,997,342,569,99800,67439
427,311,116,950,80700,67441
101,94,7,-,168200,67442
658,540,118,671,153300,67443
270,214,56,434,56000,67444
263,212,51,572,53700,67445
291,214,77,442,81300,67446
123,96,27,733,112500,67447
521,428,93,645,140000,67448
1239,920,319,630,66300,67449
239,195,44,640,60200,67450
374,276,98,800,79200,67451
112,89,23,461,58500,67452
233,207,26,615,75300,67454
802,638,164,525,68100,67455
1761,1231,530,675,157000,67456
340,242,98,566,75600,67457
130,102,28,656,(X),67458
126,90,36,610,56400,67459
6336,4679,1657,690,132000,67460
438,353,85,581,83100,67464
363,287,76,473,50900,67466
1116,851,265,598,86300,67467
71,65,6,750,56400,67468
207,171,36,1028,126600,67470
810,597,213,460,62200,67473
108,82,26,773,60800,67474
98,81,17,575,(X),67475
39,38,1,-,(X),67478
742,634,108,626,108900,67480
269,214,55,850,56000,67481
29,29,0,-,(X),67482
117,97,20,658,66800,67483
350,304,46,519,74100,67484
143,119,24,331,71700,67485
533,418,115,808,136600,67487
461,329,132,673,65300,67490
197,161,36,824,113500,67491
101,81,20,775,(X),67492
9614,5457,4157,598,66300,67501
10217,7480,2737,760,128000,67502
1107,633,474,512,91000,67505
129,113,16,(X),70700,67510
178,168,10,500,79000,67511
83,65,18,-,60500,67512
20,17,3,-,31900,67513
329,257,72,711,55500,67514
31,22,9,-,16700,67515
187,164,23,450,57100,67516
29,21,8,-,154200,67518
106,55,51,513,27000,67519
147,127,20,442,75000,67520
61,54,7,-,(X),67521
788,607,181,689,119500,67522
143,109,34,381,49700,67523
272,224,48,485,23700,67524
429,335,94,570,73000,67525
1248,949,299,533,70500,67526
154,121,33,(X),67200,67529
7963,5141,2822,596,85200,67530
782,631,151,732,94200,67543
1283,870,413,665,75300,67544
95,78,17,(X),62500,67545
1041,857,184,713,141800,67546
748,586,162,500,57500,67547
680,489,191,519,72200,67548
2150,1468,682,432,78900,67550
272,215,57,475,55400,67552
67,65,2,-,45000,67553
1620,1235,385,517,80900,67554
146,115,31,817,51400,67556
237,185,52,518,42500,67557
23,17,6,-,114200,67559
782,595,187,584,74400,67560
551,393,158,648,65400,67561
145,128,17,550,69000,67563
114,92,22,550,64500,67564
210,179,31,504,47600,67565
229,158,71,932,67700,67566
204,158,46,438,49500,67567
102,87,15,900,90800,67568
563,462,101,721,84500,67570
205,166,39,464,53300,67572
76,56,20,714,70000,67573
106,81,25,446,51200,67574
197,170,27,625,60600,67575
777,644,133,615,80100,67576
602,510,92,500,59500,67578
1104,818,286,479,87600,67579
121,103,18,363,35600,67581
367,296,71,515,47100,67583
144,107,37,542,34800,67584
9812,5890,3922,641,157500,67601
168,132,36,350,55000,67621
356,252,104,559,67200,67622
114,96,18,464,29500,67623
154,121,33,469,41500,67625
82,78,4,-,66700,67626
26,20,6,-,55000,67628
105,71,34,-,(X),67629
105,96,9,538,72500,67631
101,77,24,492,89200,67632
140,110,30,(X),38100,67634
67,61,6,-,34100,67635
1173,927,246,591,96500,67637
117,92,25,(X),60800,67638
88,81,7,-,78300,67639
245,174,71,613,70000,67640
774,609,165,478,73500,67642
113,86,27,475,42500,67643
113,84,29,683,56700,67644
287,243,44,553,64000,67645
308,244,64,467,63200,67646
123,84,39,400,71400,67647
261,197,64,507,59600,67648
144,105,39,363,52100,67649
105,75,30,425,47200,67650
232,174,58,458,29800,67651
138,127,11,(X),44400,67653
1396,1081,315,863,73800,67654
31,20,11,-,73300,67656
157,117,40,363,69100,67657
87,57,30,-,77500,67658
81,81,0,-,57000,67659
22,17,5,-,86300,67660
1372,1044,328,507,79400,67661
1141,819,322,548,77500,67663
161,123,38,663,68800,67664
2281,1709,572,552,86700,67665
75,70,5,550,87500,67667
733,571,162,504,59200,67669
727,597,130,576,132100,67671
1079,819,260,550,90600,67672
51,45,6,-,62800,67673
21,13,8,-,(X),67674
90,85,5,-,31300,67675
2677,1825,852,456,111400,67701
767,580,187,614,79900,67730
290,225,65,647,64400,67731
192,151,41,613,81900,67732
49,43,6,-,88800,67733
94,40,54,570,46400,67734
2605,1487,1118,644,76400,67735
101,74,27,-,70000,67736
233,194,39,617,72900,67737
244,211,33,513,73300,67738
111,88,23,561,48000,67739
757,570,187,470,92100,67740
106,74,32,525,61300,67741
64,38,26,-,82500,67743
95,61,34,-,90500,67744
154,113,41,435,63500,67745
99,96,3,-,(X),67747
1018,743,275,686,86600,67748
1147,853,294,547,61500,67749
117,94,23,-,66000,67751
554,414,140,570,79100,67752
184,124,60,563,73300,67753
963,779,184,539,87600,67756
236,200,36,338,94000,67757
406,310,96,391,69000,67758
87,71,16,-,66100,67761
147,105,42,421,88700,67762
226,136,90,500,52900,67764
9800,5878,3922,666,99500,67801
462,351,111,541,55100,67831
379,293,86,633,83800,67834
985,649,336,668,114500,67835
49,34,15,-,50000,67836
320,220,100,525,97900,67837
359,296,63,663,72100,67838
639,508,131,482,67100,67839
43,35,8,-,24200,67840
150,138,12,-,85000,67841
184,136,48,529,62900,67842
157,0,157,441,-,67843
308,232,76,559,85200,67844
11583,7044,4539,689,116400,67846
161,133,28,375,63100,67849
177,117,60,675,61300,67850
831,658,173,578,139500,67851
340,244,96,666,99100,67853
595,416,179,588,84200,67854
701,552,149,563,76700,67855
63,50,13,-,185000,67857
239,189,50,661,78500,67859
991,711,280,624,101800,67860
655,493,162,641,69100,67861
125,94,31,625,(X),67862
119,64,55,461,72500,67863
884,648,236,634,81600,67864
437,269,168,760,78600,67865
593,434,159,635,127600,67867
120,101,19,-,76300,67868
541,353,188,761,99700,67869
487,341,146,730,89900,67870
2222,1609,613,792,125600,67871
449,381,68,582,119700,67876
823,646,177,693,121800,67877
886,635,251,558,84400,67878
487,348,139,810,84500,67879
2736,2126,610,570,98800,67880
132,102,30,703,158300,67882
7181,4823,2358,665,87300,67901
926,660,266,602,100300,67950
1766,1330,436,648,97300,67951
226,157,69,585,76300,67952
58,44,14,-,121700,67953
237,150,87,548,83200,67954
63,60,3,-,80000,68001
801,667,134,841,163700,68002
1762,1254,508,764,167900,68003
351,270,81,539,84800,68004
9572,5524,4048,785,127500,68005
3036,2684,352,855,203700,68007
4936,3768,1168,670,165600,68008
18,0,18,-,-,68010
130,125,5,-,103500,68014
444,342,102,808,113400,68015
193,164,29,1208,228800,68016
605,498,107,738,132800,68017
234,213,21,475,148300,68018
198,170,28,696,76700,68019
336,255,81,463,58700,68020
7001,5462,1539,854,269000,68022
963,834,129,656,255700,68023
12368,7931,4437,705,121600,68025
3923,3284,639,871,216500,68028
382,271,111,713,120300,68029
346,261,85,781,108600,68030
783,634,149,575,120500,68031
155,139,16,1000,154200,68033
351,307,44,1349,211400,68034
143,108,35,722,74300,68036
728,572,156,730,160700,68037
579,470,109,511,86200,68038
272,83,189,453,36300,68039
143,140,3,-,125800,68040
400,320,80,673,120500,68041
32,27,5,875,85000,68042
244,209,35,764,109300,68044
729,579,150,629,89100,68045
9592,7106,2486,772,183500,68046
683,542,141,621,101800,68047
4869,3783,1086,725,157400,68048
287,227,60,675,98900,68050
110,87,23,595,40600,68055
721,545,176,538,87100,68057
148,139,9,-,272500,68058
1139,1022,117,448,178100,68059
932,728,204,624,96100,68061
129,110,19,550,88600,68062
118,97,21,410,59700,68063
1515,958,557,785,142800,68064
566,458,108,758,173900,68065
2152,1532,620,582,156900,68066
363,240,123,515,33200,68067
28,28,0,-,120000,68068
1183,937,246,1162,218300,68069
256,223,33,1023,149000,68070
511,203,308,518,57100,68071
18,10,8,-,50000,68072
688,609,79,1018,149500,68073
2931,393,2538,868,252300,68102
13687,8134,5553,771,98600,68104
9504,4074,5430,676,113100,68105
9494,5756,3738,809,125300,68106
9354,5509,3845,729,89400,68107
5071,2674,2397,747,83000,68108
2891,1390,1501,743,69800,68110
8038,3391,4647,791,64900,68111
4238,3011,1227,794,91700,68112
193,0,193,1010,-,68113
8120,4061,4059,872,161300,68114
10356,8350,2006,1008,204400,68116
3132,2335,797,946,107800,68117
3309,2849,460,1080,243600,68118
4072,3265,807,991,138900,68122
11144,6590,4554,990,165400,68123
6513,4256,2257,951,165800,68124
9704,4481,5223,752,141600,68127
7476,4350,3126,886,147900,68128
7220,5589,1631,1212,241100,68130
5510,1499,4011,647,104000,68131
6274,3137,3137,672,211100,68132
3365,3118,247,1136,231000,68133
12320,6514,5806,752,128900,68134
8968,8188,780,1338,207700,68135
5124,4528,596,1112,208000,68136
10163,6961,3202,960,139400,68137
4606,3367,1239,733,137600,68138
1248,1077,171,1109,181100,68142
10203,7081,3122,798,154000,68144
3781,2608,1173,851,118100,68147
2455,1903,552,778,170100,68152
9986,5880,4106,821,188300,68154
2197,1768,429,834,137600,68157
11440,7401,4039,923,143900,68164
0,0,0,-,-,68178
511,417,94,755,177700,68301
121,112,9,-,47000,68303
142,122,20,940,248000,68304
1732,1137,595,639,124200,68305
138,105,33,496,109700,68307
47,36,11,-,40000,68309
6109,3940,2169,616,105300,68310
323,253,70,600,132000,68313
252,204,48,1099,115000,68314
55,54,1,-,74400,68315
187,151,36,588,87100,68316
605,560,45,921,162000,68317
205,172,33,613,60000,68318
228,190,38,575,125000,68319
149,117,32,517,59300,68320
147,135,12,-,102400,68321
187,163,24,517,64400,68322
120,104,16,(X),114400,68323
78,27,51,624,80500,68324
94,81,13,668,52300,68325
109,81,28,565,64600,68326
145,130,15,429,48200,68327
201,178,23,592,113800,68328
251,184,67,563,69000,68329
360,307,53,642,151300,68331
47,44,3,-,(X),68332
3021,1707,1314,720,106100,68333
199,160,39,375,56500,68335
154,138,16,-,176900,68336
151,132,19,525,75700,68337
140,121,19,417,69800,68338
443,409,34,950,256200,68339
361,254,107,392,55900,68340
386,328,58,675,96500,68341
182,165,17,600,101900,68342
367,281,86,704,107600,68343
173,151,22,950,129800,68344
123,111,12,850,49000,68345
182,129,53,530,132100,68346
843,774,69,1080,170300,68347
139,108,31,595,(X),68348
442,395,47,730,149800,68349
91,86,5,-,55000,68350
364,281,83,621,78100,68351
2384,1714,670,484,66300,68352
367,288,79,516,64000,68354
2321,1679,642,465,83000,68355
153,139,14,1078,123400,68357
584,519,65,575,234000,68358
606,526,80,619,104800,68359
229,188,41,1292,163900,68360
1076,748,328,553,79700,68361
26,26,0,-,(X),68362
43,32,11,588,114300,68364
94,88,6,-,73300,68365
430,347,83,984,132700,68366
172,141,31,638,82300,68367
190,142,48,857,204500,68368
1049,786,263,481,80300,68370
633,549,84,(X),110100,68371
1091,871,220,831,162200,68372
50,49,1,-,(X),68375
654,468,186,437,54100,68376
185,144,41,975,74700,68377
289,253,36,492,94600,68378
42,38,4,-,45000,68379
49,29,20,-,36300,68380
84,71,13,-,58100,68381
14,13,1,-,58300,68382
265,201,64,702,137900,68401
468,398,70,943,218300,68402
67,57,10,681,121500,68403
412,376,36,1076,237700,68404
1219,785,434,642,150100,68405
229,182,47,515,73000,68406
298,231,67,625,150500,68407
293,255,38,875,142700,68409
3610,2510,1100,637,105900,68410
239,203,36,682,111700,68413
135,110,25,563,39100,68414
269,250,19,517,107900,68415
98,81,17,580,32500,68416
127,122,5,675,164300,68417
478,414,64,845,124600,68418
116,73,43,686,126000,68419
621,420,201,455,64500,68420
330,205,125,514,72000,68421
202,156,46,726,134800,68422
377,355,22,650,194500,68423
322,270,52,601,102100,68424
455,435,20,550,279500,68428
550,520,30,1107,273900,68430
180,159,21,-,56900,68431
84,56,28,513,(X),68433
3092,2104,988,640,145100,68434
256,207,49,713,84500,68436
126,100,26,550,71500,68437
59,49,10,692,103100,68438
176,108,68,626,122700,68439
61,52,9,388,65000,68440
106,106,0,-,75000,68441
162,147,15,642,53000,68442
442,344,98,596,93300,68443
24,20,4,675,85000,68444
42,38,4,600,47500,68445
1152,824,328,660,132600,68446
242,210,32,489,68300,68447
160,120,40,653,58600,68448
1018,720,298,588,74700,68450
51,48,3,-,32500,68452
127,89,38,846,46700,68453
228,184,44,629,97700,68454
292,263,29,708,216400,68455
456,332,124,818,137500,68456
136,121,15,461,51600,68457
70,61,9,517,95000,68458
349,288,61,595,118500,68460
195,146,49,-,450000,68461
1490,1210,280,609,162600,68462
617,478,139,655,136700,68463
212,160,52,565,59400,68464
808,552,256,606,95800,68465
798,629,169,572,61200,68466
3799,2358,1441,616,124600,68467
11044,5716,5328,585,135400,68502
6078,1869,4209,674,95200,68503
7686,2546,5140,739,101000,68504
6911,4084,2827,747,131100,68505
12919,7823,5096,845,151400,68506
5946,4332,1614,672,119300,68507
4570,494,4076,497,84500,68508
9522,5208,4314,624,139000,68510
4883,3236,1647,874,199000,68512
73,32,41,-,280800,68514
15672,11794,3878,837,203000,68516
175,175,0,-,244500,68517
558,475,83,979,269600,68520
12656,7595,5061,815,142600,68521
4307,3117,1190,859,144000,68522
493,448,45,-,287200,68523
1982,1179,803,799,122900,68524
1954,1747,207,993,278900,68526
297,297,0,-,338700,68527
2583,1330,1253,818,132900,68528
39,39,0,-,445800,68531
234,220,14,-,327700,68532
11156,7973,3183,669,128900,68601
1141,886,255,525,119900,68620
203,175,28,-,151600,68621
143,108,35,588,88000,68622
140,116,24,533,32100,68623
489,416,73,767,125000,68624
296,246,50,656,108300,68626
250,232,18,604,54200,68627
366,261,105,533,67100,68628
603,496,107,469,82400,68629
180,145,35,618,119200,68631
1650,1164,486,617,95700,68632
507,421,86,540,80400,68633
170,144,26,925,93000,68634
183,136,47,778,102400,68635
533,419,114,604,79200,68636
157,119,38,525,73500,68637
774,590,184,555,75300,68638
599,438,161,523,85800,68640
415,333,82,531,85300,68641
665,550,115,580,126200,68642
427,327,100,516,89100,68643
309,244,65,570,117800,68644
229,203,26,580,83100,68647
206,196,10,538,235700,68648
753,607,146,640,116800,68649
592,487,105,559,104000,68651
323,253,70,564,59300,68652
277,218,59,(X),91700,68653
227,182,45,425,60800,68654
58,49,9,763,45600,68655
280,247,33,809,103500,68658
71,69,2,-,129300,68659
515,374,141,575,77800,68660
2186,1500,686,621,89900,68661
515,380,135,607,100000,68662
312,263,49,680,85000,68663
141,97,44,567,64600,68664
380,324,56,488,72600,68665
604,453,151,596,102800,68666
62,60,2,-,100000,68667
186,166,20,675,88000,68669
12242,7891,4351,618,122700,68701
293,241,52,555,85700,68710
94,94,0,-,69300,68711
924,687,237,653,90200,68713
563,408,155,615,77300,68714
552,455,97,681,125200,68715
408,283,125,533,70700,68716
89,84,5,-,110000,68717
842,594,248,621,76900,68718
55,47,8,-,46900,68719
124,87,37,556,85800,68720
259,199,60,472,49600,68722
209,161,48,565,85600,68723
53,49,4,-,67500,68724
226,193,33,583,71500,68725
335,295,40,480,100600,68726
339,276,63,475,77700,68727
93,79,14,(X),64200,68728
834,637,197,581,79900,68729
730,608,122,552,137200,68730
1039,849,190,687,115700,68731
78,55,23,917,67000,68732
557,391,166,513,84400,68733
48,35,13,-,108800,68734
381,262,119,518,69400,68735
231,183,48,506,156900,68736
1205,982,223,502,116200,68739
306,269,37,796,138800,68740
309,266,43,904,131300,68741
100,54,46,624,30400,68742
241,213,28,688,149600,68743
675,500,175,650,98500,68745
207,177,30,392,35300,68746
53,46,7,425,98300,68747
1125,776,349,690,87300,68748
27,24,3,-,54000,68749
24,20,4,-,58300,68751
352,306,46,538,95000,68752
34,29,5,-,131300,68753
113,90,23,663,113100,68755
846,622,224,531,81900,68756
335,278,57,625,91900,68757
485,381,104,524,78600,68758
142,118,24,540,47700,68759
549,306,243,312,64200,68760
169,132,37,333,26500,68761
2144,1467,677,650,109200,68763
304,213,91,438,49900,68764
581,463,118,526,95200,68765
188,157,31,510,84500,68766
1307,1009,298,585,107200,68767
249,195,54,654,79500,68768
737,575,162,613,69100,68769
618,482,136,719,99500,68770
593,486,107,654,94300,68771
81,51,30,-,82200,68773
145,121,24,845,107800,68774
5115,3008,2107,683,107000,68776
338,273,65,391,57500,68777
238,159,79,621,64500,68778
1013,813,200,524,98700,68779
434,324,110,489,114000,68780
670,457,213,501,90900,68781
434,332,102,575,76800,68783
769,554,215,589,74500,68784
92,79,13,-,107300,68785
446,363,83,564,78300,68786
2446,1324,1122,521,118800,68787
1981,1378,603,565,117500,68788
73,69,4,-,56600,68789
296,214,82,589,88500,68790
745,511,234,682,93200,68791
171,147,24,395,65500,68792
11054,6380,4674,671,98200,68801
9103,5791,3312,649,147700,68803
373,282,91,458,73600,68810
267,216,51,517,113300,68812
256,200,56,420,81500,68813
411,297,114,612,58600,68814
252,170,82,472,92500,68815
72,66,6,-,138900,68816
155,145,10,388,69100,68817
2154,1601,553,692,105400,68818
129,99,30,575,45300,68820
55,31,24,-,58100,68821
2015,1394,621,585,97800,68822
1011,779,232,343,93800,68823
487,366,121,673,132800,68824
461,344,117,528,112500,68825
1768,1197,571,547,81500,68826
254,210,44,640,137500,68827
128,102,26,597,(X),68828
310,273,37,635,105500,68831
782,639,143,850,165100,68832
175,89,86,825,110200,68833
139,66,73,672,72500,68834
234,177,57,653,97500,68835
608,465,143,645,99500,68836
56,37,19,-,101800,68837
111,101,10,713,57200,68838
1110,774,336,729,123300,68840
245,223,22,700,109400,68841
227,163,64,506,54600,68842
322,270,52,495,107000,68843
94,92,2,-,115000,68844
7505,4358,3147,744,178500,68845
140,113,27,625,85400,68846
7054,4359,2695,719,143600,68847
0,0,0,-,-,68849
3927,2450,1477,666,81900,68850
278,227,51,655,89100,68852
690,490,200,511,81900,68853
353,303,50,875,122800,68854
185,150,35,733,75000,68855
240,172,68,585,75900,68856
127,96,31,600,82700,68858
259,195,64,391,77000,68859
137,119,18,925,62100,68860
29,27,2,-,87900,68861
1338,966,372,494,87400,68862
452,349,103,677,102400,68863
486,346,140,650,95000,68864
363,338,25,692,138500,68865
338,295,43,679,198400,68866
834,615,219,572,110800,68869
191,162,29,678,200000,68870
103,78,25,-,116700,68871
339,323,16,700,121200,68872
1384,1006,378,527,114100,68873
434,340,94,420,59600,68874
264,211,53,490,75000,68875
618,468,150,525,98800,68876
155,104,51,713,79500,68878
170,123,47,494,72200,68879
25,12,13,-,125000,68881
188,151,37,607,37800,68882
884,690,194,562,131600,68883
10619,7068,3551,620,100500,68901
654,494,160,542,86400,68920
548,408,140,659,70900,68922
39,35,4,-,67500,68923
473,401,72,583,125600,68924
212,174,38,681,160900,68925
441,284,157,413,42700,68926
533,366,167,778,103400,68927
174,147,27,536,84200,68928
75,62,13,-,40000,68929
568,449,119,394,109100,68930
167,149,18,679,45900,68932
406,318,88,486,75600,68933
49,37,12,-,36400,68934
293,227,66,539,70800,68935
115,92,23,(X),47500,68936
688,520,168,695,112400,68937
218,194,24,514,70000,68938
539,438,101,633,51800,68939
253,213,40,750,136400,68940
331,272,59,1000,94300,68941
197,151,46,513,44400,68942
109,86,23,425,35000,68943
431,308,123,525,73600,68944
124,83,41,716,(X),68945
19,13,6,-,41000,68946
299,242,57,525,83400,68947
132,98,34,594,46000,68948
2627,1840,787,564,109700,68949
186,130,56,517,81700,68950
54,42,12,-,(X),68952
35,21,14,-,161300,68954
754,651,103,623,155900,68955
501,427,74,748,97300,68956
307,260,47,484,68800,68957
252,202,50,738,109400,68958
1726,1105,621,698,105300,68959
78,64,14,392,86700,68960
335,231,104,434,47600,68961
55,50,5,-,55000,68964
274,212,62,588,51800,68966
557,439,118,463,68700,68967
26,21,5,-,62500,68969
641,471,170,390,54600,68970
224,174,50,500,139300,68971
102,97,5,-,24700,68972
175,158,17,596,94000,68973
91,81,10,431,57500,68974
83,79,4,-,111900,68975
91,53,38,656,106300,68976
139,139,0,-,45800,68977
1101,790,311,532,54800,68978
771,565,206,618,97300,68979
146,114,32,759,121300,68980
132,111,21,-,69400,68981
308,221,87,575,95500,68982
3988,2850,1138,541,88700,69001
167,142,25,713,65000,69020
625,412,213,447,73900,69021
731,490,241,562,98900,69022
156,134,22,-,113300,69023
567,423,144,623,76500,69024
463,306,157,558,84200,69025
103,92,11,-,(X),69026
40,40,0,-,102800,69027
279,229,50,629,87800,69028
152,125,27,425,65600,69029
149,78,71,(X),53300,69030
248,178,70,463,66700,69032
1101,837,264,578,97300,69033
403,320,83,583,77300,69034
28,25,3,-,34300,69036
33,30,3,-,(X),69037
217,150,67,595,73500,69038
36,28,8,-,87500,69039
324,217,107,530,56700,69040
65,45,20,-,(X),69041
22,9,13,-,143800,69042
224,165,59,608,48500,69043
349,245,104,686,52100,69044
491,369,122,591,62200,69045
82,82,0,-,72500,69046
12482,8015,4467,629,113000,69101
439,305,134,496,95700,69120
163,99,64,683,89200,69121
309,206,103,598,64800,69122
336,285,51,634,124000,69123
180,138,42,588,30000,69125
422,299,123,698,105100,69127
98,90,8,575,(X),69128
525,415,110,613,72100,69129
2120,1395,725,626,89700,69130
210,162,48,917,81200,69131
59,53,6,-,(X),69132
191,136,55,850,74000,69133
143,113,30,544,61700,69134
73,23,50,-,-,69135
1850,1437,413,627,106800,69138
791,559,232,643,101200,69140
142,106,36,688,72500,69141
44,40,4,-,60000,69142
536,466,70,850,119300,69143
67,57,10,-,122700,69144
1332,821,511,628,81000,69145
189,135,54,-,109400,69146
313,274,39,440,110000,69147
90,61,29,403,(X),69148
292,230,62,609,69500,69149
187,170,17,685,101500,69150
376,259,117,513,114900,69151
367,277,90,592,74400,69152
2682,1730,952,587,99500,69153
542,462,80,535,67500,69154
421,265,156,594,79700,69155
246,197,49,728,88300,69156
8,4,4,-,-,69157
45,28,17,430,23800,69161
3542,2359,1183,587,125700,69162
372,271,101,550,114900,69163
733,534,199,698,125300,69165
287,196,91,502,125000,69166
155,97,58,640,112500,69167
104,88,16,617,60000,69168
251,194,57,608,91400,69169
147,121,26,439,104200,69170
6,6,0,-,-,69171
1831,1254,577,662,121500,69201
1271,878,393,436,73300,69210
145,98,47,675,70000,69211
121,95,26,-,(X),69212
84,73,11,-,(X),69214
65,46,19,(X),78800,69216
169,109,60,538,49100,69217
86,63,23,-,34300,69218
55,31,24,-,75000,69219
12,7,5,-,-,69220
75,42,33,-,105000,69221
4304,2764,1540,542,93700,69301
10,4,6,-,-,69331
101,68,33,-,58300,69333
846,664,182,727,79300,69334
13,8,5,-,-,69335
1031,657,374,650,85200,69336
2656,1574,1082,561,117300,69337
823,689,134,577,78700,69339
70,56,14,-,(X),69340
4278,3078,1200,615,117800,69341
1053,665,388,561,71300,69343
211,147,64,484,127600,69345
251,199,52,620,77900,69346
535,441,94,539,75200,69347
630,480,150,582,86700,69348
171,138,33,341,53800,69350
54,30,24,-,(X),69351
297,218,79,842,94400,69352
8,6,2,-,-,69353
51,40,11,-,101700,69354
52,51,1,-,60600,69355
786,616,170,554,86200,69356
1417,1107,310,628,111700,69357
751,548,203,626,76000,69358
582,435,147,593,67800,69360
7281,4543,2738,721,106500,69361
26,26,0,-,45000,69365
136,51,85,648,(X),69366
99,80,19,483,83800,69367
17319,8566,8753,850,216200,70001
8334,4325,4009,860,268500,70002
15863,12197,3666,850,176000,70003
11340,6965,4375,924,257300,70005
6218,3945,2273,923,237800,70006
1655,1461,194,916,158500,70030
513,438,75,950,155700,70031
1678,1065,613,889,132500,70032
418,387,31,-,114700,70036
5934,3508,2426,998,250000,70037
176,165,11,-,103900,70038
772,598,174,775,157700,70039
384,365,19,-,81400,70040
1037,930,107,860,77200,70041
7244,4086,3158,835,133200,70043
4517,3655,862,978,216400,70047
944,726,218,601,151300,70049
29,29,0,-,15700,70050
778,591,187,481,136900,70051
1306,1048,258,738,141500,70052
6276,2836,3440,811,144300,70053
13760,8121,5639,984,164800,70056
1524,1203,321,475,163600,70057
13400,9276,4124,935,149700,70058
6259,3112,3147,852,134000,70062
19535,12138,7397,957,182400,70065
919,816,103,1119,129600,70067
11222,8544,2678,928,161200,70068
4381,3718,663,992,197000,70070
1454,1057,397,772,136000,70071
19407,13926,5481,903,141300,70072
1612,1263,349,920,154900,70075
118,69,49,-,64000,70076
1137,950,187,861,154500,70079
500,429,71,785,163500,70080
126,126,0,-,83400,70082
835,744,91,566,74800,70083
2562,2024,538,845,111600,70084
1557,1437,120,761,108700,70085
705,492,213,712,66100,70086
2909,1989,920,660,162600,70087
2863,2316,547,489,118400,70090
93,74,19,-,107000,70091
2454,1959,495,827,117600,70092
11078,6869,4209,857,109100,70094
1494,231,1263,1180,314400,70112
3537,757,2780,698,170800,70113
9756,3914,5842,813,139700,70114
15923,7170,8753,1028,358900,70115
6235,2233,4002,878,247600,70116
10489,4901,5588,882,154200,70117
13212,5886,7326,985,289400,70118
16307,5247,11060,939,199200,70119
5625,3031,2594,842,168800,70121
13537,7512,6025,923,169400,70122
11956,7187,4769,985,232600,70123
8387,5958,2429,1350,352400,70124
6008,2756,3252,950,291600,70125
9132,4601,4531,878,150300,70126
9018,3857,5161,854,151600,70127
7036,4481,2555,888,162500,70128
3211,1939,1272,695,140400,70129
8061,2334,5727,1093,345300,70130
11797,7066,4731,851,167500,70131
0,0,0,-,-,70139
0,0,0,-,-,70163
16427,11658,4769,768,154300,70301
2537,2294,243,661,113000,70339
88,60,28,-,(X),70340
1506,1046,460,736,89400,70341
1798,1272,526,667,93400,70342
1744,1463,281,810,173800,70343
2057,1736,321,765,87600,70344
3608,2842,766,619,121500,70345
3683,2511,1172,586,107300,70346
66,60,6,-,(X),70352
452,391,61,-,67300,70353
1613,1334,279,730,97500,70354
376,307,69,622,76400,70355
820,683,137,676,(X),70356
1001,733,268,575,80600,70357
397,294,103,868,157100,70358
3221,2534,687,690,121200,70359
10301,6947,3354,969,205700,70360
8604,6126,2478,739,114000,70363
11166,7538,3628,869,148000,70364
884,625,259,554,99000,70372
2595,2042,553,655,118900,70373
2641,1842,799,778,116900,70374
28,28,0,-,(X),70375
1551,1383,168,626,77500,70377
8825,5502,3323,681,105400,70380
2567,2035,532,631,108000,70390
57,33,24,-,173600,70391
3158,2135,1023,738,111200,70392
303,286,17,-,140200,70393
5275,4358,917,708,126100,70394
1898,1600,298,682,124600,70395
361,275,86,(X),109800,70397
7789,3738,4051,755,152400,70401
0,0,0,-,-,70402
10113,6403,3710,794,138300,70403
3040,2688,352,872,200100,70420
5359,4134,1225,647,102300,70422
1836,1405,431,619,59900,70426
7685,5120,2565,571,74600,70427
1908,1720,188,707,201900,70431
13018,9180,3838,986,228500,70433
6684,5944,740,982,193600,70435
241,197,44,-,103700,70436
3177,2716,461,929,174900,70437
7036,5375,1661,550,101300,70438
1718,1348,370,625,62900,70441
78,42,36,-,(X),70442
3571,2677,894,638,92900,70443
3769,2896,873,652,86900,70444
4174,3515,659,775,150200,70445
2526,1986,540,698,159800,70446
3612,3257,355,1174,244800,70447
9178,7430,1748,1166,231700,70448
1450,1334,116,1012,114700,70449
1246,1030,216,567,56400,70450
10,10,0,-,-,70451
4367,3210,1157,712,137900,70452
316,305,11,-,109900,70453
10126,7809,2317,811,159700,70454
450,292,158,-,(X),70455
791,534,257,621,75400,70456
13784,10023,3761,1012,166700,70458
8095,5645,2450,966,139000,70460
9870,7331,2539,911,188900,70461
2236,1873,363,759,143900,70462
91,83,8,625,115600,70463
238,131,107,-,(X),70464
218,139,79,567,42800,70465
3036,2105,931,771,107200,70466
7974,5879,2095,1064,277000,70471
11040,5248,5792,675,95200,70501
11154,7815,3339,881,221100,70503
18039,9072,8967,788,161200,70506
6461,4351,2110,720,132700,70507
15356,10015,5341,941,222500,70508
9367,6815,2552,613,95800,70510
3599,2848,751,596,94700,70512
137,22,115,(X),-,70513
954,732,222,607,59700,70514
1150,879,271,554,76500,70515
342,329,13,-,113100,70516
9507,7450,2057,697,103400,70517
5147,3694,1453,772,195900,70518
115,115,0,-,87100,70519
6873,5551,1322,666,146200,70520
312,296,16,(X),80000,70523
133,98,35,494,85000,70524
4740,3569,1171,523,88500,70525
6835,4134,2701,546,87600,70526
911,621,290,649,91800,70528
4416,3111,1305,634,114600,70529
569,489,80,-,106100,70531
1003,717,286,576,67900,70532
2621,2037,584,602,101900,70533
351,289,62,680,75000,70534
6633,4284,2349,614,98700,70535
177,159,18,-,(X),70537
5138,3496,1642,613,82000,70538
142,118,24,480,81700,70541
1436,1290,146,547,87100,70542
1679,1313,366,513,86300,70543
4273,3316,957,503,70800,70544
5861,4210,1651,525,95200,70546
3869,2918,951,551,87800,70548
1567,1141,426,670,82100,70549
150,150,0,-,(X),70550
664,455,209,768,78800,70552
2221,1276,945,549,76600,70554
2947,2309,638,721,132700,70555
118,56,62,244,66700,70556
0,0,0,-,-,70558
924,743,181,614,83300,70559
14798,9577,5221,656,84700,70560
6918,5657,1261,723,148500,70563
13838,9224,4614,592,94300,70570
38,27,11,-,-,70575
274,176,98,597,75600,70576
1644,1256,388,653,64100,70577
6080,4228,1852,523,102000,70578
40,40,0,-,-,70580
362,332,30,-,82900,70581
7002,5460,1542,544,93900,70582
4463,3173,1290,714,125100,70583
2915,2181,734,573,112300,70584
79,61,18,513,137500,70585
7398,4819,2579,527,91200,70586
1196,878,318,473,110100,70589
1925,1458,467,599,101200,70591
7622,6354,1268,797,190100,70592
13532,6737,6795,636,98200,70601
14082,10055,4027,925,192200,70605
10529,6213,4316,761,93200,70607
7159,6102,1057,838,171000,70611
4209,2780,1429,782,81500,70615
449,449,0,-,122300,70630
318,307,11,-,95400,70631
211,211,0,-,107500,70632
2607,1961,646,805,81300,70633
9120,6572,2548,659,123400,70634
230,192,38,-,80700,70637
260,196,64,517,81400,70638
180,147,33,-,79200,70639
168,126,42,450,72500,70640
116,116,0,-,99200,70643
65,65,0,-,77900,70644
447,408,39,-,103700,70645
185,185,0,-,107000,70646
3272,2622,650,676,121100,70647
2421,1835,586,646,86700,70648
105,105,0,-,104900,70650
90,71,19,-,87400,70651
810,599,211,689,110300,70652
1338,1051,287,439,71800,70653
64,64,0,-,"10,000-",70654
1142,793,349,566,102500,70655
1397,1213,184,496,56900,70656
1851,1677,174,1047,77600,70657
336,312,24,781,91700,70658
501,271,230,827,110200,70659
751,698,53,-,(X),70660
954,831,123,299,61000,70661
168,168,0,-,130600,70662
10443,7853,2590,740,115800,70663
3887,3192,695,839,149300,70665
2791,1924,867,606,80400,70668
3949,3062,887,735,107300,70669
7391,6686,705,747,160500,70706
1513,1108,405,869,164100,70710
1864,1550,314,646,93000,70711
179,66,113,1138,(X),70712
7136,5084,2052,872,124800,70714
535,414,121,488,102100,70715
1697,1245,452,631,185200,70719
313,91,222,804,63100,70721
2285,1875,410,719,145900,70722
630,520,110,616,58900,70723
575,522,53,-,156300,70725
19507,14283,5224,851,156900,70726
381,334,47,-,(X),70729
1445,1302,143,(X),95100,70730
438,411,27,-,93900,70732
632,537,95,717,123600,70733
2608,2005,603,1274,172800,70734
216,158,58,-,117600,70736
15098,11437,3661,937,165000,70737
4734,4257,477,720,186400,70739
560,437,123,1038,100900,70740
74,63,11,-,(X),70743
2260,1941,319,586,107400,70744
90,71,19,-,58100,70747
1495,1134,361,582,95900,70748
597,482,115,790,159900,70749
686,523,163,569,57500,70750
324,305,19,-,149200,70752
376,257,119,(X),90800,70753
3515,2716,799,803,110500,70754
803,700,103,592,138000,70755
166,145,21,-,99300,70756
1187,924,263,478,89000,70757
509,384,125,583,90000,70759
2548,1571,977,556,106100,70760
302,237,65,367,67800,70761
346,336,10,-,162000,70762
1324,1141,183,(X),186000,70763
6352,4851,1501,655,111800,70764
5628,3824,1804,779,152800,70767
13321,11762,1559,930,211300,70769
1087,1035,52,-,140000,70770
380,305,75,602,82800,70772
42,11,31,-,-,70773
3846,3202,644,741,147600,70774
3504,2720,784,811,203000,70775
857,697,160,587,191900,70776
1714,1385,329,763,152400,70777
1072,913,159,848,146300,70778
480,407,73,620,150200,70780
167,127,40,-,31800,70782
1187,999,188,512,161400,70783
7711,6353,1358,760,156500,70785
61,61,0,-,-,70787
1565,1065,500,605,122300,70788
260,200,60,(X),99400,70789
8859,6902,1957,968,200700,70791
33,0,33,-,-,70801
10556,3893,6663,696,77400,70802
73,0,73,617,-,70803
10515,4990,5525,702,78700,70805
12624,5595,7029,725,192400,70806
5896,3044,2852,641,79900,70807
12695,7351,5344,966,296100,70808
11014,5675,5339,1076,245200,70809
15010,10666,4344,1018,225200,70810
4719,3426,1293,815,114700,70811
3795,2491,1304,811,110700,70812
5485,3964,1521,775,142700,70814
11202,7365,3837,760,160500,70815
18221,9097,9124,892,172300,70816
12157,9919,2238,1080,218800,70817
3826,2949,877,817,182300,70818
1610,1278,332,1039,122900,70819
7388,1588,5800,837,255300,70820
0,0,0,-,-,70836
1835,1077,758,510,86100,71001
542,473,69,460,71500,71003
230,154,76,628,132000,71004
4315,3808,507,802,196300,71006
351,349,2,-,126900,71007
268,226,42,425,86300,71008
743,522,221,571,40500,71016
604,455,149,536,57000,71018
3208,2399,809,554,83800,71019
286,192,94,406,44700,71021
1311,1054,257,718,91600,71023
660,503,157,326,134700,71024
650,531,119,806,96300,71027
660,435,225,414,62400,71028
65,54,11,625,150000,71029
663,495,168,(X),158400,71030
502,416,86,588,71400,71031
762,613,149,668,95500,71032
1492,1160,332,711,132400,71033
131,95,36,939,59500,71034
7553,6343,1210,680,146300,71037
1792,1108,684,517,67900,71038
737,695,42,1103,58100,71039
2790,1881,909,660,80800,71040
216,184,32,625,72500,71043
284,258,26,960,70000,71044
269,234,35,532,84500,71045
525,491,34,600,109300,71046
3975,3220,755,776,130100,71047
41,41,0,-,161500,71048
1191,778,413,604,81600,71049
899,771,128,601,115000,71051
3981,2577,1404,551,77200,71052
7699,5213,2486,635,85000,71055
1070,818,252,685,104200,71060
706,407,299,437,98100,71061
224,162,62,-,80000,71063
1544,1219,325,596,59100,71064
413,279,134,249,72600,71065
1370,925,445,653,85200,71067
1515,1086,429,499,63600,71068
219,156,63,736,40000,71069
776,676,100,563,53100,71070
969,800,169,758,101500,71071
536,477,59,665,70400,71072
1001,770,231,533,100600,71073
2527,1547,980,496,76900,71075
2243,1926,317,702,133500,71078
143,95,48,-,(X),71079
2139,1380,759,629,57800,71082
3315,960,2355,563,60600,71101
2854,1115,1739,659,51500,71103
5900,2993,2907,779,122900,71104
10073,5534,4539,946,169300,71105
13024,9102,3922,759,208500,71106
11637,7593,4044,671,109400,71107
6589,3478,3111,743,67600,71108
8238,4045,4193,663,63600,71109
834,25,809,1359,-,71110
16626,9305,7321,864,193400,71111
12568,8032,4536,885,138700,71112
6707,4042,2665,825,210400,71115
10399,6614,3785,817,135400,71118
4476,3564,912,857,124600,71119
5292,2973,2319,789,136400,71129
8947,4941,4006,646,179400,71201
8909,4111,4798,594,65000,71202
13790,7783,6007,706,129300,71203
0,0,0,-,-,71209
491,403,88,570,81100,71219
8859,5715,3144,571,79400,71220
1236,944,292,458,58000,71222
166,99,67,375,32300,71223
2649,2165,484,707,113000,71225
749,482,267,355,51900,71226
1500,1194,306,609,94900,71227
487,385,102,618,81300,71229
2404,1538,866,525,82900,71232
91,58,33,383,30000,71233
1595,1420,175,612,110700,71234
1663,1359,304,596,91700,71235
527,332,195,504,51800,71237
1233,1116,117,680,96900,71238
3585,2786,799,524,90700,71241
76,64,12,-,103300,71243
1444,476,968,609,84400,71245
453,236,217,404,75900,71247
34,12,22,-,-,71250
3227,2074,1153,536,74800,71251
107,63,44,496,47500,71253
2325,998,1327,455,48300,71254
335,243,92,651,77900,71256
650,515,135,578,85200,71259
1267,1015,252,435,89200,71260
630,378,252,375,86700,71261
3126,2203,923,518,69700,71263
431,371,60,(X),76800,71264
601,402,199,614,71600,71266
1018,886,132,389,98000,71268
4596,2983,1613,540,81200,71269
12045,5907,6138,675,153200,71270
0,0,0,-,-,71272
952,667,285,816,70400,71275
117,90,27,-,65000,71276
625,556,69,337,42000,71277
31,0,31,-,-,71279
1435,1056,379,820,151800,71280
3744,1933,1811,515,62700,71282
220,174,46,-,53300,71286
13319,8485,4834,748,143900,71291
7761,5069,2692,701,85500,71292
4963,3446,1517,499,84100,71295
7931,3825,4106,738,108500,71301
5736,3451,2285,650,97500,71302
7912,4430,3482,837,173200,71303
22,22,0,-,(X),71316
2602,1791,811,636,78600,71322
318,286,32,950,118000,71323
392,266,126,475,62800,71325
425,275,150,414,31100,71326
1476,1025,451,711,90100,71327
2678,2105,573,727,115600,71328
413,330,83,807,78300,71331
306,174,132,290,89500,71333
3479,1784,1695,459,75100,71334
660,470,190,398,83900,71336
6,6,0,-,-,71339
366,250,116,489,51800,71340
1162,935,227,664,129800,71341
3085,2308,777,553,76300,71342
3051,2421,630,496,68600,71343
51,0,51,823,-,71345
1077,674,403,571,122400,71346
1747,1012,735,546,114000,71350
3955,2760,1195,614,92700,71351
727,509,218,533,76000,71353
809,575,234,582,91600,71354
1266,944,322,429,77600,71355
231,185,46,-,78000,71356
776,480,296,417,55400,71357
465,364,101,446,54800,71358
12763,8224,4539,720,137600,71360
652,554,98,534,85400,71362
724,440,284,436,53000,71366
513,441,72,-,76300,71367
575,319,256,440,77700,71368
1045,633,412,467,74600,71369
823,673,150,382,79200,71371
2770,1781,989,539,79200,71373
415,246,169,447,52400,71375
52,24,28,-,(X),71377
945,620,325,480,58400,71378
68,68,0,-,(X),71401
1499,1216,283,683,94400,71403
267,232,35,335,106700,71404
2162,1608,554,777,134300,71405
106,79,27,-,(X),71406
363,208,155,698,68700,71407
2392,1896,496,512,127400,71409
47,29,18,438,103100,71410
1039,726,313,570,70800,71411
58,38,20,(X),55000,71414
367,287,80,458,83200,71416
1787,1324,463,603,70600,71417
2513,1835,678,526,63000,71418
1038,831,207,342,85800,71419
636,514,122,714,73100,71422
1592,1141,451,945,114000,71423
462,363,99,852,79300,71424
81,39,42,-,83500,71425
79,54,25,750,76700,71426
126,93,33,-,104000,71427
1032,914,118,436,82600,71429
846,586,260,685,111100,71430
441,321,120,570,45400,71432
1562,1228,334,583,86200,71433
1371,1146,225,491,66000,71435
613,504,109,-,73400,71438
685,473,212,426,81100,71439
278,197,81,-,46200,71441
8830,5273,3557,836,99900,71446
429,335,94,475,64400,71447
3633,2616,1017,527,102400,71449
367,306,61,675,82900,71450
29,29,0,-,51500,71452
944,649,295,685,80200,71454
51,51,0,-,33300,71455
393,249,144,513,(X),71456
10385,5231,5154,617,124900,71457
3110,24,3086,981,(X),71459
942,419,523,679,97600,71461
478,406,72,381,52900,71462
3229,2295,934,382,69600,71463
1074,885,189,495,61800,71465
159,131,28,-,(X),71466
1935,1555,380,695,93200,71467
383,246,137,548,67100,71468
992,805,187,734,85200,71469
103,103,0,-,(X),71472
188,169,19,(X),39500,71473
243,194,49,900,139200,71474
314,253,61,539,55100,71479
202,167,35,-,52000,71480
3720,2290,1430,592,72600,71483
806,642,164,327,193400,71485
2132,1633,499,523,62400,71486
5916,2929,2987,657,62100,71601
6443,4520,1923,691,95900,71602
13247,8668,4579,669,88400,71603
277,200,77,585,36000,71630
249,199,50,-,61400,71631
4789,3521,1268,614,69000,71635
1323,827,496,607,49600,71638
2556,1409,1147,576,47100,71639
1304,907,397,503,44200,71640
231,195,36,-,(X),71642
417,244,173,417,55500,71643
409,209,200,381,49000,71644
2582,2100,482,590,68000,71646
751,497,254,407,76400,71647
67,67,0,-,(X),71651
523,381,142,513,44700,71652
2069,1449,620,623,76800,71653
1846,1029,817,476,74000,71654
5911,3346,2565,588,97000,71655
254,174,80,661,63500,71658
60,50,10,-,(X),71659
295,277,18,-,76100,71660
151,87,64,332,42100,71661
89,0,89,-,-,71662
249,191,58,443,73800,71663
2281,1783,498,616,89800,71665
20,20,0,-,"10,000-",71666
3046,2177,869,625,64700,71667
559,450,109,730,56500,71670
3602,2403,1199,577,70100,71671
263,213,50,606,59300,71674
849,703,146,698,86900,71675
262,181,81,341,34400,71676
70,25,45,619,26300,71677
8137,5218,2919,555,72000,71701
3,0,3,-,-,71711
924,691,233,475,54900,71720
36,25,11,-,(X),71722
179,157,22,444,44500,71724
249,207,42,492,39300,71725
656,571,85,335,56300,71726
12810,8655,4155,633,80800,71730
563,476,87,492,63600,71740
2452,1479,973,537,70100,71742
1620,1150,470,642,71200,71743
1326,1043,283,637,77200,71744
130,110,20,475,61800,71745
358,292,66,488,40900,71747
922,834,88,625,69600,71749
387,307,80,621,82500,71751
406,207,199,413,55500,71752
6561,4160,2401,614,94600,71753
219,219,0,-,(X),71758
251,171,80,634,86800,71759
908,656,252,663,58900,71762
581,507,74,500,50200,71763
862,640,222,465,46200,71764
938,768,170,611,59300,71765
256,198,58,563,45200,71766
1521,1207,314,631,78300,71770
2,2,0,-,-,71772
5795,3654,2141,581,74500,71801
43,43,0,-,(X),71820
3606,2606,1000,516,79800,71822
22,19,3,-,67500,71823
263,238,25,525,72600,71825
467,288,179,486,53800,71826
245,204,41,521,52900,71827
3627,2600,1027,526,68700,71832
813,634,179,567,63000,71833
583,469,114,713,83100,71834
553,426,127,448,53300,71835
1255,941,314,572,63400,71836
1810,1560,250,560,88500,71837
371,271,100,459,55200,71838
123,80,43,230,62700,71839
352,265,87,660,66100,71841
821,571,250,616,67700,71842
786,523,263,366,63200,71845
1267,962,305,574,67300,71846
234,166,68,521,71200,71847
846,518,328,572,74300,71851
3606,2379,1227,557,100500,71852
111,99,12,-,(X),71853
14444,8813,5631,715,96400,71854
235,201,34,-,107400,71855
2148,1415,733,654,71800,71857
804,683,121,587,59100,71858
174,166,8,-,78300,71859
1181,850,331,499,53000,71860
847,756,91,552,64200,71861
174,140,34,(X),79200,71862
66,52,14,-,56400,71865
163,112,51,767,79300,71866
11849,6941,4908,623,116600,71901
7374,6575,799,960,193800,71909
19190,12256,6934,740,132100,71913
1363,1085,278,557,70200,71921
50,41,9,340,58300,71922
5976,3598,2378,564,98600,71923
1661,1258,403,760,87400,71929
360,300,60,519,151500,71933
290,274,16,-,70600,71935
729,579,150,563,56300,71937
767,574,193,515,47500,71940
781,684,97,550,80300,71941
1822,1341,481,463,78400,71943
265,212,53,413,73700,71944
547,427,120,479,95700,71945
1025,881,144,-,106600,71949
445,394,51,480,74700,71950
71,71,0,-,(X),71952
5903,4724,1179,504,89300,71953
674,539,135,616,40400,71956
1411,1112,299,578,109300,71957
911,619,292,487,84400,71958
262,181,81,469,82800,71959
629,449,180,491,64900,71960
386,322,64,579,89000,71961
465,321,144,616,58800,71962
1422,1149,273,860,130700,71964
101,73,28,(X),(X),71965
1625,1471,154,724,131100,71968
174,135,39,466,83900,71969
342,290,52,527,106300,71970
204,159,45,-,82500,71971
78,63,15,(X),80800,71972
466,313,153,333,69300,71973
0,0,0,-,-,71998
0,0,0,-,-,71999
183,159,24,768,85600,72001
5442,4548,894,772,131900,72002
333,273,60,675,58100,72003
461,302,159,533,54100,72004
78,46,32,513,43100,72005
1162,694,468,465,64000,72006
2540,2022,518,753,134900,72007
2607,1791,816,586,80800,72010
1513,1255,258,738,98200,72011
4710,3034,1676,791,118500,72012
848,640,208,589,86600,72013
35,19,16,-,40600,72014
10479,7037,3442,787,119400,72015
1192,1102,90,673,93500,72016
388,291,97,471,44700,72017
8901,7293,1608,786,163300,72019
1641,1307,334,500,64200,72020
1718,976,742,501,69400,72021
6528,4259,2269,871,143500,72022
13512,9281,4231,730,142400,72023
1349,951,398,662,86000,72024
266,219,47,594,80400,72025
124,86,38,-,53800,72026
637,529,108,476,76300,72027
757,426,331,427,46800,72029
291,268,23,-,84600,72030
2697,1912,785,586,100600,72031
11911,7218,4693,727,129700,72032
18279,9785,8494,731,168300,72034
0,0,0,-,-,72035
334,224,110,453,25300,72036
15,5,10,-,-,72037
25,25,0,-,134400,72038
849,606,243,696,87700,72039
1249,847,402,410,66400,72040
612,399,213,425,54000,72041
2009,1364,645,544,65700,72042
321,303,18,-,186600,72044
441,378,63,-,137500,72045
1825,1103,722,533,87200,72046
311,259,52,629,86500,72047
17,17,0,-,81500,72048
268,200,68,-,78000,72051
359,241,118,569,61300,72055
367,297,70,814,95500,72057
5556,4348,1208,761,146500,72058
25,25,0,-,-,72059
178,112,66,578,37100,72060
40,34,6,-,154200,72061
637,547,90,512,90400,72063
1145,816,329,547,74400,72064
1816,1436,380,672,137400,72065
1181,881,300,634,118400,72067
187,118,69,734,61700,72068
697,559,138,529,49100,72069
721,632,89,623,86900,72070
151,120,31,581,82900,72072
461,339,122,575,54700,72073
73,62,11,644,50000,72074
14528,8830,5698,747,107800,72076
279,279,0,-,105800,72079
193,181,12,-,98300,72080
2803,2159,644,600,86200,72081
888,520,368,491,48500,72082
88,63,25,(X),67900,72083
564,417,147,510,57900,72084
83,58,25,542,70000,72085
3826,2915,911,738,113700,72086
909,794,115,609,214300,72087
1224,1058,166,862,113000,72088
0,0,0,-,-,72099
1220,733,487,453,68800,72101
1034,812,222,551,91600,72102
4769,3517,1252,719,98000,72103
8521,5785,2736,659,80900,72104
2172,1616,556,707,121500,72106
132,109,23,600,82000,72107
32,32,0,-,(X),72108
4327,2824,1503,597,95400,72110
378,323,55,759,145100,72111
3457,2148,1309,544,66100,72112
9091,5612,3479,876,214200,72113
5067,1424,3643,593,67200,72114
9381,6297,3084,849,168100,72116
4998,3215,1783,735,80800,72117
8574,5514,3060,744,93200,72118
0,0,0,-,-,72119
12411,8644,3767,810,149600,72120
1241,1023,218,658,79100,72121
262,262,0,-,(X),72122
175,110,65,563,27500,72123
337,279,58,758,57600,72125
1412,941,471,583,78500,72126
1043,735,308,691,94800,72127
308,254,54,810,84800,72128
564,473,91,697,75200,72129
194,178,16,-,121100,72130
1853,1566,287,580,112900,72131
1299,979,320,767,87200,72132
145,96,49,644,53800,72134
1038,861,177,(X),184200,72135
615,494,121,776,88100,72136
923,763,160,751,83500,72137
97,53,44,270,50800,72139
174,155,19,538,71700,72140
179,148,31,-,71100,72141
1062,878,184,758,187500,72142
13249,8559,4690,629,140100,72143
0,0,0,-,-,72149
4552,3403,1149,708,128700,72150
148,101,47,628,44800,72152
1086,892,194,513,87700,72153
309,215,94,-,88900,72156
537,497,40,1017,99700,72157
4446,2853,1593,645,85200,72160
15,15,0,-,-,72165
127,96,31,-,48000,72166
547,497,50,835,111400,72167
127,111,16,-,50600,72168
82,56,26,-,37300,72169
91,65,26,534,62500,72170
3359,2760,599,705,144900,72173
136,92,44,508,66200,72175
3180,2218,962,690,109600,72176
202,181,21,-,83900,72179
16,8,8,-,-,72181
633,228,405,983,362700,72201
5081,1652,3429,740,111200,72202
11671,6457,5214,769,88700,72204
10486,5656,4830,788,160000,72205
9381,5935,3446,659,85300,72206
4760,3348,1412,749,228300,72207
11094,5185,5909,723,78700,72209
6277,4056,2221,793,157200,72210
9325,5516,3809,848,172800,72211
4974,4430,544,873,262300,72212
8470,5559,2911,945,331000,72223
4969,3203,1766,727,184900,72227
9637,4679,4958,681,85500,72301
58,25,33,717,48500,72311
9355,5635,3720,647,82700,72315
43,25,18,-,(X),72320
57,44,13,772,81000,72321
115,32,83,483,(X),72322
883,689,194,584,69200,72324
13,0,13,-,-,72325
874,582,292,634,56100,72326
606,416,190,525,85200,72327
13,13,0,-,-,72328
49,7,42,807,-,72329
218,148,70,795,50500,72330
1119,626,493,570,78500,72331
23,5,18,520,-,72332
311,108,203,535,43400,72333
5961,3108,2853,587,66100,72335
0,0,0,-,-,72338
72,46,26,-,62900,72339
23,15,8,-,-,72340
80,62,18,713,48800,72341
1954,833,1121,556,84400,72342
250,204,46,920,56000,72346
305,198,107,190,38100,72347
1146,712,434,433,81700,72348
482,273,209,558,44100,72350
213,137,76,576,69700,72351
35,27,8,-,-,72353
920,513,407,524,66600,72354
1010,800,210,568,49500,72355
440,174,266,568,62200,72358
234,117,117,342,35800,72359
2570,1391,1179,509,62500,72360
5533,3645,1888,731,148300,72364
1294,752,542,480,62500,72365
896,470,426,576,50900,72366
50,5,45,-,-,72367
581,407,174,555,52700,72368
3047,1370,1677,642,77300,72370
837,582,255,651,63900,72372
534,318,216,415,51900,72373
371,291,80,-,46600,72374
731,597,134,673,76900,72376
7,7,0,-,-,72377
45,14,31,-,-,72379
39,39,0,-,-,72383
293,190,103,475,59600,72384
724,472,252,488,63500,72386
123,49,74,354,(X),72389
3423,1539,1884,619,65500,72390
214,173,41,400,52000,72392
322,175,147,668,47100,72394
410,247,163,492,85500,72395
5125,3167,1958,669,91400,72396
21406,11040,10366,667,127400,72401
9710,6628,3082,731,165500,72404
183,133,50,534,73900,72410
917,584,333,664,76500,72411
310,265,45,740,87500,72412
194,163,31,535,48800,72413
148,94,54,559,74400,72414
456,338,118,490,76200,72415
2293,1565,728,635,104600,72416
1556,1060,496,802,120600,72417
623,368,255,526,49500,72419
205,146,59,507,72700,72421
2185,1407,778,486,57800,72422
27,21,6,(X),35600,72424
156,93,63,-,48800,72425
90,55,35,608,89000,72426
75,27,48,578,45000,72427
28,18,10,-,(X),72428
137,106,31,500,50500,72429
144,126,18,850,68900,72430
193,138,55,528,49500,72431
2100,1422,678,576,82300,72432
1212,758,454,467,61700,72433
863,730,133,347,51700,72434
182,155,27,408,42300,72435
315,293,22,688,68600,72436
1314,867,447,746,68500,72437
865,563,302,458,56100,72438
87,67,20,481,83600,72440
32,25,7,-,22500,72441
1736,1127,609,515,89400,72442
1143,882,261,466,61900,72443
650,473,177,476,79400,72444
39,32,7,-,65000,72445
794,646,148,450,87300,72447
105,88,17,706,33100,72449
14394,9069,5325,673,113200,72450
75,63,12,395,44600,72453
2167,1674,493,533,70300,72454
5161,3610,1551,553,82500,72455
189,138,51,725,47300,72456
81,45,36,446,50800,72457
362,294,68,466,80000,72458
655,532,123,460,54800,72459
341,311,30,430,62600,72460
1531,1219,312,500,71700,72461
167,98,69,400,30000,72462
21,10,11,461,(X),72464
569,464,105,(X),70000,72466
0,0,0,-,-,72467
504,416,88,513,66200,72469
105,67,38,379,48300,72470
454,327,127,526,53300,72471
3689,2126,1563,502,80900,72472
1134,846,288,535,63200,72473
2621,1668,953,574,65900,72476
160,145,15,-,83900,72478
684,496,188,619,59800,72479
511,484,27,758,66600,72482
9827,7037,2790,590,100500,72501
1156,951,205,535,63200,72512
1104,743,361,698,84700,72513
14,14,0,-,-,72515
152,129,23,-,51500,72517
995,678,317,430,88300,72519
121,64,57,-,(X),72520
1973,1369,604,549,76000,72521
196,164,32,-,112500,72522
492,392,100,539,58800,72523
121,84,37,-,(X),72524
89,70,19,(X),(X),72526
192,181,11,-,118500,72527
24,7,17,-,-,72528
2038,1615,423,684,77000,72529
612,522,90,-,84200,72530
356,339,17,-,113600,72531
687,580,107,433,60400,72532
189,173,16,475,61700,72533
628,540,88,425,82100,72534
148,102,46,469,80700,72536
235,179,56,-,112500,72537
158,103,55,-,113700,72538
84,84,0,-,(X),72539
129,115,14,475,101100,72540
1638,1350,288,473,110100,72542
4767,3315,1452,681,141700,72543
229,229,0,-,121100,72544
79,37,42,-,95000,72546
327,226,101,(X),89700,72550
20,19,1,-,33800,72553
1247,949,298,444,99800,72554
56,56,0,-,(X),72555
1334,968,366,561,103500,72556
3736,2721,1015,522,99900,72560
372,331,41,555,90900,72561
949,631,318,615,80600,72562
310,148,162,456,61300,72564
297,227,70,573,82300,72565
251,225,26,(X),49200,72566
98,76,22,-,77500,72567
473,395,78,1021,82400,72568
133,133,0,-,(X),72569
132,55,77,-,150900,72571
59,59,0,-,84800,72572
58,37,21,-,(X),72573
1841,1207,634,466,88900,72576
190,152,38,381,90000,72577
95,95,0,-,100400,72578
500,271,229,577,78600,72579
476,397,79,528,143000,72581
742,634,108,516,88900,72583
338,318,20,-,66400,72584
114,114,0,-,(X),72585
108,86,22,-,(X),72587
12041,8373,3668,590,110700,72601
541,407,134,478,77400,72611
3708,2790,918,583,108900,72616
124,59,65,427,(X),72617
946,690,256,627,120600,72619
270,270,0,-,98800,72623
151,139,12,-,72100,72624
549,383,166,506,132100,72626
314,281,33,434,65200,72628
224,157,67,574,59800,72629
79,62,17,679,68500,72630
2078,1659,419,728,165700,72631
2035,1550,485,631,155100,72632
761,662,99,633,109700,72633
1746,1270,476,520,97600,72634
1335,885,450,608,95800,72635
11,11,0,-,212500,72636
2653,1919,734,570,82200,72638
253,176,77,-,82300,72639
113,89,24,-,54600,72640
1122,872,250,315,88800,72641
924,762,162,685,122600,72642
1140,869,271,710,109100,72644
787,586,201,431,96200,72645
279,255,24,-,(X),72648
1593,1271,322,439,80600,72650
735,440,295,622,95800,72651
12542,9591,2951,624,125300,72653
185,160,25,-,70800,72655
910,665,245,713,95800,72658
226,164,62,439,81700,72660
157,141,16,-,177900,72661
1190,967,223,589,120700,72662
180,138,42,-,(X),72663
101,101,0,-,157300,72666
271,271,0,-,120700,72668
27,24,3,-,(X),72669
59,59,0,-,(X),72670
101,37,64,610,77500,72672
578,535,43,427,87200,72675
201,113,88,471,81600,72677
21,21,0,-,-,72679
353,315,38,680,59300,72680
193,186,7,-,72600,72682
112,67,45,-,64600,72683
476,405,71,608,80400,72685
73,73,0,-,(X),72686
2358,1912,446,552,96300,72687
15950,7045,8905,688,170200,72701
14228,6049,8179,669,192900,72703
9436,5438,3998,856,167500,72704
16686,10085,6601,789,186000,72712
4864,4148,716,959,146700,72714
7073,6264,809,919,153900,72715
338,280,58,616,156600,72717
685,619,66,1015,212200,72718
3374,1995,1379,897,134400,72719
209,149,60,-,55100,72721
1133,738,395,700,118600,72722
2269,1789,480,756,107300,72727
75,75,0,-,141200,72729
3296,2093,1203,827,148300,72730
1655,1415,240,700,146300,72732
2689,2038,651,688,129400,72734
2212,1543,669,741,127600,72736
992,858,134,772,123500,72738
123,78,45,-,166100,72739
3544,2583,961,583,102700,72740
222,155,67,-,(X),72742
1997,1378,619,616,87000,72744
4301,2692,1609,786,136100,72745
50,41,9,-,159000,72747
30,30,0,-,86800,72749
2286,1793,493,842,132600,72751
157,157,0,-,56100,72752
2941,2357,584,748,139800,72753
14618,9203,5415,690,137600,72756
13178,7941,5237,902,174300,72758
154,141,13,492,57900,72760
7495,4607,2888,708,123200,72761
12998,8773,4225,755,157600,72762
17836,8611,9225,647,131900,72764
436,277,159,578,85200,72768
277,264,13,-,127300,72769
412,289,123,768,60400,72773
2372,1916,456,632,126500,72774
288,264,24,-,109800,72776
6478,2482,3996,635,99300,72801
7954,6299,1655,691,138600,72802
805,532,273,508,77500,72821
2235,1657,578,597,89200,72823
545,458,87,604,68800,72824
11,7,4,-,61300,72826
43,43,0,-,46300,72827
38,28,10,-,-,72828
5848,3890,1958,611,95600,72830
413,318,95,531,52600,72832
1384,903,481,510,109000,72833
4020,2612,1408,549,105300,72834
364,266,98,457,(X),72835
2961,2458,503,593,104900,72837
49,44,5,-,68000,72838
155,108,47,-,65500,72839
824,610,214,553,61800,72840
72,63,9,-,71000,72841
447,362,85,705,90000,72842
936,729,207,519,88100,72843
535,388,147,519,104900,72845
1509,1239,270,624,90900,72846
1089,865,224,638,91800,72847
288,246,42,834,59900,72851
76,66,10,-,78600,72852
753,408,345,465,89200,72853
379,313,66,-,86900,72854
2366,1754,612,525,82000,72855
205,174,31,-,65000,72856
473,378,95,527,91300,72857
1256,1051,205,780,117100,72858
199,155,44,-,79400,72860
525,437,88,667,84600,72863
527,440,87,633,104800,72865
8827,3596,5231,559,87500,72901
11561,5970,5591,626,159600,72903
7397,4098,3299,552,72900,72904
5582,3509,2073,788,132900,72908
2884,2460,424,1064,173700,72916
5170,4187,983,661,124800,72921
1951,1325,626,868,89100,72923
271,202,69,593,71000,72926
3503,2396,1107,555,87800,72927
200,162,38,613,93500,72928
152,113,39,-,(X),72930
823,675,148,665,100700,72932
1820,1414,406,606,97200,72933
310,220,90,657,102500,72934
202,147,55,(X),79200,72935
5268,4039,1229,705,134200,72936
1426,1255,171,655,83700,72937
612,563,49,687,90400,72938
991,798,193,548,79800,72940
2039,1626,413,713,118800,72941
959,732,227,540,69000,72943
996,771,225,649,86200,72944
80,63,17,496,59500,72945
1443,1275,168,558,91000,72946
1847,1384,463,541,82700,72947
139,117,22,-,103500,72948
3714,2578,1136,585,94500,72949
145,137,8,-,70600,72950
441,336,105,581,93200,72951
1187,969,218,807,109500,72952
131,67,64,-,103100,72955
12816,9423,3393,638,110400,72956
2797,1975,822,510,76300,72958
1034,891,143,461,91300,72959
386,301,85,550,63800,73002
8396,5158,3238,1007,152600,73003
311,234,77,667,112900,73004
3213,2061,1152,546,73700,73005
1352,1040,312,530,87500,73006
845,760,85,1458,261100,73007
7774,4458,3316,754,112800,73008
447,328,119,550,79300,73009
6349,5277,1072,773,143700,73010
179,131,48,650,65000,73011
10654,9064,1590,1542,194400,73012
18019,13921,4098,1077,193600,73013
649,529,120,677,102500,73014
1070,722,348,482,61800,73015
605,522,83,533,125500,73016
642,514,128,561,67500,73017
7872,5071,2801,659,86300,73018
0,0,0,-,-,73019
8171,6810,1361,904,161100,73020
167,145,22,630,95000,73021
267,204,63,775,83800,73024
4189,4139,50,(X),297100,73025
4033,3638,395,752,171600,73026
632,446,186,553,98200,73027
1363,1087,276,672,94300,73028
651,461,190,518,77400,73029
1577,1111,466,594,103000,73030
94,77,17,525,63600,73032
155,102,53,618,65700,73033
15716,11119,4597,801,246200,73034
6415,4351,2064,703,94700,73036
765,612,153,485,74700,73038
643,433,210,660,62500,73040
145,114,31,400,40000,73041
379,289,90,510,80400,73042
63,54,9,-,58300,73043
7553,5257,2296,695,118200,73044
3739,2989,750,683,138000,73045
1388,1009,379,678,98100,73047
773,565,208,572,79400,73048
2136,1824,312,761,130400,73049
28,10,18,586,-,73050
2674,2069,605,736,103200,73051
2558,1940,618,645,93200,73052
279,208,71,538,97500,73053
1434,1155,279,739,120300,73054
3900,2972,928,594,108200,73055
208,194,14,-,75000,73056
948,659,289,582,77400,73057
114,90,24,495,61800,73058
996,765,231,630,87100,73059
679,552,127,728,111100,73061
593,463,130,418,48400,73062
258,213,45,682,96300,73063
7831,6172,1659,954,147200,73064
2636,2230,406,666,166700,73065
101,61,40,503,68100,73066
838,661,177,581,87300,73067
4215,3078,1137,794,104400,73068
9917,4936,4981,758,139100,73069
15760,7944,7816,783,133500,73071
16340,9658,6682,833,196500,73072
266,238,28,608,133300,73073
405,306,99,603,88000,73074
3522,2246,1276,654,93600,73075
2925,2113,812,601,84800,73077
2891,2738,153,891,189500,73078
223,193,30,708,121700,73079
3625,2761,864,662,131500,73080
1025,719,306,515,65600,73082
2734,2026,708,690,80900,73084
3364,2150,1214,621,89100,73086
4048,3535,513,752,163100,73089
373,296,77,661,109200,73090
386,280,106,668,76900,73092
979,847,132,650,159800,73093
749,518,231,596,108800,73095
5239,2707,2532,614,147800,73096
59,39,20,-,-,73097
1767,1258,509,631,83000,73098
22072,16731,5341,940,148300,73099
1055,71,984,1024,113200,73102
2400,831,1569,667,171900,73103
1041,236,805,1049,250000,73104
2833,1126,1707,818,96200,73105
4462,1878,2584,648,88900,73106
10827,5832,4995,759,91400,73107
4592,1614,2978,603,48100,73108
6969,3259,3710,611,65900,73109
14294,6845,7449,763,85800,73110
4850,2340,2510,671,73400,73111
14658,7506,7152,750,117100,73112
7158,2718,4440,831,85500,73114
8573,5181,3392,812,78400,73115
4519,3076,1443,923,217800,73116
2393,950,1443,604,71200,73117
6180,3388,2792,828,135600,73118
9978,4566,5412,710,63000,73119
17805,9353,8452,762,147800,73120
1313,1034,279,903,152400,73121
5235,3090,2145,675,112200,73122
8943,4305,4638,674,101100,73127
1553,1149,404,1184,143200,73128
6179,3194,2985,708,47400,73129
7913,5884,2029,878,128300,73130
1361,875,486,1118,245600,73131
10951,6045,4906,778,146200,73132
2379,673,1706,979,230200,73134
7717,4454,3263,885,128300,73135
7514,3339,4175,719,118000,73139
1051,727,324,769,76700,73141
5398,3036,2362,869,218300,73142
465,0,465,1142,-,73145
1840,956,884,767,60700,73149
1582,1453,129,735,215600,73150
530,518,12,-,387300,73151
11741,7502,4239,810,103200,73159
21200,14471,6729,886,124400,73160
11676,8143,3533,938,169700,73162
2151,2028,123,703,192700,73165
712,616,96,963,137800,73169
13342,11028,2314,1136,174800,73170
552,522,30,817,285500,73173
1280,1080,200,1419,189900,73179
13152,8778,4374,688,107100,73401
26,26,0,-,44000,73425
411,349,62,667,98200,73430
351,273,78,650,104100,73432
1067,878,189,543,95400,73433
182,131,51,658,107800,73434
27,27,0,-,(X),73437
1407,1069,338,573,69600,73438
3002,2401,601,662,89400,73439
102,69,33,443,80600,73440
71,60,11,675,36700,73441
162,140,22,-,69100,73442
1364,1106,258,665,105900,73443
87,25,62,-,156300,73444
2861,2093,768,597,82800,73446
401,315,86,708,66400,73447
2009,1448,561,639,88700,73448
1075,831,244,580,86800,73449
529,440,89,814,89600,73450
198,167,31,-,154200,73453
225,192,33,700,58000,73455
773,569,204,487,60600,73456
312,223,89,675,81200,73458
361,297,64,725,85000,73459
1945,1245,700,517,78300,73460
240,192,48,553,71800,73461
1277,1041,236,564,70100,73463
397,337,60,621,62400,73481
73,57,16,850,34100,73487
286,212,74,533,72800,73491
7164,3163,4001,695,95400,73501
1458,0,1458,1115,-,73503
18633,10153,8480,777,120100,73505
8824,5039,3785,777,120200,73507
56,35,21,625,69000,73520
8409,4594,3815,723,98300,73521
847,647,200,623,116000,73526
1925,1478,447,630,138400,73527
232,184,48,644,80000,73528
2129,1616,513,593,76400,73529
229,182,47,492,56300,73530
167,135,32,825,81000,73531
207,158,49,510,84300,73532
11369,7642,3727,669,103900,73533
272,219,53,475,50400,73537
2120,1548,572,888,158600,73538
95,88,7,-,66300,73539
165,127,38,912,86900,73540
981,830,151,755,123400,73541
1706,1242,464,613,57400,73542
564,427,137,596,100800,73543
134,95,39,(X),51500,73544
452,334,118,631,53200,73546
689,471,218,424,53200,73547
221,221,0,-,77000,73548
109,74,35,839,80800,73549
962,666,296,473,50400,73550
10,10,0,-,(X),73551
553,476,77,569,117600,73552
19,19,0,-,178100,73553
1358,856,502,704,69400,73554
88,54,34,589,35800,73555
67,48,19,444,57500,73556
119,102,17,967,150000,73557
279,189,90,425,42400,73559
247,191,56,469,70600,73560
304,222,82,760,76300,73562
238,206,32,280,74100,73564
413,308,105,403,53500,73565
715,492,223,520,74700,73566
264,180,84,458,74400,73567
455,328,127,413,45200,73568
208,159,49,325,41900,73569
484,331,153,658,55000,73570
68,51,17,-,54600,73571
1441,1099,342,542,86500,73572
1007,691,316,477,57200,73573
3529,2188,1341,662,99500,73601
339,299,40,538,89800,73620
84,58,26,700,83300,73622
765,344,421,665,74900,73624
261,226,35,817,102200,73625
390,317,73,868,82600,73626
217,125,92,725,85000,73627
545,382,163,482,83300,73628
1411,1028,383,621,76900,73632
96,47,49,-,(X),73638
234,185,49,435,88800,73639
295,264,31,531,54600,73641
83,68,15,-,87100,73642
5094,3247,1847,726,141600,73644
565,397,168,500,69000,73645
184,154,30,336,57900,73646
291,235,56,442,89700,73647
292,213,79,413,76000,73650
1727,1105,622,541,65800,73651
304,206,98,769,89500,73654
373,284,89,488,56200,73655
80,75,5,-,75500,73658
76,74,2,-,39400,73659
182,154,28,-,70000,73660
170,143,27,738,83700,73661
1819,1148,671,577,86600,73662
440,313,127,607,94400,73663
468,348,120,516,65300,73664
76,47,29,1054,95000,73666
253,184,69,608,76200,73667
646,506,140,571,81000,73669
124,105,19,915,59800,73673
8965,5557,3408,637,63600,73701
11892,7854,4038,839,131500,73703
0,0,0,-,-,73705
204,173,31,519,59500,73716
2570,1739,831,637,91500,73717
253,211,42,675,75000,73718
16,16,0,-,311100,73719
105,100,5,-,90900,73720
193,138,55,619,89300,73722
367,281,86,541,69300,73724
250,203,47,541,49700,73726
89,76,13,-,111800,73727
829,645,184,688,66100,73728
244,211,33,579,78600,73729
268,193,75,480,80500,73730
46,41,5,-,57800,73731
100,90,10,1000,155600,73733
294,214,80,575,75800,73734
268,225,43,600,89300,73735
203,194,9,-,79500,73736
1430,955,475,503,78800,73737
428,322,106,589,62400,73738
146,117,29,390,82100,73739
322,215,107,667,79600,73741
1517,1150,367,642,103600,73742
67,63,4,-,59400,73743
84,66,18,-,71100,73744
4,4,0,-,-,73746
139,64,75,659,113900,73747
199,155,44,628,59300,73749
2789,2118,671,726,132200,73750
140,117,23,644,108900,73753
469,415,54,834,79100,73754
375,305,70,498,75700,73755
115,99,16,-,103900,73756
76,71,5,-,126600,73757
51,42,9,-,(X),73758
674,502,172,601,77900,73759
179,151,28,(X),107700,73760
204,125,79,-,68900,73761
806,654,152,778,157800,73762
660,499,161,657,72500,73763
47,35,12,-,106300,73764
490,386,104,698,77400,73766
534,462,72,594,108400,73768
222,159,63,622,45800,73771
1468,1075,393,532,87400,73772
704,521,183,607,82900,73773
5590,3804,1786,686,120700,73801
408,356,52,625,77000,73832
732,576,156,567,69700,73834
123,99,24,-,77200,73835
157,120,37,414,70000,73838
302,222,80,821,77000,73840
184,147,37,691,88600,73841
194,164,30,429,98900,73842
379,318,61,613,94400,73843
108,70,38,660,95000,73844
744,603,141,585,81500,73848
33,33,0,-,117200,73851
947,734,213,631,109200,73852
185,154,31,679,116300,73853
49,49,0,-,68100,73855
278,248,30,590,135000,73857
621,434,187,637,80800,73858
639,438,201,609,103000,73859
641,437,204,525,74500,73860
35,35,0,-,77500,73901
221,153,68,688,99000,73931
846,668,178,627,88500,73932
698,504,194,387,62800,73933
85,57,28,(X),59600,73937
237,210,27,658,71300,73938
474,217,257,562,113600,73939
4562,2604,1958,696,98400,73942
170,125,45,692,69000,73944
1089,857,232,660,84400,73945
31,26,5,-,52700,73946
175,141,34,675,42100,73947
548,416,132,630,77800,73949
529,419,110,900,97700,73950
401,303,98,675,68100,73951
155,127,28,588,44200,74001
805,602,203,575,62900,74002
5928,3403,2525,649,74300,74003
10762,8302,2460,762,127900,74006
8788,6786,2002,873,186000,74008
3852,2777,1075,562,94200,74010
9819,8116,1703,1032,159100,74011
21782,15358,6424,938,153200,74012
12943,11343,1600,998,161900,74014
3261,2243,1018,825,140100,74015
2260,1758,502,631,85500,74016
11076,7735,3341,788,119700,74017
6963,5673,1290,776,156200,74019
2801,2080,721,667,88700,74020
6862,5637,1225,872,151900,74021
780,675,105,665,97000,74022
4323,2917,1406,683,91100,74023
357,261,96,644,58200,74026
378,295,83,475,60400,74027
656,549,107,688,83900,74028
2055,1576,479,676,83400,74029
1462,1052,410,467,69500,74030
870,725,145,901,107700,74032
3574,2598,976,958,123300,74033
53,39,14,742,45000,74034
1394,1042,352,504,68300,74035
2499,2107,392,709,131800,74036
5732,4596,1136,1064,181500,74037
826,713,113,630,80700,74038
1415,1148,267,688,83400,74039
847,692,155,768,128000,74041
165,115,50,753,51900,74042
2807,2234,573,679,105700,74044
158,137,21,481,66500,74045
37,25,12,475,(X),74046
2453,1917,536,792,111000,74047
2357,1762,595,602,76800,74048
127,77,50,575,45600,74050
808,701,107,581,110800,74051
466,304,162,566,51000,74052
1633,1362,271,678,143100,74053
295,247,48,440,45300,74054
15182,11281,3901,901,171100,74055
2351,1568,783,527,72900,74056
1623,1099,524,606,86100,74058
2091,1425,666,649,107400,74059
250,212,38,581,67600,74060
836,692,144,629,127100,74061
424,325,99,584,79800,74062
11665,9013,2652,754,115100,74063
11911,8626,3285,750,116300,74066
19,11,8,425,(X),74068
5162,3915,1247,781,125800,74070
40,34,6,-,65000,74071
738,597,141,713,86300,74072
2160,1805,355,760,124200,74073
11447,5594,5853,820,166900,74074
10394,3698,6696,693,149600,74075
0,0,0,-,-,74078
1837,1233,604,629,92800,74079
1158,947,211,789,146400,74080
658,612,46,575,81100,74081
27,19,8,925,61300,74082
411,352,59,563,87400,74083
253,205,48,513,49800,74084
973,726,247,511,70800,74085
241,0,241,1566,-,74103
5605,2567,3038,785,139100,74104
12611,6936,5675,672,170200,74105
7151,3313,3838,562,64000,74106
8070,4281,3789,698,80800,74107
2690,1641,1049,796,84000,74108
5046,2481,2565,723,51300,74110
9169,5012,4157,749,97200,74112
7263,5736,1527,951,156500,74114
8184,4275,3909,791,60200,74115
1438,679,759,684,81700,74116
48,43,5,-,120500,74117
2521,625,1896,700,138600,74119
2418,956,1462,656,236100,74120
3578,2054,1524,693,46000,74126
6790,3876,2914,706,78400,74127
4502,2869,1633,768,82900,74128
7174,3780,3394,658,100200,74129
721,527,194,798,51900,74130
1150,929,221,781,124100,74131
3312,2188,1124,897,163100,74132
19073,10172,8901,858,176500,74133
5858,3472,2386,708,116200,74134
9853,5062,4791,701,157500,74135
13755,4970,8785,694,198800,74136
10801,7419,3382,904,282100,74137
7716,4047,3669,784,118400,74145
5523,1917,3606,637,88400,74146
4440,3316,1124,618,95000,74301
1131,864,267,616,114200,74330
2927,2291,636,680,128000,74331
638,539,99,714,107400,74332
392,325,67,650,118800,74333
1990,1532,458,631,97800,74337
1936,1422,514,631,78800,74338
937,620,317,518,56800,74339
113,89,24,706,67500,74340
1149,846,303,523,101100,74342
1199,856,343,608,85700,74343
6440,4827,1613,643,132400,74344
2940,2159,781,529,100400,74346
934,703,231,671,72100,74347
143,101,42,565,89600,74349
337,248,89,592,84500,74350
2431,1811,620,540,87500,74352
6938,4585,2353,643,86500,74354
76,57,19,550,51300,74358
224,172,52,575,60400,74359
9,6,3,-,-,74360
6359,4300,2059,648,117200,74361
1025,810,215,710,78400,74363
600,480,120,447,89400,74364
1800,1378,422,613,83900,74365
594,502,92,489,64500,74366
175,110,65,483,60700,74367
33,30,3,-,56000,74368
721,584,137,640,93200,74369
1357,1134,223,627,87600,74370
6701,3855,2846,635,82600,74401
11877,7792,4085,660,91700,74403
1812,1430,382,550,101000,74421
262,241,21,575,97600,74422
351,301,50,425,80700,74423
476,352,124,326,98200,74425
3883,3064,819,648,94900,74426
393,370,23,517,115300,74427
462,368,94,526,103800,74428
5123,4045,1078,727,137200,74429
191,162,29,607,75000,74430
317,245,72,640,52600,74431
4481,3598,883,490,86500,74432
3383,2692,691,670,131100,74434
1203,956,247,566,77700,74435
1812,1436,376,686,104900,74436
3895,2836,1059,619,74200,74437
53,43,10,567,47500,74438
1847,1482,365,491,102900,74441
356,317,39,617,58300,74442
1188,926,262,707,108700,74445
222,149,73,678,78200,74446
6569,3952,2617,590,71700,74447
730,635,95,712,80900,74450
1460,1165,295,544,98200,74451
151,130,21,564,79700,74452
1254,1035,219,649,79400,74454
1287,1048,239,516,61200,74455
60,54,6,-,61300,74456
173,144,29,773,77200,74457
27,21,6,325,39200,74458
39,35,4,-,103400,74459
102,71,31,563,48800,74460
2968,2109,859,539,82400,74462
87,53,34,513,58800,74463
10603,6161,4442,588,112500,74464
5964,4046,1918,715,99200,74467
91,73,18,550,77100,74468
837,497,340,568,82700,74469
695,586,109,521,77900,74470
585,486,99,552,67400,74471
257,184,73,724,83200,74472
0,0,0,-,-,74477
11131,7741,3390,694,105100,74501
60,40,20,542,64000,74521
112,97,15,850,76500,74522
2470,1812,658,530,71100,74523
3739,2603,1136,560,88000,74525
87,69,18,342,75000,74528
77,73,4,-,61300,74530
384,320,64,584,80300,74531
312,231,81,689,77900,74533
97,90,7,525,83800,74534
30,25,5,-,137500,74535
726,467,259,518,69100,74536
1670,1129,541,600,79600,74538
96,81,15,-,75500,74540
200,153,47,-,68400,74543
330,238,92,483,44700,74546
1396,977,419,582,89000,74547
35,18,17,-,60000,74549
434,337,97,494,75700,74552
455,357,98,557,78800,74553
787,492,295,705,86000,74554
308,252,56,533,84500,74555
154,127,27,563,69200,74556
210,177,33,563,68500,74557
205,176,29,457,71800,74558
214,155,59,750,78100,74560
877,699,178,531,69900,74561
362,281,81,350,71800,74562
849,700,149,550,78500,74563
256,193,63,656,80300,74565
45,37,8,-,71700,74567
258,216,42,625,86700,74569
422,329,93,813,93100,74570
1321,888,433,463,68900,74571
261,215,46,547,67000,74572
481,400,81,533,71700,74574
55,50,5,-,86700,74576
94,65,29,475,82500,74577
2446,1538,908,518,82600,74578
7592,4530,3062,656,65400,74601
4977,4137,840,636,123900,74604
269,171,98,525,71400,74630
3191,2274,917,517,53900,74631
262,211,51,706,75300,74632
183,163,20,710,62800,74633
136,101,35,718,88300,74636
769,612,157,473,39800,74637
139,116,23,717,69100,74640
302,263,39,708,81900,74641
189,166,23,656,66000,74643
191,146,45,629,62300,74644
117,117,0,-,(X),74646
1387,1033,354,548,82800,74647
246,196,50,625,41200,74650
280,204,76,379,34600,74651
318,253,65,460,41300,74652
1463,978,485,563,68500,74653
8835,4944,3891,673,110700,74701
220,172,48,665,55800,74720
106,85,21,456,61600,74722
624,440,184,537,73500,74723
130,107,23,-,62500,74724
942,731,211,644,71900,74726
803,560,243,555,76900,74727
4334,2929,1405,584,78100,74728
1179,862,317,665,77900,74729
1667,1212,455,697,89900,74730
735,506,229,614,52900,74731
1076,830,246,704,78100,74733
484,404,80,450,77100,74734
639,528,111,594,80000,74735
436,356,80,552,65400,74736
229,192,37,513,59700,74738
857,691,166,514,60400,74740
393,303,90,588,80500,74741
3251,2084,1167,513,84800,74743
3990,2236,1754,576,83900,74745
57,48,9,531,47300,74747
254,216,38,677,75900,74748
146,127,19,619,66800,74750
33,33,0,-,-,74753
145,117,28,413,63600,74754
43,43,0,-,45200,74755
341,284,57,660,77700,74756
526,455,71,517,79800,74759
102,93,9,-,113400,74760
44,26,18,(X),45000,74761
1383,1096,287,543,70700,74764
543,444,99,482,53500,74766
8535,5048,3487,638,88200,74801
7561,5182,2379,671,133300,74804
12256,7489,4767,636,112700,74820
492,388,104,675,103200,74824
739,598,141,563,87800,74825
415,320,95,563,68800,74826
147,116,31,589,110000,74827
225,169,56,488,64300,74829
91,74,17,575,47100,74830
316,232,84,510,103400,74831
323,261,62,443,95400,74832
246,208,38,530,79400,74833
2809,2117,692,565,105100,74834
78,41,37,-,(X),74836
110,87,23,538,63900,74837
242,195,47,525,59300,74839
667,528,139,600,91300,74840
37,32,5,-,(X),74842
121,93,28,725,146900,74843
120,80,40,675,39200,74844
195,157,38,650,55800,74845
2459,1772,687,526,63600,74848
1155,838,317,532,68200,74849
147,131,16,-,81400,74850
3078,2454,624,636,105600,74851
536,439,97,843,87200,74852
588,473,115,438,65900,74854
1852,1558,294,588,109500,74855
288,227,61,657,79100,74856
3017,2690,327,809,129700,74857
2134,1511,623,515,81300,74859
628,506,122,550,88800,74860
1961,1491,470,630,142000,74864
606,506,100,700,101000,74865
378,291,87,458,75800,74867
4841,3515,1326,598,75100,74868
327,270,57,702,87500,74869
847,700,147,692,96000,74871
1321,917,404,507,89700,74872
4499,3386,1113,592,92400,74873
462,359,103,640,102100,74875
578,469,109,638,85300,74878
845,639,206,367,66900,74880
1720,1395,325,683,87600,74881
860,604,256,546,66400,74883
2161,1510,651,427,60700,74884
803,579,224,532,66400,74901
1559,1234,325,625,87000,74902
772,622,150,675,75300,74930
492,402,90,531,73600,74931
884,673,211,642,87400,74932
50,34,16,605,45000,74935
430,336,94,663,70000,74936
2022,1385,637,546,58000,74937
297,217,80,577,81400,74939
873,659,214,539,82700,74940
1078,792,286,535,72000,74941
59,43,16,375,67200,74942
57,45,12,-,75800,74943
434,328,106,553,68500,74944
149,110,39,667,72500,74945
52,14,38,525,46700,74946
4604,3548,1056,583,93500,74948
129,105,24,331,65600,74949
518,347,171,613,52700,74951
4232,2982,1250,573,105200,74953
1715,1014,701,681,94500,74954
5614,3720,1894,620,94900,74955
718,522,196,628,82900,74956
438,361,77,379,67800,74957
2608,1895,713,660,79400,74959
4802,3325,1477,519,77300,74960
1901,1518,383,573,74200,74962
247,225,22,510,63100,74963
946,709,237,588,76600,74964
1861,1293,568,540,76900,74965
1344,1111,233,509,91600,74966
8027,1576,6451,1053,268800,75001
22053,17207,4846,1181,196500,75002
17445,9574,7871,950,149800,75006
18759,13742,5017,1067,175700,75007
3009,2425,584,872,247000,75009
9328,4205,5123,1138,219300,75010
11503,8905,2598,1395,324800,75013
14628,10368,4260,1199,300300,75019
8900,5880,3020,743,91800,75020
3229,2592,637,616,87800,75021
7344,6985,359,1875,342200,75022
18111,11945,6166,1209,182500,75023
17033,7536,9497,1194,308300,75024
19008,13684,5324,1186,263000,75025
14943,12577,2366,1594,248900,75028
10548,8595,1953,1246,233800,75032
28635,20658,7977,1217,313500,75034
18214,14478,3736,1491,234800,75035
12237,1778,10459,898,184900,75038
7702,1319,6383,1233,389400,75039
18039,13146,4893,1029,113200,75040
9615,5698,3917,867,95700,75041
11596,6177,5419,819,102200,75042
20666,11864,8802,969,123700,75043
15065,10333,4732,1088,143300,75044
7317,6239,1078,1348,177700,75048
15023,6534,8489,884,104800,75050
13086,6154,6932,833,91900,75051
28693,21347,7346,1102,136500,75052
2240,2058,182,1595,259000,75054
19095,12619,6476,1131,181000,75056
5004,1744,3260,1006,93100,75057
951,753,198,945,171900,75058
14554,9445,5109,829,111000,75060
17432,6629,10803,794,117800,75061
16354,6902,9452,858,122000,75062
15993,6254,9739,1038,282400,75063
4322,3148,1174,961,162500,75065
25098,10134,14964,970,155700,75067
14497,11580,2917,1396,169900,75068
13356,7115,6241,926,198500,75069
28934,21528,7406,1378,218700,75070
14073,10184,3889,1182,206000,75071
16097,9607,6490,1076,148100,75074
13648,9128,4520,1041,188700,75075
3076,2307,769,933,123500,75076
12882,10290,2592,1168,220200,75077
4601,3633,968,1299,367100,75078
17973,9926,8047,1078,197700,75080
13813,7946,5867,1136,168600,75081
8291,6033,2258,1269,264200,75082
10445,8171,2274,1233,211800,75087
8671,7188,1483,1352,155900,75088
9709,8489,1220,1309,166000,75089
8114,4995,3119,816,79800,75090
9853,5418,4435,807,131000,75092
19430,12467,6963,1135,372700,75093
5999,5328,671,1862,281000,75094
16210,13799,2411,1190,160200,75098
178,126,52,721,70000,75101
457,359,98,993,83400,75102
4916,3836,1080,847,119000,75103
16065,11421,4644,1175,134000,75104
78,66,12,-,56000,75105
1569,1258,311,1081,113400,75109
10172,5932,4240,694,82500,75110
1555,1291,264,1109,114600,75114
18576,12214,6362,954,149200,75115
6879,4201,2678,884,108100,75116
1435,1118,317,662,113700,75117
9226,5648,3578,841,112400,75119
1444,1038,406,625,95000,75124
2029,1556,473,888,78700,75125
11510,10117,1393,1276,160700,75126
579,405,174,619,91600,75127
379,338,41,-,140700,75132
7027,4152,2875,916,104200,75134
1903,1521,382,789,117000,75135
6981,4914,2067,1055,125400,75137
2257,1734,523,677,99800,75140
1306,940,366,859,71900,75141
5877,4353,1524,861,106700,75142
5829,4505,1324,779,76600,75143
1291,880,411,649,73600,75144
6644,4498,2146,893,102600,75146
2518,1747,771,662,104100,75147
2139,1495,644,653,70500,75148
18342,11306,7036,954,95700,75149
21675,10068,11607,942,103600,75150
1548,1189,359,909,132500,75152
150,142,8,-,66300,75153
12269,9376,2893,1025,145900,75154
896,707,189,818,65400,75155
5976,4581,1395,804,91700,75156
119,87,32,695,59700,75157
1447,1297,150,923,120100,75158
5391,3962,1429,778,87300,75159
8053,4907,3146,860,105700,75160
2333,1921,412,923,107300,75161
907,697,210,454,123200,75163
192,158,34,1025,102800,75164
14114,8609,5505,938,139400,75165
1188,1053,135,1410,182100,75166
3181,2789,392,1408,200800,75167
4689,3663,1026,754,88100,75169
1095,624,471,699,62100,75172
1410,1260,150,1097,156700,75173
6434,3527,2907,886,79800,75180
8061,6667,1394,1523,142100,75181
1750,1673,77,2203,304000,75182
7376,6118,1258,1113,154400,75189
7007,753,6254,1450,470100,75201
1403,189,1214,1379,194100,75202
5931,1625,4306,735,68900,75203
15682,3399,12283,1248,282300,75204
9041,5691,3350,1398,996000,75205
20563,4772,15791,1065,300200,75206
1295,0,1295,1522,-,75207
10060,5473,4587,777,137100,75208
6499,3877,2622,1163,496400,75209
2518,792,1726,641,61300,75210
21266,10974,10292,787,88000,75211
7245,4051,3194,630,80400,75212
15627,8780,6847,896,370900,75214
5825,2059,3766,764,59200,75215
17106,9093,8013,741,59300,75216
22413,13272,9141,875,72300,75217
10247,6725,3522,998,243600,75218
12561,4946,7615,1051,267900,75219
14369,4538,9831,728,181400,75220
4395,2471,1924,817,93800,75223
10619,5336,5283,773,89200,75224
8505,6298,2207,1725,845400,75225
1552,41,1511,1087,234100,75226
17040,9508,7532,818,86500,75227
24786,11110,13676,732,110500,75228
11018,7754,3264,870,301500,75229
12208,7414,4794,847,463700,75230
15314,3074,12240,722,262700,75231
10000,6213,3787,852,90100,75232
4681,2609,2072,815,118100,75233
10741,6871,3870,977,140800,75234
6973,2033,4940,977,116300,75235
5764,1987,3777,827,101500,75236
7810,1096,6714,750,106700,75237
12314,6013,6301,772,258700,75238
9908,2073,7835,830,182400,75240
10018,6085,3933,873,77300,75241
24774,6503,18271,745,177100,75243
5889,3070,2819,1194,300900,75244
1293,249,1044,677,148000,75246
195,0,195,803,-,75247
15761,8558,7203,1020,289800,75248
4623,3730,893,1202,123500,75249
1685,0,1685,1233,-,75251
12473,5134,7339,843,289500,75252
5502,3664,1838,890,53800,75253
11520,2161,9359,904,304200,75254
0,0,0,-,-,75270
26958,5774,21184,872,247900,75287
0,0,0,-,-,75390
6340,3513,2827,734,60400,75401
6175,4218,1957,771,119100,75402
5460,3831,1629,862,118900,75407
4229,3503,726,1212,151900,75409
1700,1352,348,613,98000,75410
455,323,132,693,78900,75411
247,213,34,-,76000,75412
79,51,28,810,33800,75413
1239,986,253,744,117400,75414
94,94,0,-,74200,75415
936,726,210,760,76400,75416
1058,799,259,411,75900,75417
4620,3182,1438,694,94600,75418
426,343,83,706,108900,75420
335,290,45,757,83200,75421
909,791,118,759,93000,75422
1048,898,150,857,96000,75423
1212,989,223,947,118700,75424
2014,1205,809,604,61600,75426
3411,1709,1702,775,79900,75428
726,545,181,677,91500,75431
1285,902,383,582,71900,75432
1061,882,179,797,89400,75433
601,459,142,400,54200,75435
787,617,170,478,73400,75436
471,418,53,425,118600,75437
333,280,53,781,94000,75438
406,286,120,839,84200,75439
2476,2062,414,559,124500,75440
40,40,0,-,-,75441
3271,2262,1009,864,115700,75442
1190,969,221,369,102500,75446
358,268,90,706,109700,75447
199,191,8,-,45700,75448
500,384,116,517,58200,75449
113,105,8,-,115800,75450
389,288,101,518,138500,75451
1510,1142,368,667,107200,75452
1355,1066,289,874,89000,75453
2107,1716,391,1040,193900,75454
9171,6053,3118,633,103400,75455
2548,1888,660,748,101600,75457
1700,1250,450,613,117700,75459
9214,4660,4554,641,66300,75460
4340,3381,959,760,132200,75462
290,247,43,-,133100,75468
151,117,34,475,66300,75469
164,126,38,-,48600,75470
454,369,85,-,68500,75471
1350,1021,329,770,84100,75472
1443,1256,187,794,108600,75473
5403,4095,1308,740,81300,75474
65,56,9,-,57300,75475
448,378,70,715,85700,75476
358,210,148,556,62100,75477
416,343,73,543,87000,75478
641,487,154,754,86100,75479
587,489,98,681,100400,75480
205,124,81,571,77300,75481
9180,6123,3057,681,92600,75482
863,714,149,743,90400,75486
557,403,154,493,65000,75487
437,380,57,759,90700,75488
366,224,142,617,95000,75489
848,672,176,721,126800,75490
2012,1425,587,758,93600,75491
166,135,31,482,106300,75492
156,110,46,575,50000,75493
3895,2931,964,716,93200,75494
2697,2165,532,823,156800,75495
1351,1058,293,552,85800,75496
1435,1258,177,618,150400,75497
13019,8074,4945,666,89900,75501
9200,6101,3099,817,154200,75503
389,291,98,672,86600,75550
4276,3385,891,550,96700,75551
734,627,107,467,74500,75554
566,476,90,1042,76300,75555
389,326,63,835,64100,75556
489,372,117,695,70900,75558
2165,1699,466,557,71600,75559
435,400,35,736,69400,75560
2063,1405,658,722,94100,75561
34,34,0,-,-,75562
1928,1426,502,512,78000,75563
106,61,45,754,61900,75565
285,221,64,850,83000,75566
1661,1254,407,814,93900,75567
1106,752,354,397,62000,75568
1219,604,615,848,90000,75569
3285,2271,1014,605,86500,75570
1092,851,241,538,88400,75571
1353,974,379,573,74000,75572
15,6,9,-,-,75573
713,572,141,591,64600,75574
6382,3759,2623,697,132800,75601
7205,4375,2830,674,77000,75602
2392,1855,537,699,96400,75603
11433,6138,5295,803,128400,75604
11701,7680,4021,881,177000,75605
1062,871,191,513,84200,75630
1049,832,217,702,85900,75631
5379,4044,1335,677,99600,75633
2361,1816,545,740,67200,75638
1190,946,244,682,78000,75639
1574,1281,293,1189,102100,75640
84,76,8,-,75500,75641
14,14,0,-,-,75642
852,722,130,781,77700,75643
4197,3073,1124,704,95600,75644
3284,2760,524,833,106300,75645
4550,3232,1318,809,112500,75647
2920,2313,607,638,141400,75650
782,698,84,883,85500,75651
4898,3507,1391,699,113400,75652
4349,3283,1066,702,110100,75654
1726,1225,501,533,83900,75656
3404,2485,919,625,91200,75657
1135,889,246,498,64500,75661
8984,6299,2685,726,102600,75662
435,309,126,526,91300,75667
784,467,317,589,56800,75668
245,213,32,-,151300,75669
5946,3746,2200,618,69000,75670
6317,4720,1597,749,123700,75672
892,708,184,711,75100,75681
169,147,22,950,76600,75682
1609,1381,228,630,69000,75683
2520,1922,598,741,78700,75684
4684,3319,1365,728,79300,75686
1075,755,320,573,80500,75691
1753,1389,364,688,89100,75692
2390,1690,700,700,137000,75693
13149,7369,5780,828,119600,75701
8115,4188,3927,670,67200,75702
16172,8764,7408,856,187000,75703
3078,2198,880,803,77600,75704
763,532,231,817,89100,75705
2840,1754,1086,740,82500,75706
5465,3869,1596,942,150600,75707
2233,1624,609,681,63700,75708
1999,1108,891,1119,98500,75709
1476,1263,213,875,129700,75750
6038,3815,2223,732,96900,75751
2642,2197,445,773,95400,75752
2034,1667,367,844,103800,75754
2043,1540,503,659,81700,75755
1386,1191,195,757,92600,75756
4026,3372,654,802,161200,75757
3318,2641,677,669,115500,75758
39,25,14,770,59400,75759
969,776,193,571,87200,75760
4921,4104,817,1144,156300,75762
2201,1733,468,751,86400,75763
54,44,10,-,62500,75764
2798,2430,368,818,131600,75765
9248,6288,2960,652,81400,75766
1209,998,211,382,93200,75770
7331,5926,1405,873,132100,75771
4715,3578,1137,727,112900,75773
1342,1042,300,758,85100,75778
49,41,8,-,(X),75779
74,43,31,535,104200,75780
2971,2356,615,797,96900,75783
295,252,43,1327,60000,75784
3326,2377,949,772,78500,75785
148,80,68,-,-,75788
2784,2245,539,731,119200,75789
1595,1187,408,581,104200,75790
4631,3695,936,1235,149500,75791
1354,931,423,831,81100,75792
5983,3745,2238,750,79800,75801
6323,4514,1809,697,83700,75803
2016,1593,423,653,85800,75831
11,0,11,-,-,75832
1420,1191,229,613,106200,75833
4450,2756,1694,634,85000,75835
292,219,73,688,91400,75838
1888,1554,334,588,73600,75839
2738,1975,763,655,90400,75840
2436,1871,565,598,75500,75844
1301,1046,255,633,76600,75845
984,694,290,586,85000,75846
711,578,133,590,65500,75847
41,33,8,-,33200,75848
36,26,10,-,80700,75849
239,177,62,1108,(X),75850
847,653,194,893,74100,75851
438,328,110,772,144700,75852
415,360,55,(X),59800,75853
990,830,160,825,72600,75855
73,73,0,-,151500,75856
28,28,0,-,-,75858
793,691,102,581,81300,75859
2104,1657,447,603,71500,75860
555,364,191,728,87300,75861
3558,2931,627,739,81000,75862
10488,6741,3747,802,90200,75901
12513,7608,4905,793,91600,75904
1619,1188,431,600,77000,75925
458,347,111,621,57200,75926
358,290,68,-,67900,75928
661,560,101,461,68200,75929
735,610,125,-,91800,75930
906,843,63,1111,119600,75931
575,491,84,555,66400,75932
487,414,73,-,67200,75933
38,28,10,-,75000,75934
5140,3579,1561,571,80900,75935
412,339,73,398,104500,75936
332,249,83,580,64600,75937
1042,966,76,703,81100,75938
1596,1102,494,452,73400,75939
2618,1962,656,580,68200,75941
93,93,0,-,(X),75942
527,410,117,569,99300,75943
572,526,46,910,79300,75944
1293,820,473,667,91900,75946
2295,2030,265,532,88600,75948
2718,2089,629,658,82400,75949
5106,3549,1557,706,87400,75951
1133,896,237,663,67900,75954
2679,2019,660,574,75200,75956
269,245,24,-,77200,75959
336,280,56,676,74000,75960
6158,3007,3151,770,91500,75961
0,0,0,-,-,75962
6572,4034,2538,700,79400,75964
7777,3734,4043,739,158100,75965
1552,1083,469,709,67400,75966
542,462,80,471,61800,75968
1248,1013,235,723,93800,75969
2011,1656,355,630,77400,75972
891,730,161,658,74400,75973
1120,757,363,529,69200,75974
1425,1089,336,533,70600,75975
321,169,152,480,59300,75976
307,170,137,-,80000,75977
15,15,0,-,110400,75978
3901,2993,908,654,80500,75979
1144,875,269,514,61100,75980
9647,7745,1902,1173,152100,76001
9425,8133,1292,1717,148600,76002
11514,3036,8478,827,190900,76006
5039,4292,747,1419,259900,76008
6567,5136,1431,875,89000,76009
17757,6014,11743,731,80000,76010
9468,2300,7168,735,99800,76011
10057,6555,3502,895,165100,76012
12808,6750,6058,775,147700,76013
10882,5430,5452,991,93400,76014
6558,3091,3467,993,116800,76015
11445,9039,2406,1340,158500,76016
17015,11515,5500,1009,140700,76017
8919,6473,2446,1132,112200,76018
9996,7492,2504,846,124100,76020
15635,8949,6686,904,176900,76021
5542,3153,2389,950,127800,76022
2024,1572,452,872,110300,76023
22841,17622,5219,1100,146200,76028
5635,4312,1323,777,92600,76031
9372,5661,3711,819,109300,76033
8484,8170,314,1858,425400,76034
653,583,70,900,191100,76035
8075,5860,2215,1098,142400,76036
13873,5793,8080,1060,156600,76039
11535,5077,6458,755,146100,76040
83,53,30,(X),69800,76041
2960,1910,1050,850,135400,76043
1355,1112,243,945,141700,76044
8794,6026,2768,821,125300,76048
10419,8570,1849,890,178500,76049
2090,1748,342,750,170600,76050
19356,11019,8337,1099,243000,76051
5697,4990,707,1359,219600,76052
10918,6468,4450,840,122400,76053
4430,3986,444,1067,181500,76054
1075,810,265,606,75300,76055
5715,4654,1061,822,106400,76058
1603,642,961,794,96300,76059
2535,1988,547,968,163900,76060
93,93,0,-,-,76061
21649,16936,4713,1160,192400,76063
496,392,104,688,175000,76064
10525,8644,1881,1002,172100,76065
1233,971,262,762,123300,76066
7272,4515,2757,720,78000,76067
250,239,11,-,139100,76070
1247,982,265,1024,124100,76071
2134,1850,284,621,122500,76073
158,151,7,-,174600,76077
3154,2562,592,1005,121300,76078
6256,4970,1286,894,120900,76082
2391,1869,522,714,92200,76084
3123,2432,691,805,134900,76085
7816,4296,3520,926,118400,76086
9683,8482,1201,987,188300,76087
4088,3423,665,743,174400,76088
9076,8416,660,(X),556300,76092
656,456,200,908,98400,76093
3467,796,2671,1170,193500,76102
4950,2873,2077,684,81200,76103
5989,2481,3508,693,56700,76104
6343,3335,3008,756,50500,76105
9542,5187,4355,824,69300,76106
12987,6503,6484,954,227000,76107
14892,9863,5029,887,117300,76108
9653,5272,4381,982,351200,76109
9592,5935,3657,774,87200,76110
6631,4243,2388,856,79600,76111
15824,7739,8085,743,95400,76112
8615,5271,3344,842,81700,76114
5824,3084,2740,765,66700,76115
20991,8261,12730,799,131600,76116
10396,6005,4391,772,86500,76117
5388,3905,1483,844,131800,76118
13886,7253,6633,778,61600,76119
7108,2558,4550,851,133900,76120
9733,7507,2226,1403,140500,76123
7915,6468,1447,1021,151700,76126
56,0,56,1214,-,76127
0,0,0,-,-,76129
10332,7674,2658,1354,134500,76131
12321,4015,8306,863,236900,76132
18146,11668,6478,923,106800,76133
8100,5124,2976,890,91500,76134
8159,5428,2731,851,115400,76135
19890,12325,7565,1077,138100,76137
9240,6699,2541,1114,89500,76140
8152,6415,1737,1303,99200,76148
2364,0,2364,941,-,76155
4747,2869,1878,730,67200,76164
2612,1346,1266,1278,176300,76177
17117,13418,3699,1195,143600,76179
13827,6757,7070,940,135700,76180
10715,8669,2046,1182,170600,76182
9636,1833,7803,769,124300,76201
6923,2565,4358,942,170800,76205
5050,3278,1772,1032,176000,76207
7126,4558,2568,981,192100,76208
9257,4606,4651,853,118500,76209
13834,10691,3143,1150,171700,76210
1181,974,207,901,124000,76225
7045,6237,808,1746,329100,76226
8304,6332,1972,1444,163800,76227
410,324,86,615,88000,76228
3999,2846,1153,769,104200,76230
1260,963,297,915,123600,76233
5346,3990,1356,931,152000,76234
165,138,27,664,119300,76238
450,362,88,418,121400,76239
10214,6582,3632,718,118800,76240
21117,16089,5028,1449,178200,76244
707,626,81,(X),71700,76245
3950,3204,746,1124,143100,76247
12488,10141,2347,1161,283200,76248
2473,1992,481,1198,148900,76249
346,295,51,797,181300,76250
277,217,60,906,158900,76251
1043,838,205,783,154800,76252
114,90,24,503,(X),76253
2354,1657,697,611,76200,76255
2409,1906,503,953,147500,76258
1685,1309,376,1095,151900,76259
113,98,15,-,95000,76261
12368,9241,3127,1093,266400,76262
23,13,10,-,104200,76263
536,417,119,695,80200,76264
736,617,119,553,88700,76265
5097,3738,1359,1018,141500,76266
70,53,17,-,48100,76268
586,507,79,-,119600,76270
601,405,196,913,122100,76271
1626,1317,309,563,136100,76272
3279,2305,974,602,114000,76273
6722,3423,3299,592,45800,76301
5107,3080,2027,697,106100,76302
1908,1645,263,531,105000,76305
5723,3622,2101,710,74700,76306
8043,4410,3633,800,130600,76308
5174,3067,2107,690,94500,76309
7299,5025,2274,783,124700,76310
581,0,581,1183,-,76311
749,529,220,630,59800,76351
4510,3130,1380,856,92200,76354
247,201,46,592,62500,76357
1481,1087,394,524,44900,76360
116,90,26,381,31700,76363
69,53,16,-,81300,76364
1844,1481,363,627,77800,76365
890,774,116,766,96200,76366
3617,2999,618,836,86300,76367
112,88,24,(X),41300,76370
653,455,198,468,48200,76371
405,310,95,560,66400,76372
84,72,12,-,(X),76373
1538,1060,478,506,55300,76374
320,289,31,525,59900,76377
220,162,58,638,104200,76379
1734,1384,350,480,81300,76380
4991,3236,1755,547,69600,76384
132,123,9,525,(X),76388
438,337,101,900,115500,76389
10499,5653,4846,715,129100,76401
0,0,0,-,-,76402
3176,2389,787,562,79900,76424
4013,2752,1261,838,126900,76426
359,252,107,(X),59300,76427
58,58,0,-,157800,76429
1085,839,246,534,85800,76430
1171,992,179,845,106700,76431
468,410,58,594,108900,76432
530,414,116,648,197100,76433
195,152,43,631,44700,76435
78,78,0,-,(X),76436
2121,1523,598,557,67100,76437
2793,2097,696,565,68000,76442
754,583,171,612,76900,76443
1376,1097,279,425,77600,76444
106,90,16,-,63300,76445
3062,2212,850,555,87700,76446
2212,1656,556,554,74900,76448
977,778,199,598,84400,76449
5245,4164,1081,715,89000,76450
12,0,12,-,-,76452
504,448,56,711,130400,76453
539,428,111,373,49800,76454
417,333,84,542,63700,76455
1496,1033,463,611,133100,76457
1898,1423,475,752,84300,76458
79,71,8,-,47200,76459
182,150,32,-,(X),76460
1037,888,149,825,172800,76462
219,179,40,817,73100,76463
228,169,59,670,67200,76464
98,47,51,-,-,76466
17,17,0,-,(X),76469
1182,786,396,505,58500,76470
683,526,157,569,51200,76471
624,550,74,-,121100,76472
87,67,20,640,84200,76474
395,294,101,482,69700,76475
1039,830,209,867,142400,76476
62,62,0,-,-,76481
465,343,122,447,66600,76483
370,301,69,(X),103800,76484
547,479,68,627,73100,76486
894,743,151,966,142200,76487
29,29,0,-,(X),76490
168,117,51,525,36300,76491
6087,3711,2376,707,94300,76501
12991,8769,4222,900,147500,76502
8483,3482,5001,787,91400,76504
0,0,0,-,-,76508
655,525,130,552,101000,76511
11801,7871,3930,772,149400,76513
481,335,146,567,67900,76518
272,176,96,817,(X),76519
2930,1926,1004,581,77100,76520
13002,7646,5356,862,107100,76522
0,0,0,-,-,76523
1080,967,113,745,91200,76524
420,291,129,697,112200,76525
1432,1120,312,749,160900,76527
5964,4264,1700,739,104400,76528
894,709,185,529,136400,76530
1902,1492,410,588,88300,76531
774,558,216,661,89600,76534
1536,1144,392,1009,137900,76537
307,246,61,756,102100,76538
2919,2579,340,899,159700,76539
7218,2250,4968,667,66000,76541
15489,9184,6305,989,144800,76542
11039,4563,6476,803,88700,76543
5397,47,5350,1149,45600,76544
9107,5825,3282,800,168400,76548
15227,7761,7466,1020,124500,76549
4522,3047,1475,741,121900,76550
669,529,140,773,100900,76554
509,431,78,416,80200,76556
1619,1425,194,775,88900,76557
1780,999,781,833,125000,76559
418,335,83,720,80300,76561
22,22,0,-,-,76565
138,84,54,293,182100,76566
3673,2143,1530,696,84300,76567
824,667,157,674,98500,76569
899,717,182,623,59300,76570
2413,2100,313,653,241900,76571
22,11,11,-,-,76573
6313,3916,2397,834,120700,76574
1245,893,352,688,113700,76577
536,416,120,769,125000,76578
1462,1104,358,750,112400,76579
0,0,0,-,-,76596
0,0,0,-,-,76597
0,0,0,-,-,76598
0,0,0,-,-,76599
374,319,55,800,115300,76621
415,325,90,620,78600,76622
57,51,6,-,77900,76623
739,627,112,730,114800,76624
604,489,115,769,103700,76626
573,490,83,703,84400,76627
20,12,8,-,85000,76628
671,444,227,481,80300,76629
431,364,67,913,133100,76630
163,134,29,975,76500,76631
421,359,62,592,46800,76632
2036,1576,460,882,168800,76633
2652,2044,608,674,100700,76634
430,303,127,553,56900,76635
611,505,106,750,112800,76636
218,169,49,610,100500,76637
1074,889,185,1181,230000,76638
553,396,157,513,57800,76639
1206,833,373,797,79100,76640
606,511,95,753,67300,76641
2380,1856,524,647,93800,76642
5180,3802,1378,1012,139400,76643
3819,2212,1607,654,84300,76645
1062,807,255,687,81100,76648
344,305,39,658,79400,76649
48,42,6,-,52900,76650
1300,954,346,734,88500,76651
454,382,72,595,70000,76652
370,307,63,848,85400,76653
59,54,5,-,68600,76654
3000,2525,475,917,164500,76655
766,584,182,509,85500,76656
3169,2301,868,749,151700,76657
197,182,15,-,68700,76660
2434,1511,923,551,54400,76661
1160,791,369,778,74600,76664
966,633,333,550,87300,76665
104,94,10,758,65000,76666
3801,2651,1150,692,81200,76667
471,390,81,823,103600,76670
815,639,176,664,80600,76671
470,352,118,767,68400,76673
147,116,31,537,47500,76676
121,95,26,-,(X),76678
577,465,112,609,80700,76679
140,140,0,-,73700,76680
285,200,85,1028,72000,76681
982,761,221,760,86300,76682
17,7,10,-,-,76685
111,84,27,825,70000,76686
670,535,135,510,126200,76687
1285,1091,194,640,98100,76689
346,259,87,756,67800,76690
2425,1716,709,636,103700,76691
3808,2895,913,634,79200,76692
546,355,191,688,83000,76693
660,100,560,826,(X),76701
3223,1238,1985,667,62500,76704
9730,5435,4295,703,85500,76705
12544,4967,7577,742,100200,76706
5210,2542,2668,726,63300,76707
9041,5403,3638,810,104200,76708
10524,5004,5520,695,117200,76710
3115,1800,1315,830,57500,76711
9851,6840,3011,906,170500,76712
0,0,0,-,-,76798
8571,5540,3031,667,88200,76801
1706,1368,338,780,109000,76802
66,66,0,-,(X),76820
1698,1322,376,570,67900,76821
1209,913,296,547,80700,76823
0,0,0,-,-,76824
2666,2036,630,667,64900,76825
182,165,17,-,92500,76827
80,67,13,-,67500,76828
24,24,0,-,-,76831
273,188,85,769,129200,76832
2284,1516,768,545,59700,76834
13,13,0,-,-,76836
543,390,153,594,82500,76837
14,14,0,-,-,76841
74,66,8,-,(X),76842
1419,1131,288,519,128500,76844
57,35,22,-,252300,76845
39,39,0,-,(X),76848
1717,1233,484,636,85700,76849
108,94,14,631,90000,76852
605,438,167,465,87500,76853
127,83,44,-,(X),76854
1528,1190,338,746,145000,76856
818,706,112,(X),79800,76857
98,88,10,-,23900,76858
831,583,248,504,53900,76859
733,538,195,668,84000,76861
58,52,6,-,114700,76862
261,226,35,536,95000,76864
29,29,0,-,(X),76865
179,163,16,-,83100,76866
53,38,15,-,154200,76869
81,64,17,400,46300,76870
323,270,53,494,50000,76871
289,246,43,(X),144600,76872
13,13,0,-,42500,76873
40,29,11,-,-,76874
246,208,38,375,104500,76875
1440,1040,400,639,74000,76877
653,417,236,471,53700,76878
87,71,16,-,(X),76882
81,60,21,-,31400,76884
49,19,30,-,-,76885
49,49,0,-,(X),76887
55,52,3,-,96700,76888
328,273,55,900,112500,76890
11194,7262,3932,825,88600,76901
11821,6991,4830,693,68900,76903
13861,7895,5966,807,167800,76904
4538,3159,1379,979,104800,76905
0,0,0,-,-,76908
61,41,20,-,41000,76930
1256,855,401,629,84200,76932
650,452,198,629,84400,76933
370,320,50,675,137500,76934
531,486,45,888,183000,76935
1074,806,268,503,79200,76936
18,18,0,-,-,76937
20,6,14,-,-,76939
54,40,14,-,-,76940
559,449,110,808,142000,76941
1403,1035,368,588,78000,76943
788,551,237,531,76000,76945
10,10,0,-,-,76949
1496,961,535,613,87900,76950
451,341,110,820,86300,76951
27,13,14,-,-,76953
42,29,13,-,-,76955
0,0,0,-,-,76957
93,73,20,-,88800,76958
3185,765,2420,1293,203200,77002
4363,1709,2654,825,204800,77003
12892,4200,8692,877,215800,77004
9691,7031,2660,1673,836600,77005
11894,4134,7760,1059,383500,77006
17211,8290,8921,1395,343100,77007
15283,8417,6866,1094,344000,77008
14072,7381,6691,816,195600,77009
510,40,470,3014,(X),77010
5629,2301,3328,643,83700,77011
6144,2536,3608,656,79100,77012
5762,2289,3473,814,84900,77013
11101,5152,5949,818,123700,77014
17199,8800,8399,799,90000,77015
9255,6176,3079,748,63300,77016
9985,5290,4695,748,85700,77017
10865,7261,3604,776,271600,77018
10266,5287,4979,1347,437200,77019
8354,3800,4554,642,72800,77020
10258,3972,6286,812,81500,77021
9196,4295,4901,676,79000,77022
9360,4301,5059,694,100300,77023
15009,10270,4739,1397,770200,77024
12626,5546,7080,1034,352700,77025
7843,3316,4527,627,60500,77026
9001,3110,5891,1360,578800,77027
5285,3193,2092,751,56400,77028
5686,3216,2470,693,68900,77029
4754,2100,2654,1334,460900,77030
5809,2632,3177,766,116000,77031
4068,1273,2795,832,81600,77032
8691,5414,3277,863,61900,77033
12189,5734,6455,815,99500,77034
13435,5660,7775,731,174700,77035
25180,5055,20125,695,116200,77036
5326,3683,1643,868,86100,77037
7807,4015,3792,890,89400,77038
7379,4385,2994,774,84900,77039
17347,9042,8305,921,129000,77040
11578,9001,2577,1190,140900,77041
18270,5154,13116,906,218500,77042
8456,4998,3458,858,155100,77043
10999,8624,2375,1137,157500,77044
9696,6567,3129,872,81800,77045
699,238,461,1711,361300,77046
8573,6130,2443,1070,109800,77047
5312,3442,1870,689,73000,77048
9448,6406,3042,906,111900,77049
1454,992,462,682,70000,77050
5793,2340,3453,768,67500,77051
8596,5953,2643,1074,83400,77053
12430,1806,10624,1000,125700,77054
14637,6296,8341,832,305500,77055
9688,4301,5387,1333,629800,77056
19940,6624,13316,982,241800,77057
8349,2560,5789,955,166600,77058
5867,5474,393,1394,257100,77059
13712,3115,10597,707,87800,77060
8677,2950,5727,680,109500,77061
9763,7558,2205,1102,165300,77062
17804,4688,13116,915,182400,77063
15941,9710,6231,1070,131200,77064
14984,7021,7963,985,141400,77065
9803,6659,3144,985,116500,77066
9762,4009,5753,766,94000,77067
3915,2455,1460,944,168500,77068
8035,4697,3338,1059,203300,77069
18740,9767,8973,1130,156100,77070
10045,5658,4387,727,123400,77071
17638,8141,9497,856,94600,77072
12216,6787,5429,967,106000,77073
12348,4539,7809,762,104700,77074
12625,7052,5573,862,116600,77075
9414,4660,4754,793,84200,77076
25129,9115,16014,1060,219800,77077
4720,2673,2047,839,70800,77078
12351,7943,4408,1170,368100,77079
14833,5755,9078,827,145200,77080
16677,991,15686,729,171700,77081
21450,7656,13794,997,130200,77082
21204,14735,6469,919,118200,77083
33270,20180,13090,1082,128700,77084
4867,3245,1622,957,102300,77085
7980,4672,3308,886,93200,77086
10794,5677,5117,720,85000,77087
16768,10389,6379,823,93800,77088
16775,10937,5838,984,123500,77089
14527,3251,11276,873,143000,77090
8913,3636,5277,709,99300,77091
13294,5080,8214,756,132100,77092
11602,6684,4918,732,75700,77093
3057,2588,469,1389,337100,77094
24198,17562,6636,1093,170600,77095
14635,7289,7346,841,274000,77096
7648,2285,5363,1397,442900,77098
15663,6556,9107,822,97200,77099
0,0,0,-,-,77201
9747,4629,5118,745,96800,77301
6323,5082,1241,931,123500,77302
6223,4752,1471,878,94700,77303
10148,5717,4431,972,181000,77304
3490,2806,684,717,68900,77306
6493,5485,1008,849,228300,77316
5489,4476,1013,1186,169200,77318
8998,5963,3035,749,112300,77320
15,15,0,-,-,77326
6944,4837,2107,720,79600,77327
4898,3998,900,745,89000,77328
2734,2443,291,742,116200,77331
68,68,0,-,-,77334
844,660,184,583,80400,77335
4281,3378,903,1063,159400,77336
12814,7012,5802,931,106500,77338
15361,9907,5454,1116,154200,77339
9802,4164,5638,807,142800,77340
0,0,0,-,-,77342
9995,8148,1847,1171,242600,77345
18927,15430,3497,1249,163200,77346
43,39,4,-,66400,77350
12253,9722,2531,650,86000,77351
10856,9276,1580,1069,214200,77354
8666,7105,1561,1039,178500,77355
10079,8571,1508,1252,225800,77356
6871,5207,1664,779,89700,77357
1970,1363,607,769,86300,77358
315,252,63,-,143800,77359
2256,1819,437,747,54800,77360
1500,1304,196,(X),131600,77362
1201,973,228,930,101700,77363
728,680,48,638,126300,77364
9590,6800,2790,923,137800,77365
108,64,44,647,(X),77367
101,101,0,-,106700,77368
240,204,36,-,28900,77369
2601,1928,673,575,58900,77371
4101,3153,948,809,79000,77372
18830,13772,5058,1231,115300,77373
134,122,12,-,99200,77374
14080,9333,4747,1084,151200,77375
188,188,0,-,31900,77376
10522,8394,2128,1029,220800,77377
4848,3495,1353,694,92100,77378
25319,19745,5574,1153,202300,77379
10993,4585,6408,1172,196600,77380
13929,10489,3440,1226,302900,77381
12110,9457,2653,1562,366500,77382
6039,3733,2306,1262,257500,77384
7209,5737,1472,1100,174100,77385
14341,11151,3190,1340,180500,77386
14998,12911,2087,1486,155600,77388
9220,8310,910,1508,232100,77389
15531,9014,6517,1093,117100,77396
6655,5519,1136,1417,708800,77401
11660,10583,1077,1131,223100,77406
11644,9820,1824,1511,188000,77407
50,46,4,-,94200,77412
8345,5041,3304,649,99700,77414
31,31,0,-,-,77415
1076,778,298,772,83000,77417
4044,2965,1079,842,165800,77418
437,328,109,800,82900,77419
803,691,112,544,78600,77420
4575,3700,875,751,86600,77422
3406,2303,1103,776,138700,77423
782,685,97,-,154900,77426
0,0,0,-,-,77428
25991,21401,4590,1201,194900,77429
800,681,119,620,116300,77430
16,16,0,-,-,77432
19465,16311,3154,1432,194900,77433
1551,1124,427,745,71700,77434
1649,1148,501,901,120400,77435
0,0,0,-,-,77436
5811,4060,1751,700,115000,77437
0,0,0,-,-,77440
2390,2245,145,603,394000,77441
410,329,81,543,128900,77442
17,17,0,-,-,77443
292,269,23,(X),(X),77444
4277,2646,1631,813,138100,77445
499,131,368,927,129200,77446
4062,3384,678,1077,126300,77447
50,28,22,-,-,77448
30407,22355,8052,1283,122700,77449
24901,17628,7273,1232,214600,77450
28,26,2,-,(X),77451
104,46,58,700,(X),77453
71,71,0,-,(X),77454
793,626,167,684,104600,77455
469,411,58,686,72300,77456
213,182,31,-,135900,77457
165,137,28,-,37700,77458
20250,17652,2598,1653,217200,77459
31,24,7,-,-,77460
3607,2898,709,803,122200,77461
85,45,40,742,128400,77464
2929,2388,541,653,92100,77465
265,155,110,947,151000,77466
32,4,28,-,-,77467
116,116,0,-,(X),77468
12904,9417,3487,887,168200,77469
126,126,0,-,65000,77470
12223,6920,5303,894,117100,77471
33,23,10,963,(X),77473
4565,3239,1326,796,163900,77474
183,157,26,-,74600,77475
65,40,25,-,340000,77476
12926,6014,6912,1103,145600,77477
8759,7113,1646,1320,250100,77478
25629,21533,4096,1699,302600,77479
2708,1985,723,753,100100,77480
10,3,7,-,-,77481
850,655,195,648,76000,77482
98,39,59,-,-,77483
3817,2854,963,848,134900,77484
1650,1279,371,739,131600,77485
2532,2025,507,827,113900,77486
5413,3258,2155,661,93300,77488
11682,9010,2672,1222,108700,77489
8141,6427,1714,1157,157100,77493
27192,23025,4167,1506,288100,77494
15339,11134,4205,1281,165700,77498
10930,6803,4127,822,91400,77502
7889,4235,3654,805,90800,77503
8802,3468,5334,802,125700,77504
8410,5950,2460,892,161200,77505
10770,4401,6369,710,69400,77506
0,0,0,-,-,77507
5286,4300,986,950,151600,77510
16092,11555,4537,817,111300,77511
1706,1354,352,709,102800,77514
9986,6869,3117,736,101700,77515
1783,1651,132,984,158600,77517
3312,2216,1096,777,80900,77518
446,416,30,-,62100,77519
12561,7567,4994,814,78500,77520
18434,11315,7119,818,119000,77521
6417,5140,1277,978,176100,77523
9132,5816,3316,797,85700,77530
5899,2975,2924,772,99800,77531
9645,7724,1921,946,123200,77532
302,214,88,622,63400,77533
999,824,175,832,118500,77534
9829,7629,2200,831,99000,77535
10888,8337,2551,1097,137300,77536
367,346,21,950,84200,77538
14667,10355,4312,870,136800,77539
6483,4146,2337,666,83600,77541
6203,5159,1044,1336,141300,77545
17294,13698,3596,1183,193400,77546
2656,1699,957,841,64700,77547
9899,3896,6003,799,120500,77550
7677,3423,4254,881,135000,77551
3702,2326,1376,913,263900,77554
270,255,15,-,(X),77560
41,34,7,-,(X),77561
3573,2733,840,959,91700,77562
3869,2682,1187,879,122100,77563
799,747,52,-,72100,77564
2914,1808,1106,1228,197800,77565
11350,7624,3726,870,151500,77566
5517,3929,1588,846,85400,77568
12891,9581,3310,1009,124400,77571
27846,20706,7140,1187,194700,77573
5725,4200,1525,811,99800,77575
481,445,36,625,113700,77577
5178,4315,863,1020,183900,77578
166,166,0,-,287000,77580
15895,11989,3906,982,180200,77581
7086,5775,1311,674,144400,77583
27838,20680,7158,1312,196700,77584
385,311,74,(X),33400,77585
8568,5855,2713,920,192700,77586
4616,2830,1786,738,82700,77587
10932,6616,4316,797,92400,77590
5269,2820,2449,865,99900,77591
277,260,17,-,95200,77597
9951,2114,7837,954,123400,77598
3037,2379,658,774,132900,77611
3522,2926,596,696,91300,77612
450,345,105,682,107500,77613
258,217,41,-,104400,77614
307,257,50,496,68300,77615
340,292,48,-,73400,77616
45,45,0,-,(X),77617
6252,4554,1698,810,99600,77619
484,457,27,788,124800,77622
224,157,67,547,87700,77623
483,409,74,-,86700,77624
3071,2628,443,771,86900,77625
9061,6587,2474,842,128400,77627
274,201,73,456,108600,77629
11212,7459,3753,758,97500,77630
8928,7519,1409,717,113600,77632
6346,4281,2065,713,62600,77640
13352,7256,6096,700,65700,77642
628,509,119,807,216600,77650
4994,3753,1241,878,143200,77651
132,123,9,-,95400,77655
6875,5307,1568,721,83800,77656
7797,5904,1893,869,143100,77657
1823,1598,225,824,120100,77659
463,407,56,640,66100,77660
289,240,49,-,101500,77661
10045,8114,1931,735,83200,77662
369,369,0,-,156300,77663
997,981,16,-,83000,77664
2297,1714,583,772,106900,77665
5230,2866,2364,660,54600,77701
1079,452,627,765,87200,77702
5366,2660,2706,693,54600,77703
10786,6678,4108,710,74200,77705
12846,7788,5058,788,163300,77706
6354,4510,1844,864,99300,77707
4584,2487,2097,796,105100,77708
5543,3604,1939,919,135400,77713
6691,1054,5637,731,103500,77801
10519,5377,5142,880,153300,77802
9056,5136,3920,749,82600,77803
3304,2268,1036,765,141900,77807
3883,3382,501,954,180200,77808
1044,832,212,555,161700,77830
1215,1131,84,811,93400,77831
9806,6931,2875,779,156900,77833
885,718,167,674,139600,77835
4232,3368,864,743,99700,77836
637,364,273,583,70000,77837
20373,2604,17769,859,161000,77840
19932,13222,6710,1112,199300,77845
457,372,85,492,101700,77853
15,15,0,-,-,77855
1832,1376,456,605,164600,77856
316,253,63,555,78300,77857
2561,1803,758,632,76900,77859
950,841,109,933,118700,77861
2881,1812,1069,757,100100,77864
642,600,42,532,133800,77865
43,41,2,-,39800,77867
4872,3463,1409,672,105100,77868
1142,992,150,662,137500,77871
584,479,105,692,91300,77872
511,442,69,547,87200,77873
82,67,15,-,(X),77876
134,44,90,545,(X),77878
1973,1703,270,613,79000,77879
585,509,76,(X),154500,77880
15085,7855,7230,774,87100,77901
10345,7627,2718,856,159200,77904
5157,4521,636,813,120600,77905
115,63,52,-,79300,77950
773,591,182,558,57200,77951
3624,2630,994,695,111400,77954
2919,2107,812,800,90200,77957
10,10,0,-,-,77960
66,66,0,-,-,77961
1041,758,283,782,95300,77962
2190,1829,361,683,117000,77963
3367,2627,740,633,152000,77964
888,732,156,821,131300,77968
51,39,12,-,70400,77969
188,129,59,522,233800,77970
364,295,69,-,83400,77971
22,0,22,-,-,77973
166,148,18,-,105800,77974
754,577,177,764,104100,77975
51,33,18,-,142200,77976
259,161,98,575,54600,77977
280,197,83,1029,69800,77978
6474,4545,1929,774,100300,77979
333,283,50,-,169300,77982
884,622,262,686,101400,77983
1635,1363,272,645,118300,77984
97,78,19,-,69000,77987
116,72,44,841,154500,77988
287,199,88,785,62800,77990
134,109,25,-,(X),77991
130,88,42,-,(X),77993
181,162,19,-,98700,77994
3394,2504,890,598,86800,77995
0,0,0,-,-,78001
2235,1692,543,604,103700,78002
3530,2968,562,864,137000,78003
482,476,6,-,296400,78004
197,191,6,-,141400,78005
11042,7991,3051,1015,278100,78006
27,19,8,-,75600,78007
92,58,34,-,37100,78008
2812,2416,396,696,129200,78009
1216,1069,147,873,179700,78010
692,543,149,778,45700,78011
201,185,16,917,(X),78012
2113,1541,572,667,214900,78013
1543,1129,414,418,71800,78014
3821,3491,330,1344,373300,78015
3067,2428,639,682,106400,78016
1134,727,407,725,54600,78017
346,247,99,802,53400,78019
29,26,3,-,-,78021
1525,1209,316,755,94000,78022
8703,7690,1013,1147,259600,78023
525,405,120,(X),281100,78024
1689,1371,318,809,83200,78025
2067,1405,662,922,82500,78026
201,138,63,-,310400,78027
16338,10923,5415,778,158000,78028
0,0,0,-,-,78029
598,527,71,652,88900,78039
11712,5075,6637,604,75900,78040
13411,7252,6159,775,136600,78041
11862,7054,4808,730,93200,78043
54,33,21,-,59400,78044
16985,13135,3850,1082,159500,78045
15256,11079,4177,774,84600,78046
232,184,48,-,(X),78050
2083,1718,365,668,119200,78052
689,529,160,873,102800,78055
683,664,19,-,330000,78056
357,333,24,-,29300,78057
355,332,23,433,267700,78058
1924,1698,226,541,113400,78059
14,14,0,-,-,78060
3228,2150,1078,640,77300,78061
3695,3115,580,812,149400,78063
5171,3461,1710,851,122200,78064
3187,2560,627,645,79800,78065
112,64,48,-,(X),78066
234,188,46,-,50400,78067
1695,1299,396,707,88000,78069
5499,4851,648,1187,270200,78070
1119,808,311,688,75500,78071
233,195,38,522,67600,78072
2255,1729,526,646,73800,78073
35,24,11,-,37100,78075
4184,3155,1029,410,55700,78076
2609,2378,231,1042,202900,78101
7385,4308,3077,797,74200,78102
39,37,2,-,76100,78104
93,67,26,-,(X),78107
10452,8727,1725,1484,194200,78108
11567,7783,3784,1091,125600,78109
2115,1721,394,825,82400,78112
1044,879,165,763,161500,78113
7192,5702,1490,731,144500,78114
100,85,15,-,206300,78116
260,233,27,880,120200,78117
1204,864,340,695,86200,78118
1716,1290,426,545,73400,78119
4045,3692,353,968,180500,78121
130,130,0,-,(X),78122
1034,750,284,766,101500,78123
2051,1633,418,876,131800,78124
37,31,6,-,207500,78125
22547,14555,7992,970,162400,78130
8483,7374,1109,882,277500,78132
7159,5794,1365,942,170200,78133
1120,766,354,635,66900,78140
266,223,43,544,85800,78141
39,29,10,-,104700,78142
87,87,0,-,(X),78143
36,25,11,-,72200,78144
40,33,7,-,112500,78145
140,98,42,1034,58600,78146
657,465,192,746,113700,78147
7904,4078,3826,904,146300,78148
0,0,0,-,-,78150
583,391,192,557,78300,78151
793,701,92,733,157900,78152
12108,8606,3502,1052,169200,78154
17023,12292,4731,753,116500,78155
334,225,109,459,109000,78159
1644,1228,416,913,129500,78160
268,245,23,-,102100,78161
138,131,7,-,73700,78162
3659,3441,218,1147,295500,78163
1539,1323,216,543,87700,78164
15450,7620,7830,718,82300,78201
3797,1805,1992,688,57600,78202
1944,861,1083,710,63300,78203
4151,2381,1770,767,71600,78204
806,85,721,603,344100,78205
15667,7111,8556,580,58000,78207
1382,528,854,657,68300,78208
17917,10197,7720,875,300200,78209
13355,7102,6253,752,76800,78210
9123,5873,3250,740,63700,78211
10765,5122,5643,735,117000,78212
16395,7414,8981,821,105000,78213
7421,4243,3178,718,64300,78214
1015,47,968,1068,302100,78215
17631,6319,11312,816,158700,78216
14007,6014,7993,833,119000,78217
12435,5676,6759,815,89500,78218
5388,3055,2333,797,80900,78219
5551,3151,2400,781,68400,78220
11346,6947,4399,757,79400,78221
7031,4691,2340,832,97000,78222
17045,9970,7075,758,85900,78223
5416,3276,2140,810,80200,78224
4356,2755,1601,750,67200,78225
2163,804,1359,584,65000,78226
14459,7552,6907,776,78200,78227
19469,11658,7811,735,86600,78228
14043,2316,11727,833,118600,78229
18578,8686,9892,908,192800,78230
3316,2515,801,942,231500,78231
15749,9045,6704,1026,202100,78232
16626,10032,6594,950,114600,78233
1052,10,1042,1522,-,78234
346,0,346,1155,-,78235
406,0,406,1439,-,78236
10976,7064,3912,727,58000,78237
9462,4424,5038,846,113400,78238
9563,6651,2912,1048,114000,78239
23799,8173,15626,915,144400,78240
8923,5239,3684,834,67000,78242
0,0,0,-,-,78243
9398,6222,3176,1107,111800,78244
19007,12983,6024,1063,120000,78245
18013,13734,4279,1109,148900,78247
5632,4427,1205,1092,276400,78248
18466,11094,7372,1101,165100,78249
18684,13897,4787,1049,125900,78250
19016,10847,8169,1029,145500,78251
2094,1519,575,1171,113200,78252
11368,9524,1844,1334,198500,78253
15497,12632,2865,1201,159100,78254
4186,3575,611,1553,281700,78255
3314,1469,1845,1075,390600,78256
1712,1271,441,963,572400,78257
15263,10126,5137,1265,283700,78258
8136,6076,2060,1226,219600,78259
8854,7506,1348,1421,281300,78260
4983,3978,1005,1369,258900,78261
1523,1326,197,866,166700,78263
3027,2374,653,849,75100,78264
2193,2052,141,2550,372700,78266
321,254,67,717,61000,78330
9547,6135,3412,702,73200,78332
0,0,0,-,-,78335
4684,2866,1818,806,100200,78336
10,4,6,-,-,78338
192,123,69,777,34500,78339
190,153,37,513,88100,78340
812,550,262,723,40500,78341
128,114,14,-,32300,78342
1519,1210,309,686,68300,78343
146,123,23,680,78500,78344
212,203,9,-,40500,78349
186,137,49,625,35400,78351
87,54,33,-,33500,78352
146,99,47,-,54300,78353
2008,1387,621,533,51500,78355
1013,754,259,696,60400,78357
294,153,141,894,34800,78358
650,436,214,689,58500,78359
1688,1319,369,490,68500,78361
3270,2307,963,885,109400,78362
10364,5326,5038,745,80800,78363
3123,2300,823,547,60000,78368
92,64,28,679,(X),78369
1612,1222,390,871,76600,78370
123,103,20,-,49800,78371
1963,1472,491,824,81300,78372
1907,1155,752,1152,293900,78373
5991,3753,2238,1095,145800,78374
1070,851,219,588,55600,78375
253,190,63,525,30600,78376
1400,990,410,599,78900,78377
541,442,99,730,80800,78379
7519,5067,2452,758,74200,78380
8237,6190,2047,779,150600,78382
1464,1343,121,(X),109200,78383
1950,1208,742,728,52800,78384
104,40,64,583,(X),78385
3209,2249,960,744,68000,78387
536,394,142,913,68300,78389
1833,1336,497,666,68300,78390
105,87,18,-,51300,78391
821,657,164,669,60500,78393
1807,423,1384,562,57400,78401
273,84,189,1125,151500,78402
6664,3122,3542,822,100800,78404
5337,2981,2356,650,51500,78405
259,206,53,695,64300,78406
1164,570,594,785,60000,78407
4102,2006,2096,671,63100,78408
982,599,383,695,84700,78409
9203,5921,3282,961,134100,78410
10458,6101,4357,833,106400,78411
14771,6749,8022,920,114100,78412
14595,8209,6386,980,155600,78413
12891,8574,4317,1081,171200,78414
13486,7912,5574,816,84000,78415
5148,3328,1820,781,64700,78416
1381,1098,283,671,83000,78417
12428,6755,5673,1008,154600,78418
213,3,210,1375,-,78419
20110,10357,9753,658,92800,78501
6474,4172,2302,732,87300,78503
16164,11434,4730,825,141700,78504
9769,7425,2344,487,52400,78516
18243,10962,7281,564,82000,78520
25630,15493,10137,642,65700,78521
12534,9367,3167,754,102400,78526
210,145,65,826,51800,78535
92,69,23,-,33500,78536
10793,7937,2856,546,53600,78537
3056,2170,886,511,49900,78538
10565,6254,4311,707,110700,78539
12200,6413,5787,694,83600,78541
15748,12018,3730,553,74900,78542
2639,1672,967,514,62900,78543
151,93,58,-,53000,78545
130,121,9,-,51900,78548
181,158,23,-,51900,78549
16074,8728,7346,694,75700,78550
11552,9034,2518,766,96300,78552
3065,2253,812,613,88400,78557
298,206,92,569,73900,78558
3722,2694,1028,614,63400,78559
1422,881,541,632,82500,78560
176,153,23,-,35500,78561
748,608,140,456,49700,78562
64,57,7,-,53300,78563
15,0,15,-,-,78564
126,108,18,-,40400,78565
4641,3482,1159,678,91400,78566
190,179,11,-,52600,78567
1150,1014,136,631,55000,78569
8808,6232,2576,504,54200,78570
23228,16513,6715,697,78400,78572
8977,6071,2906,671,87900,78573
15547,12010,3537,585,75200,78574
2609,2005,604,1009,123100,78575
2250,1833,417,573,58500,78576
20462,12491,7971,690,71900,78577
4246,2865,1381,623,113500,78578
945,733,212,564,58300,78579
3570,2588,982,485,50900,78580
10578,8131,2447,534,64800,78582
2456,2086,370,617,47500,78583
4972,3529,1443,478,68000,78584
136,119,17,-,37400,78585
15417,11392,4025,545,62000,78586
89,65,24,396,(X),78588
9887,7610,2277,621,79900,78589
79,61,18,-,34100,78590
81,67,14,-,48900,78591
272,220,52,505,31800,78592
1640,1190,450,553,54300,78593
545,437,108,278,41700,78594
1639,1344,295,520,60700,78595
18849,13592,5257,619,71500,78596
1661,1043,618,854,262800,78597
43,31,12,-,106300,78598
8586,6297,2289,918,154900,78602
1903,1503,400,837,150200,78605
1966,1503,463,765,173100,78606
73,64,9,-,121300,78607
184,171,13,-,158100,78608
884,748,136,817,162900,78609
9723,7886,1837,1038,191900,78610
5179,3666,1513,813,137600,78611
3485,2887,598,1139,138500,78612
24111,17315,6796,1141,221700,78613
179,159,20,-,149100,78614
388,341,47,923,145300,78615
1940,1319,621,855,106700,78616
6278,4811,1467,1085,104200,78617
137,127,10,780,217900,78618
1386,1115,271,(X),380000,78619
5358,4538,820,1004,317500,78620
7320,5899,1421,892,113700,78621
94,62,32,912,(X),78622
329,258,71,(X),197000,78623
9065,6757,2308,884,245400,78624
9484,6042,3442,898,159700,78626
10186,7370,2816,1003,236400,78628
3890,2578,1312,615,95000,78629
1006,844,162,725,127400,78631
386,324,62,485,121700,78632
10339,9678,661,1544,247800,78633
8334,6847,1487,1192,151300,78634
13,0,13,-,-,78635
1654,1197,457,685,217400,78636
893,697,196,610,144500,78638
3117,2241,876,741,115000,78639
13727,10529,3198,1241,145500,78640
16445,13006,3439,1313,171600,78641
3049,2707,342,962,236200,78642
2507,1902,605,711,139300,78643
5811,3796,2015,834,123800,78644
4406,3528,878,1037,188900,78645
2932,1964,968,636,103600,78648
600,492,108,840,100800,78650
2017,1336,681,1218,196700,78652
5524,4609,915,1191,145000,78653
7176,5082,2094,862,179600,78654
1128,840,288,891,125000,78655
695,461,234,778,87100,78656
2568,2084,484,1013,273900,78657
1049,873,176,672,123100,78659
26362,20013,6349,1139,172900,78660
125,108,17,(X),55000,78661
1033,897,136,861,100800,78662
328,255,73,(X),154000,78663
19403,10791,8612,1056,157300,78664
13130,9557,3573,1219,201900,78665
25565,9562,16003,929,136600,78666
3620,3153,467,1160,328300,78669
77,55,22,910,105800,78670
249,212,37,599,137500,78671
551,471,80,570,77200,78672
92,92,0,-,(X),78675
5241,4467,774,1019,233800,78676
35,35,0,-,(X),78677
17147,13034,4113,1113,230100,78681
4366,1633,2733,1752,440100,78701
8337,3873,4464,893,235400,78702
9756,4948,4808,1266,704700,78703
22043,7639,14404,1088,385700,78704
8704,971,7733,1108,385600,78705
0,0,0,-,-,78712
9269,5851,3418,1103,273200,78717
416,356,60,817,113300,78719
4176,2149,2027,920,156800,78721
2973,1271,1702,1081,293000,78722
11989,5020,6969,856,207600,78723
6003,3413,2590,946,109100,78724
2294,1804,490,1291,121100,78725
5237,2214,3023,1059,358100,78726
12856,6175,6681,1160,215500,78727
9639,3017,6622,991,182300,78728
12734,5488,7246,1057,205600,78729
3631,2294,1337,1187,576100,78730
12331,7163,5168,1150,476400,78731
5202,4149,1053,1393,467300,78732
2981,2654,327,1653,497900,78733
7283,5650,1633,1564,340800,78734
7362,3970,3392,1240,410400,78735
2904,2475,429,1373,266100,78736
4808,4405,403,1579,350900,78737
5109,3979,1130,1402,469200,78738
6003,5720,283,2282,381400,78739
20177,2822,17355,901,139000,78741
273,167,106,911,76400,78742
13249,6136,7113,1012,106000,78744
24940,11422,13518,1092,183900,78745
10920,7634,3286,1421,713400,78746
6122,4184,1938,1180,169400,78747
17683,10703,6980,1198,205800,78748
14688,8980,5708,1284,257400,78749
11151,7172,3979,1151,322700,78750
7388,1842,5546,963,322900,78751
7579,1851,5728,852,187400,78752
18672,6351,12321,893,142700,78753
7171,3512,3659,1055,159300,78754
4408,1952,2456,1023,395600,78756
10591,6285,4306,1020,302500,78757
18447,5348,13099,962,151200,78758
19851,8795,11056,1081,341200,78759
6691,4787,1904,635,77900,78801
201,155,46,-,115200,78802
411,294,117,464,50400,78827
81,81,0,-,76000,78828
409,332,77,474,50400,78829
209,180,29,646,38200,78830
1079,855,224,578,72200,78832
437,319,118,710,94600,78833
2876,1922,954,670,64400,78834
62,62,0,-,37600,78836
85,70,15,-,66700,78837
79,70,9,-,245200,78838
2634,1683,951,454,39000,78839
14672,9508,5164,676,92700,78840
10,0,10,-,-,78843
396,339,57,626,147000,78850
12,10,2,-,-,78851
15525,10789,4736,589,88800,78852
99,99,0,-,56000,78860
3830,2660,1170,743,112500,78861
371,290,81,521,65300,78870
7,7,0,-,-,78871
594,451,143,523,45800,78872
712,574,138,835,115000,78873
355,285,70,-,151800,78877
150,141,9,-,131800,78879
647,576,71,473,62800,78880
754,627,127,770,59800,78881
180,152,28,840,378600,78883
391,305,86,523,122400,78884
55,52,3,-,148600,78885
198,180,18,-,133300,78886
90,64,26,-,109200,78931
247,208,39,686,124400,78932
527,518,9,-,170900,78933
2358,1851,507,599,133200,78934
460,452,8,-,179400,78935
158,129,29,-,64100,78938
905,797,108,714,128900,78940
1094,820,274,557,115000,78941
2934,1952,982,752,99700,78942
51,44,7,-,75000,78943
229,206,23,594,163800,78944
3918,2991,927,839,139400,78945
417,338,79,809,125000,78946
1607,1358,249,800,133000,78947
293,266,27,-,209500,78948
177,123,54,524,154900,78949
910,726,184,783,155200,78950
0,0,0,-,-,78951
255,227,28,850,87100,78953
455,417,38,741,213700,78954
2072,1545,527,692,121200,78956
3728,2838,890,814,117700,78957
626,484,142,558,54600,78959
2066,1769,297,677,119500,78962
325,290,35,-,151900,78963
121,92,29,-,65700,79001
75,52,23,-,95000,79003
570,392,178,654,118200,79005
5372,3839,1533,676,68300,79007
653,377,276,570,77400,79009
161,84,77,431,(X),79010
128,96,32,(X),80000,79011
471,471,0,-,213200,79012
860,419,441,564,28200,79013
1443,1043,400,708,130300,79014
7783,4668,3115,743,172100,79015
0,0,0,-,-,79016
161,94,67,732,65600,79018
639,476,163,704,113700,79019
39,8,31,425,(X),79021
3332,2113,1219,714,102900,79022
178,122,56,688,70000,79024
32,9,23,-,-,79025
1567,1072,495,664,68900,79027
5165,3591,1574,726,104100,79029
460,380,80,538,79500,79031
39,30,9,-,91800,79032
33,27,6,-,(X),79033
231,192,39,570,87100,79034
1527,1002,525,655,71900,79035
2113,1907,206,639,83500,79036
368,331,37,613,95600,79039
564,369,195,661,97800,79040
1233,903,330,599,62500,79041
440,333,107,677,66300,79042
460,318,142,804,58800,79043
288,153,135,725,106800,79044
6197,4189,2008,702,86100,79045
192,134,58,692,59600,79046
18,0,18,-,-,79051
394,305,89,638,76500,79052
57,36,21,518,117300,79053
184,130,54,558,29400,79054
23,18,5,-,90000,79056
513,365,148,532,62100,79057
0,0,0,-,-,79058
298,253,45,844,99400,79059
161,117,44,569,56800,79061
107,79,28,844,57500,79062
252,220,32,545,125000,79063
852,536,316,593,62600,79064
7651,5637,2014,685,77200,79065
1132,1003,129,733,101900,79068
3579,2584,995,700,84300,79070
8755,5062,3693,607,75900,79072
102,95,7,-,(X),79078
1169,798,371,581,73800,79079
225,189,36,675,39600,79080
1455,1137,318,626,79100,79081
101,77,24,963,81000,79082
850,670,180,853,68200,79083
760,588,172,629,77800,79084
10,10,0,-,-,79085
870,668,202,610,81800,79086
245,169,76,673,64500,79087
1936,1394,542,597,67300,79088
77,66,11,-,74700,79091
385,338,47,596,96000,79092
20,20,0,-,65800,79093
24,24,0,-,55000,79094
989,756,233,486,64200,79095
801,591,210,676,103800,79096
420,383,37,1013,88000,79097
177,145,32,750,110400,79098
1218,251,967,721,73100,79101
4022,2040,1982,661,92800,79102
3848,2816,1032,788,81200,79103
2396,1376,1020,641,63700,79104
0,0,0,-,-,79105
11923,6226,5697,707,107500,79106
10972,6543,4429,729,62500,79107
4618,3583,1035,728,99600,79108
18483,11133,7350,734,148100,79109
7353,4956,2397,831,106600,79110
451,6,445,890,-,79111
6747,5383,1364,1042,142600,79118
5365,4112,1253,930,239400,79119
2934,2161,773,780,180400,79121
3079,2555,524,958,218500,79124
2402,1539,863,702,73600,79201
119,64,55,532,101900,79220
412,294,118,625,48100,79225
1163,879,284,592,62800,79226
527,414,113,300,54400,79227
163,133,30,613,40700,79229
41,40,1,-,(X),79230
0,0,0,-,-,79231
46,41,5,-,21100,79233
28,19,9,-,58300,79234
1442,956,486,660,60000,79235
102,26,76,743,71000,79236
161,115,46,425,46100,79237
86,54,32,-,63300,79239
7,7,0,-,-,79240
948,654,294,625,72200,79241
24,14,10,-,(X),79243
255,185,70,525,54300,79244
839,581,258,465,34500,79245
30,30,0,-,27700,79247
610,433,177,275,41800,79248
509,372,137,659,61300,79250
21,21,0,-,(X),79251
1253,916,337,473,45100,79252
250,148,102,546,60000,79255
154,113,41,508,45600,79256
437,365,72,637,62800,79257
5,0,5,-,-,79258
18,18,0,-,(X),79259
183,124,59,500,57000,79261
1363,955,408,757,81900,79311
399,289,110,489,53200,79312
587,409,178,590,59800,79313
42,38,4,-,35500,79314
3599,2615,984,715,64800,79316
814,522,292,564,49400,79322
2145,1576,569,689,73400,79323
7,7,0,-,-,79324
851,682,169,683,118200,79325
6,6,0,-,-,79326
1228,844,384,853,117500,79329
61,53,8,-,(X),79330
4035,2890,1145,580,62000,79331
6038,3973,2065,649,88600,79336
2525,1726,799,689,61100,79339
162,106,56,(X),70000,79342
501,341,160,494,58700,79343
13,13,0,-,-,79344
303,226,77,533,64200,79345
790,629,161,449,32400,79346
2518,1738,780,671,59600,79347
109,67,42,832,73900,79350
473,328,145,589,51000,79351
8,0,8,-,-,79353
731,509,222,683,82200,79355
1446,960,486,732,78600,79356
829,573,256,641,53000,79357
367,298,69,580,83600,79358
924,575,349,666,60600,79359
4320,3517,803,840,99100,79360
1746,1282,464,766,102600,79363
3315,2474,841,706,74600,79364
508,468,40,(X),207800,79366
269,209,60,818,65200,79367
33,25,8,-,17500,79369
604,478,126,465,52300,79370
498,393,105,543,61300,79371
420,295,125,767,64800,79372
1239,860,379,590,71200,79373
37,22,15,-,121400,79376
89,74,15,(X),66400,79377
138,69,69,353,33400,79378
203,151,52,445,29800,79379
81,49,32,917,(X),79380
473,377,96,600,83700,79381
1943,1498,445,844,147100,79382
3407,298,3109,798,66700,79401
5203,3427,1776,693,49400,79403
3292,1997,1295,738,55600,79404
0,0,0,-,-,79406
7749,3794,3955,752,93000,79407
3801,1569,2232,982,119800,79410
3269,1230,2039,789,56700,79411
5409,2799,2610,718,74600,79412
8702,5039,3663,935,121200,79413
7997,2953,5044,792,85900,79414
6256,2667,3589,753,59600,79415
12895,6395,6500,892,112500,79416
13498,9923,3575,945,124000,79423
17271,12511,4760,857,171900,79424
1172,891,281,882,65000,79501
515,407,108,439,45800,79502
79,73,6,-,318900,79503
1180,963,217,539,66400,79504
126,91,35,536,42300,79505
384,278,106,475,64300,79506
471,438,33,888,165500,79508
2943,2435,508,750,74200,79510
492,425,67,766,94500,79511
2319,1575,744,610,61000,79512
70,56,14,(X),(X),79517
52,48,4,-,82900,79518
38,38,0,-,158300,79519
986,736,250,517,47900,79520
1399,1046,353,400,57300,79521
871,747,124,668,75900,79525
453,378,75,862,78500,79526
83,73,10,420,62500,79527
296,207,89,511,68100,79528
511,388,123,438,38900,79529
162,153,9,708,38600,79530
352,295,57,456,37500,79532
127,91,36,475,30300,79533
40,37,3,-,(X),79534
38,31,7,-,68800,79535
1868,1468,400,786,66900,79536
33,30,3,-,43800,79537
85,77,8,-,(X),79538
71,55,16,520,25400,79539
33,33,0,-,69700,79540
308,233,75,830,153800,79541
483,376,107,463,69100,79543
228,175,53,(X),19100,79544
696,571,125,647,62800,79545
839,511,328,479,60400,79546
312,264,48,557,40900,79547
104,58,46,-,83300,79548
5312,3967,1345,716,90300,79549
1440,925,515,616,57900,79553
4795,3132,1663,580,58500,79556
43,43,0,-,63000,79560
244,189,55,600,66300,79561
1346,1260,86,663,167900,79562
402,292,110,548,48400,79563
96,75,21,-,55000,79565
179,166,13,-,111700,79566
1169,818,351,437,50400,79567
7757,3624,4133,714,85700,79601
8037,5690,2347,778,128700,79602
8563,5530,3033,649,68200,79603
11411,6504,4907,775,94000,79605
9549,5390,4159,864,153900,79606
646,13,633,1178,-,79607
0,0,0,-,-,79699
9479,6368,3111,857,96100,79701
7460,4998,2462,1122,124000,79703
13141,9029,4112,1145,206700,79705
7224,5673,1551,884,112800,79706
13876,8497,5379,1180,240100,79707
173,106,67,642,81300,79713
5476,4090,1386,929,111600,79714
265,180,85,563,50000,79718
165,115,50,490,26500,79719
10729,7124,3605,784,72900,79720
96,60,36,-,29200,79730
1492,1122,370,641,77500,79731
59,38,21,438,50000,79733
975,745,230,850,96300,79734
3618,2538,1080,768,69400,79735
125,73,52,450,68300,79738
337,223,114,1063,223900,79739
101,88,13,-,80600,79741
144,100,44,338,30000,79742
123,104,19,375,61400,79743
438,301,137,565,78500,79744
2267,1813,454,640,44100,79745
46,39,7,-,86900,79748
111,89,22,400,106900,79749
788,584,204,582,54100,79752
43,22,21,871,92500,79754
78,36,42,675,85500,79755
3290,2398,892,662,78900,79756
644,466,178,774,90400,79758
8,8,0,-,-,79759
11420,7270,4150,835,103000,79761
15866,9293,6573,1005,127900,79762
11494,7809,3685,744,81000,79763
7375,5540,1835,877,74800,79764
3865,2638,1227,1231,203400,79765
1835,1548,287,827,72200,79766
14,14,0,-,-,79770
3293,2451,842,727,45700,79772
73,35,38,-,33100,79777
351,294,57,679,60500,79778
127,113,14,-,(X),79780
67,41,26,634,33100,79781
1342,1006,336,807,96900,79782
83,73,10,-,(X),79783
51,39,12,-,27500,79785
176,147,29,725,41400,79788
354,264,90,521,55200,79789
1619,1041,578,564,94400,79821
3248,1840,1408,647,126600,79830
12,6,6,-,-,79831
88,2,86,525,-,79834
3339,2176,1163,679,65100,79835
1594,1314,280,711,79800,79836
203,113,90,519,32500,79837
2067,1417,650,491,60700,79838
536,475,61,525,44900,79839
286,201,85,470,78500,79842
915,622,293,(X),110300,79843
1689,1161,528,422,42100,79845
20,10,10,-,-,79846
56,25,31,-,18900,79847
447,299,148,747,64700,79848
3001,2146,855,636,60700,79849
158,112,46,623,45000,79851
391,278,113,402,79400,79852
758,589,169,440,43900,79853
58,37,21,458,(X),79854
773,564,209,540,60700,79855
3998,434,3564,355,64700,79901
8402,3476,4926,562,150600,79902
6160,3631,2529,486,87800,79903
11014,4659,6355,749,99900,79904
8041,4244,3797,425,77400,79905
1021,0,1021,1245,-,79906
16741,10035,6706,630,85800,79907
588,6,582,1425,-,79908
1194,1000,194,1580,223700,79911
28566,15676,12890,853,176300,79912
12520,6975,5545,548,85000,79915
4,0,4,-,-,79916
0,0,0,-,-,79920
2727,2334,393,781,297400,79922
19653,12236,7417,799,98300,79924
14873,7887,6986,775,133600,79925
10773,8247,2526,667,83900,79927
14458,11862,2596,954,115500,79928
10638,4887,5751,683,90200,79930
8678,6015,2663,805,156000,79932
7613,5667,1946,1140,133600,79934
6463,3424,3039,785,136100,79935
34861,24283,10578,964,122000,79936
18322,14060,4262,1061,135700,79938
7,7,0,-,-,79942
8227,4373,3854,942,216100,80002
14198,9884,4314,1088,215100,80003
14814,10224,4590,999,258100,80004
10671,9261,1410,1194,290800,80005
2742,2707,35,2575,464300,80007
12952,4351,8601,806,147500,80010
15838,8002,7836,959,137000,80011
18340,8514,9826,935,173800,80012
24750,17683,7067,1215,206900,80013
17930,9939,7991,1024,185100,80014
21750,17463,4287,1325,257900,80015
16434,12639,3795,1346,393500,80016
12713,6658,6055,1065,164000,80017
3421,2906,515,1513,267300,80018
845,558,287,1080,194200,80019
18249,13162,5087,1283,261500,80020
13034,7303,5731,1304,244300,80021
13488,9261,4227,929,174000,80022
6911,5903,1008,1497,445200,80023
96,81,15,-,118300,80024
147,129,18,-,712500,80025
11468,8342,3126,1228,293400,80026
12397,8556,3841,1454,420200,80027
5990,3185,2805,765,169300,80030
13056,9136,3920,1180,237700,80031
11345,5717,5628,866,247200,80033
424,0,424,1250,-,80045
148,128,20,1100,248200,80101
1850,1594,256,1047,243500,80102
948,775,173,950,204700,80103
10592,7942,2650,1214,273300,80104
558,449,109,725,186300,80105
1512,1425,87,1479,377400,80106
4271,3814,457,1085,345400,80107
8818,6985,1833,1348,490400,80108
6463,5596,867,1452,344500,80109
8896,4773,4123,963,196400,80110
12131,7749,4382,1332,493700,80111
13043,8203,4840,1318,325900,80112
9499,5208,4291,935,298100,80113
1435,1350,85,"3,500+",498900,80116
1011,893,118,1141,243900,80117
2361,2139,222,1487,475800,80118
13418,7924,5494,920,274500,80120
7122,6061,1061,1240,347900,80121
12326,10248,2078,1412,299500,80122
18660,13256,5404,1178,282800,80123
7665,4749,2916,1365,419500,80124
3776,3566,210,1808,344400,80125
15179,12522,2657,1498,366200,80126
16168,14023,2145,1285,335500,80127
14065,11650,2415,1243,272800,80128
10659,8253,2406,1567,336500,80129
10373,7901,2472,1658,352600,80130
73,73,0,-,240100,80131
6845,6212,633,1452,387100,80132
897,545,352,1038,220000,80133
21053,17510,3543,1431,329700,80134
1543,1393,150,976,481500,80135
1731,1509,222,1047,227600,80136
374,275,99,903,348700,80137
10981,9229,1752,1220,356500,80138
7812,2415,5397,1527,372400,80202
13860,2810,11050,885,253800,80203
12193,4004,8189,784,192200,80204
12972,6118,6854,949,275200,80205
12589,5843,6746,908,466700,80206
9273,6329,2944,1037,296100,80207
12956,6475,6481,1183,517800,80209
15531,8894,6637,1034,443300,80210
15403,8299,7104,872,339500,80211
8961,5504,3457,945,323400,80212
11162,4046,7116,830,222100,80214
8134,4857,3277,948,325600,80215
3306,1225,2081,1013,132100,80216
11225,3997,7228,872,341000,80218
19730,10090,9640,869,159900,80219
15846,9236,6610,918,367000,80220
12989,7973,5016,951,175100,80221
9709,5002,4707,909,268800,80222
7043,3383,3660,855,169500,80223
8399,4334,4065,917,286100,80224
13221,7350,5871,1031,234300,80226
14870,9071,5799,1043,241700,80227
13502,8918,4584,1041,285900,80228
17400,10492,6908,1071,161400,80229
3892,1928,1964,1228,451500,80230
16539,5871,10668,955,258400,80231
8900,6359,2541,1098,230200,80232
17266,10557,6709,1178,194100,80233
10347,6179,4168,1056,237200,80234
3368,1806,1562,995,240900,80235
5989,3749,2240,930,226700,80236
9709,5071,4638,1175,317700,80237
5030,3849,1181,1610,445500,80238
11128,6454,4674,1180,162700,80239
11336,8314,3022,1254,244200,80241
7233,1433,5800,879,278700,80246
13598,4818,8780,1024,122700,80247
8359,6188,2171,1375,203200,80249
11795,6741,5054,923,72500,80260
0,0,0,-,-,80264
0,0,0,-,-,80290
0,0,0,-,-,80293
0,0,0,-,-,80294
10905,6930,3975,1266,400500,80301
11987,4592,7395,1187,607500,80302
11144,4623,6521,1170,526800,80303
11193,7604,3589,1356,596300,80304
7073,4406,2667,1661,501200,80305
173,0,173,853,-,80310
16051,10848,5203,1085,376500,80401
7590,6131,1459,1233,402200,80403
0,0,0,-,-,80419
369,217,152,1166,243500,80420
3680,3097,583,1156,241700,80421
1927,1667,260,1139,259700,80422
16,11,5,-,-,80423
3303,2442,861,1145,506100,80424
122,122,0,-,388200,80425
47,41,6,-,285900,80426
480,141,339,903,177200,80427
240,180,60,1621,534100,80428
116,116,0,-,140700,80432
3234,2871,363,1334,358000,80433
17,17,0,-,75000,80434
2483,1430,1053,1028,477100,80435
246,232,14,-,252800,80436
208,146,62,775,187500,80438
9773,8376,1397,1214,429600,80439
993,675,318,1262,267400,80440
822,589,233,963,413400,80442
1434,826,608,1534,486700,80443
529,342,187,808,252000,80444
1406,952,454,1086,231600,80446
796,699,97,700,351500,80447
146,105,41,-,354700,80448
370,355,15,-,183300,80449
278,169,109,1067,224600,80451
1471,1025,446,793,207400,80452
124,92,32,-,247700,80453
477,359,118,1169,248400,80454
211,169,42,884,344800,80455
410,342,68,-,224000,80456
282,58,224,1056,191100,80457
876,564,312,1017,226700,80459
2934,1628,1306,854,166100,80461
56,47,9,-,275000,80463
6051,5341,710,1213,290400,80465
1567,937,630,961,360800,80466
946,743,203,1035,218100,80467
189,125,64,(X),301400,80468
131,85,46,725,229200,80469
1345,1236,109,1627,294400,80470
0,0,0,-,-,80471
22,22,0,-,321400,80473
82,42,40,-,-,80475
125,87,38,863,183700,80476
93,64,29,-,847200,80477
442,382,60,-,(X),80478
11,11,0,-,-,80479
577,379,198,721,151700,80480
309,297,12,1375,685100,80481
441,338,103,1003,338600,80482
225,161,64,1063,204800,80483
6751,4631,2120,1178,499700,80487
45,0,45,1099,-,80488
308,271,37,-,349700,80497
2615,1759,856,1297,486100,80498
15894,8358,7536,931,208100,80501
12788,8806,3982,1097,368300,80503
17256,14205,3051,1201,277600,80504
298,218,80,(X),301900,80510
0,0,0,-,-,80511
826,722,104,1049,290500,80512
4317,3765,552,871,295200,80513
1831,1231,600,946,169600,80514
385,339,46,-,205500,80515
7740,6814,926,1694,359700,80516
4555,3173,1382,864,334200,80517
562,444,118,1227,166700,80520
12829,4968,7861,1065,247900,80521
13423,8669,4754,929,273000,80524
20587,12480,8107,1107,284100,80525
17688,10288,7400,1069,251900,80526
6606,5557,1049,1351,345600,80528
1446,1216,230,1454,196900,80530
44,44,0,-,-,80532
5131,4554,577,1501,244900,80534
1224,828,396,929,255000,80535
880,759,121,1107,282000,80536
17457,10904,6553,936,227000,80537
18555,12797,5758,1061,235500,80538
1949,1648,301,1310,389500,80540
1323,1266,57,2183,302500,80542
2106,1782,324,1196,191800,80543
0,0,0,-,-,80544
249,210,39,-,235100,80545
37,18,19,-,215400,80546
366,327,39,1109,383800,80547
3251,2651,600,1250,221000,80549
8439,6820,1619,1155,278400,80550
11152,7431,3721,1003,205700,80601
9568,8761,807,1530,316800,80602
4215,3544,671,1250,226400,80603
1065,796,269,844,188300,80610
250,204,46,618,217900,80611
192,176,16,-,353600,80612
2808,2052,756,971,239800,80615
6141,3253,2888,1017,142300,80620
3998,2836,1162,954,173500,80621
60,50,10,-,(X),80622
294,198,96,950,133800,80623
355,226,129,897,264500,80624
16516,7300,9216,718,130400,80631
20835,14169,6666,924,196700,80634
3516,2700,816,1293,241400,80640
1236,984,252,1018,288100,80642
1152,918,234,1089,288400,80643
1135,790,345,806,170800,80644
1563,1153,410,896,181700,80645
366,329,37,1033,244000,80648
109,83,26,(X),(X),80649
580,451,129,733,157200,80650
1549,1048,501,834,206500,80651
232,182,50,-,122200,80652
306,225,81,663,152600,80653
993,739,254,913,184200,80654
5803,3786,2017,683,141500,80701
381,248,133,841,72200,80705
1127,840,287,599,102900,80720
86,39,47,-,159800,80721
98,58,40,773,216000,80722
2580,1504,1076,756,150900,80723
195,162,33,531,161700,80726
99,65,34,537,58500,80727
398,313,85,680,104700,80728
191,149,42,597,212000,80729
610,476,134,606,117800,80731
207,153,54,819,112900,80733
1058,729,329,613,141700,80734
126,81,45,739,205400,80735
201,166,35,539,126200,80736
624,445,179,525,99500,80737
62,33,29,575,(X),80740
329,207,122,729,152500,80741
91,81,10,-,69200,80742
437,321,116,624,150400,80743
179,141,38,538,59300,80744
68,56,12,-,(X),80745
27,25,2,-,66600,80746
178,162,16,550,115900,80747
143,114,29,658,79100,80749
117,83,34,-,158900,80750
6474,4114,2360,672,124800,80751
74,55,19,-,173800,80754
42,26,16,-,141700,80755
94,53,41,708,118800,80757
1347,731,616,716,132400,80758
2036,1356,680,613,139400,80759
57,52,5,375,120000,80801
96,77,19,711,99000,80802
155,121,34,513,73800,80804
203,164,39,639,118000,80805
1810,1170,640,759,128800,80807
2325,1731,594,930,192900,80808
692,509,183,1193,244400,80809
466,349,117,588,84100,80810
82,72,10,-,93300,80812
730,450,280,871,146300,80813
1491,1328,163,1143,246200,80814
395,265,130,478,118600,80815
2401,1996,405,923,200000,80816
9629,6106,3523,1211,180800,80817
126,86,40,616,88300,80818
350,247,103,844,217100,80819
368,368,0,-,277200,80820
415,301,114,658,131900,80821
98,83,15,575,172500,80822
72,52,20,767,200000,80823
102,80,22,289,106300,80824
154,109,45,707,74200,80825
414,350,64,-,303400,80827
902,537,365,730,128900,80828
2854,1672,1182,793,296200,80829
125,94,31,775,233300,80830
7877,6810,1067,1549,260500,80831
197,177,20,(X),150500,80832
249,202,47,1078,190500,80833
131,109,22,660,103400,80834
327,263,64,811,212500,80835
416,296,120,663,121400,80836
515,0,515,1467,-,80840
312,240,72,628,97300,80860
107,87,20,478,122500,80861
16,13,3,-,61700,80862
4711,3780,931,1085,259800,80863
487,402,85,946,201600,80864
2871,16,2855,1363,-,80902
6930,2623,4307,704,190000,80903
10091,5575,4516,836,204700,80904
7513,3245,4268,762,176400,80905
15344,9326,6018,1019,334100,80906
12641,7341,5300,767,177700,80907
5139,4823,316,1743,390800,80908
15932,7711,8221,719,168200,80909
11977,4873,7104,742,132900,80910
11125,8971,2154,1156,165600,80911
39,0,39,1394,-,80913
0,0,0,-,-,80914
7766,5231,2535,928,159600,80915
13602,6666,6936,945,138400,80916
13018,7287,5731,832,193500,80917
18728,11104,7624,1013,209100,80918
11030,8463,2567,1119,316100,80919
13529,9830,3699,1259,276000,80920
6992,5399,1593,1349,374700,80921
9204,6728,2476,1340,213400,80922
10121,6919,3202,1401,240500,80923
2002,1458,544,1654,377000,80924
2341,1773,568,1496,224400,80925
603,516,87,539,(X),80926
526,462,64,1957,313400,80927
468,345,123,1120,151000,80928
125,75,50,(X),225000,80929
467,238,229,1250,204900,80930
0,0,0,-,-,80938
0,0,0,-,-,80939
1476,935,541,1503,193800,80951
11948,6115,5833,728,103500,81001
5698,2579,3119,672,86900,81003
10480,5295,5185,709,92800,81004
12487,9015,3472,798,139500,81005
4429,3726,703,890,169200,81006
10940,8730,2210,937,177200,81007
4213,2614,1599,952,153600,81008
659,592,67,977,169300,81019
428,281,147,675,131000,81020
9,3,6,-,-,81021
566,500,66,-,121500,81022
524,436,88,1050,200000,81023
71,62,9,-,(X),81024
381,280,101,600,95200,81025
62,49,13,1292,(X),81027
102,65,37,413,63000,81029
57,47,10,608,80500,81030
63,39,24,838,68100,81033
413,345,68,632,85500,81036
0,0,0,-,-,81038
729,510,219,632,107900,81039
251,222,29,-,145700,81040
240,164,76,483,64500,81041
20,14,6,-,(X),81043
128,106,22,929,(X),81044
41,40,1,-,58300,81045
590,433,157,547,100600,81047
125,102,23,525,123100,81049
3792,2254,1538,684,93400,81050
3726,2466,1260,589,91200,81052
1248,864,384,717,59800,81054
658,497,161,767,237300,81055
190,138,52,563,93800,81057
376,251,125,539,87200,81058
76,61,15,-,114400,81059
346,282,64,653,72200,81062
534,421,113,572,75000,81063
113,96,17,621,74400,81064
2409,1645,764,585,89300,81067
683,621,62,789,179400,81069
120,54,66,542,104200,81071
814,640,174,547,80500,81073
208,169,39,605,81300,81076
191,129,62,569,110400,81077
30,24,6,-,207100,81081
4766,3234,1532,756,151800,81082
47,28,19,-,(X),81084
86,54,32,655,57500,81087
1947,1320,627,587,99700,81089
424,268,156,445,82600,81090
274,204,70,931,227800,81091
344,236,108,764,80900,81092
5627,3200,2427,627,145100,81101
797,581,216,453,97400,81120
111,87,24,900,231900,81121
3342,2626,716,1130,281900,81122
324,240,84,863,88900,81123
40,20,20,-,117500,81124
1134,630,504,381,91500,81125
108,103,5,-,86300,81126
61,29,32,-,536800,81128
53,53,0,-,95600,81129
385,343,42,755,264500,81130
672,516,156,810,202300,81131
1235,899,336,543,112300,81132
410,332,78,560,151500,81133
75,46,29,435,88200,81136
2299,1613,686,952,223700,81137
26,19,7,-,(X),81138
964,752,212,562,114400,81140
442,379,63,569,104400,81141
306,228,78,696,79100,81143
2696,1729,967,605,131100,81144
230,143,87,715,151100,81146
5091,3643,1448,955,262700,81147
118,98,20,671,66300,81148
422,300,122,668,155800,81149
534,455,79,435,122300,81151
560,391,169,305,108800,81152
584,462,122,740,211200,81154
166,134,32,804,230000,81155
4160,3240,920,754,288000,81201
109,32,77,-,453300,81210
2751,1997,754,878,240600,81211
10770,7254,3516,692,158800,81212
84,84,0,-,428800,81220
116,101,15,-,92500,81221
197,82,115,814,221100,81222
776,705,71,588,151100,81223
1508,964,544,1197,447700,81224
496,308,188,1026,395300,81225
2149,1505,644,830,132700,81226
8,8,0,-,-,81227
3779,2096,1683,810,272800,81230
0,0,0,-,-,81231
6,6,0,-,-,81232
458,374,84,825,244100,81233
331,240,91,692,285000,81235
485,446,39,-,353200,81236
45,25,20,-,(X),81237
10,10,0,-,-,81239
1610,1337,273,810,178400,81240
36,35,1,-,255000,81241
373,189,184,789,212100,81242
58,49,9,-,306300,81243
147,107,40,956,115300,81244
55,35,20,-,-,81248
91,82,9,-,256300,81251
1785,1400,385,744,220800,81252
261,241,20,-,196500,81253
11984,7418,4566,964,369700,81301
3119,2189,930,1017,339600,81303
96,96,0,-,126400,81320
5871,4027,1844,768,159400,81321
1958,1413,545,961,232200,81323
490,387,103,654,100800,81324
96,75,21,-,(X),81325
884,718,166,993,303800,81326
269,237,32,-,149600,81327
1690,1188,502,740,237200,81328
26,0,26,-,-,81330
241,202,39,-,347200,81331
87,52,35,813,260000,81332
384,227,157,281,105000,81334
67,56,11,-,306700,81335
9501,6137,3364,808,181800,81401
4257,3518,739,947,239900,81403
686,550,136,738,172500,81410
5,0,5,-,-,81411
2088,1656,432,810,197900,81413
567,488,79,708,254200,81415
5235,3376,1859,854,176900,81416
713,541,172,915,187400,81418
1577,1084,493,795,228300,81419
320,219,101,644,134400,81422
653,516,137,865,280800,81423
482,351,131,738,156900,81424
1978,1288,690,741,176900,81425
74,60,14,1313,423100,81426
413,266,147,998,360000,81427
1467,1116,351,782,201000,81428
51,51,0,-,(X),81429
334,284,50,(X),693500,81430
166,150,16,-,181900,81431
1242,904,338,1085,413500,81432
268,175,93,940,222100,81433
63,45,18,-,(X),81434
2180,1100,1080,1191,730700,81435
9467,4009,5458,752,165400,81501
6035,4265,1770,833,174400,81503
11514,8502,3012,983,167200,81504
3894,2843,1051,1105,235100,81505
4843,3274,1569,950,275000,81506
6262,5467,795,1164,290600,81507
5425,3574,1851,661,126400,81520
5925,4323,1602,1083,212300,81521
12,12,0,-,-,81522
538,538,0,-,352500,81523
763,586,177,849,325600,81524
401,267,134,-,273200,81525
2252,1616,636,781,237500,81526
746,711,35,-,267100,81527
6076,3430,2646,1133,371400,81601
138,122,16,850,78300,81610
4412,2854,1558,1249,618200,81611
0,0,0,-,-,81612
1261,679,582,1122,1029700,81615
3685,1682,2003,1183,449400,81620
2512,1837,675,1601,487600,81621
5491,4026,1465,1406,487100,81623
481,386,95,833,227900,81624
4708,3278,1430,721,178400,81625
325,238,87,770,193800,81630
2563,2067,496,1457,420700,81631
3265,2196,1069,1343,482900,81632
0,0,0,-,-,81633
2415,1382,1033,868,211200,81635
2325,1801,524,1180,316500,81637
74,55,19,-,312500,81638
928,607,321,1023,261900,81639
66,31,35,559,122100,81640
1488,940,548,760,241200,81641
33,20,13,-,(X),81642
291,245,46,(X),287300,81643
430,179,251,1122,521600,81645
68,62,6,-,372700,81646
2366,1752,614,1453,267400,81647
971,706,265,769,165600,81648
91,63,28,1550,325000,81649
4372,3060,1312,975,202500,81650
1658,1241,417,1124,242600,81652
27,9,18,-,-,81653
481,346,135,2743,(X),81654
12,0,12,-,-,81655
118,118,0,-,"2,000,000+",81656
2515,1555,960,1228,537600,81657
14837,8660,6177,803,168800,82001
0,0,0,-,-,82005
7852,5332,2520,888,131700,82007
12813,10215,2598,789,253600,82009
84,70,14,625,(X),82050
16,4,12,-,-,82051
5,5,0,-,-,82052
539,388,151,(X),192300,82053
257,201,56,-,164800,82054
109,109,0,-,141300,82055
26,26,0,-,"2,000,000+",82058
58,58,0,-,420800,82059
191,191,0,-,202800,82060
0,0,0,-,-,82061
46,17,29,-,(X),82063
8408,4607,3801,744,219800,82070
6879,2671,4208,704,212100,82072
0,0,0,-,-,82073
19,19,0,-,-,82081
660,514,146,614,169200,82082
148,94,54,767,90000,82083
0,0,0,-,-,82084
106,0,106,337,-,82190
2787,2166,621,580,161500,82201
158,90,68,688,84000,82210
200,179,21,675,128800,82212
251,202,49,525,119600,82213
564,423,141,785,135900,82214
78,71,7,-,191100,82215
36,17,19,-,-,82217
9,9,0,-,-,82219
200,132,68,500,109500,82221
62,48,14,-,(X),82222
487,423,64,763,171900,82223
6,6,0,-,-,82224
855,556,299,589,148800,82225
80,77,3,-,(X),82227
48,41,7,-,344600,82229
4150,3111,1039,659,145500,82240
23,23,0,-,276600,82242
29,17,12,-,-,82243
232,207,25,893,195300,82244
3516,2313,1203,801,142600,82301
279,213,66,739,171000,82321
48,40,8,-,45000,82322
43,39,4,-,121900,82323
127,72,55,-,182500,82324
344,258,86,541,176900,82325
355,256,99,729,72000,82327
141,118,23,578,86400,82329
1022,786,236,861,172800,82331
43,32,11,-,(X),82332
182,126,56,845,117900,82334
16,16,0,-,-,82335
124,67,57,1010,83000,82336
3255,2402,853,600,160800,82401
707,535,172,750,150700,82410
170,132,38,590,226100,82411
196,152,44,(X),105400,82412
6444,4686,1758,704,250100,82414
320,261,59,600,127200,82420
135,104,31,568,150000,82421
33,33,0,-,-,82422
103,76,27,388,(X),82423
1172,832,340,613,139500,82426
39,33,6,-,425000,82428
30,26,4,-,107100,82430
1344,992,352,532,134500,82431
100,66,34,538,80000,82432
407,267,140,628,182400,82433
55,48,7,-,115600,82434
4691,3439,1252,705,196000,82435
74,74,0,-,207000,82440
101,53,48,-,302500,82441
307,224,83,720,169800,82442
2136,1583,553,667,151800,82443
74,28,46,-,-,82450
7344,5104,2240,709,178000,82501
104,88,16,(X),64300,82510
67,63,4,-,(X),82512
920,689,231,634,217700,82513
447,252,195,441,109000,82514
176,122,54,821,116700,82515
180,146,34,746,190000,82516
5188,3737,1451,736,210900,82520
410,339,71,1025,151800,82523
11651,7204,4447,780,172600,82601
10273,7703,2570,945,190100,82604
7298,4565,2733,864,215700,82609
83,52,31,-,564300,82620
10,10,0,-,-,82630
4083,3094,989,692,194200,82633
112,66,46,788,59200,82635
1798,1351,447,747,184000,82636
1551,1092,459,567,179300,82637
0,0,0,-,-,82638
322,184,138,637,117100,82639
8,8,0,-,-,82640
46,28,18,-,(X),82642
199,166,33,496,35500,82643
700,264,436,779,109800,82644
0,0,0,-,-,82646
0,0,0,-,-,82648
448,307,141,647,132600,82649
2134,1717,417,780,180800,82701
151,145,6,-,245900,82710
54,45,9,-,556000,82711
158,96,62,631,239300,82712
40,21,19,-,-,82714
0,0,0,-,-,82715
6830,4634,2196,867,186800,82716
8955,6627,2328,974,226400,82718
425,324,101,608,140000,82720
1132,912,220,798,218000,82721
227,179,48,-,(X),82723
79,79,0,-,(X),82725
715,696,19,-,213400,82727
927,727,200,719,165000,82729
704,506,198,711,177300,82730
40,15,25,-,-,82731
878,587,291,1073,201000,82732
10564,7157,3407,735,224900,82801
70,34,36,1037,(X),82831
274,270,4,-,316100,82832
38,38,0,-,-,82833
3289,2418,871,872,232100,82834
125,67,58,814,132500,82835
450,323,127,596,194600,82836
15,12,3,-,170800,82837
148,77,71,-,226200,82838
485,371,114,750,241300,82839
470,283,187,734,244700,82842
7,7,0,-,-,82844
12,12,0,-,-,82845
10923,7701,3222,901,189100,82901
40,40,0,-,-,82922
89,77,12,-,599400,82923
221,221,0,-,445800,82925
74,0,74,-,-,82929
5113,3567,1546,629,171700,82930
334,192,142,934,279500,82932
288,245,43,680,158900,82933
93,47,46,-,(X),82934
4807,3557,1250,893,199900,82935
0,0,0,-,-,82936
1340,1078,262,657,185300,82937
47,47,0,-,(X),82938
711,509,202,682,194800,82939
1734,1223,511,1250,256600,82941
39,39,0,-,"10,000-",82942
88,73,15,-,(X),82943
96,96,0,-,(X),82944
102,78,24,(X),108300,82945
5989,3421,2568,1105,646400,83001
29,18,11,-,-,83011
112,12,100,-,-,83012
213,97,116,1646,(X),83013
1462,1135,327,1234,1052500,83014
80,43,37,-,1080900,83025
1218,949,269,860,178700,83101
1516,1229,287,769,188600,83110
139,111,28,-,226900,83111
96,96,0,-,220600,83112
994,752,242,923,224000,83113
290,241,49,550,206100,83114
545,351,194,1649,329400,83115
280,237,43,1016,127200,83116
618,458,160,811,209900,83118
30,21,9,-,-,83119
316,274,42,-,200000,83120
5,0,5,-,-,83121
165,145,20,-,167900,83122
218,165,53,703,181600,83123
49,47,2,-,101400,83124
145,145,0,-,231300,83126
1183,967,216,763,283500,83127
603,485,118,939,258900,83128
13899,8736,5163,632,140200,83201
7528,5492,2036,667,159800,83202
124,106,18,527,87300,83203
7059,4496,2563,587,132700,83204
156,0,156,541,-,83209
1026,667,359,558,108600,83210
1980,1343,637,712,130200,83211
94,81,13,450,123400,83212
587,435,152,556,88400,83213
191,174,17,542,117900,83214
8,6,2,-,(X),83215
277,244,33,592,125000,83217
107,95,12,1042,110800,83218
51,40,11,-,178100,83220
8886,6397,2489,651,141000,83221
42,42,0,-,162500,83223
973,849,124,583,159700,83226
111,47,64,-,-,83227
205,145,60,710,164800,83228
152,119,33,788,155400,83232
15,15,0,-,-,83233
564,475,89,640,99900,83234
13,13,0,-,-,83235
668,551,117,707,153100,83236
365,265,100,734,165500,83237
41,21,20,-,-,83238
201,180,21,639,107700,83239
775,576,199,539,118800,83241
37,13,24,-,-,83243
78,69,9,-,147900,83244
777,684,93,675,172000,83245
364,301,63,714,158700,83246
470,407,63,818,148000,83250
477,351,126,548,164300,83251
1545,1246,299,515,132400,83252
65,36,29,-,213300,83253
1497,1123,374,549,132700,83254
426,358,68,705,123400,83255
211,185,26,605,140100,83261
401,349,52,1046,122100,83262
3051,2419,632,643,158700,83263
191,155,36,644,97200,83271
112,112,0,-,159000,83272
2901,2284,617,713,156000,83274
1528,1266,262,546,127200,83276
110,99,11,-,116300,83277
84,55,29,458,(X),83278
78,42,36,-,112500,83281
56,52,4,-,(X),83283
51,34,17,-,262500,83285
407,350,57,693,169000,83286
108,97,11,-,231300,83287
19916,12580,7336,694,149200,83301
40,25,15,525,(X),83302
173,141,32,531,153100,83311
71,44,27,-,143300,83312
1458,894,564,904,305700,83313
359,214,145,534,122500,83314
3619,2491,1128,715,129800,83316
5846,4188,1658,597,124000,83318
306,185,121,584,139900,83320
192,123,69,613,113800,83321
19,19,0,-,(X),83322
592,360,232,544,145600,83323
197,157,40,775,130700,83324
300,250,50,508,126900,83325
361,222,139,661,160700,83327
1910,1314,596,843,154300,83328
2286,1502,784,766,105700,83330
1118,789,329,729,166100,83332
4138,2731,1407,912,326300,83333
716,563,153,759,109400,83334
638,398,240,660,155700,83335
1575,1036,539,593,104200,83336
17,17,0,-,-,83337
6708,4235,2473,722,134800,83338
2321,1517,804,953,704600,83340
2282,1910,372,823,163100,83341
464,331,133,371,132500,83342
392,193,199,591,164500,83344
499,383,116,603,150200,83346
1148,941,207,607,115600,83347
60,52,8,-,275000,83348
381,266,115,559,133800,83349
4496,3358,1138,518,114000,83350
1102,788,314,810,118400,83352
596,481,115,1107,797100,83353
0,0,0,-,-,83354
1546,1080,466,713,140600,83355
13032,8954,4078,733,147500,83401
9188,6174,3014,610,137400,83402
8091,6030,2061,849,169500,83404
5383,4274,1109,767,172500,83406
302,227,75,(X),326600,83414
840,712,128,737,168500,83420
71,60,11,-,-,83421
1283,839,444,836,193900,83422
245,149,96,528,91200,83423
82,47,35,-,-,83424
222,162,60,589,99000,83425
472,432,40,910,169200,83427
169,133,36,546,194300,83428
410,394,16,-,275500,83429
284,220,64,513,153400,83431
4,4,0,-,-,83433
510,395,115,803,137700,83434
137,120,17,-,88800,83435
145,112,33,675,144200,83436
9902,4628,5274,640,180200,83440
6054,5123,931,667,165500,83442
363,256,107,750,119800,83443
400,307,93,503,109500,83444
2435,1928,507,654,124500,83445
19,19,0,-,187500,83446
579,429,150,723,179400,83448
106,94,12,-,267900,83449
322,205,117,756,107900,83450
331,280,51,764,126700,83451
477,430,47,578,285100,83452
177,134,43,646,137500,83454
1763,1272,491,871,226100,83455
0,0,0,-,-,83460
304,229,75,-,273400,83462
79,79,0,-,(X),83463
134,89,45,375,104200,83464
44,41,3,-,256800,83465
120,120,0,-,228600,83466
2926,1999,927,561,159400,83467
65,57,8,-,265900,83468
14,14,0,-,-,83469
14228,9863,4365,660,169800,83501
73,56,17,-,(X),83520
677,524,153,681,160100,83522
316,271,45,569,108500,83523
370,274,96,679,148500,83524
211,185,26,-,141800,83525
119,103,16,(X),168500,83526
2335,1923,412,587,140200,83530
61,53,8,-,217200,83533
504,436,68,725,140200,83535
1753,1248,505,604,146600,83536
490,382,108,721,160600,83537
913,774,139,606,153200,83539
770,487,283,680,105300,83540
406,354,52,605,174500,83541
74,60,14,475,191700,83542
287,220,67,605,119100,83543
2351,1764,587,649,146800,83544
210,174,36,850,112500,83545
342,297,45,636,85800,83546
85,60,25,807,153600,83547
44,38,6,525,137500,83548
332,214,118,562,179300,83549
399,319,80,500,153400,83552
572,501,71,383,108400,83553
284,217,67,842,158600,83554
223,189,34,700,119400,83555
21,21,0,-,221900,83601
15,15,0,-,-,83602
252,135,117,-,163200,83604
13611,8907,4704,653,103100,83605
7535,5675,1860,750,160100,83607
404,350,54,525,158100,83610
935,781,154,675,191300,83611
807,589,218,516,123600,83612
369,258,111,695,269000,83615
9189,7522,1667,1085,321900,83616
5832,4066,1766,772,135700,83617
2600,2208,392,916,143300,83619
704,560,144,795,210600,83622
565,356,209,588,96500,83623
407,229,178,567,108500,83624
371,251,120,575,108400,83626
261,221,40,729,197500,83627
1464,1030,434,589,95100,83628
646,532,114,708,143200,83629
480,359,121,625,163800,83631
107,102,5,-,123800,83632
169,117,52,522,109500,83633
6995,5644,1351,1022,139900,83634
0,0,0,-,-,83636
115,82,33,428,211100,83637
1835,1226,609,778,236600,83638
1044,716,328,504,139100,83639
1248,931,317,634,157900,83641
14438,10337,4101,869,188700,83642
56,56,0,-,(X),83643
3502,2821,681,808,166200,83644
273,209,64,(X),160400,83645
18490,14706,3784,1122,207500,83646
7869,5054,2815,739,137300,83647
859,0,859,900,-,83648
211,99,112,(X),152400,83650
10623,6842,3781,785,101400,83651
661,501,160,599,174200,83654
1551,1177,374,656,113200,83655
219,171,48,817,90300,83656
73,73,0,-,386400,83657
2155,1624,531,622,131300,83660
3500,2379,1121,650,111800,83661
14,14,0,-,162500,83666
3083,2379,704,1109,194500,83669
215,188,27,-,137500,83670
10,10,0,-,-,83671
3132,2229,903,689,118300,83672
1417,1017,400,594,156200,83676
62,62,0,-,(X),83677
15966,10988,4978,768,136300,83686
9939,6540,3399,855,130400,83687
10653,5171,5482,690,289800,83702
7162,4492,2670,848,173300,83703
16211,9542,6669,831,144300,83704
11899,5874,6025,748,140100,83705
13534,7159,6375,774,195800,83706
18493,14568,3925,1056,176100,83709
3610,2263,1347,770,314000,83712
10202,7029,3173,971,185800,83713
8720,5789,2931,833,181900,83714
5958,4581,1377,1105,233000,83716
2248,1897,351,1061,192900,83801
66,9,57,567,206300,83802
337,282,55,-,308400,83803
483,410,73,435,170100,83804
2850,2154,696,710,168400,83805
90,59,31,610,78800,83806
62,51,11,-,(X),83808
132,114,18,-,(X),83809
423,352,71,936,230300,83810
587,425,162,730,154700,83811
41,39,2,-,63800,83812
364,292,72,-,272400,83813
10577,6133,4444,776,246700,83814
12820,8647,4173,885,174300,83815
121,88,33,542,325900,83821
887,751,136,754,157800,83822
554,465,89,694,156900,83823
141,98,43,406,115600,83824
148,94,54,(X),196900,83825
0,0,0,-,-,83826
72,48,24,-,110700,83827
302,202,100,1042,151400,83830
559,435,124,789,182300,83832
515,419,96,850,328400,83833
131,112,19,-,(X),83834
7811,6263,1548,919,218500,83835
417,309,108,725,278700,83836
1301,667,634,640,115100,83837
591,465,126,679,188900,83839
86,67,19,775,176300,83840
172,124,48,-,267800,83841
71,46,25,950,147500,83842
10930,4870,6060,654,206500,83843
0,0,0,-,-,83844
729,548,181,843,153700,83845
340,272,68,603,74300,83846
686,456,230,471,255600,83847
124,101,23,-,256900,83848
878,710,168,587,119300,83849
964,760,204,471,144200,83850
639,437,202,701,120500,83851
400,106,294,658,130000,83852
14879,10402,4477,809,167600,83854
884,653,231,650,133200,83855
2498,2077,421,717,168500,83856
331,206,125,997,192700,83857
5083,3809,1274,909,171500,83858
2420,1993,427,974,261400,83860
2602,1952,650,633,156500,83861
7521,4870,2651,716,231200,83864
88,88,0,-,(X),83866
280,239,41,-,120100,83867
372,194,178,635,62700,83868
1655,1329,326,749,166300,83869
132,76,56,541,147700,83870
726,621,105,675,185800,83871
226,210,16,-,283300,83872
733,446,287,624,109300,83873
42,10,32,-,-,83874
641,513,128,663,211700,83876
329,294,35,850,203700,84001
84,84,0,-,203200,84002
11769,9255,2514,1081,276800,84003
2763,2167,596,1302,444500,84004
5963,4979,984,1406,202800,84005
271,237,34,-,174500,84006
187,139,48,619,236000,84007
15055,10570,4485,878,246000,84010
280,256,24,1313,200900,84013
5337,4493,844,1063,248300,84014
19391,14101,5290,892,171100,84015
1421,1115,306,869,266000,84017
30,30,0,-,375000,84018
12400,9839,2561,1190,381100,84020
1414,1077,337,838,150700,84021
278,20,258,598,261500,84022
100,75,25,1099,166800,84023
35,27,8,-,(X),84024
6134,5120,1014,900,291300,84025
416,347,69,777,139800,84026
229,193,36,1566,133900,84027
260,185,75,614,261600,84028
2907,2375,532,782,188200,84029
93,71,22,-,202300,84031
5878,4289,1589,1099,292800,84032
326,281,45,543,242300,84033
77,65,12,263,107200,84034
186,171,15,-,157400,84035
2079,1491,588,978,273700,84036
9748,8562,1186,780,284600,84037
90,82,8,-,257100,84038
281,229,52,928,174800,84039
7053,6015,1038,1270,249600,84040
15166,10375,4791,845,181700,84041
2566,2105,461,1068,318700,84042
14180,11510,2670,1230,251400,84043
7950,6142,1808,993,148300,84044
5018,4104,914,1459,261700,84045
163,156,7,488,201500,84046
12381,5587,6794,966,194500,84047
1552,1191,361,1107,378800,84049
2994,2487,507,917,264800,84050
115,115,0,-,267900,84051
471,323,148,909,158800,84052
349,319,30,788,168800,84053
5685,4166,1519,963,232500,84054
412,307,105,865,266800,84055
903,15,888,1095,-,84056
10851,6523,4328,889,194000,84057
9654,4969,4685,917,201300,84058
3273,2030,1243,1223,871600,84060
171,141,30,-,405600,84061
12198,8479,3719,1074,251300,84062
155,149,6,-,152000,84063
216,177,39,594,131000,84064
10843,9790,1053,1063,295000,84065
3740,2708,1032,866,173700,84066
12241,10297,1944,941,157200,84067
216,191,25,(X),179200,84069
9164,5710,3454,1000,210100,84070
418,342,76,767,234800,84071
156,139,17,632,186600,84072
53,48,5,-,173100,84073
14226,11227,2999,908,176200,84074
6991,6449,542,1465,252300,84075
113,94,19,-,167900,84076
9083,6733,2350,979,197200,84078
86,74,12,1021,156300,84080
12229,10272,1957,1199,231500,84081
239,235,4,-,276700,84082
467,85,382,517,61900,84083
11637,8531,3106,992,201500,84084
133,122,11,-,160800,84085
74,62,12,(X),140600,84086
4519,4064,455,1224,218400,84087
11011,7951,3060,1014,227100,84088
8757,7777,980,1466,359300,84092
7344,6540,804,1612,328300,84093
8835,6810,2025,1218,229300,84094
17021,13460,3561,1408,332200,84095
9492,7535,1957,1115,284000,84096
5931,4625,1306,836,238400,84097
6564,5149,1415,1564,615400,84098
2590,645,1945,836,224100,84101
8655,2450,6205,772,240600,84102
10230,4624,5606,813,355700,84103
7498,3586,3912,896,140000,84104
9341,5763,3578,839,292100,84105
13995,8379,5616,957,244000,84106
13755,6612,7143,896,209000,84107
7686,5354,2332,832,417400,84108
8461,6534,1927,967,334800,84109
6162,1391,4771,639,177900,84111
266,0,266,828,-,84112
0,0,0,-,-,84113
10385,4192,6193,763,174100,84115
10592,6007,4585,850,152600,84116
10423,6555,3868,962,295400,84117
19040,15217,3823,1098,168300,84118
16124,8867,7257,906,152600,84119
13203,9542,3661,984,165400,84120
15590,11470,4120,1050,298000,84121
13942,8348,5594,888,195500,84123
8049,6061,1988,1008,329400,84124
7048,5789,1259,1337,177200,84128
116,26,90,1576,275000,84144
0,0,0,-,-,84180
299,271,28,(X),162800,84301
7912,5914,1998,691,167300,84302
0,0,0,-,-,84304
204,190,14,950,157900,84305
140,85,55,-,274200,84306
468,365,103,822,169700,84307
126,101,25,850,131900,84308
167,130,37,811,178800,84309
1502,1258,244,1229,343200,84310
274,219,55,625,162800,84311
1135,919,216,736,152000,84312
20,4,16,-,-,84313
336,297,39,811,174700,84314
2364,2263,101,1370,271700,84315
94,87,7,575,119500,84316
845,764,81,894,296700,84317
1167,1097,70,1138,223700,84318
2105,1771,334,780,162800,84319
785,656,129,663,170700,84320
14024,7176,6848,631,175000,84321
233,211,22,753,185700,84324
631,583,48,1075,269300,84325
504,463,41,660,217200,84326
293,284,9,-,172200,84327
515,477,38,735,233700,84328
48,28,20,-,102500,84329
147,143,4,-,139600,84330
111,89,22,931,127500,84331
2339,1959,380,911,233000,84332
887,752,135,707,175500,84333
161,31,130,563,-,84334
3588,3118,470,825,195200,84335
82,57,25,-,151600,84336
3625,2895,730,588,161800,84337
144,132,12,825,159400,84338
1420,1160,260,700,213700,84339
1130,941,189,641,219500,84340
6953,3370,3583,764,203900,84341
12922,6340,6582,691,170100,84401
13116,8980,4136,744,177300,84403
19361,13866,5495,801,143800,84404
10924,7441,3483,821,173800,84405
8790,7618,1172,976,219700,84414
4701,3266,1435,617,148300,84501
1260,987,273,582,160100,84511
366,309,57,555,143200,84512
543,456,87,561,123200,84513
0,0,0,-,-,84515
54,47,7,-,143100,84516
274,245,29,609,192000,84518
492,389,103,530,55300,84520
238,210,28,563,113300,84521
121,112,9,-,109600,84522
559,491,68,539,138400,84523
401,277,124,504,131300,84525
1706,1242,464,653,118200,84526
864,694,170,669,145700,84528
67,67,0,-,60500,84529
191,110,81,1264,165000,84530
170,141,29,-,85000,84531
3916,2646,1270,716,226000,84532
61,61,0,-,(X),84533
491,439,52,594,83100,84534
829,613,216,698,155900,84535
367,315,52,425,57000,84536
477,383,94,693,126900,84537
139,101,38,688,48300,84539
19,19,0,-,-,84540
700,488,212,609,117600,84542
10674,4945,5729,753,166000,84601
11687,6214,5473,784,273000,84604
10306,2380,7926,726,181200,84606
365,344,21,963,141500,84620
105,73,32,-,(X),84621
448,353,95,(X),147900,84622
120,93,27,-,256900,84623
1900,1469,431,661,139700,84624
70,70,0,-,169000,84626
1849,922,927,607,180900,84627
290,219,71,875,97900,84628
907,763,144,858,190700,84629
112,110,2,-,164700,84630
1015,772,243,594,124700,84631
338,287,51,686,143900,84632
321,273,48,475,157200,84633
341,257,84,725,148700,84634
256,221,35,778,116900,84635
157,137,20,663,159300,84636
211,172,39,690,135600,84637
99,87,12,400,161900,84638
292,215,77,749,143800,84639
45,44,1,-,130000,84640
1138,888,250,690,158700,84642
177,143,34,950,163300,84643
677,555,122,645,209200,84645
579,517,62,672,127000,84646
1290,1034,256,655,170900,84647
1806,1534,272,781,166300,84648
301,222,79,833,148800,84649
6665,5319,1346,863,197000,84651
263,243,20,-,129200,84652
2293,1953,340,944,280800,84653
1020,770,250,677,111000,84654
2809,2307,502,958,195100,84655
146,126,20,467,156000,84656
202,150,52,629,150000,84657
10521,8110,2411,972,198500,84660
388,297,91,622,167900,84662
9120,6319,2801,939,196000,84663
2148,1923,225,1390,332400,84664
108,107,1,-,183700,84665
97,93,4,-,171900,84667
2929,1973,956,703,154600,84701
36,34,2,-,225000,84710
201,165,36,850,191400,84711
87,62,25,-,92700,84712
1263,899,364,536,165000,84713
186,114,72,766,68600,84714
162,138,24,548,216700,84715
90,60,30,542,210000,84716
56,51,5,608,164100,84718
26,12,14,639,115000,84719
6715,4159,2556,619,179600,84720
6514,4026,2488,668,155600,84721
280,224,56,845,148400,84722
255,213,42,567,141900,84723
433,387,46,593,125600,84724
471,386,85,862,142900,84725
310,249,61,842,146800,84726
23,0,23,-,-,84728
100,88,12,638,164100,84729
74,71,3,-,207000,84730
40,40,0,-,139700,84731
15,15,0,-,(X),84732
67,33,34,-,-,84733
65,34,31,500,(X),84734
113,108,5,-,(X),84735
83,71,12,480,115600,84736
5204,3601,1603,969,187000,84737
2843,2037,806,1117,213300,84738
165,133,32,900,142000,84739
63,46,17,725,154200,84740
2302,1804,498,872,181100,84741
83,72,11,755,261100,84742
10,10,0,-,240000,84743
101,88,13,563,137500,84744
1271,1003,268,978,124000,84745
391,348,43,825,238900,84746
314,251,63,547,161700,84747
106,82,24,495,200000,84749
182,160,22,760,138200,84750
620,490,130,667,130400,84751
333,266,67,927,140600,84752
22,22,0,-,110400,84753
1260,1087,173,781,174600,84754
21,21,0,-,(X),84755
120,77,43,-,122700,84756
330,244,86,813,280000,84757
216,160,56,820,142600,84758
692,556,136,772,166500,84759
226,181,45,678,162900,84760
1126,870,256,841,165300,84761
96,96,0,-,167500,84762
132,107,25,817,419600,84763
57,32,25,(X),(X),84764
1819,1471,348,1404,240400,84765
50,44,6,-,225000,84766
225,136,89,689,470400,84767
13894,7976,5918,834,192500,84770
54,54,0,-,215500,84772
95,90,5,-,305300,84773
517,429,88,1103,248100,84774
230,210,20,569,234200,84775
227,176,51,485,171100,84776
186,148,38,575,216700,84779
7493,5387,2106,1138,219000,84780
53,39,14,-,271000,84781
244,233,11,-,212200,84782
201,201,0,-,386800,84783
294,28,266,1148,153100,84784
13028,9626,3402,1044,232200,84790
3945,1247,2698,723,288500,85003
2025,577,1448,762,238300,85004
8610,3182,5428,700,117200,85006
4873,1666,3207,673,190000,85007
20588,5514,15074,776,103600,85008
11840,5190,6650,714,58200,85009
3178,1539,1639,897,365300,85012
9716,4222,5494,843,202300,85013
11663,4448,7215,815,178400,85014
14216,5078,9138,703,120700,85015
16062,7227,8835,822,199600,85016
11487,3992,7495,691,78700,85017
16508,8895,7613,812,368000,85018
7023,3561,3462,861,78100,85019
14471,7856,6615,842,176300,85020
15236,5810,9426,715,197100,85021
20687,10949,9738,866,175200,85022
11778,6438,5340,826,161100,85023
9677,6429,3248,1234,192300,85024
14758,8126,6632,986,130100,85027
7960,6391,1569,1330,296800,85028
16644,8056,8588,809,118600,85029
7392,3453,3939,892,65300,85031
26771,14616,12155,874,162000,85032
15172,7043,8129,888,76800,85033
1495,310,1185,595,97600,85034
13995,5077,8918,870,73900,85035
13373,7436,5937,1069,103000,85037
9135,3816,5319,775,82100,85040
16296,9848,6448,1003,107300,85041
13089,7621,5468,907,119600,85042
9228,5106,4122,1077,107900,85043
16691,9454,7237,1082,228500,85044
2533,2114,419,1769,360100,85045
12808,9147,3661,1279,321300,85048
11159,7796,3363,1406,254800,85050
14510,7300,7210,782,110500,85051
10838,6436,4402,869,135400,85053
3114,1248,1866,1306,326700,85054
6142,5294,848,1780,293700,85083
7308,4393,2915,1174,308300,85085
13802,10799,3003,1575,268100,85086
3047,2705,342,1390,258700,85087
5686,4969,717,1213,245500,85118
9573,7574,1999,723,113500,85119
12437,8789,3648,788,63100,85120
664,350,314,701,57600,85121
18012,11997,6015,865,103700,85122
3503,2227,1276,850,88700,85123
4862,2986,1876,698,84500,85128
3544,2264,1280,613,75800,85131
7952,5863,2089,928,113900,85132
207,132,75,525,31200,85135
911,744,167,845,85300,85137
11107,8502,2605,1270,148100,85138
5700,3898,1802,1067,121700,85139
11698,8635,3063,1134,148700,85140
120,90,30,800,50000,85141
15719,12341,3378,1188,218500,85142
11269,7494,3775,1200,147300,85143
685,561,124,1085,124300,85145
1247,682,565,573,51600,85147
523,140,383,912,288400,85172
953,654,299,705,76200,85173
529,492,37,394,81700,85192
1281,777,504,761,84600,85193
2907,2238,669,744,157700,85194
19043,6791,12252,792,118100,85201
15158,6520,8638,847,155400,85202
11930,6802,5128,792,169100,85203
21010,11455,9555,867,117100,85204
17544,12004,5540,844,134200,85205
14634,8994,5640,1065,151100,85206
17043,13485,3558,966,204400,85207
14473,10816,3657,1053,104200,85208
15722,11319,4403,1180,166300,85209
13292,5651,7641,788,124600,85210
7694,5892,1802,1291,216600,85212
12092,8974,3118,977,187900,85213
6763,5608,1155,1241,199200,85215
17670,9614,8056,1093,175100,85224
25639,13720,11919,992,169000,85225
14623,8696,5927,1144,229600,85226
13322,8939,4383,1073,225800,85233
16701,11948,4753,1141,237700,85234
14676,11766,2910,1268,274000,85248
13288,11401,1887,1671,311100,85249
8552,5698,2854,1158,258600,85250
18469,8834,9635,987,240700,85251
7147,6003,1144,1299,1083400,85253
17845,12523,5322,1243,362800,85254
15551,12367,3184,1712,581600,85255
1468,1084,384,725,86300,85256
12767,7663,5104,1075,174400,85257
11660,8391,3269,1286,419500,85258
9165,7071,2094,950,557500,85259
16924,9790,7134,1184,377400,85260
4488,4134,354,2010,649500,85262
1215,1128,87,-,458300,85263
318,222,96,704,155400,85264
4845,4552,293,2174,609000,85266
11075,9055,2020,1157,348200,85268
21275,4643,16632,878,158900,85281
20486,9150,11336,958,168400,85282
18304,8556,9748,1013,194900,85283
6309,5570,739,1655,349300,85284
13263,9138,4125,1295,299400,85286
13525,8808,4717,1270,226700,85295
13195,9857,3338,1406,232200,85296
8984,6634,2350,1403,254800,85297
8695,7552,1143,1753,315400,85298
20575,7395,13180,697,74600,85301
13672,7862,5810,809,127300,85302
8669,5225,3444,960,119100,85303
9348,6588,2760,1035,146800,85304
4084,2097,1987,1012,155300,85305
8681,5248,3433,983,156300,85306
2817,1351,1466,1084,118000,85307
24052,16366,7686,1110,208300,85308
0,0,0,-,-,85309
6630,5412,1218,1456,232100,85310
329,240,89,429,158300,85320
1904,1246,658,675,84100,85321
256,144,112,500,101700,85322
11197,5533,5664,1014,116900,85323
1047,879,168,666,85500,85324
514,458,56,-,105600,85325
14811,9334,5477,1062,136900,85326
145,84,61,(X),63400,85328
10799,9161,1638,1485,381300,85331
668,609,59,471,119700,85332
179,125,54,439,76600,85333
437,281,156,922,57300,85334
9777,5956,3821,1081,108300,85335
176,114,62,583,(X),85336
830,419,411,623,63300,85337
14645,9729,4916,1194,168800,85338
11246,7980,3266,1382,168600,85339
9088,6669,2419,1284,256700,85340
16,0,16,-,-,85341
589,502,87,557,135000,85342
75,40,35,660,175000,85343
4011,2693,1318,676,88400,85344
20857,13259,7598,999,112800,85345
2598,2127,471,367,50500,85346
277,147,130,684,(X),85347
1235,1038,197,486,55200,85348
8108,5891,2217,623,110800,85349
5774,4079,1695,616,115100,85350
17401,14366,3035,953,108500,85351
155,123,32,420,37700,85352
9450,5868,3582,1083,141000,85353
2000,1503,497,783,98200,85354
2995,2448,547,1263,263000,85355
2023,1717,306,736,70900,85356
223,178,45,472,54700,85357
105,54,51,277,55800,85360
1979,1742,237,1375,162300,85361
325,286,39,(X),127700,85362
2271,1102,1169,959,103600,85363
26286,14425,11861,821,110800,85364
17836,13362,4474,1054,114600,85365
9851,8106,1745,1256,120900,85367
202,113,89,333,25400,85371
8885,7459,1426,1173,150100,85373
20507,14701,5806,1083,173500,85374
16121,13930,2191,1175,177500,85375
1609,1417,192,779,648900,85377
13020,8869,4151,1328,177000,85379
9502,6407,3095,1053,200000,85381
16530,11058,5472,1222,202900,85382
13081,11265,1816,1684,319500,85383
4675,4142,533,1151,267900,85387
7707,5499,2208,1200,178900,85388
4097,2925,1172,655,223400,85390
12137,6956,5181,1088,156900,85392
9649,7213,2436,1139,283400,85395
4980,3840,1140,1471,211200,85396
5263,3650,1613,743,99400,85501
441,343,98,330,51300,85530
155,138,17,-,228300,85531
1047,635,412,380,82400,85533
1053,821,232,759,80900,85534
0,0,0,-,-,85535
149,141,8,-,(X),85536
1970,1388,582,714,74500,85539
1082,0,1082,401,-,85540
9415,6978,2437,812,183900,85541
746,431,315,396,47400,85542
1205,910,295,819,120100,85543
847,725,122,-,301800,85544
224,196,28,-,133300,85545
6064,4365,1699,764,123000,85546
1143,616,527,337,48400,85550
105,84,21,-,115300,85551
2178,1421,757,722,153800,85552
741,662,79,424,131700,85553
268,236,32,-,215400,85554
334,235,99,652,124500,85601
4174,2974,1200,788,104400,85602
3281,2185,1096,645,132000,85603
208,133,75,486,66100,85605
556,503,53,530,118700,85606
4548,3062,1486,549,84300,85607
0,0,0,-,-,85608
162,150,12,-,190300,85609
454,401,53,756,89400,85610
460,424,36,950,281100,85611
793,5,788,1225,-,85613
12174,9823,2351,1026,161400,85614
3891,3492,399,1145,191000,85615
2283,1618,665,604,115400,85616
575,448,127,477,122600,85617
578,426,152,601,64200,85618
32,16,16,-,-,85619
257,156,101,614,107000,85620
7166,3721,3445,508,120800,85621
3770,3415,355,982,223500,85622
2022,1595,427,838,176300,85623
641,413,228,625,221300,85624
957,811,146,726,112200,85625
353,280,73,(X),50500,85626
397,297,100,909,122600,85627
7577,5973,1604,1294,163800,85629
983,894,89,480,141600,85630
1318,918,400,795,73600,85631
421,355,66,622,170800,85632
17,4,13,931,-,85633
1496,1001,495,451,64200,85634
14370,7306,7064,885,166200,85635
605,540,65,1013,344800,85637
958,774,184,600,101700,85638
213,112,101,-,564300,85640
8011,6882,1129,1283,214200,85641
3460,2374,1086,589,103500,85643
726,607,119,788,111600,85645
859,622,237,962,304300,85646
5598,4503,1095,758,123700,85648
6196,5295,901,1035,219800,85650
4920,3782,1138,884,124700,85653
57,11,46,-,-,85654
4232,3483,749,1346,281600,85658
2794,787,2007,765,232200,85701
13910,7929,5981,875,235200,85704
24124,10175,13949,655,76500,85705
16618,9514,7104,733,77500,85706
0,0,0,-,-,85707
1187,10,1177,1187,-,85708
25075,13183,11892,774,142000,85710
16923,7559,9364,691,137700,85711
16035,5636,10399,755,135600,85712
16428,10070,6358,730,82000,85713
5063,2681,2382,604,81100,85714
8147,5547,2600,956,200200,85715
15657,5786,9871,727,172600,85716
12844,8752,4092,828,440900,85718
17027,4548,12479,747,193800,85719
0,0,0,-,-,85723
0,0,0,-,-,85724
0,0,0,-,-,85726
15677,10243,5434,868,122200,85730
4037,3312,725,787,93400,85735
1609,1316,293,640,84000,85736
8901,6752,2149,1121,270600,85737
7866,7149,717,974,280400,85739
13319,7518,5801,983,153600,85741
9540,7403,2137,1175,174500,85742
11062,8767,2295,1221,186400,85743
15071,9147,5924,825,192800,85745
13911,9485,4426,840,101000,85746
8226,6188,2038,1324,185900,85747
7332,5500,1832,1120,206200,85748
7664,6223,1441,1145,350300,85749
11085,7793,3292,956,363000,85750
6602,5777,825,1438,292900,85755
10236,7678,2558,1023,96800,85756
5390,4172,1218,988,116700,85757
6500,4449,2051,778,137100,85901
437,213,224,523,37500,85911
91,91,0,-,75800,85912
172,123,49,488,229500,85920
37,37,0,-,262500,85922
144,121,23,-,(X),85923
1070,982,88,870,103800,85924
1440,1085,355,805,151600,85925
74,56,18,(X),38000,85926
67,43,24,-,454300,85927
479,322,157,843,118500,85928
3204,2300,904,776,167900,85929
253,112,141,647,84400,85930
104,104,0,-,275000,85931
228,174,54,-,277000,85932
1046,734,312,876,136100,85933
196,169,27,-,163100,85934
2042,1633,409,851,233700,85935
1251,906,345,900,86200,85936
2594,2200,394,689,118100,85937
794,568,226,600,114500,85938
1511,982,529,739,135400,85939
539,493,46,938,145700,85940
2625,1615,1010,418,57500,85941
66,66,0,-,-,85942
16736,7922,8814,1067,275800,86001
3,3,0,-,-,86003
13607,8429,5178,1076,259400,86004
41,0,41,-,-,86011
83,43,40,-,-,86015
32,31,1,-,89400,86016
352,311,41,-,290200,86017
338,281,57,1273,233200,86018
609,511,98,419,69700,86020
752,199,553,770,180500,86021
817,583,234,693,111400,86022
655,144,511,573,37600,86023
283,238,45,1078,298400,86024
1869,1326,543,668,78700,86025
0,0,0,-,-,86028
140,140,0,-,"10,000-",86029
373,329,44,525,84100,86030
559,443,116,488,65000,86031
378,255,123,669,89700,86032
1974,1127,847,597,46500,86033
551,363,188,485,84000,86034
521,407,114,450,68300,86035
144,113,31,-,157400,86036
7,7,0,-,-,86038
423,353,70,378,97700,86039
3148,2278,870,696,138200,86040
492,364,128,806,60000,86042
494,440,54,538,59000,86043
1048,871,177,541,74800,86044
3091,1992,1099,646,73800,86045
2527,1910,617,781,158100,86046
4264,2515,1749,594,81100,86047
8,0,8,-,-,86052
561,419,142,531,57300,86053
497,399,98,527,53200,86054
9634,6153,3481,871,215100,86301
8516,6017,2499,796,289400,86303
8110,6248,1862,787,329000,86305
0,0,0,-,-,86313
13678,7606,6072,870,156300,86314
2746,2492,254,1165,236000,86315
824,666,158,556,69100,86320
792,109,683,469,(X),86321
4695,3401,1294,759,145400,86322
6618,5191,1427,823,160900,86323
1931,1378,553,919,200800,86324
2256,1880,376,1261,252000,86325
9991,6449,3542,837,136200,86326
4194,3570,624,1159,183700,86327
324,263,61,-,205600,86329
377,304,73,790,189000,86331
730,607,123,611,106300,86332
2559,1880,679,764,92500,86333
1655,1106,549,819,108700,86334
2476,1703,773,904,122400,86335
5801,3930,1871,1249,423500,86336
530,372,158,550,131300,86337
241,191,50,1054,223200,86338
66,56,10,-,167900,86343
3251,2332,919,1142,407000,86351
9391,6307,3084,814,113700,86401
6858,3811,3047,807,169300,86403
7592,5518,2074,904,174500,86404
10074,7336,2738,883,218300,86406
10666,7186,3480,732,76900,86409
106,99,7,-,174300,86411
4756,3997,759,719,75700,86413
5572,3853,1719,967,132600,86426
3423,1591,1832,741,176400,86429
155,132,23,-,46000,86431
1239,1067,172,623,112300,86432
85,16,69,-,-,86433
367,176,191,397,108700,86434
16,11,5,-,"10,000-",86435
672,515,157,433,118000,86436
35,26,9,(X),56000,86437
399,326,73,574,(X),86438
2828,1960,868,759,107800,86440
1080,856,224,374,56100,86441
13863,8567,5296,742,88100,86442
0,0,0,-,-,86443
401,316,85,641,(X),86444
189,181,8,-,96900,86445
322,295,27,425,80500,86502
2835,1879,956,414,42700,86503
1545,1036,509,594,53100,86504
2063,1642,421,447,53400,86505
358,319,39,586,72900,86506
512,444,68,513,65000,86507
209,195,14,-,92200,86508
1406,1179,227,475,68700,86510
876,821,55,392,75500,86511
603,426,177,512,84500,86512
680,542,138,538,90400,86514
1239,766,473,519,74100,86515
495,426,69,564,52400,86520
266,262,4,-,61500,86535
609,412,197,396,53700,86538
278,241,37,(X),83900,86540
326,280,46,725,90900,86544
329,278,51,456,58500,86545
280,253,27,286,63800,86547
385,244,141,274,61500,86556
898,822,76,558,135600,87001
8049,5942,2107,741,120900,87002
3729,2876,853,691,140700,87004
320,285,35,-,(X),87005
259,224,35,-,201700,87006
282,269,13,425,77900,87007
1136,1000,136,1423,212300,87008
571,466,105,904,246700,87010
22,22,0,-,132100,87011
92,76,16,-,141700,87012
1349,1060,289,536,58800,87013
235,199,36,-,167100,87014
4553,4164,389,914,186700,87015
1078,888,190,587,120300,87016
157,143,14,-,95600,87017
134,105,29,338,27500,87018
3773,2446,1327,613,100400,87020
976,679,297,624,85900,87021
373,309,64,468,86600,87022
237,206,31,-,110900,87023
533,502,31,708,115100,87024
569,519,50,764,251600,87025
1158,881,277,411,61300,87026
157,105,52,-,131300,87027
65,65,0,-,75800,87028
117,117,0,-,(X),87029
15001,12241,2760,780,134200,87031
37,37,0,-,-,87032
521,476,45,582,62600,87034
2464,1923,541,815,99200,87035
770,696,74,756,111000,87036
173,144,29,450,52300,87037
186,127,59,310,(X),87038
172,162,10,-,85900,87040
280,234,46,742,119100,87041
1377,1126,251,734,185700,87042
2418,2193,225,1545,329200,87043
197,166,31,-,135700,87044
477,444,33,-,51000,87045
23,23,0,-,293800,87046
1909,1760,149,1150,280400,87047
3603,3233,370,866,414600,87048
276,243,33,708,30400,87049
358,334,24,-,126300,87051
568,475,93,443,85300,87052
286,253,33,717,88100,87053
425,400,25,-,263600,87056
3817,3539,278,1179,250900,87059
126,126,0,-,(X),87061
424,336,88,-,111000,87062
84,69,15,-,59000,87063
70,57,13,-,(X),87064
1793,1596,197,1035,161600,87068
39,24,15,-,-,87070
157,137,20,400,102500,87072
283,262,21,1016,160300,87083
8886,3277,5609,647,135800,87102
5374,3276,2098,737,221800,87104
19341,13940,5401,699,127800,87105
11720,4561,7159,699,236500,87106
13082,8210,4872,712,204000,87107
17028,5367,11661,608,155000,87108
17913,9198,8715,779,205500,87109
17037,11176,5861,796,180500,87110
25529,15877,9652,968,246300,87111
18408,10877,7531,767,173500,87112
5771,4303,1468,1019,237600,87113
24087,16286,7801,1018,206500,87114
1270,0,1270,1302,-,87116
0,0,0,-,-,87117
22843,16605,6238,994,187800,87120
22478,16578,5900,926,124900,87121
6879,6128,751,1326,452400,87122
17396,10707,6689,760,171400,87123
19876,15427,4449,957,166400,87124
13208,10682,2526,1236,183300,87144
6723,4087,2636,659,122900,87301
849,791,58,-,45500,87305
245,222,23,558,50300,87310
930,767,163,506,33500,87311
135,123,12,-,29300,87312
1452,989,463,510,57100,87313
59,39,20,-,160400,87315
338,235,103,813,31000,87316
350,284,66,-,43100,87317
526,498,28,-,55500,87319
182,162,20,(X),54100,87320
619,505,114,331,110300,87321
45,43,2,-,74500,87322
1265,1047,218,631,48200,87323
799,631,168,496,57600,87325
457,414,43,594,59700,87326
1959,1569,390,500,76100,87327
677,306,371,387,56000,87328
114,59,55,-,159500,87347
238,125,113,474,(X),87357
298,252,46,365,50800,87364
692,631,61,342,45300,87375
14879,10012,4867,745,155000,87401
3616,3019,597,1212,229100,87402
6527,4974,1553,850,154400,87410
298,245,53,599,106000,87412
5273,3902,1371,735,139400,87413
613,549,64,851,217000,87415
1331,1082,249,803,74600,87416
1751,1290,461,764,108200,87417
389,278,111,1035,194900,87418
139,121,18,-,(X),87419
3131,2045,1086,489,82100,87420
495,415,80,1013,124700,87421
497,391,106,519,70400,87455
413,369,44,875,72500,87461
131,123,8,-,71700,87499
8370,5089,3281,1031,385300,87501
14175,8623,5552,962,311300,87505
5775,4626,1149,880,385800,87506
17185,11286,5899,895,203800,87507
7738,6220,1518,1213,354700,87508
278,222,56,-,218100,87510
797,586,211,603,154800,87511
57,57,0,-,-,87512
331,302,29,-,356400,87513
309,261,48,-,(X),87514
148,128,20,-,114400,87515
30,30,0,-,162500,87516
102,90,12,-,156500,87517
37,29,8,-,117000,87518
233,98,135,596,125000,87519
440,332,108,713,160300,87520
513,482,31,575,131400,87521
994,704,290,621,86200,87522
118,99,19,-,(X),87523
43,11,32,-,-,87524
28,11,17,-,475000,87525
318,235,83,-,110500,87527
928,641,287,433,78300,87528
1996,1378,618,947,262400,87529
373,299,74,-,155900,87530
172,98,74,537,277800,87531
6721,4771,1950,698,172700,87532
52,41,11,692,"10,000-",87533
369,303,66,1039,181300,87535
930,700,230,491,131300,87537
219,219,0,-,164500,87538
109,86,23,-,-,87539
451,369,82,692,411600,87540
145,145,0,-,(X),87543
7615,5649,1966,931,274200,87544
292,282,10,-,160400,87548
404,353,51,-,189100,87549
157,147,10,-,165300,87551
1380,968,412,766,166900,87552
449,364,85,588,125000,87553
13,0,13,-,-,87554
1011,717,294,568,122300,87556
2671,2249,422,959,232100,87557
201,96,105,643,330400,87558
502,389,113,-,84100,87560
254,208,46,-,159700,87562
132,132,0,-,275000,87564
238,177,61,-,81000,87565
948,811,137,674,141600,87566
654,521,133,480,157800,87567
151,142,9,-,170200,87569
4643,2965,1678,697,228900,87571
31,31,0,-,-,87573
94,79,15,-,(X),87574
253,253,0,-,289200,87575
101,101,0,-,113000,87577
215,203,12,-,259900,87578
253,136,117,858,114800,87579
258,191,67,-,270200,87580
0,0,0,-,-,87581
465,381,84,-,156300,87582
66,66,0,-,(X),87583
7190,4879,2311,594,117900,87701
753,482,271,771,342200,87710
185,167,18,-,55900,87711
130,100,30,-,(X),87712
80,80,0,-,123300,87713
494,379,115,757,89200,87714
245,191,54,-,43900,87715
180,143,37,1025,195800,87718
148,148,0,-,116300,87722
106,76,30,-,(X),87723
0,0,0,-,-,87724
146,107,39,604,81700,87728
41,39,2,-,468800,87729
8,4,4,-,(X),87730
119,119,0,-,(X),87731
413,326,87,807,(X),87732
45,38,7,-,46700,87733
111,95,16,-,(X),87734
18,0,18,-,-,87735
124,124,0,-,157300,87736
3242,2194,1048,571,99600,87740
238,220,18,-,174700,87742
114,95,19,650,65000,87743
235,209,26,-,188200,87745
37,37,0,-,60300,87746
592,429,163,456,113400,87747
82,82,0,-,166100,87749
0,0,0,-,-,87750
255,166,89,558,52700,87752
13,7,6,-,-,87753
2791,1719,1072,567,114000,87801
42,42,0,-,(X),87820
292,287,5,-,121100,87821
365,346,19,-,189900,87823
111,111,0,-,315100,87824
581,453,128,850,77100,87825
97,97,0,-,260400,87827
228,228,0,-,83000,87828
304,285,19,-,196000,87829
464,397,67,528,134200,87830
84,79,5,-,(X),87831
241,231,10,-,132900,87832
3063,1940,1123,507,82900,87901
289,262,27,-,78100,87930
224,196,28,-,147000,87931
0,0,0,-,-,87933
742,627,115,681,145900,87935
134,98,36,-,165000,87936
875,558,317,453,61700,87937
44,44,0,-,270600,87939
157,139,18,-,304800,87940
303,250,53,-,73000,87941
477,370,107,783,138000,87942
78,74,4,-,(X),87943
13616,6032,7584,635,105600,88001
452,0,452,1032,-,88002
0,0,0,-,-,88003
0,0,0,-,-,88004
11265,7488,3777,682,150600,88005
8494,6767,1727,673,165700,88007
2242,1271,971,783,162700,88008
32,0,32,-,-,88009
12208,7026,5182,871,241700,88011
9486,7340,2146,1047,135500,88012
307,263,44,(X),78400,88020
5469,4127,1342,500,89900,88021
448,407,41,704,100900,88022
1001,650,351,604,83100,88023
87,69,18,-,"10,000-",88024
142,80,62,451,(X),88025
544,400,144,595,81300,88026
170,160,10,-,88400,88027
197,188,9,-,189500,88028
557,396,161,453,43500,88029
8487,5701,2786,563,85100,88030
100,59,41,-,-,88032
15,15,0,-,-,88033
79,67,12,-,(X),88034
119,119,0,-,117600,88038
74,74,0,-,227900,88039
57,50,7,-,(X),88040
591,519,72,812,150600,88041
112,112,0,-,(X),88042
679,537,142,545,77400,88043
1337,921,416,570,125400,88044
1347,877,470,463,75400,88045
363,190,173,565,225000,88046
739,575,164,507,110400,88047
1019,796,223,620,81400,88048
175,175,0,-,264400,88049
24,18,6,-,(X),88051
70,51,19,-,18000,88052
61,7,54,583,-,88053
19,7,12,-,-,88055
135,100,35,-,119500,88056
7608,5607,2001,652,160200,88061
3474,2352,1122,580,87000,88063
295,177,118,808,129900,88065
601,475,126,488,64500,88072
3877,3099,778,835,68800,88081
17001,9754,7247,795,129200,88101
0,0,0,-,-,88103
57,37,20,688,176600,88112
13,12,1,-,125000,88113
6,3,3,-,-,88114
19,17,2,-,(X),88115
179,141,38,425,108600,88116
113,76,37,575,137500,88118
496,398,98,393,67300,88119
64,44,20,639,64000,88120
46,36,10,-,62500,88121
462,369,93,703,84500,88124
24,12,12,-,(X),88125
17,17,0,-,54100,88126
6656,3827,2829,698,118200,88130
91,48,43,1089,160000,88132
11,8,3,-,(X),88134
624,425,199,639,93200,88135
13,9,4,-,(X),88136
9966,6863,3103,783,132300,88201
10851,6735,4116,642,85500,88203
6442,4698,1744,685,136600,88210
13134,9579,3555,777,122000,88220
1619,1249,370,652,90000,88230
1180,951,229,700,96400,88231
690,517,173,530,81400,88232
11951,7833,4118,825,111200,88240
2447,2092,355,893,159500,88242
52,42,10,-,(X),88250
777,562,215,680,65600,88252
343,251,92,563,84500,88253
21,21,0,-,-,88254
34,0,34,-,-,88255
758,599,159,798,103100,88256
4567,3093,1474,637,99300,88260
8,8,0,-,-,88262
49,38,11,-,187500,88263
11,0,11,-,-,88264
55,29,26,-,78500,88265
447,327,120,571,75600,88267
51,26,25,-,-,88268
570,483,87,618,83000,88301
14753,9187,5566,755,110000,88310
549,432,117,675,53500,88311
1259,1049,210,792,299000,88312
70,47,23,-,93700,88314
806,690,116,742,124600,88316
627,473,154,740,160100,88317
149,132,17,-,202500,88318
48,32,16,-,63100,88321
0,0,0,-,-,88323
110,84,26,-,178800,88324
320,243,77,761,211400,88325
1058,10,1048,1115,-,88330
131,90,41,-,(X),88336
1003,897,106,1466,126500,88337
83,83,0,-,161600,88338
250,219,31,-,158100,88339
812,434,378,322,55600,88340
189,186,3,-,270700,88341
48,48,0,-,(X),88342
14,9,5,-,(X),88343
34,34,0,-,-,88344
3837,3034,803,778,157400,88345
1157,723,434,549,111000,88346
55,39,16,-,-,88347
120,88,32,628,(X),88348
12,12,0,-,-,88349
237,218,19,-,76300,88350
67,58,9,-,(X),88351
2024,1549,475,713,85500,88352
116,79,37,870,44200,88353
47,32,15,-,-,88354
0,0,0,-,-,88355
2578,1748,830,472,73700,88401
29,7,22,-,-,88410
26,21,5,-,95600,88411
15,9,6,-,36300,88414
1159,751,408,706,80200,88415
21,21,0,-,-,88416
31,31,0,-,-,88417
123,71,52,575,77900,88418
92,82,10,-,165000,88419
31,31,0,-,-,88421
48,48,0,-,205600,88422
41,35,6,-,"2,000,000+",88424
470,404,66,630,92700,88426
41,28,13,-,(X),88427
53,51,2,-,63900,88430
0,0,0,-,-,88431
127,95,32,(X),63900,88434
894,611,283,534,87600,88435
70,24,46,(X),155000,88436
455,368,87,592,112800,89001
11127,8003,3124,1273,186700,89002
441,249,192,561,57800,89003
138,138,0,-,351900,89004
6366,4392,1974,923,197900,89005
346,257,89,1308,119200,89007
475,304,171,767,143800,89008
252,136,116,(X),116300,89010
7641,4643,2998,1099,175100,89011
12254,7523,4731,1207,239800,89012
178,135,43,567,59400,89013
15071,6434,8637,983,172000,89014
14524,8724,5800,924,144300,89015
53,53,0,-,(X),89017
419,253,166,855,77300,89018
861,588,273,570,108200,89019
344,120,224,429,96300,89020
1025,823,202,1078,220100,89021
33,33,0,-,38800,89022
358,274,84,642,107400,89025
0,0,0,-,-,89026
6978,4693,2285,799,185700,89027
3810,1627,2183,670,140900,89029
13201,4798,8403,771,75400,89030
19770,12492,7278,1322,146500,89031
13642,7802,5840,1114,129800,89032
105,95,10,-,67800,89039
1196,929,267,821,146600,89040
535,257,278,590,109400,89042
365,295,70,-,161000,89043
7811,6410,1401,1523,263400,89044
703,565,138,852,79900,89045
218,108,110,789,(X),89046
35,18,17,-,55000,89047
8239,5861,2378,795,109800,89048
1188,605,583,500,85100,89049
20403,13215,7188,1362,326200,89052
36,36,0,-,129500,89054
4011,2944,1067,748,105200,89060
2214,1741,473,1089,137400,89061
18633,11128,7505,1219,201200,89074
9819,5178,4641,1208,167000,89081
8398,5619,2779,1206,198100,89084
1196,1046,150,1927,244000,89085
1945,502,1443,1054,201300,89086
13617,2633,10984,655,76700,89101
13739,3656,10083,772,155400,89102
21368,7166,14202,859,101700,89103
13911,6168,7743,790,97500,89104
8785,3024,5761,794,98400,89106
12256,6410,5846,853,106700,89107
24688,11155,13533,950,112800,89108
3792,1197,2595,902,250400,89109
20852,11319,9533,894,111800,89110
10220,5604,4616,1089,196200,89113
17520,5996,11524,834,81500,89115
22106,10412,11694,1061,236800,89117
8198,3095,5103,978,161300,89118
20026,3980,16046,782,130000,89119
9342,5052,4290,935,156900,89120
23692,11083,12609,868,112200,89121
17299,9925,7374,936,103700,89122
22818,12519,10299,1146,189000,89123
345,263,82,968,356200,89124
14610,7116,7494,1003,167100,89128
19422,12674,6748,1163,199200,89129
12152,8565,3587,1264,172300,89130
15351,11508,3843,1351,241000,89131
11726,9156,2570,1411,230800,89134
10695,6861,3834,1546,349900,89135
4738,3136,1602,1653,340500,89138
11438,6463,4975,1380,203000,89139
9477,6138,3339,1578,243300,89141
10089,5516,4573,989,114400,89142
3887,2778,1109,1375,205300,89143
7154,4731,2423,1388,247300,89144
9329,5600,3729,1165,140300,89145
6558,2806,3752,897,217900,89146
18387,9437,8950,1140,169500,89147
15610,7433,8177,1286,212600,89148
13105,8016,5089,1151,217800,89149
8791,4942,3849,922,107100,89156
37,37,0,-,-,89161
4642,2323,2319,1115,211300,89166
9190,1664,7526,737,114000,89169
10937,7249,3688,1330,219700,89178
1426,1175,251,1402,215600,89179
13830,6714,7116,1174,170700,89183
0,0,0,-,-,89191
2368,1741,627,686,139500,89301
251,212,39,473,142600,89310
49,39,10,-,(X),89311
142,56,86,1015,65000,89314
591,401,190,575,129000,89316
135,127,8,-,129700,89317
487,385,102,729,81300,89318
109,55,54,969,(X),89319
0,0,0,-,-,89402
5627,4267,1360,977,148500,89403
23,23,0,-,-,89404
10,0,10,-,-,89405
9475,5818,3657,851,151000,89406
6886,4532,2354,962,136600,89408
77,77,0,-,(X),89409
4405,2950,1455,932,270300,89410
413,371,42,850,646200,89411
154,154,0,-,(X),89412
254,169,85,2131,1297800,89413
179,125,54,950,76500,89414
1602,1043,559,553,86000,89415
81,49,32,-,(X),89418
1620,1002,618,584,104700,89419
19,7,12,-,-,89420
202,142,60,479,55700,89421
23,23,0,-,(X),89422
4376,3450,926,1178,311800,89423
105,79,26,263,87500,89424
243,149,94,-,(X),89425
135,123,12,-,(X),89426
329,199,130,361,72700,89427
78,78,0,-,228600,89428
2774,2111,663,842,84700,89429
142,91,51,-,328700,89430
13792,6198,7594,776,122500,89431
6514,4321,2193,929,99700,89433
10104,6200,3904,1030,171500,89434
14203,10193,4010,1362,234800,89436
8,8,0,-,-,89438
724,497,227,1090,264000,89439
471,339,132,(X),251600,89440
4082,3316,766,1406,270600,89441
402,252,150,843,100800,89442
1155,971,184,960,167800,89444
5749,4207,1542,815,160700,89445
18,18,0,-,-,89446
3394,2125,1269,652,112900,89447
718,508,210,1242,640400,89448
1486,674,812,1072,387200,89449
105,63,42,-,-,89450
3895,2702,1193,1377,700900,89451
5245,3553,1692,959,225800,89460
2327,438,1889,594,243400,89501
17553,6005,11548,715,148600,89502
10920,4771,6149,800,173300,89503
13090,8985,4105,1077,146200,89506
4291,3755,536,1339,157800,89508
15729,8104,7625,811,302400,89509
660,598,62,496,285000,89510
10469,7250,3219,1005,429800,89511
9450,3050,6400,712,96600,89512
3642,2715,927,1424,387700,89519
10189,7203,2986,1468,263200,89521
13198,7005,6193,1084,261100,89523
9795,5419,4376,789,171200,89701
0,0,0,-,-,89702
4413,3082,1331,893,293100,89703
1768,1589,179,995,298600,89704
2091,1417,674,1178,193300,89705
7973,4070,3903,825,125600,89706
8341,5621,2720,950,192500,89801
4986,4247,739,1329,215400,89815
1928,1478,450,646,107100,89820
212,180,32,-,91800,89821
762,550,212,953,106500,89822
75,62,13,-,677600,89823
547,223,324,582,13000,89825
27,0,27,-,-,89826
224,224,0,-,209200,89828
90,30,60,-,(X),89830
16,16,0,-,-,89831
578,277,301,402,85000,89832
77,24,53,-,322200,89833
33,19,14,-,-,89834
695,428,267,724,135100,89835
1346,775,571,676,120300,89883
13438,4638,8800,984,258500,90001
12134,4480,7654,991,227200,90002
16287,5035,11252,1075,242200,90003
22726,3724,19002,1090,746000,90004
15823,1272,14551,952,688300,90005
19156,1436,17720,963,436500,90006
11707,1250,10457,1046,368600,90007
14370,5012,9358,1001,462500,90008
2180,398,1782,1645,710800,90010
22734,5909,16825,991,277600,90011
10658,1363,9295,1163,397300,90012
6592,733,5859,640,418100,90013
4656,386,4270,732,343500,90014
7683,1096,6587,897,468100,90015
17146,6247,10899,1098,377600,90016
9981,346,9635,870,446400,90017
15929,4657,11272,977,382300,90018
24313,6578,17735,1156,664400,90019
16425,1581,14844,1137,525700,90020
1712,107,1605,427,409400,90021
17216,5918,11298,975,312400,90022
11125,2975,8150,982,299500,90023
17146,5210,11936,1912,1026300,90024
21934,5402,16532,1668,693100,90025
25139,5603,19536,1118,610000,90026
21953,4442,17511,1229,842800,90027
15873,852,15021,1143,611900,90028
14169,1268,12901,1020,561100,90029
11430,3628,7802,995,366900,90031
13111,6223,6888,1100,349600,90032
13110,2265,10845,911,306900,90033
25769,4981,20788,1425,671000,90034
13192,4284,8908,1678,888400,90035
18602,2906,15696,1854,983300,90036
16603,4060,12543,974,289000,90037
11781,1110,10671,1050,580100,90038
11443,4942,6501,1360,644700,90039
3465,1514,1951,965,334400,90040
9591,5062,4529,1206,570200,90041
19846,8610,11236,1173,417200,90042
16631,8242,8389,994,374400,90043
26326,7743,18583,986,283100,90044
15740,8101,7639,1706,712100,90045
29069,6356,22713,1422,889200,90046
16604,9090,7514,1070,306500,90047
11957,3459,8498,1751,1016800,90048
16259,8559,7700,1891,1664900,90049
3471,2268,1203,1489,783900,90056
16149,644,15505,876,308100,90057
802,65,737,640,190800,90058
9933,4200,5733,912,229200,90059
7223,2796,4427,1131,266500,90061
9440,3703,5737,1040,298900,90062
13390,4892,8498,1028,299100,90063
10771,6113,4658,1703,943200,90064
14931,7290,7641,1131,501800,90065
24434,9273,15161,1443,781600,90066
1428,1073,355,2564,973900,90067
11845,5441,6404,1446,1001200,90068
12551,4653,7898,1571,720100,90069
0,0,0,-,-,90071
0,0,0,-,-,90073
3341,2790,551,2310,1391900,90077
0,0,0,-,-,90079
5,0,5,-,-,90089
0,0,0,-,-,90090
3100,1266,1834,2442,657900,90094
0,0,0,-,-,90095
24107,5551,18556,1090,293100,90201
8398,5812,2586,2209,"2,000,000+",90210
3514,1052,2462,1699,1182800,90211
5716,1729,3987,1959,1520300,90212
13182,7864,5318,1114,230400,90220
11886,6057,5829,1077,253100,90221
7832,3694,4138,1055,236600,90222
12915,7137,5778,1530,567700,90230
6388,2597,3791,1494,748300,90232
7181,4930,2251,1371,461900,90240
13440,5842,7598,1201,437800,90241
12117,5844,6273,1239,389300,90242
6747,2766,3981,1575,784800,90245
16053,6658,9395,1126,342800,90247
3432,2531,901,1175,370400,90248
8739,5352,3387,1036,374200,90249
31813,9723,22090,1059,417800,90250
9197,4431,4766,1902,1086200,90254
18456,5479,12977,945,301400,90255
10501,4029,6472,1344,406900,90260
15134,6599,8535,1054,289300,90262
0,0,0,-,-,90263
7206,5166,2040,2618,1659800,90265
13644,9290,4354,2122,1398400,90266
6378,1635,4743,976,302800,90270
9185,7210,1975,2453,1694400,90272
9442,8321,1121,2390,1292600,90274
15861,12743,3118,2244,968800,90275
16081,7289,8792,1799,853900,90277
15430,8653,6777,1680,696000,90278
23398,10600,12798,999,312200,90280
2347,1853,494,1901,885700,90290
13779,4499,9280,1786,1052100,90291
11963,3410,8553,2341,767600,90292
6689,3154,3535,1798,561000,90293
12150,2857,9293,1065,281100,90301
10859,3003,7856,1113,315100,90302
7327,2850,4477,1097,347700,90303
6535,2014,4521,1000,331200,90304
5854,3907,1947,1229,367700,90305
4686,207,4479,1624,705800,90401
5165,3396,1769,1793,"2,000,000+",90402
13719,3060,10659,1700,935000,90403
9808,2236,7572,1441,698100,90404
14254,4485,9769,1556,1025800,90405
14218,6375,7843,1200,528700,90501
5641,3865,1776,1326,353900,90502
17270,8683,8587,1492,651300,90503
11465,6905,4560,1354,541000,90504
14195,8046,6149,1561,727400,90505
0,0,0,-,-,90506
11058,6643,4415,1291,430300,90601
8116,3077,5039,1101,434200,90602
6492,5101,1391,1660,452000,90603
11940,7734,4206,1246,389300,90604
10551,7059,3492,1317,377000,90605
8539,5850,2689,1238,342400,90606
12862,9176,3686,1559,418000,90620
10039,3918,6121,1344,429700,90621
5021,3448,1573,1499,587200,90623
15961,10614,5347,1625,504100,90630
21351,12660,8691,1330,448300,90631
14517,11178,3339,1586,426300,90638
19826,9004,10822,1146,402400,90640
27225,17191,10034,1349,331400,90650
16594,11046,5548,1210,336000,90660
4638,2897,1741,1272,351100,90670
9163,4622,4541,1292,306000,90680
4558,2380,2178,1387,395200,90701
15145,11928,3217,2092,604300,90703
1340,307,1033,1359,721200,90704
23176,9089,14087,1185,354200,90706
8922,4968,3954,1024,401000,90710
10605,7746,2859,1458,424600,90712
9360,7386,1974,1873,445200,90713
5865,3181,2684,1449,360800,90715
3856,1445,2411,1166,258600,90716
8536,3592,4944,1260,478000,90717
7748,5183,2565,1609,790900,90720
13844,5405,8439,1192,262300,90723
22189,6951,15238,1129,459800,90731
8431,5778,2653,1737,517700,90732
12375,9299,3076,1582,296600,90740
360,201,159,2118,1237500,90742
166,98,68,1925,980800,90743
14272,5718,8554,1006,322500,90744
15126,10538,4588,1339,337900,90745
8047,6938,1109,1616,376200,90746
0,0,0,-,-,90747
4028,1954,2074,1209,378000,90755
20636,4586,16050,1057,297500,90802
16995,7427,9568,1377,712900,90803
14682,3032,11650,1122,393900,90804
26108,11297,14811,1062,304100,90805
12403,4207,8196,1035,363900,90806
12677,6885,5792,1216,499500,90807
14119,10941,3178,1455,534800,90808
9179,5126,4053,1043,320100,90810
16575,2044,14531,947,313500,90813
9263,2794,6469,1193,600100,90814
14479,9588,4891,1548,527100,90815
0,0,0,-,-,90822
0,0,0,-,-,90831
12725,9747,2978,1445,586500,91001
10435,7168,3267,1547,802900,91006
11808,6495,5313,1384,811200,91007
468,317,151,3008,1058600,91008
7875,4920,2955,1389,364300,91010
6604,5890,714,2097,1173600,91011
14476,7420,7056,1299,534700,91016
3216,1115,2101,1331,544700,91020
4538,2725,1813,1478,835400,91024
10260,4467,5793,1403,855600,91030
7085,4915,2170,1212,445200,91040
9977,5232,4745,1175,437500,91042
151,0,151,1077,-,91046
10803,1768,9035,1389,431500,91101
8324,4013,4311,1207,557500,91103
12964,6818,6146,1250,614800,91104
5354,3122,2232,2029,902500,91105
10578,3851,6727,1412,579600,91106
12406,7582,4824,1398,678000,91107
4646,4118,528,3390,1387500,91108
8183,2535,5648,1266,626200,91201
8716,3436,5280,1517,638700,91202
4812,1208,3604,1301,369100,91203
5824,749,5075,1166,399000,91204
14193,2074,12119,1221,452000,91205
12925,4602,8323,1284,609600,91206
3962,2359,1603,1446,836300,91207
5847,4033,1814,1478,745100,91208
258,36,222,3074,650000,91210
10453,7722,2731,1655,617600,91214
9246,7200,2046,2028,689300,91301
9135,6622,2513,2046,988500,91302
9466,2368,7098,1235,347000,91303
16999,8713,8286,1232,468100,91304
14447,8201,6246,1185,389500,91306
8581,7064,1517,2508,546700,91307
13715,9350,4365,1438,464300,91311
12335,6322,6013,1426,564600,91316
15037,11821,3216,1948,594800,91320
10973,5884,5089,1354,364600,91321
9552,5027,4525,1445,455200,91324
11775,5406,6369,1339,520100,91325
12357,8621,3736,1775,624200,91326
0,0,0,-,-,91330
22406,13105,9301,1299,311000,91331
23433,11664,11769,1215,358300,91335
8341,4549,3792,1202,318400,91340
24189,16452,7737,1334,341200,91342
17294,9190,8104,1163,405600,91343
17049,12588,4461,1621,472000,91344
5125,3597,1528,1339,346500,91345
11272,9185,2087,1625,413200,91350
10113,6558,3555,1462,325800,91351
12270,6562,5708,1193,358400,91352
9659,7508,2151,2108,469900,91354
12700,7558,5142,1763,438200,91355
11259,6177,5082,1340,772800,91356
15006,9977,5029,1765,577600,91360
8539,6453,2086,1885,803100,91361
13592,9842,3750,1742,662300,91362
10243,7102,3141,1891,670000,91364
17489,9320,8169,1805,578600,91367
0,0,0,-,-,91371
5388,3865,1523,2000,660600,91377
6540,4442,2098,1786,598300,91381
7060,5685,1375,1277,402700,91384
13470,8347,5123,1681,396100,91387
6420,5736,684,1609,489700,91390
14904,5193,9711,1194,532600,91401
18662,6304,12358,1079,302000,91402
11336,5328,6008,1565,774900,91403
16953,4464,12489,1071,363700,91405
17749,7253,10496,1150,387400,91406
9520,2701,6819,1158,485500,91411
15184,5862,9322,1549,772700,91423
5382,4336,1046,2203,1039100,91436
7760,2384,5376,1454,618400,91501
5241,489,4752,1263,358200,91502
9314,4859,4455,1344,595100,91504
12978,5748,7230,1544,562800,91505
7208,4069,3139,1344,583100,91506
16615,3208,13407,1271,478900,91601
9276,3161,6115,1456,640100,91602
14297,6704,7593,1668,860000,91604
15694,5979,9715,1112,359400,91605
15197,4617,10580,1135,393100,91606
13354,3996,9358,1302,615200,91607
0,0,0,-,-,91608
12832,9959,2873,1437,392100,91701
14794,8446,6348,1239,323100,91702
18010,10303,7707,1238,312300,91706
369,304,65,2580,383900,91708
23696,18358,5338,1843,507500,91709
21534,14647,6887,1359,350700,91710
11922,7926,3996,1395,558500,91711
10022,6964,3058,1364,347300,91722
6168,2616,3552,1226,382600,91723
8084,5730,2354,1424,435600,91724
22957,10685,12272,1475,306700,91730
8692,3204,5488,1005,362200,91731
16430,7122,9308,1137,356500,91732
11145,4458,6687,1101,351200,91733
8244,5923,2321,1516,466000,91737
11317,7873,3444,1678,480200,91739
8383,5546,2837,1355,386700,91740
8745,6341,2404,1583,574800,91741
18358,12235,6123,1261,316600,91744
16030,12331,3699,1640,489900,91745
6607,4826,1781,1284,325300,91746
13476,8868,4608,1376,491200,91748
11888,8607,3281,1390,468900,91750
8066,5167,2899,1188,320300,91752
10669,5844,4825,1211,521100,91754
8437,4095,4342,1263,484100,91755
207,146,61,1396,309100,91759
16322,10541,5781,1310,286000,91761
16696,8319,8377,1176,266000,91762
10411,6087,4324,1134,265200,91763
15163,6925,8238,1268,248800,91764
14978,11581,3397,1808,568100,91765
18002,9478,8524,1191,285500,91766
14060,7400,6660,1147,279400,91767
8220,4203,4017,1071,273200,91768
17085,8553,8532,1178,432100,91770
12074,8954,3120,1532,447900,91773
8270,5566,2704,1246,658800,91775
11544,4703,6841,1244,536000,91776
11417,7278,4139,1244,606000,91780
9151,7963,1188,1975,505600,91784
19061,7892,11169,1182,351800,91786
12853,10770,2083,1928,623200,91789
12459,8686,3773,1365,385800,91790
10010,6868,3142,1314,459500,91791
8786,4934,3852,1461,378700,91792
19503,7274,12229,1224,490900,91801
9641,4474,5167,1176,499700,91803
6511,4746,1765,1347,481900,91901
6009,4480,1529,1640,542900,91902
406,262,144,625,266500,91905
1121,722,399,887,169500,91906
25928,12147,13781,1185,363900,91910
24503,12247,12256,1206,314300,91911
13722,9688,4034,1830,411400,91913
4734,4050,684,2297,497700,91914
7637,5990,1647,2113,401200,91915
606,532,74,842,301500,91916
204,185,19,-,187500,91917
150,124,26,-,(X),91931
9014,2844,6170,1215,356500,91932
186,127,59,-,125200,91934
2677,2339,338,1500,543800,91935
12055,7367,4688,1249,519100,91941
16697,6814,9883,1300,369700,91942
8565,4723,3842,1155,316600,91945
26,12,14,-,-,91948
15686,5044,10642,987,291900,91950
724,567,157,1123,358300,91962
376,289,87,(X),130600,91963
18528,10707,7821,1228,322400,91977
3113,2069,1044,1611,369700,91978
96,60,36,-,-,91980
1687,1256,431,1277,514200,92003
1289,798,491,913,168700,92004
4516,2667,1849,1879,836900,92007
11483,4951,6532,1553,627700,92008
16355,11833,4522,1867,691500,92009
5697,4002,1695,1932,521600,92010
9247,5982,3265,2013,682600,92011
5941,4254,1687,1947,1198200,92014
15083,9832,5251,1403,422900,92019
19371,7562,11809,1114,432900,92020
21807,10917,10890,1159,305800,92021
18964,12533,6431,1708,744700,92024
15098,6133,8965,1150,415000,92025
16804,10135,6669,1253,380700,92026
16042,9257,6785,1167,335000,92027
16662,11201,5461,1070,436000,92028
6891,5171,1720,1388,475300,92029
1350,1029,321,896,275300,92036
16796,9489,7307,1765,1132900,92037
14738,9302,5436,1190,356800,92040
15337,5626,9711,1224,422000,92054
144,0,144,1968,-,92055
19445,12346,7099,1570,368200,92056
18615,12122,6493,1676,355200,92057
13716,4178,9538,1629,289200,92058
383,283,100,775,329500,92059
39,39,0,-,(X),92060
596,455,141,1415,342800,92061
15863,11751,4112,1447,545900,92064
11638,8658,2980,1221,394100,92065
161,90,71,1142,400000,92066
3198,2785,413,2226,"2,000,000+",92067
14613,8035,6578,1233,392300,92069
425,278,147,905,366700,92070
19297,13506,5791,1403,348100,92071
5341,3032,2309,1868,973400,92075
16890,10854,6036,1459,411200,92078
10452,5416,5036,1419,410000,92081
6214,4835,1379,1041,452500,92082
10818,5037,5781,1208,312200,92083
15337,8344,6993,1212,409400,92084
663,539,124,797,147000,92086
629,536,93,2337,943800,92091
20531,4599,15932,1332,457300,92101
14479,3952,10527,1070,294600,92102
17661,6023,11638,1258,590400,92103
20739,6189,14550,1096,467600,92104
21192,6012,15180,977,280600,92105
7251,4363,2888,1704,826800,92106
12658,4785,7873,1367,701400,92107
10361,2895,7466,1808,283300,92108
22421,6512,15909,1432,690800,92109
11146,4908,6238,1359,496600,92110
16893,8525,8368,1321,417900,92111
12833,3780,9053,960,253200,92113
17587,11491,6096,1216,299300,92114
20596,7077,13519,1137,384700,92115
16301,5234,11067,1116,493900,92116
20785,12287,8498,1370,477800,92117
8500,4046,4454,2099,1301100,92118
9502,6451,3051,1490,451900,92119
10788,7249,3539,1480,483400,92120
1554,744,810,1822,623900,92121
19468,6238,13230,1758,603400,92122
10842,5371,5471,1779,425600,92123
10705,5011,5694,2029,522300,92124
23404,13335,10069,1748,409800,92126
13875,9749,4126,1861,659100,92127
20121,13257,6864,1737,528500,92128
17339,11761,5578,1694,603600,92129
17998,11713,6285,2180,870400,92130
11536,9083,2453,2112,644500,92131
0,0,0,-,-,92132
0,0,0,-,-,92134
0,0,0,-,-,92135
10329,6235,4094,1444,291500,92139
11,0,11,-,-,92140
560,398,162,1225,1136900,92145
0,0,0,-,-,92147
21366,12392,8974,1350,293700,92154
0,0,0,-,-,92155
7922,2254,5668,969,279200,92173
19219,10904,8315,963,171900,92201
10230,7192,3038,1263,272100,92203
2672,2213,459,831,627200,92210
12473,9254,3219,1264,340700,92211
11844,8011,3833,981,168500,92220
0,0,0,-,-,92222
15553,11755,3798,1101,221300,92223
5980,3121,2859,711,120300,92225
7818,4222,3596,745,145600,92227
960,565,395,1016,81100,92230
9451,4751,4700,812,161100,92231
971,464,507,715,94400,92233
17354,10358,6996,1106,185900,92234
10484,6584,3900,875,152200,92236
67,50,17,(X),112500,92239
11790,5525,6265,937,124000,92240
4077,3145,932,698,59800,92241
697,605,92,560,64000,92242
13770,7123,6647,747,153200,92243
1757,1196,561,774,162300,92249
2488,1444,1044,762,149100,92250
5198,3825,1373,1141,184000,92251
3798,2048,1750,826,119100,92252
14949,10695,4254,1389,349400,92253
3003,1510,1493,705,91300,92254
1545,1129,416,859,113600,92256
781,488,293,534,41000,92257
213,169,44,-,73800,92258
121,93,28,-,92500,92259
15807,9222,6585,1090,297900,92260
12542,6622,5920,935,294300,92262
10902,6651,4251,976,259500,92264
91,65,26,-,(X),92266
0,0,0,-,-,92267
264,243,21,-,215700,92268
9176,7142,2034,1237,478500,92270
411,154,257,709,85700,92273
5278,3283,1995,742,48800,92274
552,357,195,840,82400,92275
2813,2004,809,1156,143100,92276
9211,3101,6110,915,116700,92277
178,0,178,1227,-,92278
14,0,14,-,-,92280
594,265,329,640,106800,92281
335,194,141,1691,102000,92282
836,357,479,522,78100,92283
10290,6384,3906,900,125600,92284
1086,908,178,892,77800,92285
7966,4097,3869,1008,101100,92301
15,0,15,-,-,92304
170,83,87,1350,251400,92305
12427,8791,3636,918,192700,92307
13959,9015,4944,973,170800,92308
259,77,182,717,21100,92309
2337,33,2304,1231,-,92310
11202,5704,5498,743,96700,92311
4371,2764,1607,1216,237900,92313
4435,2694,1741,1026,226000,92314
2305,1296,1009,902,365800,92315
7353,5454,1899,1110,191700,92316
3346,2848,498,984,160800,92320
466,318,148,1318,265200,92321
365,250,115,1071,161200,92322
16790,8808,7982,1004,168500,92324
3503,2395,1108,837,179900,92325
236,127,109,913,56400,92327
204,95,109,(X),(X),92328
8,8,0,-,-,92332
239,173,66,(X),336500,92333
23521,11820,11701,994,198800,92335
22722,16989,5733,1652,306200,92336
9326,6747,2579,1482,251800,92337
0,0,0,-,-,92338
411,282,129,1182,241900,92339
177,121,56,-,191300,92341
2298,1662,636,1385,214000,92342
5909,4552,1357,1538,234400,92344
23423,14357,9066,1012,154600,92345
16691,11047,5644,944,242500,92346
422,310,112,(X),107900,92347
2608,2167,441,1024,314700,92352
7411,2801,4610,1088,279800,92354
2273,1713,560,649,102400,92356
461,358,103,1117,237000,92358
2878,1731,1147,889,214600,92359
2309,1191,1118,573,86400,92363
17,12,5,-,-,92364
738,616,122,(X),124400,92365
284,162,122,957,85600,92368
5153,3738,1415,974,140100,92371
2118,1653,465,1114,153900,92372
13436,6600,6836,1162,379900,92373
12758,7844,4914,1157,252900,92374
21042,12173,8869,1057,178800,92376
5227,4456,771,1764,275000,92377
67,67,0,-,195500,92378
2047,1433,614,1250,197100,92382
16,4,12,-,-,92384
104,81,23,-,280900,92385
977,607,370,981,153600,92386
59,33,26,513,71700,92389
976,624,352,1180,229900,92391
15509,10199,5310,1226,151300,92392
7720,4530,3190,1164,144600,92394
13065,6259,6806,1033,144900,92395
1888,1236,652,1156,251600,92397
481,271,210,569,110400,92398
18585,13392,5193,1082,225500,92399
656,40,616,766,(X),92401
17179,7620,9559,925,175800,92404
8355,3987,4368,932,151000,92405
15737,8798,6939,1123,216900,92407
3718,1180,2538,877,164400,92408
12339,5184,7155,836,95600,92410
6462,3086,3376,1001,121300,92411
6841,2946,3895,977,212500,92501
25102,15705,9397,1178,251900,92503
15988,9310,6678,1127,240800,92504
13397,6995,6402,1224,245800,92505
15318,11581,3737,1248,345700,92506
16297,5498,10799,1129,238100,92507
10209,8397,1812,1804,355100,92508
19296,12810,6486,1120,232300,92509
509,75,434,1607,270800,92518
14734,8462,6272,1131,196400,92530
5925,4127,1798,1679,263800,92532
1066,817,249,1081,208500,92536
1561,973,588,792,138300,92539
13270,6561,6709,872,80700,92543
15426,9985,5441,977,149900,92544
14875,9605,5270,1130,154800,92545
2220,1341,879,953,80600,92548
1232,891,341,1127,249700,92549
7990,5127,2863,1342,178600,92551
18770,9157,9613,1154,170200,92553
10684,7631,3053,1559,259800,92555
14350,9461,4889,1317,221900,92557
714,585,129,948,326000,92561
19867,13190,6677,1532,327300,92562
16929,11799,5130,1696,316000,92563
2681,1964,717,1147,215100,92567
13752,8601,5151,1053,182600,92570
12050,7909,4141,1403,185400,92571
4316,3254,1062,1270,165900,92582
9525,5865,3660,891,131100,92583
13913,10783,3130,1652,278100,92584
5711,4298,1413,1366,215800,92585
8936,6045,2891,1052,144300,92586
5833,4693,1140,1559,288700,92587
1623,746,877,826,784300,92590
12647,7139,5508,1436,330900,92591
23171,17129,6042,1759,355300,92592
9138,6437,2701,1472,244200,92595
7228,5620,1608,1533,308300,92596
8478,4149,4329,1882,713900,92602
7765,5201,2564,2063,1067700,92603
10168,6029,4139,1876,610800,92604
8041,3077,4964,1969,675700,92606
4020,2978,1042,1766,608200,92610
12238,3851,8387,1912,607400,92612
9736,4589,5147,1913,642300,92614
4082,1128,2954,1280,403400,92617
10467,4165,6302,2067,615300,92618
16302,9929,6373,1895,768700,92620
2751,1609,1142,1773,712800,92624
5710,3744,1966,2190,1726400,92625
19070,8394,10676,1702,614200,92626
22118,7380,14738,1469,597900,92627
11534,6860,4674,1794,742000,92629
20517,13994,6523,1674,504200,92630
11298,8498,2800,1457,211500,92637
21025,15846,5179,1846,608600,92646
20028,9376,10652,1513,605700,92647
19267,9589,9678,1586,792700,92648
13780,8405,5375,1685,666200,92649
11608,7070,4538,1931,1324200,92651
9466,6659,2807,1835,611900,92653
2639,1005,1634,1312,389800,92655
19202,11616,7586,1870,492600,92656
3873,2841,1032,2529,1715800,92657
14682,7783,6899,2148,1362700,92660
1596,775,821,1671,1562500,92661
1492,718,774,1886,1940500,92662
10669,4996,5673,1833,1040200,92663
14211,7518,6693,1651,732200,92672
9890,8196,1694,2280,777400,92673
11857,8764,3093,1724,541400,92675
798,627,171,1697,450000,92676
25023,17807,7216,1839,685700,92677
212,122,90,1136,523800,92678
10597,9180,1417,2089,761400,92679
27337,14388,12949,1360,470400,92683
15938,10798,5140,1709,516000,92688
16119,12300,3819,1899,569100,92691
18008,13676,4332,1875,602700,92692
7361,5678,1683,2142,684100,92694
12649,3341,9308,1078,341200,92701
13221,6034,7187,1322,315300,92703
19802,10730,9072,1422,355300,92704
14936,10198,4738,1398,749100,92705
9388,4835,4553,1208,443800,92706
13263,6729,6534,1465,350000,92707
19086,13230,5856,1696,613800,92708
18984,9025,9959,1431,473100,92780
8272,5188,3084,2022,663700,92782
18161,6631,11530,1335,357800,92801
11686,4622,7064,1301,388600,92802
23878,9943,13935,1308,385200,92804
18197,7043,11154,1313,381200,92805
12366,5091,7275,1555,436900,92806
12186,9730,2456,1931,572100,92807
7397,5622,1775,1975,620300,92808
13230,7834,5396,1575,534600,92821
1059,970,89,2629,674800,92823
12196,4774,7422,1293,521800,92831
8100,3205,4895,1321,431400,92832
15980,9506,6474,1417,487700,92833
8415,6000,2415,1424,659400,92835
14929,8354,6575,1366,394500,92840
9263,4975,4288,1319,417200,92841
11226,5182,6044,1231,382200,92843
6682,2826,3856,1372,399500,92844
5665,4658,1007,1490,495100,92845
7030,5682,1348,1728,412400,92860
1922,1818,104,2758,970000,92861
6154,3958,2196,1560,473900,92865
5445,1948,3497,1461,556000,92866
13061,8434,4627,1556,607200,92867
7643,2743,4900,1562,357300,92868
11542,8535,3007,1613,571900,92869
16532,10835,5697,1545,533000,92870
14336,8385,5951,1414,286200,92879
15889,11815,4074,1995,412700,92880
9687,7751,1936,1552,399800,92881
21090,13793,7297,1270,348100,92882
9976,8458,1518,2368,359300,92883
16254,13474,2780,1684,685700,92886
6642,5651,991,1829,740200,92887
12762,5439,7323,1249,433700,93001
19352,10952,8400,1494,434600,93003
10727,6810,3917,1509,421500,93004
15665,10121,5544,1562,492600,93010
12782,10015,2767,1849,495900,93012
6308,3461,2847,1489,623800,93013
4830,3220,1610,1104,317000,93015
11158,8219,2939,1760,553300,93021
2513,1918,595,1576,424300,93022
7659,4911,2748,1220,554800,93023
15183,7443,7740,1283,368300,93030
17261,9508,7753,1302,283100,93033
9715,6026,3689,1777,415800,93035
12363,6658,5705,1347,376000,93036
581,408,173,906,215200,93040
7308,3100,4208,1543,296600,93041
0,0,0,-,-,93042
25,4,21,-,-,93043
9505,5369,4136,1110,315600,93060
19090,14066,5024,1651,440300,93063
0,0,0,-,-,93064
23989,17619,6370,1748,463000,93065
1125,772,353,1393,855000,93066
487,202,285,1172,805900,93067
12357,2664,9693,1366,692400,93101
6978,2964,4014,1683,812300,93103
10806,6104,4702,1557,912200,93105
4306,3241,1065,2309,1849300,93108
4342,2772,1570,2179,924600,93109
6324,4019,2305,1561,736900,93110
6338,4319,2019,1882,774400,93111
15729,5888,9841,1444,649000,93117
338,175,163,698,84700,93201
1057,586,471,785,110200,93202
4986,2175,2811,800,107700,93203
2156,980,1176,715,116600,93204
1010,811,199,-,115200,93205
578,255,323,702,153500,93206
142,119,23,792,147900,93207
68,48,20,-,(X),93208
4679,2409,2270,787,153300,93210
4117,1789,2328,734,109800,93212
11729,6510,5219,779,150100,93215
279,158,121,763,97100,93218
2403,941,1462,688,111500,93219
76,0,76,-,-,93220
4948,3316,1632,832,186300,93221
706,484,222,1348,148000,93222
2622,1665,957,699,114500,93223
156,102,54,743,90000,93224
1882,1121,761,961,198100,93225
161,126,35,950,190800,93226
21055,11802,9253,908,176600,93230
1729,521,1208,626,122900,93234
1048,669,379,753,105300,93235
841,538,303,799,228200,93238
394,246,148,643,77600,93239
2481,1630,851,827,120500,93240
4188,1688,2500,737,84200,93241
1048,417,631,717,154500,93242
567,315,252,775,221800,93243
169,129,40,(X),220200,93244
11994,5558,6436,988,189500,93245
5039,2601,2438,726,145000,93247
549,197,352,629,109800,93249
3157,1619,1538,829,122300,93250
74,42,32,375,(X),93251
571,332,239,743,74100,93252
276,152,124,879,106900,93254
330,263,67,-,84400,93255
1321,493,828,748,123400,93256
21344,11860,9484,782,152400,93257
537,229,308,708,86100,93258
67,43,24,-,212000,93260
669,234,435,618,101000,93261
0,0,0,-,-,93262
5091,2704,2387,747,147100,93263
1571,1262,309,888,262500,93265
348,204,144,724,107600,93266
1836,963,873,720,142900,93267
5507,2730,2777,899,121600,93268
1410,879,531,669,181100,93270
1064,846,218,746,282100,93271
972,327,645,813,113100,93272
21385,12132,9253,896,159300,93274
60,37,23,855,63100,93276
18093,10402,7691,943,169500,93277
5570,2710,2860,685,138900,93280
1098,868,230,531,103200,93283
995,881,114,600,164100,93285
2840,1883,957,635,142300,93286
53,51,2,-,256900,93287
15967,9378,6589,893,224300,93291
13304,7939,5365,965,168900,93292
4762,1307,3455,735,135600,93301
15546,6282,9264,838,108500,93304
10751,3949,6802,783,106000,93305
21060,13087,7973,928,158900,93306
21924,10876,11048,866,109900,93307
19121,9517,9604,925,169000,93308
21625,9687,11938,892,162800,93309
14083,9556,4527,1347,261800,93311
18513,14007,4506,1513,253200,93312
12344,9023,3321,1342,202600,93313
7731,6596,1135,1393,316500,93314
11821,5112,6709,1227,581400,93401
6491,4175,2316,1366,393400,93402
8283,2920,5363,1403,593200,93405
0,0,0,-,-,93410
11860,7932,3928,1234,542100,93420
12301,7563,4738,1166,394900,93422
604,400,204,1163,644000,93424
426,286,140,1128,400000,93426
2001,1505,496,1235,428500,93427
2943,2108,835,1325,604500,93428
33,33,0,-,163200,93429
1451,963,488,1261,700200,93430
383,336,47,-,600000,93432
5453,2286,3167,1172,399500,93433
1862,920,942,1052,203100,93434
17798,9018,8780,1030,253400,93436
873,0,873,1591,-,93437
583,321,262,1219,364400,93440
430,329,101,1450,841300,93441
5220,2497,2723,1310,507400,93442
6686,4805,1881,1368,410700,93444
2464,1239,1225,1079,252500,93445
17032,10615,6417,1168,370000,93446
3867,2119,1748,1496,619500,93449
273,59,214,742,151000,93450
1358,857,501,1224,305600,93451
158,68,90,945,(X),93452
1413,952,461,1279,382800,93453
11386,5702,5684,1175,276300,93454
15102,11230,3872,1577,334000,93455
13126,5806,7320,1101,227500,93458
1986,1480,506,1921,825500,93460
525,274,251,1292,210700,93461
3375,2016,1359,1469,748200,93463
3226,2498,728,1145,491900,93465
1929,912,1017,671,67400,93501
4459,2644,1815,815,91500,93505
2520,2250,270,1793,420100,93510
137,101,36,365,(X),93512
719,465,254,898,214600,93513
6031,4058,1973,886,281200,93514
846,477,369,703,55700,93516
228,202,26,1105,160700,93517
456,368,88,1269,148400,93518
67,67,0,-,(X),93519
13,13,0,-,-,93522
1147,249,898,1313,48300,93523
0,0,0,-,-,93524
357,221,136,746,177900,93526
810,699,111,804,171400,93527
55,27,28,-,-,93528
111,34,77,860,-,93529
24,24,0,-,50000,93530
165,152,13,-,232100,93531
962,716,246,1111,190900,93532
14056,4846,9210,933,135400,93534
20901,12505,8396,1117,127000,93535
20910,15036,5874,1226,228500,93536
123,75,48,1029,344800,93541
3599,2679,920,1315,151400,93543
455,370,85,-,205500,93544
868,486,382,708,197400,93545
3168,1668,1500,1137,447800,93546
141,119,22,-,(X),93549
20648,10469,10179,992,152600,93550
15845,12141,3704,1579,262000,93551
9937,7122,2815,1445,172200,93552
789,534,255,813,172400,93553
86,80,6,-,54200,93554
13180,8215,4965,851,173500,93555
93,75,18,-,(X),93558
6301,3772,2529,1021,128900,93560
10910,7799,3111,879,215700,93561
698,453,245,545,43300,93562
137,101,36,964,283000,93563
1916,1200,716,1068,102400,93591
8,8,0,-,-,93592
730,569,161,(X),304800,93601
1606,1245,361,830,242500,93602
122,96,26,-,368800,93603
337,247,90,1355,524700,93604
97,32,65,695,320000,93605
186,119,67,718,133000,93606
240,106,134,866,120300,93608
1558,671,887,844,205400,93609
5004,2416,2588,931,165200,93610
15833,11599,4234,1388,257600,93611
13498,4993,8505,893,149300,93612
4257,3418,839,1128,219600,93614
1482,595,887,748,115100,93615
596,299,297,511,223300,93616
8055,4107,3948,796,153900,93618
10458,8783,1675,1705,361300,93619
2870,1642,1228,747,122200,93620
183,83,100,793,350000,93621
2762,1326,1436,677,122400,93622
50,33,17,-,(X),93623
299,14,285,517,(X),93624
2080,1055,1025,735,224400,93625
475,409,66,(X),299200,93626
27,0,27,-,-,93627
58,44,14,-,(X),93628
5184,2547,2637,774,184800,93630
5155,3201,1954,817,234400,93631
0,0,0,-,-,93633
1,0,1,-,-,93634
11415,5837,5578,1053,167000,93635
3861,3226,635,1434,258500,93636
11530,6382,5148,964,170400,93637
12063,6056,6007,841,151100,93638
3047,1160,1887,667,109900,93640
84,71,13,-,(X),93641
1156,756,400,578,227100,93643
3307,2481,826,1019,241100,93644
59,59,0,-,331400,93645
2673,1080,1593,710,119900,93646
2880,1381,1499,724,136300,93647
3999,1792,2207,745,115600,93648
1348,568,780,924,48000,93650
630,537,93,1086,317000,93651
69,38,31,584,141700,93652
559,503,56,975,272800,93653
8652,5274,3378,872,170700,93654
1721,907,814,864,161600,93656
10561,6771,3790,873,185400,93657
1133,405,728,469,107800,93660
8712,4939,3773,830,172900,93662
267,192,75,1073,478900,93664
192,192,0,-,91000,93665
182,35,147,547,(X),93666
897,623,274,943,266400,93667
333,209,124,1089,257600,93668
144,82,62,-,(X),93669
179,89,90,695,104800,93673
1146,1011,135,963,151200,93675
3038,443,2595,671,92000,93701
12015,4051,7964,777,89500,93702
9714,3224,6490,834,105000,93703
10713,5740,4973,875,205100,93704
12223,5587,6636,874,127900,93705
10630,4380,6250,786,117800,93706
11201,4502,6699,863,185100,93710
15686,9769,5917,1073,306900,93711
17608,10541,7067,1310,270100,93720
1730,153,1577,609,118400,93721
24334,13876,10458,1094,178200,93722
3030,2471,559,996,277200,93723
6810,3619,3191,847,144900,93725
14037,5196,8841,841,136700,93726
22614,12695,9919,833,197200,93727
5617,2548,3069,829,108100,93728
3856,3128,728,1843,380900,93730
9745,3797,5948,1093,346000,93901
13052,4939,8113,1083,234900,93905
17057,8617,8440,1252,273000,93906
7136,4550,2586,1364,359300,93907
4573,3780,793,1597,629600,93908
312,87,225,(X),1587500,93920
1476,929,547,1745,1165800,93921
5772,4286,1486,1919,956500,93923
2557,1749,808,1762,805000,93924
422,236,186,829,350000,93925
2256,1030,1226,1139,222800,93926
3953,1900,2053,1128,213700,93927
53,0,53,966,-,93928
3974,2056,1918,1012,218100,93930
202,92,110,1087,384000,93932
8358,2985,5373,1174,360900,93933
13323,5225,8098,1479,643000,93940
0,0,0,-,-,93943
6832,3286,3546,1456,687400,93950
1851,1478,373,2828,993600,93953
91,32,59,988,168800,93954
10339,3948,6391,1439,346800,93955
3977,2209,1768,1117,220700,93960
229,155,74,904,423200,93962
10334,6217,4117,1668,960500,94002
1783,1203,580,1652,638800,94005
16364,9575,6789,1666,1655000,94010
13595,7635,5960,1477,554600,94014
19916,10968,8948,1757,597100,94015
7021,4951,2070,1782,751800,94019
618,434,184,1622,698300,94020
46,18,28,-,-,94021
7423,6228,1195,2525,"2,000,000+",94022
7870,6952,918,2287,1858000,94024
14832,8962,5870,1877,1313100,94025
2476,2272,204,2987,"2,000,000+",94027
2645,2290,355,2311,"2,000,000+",94028
8165,5082,3083,1849,967800,94030
1025,843,182,1692,795500,94037
1138,877,261,1853,699400,94038
13986,5665,8321,1763,1116900,94040
6248,2225,4023,1834,917100,94041
12578,5603,6975,1790,735600,94043
14136,9628,4508,1868,633600,94044
474,287,187,(X),804000,94060
13875,7209,6666,1680,854500,94061
10272,7574,2698,1679,1219300,94062
9213,3221,5992,1442,516700,94063
4975,3444,1531,2650,937900,94065
14899,8302,6597,1742,615000,94066
11857,8402,3455,1759,1019600,94070
83,52,31,-,1080000,94074
21239,12888,8351,1542,606800,94080
8241,2595,5646,1828,568500,94085
19086,6335,12751,1743,737500,94086
20347,11865,8482,1806,1002900,94087
7680,4899,2781,2055,212400,94089
16463,1429,15034,877,572700,94102
12728,2094,10634,991,687300,94103
176,26,150,704,1350000,94104
3778,1792,1986,3020,694700,94105
13743,5422,8321,2128,792600,94107
7867,782,7085,1072,836100,94108
33721,5186,28535,1459,782600,94109
28019,9912,18107,1470,828300,94110
2118,578,1540,1973,863500,94111
23323,14813,8510,1520,629700,94112
16456,7546,8910,1881,1082900,94114
17732,4358,13374,1667,1028800,94115
15826,10403,5423,1607,805600,94116
18362,5006,13356,1813,1007100,94117
17663,5492,12171,1697,1109200,94118
17388,7231,10157,1551,902700,94121
22882,10632,12250,1735,824100,94122
13962,3546,10416,1929,1269300,94123
10501,5227,5274,891,508200,94124
7208,5728,1480,2182,977800,94127
0,0,0,-,-,94128
1258,23,1235,2952,-,94129
624,0,624,1732,-,94130
13254,6967,6287,1878,919200,94131
10391,4586,5805,1855,756700,94132
13230,2205,11025,1258,996800,94133
11661,7033,4628,1226,585900,94134
2929,681,2248,2745,760300,94158
7131,3539,3592,2031,"2,000,000+",94301
13540,7135,6405,1675,1108300,94303
1837,352,1485,2747,1591500,94304
3162,824,2338,1504,1471700,94305
10641,5805,4836,2030,1390400,94306
12983,5376,7607,1586,592300,94401
9278,6227,3051,1779,1094500,94402
15422,8889,6533,1931,823500,94403
14023,8157,5866,2340,857300,94404
25527,10274,15253,1383,628300,94501
5181,4194,987,2004,665500,94502
5861,4357,1504,1584,343200,94503
5141,3919,1222,2116,400800,94505
7872,6959,913,2449,981200,94506
5579,5007,572,2892,1303900,94507
1105,532,573,1242,595000,94508
21588,12017,9571,1204,231200,94509
10861,7412,3449,1368,449700,94510
1100,953,147,1379,180600,94511
69,15,54,-,-,94512
18658,13783,4875,1910,396100,94513
376,240,136,1176,344200,94514
2870,1675,1195,1123,507600,94515
78,53,25,1375,410000,94516
4659,4124,535,2005,601400,94517
10263,6887,3376,1428,449700,94518
6836,4646,2190,1404,360100,94519
13046,4694,8352,1195,270100,94520
15854,11092,4762,1444,432700,94521
14035,8161,5874,1523,541200,94523
1394,666,728,1091,381500,94525
11994,9974,2020,2430,866300,94526
283,266,17,-,1064600,94528
10114,5977,4137,1511,606800,94530
12130,8223,3907,2011,302700,94531
22324,11115,11209,1141,229300,94533
12798,9592,3206,1803,363200,94534
1054,11,1043,1763,-,94535
24138,14057,10081,1643,598000,94536
21085,9877,11208,1735,539300,94538
16225,13195,3030,2024,957900,94539
20867,9136,11731,1278,367900,94541
4322,2774,1548,1559,547900,94542
22602,11181,11421,1332,340700,94544
9325,6470,2855,1507,384000,94545
15957,9862,6095,1386,496700,94546
8142,6512,1630,1559,396100,94547
145,76,69,(X),757600,94548
10832,8076,2756,1680,1013500,94549
17521,12624,4897,1516,615500,94550
14143,9828,4315,1669,487500,94551
5078,4591,487,2650,695700,94552
18922,12367,6555,1397,401400,94553
11245,8017,3228,1940,607600,94555
5777,4798,979,1810,944900,94556
24230,15266,8964,1505,482500,94558
10414,4673,5741,1284,446300,94559
13436,9292,4144,1632,492400,94560
11703,8865,2838,1401,279000,94561
6709,5928,781,2330,1028500,94563
6741,4829,1912,1356,359200,94564
26906,14969,11937,1339,233100,94565
15288,10944,4344,1697,837300,94566
213,170,43,1194,211800,94567
16697,10462,6235,1971,616100,94568
179,66,113,924,421400,94569
3928,2943,985,1213,234200,94571
3167,2050,1117,1126,305400,94572
64,7,57,1885,-,94573
3613,2201,1412,1433,945600,94574
0,0,0,-,-,94575
28,8,20,-,-,94576
16996,8983,8013,1294,406700,94577
13798,5275,8523,1183,358800,94578
7168,5159,2009,1463,388800,94579
8643,5733,2910,1430,365000,94580
13064,9066,3998,1883,839500,94582
12558,8421,4137,1827,682000,94583
8872,5328,3544,1542,228700,94585
367,274,93,1479,802300,94586
20461,13335,7126,1652,521400,94587
11183,7569,3614,1940,693500,94588
9552,5644,3908,1382,188500,94589
14036,5669,8367,1034,192500,94590
18291,12096,6195,1386,280400,94591
256,211,45,2304,352000,94592
9060,7450,1610,1353,429500,94595
9507,4009,5498,1472,764300,94596
9840,4630,5210,1621,580400,94597
10179,7896,2283,1849,766900,94598
1350,923,427,1825,603600,94599
14931,4611,10320,1043,274700,94601
11930,7011,4919,1136,565800,94602
9614,4550,5064,1192,221100,94603
15199,8716,6483,1160,392500,94605
14896,2793,12103,1054,357100,94606
11344,2799,8545,972,361400,94607
13748,4772,8976,1416,377600,94608
9794,2916,6878,1188,573500,94609
15562,5605,9957,1316,718100,94610
16911,10225,6686,1275,850000,94611
8193,693,7500,927,398700,94612
5,0,5,-,-,94613
7106,4627,2479,1566,924300,94618
8916,5730,3186,1359,491400,94619
9410,2969,6441,1099,205900,94621
7581,3447,4134,1270,569100,94702
8887,3675,5212,1366,643900,94703
8143,759,7384,1327,753200,94704
5840,3295,2545,1382,997000,94705
7996,3655,4341,1625,669300,94706
5132,4210,922,1700,883700,94707
4738,4102,636,2472,882700,94708
5219,1309,3910,1451,773100,94709
2933,1174,1759,1326,613600,94710
28,12,16,-,-,94720
9291,3737,5554,1023,197200,94801
9328,6356,2972,1362,360900,94803
14597,6618,7979,1168,244400,94804
5327,3204,2123,1283,319100,94805
19261,8984,10277,1199,246800,94806
0,0,0,-,-,94850
15638,7732,7906,1435,805400,94901
12168,8345,3823,1795,644200,94903
5435,3205,2230,1730,1230700,94904
5435,3791,1644,2269,1710300,94920
237,38,199,882,-,94922
450,343,107,1097,606200,94923
539,339,200,1734,923000,94924
3784,2666,1118,1887,985900,94925
15946,8124,7822,1317,323100,94928
79,55,24,-,835900,94929
3866,2538,1328,1712,721600,94930
3194,1954,1240,1226,426500,94931
342,227,115,(X),584200,94933
463,210,253,1455,780500,94937
300,180,120,1643,656600,94938
3247,1617,1630,1853,1355400,94939
131,71,60,1139,1529800,94940
12968,8428,4540,1724,1083500,94941
7218,4712,2506,1654,633800,94945
295,236,59,1453,1270800,94946
9946,6927,3019,1687,587500,94947
6857,4231,2626,1810,577900,94949
39,25,14,-,1026800,94950
1556,1010,546,1233,703000,94951
13176,7664,5512,1397,588500,94952
13293,9379,3914,1603,442000,94954
756,323,433,1147,890900,94956
397,359,38,2357,"2,000,000+",94957
6384,4922,1462,1611,922900,94960
269,182,87,1730,884100,94963
90,13,77,740,-,94964
5571,2445,3126,1781,935500,94965
278,187,91,3359,1388200,94970
156,43,113,1340,-,94971
0,0,0,-,-,94972
748,574,174,1156,695400,94973
543,310,233,1272,408800,95002
10058,6954,3104,1757,672300,95003
1303,998,305,1160,439300,95004
2548,1877,671,1357,526000,95005
3932,2909,1023,1333,439100,95006
310,272,38,-,648400,95007
18351,9228,9123,1638,714200,95008
4238,1950,2288,1581,525400,95010
2451,1191,1260,988,238800,95012
22,0,22,-,-,95013
21266,13012,8254,2394,1143200,95014
282,154,128,1192,631000,95017
3013,2204,809,1230,449000,95018
2074,751,1323,1119,334900,95019
17598,10482,7116,1418,513300,95020
14805,9441,5364,1384,373600,95023
5347,3891,1456,1918,1732700,95030
10013,6737,3276,1817,1131300,95032
3742,3016,726,1569,864800,95033
20871,13382,7489,1864,583800,95035
15819,11371,4448,1665,656300,95037
496,331,165,1224,232200,95039
62,54,8,-,470400,95041
285,173,112,1174,376800,95043
1504,783,721,1224,448600,95045
1876,1403,473,1907,737100,95046
14442,5117,9325,1505,643300,95050
20201,10269,9932,1823,682300,95051
27,27,0,-,646700,95053
8433,3557,4876,2192,685700,95054
18291,8599,9692,1526,693800,95060
14946,7679,7267,1423,582200,95062
432,184,248,1602,362800,95064
3132,2147,985,1987,685900,95065
5797,4270,1527,1735,675800,95066
10943,9347,1596,2728,1645900,95070
4082,2903,1179,1448,627800,95073
125,66,59,1292,466700,95075
22946,11872,11074,1269,390700,95076
6381,2539,3842,1545,449500,95110
15698,8939,6759,1313,364600,95111
19974,5768,14206,1259,459800,95112
696,140,556,1545,645000,95113
14250,5439,8811,1257,368900,95116
10960,3844,7116,1511,671900,95117
11326,7417,3909,1625,650300,95118
3152,2376,776,2013,578800,95119
12486,10984,1502,2454,983800,95120
9657,6900,2757,1853,510400,95121
13090,6342,6748,1464,374100,95122
21783,13804,7979,1852,550500,95123
17272,13024,4248,1656,748700,95124
21074,13549,7525,1515,779000,95125
14199,4904,9295,1459,607200,95126
16813,10509,6304,1613,477700,95127
13946,5792,8154,1459,625300,95128
14080,8064,6016,1784,968400,95129
4999,3062,1937,1425,792000,95130
9177,5817,3360,1866,576300,95131
11906,8718,3188,1781,611500,95132
7928,4597,3331,1426,489500,95133
7736,1976,5760,2345,154900,95134
7462,6353,1109,2120,804700,95135
15054,8911,6143,1799,564100,95136
5772,4725,1047,2162,742100,95138
2251,1810,441,1801,573000,95139
58,49,9,-,"2,000,000+",95140
11917,9282,2635,2079,624900,95148
2923,110,2813,573,133300,95202
5163,1831,3332,851,157600,95203
10940,5988,4952,931,144600,95204
10265,4544,5721,867,106600,95205
16678,8943,7735,1073,138400,95206
17778,7067,10711,862,171400,95207
12653,8306,4347,1248,204500,95209
11564,5074,6490,997,131400,95210
0,0,0,-,-,95211
7280,5605,1675,1505,246800,95212
6729,4047,2682,936,152800,95215
10796,5933,4863,1127,287500,95219
2456,1951,505,1258,389500,95220
2186,1549,637,845,266800,95222
1400,1079,321,1023,318500,95223
122,98,24,-,(X),95224
233,188,45,-,190300,95225
14,0,14,-,-,95226
306,266,40,-,486400,95227
1813,1529,284,1503,226400,95228
236,132,104,(X),368000,95230
809,373,436,950,166200,95231
109,98,11,-,292500,95232
248,193,55,(X),372200,95233
22,0,22,-,-,95234
1352,917,435,674,346300,95236
1146,801,345,1100,204600,95237
15836,7901,7935,916,209700,95240
9894,6639,3255,1167,283400,95242
943,796,147,854,240400,95245
623,524,99,805,318800,95246
2154,1589,565,1214,268500,95247
58,58,0,-,(X),95248
1449,923,526,819,174900,95249
31,31,0,-,-,95250
316,242,74,1021,175000,95251
5012,4235,777,1374,229500,95252
393,393,0,-,282300,95254
804,627,177,812,185100,95255
156,111,45,1401,253900,95257
1442,1009,433,990,303300,95258
11477,6346,5131,884,168200,95301
265,101,164,850,220500,95303
4119,2915,1204,1342,395500,95304
16,0,16,-,-,95305
454,362,92,(X),361800,95306
12252,7370,4882,991,163200,95307
912,655,257,907,235000,95310
880,679,201,779,204400,95311
91,79,12,-,170800,95312
395,155,240,823,350000,95313
0,0,0,-,-,95314
3441,2167,1274,990,140800,95315
2294,1698,596,918,223500,95316
311,106,205,436,185000,95317
167,57,110,1135,405000,95318
463,172,291,725,(X),95319
4394,2955,1439,1063,253400,95320
1592,1121,471,820,265300,95321
2948,1558,1390,819,145700,95322
344,226,118,967,261500,95323
2483,1713,770,1022,204600,95324
28,20,8,-,-,95325
3282,2093,1189,1070,242900,95326
2422,1759,663,780,181200,95327
1203,770,433,965,121300,95328
1176,970,206,1143,206300,95329
5021,3511,1510,1507,208800,95330
885,588,297,750,162300,95333
4148,2391,1757,904,182800,95334
202,76,126,850,271400,95335
14909,8641,6268,1231,220500,95336
10283,6398,3885,1207,268000,95337
4588,3347,1241,881,229300,95338
11740,6119,5621,823,181500,95340
8504,3435,5069,798,116900,95341
223,140,83,624,215700,95345
655,526,129,1041,288500,95346
10747,4704,6043,884,169200,95348
19279,9525,9754,934,161400,95350
13196,5586,7610,913,117400,95351
8596,4032,4564,882,152400,95354
21162,11950,9212,1079,217500,95355
11495,7129,4366,1090,244000,95356
3601,2661,940,1186,225900,95357
8887,5209,3678,1091,165600,95358
3589,1913,1676,1012,146700,95360
11539,7331,4208,969,280800,95361
7171,4564,2607,1277,180800,95363
0,0,0,-,-,95364
1205,595,610,645,101900,95365
5920,4095,1825,1118,338000,95366
7214,4991,2223,1078,198500,95367
3939,2980,959,1312,198600,95368
341,165,176,818,251000,95369
11784,7725,4059,937,274100,95370
714,574,140,1175,209100,95372
509,246,263,910,313200,95374
80,80,0,-,-,95375
15004,8548,6456,1309,247400,95376
8672,6291,2381,1845,345100,95377
1571,1010,561,739,220100,95379
13785,6255,7530,882,171300,95380
12897,7732,5165,1130,253000,95382
1583,1085,498,890,287100,95383
230,122,108,505,(X),95385
2898,1885,1013,918,160600,95386
136,27,109,424,(X),95387
3708,1923,1785,808,129100,95388
342,61,281,361,437500,95389
3669,2730,939,2103,415300,95391
13330,6993,6337,1266,334200,95401
17294,9223,8071,1336,370200,95403
16184,9030,7154,1264,530100,95404
8562,5015,3547,1414,448500,95405
12149,5926,6223,1251,302100,95407
11943,7770,4173,1450,452400,95409
400,252,148,1130,385700,95410
128,71,57,942,490600,95412
494,232,262,838,362900,95415
109,109,0,-,198000,95417
235,145,90,(X),495700,95420
652,459,193,1058,418700,95421
6962,3833,3129,789,86800,95422
1549,996,553,861,160100,95423
3926,2569,1357,1127,353400,95425
628,474,154,909,195100,95426
157,125,32,-,448500,95427
907,662,245,1002,235800,95428
29,29,0,-,387500,95429
0,0,0,-,-,95430
0,0,0,-,-,95431
199,138,61,1255,500000,95432
96,55,41,-,-,95435
2540,1715,825,1324,374300,95436
5851,3180,2671,987,333600,95437
296,150,146,919,537500,95439
671,353,318,1110,686600,95441
1504,983,521,1373,614100,95442
128,57,71,677,"10,000-",95443
231,200,31,1544,384900,95444
963,694,269,898,452600,95445
2199,1293,906,1007,362100,95446
6993,4120,2873,1309,627000,95448
577,283,294,843,396100,95449
149,67,82,970,477300,95450
4758,3340,1418,1152,197300,95451
553,461,92,-,579400,95452
4366,2672,1694,878,187000,95453
960,528,432,422,345000,95454
413,248,165,811,313800,95456
1333,1056,277,1097,144400,95457
1251,586,665,824,85700,95458
242,140,102,1026,368100,95459
1123,794,329,1062,514400,95460
1355,860,495,967,281500,95461
617,349,268,926,325300,95462
29,13,16,-,-,95463
1142,610,532,780,147800,95464
979,701,278,1192,595100,95465
312,155,157,731,589300,95466
2199,1697,502,1513,194000,95467
540,360,180,775,387100,95468
694,370,324,1327,459300,95469
2201,1553,648,1182,322800,95470
231,62,169,1385,(X),95471
12891,8261,4630,1248,631100,95472
15363,9499,5864,1309,502300,95476
11539,5934,5605,955,283400,95482
1065,687,378,1109,163800,95485
24,0,24,-,-,95486
184,100,84,-,618100,95488
5429,3289,2140,970,218100,95490
9994,7359,2635,1585,414500,95492
129,91,38,-,362500,95493
49,19,30,(X),830400,95494
601,518,83,1590,695200,95497
9544,4052,5492,831,243800,95501
9822,6280,3542,957,263700,95503
185,133,52,-,222600,95511
85,85,0,-,269700,95514
7074,4287,2787,981,296200,95519
8214,3146,5068,891,322600,95521
757,579,178,1052,426100,95524
718,451,267,1039,293400,95525
134,94,40,700,250000,95526
249,202,47,764,271400,95527
420,328,92,1082,309100,95528
7950,4751,3199,810,186000,95531
1135,649,486,1020,338200,95536
133,70,63,-,-,95537
4938,2926,2012,882,258700,95540
1004,579,425,956,401000,95542
280,231,49,1141,163500,95543
43,43,0,-,(X),95545
1111,738,373,484,120600,95546
489,348,141,827,340800,95547
452,234,218,756,87700,95548
314,238,76,649,443800,95549
91,12,79,872,(X),95550
671,396,275,1006,237400,95551
310,172,138,688,233800,95552
457,274,183,950,450000,95553
188,154,34,-,381300,95554
168,98,70,660,223700,95555
257,176,81,435,(X),95556
194,143,51,688,355800,95558
95,20,75,-,-,95559
512,224,288,911,331300,95560
1358,787,571,739,207100,95562
302,163,139,809,383800,95563
172,42,130,970,225000,95564
354,87,267,1026,306800,95565
738,488,250,721,214800,95567
40,25,15,(X),270800,95568
139,92,47,(X),264700,95569
1000,748,252,897,381500,95570
94,73,21,-,327000,95571
740,406,334,808,255100,95573
226,144,82,697,292900,95585
87,87,0,-,445000,95587
464,409,55,1181,336700,95589
54,54,0,-,(X),95595
75,43,32,875,159700,95601
6836,4917,1919,1063,381200,95602
11598,7539,4059,1092,323100,95603
32,32,0,-,700000,95604
4939,1862,3077,807,166900,95605
8,0,8,-,-,95606
216,173,43,-,373900,95607
25450,13983,11467,928,311900,95608
17133,8306,8827,986,228100,95610
440,304,136,889,509400,95612
1486,1254,232,1617,305300,95614
260,103,157,713,243400,95615
17057,6265,10792,1200,548000,95616
9643,5343,4300,1403,561800,95618
1856,1392,464,1384,213800,95619
6556,4313,2243,1122,284900,95620
16075,9997,6078,1099,178900,95621
1519,1086,433,1054,292300,95623
19184,14498,4686,1358,290800,95624
56,8,48,(X),-,95625
2057,1492,565,1408,211600,95626
1133,726,407,1113,205100,95627
16254,10770,5484,1115,332000,95628
321,167,154,962,321200,95629
25856,17715,8141,1452,409900,95630
2392,1678,714,1165,265700,95631
9154,6449,2705,1138,233700,95632
1097,953,144,962,264100,95633
1196,888,308,1133,245900,95634
388,326,62,(X),275700,95635
302,302,0,-,207800,95636
189,141,48,-,376600,95637
712,654,58,1396,381900,95638
78,61,17,945,320400,95639
3884,2983,901,1092,233200,95640
828,542,286,794,200000,95641
2724,1921,803,987,257800,95642
780,367,413,820,168300,95645
21,0,21,-,-,95646
18989,14853,4136,1517,351800,95648
4459,3828,631,1345,436500,95650
297,229,68,-,478700,95651
184,0,184,715,-,95652
166,133,33,781,197300,95653
1337,1062,275,(X),270100,95655
2520,2083,437,1191,403300,95658
342,215,127,900,339300,95659
10699,5615,5084,1005,143000,95660
11877,7034,4843,1243,343900,95661
12000,8639,3361,1282,279700,95662
857,785,72,1530,444500,95663
443,339,104,2009,374800,95664
1699,1395,304,1121,243300,95665
2043,1715,328,1146,216600,95666
14400,10641,3759,963,319600,95667
320,219,101,1375,265000,95668
812,635,177,1094,263800,95669
20293,11046,9247,951,226500,95670
1735,1519,216,1864,426200,95672
4847,3652,1195,1145,183800,95673
307,202,105,1099,343300,95674
126,110,16,-,93300,95675
8889,5671,3218,1282,312400,95677
15892,8498,7394,1259,273900,95678
44,18,26,-,-,95679
63,9,54,-,-,95680
426,352,74,1474,274500,95681
10894,7978,2916,1135,380000,95682
2594,2364,230,1694,434500,95683
1381,1097,284,1058,245900,95684
1739,1169,570,1017,358400,95685
357,170,187,683,148800,95686
21702,13124,8578,1424,275300,95687
12779,8265,4514,1293,369000,95688
461,414,47,-,341000,95689
768,423,345,727,370900,95690
13013,7785,5228,991,264800,95691
1596,946,650,883,190100,95692
2334,1967,367,927,421300,95693
3392,2259,1133,954,285100,95694
14252,7772,6480,912,290600,95695
150,41,109,1067,(X),95697
81,53,28,-,367400,95698
64,64,0,-,347900,95699
329,269,60,1643,311200,95701
461,374,87,1030,324200,95703
1807,1439,368,1085,308400,95709
3826,2714,1112,1169,280000,95713
171,127,44,939,271600,95714
53,35,18,338,241700,95715
90,71,19,-,306300,95717
33,23,10,780,192500,95720
13,13,0,-,-,95721
1869,1735,134,1243,377400,95722
0,0,0,-,-,95724
3361,2731,630,1061,230400,95726
230,93,137,437,561000,95728
7,7,0,-,625000,95735
67,0,67,518,-,95736
2909,2412,497,1962,320500,95742
8078,6978,1100,1759,612500,95746
20332,15652,4680,1453,361600,95747
12097,8467,3630,1634,337700,95757
20585,13723,6862,1410,256700,95758
13271,11432,1839,2025,493400,95762
12344,8334,4010,1422,375900,95765
6799,4417,2382,1166,264800,95776
4055,568,3487,798,346200,95811
5179,415,4764,824,290800,95814
8844,2923,5921,912,119900,95815
9855,2645,7210,918,458100,95816
5909,2297,3612,886,224300,95817
9527,4838,4689,835,438200,95818
7745,5316,2429,1320,413300,95819
12419,6451,5968,1032,166500,95820
14367,6165,8202,806,251300,95821
15695,8745,6950,1035,222800,95822
22782,9882,12900,934,154800,95823
8981,3538,5443,891,110500,95824
15274,3705,11569,862,217000,95825
14967,7992,6975,965,211800,95826
7170,4043,3127,1111,179800,95827
17841,10413,7428,1095,161700,95828
7774,5853,1921,1510,295800,95829
275,246,29,1368,395500,95830
18084,10199,7885,1140,337900,95831
2886,1476,1410,1139,163800,95832
14369,6693,7676,1092,183200,95833
9270,3642,5628,1035,237700,95834
13019,7701,5318,1479,273800,95835
153,133,20,-,354800,95837
10722,5393,5329,985,143700,95838
7640,2790,4850,900,168800,95841
11211,5950,5261,985,160100,95842
14205,9175,5030,1326,225300,95843
9368,6947,2421,1277,463900,95864
11428,5746,5682,877,164600,95901
432,3,429,1449,-,95903
38,38,0,-,-,95910
1388,957,431,931,240700,95912
278,258,20,991,183300,95914
10,10,0,-,-,95915
541,393,148,825,171700,95916
1068,630,438,925,162300,95917
934,859,75,(X),361500,95918
607,444,163,853,146800,95919
67,32,35,468,625000,95920
312,228,84,871,164000,95922
5,5,0,-,-,95923
95,52,43,-,-,95925
15013,6526,8487,908,267300,95926
13839,6334,7505,943,298500,95928
47,30,17,-,-,95930
2768,1629,1139,809,211900,95932
157,107,50,675,217400,95934
237,135,102,-,231500,95935
111,78,33,-,214300,95936
443,297,146,675,(X),95937
1513,939,574,986,375100,95938
187,102,85,722,161400,95939
134,95,39,-,(X),95941
476,459,17,-,336900,95942
326,175,151,844,343400,95943
14,0,14,-,-,95944
11300,6686,4614,979,305100,95945
4109,3452,657,1544,325200,95946
749,484,265,856,147200,95947
3717,2235,1482,789,170300,95948
8133,6889,1244,1380,325500,95949
153,57,96,673,114700,95950
721,463,258,715,155100,95951
3002,1945,1057,786,160300,95953
5017,3857,1160,1032,151300,95954
495,283,212,829,165200,95955
172,172,0,-,209500,95956
341,201,140,732,230200,95957
7270,5491,1779,1178,388100,95959
342,231,111,1075,252300,95960
8428,5479,2949,866,164500,95961
646,436,210,747,242900,95962
5230,3443,1787,706,218700,95963
6967,4028,2939,767,156900,95965
11552,8108,3444,905,160900,95966
510,371,139,917,106300,95968
11349,8163,3186,931,203500,95969
183,145,38,906,168500,95970
2526,1733,793,860,205600,95971
13474,7809,5665,914,277700,95973
15,0,15,-,-,95974
702,525,177,1314,280500,95975
604,427,177,1384,242600,95977
36,8,28,-,-,95978
278,221,57,755,154500,95979
45,0,45,-,-,95981
1236,872,364,976,188900,95982
233,202,31,-,144800,95983
31,31,0,-,-,95984
24,24,0,-,-,95986
1797,1118,679,951,165400,95987
3137,1776,1361,747,197900,95988
14376,6884,7492,867,165800,95991
11628,8154,3474,1055,231600,95993
13397,7740,5657,895,251500,96001
12468,7053,5415,924,211500,96002
17716,10368,7348,1013,230800,96003
122,115,7,-,148800,96006
8969,5978,2991,781,175900,96007
393,369,24,864,261000,96008
146,138,8,-,194400,96009
74,63,11,638,259400,96010
72,39,33,568,(X),96011
1718,949,769,602,135100,96013
71,71,0,-,(X),96014
110,74,36,-,153700,96015
222,145,77,(X),235600,96016
79,48,31,775,271400,96017
3859,2308,1551,998,154500,96019
936,638,298,914,173500,96020
5612,3684,1928,763,146400,96021
6332,4975,1357,999,227300,96022
462,303,159,719,103000,96023
425,337,88,941,245200,96024
1034,599,435,854,148400,96025
1046,794,252,842,217200,96027
581,464,117,618,263200,96028
58,42,16,755,336400,96029
54,45,9,-,208300,96031
890,590,300,751,231800,96032
248,181,67,875,79600,96033
142,80,62,1078,206300,96034
1140,805,335,900,164400,96035
66,56,10,-,91300,96037
262,136,126,1083,141700,96038
529,315,214,674,123500,96039
174,93,81,-,(X),96040
1231,835,396,691,269900,96041
420,346,74,841,150900,96044
81,47,34,-,375000,96046
348,245,103,878,207900,96047
283,221,62,803,263600,96048
20,9,11,-,153100,96049
208,151,57,400,195100,96050
552,433,119,765,239500,96051
607,449,158,846,188400,96052
119,103,16,-,153700,96054
1570,1058,512,730,158500,96055
647,530,117,839,187200,96056
611,433,178,832,172200,96057
276,184,92,611,150000,96058
281,197,84,763,255400,96059
13,13,0,-,569400,96061
438,367,71,1221,324300,96062
102,51,51,781,202100,96063
1975,1429,546,796,157700,96064
177,131,46,950,378600,96065
3361,2147,1214,939,246300,96067
44,22,22,-,112500,96068
353,275,78,753,221600,96069
45,45,0,-,130600,96071
1489,1362,127,1750,340800,96073
56,42,14,875,(X),96074
119,88,31,771,(X),96075
45,35,10,-,322500,96076
10772,6786,3986,753,168800,96080
235,185,50,989,164100,96084
30,30,0,-,(X),96085
163,135,28,615,162000,96086
283,254,29,(X),240200,96087
1814,1507,307,988,193100,96088
176,123,53,819,151600,96090
270,228,42,745,317300,96091
160,134,26,838,205000,96092
1587,996,591,1003,252900,96093
2620,1624,996,853,190700,96094
297,244,53,698,256100,96096
4401,2516,1885,783,161900,96097
2334,1701,633,730,129200,96101
743,591,152,875,289100,96103
265,203,62,583,316100,96104
25,25,0,-,641700,96105
116,116,0,-,381800,96106
523,377,146,767,211100,96107
5,5,0,-,-,96108
475,333,142,792,156900,96109
69,36,33,(X),(X),96110
27,27,0,-,201800,96111
89,63,26,225,179200,96112
377,163,214,870,72700,96113
1401,1169,232,1000,215700,96114
63,54,9,-,159200,96115
71,63,8,-,(X),96116
96,53,43,1106,(X),96117
630,482,148,840,110000,96118
51,26,25,-,(X),96119
341,277,64,779,292900,96120
129,129,0,-,269700,96121
1548,982,566,734,182300,96122
13,6,7,-,-,96123
187,121,66,-,(X),96124
127,123,4,-,345300,96125
33,33,0,-,335000,96126
354,279,75,1188,247300,96128
62,51,11,-,-,96129
5378,3215,2163,900,175000,96130
41,20,21,-,(X),96132
90,23,67,-,-,96133
914,476,438,582,126100,96134
15,15,0,-,-,96135
44,44,0,-,257700,96136
1741,1238,503,747,229400,96137
379,279,100,2028,527900,96140
263,195,68,1353,492400,96141
318,163,155,938,440900,96142
1541,629,912,1116,393300,96143
1231,793,438,1327,556200,96145
386,290,96,808,759000,96146
272,156,116,1083,494100,96148
11282,6020,5262,903,353700,96150
0,0,0,-,-,96155
7207,4875,2332,1444,483700,96161
13001,8031,4970,1594,586300,96701
615,466,149,1188,419800,96703
2541,1726,815,1059,413500,96704
721,513,208,1183,387300,96705
18042,11887,6155,2085,462400,96706
12340,8355,3985,2217,486300,96707
3699,2283,1416,1323,640600,96708
127,102,25,-,840000,96710
2584,1463,1121,2030,922600,96712
508,322,186,885,429900,96713
305,212,93,1610,1020800,96714
867,630,237,1122,400000,96716
1379,626,753,1519,560300,96717
595,423,172,1042,364200,96719
16392,10544,5848,936,297800,96720
1041,631,410,1769,784000,96722
1116,602,514,1157,593400,96725
196,118,78,(X),520800,96726
1452,1033,419,1112,365100,96727
196,149,47,-,246900,96728
343,291,52,900,171100,96729
470,283,187,1563,640000,96730
720,483,237,1557,512300,96731
6959,4182,2777,1143,480200,96732
16187,9645,6542,2315,837600,96734
1587,1245,342,914,115000,96737
2439,1859,580,1455,388000,96738
12521,7733,4788,1187,426300,96740
1972,1315,657,1354,547200,96741
54,2,52,856,-,96742
4072,2729,1343,1590,406900,96743
16438,11761,4677,1774,645700,96744
6585,4013,2572,1385,496000,96746
225,0,225,593,-,96747
1574,926,648,737,291700,96748
6113,4403,1710,1063,250600,96749
1231,662,569,856,384400,96750
24,24,0,-,-,96751
1020,648,372,1058,380200,96752
10977,5526,5451,1460,523600,96753
1272,760,512,1690,718800,96754
964,629,335,1139,322000,96755
1993,1100,893,1171,606900,96756
243,139,104,1412,202300,96757
91,0,91,-,-,96759
1072,800,272,888,218600,96760
7491,3835,3656,1387,563900,96761
976,479,497,1372,652100,96762
1197,612,585,880,385700,96763
228,180,48,810,346900,96764
241,188,53,1340,478700,96765
4799,3002,1797,1168,427900,96766
6214,3643,2571,1293,575500,96768
101,0,101,425,-,96769
240,72,168,717,328600,96770
2541,1833,708,763,171700,96771
761,517,244,738,204900,96772
59,59,0,-,505200,96773
79,37,42,-,(X),96774
483,352,131,990,291100,96776
481,311,170,698,177300,96777
5293,3493,1800,1014,182600,96778
944,576,368,1851,618200,96779
242,160,82,629,225000,96780
523,332,191,1065,238100,96781
11530,7828,3702,1747,578400,96782
631,420,211,392,258300,96783
1113,762,351,1083,221100,96785
13428,3333,10095,2110,481100,96786
17974,13161,4813,1879,560400,96789
3420,2325,1095,1371,666200,96790
2305,1351,954,1539,569900,96791
11385,6648,4737,1196,325600,96792
9612,6050,3562,1075,451800,96793
2407,1612,795,1149,496300,96795
624,297,327,1152,375000,96796
19052,11922,7130,1594,508800,96797
9549,4499,5050,1173,575100,96813
9719,3752,5967,1282,458200,96814
14233,5963,8270,1421,458300,96815
17169,10500,6669,1505,796300,96816
19071,7550,11521,1052,609000,96817
18087,6091,11996,2385,462700,96818
11959,5061,6898,1385,629100,96819
6427,5226,1201,2227,937500,96821
18077,8284,9793,1302,657100,96822
10517,8706,1811,2545,757700,96825
14485,4051,10434,1154,372000,96826
0,0,0,-,-,96850
0,0,0,-,-,96853
0,0,0,-,-,96857
0,0,0,-,-,96859
0,0,0,-,-,96860
0,0,0,-,-,96863
52,7,45,730,109400,97001
2136,1826,310,1013,318700,97002
1615,1445,170,942,338900,97004
10454,3500,6954,913,234700,97005
24536,12616,11920,1117,245700,97006
25043,16875,8168,1124,272300,97007
11512,6335,5177,1012,276400,97008
2847,2447,400,919,323300,97009
287,163,124,1519,243200,97011
8217,5549,2668,890,260600,97013
514,341,173,566,162700,97014
7917,4471,3446,1000,276700,97015
2607,2009,598,761,187600,97016
938,823,115,964,291000,97017
913,711,202,971,241400,97018
1255,1060,195,1262,323800,97019
342,310,32,838,171600,97020
439,323,116,872,174100,97021
1112,976,136,839,311800,97022
3732,2800,932,995,304200,97023
4259,2327,1932,972,182000,97024
1196,954,242,895,172700,97026
4886,2923,1963,983,224300,97027
60,60,0,-,348500,97028
120,83,37,925,146900,97029
14481,6491,7990,914,197900,97030
6887,4359,2528,921,329900,97031
1588,1230,358,814,182700,97032
44,32,12,-,170000,97033
8058,6126,1932,1404,577300,97034
10603,6398,4205,1241,422400,97035
436,266,170,729,150500,97037
5688,4120,1568,907,225600,97038
230,128,102,731,137500,97039
444,313,131,956,328900,97040
820,636,184,890,345600,97041
1160,970,190,1220,320000,97042
19419,14335,5084,980,278900,97045
2561,1932,629,730,208000,97048
782,627,155,736,209600,97049
119,64,55,660,116700,97050
5580,3802,1778,789,181000,97051
1236,980,256,1085,295100,97053
622,545,77,918,216600,97054
6588,4826,1762,1161,246100,97055
4560,3209,1351,799,227500,97056
4,4,0,-,-,97057
7610,4792,2818,753,175500,97058
7587,4871,2716,972,224800,97060
11209,6362,4847,1025,326300,97062
525,395,130,769,172500,97063
1268,1045,223,774,183400,97064
291,188,103,644,121400,97065
1104,839,265,832,267600,97067
10875,8227,2648,1280,400000,97068
8970,4227,4743,1053,351400,97070
9118,5597,3521,791,168800,97071
14687,9942,4745,985,238900,97080
9983,6617,3366,1088,369200,97086
4338,3983,355,1313,339600,97089
1248,902,346,971,258300,97101
78,58,20,-,581400,97102
7349,4669,2680,744,234400,97103
1536,1349,187,1035,328100,97106
615,498,117,957,195800,97107
174,141,33,942,201000,97108
200,195,5,-,243400,97109
514,226,288,750,474500,97110
1204,929,275,928,223900,97111
757,595,162,886,245200,97112
4104,3144,960,913,183000,97113
1560,1130,430,1034,216700,97114
1296,1125,171,1095,243800,97115
9002,5414,3588,801,235300,97116
222,209,13,-,349200,97117
350,262,88,969,153900,97118
1612,1254,358,1145,358100,97119
592,296,296,860,240100,97121
198,188,10,-,202100,97122
15094,9997,5097,1038,234200,97123
19491,9869,9622,1167,274300,97124
38,38,0,-,345700,97125
1103,928,175,897,167900,97127
13330,8087,5243,858,202500,97128
202,144,58,958,426700,97130
1080,874,206,876,224500,97131
9921,6551,3370,962,241600,97132
1453,1145,308,1043,288000,97133
139,132,7,-,(X),97134
390,364,26,-,227900,97135
798,577,221,972,198200,97136
426,243,183,697,326300,97137
4292,2375,1917,879,277500,97138
8807,6782,2025,1212,318900,97140
4946,3203,1743,811,217500,97141
46,31,15,-,(X),97144
224,138,86,872,500000,97145
2270,1481,789,945,233400,97146
159,84,75,675,228300,97147
1186,1010,176,1168,306300,97148
253,201,52,-,409500,97149
8564,2672,5892,1150,553900,97201
18011,8723,9288,956,382400,97202
11630,6343,5287,899,231000,97203
404,25,379,574,-,97204
4935,790,4145,839,465200,97205
19632,11964,7668,1039,234700,97206
0,0,0,-,-,97208
10744,2595,8149,998,378400,97209
6369,2608,3761,1030,622100,97210
12575,8292,4283,1173,328700,97211
10451,6888,3563,1119,488700,97212
13600,8275,5325,955,335700,97213
11740,4514,7226,947,415900,97214
7489,4907,2582,954,374600,97215
6212,2630,3582,997,216000,97216
13812,8781,5031,997,279500,97217
5591,3153,2438,815,255100,97218
16628,11464,5164,1051,352500,97219
11291,6111,5180,965,205300,97220
5082,3728,1354,902,460400,97221
15259,8202,7057,954,223300,97222
18580,11277,7303,966,308400,97223
14237,9458,4779,1017,307800,97224
11173,6220,4953,1099,393400,97225
1968,650,1318,1022,373100,97227
23046,16985,6061,1087,416800,97229
15198,8479,6719,878,222700,97230
1649,1423,226,1457,506600,97231
6219,2104,4115,992,466900,97232
12983,5951,7032,875,176800,97233
12637,6863,5774,936,191300,97236
8023,3846,4177,1111,443900,97239
12085,6386,5699,915,184000,97266
12526,8526,4000,1021,263400,97267
17799,7920,9879,734,142400,97301
15617,8973,6644,785,215100,97302
14254,8646,5608,811,194100,97303
11360,7308,4052,859,231000,97304
13648,7194,6454,769,162000,97305
11511,7241,4270,927,222500,97306
7835,5224,2611,905,190400,97317
9908,7463,2445,807,226300,97321
13389,7071,6318,796,163700,97322
472,368,104,771,219700,97324
2487,2033,454,1019,198600,97325
429,379,50,783,273300,97326
1120,855,265,882,193400,97327
56,56,0,-,235200,97329
17021,8566,8455,847,285600,97330
12,12,0,-,-,97331
8808,4193,4615,896,265700,97333
7475,5137,2338,722,199300,97338
1274,881,393,918,259100,97341
95,33,62,909,164800,97342
80,70,10,-,(X),97343
424,349,75,853,142200,97344
178,101,77,810,145100,97345
380,283,97,728,254300,97346
731,449,282,619,158200,97347
631,338,293,670,160200,97348
104,64,40,716,121900,97350
3332,1949,1383,842,153500,97351
2149,1604,545,957,217200,97352
11076,7333,3743,849,159500,97355
92,92,0,-,337500,97357
1004,876,128,700,236400,97358
928,615,313,719,160600,97360
4314,2407,1907,711,213400,97361
1433,828,605,892,202700,97362
344,219,125,1188,455000,97364
4921,2604,2317,836,218800,97365
631,478,153,832,202400,97366
4311,2237,2074,814,218600,97367
1483,1212,271,839,158600,97368
85,85,0,-,305600,97369
3261,2539,722,787,235200,97370
184,179,5,-,367800,97371
0,0,0,-,-,97373
2049,1766,283,778,273100,97374
473,431,42,965,199500,97375
633,501,132,965,238700,97376
229,203,26,-,268800,97377
2448,1620,828,801,163700,97378
1158,912,246,513,167900,97380
5381,3827,1554,807,240200,97381
3422,1859,1563,774,194300,97383
0,0,0,-,-,97384
1405,870,535,851,244500,97385
5159,3482,1677,810,146200,97386
368,278,90,-,352100,97388
622,438,184,976,205300,97389
289,169,120,833,187500,97390
1891,1211,680,839,201100,97391
2182,1749,433,1088,232800,97392
1993,1450,543,839,216700,97394
1112,789,323,811,151000,97396
18783,5731,13052,857,269500,97401
20747,10075,10672,842,172000,97402
3795,1713,2082,971,336500,97403
12879,8778,4101,962,210700,97404
19249,12772,6477,1012,284800,97405
26,26,0,-,(X),97406
5069,3642,1427,992,263700,97408
374,302,72,529,255400,97410
3363,2315,1048,633,217800,97411
186,129,57,1000,240600,97412
443,303,140,700,260300,97413
126,26,100,-,-,97414
6627,4020,2607,843,229800,97415
413,288,125,572,190600,97416
1052,604,448,675,142300,97417
568,453,115,1083,266800,97419
11008,6544,4464,734,168400,97420
2705,1933,772,703,160300,97423
7117,4746,2371,816,180000,97424
3853,3022,831,871,215400,97426
338,242,96,595,206100,97429
181,135,46,689,177700,97430
869,691,178,866,270300,97431
317,262,55,771,174400,97434
923,680,243,671,153800,97435
387,272,115,634,239800,97436
1007,804,203,882,245400,97437
367,308,59,630,257000,97438
7064,4782,2282,791,199900,97439
113,92,21,-,168400,97441
872,656,216,807,178100,97442
762,573,189,545,259000,97443
2276,1668,608,789,202200,97444
1629,1200,429,910,180300,97446
355,208,147,734,88200,97447
4910,3447,1463,859,219500,97448
889,742,147,633,156800,97449
240,217,23,(X),184900,97450
147,118,29,332,276000,97451
663,517,146,935,209100,97452
401,254,147,675,227000,97453
579,489,90,983,217400,97454
1001,853,148,924,278600,97455
1066,742,324,639,252900,97456
3833,2572,1261,809,152100,97457
1928,1354,574,698,144600,97458
5527,3677,1850,727,180000,97459
245,218,27,-,245300,97461
1540,1087,453,738,219300,97462
1730,1363,367,678,142700,97463
1228,853,375,617,174400,97465
371,252,119,558,111300,97466
2253,1448,805,604,154800,97467
1036,742,294,629,152500,97469
8545,5136,3409,720,150800,97470
12187,8538,3649,858,206600,97471
137,119,18,-,169900,97473
57,57,0,-,571900,97476
15523,7407,8116,763,168000,97477
14109,9349,4760,907,190800,97478
3787,2560,1227,827,152700,97479
140,87,53,663,190200,97480
256,209,47,573,206100,97481
114,85,29,761,169400,97484
259,203,56,743,400900,97486
3037,2319,718,926,181900,97487
456,365,91,969,290600,97488
383,332,51,933,351100,97489
120,73,47,-,296900,97490
285,229,56,(X),128400,97492
147,121,26,(X),271100,97493
14,14,0,-,-,97494
611,475,136,859,284800,97495
2700,1766,934,674,147500,97496
669,493,176,664,206500,97497
849,548,301,904,336800,97498
760,529,231,676,152100,97499
16887,9037,7850,807,157800,97501
10710,7564,3146,930,196200,97502
3672,2715,957,984,152500,97503
17922,9820,8102,900,244000,97504
11368,6694,4674,951,347600,97520
221,157,64,800,131300,97522
2685,1782,903,741,172200,97523
5157,3666,1491,928,222800,97524
1903,1565,338,733,204800,97525
14608,9159,5449,757,216600,97526
13871,9447,4424,951,220500,97527
3077,2269,808,885,296400,97530
239,137,102,-,(X),97531
1002,791,211,820,273900,97532
188,93,95,-,181500,97534
2444,1457,987,727,180200,97535
437,311,126,761,169200,97536
3376,2158,1218,753,210100,97537
825,620,205,659,174400,97538
1551,1173,378,989,211000,97539
3480,2217,1263,1022,213200,97540
514,352,162,816,164600,97541
301,256,45,653,256500,97543
907,732,175,586,272900,97544
9305,4860,4445,735,147500,97601
11778,7978,3800,720,151300,97603
16,0,16,-,-,97604
75,41,34,588,126400,97620
64,43,21,-,(X),97621
214,201,13,-,113900,97622
1026,813,213,698,154200,97623
1517,1214,303,703,142900,97624
97,61,36,-,(X),97625
87,79,8,-,262500,97626
351,319,32,-,183500,97627
2199,1261,938,632,165600,97630
479,309,170,695,139800,97632
546,361,185,582,147800,97633
88,88,0,-,136400,97634
155,107,48,661,160900,97635
212,121,91,500,88700,97636
39,28,11,-,120000,97637
237,162,75,521,116300,97638
307,292,15,-,163100,97639
58,37,21,225,112500,97640
544,372,172,388,55400,97641
25948,15568,10380,946,287800,97701
16790,11728,5062,987,281800,97702
2656,1957,699,931,202300,97707
75,43,32,(X),228100,97710
34,25,9,930,(X),97711
9,9,0,-,-,97712
1852,1297,555,564,85400,97720
143,84,59,-,218800,97721
24,12,12,-,(X),97722
140,114,26,900,523800,97730
126,78,48,-,(X),97731
53,36,17,463,170000,97732
198,116,82,-,168500,97733
1011,735,276,775,153800,97734
65,43,22,-,(X),97735
48,18,30,483,325000,97736
248,138,110,831,123200,97737
692,506,186,575,112600,97738
4778,3618,1160,831,156800,97739
4127,2399,1728,742,117000,97741
181,130,51,554,141700,97750
29,25,4,-,(X),97751
32,6,26,-,-,97752
861,746,115,1571,387800,97753
8036,5394,2642,744,155000,97754
13342,8010,5332,905,189300,97756
53,31,22,(X),(X),97758
2489,1739,750,1021,367100,97759
2769,2374,395,889,182800,97760
1015,680,335,513,112000,97761
7963,4656,3307,641,159300,97801
324,273,51,836,194800,97810
333,220,113,734,150900,97812
446,295,151,759,146700,97813
5516,3661,1855,628,144000,97814
16,16,0,-,(X),97817
1253,832,421,669,115700,97818
16,9,7,-,(X),97819
439,353,86,516,129500,97820
481,275,206,719,97700,97823
693,561,132,919,248700,97824
140,109,31,546,126800,97825
366,253,113,725,114700,97826
1014,742,272,643,138900,97827
1309,895,414,685,198900,97828
359,236,123,550,95900,97830
398,219,179,712,173800,97833
402,295,107,614,168900,97834
130,97,33,845,146400,97835
814,555,259,650,154700,97836
32,25,7,-,159400,97837
9042,5690,3352,694,148700,97838
99,80,19,950,88800,97839
66,15,51,270,331800,97840
198,159,39,1065,193800,97841
68,55,13,-,135400,97842
243,187,56,841,156400,97843
1346,964,382,587,116900,97844
1134,745,389,638,151400,97845
941,632,309,572,262500,97846
88,59,29,475,187500,97848
6651,3811,2840,696,157900,97850
162,122,40,575,215400,97856
222,138,84,841,256300,97857
31,31,0,-,-,97859
4321,2918,1403,666,129100,97862
101,70,31,568,161500,97864
540,397,143,529,166900,97865
300,199,101,810,165400,97867
758,504,254,725,113000,97868
405,289,116,809,117200,97869
254,183,71,494,169000,97870
83,79,4,-,66300,97873
143,110,33,538,115000,97874
974,642,332,786,119700,97875
348,309,39,713,297300,97876
148,134,14,813,140300,97877
111,89,22,794,122900,97880
1878,991,887,634,120600,97882
928,675,253,688,126900,97883
68,50,18,-,120000,97884
542,358,184,631,160100,97885
477,379,98,707,110700,97886
247,169,78,704,219600,97901
76,36,40,-,210000,97903
90,63,27,581,202100,97904
85,49,36,-,164600,97905
110,82,28,625,200000,97906
215,136,79,521,79200,97907
29,12,17,933,(X),97908
29,24,5,-,-,97909
227,155,72,625,113100,97910
34,20,14,(X),110000,97911
1802,1126,676,606,107300,97913
5985,3446,2539,600,129100,97914
1624,1014,610,603,136500,97918
104,63,41,-,187000,97920
11109,8669,2440,1375,259600,98001
12687,6406,6281,966,163000,98002
17791,8579,9212,986,213200,98003
15518,6913,8605,1745,782200,98004
7507,4240,3267,1423,580000,98005
13188,10216,2972,1688,621600,98006
10501,3777,6724,1396,407700,98007
9016,6531,2485,1360,479900,98008
1913,1717,196,990,329400,98010
12725,8299,4426,1333,362100,98011
20799,14594,6205,1427,354400,98012
2611,2092,519,1156,424700,98014
4118,3381,737,1433,387000,98019
8728,6290,2438,1223,460200,98020
10399,8457,1942,1517,366000,98021
8533,6071,2462,928,302200,98022
17560,11732,5828,1141,264300,98023
1986,1669,317,1083,558300,98024
14335,10420,3915,1148,353500,98026
10847,7734,3113,1356,487700,98027
8027,5834,2193,1179,403900,98028
10549,7198,3351,1755,443900,98029
11726,5525,6201,1059,243200,98030
12125,7761,4364,1092,263600,98031
13411,5530,7881,998,217900,98032
15592,10080,5512,1594,566800,98033
17282,10583,6699,1374,383000,98034
14258,8871,5387,1067,317100,98036
10204,5803,4401,1136,306600,98037
12012,10196,1816,1509,315600,98038
1087,996,91,"3,500+",1555600,98039
9583,6895,2688,1766,902100,98040
15784,12918,2866,1488,291900,98042
8155,4813,3342,1200,260700,98043
5600,4259,1341,1267,367200,98045
2253,1183,1070,987,198200,98047
33,33,0,-,-,98050
1312,1037,275,1494,359400,98051
24782,13280,11502,1490,496900,98052
7876,6768,1108,1551,566800,98053
8884,4700,4184,1273,252700,98055
13415,6928,6487,1213,355100,98056
5852,1497,4355,1142,266100,98057
15893,11605,4288,1256,304300,98058
13217,10557,2660,1238,369900,98059
4713,3759,954,1693,436200,98065
110,83,27,1425,358200,98068
4757,3649,1108,975,389200,98070
8723,6551,2172,1240,482800,98072
8778,7640,1138,2107,574500,98074
7369,6416,953,1793,647600,98075
4806,4524,282,1980,601800,98077
12175,6266,5909,1271,275900,98087
15241,10680,4561,1169,289800,98092
7911,1361,6550,1118,447600,98101
14390,4121,10269,1300,445800,98102
22936,11035,11901,1240,506100,98103
7277,729,6548,883,357000,98104
15274,5607,9667,1153,622000,98105
10119,4697,5422,1039,284500,98106
12128,4331,7797,1262,475000,98107
8057,4399,3658,918,323700,98108
14006,3954,10052,1447,453100,98109
9475,7183,2292,1138,548100,98110
10382,5774,4608,1297,783000,98112
21079,13189,7890,1348,517800,98115
11541,6466,5075,1200,501300,98116
13813,9643,4170,1388,498600,98117
16043,9056,6987,996,358200,98118
11643,4727,6916,1237,615600,98119
9245,1854,7391,1362,397100,98121
16673,5538,11135,1184,451600,98122
17836,8389,9447,1050,379800,98125
9544,5397,4147,1079,367300,98126
20759,9846,10913,1057,328700,98133
161,44,117,1125,258300,98134
7194,4684,2510,1192,461700,98136
12303,5789,6514,958,423700,98144
9434,5749,3685,1003,295000,98146
4260,1691,2569,988,253000,98148
0,0,0,-,-,98154
13363,9107,4256,1198,349300,98155
0,0,0,-,-,98158
81,67,14,-,535300,98164
8379,5367,3012,972,384100,98166
11522,6012,5510,1012,231900,98168
0,0,0,-,-,98174
7797,6212,1585,1281,495800,98177
8922,5347,3575,1155,277700,98178
9610,4118,5492,938,231000,98188
0,0,0,-,-,98195
13126,7151,5975,1090,251900,98198
9173,5693,3480,1337,629700,98199
12550,5053,7497,852,210300,98201
13335,7857,5478,1094,251200,98203
16380,5115,11265,1022,187900,98204
4494,3696,798,1457,252700,98205
0,0,0,-,-,98207
19747,13056,6691,1192,283500,98208
235,191,44,-,225300,98220
9050,6187,2863,1038,338700,98221
29,29,0,-,541700,98222
14887,11233,3654,1132,258400,98223
153,95,58,646,177700,98224
19376,7981,11395,873,289100,98225
16114,10677,5437,1010,291600,98226
12236,7826,4410,963,287900,98229
6582,4969,1613,942,251700,98230
1624,1347,277,880,365300,98232
5747,3538,2209,977,222700,98233
35,12,23,-,-,98235
2606,1999,607,1038,370300,98236
1640,1166,474,988,161100,98237
5,5,0,-,-,98238
3065,2390,675,910,313100,98239
1087,864,223,1155,244000,98240
854,535,319,811,173400,98241
251,203,48,1643,625000,98243
1229,971,258,719,278800,98244
1892,1211,681,829,454500,98245
3278,2470,808,850,251400,98247
8284,5936,2348,911,264900,98248
2051,1562,489,1029,335300,98249
3535,2523,1012,1036,442000,98250
1796,1454,342,1157,180700,98251
3409,2549,860,1312,209400,98252
913,784,129,858,388900,98253
66,45,21,872,87500,98255
201,137,64,900,168800,98256
1713,1242,471,1244,287200,98257
10847,7981,2866,1277,278600,98258
2499,1984,515,1011,392800,98260
1247,917,330,1069,480200,98261
469,382,87,950,400000,98262
29,19,10,1188,112500,98263
6970,5167,1803,913,271200,98264
1354,921,433,952,130400,98266
257,197,60,(X),183500,98267
16970,11267,5703,1144,236500,98270
10133,7364,2769,1238,223000,98271
8535,6435,2100,1146,275400,98272
10549,6250,4299,827,225800,98273
6401,4826,1575,996,253400,98274
7900,5367,2533,1390,442300,98275
204,181,23,1219,234100,98276
15632,8358,7274,1066,243900,98277
0,0,0,-,-,98278
324,257,67,858,527500,98279
235,220,15,1083,579500,98280
646,531,115,932,239100,98281
6359,5370,989,1303,298200,98282
172,75,97,-,(X),98283
9360,6394,2966,1022,213600,98284
91,67,24,888,633900,98286
82,78,4,-,214300,98288
12296,9560,2736,994,339100,98290
8035,6068,1967,1020,298400,98292
2460,1686,774,1279,186200,98294
869,563,306,956,230500,98295
9641,8232,1409,1572,406800,98296
31,20,11,-,650000,98297
574,513,61,1011,244000,98303
334,211,123,588,119800,98304
154,124,30,-,(X),98305
8659,4404,4255,862,196300,98310
10031,6992,3039,1091,223500,98311
12308,7401,4907,993,208900,98312
17,0,17,-,-,98314
1308,0,1308,1325,-,98315
561,451,110,688,182400,98320
5041,4047,994,1202,254800,98321
232,177,55,1014,167700,98323
734,574,160,579,225000,98325
231,113,118,660,210700,98326
3290,1731,1559,1730,295500,98327
3886,2991,895,826,229000,98328
3883,3256,627,1102,245200,98329
94,51,43,-,-,98330
2477,1583,894,627,122300,98331
6016,4940,1076,1300,378700,98332
1354,1214,140,1090,430800,98333
9576,6978,2598,1202,372000,98335
402,275,127,611,144900,98336
2879,963,1916,765,151200,98337
8983,7594,1389,1177,221800,98338
1340,906,434,781,174300,98339
1249,1135,114,1025,293000,98340
603,456,147,1205,361900,98342
200,149,51,1190,330700,98345
3875,2897,978,1138,287700,98346
1784,1426,358,856,204300,98349
121,66,55,525,64300,98350
313,282,31,-,348500,98351
15,0,15,-,-,98353
2814,1787,1027,1132,224700,98354
309,252,57,-,150000,98355
943,719,224,682,151500,98356
487,325,162,464,101300,98357
478,423,55,1058,404600,98358
1722,1454,268,1309,287000,98359
4239,3491,748,1441,224400,98360
514,401,113,670,144800,98361
10021,6549,3472,740,212400,98362
5494,3845,1649,843,202000,98363
29,0,29,-,-,98364
2048,1727,321,1320,351100,98365
12370,7965,4405,1026,219000,98366
10238,8744,1494,1234,244300,98367
7168,5055,2113,884,298700,98368
11400,8954,2446,1062,312800,98370
8050,5385,2665,1000,257900,98371
9176,5483,3693,1068,257000,98372
8609,4886,3723,1099,236900,98373
13440,9533,3907,1236,244200,98374
9437,7041,2396,1387,213600,98375
738,632,106,783,269300,98376
854,602,252,635,140200,98377
1931,1662,269,1410,277900,98380
216,155,61,705,165800,98381
12475,9408,3067,935,248200,98382
8193,4438,3755,1129,289700,98383
109,99,10,-,170100,98385
14907,10974,3933,1173,188900,98387
2606,1546,1060,1040,283800,98388
4246,2234,2012,926,228100,98390
15711,13152,2559,1327,260200,98391
1237,874,363,996,202000,98392
463,399,64,995,271200,98394
237,192,45,1268,192500,98396
3277,383,2894,884,319200,98402
4299,1556,2743,839,362800,98403
10769,5996,4773,914,158000,98404
9379,4058,5321,832,182900,98405
9265,5664,3601,934,266500,98406
8917,5284,3633,1117,293200,98407
6967,3979,2988,1038,165000,98408
9276,3677,5599,979,155900,98409
0,0,0,-,-,98416
3618,2175,1443,976,159900,98418
0,0,0,-,-,98421
7404,5630,1774,1330,303600,98422
3860,1633,2227,1017,233400,98424
4,4,0,-,-,98430
3914,18,3896,1438,-,98433
0,0,0,-,-,98438
1949,307,1642,1189,17600,98439
2214,1812,402,978,243200,98443
12757,4548,8209,862,165400,98444
10829,7087,3742,1114,187200,98445
3868,2717,1151,1039,254200,98446
0,0,0,-,-,98447
3085,1379,1706,846,265000,98465
11238,5805,5433,991,270400,98466
6117,3042,3075,896,294000,98467
10957,6654,4303,908,225800,98498
12627,4810,7817,826,190100,98499
16602,9999,6603,953,266500,98501
12829,7393,5436,996,299000,98502
14825,7533,7292,998,209300,98503
7974,4881,3093,941,253100,98506
11343,7745,3598,1054,241800,98512
12312,8995,3317,1320,234100,98513
8671,6191,2480,1160,260700,98516
8037,4936,3101,698,139100,98520
1331,1120,211,1013,293400,98524
105,62,43,517,93300,98526
129,120,9,-,286700,98527
3312,2633,679,979,246900,98528
231,138,93,856,119100,98530
9582,5406,4176,848,158800,98531
8738,6223,2515,813,207200,98532
296,270,26,-,188400,98533
244,49,195,781,(X),98535
87,43,44,-,(X),98536
819,631,188,898,178400,98537
89,56,33,805,250000,98538
3775,2657,1118,665,178500,98541
194,125,69,810,235500,98542
0,0,0,-,-,98544
1207,1019,188,968,227700,98546
511,408,103,465,151400,98547
1302,1100,202,(X),149700,98548
4521,2840,1681,668,127300,98550
231,192,39,566,117600,98552
189,156,33,-,306900,98555
1187,844,343,1023,164100,98557
98,57,41,-,-,98558
27,0,27,-,-,98559
72,61,11,-,174400,98560
0,0,0,-,-,98562
3171,2558,613,831,194100,98563
944,788,156,645,183900,98564
211,192,19,-,169300,98565
985,683,302,827,174400,98568
2844,2239,605,1013,166500,98569
1635,1155,480,793,186100,98570
86,86,0,-,(X),98571
290,236,54,582,123900,98572
75,72,3,-,155000,98575
1756,1410,346,995,199000,98576
2637,2002,635,691,129200,98577
4754,3807,947,1224,209300,98579
4042,3217,825,1040,248100,98580
168,148,20,-,103600,98581
266,165,101,789,165600,98582
43,35,8,-,110600,98583
13426,9733,3693,876,192500,98584
340,254,86,-,200000,98585
823,515,308,615,100800,98586
260,183,77,450,89400,98587
811,716,95,869,300000,98588
2864,2182,682,992,218000,98589
210,136,74,600,95000,98590
1497,1157,340,789,184600,98591
629,629,0,-,297400,98592
373,276,97,908,122400,98593
1250,661,589,597,155300,98595
2504,1670,834,850,184700,98596
7928,5609,2319,1156,200600,98597
1023,717,306,959,258100,98601
54,54,0,-,(X),98602
430,363,67,677,241000,98603
11601,9088,2513,989,262500,98604
459,256,203,838,192000,98605
3029,2729,300,905,339600,98606
10236,7873,2363,1231,312300,98607
1141,813,328,692,197300,98610
3916,3128,788,742,196300,98611
1055,801,254,895,204400,98612
155,114,41,1071,181500,98613
145,107,38,-,164100,98614
72,61,11,-,229300,98616
389,327,62,626,150200,98617
180,110,70,725,208300,98619
2820,1826,994,752,158500,98620
198,160,38,-,181500,98621
683,412,271,862,211000,98624
2484,1949,535,910,215200,98625
8918,5806,3112,799,166300,98626
183,100,83,598,101900,98628
2946,2536,410,1330,279500,98629
1668,1075,593,708,162500,98631
20093,11922,8171,736,168200,98632
780,613,167,744,213500,98635
517,426,91,930,182300,98638
512,277,235,733,221200,98639
1953,1618,335,821,164300,98640
0,0,0,-,-,98641
6164,4976,1188,1275,329800,98642
214,188,26,-,165200,98643
132,51,81,897,(X),98644
533,428,105,945,154500,98645
157,127,30,-,164300,98647
1206,745,461,605,250800,98648
362,302,60,783,203300,98649
334,258,76,1071,370000,98650
312,209,103,1156,325700,98651
5212,2228,2984,765,200900,98660
17776,7122,10654,847,192100,98661
11963,7497,4466,1108,195100,98662
5673,3332,2341,897,191800,98663
8748,4974,3774,1011,196700,98664
9686,6001,3685,922,218500,98665
32,27,5,-,202500,98670
8143,6092,2051,999,265300,98671
2260,1589,671,992,322000,98672
199,122,77,663,90000,98673
3855,2794,1061,819,247000,98674
2054,1683,371,1023,253500,98675
18289,12465,5824,1082,192600,98682
12968,7136,5832,1066,248900,98683
9969,5240,4729,1110,210400,98684
10000,7684,2316,1173,264000,98685
7011,5157,1854,1198,270400,98686
14854,9120,5734,803,221800,98801
10633,7976,2657,865,221900,98802
34,27,7,-,124100,98811
1522,930,592,615,174300,98812
932,515,417,636,122400,98813
151,115,36,-,364600,98814
2525,1720,805,758,281900,98815
2595,1771,824,601,340900,98816
152,126,26,-,194200,98817
102,71,31,588,176400,98819
196,154,42,-,330700,98821
817,628,189,808,240500,98822
3982,2517,1465,669,155600,98823
116,50,66,622,113600,98824
2877,2108,769,1002,293000,98826
212,155,57,-,95000,98827
854,693,161,758,237900,98828
241,111,130,(X),(X),98829
234,180,54,275,119200,98830
1302,789,513,595,260500,98831
83,80,3,-,196900,98832
53,53,0,-,447700,98833
80,67,13,-,221900,98834
268,168,100,811,252100,98836
14552,8838,5714,745,172100,98837
1895,1326,569,601,133100,98840
3446,2062,1384,636,166100,98841
567,269,298,800,301900,98843
2094,1423,671,563,159600,98844
77,56,21,763,187500,98845
436,261,175,614,210600,98846
595,480,115,573,224000,98847
3592,2183,1409,739,143900,98848
463,325,138,698,98400,98849
514,356,158,803,133300,98850
1816,1247,569,592,131900,98851
11,5,6,-,(X),98852
2,2,0,-,-,98853
2757,2103,654,607,144300,98855
1160,847,313,585,258400,98856
1193,813,380,632,104000,98857
854,565,289,692,157700,98858
115,63,52,-,(X),98859
109,70,39,738,86500,98860
958,778,180,750,325300,98862
9761,5449,4312,679,146900,98901
16452,8346,8106,763,139700,98902
5104,3812,1292,783,138600,98903
14085,9856,4229,898,203000,98908
238,46,192,998,-,98921
2601,1976,625,838,256900,98922
325,139,186,592,118600,98923
240,168,72,686,411100,98925
12172,6457,5715,773,246700,98926
0,0,0,-,-,98929
4720,3247,1473,753,133600,98930
1293,869,424,786,108300,98932
366,238,128,723,117000,98933
433,217,216,907,149700,98934
909,663,246,824,115400,98935
1897,1459,438,888,183600,98936
1523,1112,411,933,204900,98937
641,409,232,1216,204700,98938
42,28,14,-,(X),98939
242,227,15,-,208600,98940
364,229,135,884,210600,98941
6264,4378,1886,922,203100,98942
414,225,189,1178,167600,98943
5961,3424,2537,660,150000,98944
239,144,95,685,300000,98946
958,670,288,810,189500,98947
3402,2032,1370,728,115000,98948
123,26,97,-,450000,98950
3677,2195,1482,653,114100,98951
528,318,210,624,97800,98952
2099,1500,599,947,184000,98953
1402,726,676,790,148800,99001
1908,1722,186,814,255900,99003
6907,3815,3092,772,190900,99004
2908,2543,365,1221,285800,99005
4168,3557,611,621,198000,99006
253,182,71,543,191400,99008
1389,1039,350,833,220800,99009
731,9,722,1169,-,99011
351,245,106,907,163100,99012
575,384,191,513,171400,99013
4861,3840,1021,921,193500,99016
76,41,35,822,65000,99017
102,64,38,627,155200,99018
3901,2590,1311,957,291500,99019
15,15,0,-,-,99020
3445,2975,470,900,210800,99021
3317,2474,843,629,191800,99022
221,185,36,-,358300,99023
1848,1577,271,763,228800,99025
3729,3251,478,971,238900,99026
2466,2108,358,1050,171500,99027
501,384,117,919,148800,99029
379,262,117,835,168000,99030
435,304,131,621,199000,99031
344,290,54,836,109000,99032
397,236,161,615,126600,99033
38,38,0,-,-,99034
537,458,79,874,313100,99036
4921,3565,1356,772,223300,99037
40,37,3,-,112500,99039
279,203,76,419,70300,99040
563,402,161,704,161800,99101
247,165,82,641,66500,99102
215,160,55,775,120600,99103
20,15,5,-,75000,99105
2290,1531,759,662,154900,99109
502,305,197,630,191800,99110
1768,1099,669,573,170100,99111
313,275,38,945,186300,99113
4996,3537,1459,659,167800,99114
488,356,132,564,168200,99115
684,505,179,674,127100,99116
197,158,39,580,125000,99117
339,233,106,559,199300,99118
456,402,54,902,166500,99119
52,50,2,-,130000,99121
1455,1205,250,543,164200,99122
512,379,133,858,169200,99123
127,96,31,860,110000,99124
220,162,58,444,111700,99125
442,337,105,828,231300,99126
113,82,31,807,191700,99128
330,253,77,458,120600,99129
351,248,103,625,150900,99130
74,70,4,575,207100,99131
805,472,333,609,174100,99133
237,166,71,748,128500,99134
108,64,44,675,137500,99135
19,19,0,-,95000,99136
147,115,32,642,121800,99137
485,311,174,410,92800,99138
541,405,136,628,190800,99139
147,97,50,288,87700,99140
2130,1596,534,675,171400,99141
286,228,58,420,100000,99143
5,5,0,-,-,99144
22,22,0,-,(X),99146
73,66,7,-,242300,99147
926,806,120,713,214200,99148
77,64,13,625,72500,99149
92,83,9,769,(X),99150
61,61,0,-,128500,99151
88,54,34,635,175000,99152
202,110,92,558,169400,99153
15,15,0,-,81700,99154
348,205,143,425,77300,99155
3400,2529,871,838,176600,99156
344,223,121,600,119600,99157
272,198,74,793,116700,99158
600,472,128,738,132000,99159
78,64,14,634,78800,99160
609,470,139,541,158300,99161
11424,3592,7832,712,223400,99163
0,0,0,-,-,99164
1450,961,489,589,166500,99166
256,220,36,791,171900,99167
1041,667,374,647,133100,99169
466,381,85,558,124200,99170
519,301,218,647,125300,99171
590,443,147,730,122900,99173
24,17,7,(X),110400,99174
70,46,24,623,167900,99176
216,174,42,785,218800,99179
428,362,66,575,164200,99180
788,585,203,496,139500,99181
513,400,113,565,130700,99185
6683,1548,5135,569,133600,99201
6735,3027,3708,681,136100,99202
9139,6389,2750,915,233200,99203
3534,1107,2427,600,169000,99204
17610,11608,6002,851,140300,99205
14483,9023,5460,788,178000,99206
11926,5942,5984,798,108200,99207
20001,13295,6706,758,210900,99208
7997,5520,2477,846,146400,99212
10323,5281,5042,800,173100,99216
6997,4644,2353,765,163000,99217
5806,3056,2750,740,211800,99218
12715,8270,4445,825,233100,99223
8389,5567,2822,867,236900,99224
22072,15068,7004,837,168700,99301
3343,2657,686,784,158200,99320
158,88,70,-,-,99321
69,50,19,888,206300,99322
1237,1072,165,675,164400,99323
3642,1993,1649,755,180900,99324
1323,780,543,634,138800,99326
1542,1130,412,724,154300,99328
91,78,13,-,153800,99329
382,220,162,422,182400,99330
15,11,4,-,(X),99333
107,65,42,738,115600,99335
18289,8747,9542,796,151300,99336
10608,8728,1880,922,179900,99337
4451,4075,376,941,270200,99338
254,178,76,840,122200,99341
742,430,312,596,155700,99343
4852,3090,1762,677,142500,99344
71,42,29,367,278600,99345
169,122,47,693,118300,99346
990,700,290,662,139300,99347
446,176,270,605,112900,99348
1777,782,995,640,148100,99349
4497,3049,1448,648,166200,99350
11718,7855,3863,939,233100,99352
5061,4367,694,909,197100,99353
9044,5737,3307,834,181100,99354
93,47,46,585,123600,99356
870,337,533,639,118900,99357
66,43,23,446,107800,99359
405,299,106,772,284500,99360
692,521,171,854,167200,99361
15186,9811,5375,742,204900,99362
28,17,11,-,-,99363
174,138,36,675,80900,99371
117,107,10,-,145800,99401
734,538,196,784,250000,99402
8510,5621,2889,686,169500,99403
7545,2257,5288,995,299100,99501
8688,5596,3092,1215,289200,99502
5866,1828,4038,999,245100,99503
14441,9302,5139,1278,255500,99504
1149,0,1149,2135,-,99505
2158,11,2147,2041,-,99506
14010,9884,4126,1280,276900,99507
12195,6223,5972,1002,255700,99508
0,0,0,-,-,99510
0,0,0,-,-,99513
7615,5512,2103,1325,305600,99515
7000,6418,582,1418,430000,99516
6787,3652,3135,1211,291300,99517
4065,2617,1448,1319,240400,99518
0,0,0,-,-,99519
172,144,28,-,337000,99540
36,21,15,1075,25800,99546
27,17,10,725,107500,99547
30,26,4,-,96000,99548
29,17,12,850,118800,99549
95,84,11,675,116700,99550
128,100,28,725,175000,99551
100,79,21,775,139600,99552
46,26,20,325,112500,99553
159,129,30,(X),106700,99554
57,46,11,413,193800,99555
1078,933,145,836,171500,99556
228,135,93,967,165200,99557
37,29,8,-,(X),99558
2226,1196,1030,1345,217400,99559
88,72,16,575,170000,99561
208,175,33,475,107600,99563
24,13,11,1063,(X),99564
29,26,3,-,250000,99565
64,54,10,400,(X),99566
3291,2495,796,1094,333500,99567
100,93,7,-,211800,99568
16,10,6,-,75000,99569
41,17,24,975,143800,99571
191,153,38,-,359400,99572
256,215,41,764,160700,99573
891,653,238,855,283400,99574
31,19,12,-,153100,99575
833,456,377,1053,241900,99576
9189,6785,2404,1743,328500,99577
98,76,22,450,65000,99578
23,16,7,-,108300,99579
25,19,6,-,137500,99580
196,144,52,600,87700,99581
21,4,17,763,-,99583
82,66,16,413,125000,99585
133,109,24,(X),205000,99586
930,385,545,967,471500,99587
273,206,67,623,159400,99588
61,48,13,-,108300,99589
51,27,24,350,129200,99590
20,13,7,688,95000,99591
59,42,17,675,90000,99602
3871,2661,1210,890,251800,99603
213,170,43,300,88200,99604
24,18,6,-,250000,99605
120,76,44,690,130000,99606
73,61,12,975,158900,99607
106,78,28,475,58600,99609
915,784,131,1146,222800,99610
5819,3989,1830,936,209600,99611
230,130,100,913,126600,99612
142,54,88,1250,193800,99613
152,125,27,525,92500,99614
4289,2517,1772,987,258200,99615
143,102,41,538,75600,99620
162,128,34,706,93300,99621
57,46,11,-,177800,99622
27,22,5,(X),78000,99624
31,19,12,650,255000,99625
83,71,12,(X),173400,99626
152,94,58,925,100000,99627
128,93,35,425,103400,99628
65,54,11,650,(X),99630
163,144,19,-,225600,99631
153,101,52,483,109400,99632
221,135,86,975,197900,99633
98,73,25,460,79400,99634
107,75,32,475,170200,99636
112,80,32,914,175000,99637
20,8,12,950,45000,99638
475,377,98,727,163100,99639
66,46,20,(X),125000,99640
96,75,21,492,66100,99641
85,65,20,692,76200,99643
81,62,19,725,66900,99644
8568,6499,2069,993,235700,99645
8,4,4,-,(X),99647
27,21,6,675,97500,99648
28,24,4,575,212500,99649
117,95,22,375,123400,99650
9,6,3,-,225000,99651
1406,1135,271,1058,193500,99652
45,16,29,725,300000,99653
18070,13442,4628,1132,227800,99654
157,129,28,606,171900,99655
10,10,0,-,(X),99656
79,66,13,-,118800,99657
184,148,36,843,131300,99658
99,46,53,933,(X),99659
161,95,66,942,93800,99660
352,192,160,962,130000,99661
109,72,37,463,100000,99662
221,168,53,519,213000,99663
1635,1001,634,775,165300,99664
18,12,6,-,(X),99665
40,26,14,650,170800,99666
33,33,0,-,75000,99667
29,15,14,950,121900,99668
5408,3986,1422,1080,221200,99669
33,26,7,-,155000,99670
125,77,48,596,118100,99671
1511,1210,301,999,277600,99672
520,394,126,872,167500,99674
615,440,175,935,117500,99676
34,22,12,655,168800,99677
183,114,69,525,118100,99678
82,55,27,475,145800,99679
113,81,32,442,67000,99680
70,47,23,575,(X),99681
74,49,25,575,45000,99682
190,169,21,833,148900,99683
238,154,84,954,142300,99684
813,213,600,1425,338600,99685
1189,800,389,1136,178100,99686
1028,898,130,911,176300,99688
250,136,114,945,166000,99689
51,37,14,613,92500,99690
37,23,14,650,42500,99691
61,0,61,738,-,99692
113,45,68,683,61900,99693
584,459,125,882,177200,99694
0,0,0,-,-,99695
7345,3111,4234,1068,189700,99701
775,9,766,2046,-,99702
1786,0,1786,2099,-,99703
0,0,0,-,-,99704
8373,6050,2323,1420,210100,99705
0,0,0,-,-,99706
12251,7575,4676,1037,234100,99709
4500,3592,908,1190,233300,99712
430,344,86,1118,212000,99714
49,31,18,579,106300,99720
63,41,22,900,115600,99721
53,39,14,-,82500,99722
1329,626,703,1134,165700,99723
28,22,6,675,87500,99724
20,12,8,775,(X),99726
122,65,57,750,89400,99727
95,82,13,1063,154200,99729
36,26,10,-,67500,99730
0,0,0,-,-,99732
45,19,26,623,168800,99733
0,0,0,-,-,99734
44,27,17,900,75000,99736
1438,960,478,1247,237700,99737
48,33,15,-,72500,99738
97,61,36,731,72500,99739
214,150,64,630,86500,99740
202,153,49,1111,113100,99741
163,129,34,533,57400,99742
450,323,127,(X),226800,99743
75,63,12,1125,117700,99744
16,8,8,-,90000,99745
103,72,31,681,111500,99746
49,42,7,900,97100,99747
62,50,12,625,118800,99748
109,75,34,763,111300,99749
125,81,44,788,79000,99750
32,17,15,738,110400,99751
921,431,490,1368,183800,99752
74,47,27,719,82500,99753
36,20,16,475,57500,99754
58,42,16,1300,221400,99755
38,31,7,-,99200,99756
13,9,4,-,97500,99757
81,58,23,508,73300,99758
69,33,36,950,92500,99759
267,198,69,613,98300,99760
90,72,18,1000,120500,99761
1429,693,736,1426,213600,99762
138,83,55,681,104800,99763
84,62,22,(X),97100,99764
81,59,22,538,76300,99765
167,110,57,842,90000,99766
4,4,0,-,-,99767
61,50,11,463,90000,99768
189,147,42,792,51700,99769
165,111,54,608,99300,99770
68,42,26,825,78900,99771
161,108,53,719,78900,99772
69,51,18,675,104700,99773
9,6,3,-,(X),99774
126,0,126,1088,-,99775
48,37,11,625,95000,99776
103,72,31,625,60000,99777
59,31,28,533,62500,99778
572,435,137,765,123600,99780
66,57,9,513,40800,99781
134,88,46,838,93000,99782
57,30,27,571,(X),99783
69,34,35,763,107100,99784
97,50,47,725,95000,99785
81,47,34,850,59000,99786
35,23,12,(X),62500,99788
99,71,28,950,93600,99789
8,8,0,-,-,99790
52,39,13,850,131300,99791
11115,7257,3858,1200,324500,99801
124,64,60,692,205600,99820
999,454,545,1137,305600,99824
39,32,7,-,433300,99825
261,193,68,678,267500,99826
1204,833,371,865,207500,99827
329,182,147,935,162200,99829
194,127,67,869,137500,99830
36,31,5,-,252100,99832
1284,864,420,938,218800,99833
3472,2056,1416,1057,338600,99835
11,11,0,-,98800,99836
406,223,183,1020,324600,99840
75,68,7,-,240900,99841
5267,3096,2171,1033,252500,99901
11,11,0,-,-,99903
85,66,19,792,228100,99918
304,233,71,834,198400,99919
673,488,185,931,210400,99921
109,82,27,475,77400,99922
13,7,6,-,-,99923
325,216,109,596,161700,99925
476,317,159,692,115700,99926
78,78,0,-,170500,99927
1116,734,382,732,172600,99929
