housing_units_occ,homeowner_units_occ,renters_units_occ,med_rent,med_household_price,zip
5611,3902,1709,414,89500,601
12546,9443,3103,465,108200,602
19537,11148,8389,448,141800,603
1871,1438,433,405,100700,606
8838,6415,2423,553,113600,610
611,393,218,471,100300,611
23438,14335,9103,503,112300,612
3471,2424,1047,623,102700,616
8579,6108,2471,625,121400,617
3141,2320,821,609,115400,622
15031,11678,3353,576,118200,623
7301,5023,2278,530,88100,624
11814,9065,2749,574,105500,627
477,295,182,336,102900,631
271,126,145,385,131700,636
7555,5754,1801,445,99200,637
5924,4200,1724,404,94500,638
8947,5510,3437,464,101900,641
12180,9636,2544,688,156900,646
1844,1407,437,433,87500,647
5260,3632,1628,662,104100,650
1583,1217,366,733,128500,652
3749,2569,1180,326,80400,653
6443,4716,1727,435,84900,656
12865,9498,3367,598,130000,659
6000,4347,1653,558,115200,660
13949,8945,5004,555,122300,662
4962,2944,2018,483,105500,664
8247,5871,2376,492,103300,667
10374,6733,3641,496,102700,669
2777,2043,734,355,89600,670
14871,10811,4060,551,115300,674
12974,8324,4650,506,116500,676
5655,4112,1543,626,154600,677
8739,5934,2805,525,109600,678
17584,9475,8109,463,101300,680
12194,5623,6571,448,116800,682
10866,7306,3560,466,100600,683
14525,10248,4277,470,110000,685
10026,7040,2986,572,113800,687
3904,2450,1454,546,99500,688
2138,1248,890,595,139500,690
12539,8561,3978,667,136500,692
20982,15690,5292,600,117900,693
68,68,0,-,-,694
12410,9186,3224,521,99100,698
9057,5974,3083,461,129800,703
2461,1905,556,645,95500,704
9342,6995,2347,505,120700,705
3946,2944,1002,498,106300,707
6364,4885,1479,466,95200,714
804,616,188,671,80000,715
11826,7373,4453,511,119800,716
6638,3252,3386,492,111000,717
8186,5984,2202,525,105700,718
9107,6277,2830,484,105900,719
6613,4621,1992,482,96200,720
6051,4238,1813,515,89000,723
31121,19989,11132,558,139900,725
20559,14642,5917,821,147800,727
13259,9962,3297,517,108500,728
17269,12888,4381,606,117500,729
13366,8946,4420,496,100700,730
3741,2969,772,426,86800,731
4131,3047,1084,522,110400,735
18095,11302,6793,546,142300,736
12136,8429,3707,617,118800,738
12712,8566,4146,547,138400,739
727,358,369,531,103600,740
1377,1093,284,633,95600,741
16657,12130,4527,580,129800,745
7850,6077,1773,449,89600,751
13585,9963,3622,552,115000,754
7379,5755,1624,486,106400,757
2663,1836,827,424,113100,765
7624,6001,1623,519,102900,766
11939,8501,3438,500,96600,767
12928,9831,3097,518,103600,769
12454,9606,2848,493,120700,771
6435,4169,2266,439,99600,772
6738,4675,2063,532,125200,773
428,283,145,548,168200,775
13579,9807,3772,589,116800,777
15185,11737,3448,674,160200,778
4706,4049,657,745,121500,780
5395,3328,2067,490,107800,782
10803,8149,2654,527,118300,783
14748,10487,4261,443,104000,784
73,73,0,-,-,786
17283,12828,4455,526,120000,791
9374,6421,2953,504,119800,794
14801,11433,3368,522,102200,795
3189,1375,1814,646,386900,901
30,30,0,-,-,906
8306,5217,3089,1020,323600,907
2625,1116,1509,719,199100,909
3885,1968,1917,740,384900,911
2841,1468,1373,698,139600,912
3044,510,2534,268,431000,913
10585,4274,6311,517,109600,915
8233,3951,4282,558,124800,917
8070,3830,4240,628,216600,918
7119,3823,3296,753,151000,920
14100,6320,7780,605,147800,921
10540,4712,5828,517,114600,923
20114,10294,9820,537,136800,924
2400,461,1939,581,142900,925
37761,27602,10159,717,189400,926
6161,3321,2840,543,223000,927
20,0,20,-,-,934
26103,18940,7163,724,141900,949
0,0,0,-,-,950
170,57,113,573,87100,951
3384,2209,1175,521,117800,952
23070,18841,4229,752,154600,953
26223,18340,7883,645,134800,956
15700,11591,4109,680,136600,957
18719,12349,6370,666,149700,959
0,0,0,-,-,960
11489,8175,3314,736,165200,961
7760,4278,3482,537,118700,962
2084,1283,801,538,102200,965
7117,5124,1993,1095,286200,966
1903,1415,488,1027,206900,968
16264,11619,4645,963,250900,969
9811,6787,3024,651,161600,971
23850,17539,6311,605,161200,976
8201,5328,2873,990,189100,979
5786,3591,2195,706,139400,982
13006,8561,4445,601,156400,983
12622,8441,4181,554,144900,985
20772,15883,4889,778,151400,987
6813,4964,1849,1305,270300,1001
9715,4729,4986,1561,449000,1002
34,0,34,2667,-,1003
1688,1367,321,1603,328500,1005
6429,5409,1020,1301,350400,1007
585,552,33,954,279500,1008
367,210,157,1305,275800,1009
1479,1292,187,786,379700,1010
446,371,75,1134,280900,1011
164,124,40,895,350000,1012
9549,4914,4635,1005,249300,1013
13578,8110,5468,1153,259100,1020
1069,824,245,1878,169700,1022
443,379,64,1023,283600,1026
8576,5350,3226,1195,348300,1027
5857,5059,798,1229,344100,1028
305,286,19,-,469400,1029
4979,3725,1254,1124,315900,1030
697,364,333,1164,237700,1031
247,219,28,1281,319200,1032
2539,2401,138,-,319600,1033
877,813,64,1804,331300,1034
2293,1703,590,1682,453300,1035
1965,1902,63,-,345200,1036
246,232,14,-,408600,1037
1062,834,228,1458,450200,1038
693,610,83,1513,413800,1039
15524,6451,9073,1016,255300,1040
1019,878,141,1302,282400,1050
791,607,184,1677,345600,1053
714,628,86,1339,444700,1054
8502,6326,2176,1250,303900,1056
3443,2880,563,880,312100,1057
7481,3395,4086,1460,427100,1060
4216,3199,1017,1016,389000,1062
6,0,6,-,-,1063
60,60,0,-,409100,1066
640,573,67,1208,379600,1068
4036,2988,1048,929,251300,1069
247,230,17,1063,271100,1070
536,478,58,950,287000,1071
605,553,52,1500,321400,1072
2464,2207,257,741,426900,1073
231,42,189,1032,-,1074
7246,5573,1673,1264,324800,1075
3810,3096,714,1343,375700,1077
138,96,42,-,283300,1079
1007,590,417,1115,254800,1080
678,616,62,1263,275400,1081
4647,3476,1171,1049,271200,1082
1108,695,413,-,375200,1083
50,44,6,-,328600,1084
15994,10975,5019,1064,296300,1085
325,185,140,1161,383300,1088
12598,7374,5224,1121,307900,1089
584,332,252,875,326000,1092
98,98,0,-,425600,1093
16,16,0,-,433300,1094
5377,4853,524,972,383200,1095
1071,929,142,1393,356800,1096
14,5,9,-,-,1097
496,463,33,592,355000,1098
1550,130,1420,1053,148000,1103
8844,4074,4770,1004,210800,1104
4896,553,4343,976,238400,1105
5888,5333,555,2056,423800,1106
4164,1299,2865,963,215500,1107
10552,4986,5566,1224,219500,1108
9746,4476,5270,1112,203100,1109
5630,4415,1215,1220,243800,1118
5221,4010,1211,1181,222900,1119
1117,1056,61,-,246200,1128
2582,2056,526,1325,239200,1129
0,0,0,-,-,1144
3606,1628,1978,1239,219800,1151
20199,12587,7612,1098,236500,1201
4081,2517,1564,930,199800,1220
232,232,0,-,312700,1222
1201,1146,55,1488,352200,1223
88,77,11,-,275900,1224
1513,1323,190,1309,237000,1225
2831,2139,692,830,289300,1226
87,66,21,-,531300,1229
3652,2737,915,1286,479200,1230
1069,899,170,1015,266200,1235
650,491,159,-,481300,1236
992,952,40,1153,278100,1237
2711,2132,579,1255,332100,1238
2289,1635,654,1060,480800,1240
41,41,0,-,-,1242
86,86,0,-,288100,1243
112,103,9,-,584200,1244
322,307,15,-,602900,1245
6723,3903,2820,786,190600,1247
403,323,80,-,339200,1253
431,412,19,928,555300,1254
335,323,12,1225,331300,1255
366,339,27,731,267200,1256
1062,764,298,1161,432100,1257
85,77,8,-,593800,1258
284,254,30,3114,456400,1259
9,9,0,-,-,1260
662,508,154,777,556000,1262
85,68,17,1071,666700,1264
454,403,51,1471,481600,1266
2724,2002,722,1280,438100,1267
399,387,12,-,350400,1270
8291,4553,3738,1098,253800,1301
834,704,130,957,368400,1330
5425,4055,1370,1041,257300,1331
1078,888,190,997,312300,1337
47,43,4,-,254400,1338
615,534,81,1089,307600,1339
811,672,139,1081,268100,1340
700,633,67,1696,376500,1341
447,297,150,1631,363100,1342
81,61,20,1250,265000,1343
685,525,160,992,241500,1344
232,223,9,-,285200,1346
72,34,38,-,166300,1347
358,254,104,1353,273500,1349
55,43,12,-,147900,1350
998,758,240,1552,308400,1351
658,510,148,1337,323900,1354
399,349,50,1180,357400,1355
1271,1122,149,1189,337200,1360
3099,2086,1013,745,226000,1364
463,420,43,1214,375000,1366
217,192,25,1536,271100,1367
545,494,51,1031,325200,1368
1709,1117,592,1057,334000,1370
2301,1881,420,1351,387500,1373
1788,720,1068,1613,391200,1375
2296,1223,1073,1147,237800,1376
378,338,40,1375,301400,1378
326,275,51,1726,271300,1379
15,15,0,-,129200,1380
16933,9571,7362,1131,294600,1420
2366,2258,108,-,369700,1430
1264,1191,73,969,362200,1431
3510,2471,1039,1373,419800,1432
328,230,98,1286,472100,1434
1280,983,297,1109,308100,1436
119,97,22,-,243300,1438
9021,5159,3862,1071,270500,1440
3659,3278,381,1521,673500,1450
1807,1644,163,1387,849200,1451
1630,1484,146,898,342100,1452
18148,11384,6764,1282,345900,1453
3637,3074,563,1542,633000,1460
4538,3691,847,1784,442900,1462
4322,3593,729,1303,459800,1463
2404,1978,426,1189,412700,1464
1637,1520,117,1308,358700,1468
2659,2242,417,1121,385200,1469
3275,2866,409,1643,394000,1473
777,643,134,2368,427600,1474
3780,2955,825,1245,294900,1475
6822,5465,1357,1241,363400,1501
1447,1155,292,1432,566800,1503
3969,2927,1042,1157,394600,1504
1932,1543,389,1833,578700,1505
1473,1247,226,1043,313200,1506
4977,4136,841,1215,405200,1507
6663,3526,3137,1353,348000,1510
905,742,163,997,342400,1515
3323,2779,544,1537,436700,1516
1247,898,349,1051,410100,1518
2724,2177,547,2266,573200,1519
5946,5071,875,1578,444300,1520
1164,1117,47,1750,288700,1521
1178,984,194,1100,386100,1522
2944,2442,502,1985,467400,1523
2229,2037,192,1055,390800,1524
0,0,0,-,-,1525
5292,3910,1382,1507,415600,1527
1222,1082,140,1275,418000,1529
380,326,54,1094,387200,1531
5715,4881,834,2087,598500,1532
2407,1926,481,1170,451800,1534
1897,1355,542,973,316500,1535
3021,2321,700,-,450500,1536
735,497,238,1223,338000,1537
4145,3466,679,1135,346000,1540
1324,1262,62,921,496400,1541
1046,915,131,1571,380300,1542
3091,2736,355,998,439200,1543
14508,10462,4046,2046,555500,1545
7256,3213,4043,1157,267000,1550
1955,1116,839,1364,442900,1560
0,0,0,-,-,1561
5135,3345,1790,1085,368300,1562
3283,2882,401,1606,467400,1564
2784,2570,214,1677,393000,1566
2878,2590,288,-,558600,1568
5434,4359,1075,1480,417900,1569
7468,4331,3137,1135,339600,1570
4255,3012,1243,1188,372400,1571
8065,4895,3170,2038,637900,1581
2914,2332,582,1248,399700,1583
2171,1750,421,1153,319800,1585
4350,2613,1737,1263,413600,1588
3220,2792,428,1167,526400,1590
9952,5995,3957,1471,380800,1602
8133,3935,4198,1339,287800,1603
16775,7272,9503,1570,321900,1604
11886,3718,8168,1362,349800,1605
8928,6122,2806,1615,343700,1606
3770,1623,2147,1356,341300,1607
2214,100,2114,1461,117100,1608
8230,3277,4953,1212,422100,1609
9259,1507,7752,1339,279100,1610
825,659,166,1040,306400,1611
1633,1474,159,1364,464700,1612
12804,10015,2789,1973,612600,1701
14665,5033,9632,1822,563600,1702
217,209,8,-,359300,1718
2210,1708,502,1816,671800,1719
8821,6652,2169,1908,766500,1720
7573,5721,1852,2334,586000,1721
5862,4148,1714,2430,878200,1730
495,0,495,"3,500+",-,1731
1990,1888,102,1632,722300,1740
1726,1624,102,1409,1055600,1741
6191,4896,1295,2471,1139200,1742
250,218,32,-,647400,1745
5654,4907,747,1651,620500,1746
2171,1667,504,1819,456000,1747
6633,5660,973,2500,726100,1748
8041,5992,2049,1416,480300,1749
16649,9352,7297,1721,485400,1752
4673,3599,1074,1678,494200,1754
2103,1916,187,1947,605500,1756
11410,7801,3609,1702,444100,1757
15358,10362,4996,2061,740700,1760
1512,1351,161,2313,944400,1770
3461,3093,368,2425,816500,1772
2194,1687,507,2162,1169800,1773
2731,2336,395,1829,657900,1775
6327,5707,620,1427,939400,1776
4981,4506,475,1403,935700,1778
16360,9429,6931,2190,641800,1801
9991,7501,2490,2615,679400,1803
13279,10688,2591,2046,813800,1810
11511,9334,2177,2211,581300,1821
9868,8161,1707,2076,590900,1824
12149,9694,2455,1740,466200,1826
1135,1089,46,1500,624300,1827
10542,5996,4546,1602,436400,1830
10306,5989,4317,1612,410300,1832
3151,2645,506,1973,614700,1833
2672,2450,222,1815,571900,1834
5452,4142,1310,1747,431400,1835
3299,76,3223,1174,-,1840
17097,5523,11574,1565,393800,1841
10613,3808,6805,1703,393700,1843
18801,13663,5138,1610,471900,1844
11521,8048,3473,2113,670000,1845
5877,2933,2944,1666,367200,1850
11321,5066,6255,1686,432100,1851
14809,6842,7967,1567,397200,1852
10376,3809,6567,1477,360500,1854
2710,2140,570,1236,531300,1860
4247,2999,1248,1881,503600,1862
3628,3063,565,1698,477900,1863
5856,4910,946,2253,680000,1864
9587,7956,1631,1722,741100,1867
11828,10035,1793,2248,546600,1876
4182,3606,576,1863,533300,1879
11053,7795,3258,1872,670100,1880
8814,7797,1017,2068,689400,1886
7871,6841,1030,2412,646200,1887
8054,6714,1340,2271,1181700,1890
1157,39,1118,1193,343200,1901
19110,7759,11351,1571,456000,1902
7006,5892,1114,1742,515100,1904
9055,4617,4438,1749,443200,1905
10701,7908,2793,1982,589500,1906
6332,4664,1668,2206,690800,1907
1604,1350,254,1790,686000,1908
7545,5157,2388,1573,475400,1913
16568,9847,6721,1684,619600,1915
2902,2742,160,736,874900,1921
1253,1062,191,-,727800,1922
11041,7610,3431,2004,611200,1923
1317,1010,307,1828,828200,1929
13180,8347,4833,1395,587800,1930
0,0,0,-,-,1937
5757,4178,1579,1525,701400,1938
4785,4159,626,2333,891100,1940
2212,1549,663,1872,932000,1944
8232,6821,1411,1769,904700,1945
3316,3065,251,1621,713000,1949
7792,5939,1853,1511,792400,1950
1335,1178,157,1803,808400,1951
4035,3016,1019,1646,450100,1952
22305,14582,7723,1902,566700,1960
347,325,22,-,664500,1965
3263,2257,1006,1827,692500,1966
2428,1987,441,1424,633900,1969
19709,10118,9591,1800,497500,1970
2719,2259,460,1746,688500,1982
2245,2030,215,1003,810400,1983
1315,1126,189,-,841800,1984
1652,1574,78,1809,765800,1985
6289,4937,1352,1788,425900,2019
9677,7308,2369,2237,665500,2021
3109,2588,521,1959,1092500,2025
10297,7484,2813,2058,630400,2026
1912,1854,58,2500,1285800,2030
1588,1316,272,2448,673400,2032
7169,5232,1937,1763,581900,2035
12339,9668,2671,1856,567100,2038
9558,7672,1886,2452,1075100,2043
4575,3711,864,1885,606100,2045
64,64,0,-,695100,2047
8980,6527,2453,1702,571000,2048
10260,8323,1937,1620,622600,2050
4559,3937,622,1652,869400,2052
4573,3997,576,1570,588900,2053
3383,2829,554,1733,570300,2054
3361,3197,164,1791,694300,2056
3643,3333,310,2181,799600,2061
13299,6884,6415,2056,613500,2062
7606,6716,890,1579,789500,2066
6454,5597,857,2269,697900,2067
473,449,24,-,590300,2071
10861,8392,2469,1993,496700,2072
7306,5971,1335,1980,647200,2081
5492,4791,701,2390,985800,2090
4395,3753,642,1046,599500,2093
2008,1075,933,2692,1570400,2108
2066,682,1384,"3,500+",1007200,2109
1225,815,410,3142,1104700,2110
3614,971,2643,1994,953400,2111
4060,623,3437,2498,693900,2113
7992,1820,6172,2933,927900,2114
9899,1450,8449,2033,1015400,2115
11525,4007,7518,2341,1583500,2116
14185,4487,9698,1748,1029100,2118
11764,2886,8878,1252,668900,2119
4564,542,4022,1630,941200,2120
10363,2396,7967,1316,548100,2121
9159,4000,5159,2052,656400,2122
19987,8386,11601,1783,607200,2124
13759,4841,8918,1897,645400,2125
8862,3705,5157,1659,515000,2126
17895,8023,9872,2435,858600,2127
17619,5033,12586,2009,680000,2128
9389,4661,4728,2258,926000,2129
17928,8184,9744,2434,763700,2130
12449,7095,5354,1999,634200,2131
11110,7889,3221,2140,714000,2132
13,13,0,-,-,2133
8267,1089,7178,2269,586700,2134
21072,4582,16490,2179,684000,2135
13570,7250,6320,1772,566300,2136
14239,5821,8418,2799,1088700,2138
16062,5140,10922,2613,1066200,2139
10030,3605,6425,2581,1070200,2140
7233,1976,5257,2752,892600,2141
2168,187,1981,"3,500+",1726900,2142
12132,3780,8352,2424,930200,2143
11217,4266,6951,2654,987000,2144
11946,4098,7848,2377,784900,2145
26319,11070,15249,2066,607500,2148
17262,6304,10958,1988,605200,2149
13522,3949,9573,1861,476500,2150
21528,10777,10751,1964,566200,2151
7918,4399,3519,1909,606900,2152
24586,13038,11548,2483,715500,2155
399,0,399,"3,500+",-,2163
28674,11544,17130,1975,552200,2169
7957,4358,3599,1801,661800,2170
8895,4587,4308,2281,630200,2171
12368,8388,3980,1933,796100,2176
9520,6769,2751,1878,629000,2180
14339,11058,3281,1925,623200,2184
9184,7738,1446,1545,896500,2186
6860,4181,2679,1859,542900,2188
6529,4190,2339,1732,463300,2189
8329,5802,2527,2012,554900,2190
3581,2969,612,1833,492200,2191
825,28,797,3404,-,2199
0,0,0,-,-,2203
0,0,0,-,-,2205
4306,994,3312,"3,500+",1212000,2210
8232,701,7531,2385,683800,2215
23256,11634,11622,1566,414200,2301
12354,8664,3690,1476,395000,2302
1702,1346,356,1648,482800,2322
9354,7023,2331,1975,500600,2324
4,0,4,-,-,2325
4732,4196,536,1759,409800,2330
5980,5383,597,1644,826300,2332
5046,4198,848,1566,474000,2333
2965,2848,117,1494,442800,2338
4904,4243,661,1642,706200,2339
3967,3571,396,1912,498700,2341
4251,3539,712,1522,435300,2343
9796,7546,2250,1692,426800,2346
4191,3415,776,1837,533800,2347
61,61,0,-,309600,2350
6438,4777,1661,1547,516300,2351
4712,3515,1197,1710,621600,2356
0,0,0,-,-,2357
7005,6210,795,2413,550300,2359
25822,20596,5226,1831,494700,2360
5547,4643,904,1157,562000,2364
0,0,0,-,-,2366
1048,990,58,402,499300,2367
12659,8806,3853,2049,464000,2368
6662,5201,1461,1497,452300,2370
4612,3790,822,2080,492000,2375
2876,2410,466,2011,501000,2379
5754,4190,1564,1785,456400,2382
5572,4836,736,2771,1148100,2420
6765,5162,1603,2847,1147700,2421
9594,5038,4556,2779,1218000,2445
14426,5263,9163,2757,1172800,2446
7544,4423,3121,2537,709200,2451
5464,2792,2672,2325,779900,2452
12684,5319,7365,2063,666300,2453
17,17,0,-,-,2457
5053,3146,1907,2313,1116600,2458
6475,5395,1080,2308,1336200,2459
3972,2349,1623,2606,1124300,2460
2544,1972,572,3026,1154500,2461
526,401,125,-,1265400,2462
1395,841,554,2407,899300,2464
4381,3000,1381,2251,1098600,2465
2929,1687,1242,2082,1164900,2466
6728,4595,2133,3067,1249100,2467
2027,1978,49,2875,1809300,2468
16220,7913,8307,2356,737600,2472
12049,7038,5011,2157,887000,2474
7804,4996,2808,1823,882100,2476
10336,6654,3682,2382,1108800,2478
4963,4329,634,3064,1642700,2481
4121,3296,825,2674,1255200,2482
7339,6660,679,2256,1177300,2492
3532,3193,339,2168,1586100,2493
4062,2952,1110,2452,1052400,2494
6172,4775,1397,1474,477200,2532
439,391,48,-,1010500,2534
798,702,96,1771,1805200,2535
8936,8008,928,1473,496500,2536
2404,2195,209,1328,617600,2537
1724,1297,427,1548,347300,2538
1666,1316,350,1717,1171700,2539
4113,2704,1409,1328,756300,2540
256,0,256,1830,-,2542
468,380,88,1206,909100,2543
38,38,0,-,-,2553
4919,3741,1178,2081,1386100,2554
1088,984,104,-,658600,2556
924,621,303,-,1006000,2557
890,762,128,1482,426900,2558
1444,1140,304,671,563500,2559
172,115,57,-,462100,2561
1412,1194,218,1802,575600,2562
4284,3802,482,1764,552900,2563
106,97,9,-,1546900,2564
3095,2085,1010,1172,911300,2568
5035,4010,1025,1427,422500,2571
852,759,93,2146,1183300,2575
1820,1534,286,-,348500,2576
23,23,0,-,-,2584
7134,3565,3569,1629,408800,2601
851,766,85,2461,686300,2630
4720,3729,991,1386,621800,2631
4789,3879,910,2191,542000,2632
2243,1988,255,1005,881400,2633
1637,1451,186,2122,649900,2635
185,185,0,-,860700,2637
1390,1196,194,1689,714000,2638
1785,1284,501,1296,451700,2639
133,133,0,-,1024500,2641
2860,2543,317,1692,668400,2642
0,0,0,-,-,2643
1408,1269,139,1790,459400,2644
4831,4018,813,1809,581200,2645
957,811,146,1964,723600,2646
100,80,20,-,-,2647
3032,2908,124,1533,580700,2648
6853,5703,1150,1808,515800,2649
470,424,46,-,973800,2650
642,515,127,-,844200,2652
3002,2344,658,1181,816700,2653
1641,1525,116,1781,746200,2655
2034,1448,586,1306,769500,2657
548,483,65,1232,650400,2659
3068,2326,742,1513,502500,2660
195,195,0,-,662700,2663
4561,3392,1169,1692,479400,2664
411,367,44,-,670700,2666
1729,1415,314,1200,760000,2667
1042,889,153,-,622100,2668
717,611,106,1493,647400,2670
470,459,11,-,593500,2671
0,0,0,-,-,2672
4112,3270,842,1502,445100,2673
3229,3000,229,1673,544300,2675
1577,1423,154,1674,479000,2702
17767,11748,6019,1446,409400,2703
18,12,6,-,700000,2713
1444,1375,69,1349,479100,2715
1605,1411,194,2122,512900,2717
2499,2221,278,1683,437300,2718
7200,5316,1884,1071,407300,2719
14300,5675,8625,1177,361800,2720
11288,3923,7365,1010,362800,2721
7580,2456,5124,1058,312900,2723
8342,2839,5503,1105,368300,2724
822,810,12,-,389700,2725
6530,5398,1132,1316,389300,2726
1970,1664,306,1452,585500,2738
2974,2346,628,1478,671900,2739
19586,7421,12165,1052,303400,2740
4081,3581,500,1155,407000,2743
5239,1789,3450,1133,344800,2744
10160,6187,3973,1104,339600,2745
7210,1445,5765,1100,324400,2746
7178,5662,1516,1384,460400,2747
4854,3627,1227,1362,482500,2748
12098,8627,3471,1386,458300,2760
4200,2709,1491,1901,461200,2762
757,525,232,1692,556800,2763
1460,1245,215,1444,498100,2764
6558,5541,1017,1986,476900,2766
5931,4543,1388,1671,507500,2767
4643,4213,430,1304,487000,2769
2099,1841,258,1442,542800,2770
5847,4977,870,1808,461600,2771
6741,5839,902,1332,414900,2777
2297,2250,47,-,472100,2779
21340,12764,8576,1257,377800,2780
6735,5661,1074,1313,476000,2790
215,205,10,-,947100,2791
302,173,129,-,271000,2802
1014,822,192,1318,303000,2804
5978,5322,656,1794,591700,2806
393,282,111,1422,936200,2807
970,762,208,1182,331700,2808
8480,5884,2596,1352,447500,2809
432,414,18,-,474600,2812
3481,3024,457,1499,467700,2813
2879,2594,285,1046,376200,2814
67,43,24,-,-,2815
13667,10903,2764,1168,317400,2816
2401,1983,418,1977,500500,2817
8185,6243,1942,1384,564800,2818
2011,1625,386,1128,469600,2822
10,10,0,-,-,2823
110,110,0,-,414100,2824
1952,1800,152,1525,398900,2825
318,248,70,-,266400,2826
833,788,45,2677,379800,2827
2930,2523,407,999,400900,2828
16,16,0,-,-,2829
2705,2132,573,981,381200,2830
1308,1238,70,1723,468600,2831
2024,1607,417,1114,391100,2832
287,185,102,464,272400,2833
2563,2222,341,1932,752300,2835
36,36,0,-,-,2836
1578,1419,159,2523,726200,2837
1451,792,659,1311,327500,2838
634,524,110,1402,321400,2839
10663,5291,5372,1610,669500,2840
12,0,12,-,-,2841
7237,4249,2988,1906,536600,2842
9872,7037,2835,1188,461700,2852
3381,2814,567,1463,387500,2857
124,124,0,-,342900,2858
2273,1785,488,1223,361600,2859
19791,7900,11891,1112,287400,2860
11259,7275,3984,1278,285200,2861
7487,2139,5348,1118,300500,2863
14102,10794,3308,1251,394800,2864
6905,5316,1589,1206,427700,2865
7219,5809,1410,1577,539700,2871
61,61,0,-,293600,2872
89,50,39,-,-,2873
2283,2012,271,1939,635300,2874
128,83,45,-,415300,2875
384,70,314,1694,-,2876
6853,5354,1499,1228,367400,2878
9499,7500,1999,1281,515800,2879
1059,460,599,1368,481000,2881
5536,3827,1709,1661,686000,2882
4962,3022,1940,1253,363900,2885
13121,8588,4533,1300,334400,2886
8740,7022,1718,1218,318100,2888
11443,9097,2346,1216,299900,2889
10002,7464,2538,1249,422600,2891
2023,1908,115,1961,479600,2892
14350,7827,6523,1249,293100,2893
196,196,0,-,341600,2894
17472,6669,10803,1116,267900,2895
4525,3664,861,1282,423500,2896
713,695,18,-,399400,2898
5648,1238,4410,1640,365600,2903
13635,6994,6641,1217,302200,2904
9755,4972,4783,1103,322700,2905
12434,6226,6208,1729,582700,2906
10747,4019,6728,1136,311600,2907
14682,6826,7856,1381,293800,2908
15704,6150,9554,1258,283800,2909
8916,6140,2776,1385,302400,2910
6614,4345,2269,1480,319300,2911
15,0,15,-,-,2912
9211,4991,4220,1165,309600,2914
7359,4679,2680,1482,317600,2915
3787,2751,1036,1267,360400,2916
4883,3827,1056,988,416100,2917
37,0,37,-,-,2918
11295,8182,3113,1259,326100,2919
14657,9163,5494,1271,336900,2920
4758,4029,729,1439,523900,2921
4540,4131,409,1447,491400,3031
1998,1872,126,1960,547900,3032
1853,1759,94,2235,480100,3033
1559,1415,144,1198,395000,3034
1827,1780,47,-,479500,3036
1579,1444,135,1531,389800,3037
13179,9133,4046,1473,381700,3038
3023,2581,442,2019,421400,3042
561,536,25,1385,379200,3043
1779,1636,143,2618,405400,3044
5338,4591,747,1590,360300,3045
1181,1123,58,1000,436500,3046
688,572,116,1174,314500,3047
1410,1083,327,1199,275000,3048
3367,3021,346,1572,622800,3049
9752,8245,1507,1615,407100,3051
3015,2543,472,2152,443600,3052
9482,8176,1306,1837,464100,3053
10378,9237,1141,1819,406200,3054
6441,4149,2292,1569,363500,3055
883,820,63,1206,478500,3057
12359,4808,7551,1539,338700,3060
11657,8060,3597,1864,398100,3062
6546,4142,2404,1820,371700,3063
6345,3788,2557,1439,382000,3064
2092,1881,211,1140,436300,3070
1824,1576,248,896,317900,3071
5005,4408,597,1390,484500,3076
4269,3478,791,1380,342500,3077
12573,9661,2912,1487,438500,3079
629,586,43,1702,334300,3082
509,406,103,1108,362200,3084
1701,1300,401,1389,369900,3086
5454,5208,246,3226,684700,3087
1987,122,1865,1587,418400,3101
14530,5716,8814,1533,309400,3102
15345,7640,7705,1322,313500,3103
14727,8402,6325,1455,364200,3104
5475,4273,1202,1638,371600,3106
4120,3280,840,1834,350000,3109
8033,6700,1333,1913,582000,3110
120,101,19,1021,376800,3215
873,779,94,1257,332100,3216
979,585,394,1129,188600,3217
483,398,85,1302,305200,3218
2963,2453,510,1151,265000,3220
931,832,99,1465,302400,3221
2477,1923,554,1246,256500,3222
1209,1171,38,-,285100,3223
956,884,72,1967,409600,3224
1353,1256,97,1399,308600,3225
413,379,34,-,388100,3226
712,648,64,2000,387000,3227
2112,1839,273,1166,441200,3229
646,599,47,1375,213000,3230
34,31,3,-,-,3231
88,88,0,-,396700,3233
1998,1771,227,1235,298100,3234
3623,2269,1354,1088,244800,3235
1004,943,61,-,317600,3237
37,37,0,-,189900,3238
489,423,66,1232,256400,3240
425,388,37,1550,401800,3241
2176,1374,802,1073,317600,3242
364,328,36,985,243300,3243
2916,2636,280,1112,252900,3244
844,669,175,1746,327400,3245
7112,4472,2640,1180,307800,3246
2957,2692,265,1308,388700,3249
659,500,159,972,312000,3251
3122,2412,710,1230,444500,3253
2311,2093,218,1372,516800,3254
754,670,84,514,440600,3255
920,803,117,1125,363200,3256
1628,1412,216,1569,469000,3257
1039,943,96,1700,360300,3258
138,138,0,-,372100,3259
325,312,13,-,297000,3260
1653,1508,145,1183,356100,3261
468,348,120,1050,305500,3262
1746,1128,618,1185,270600,3263
2196,1272,924,1178,273300,3264
829,681,148,972,264000,3266
570,538,32,1235,312900,3268
1055,883,172,1302,392900,3269
145,145,0,-,277300,3273
4596,3465,1131,1258,309400,3275
3492,2399,1093,1024,245500,3276
1218,920,298,1211,322900,3278
317,262,55,745,239400,3279
453,408,45,1181,288300,3280
3594,3382,212,1418,363100,3281
382,336,46,1238,274200,3282
241,214,27,1034,312300,3284
1206,1005,201,1269,289700,3285
630,528,102,1154,373000,3287
2021,1891,130,2022,419100,3290
0,0,0,-,-,3291
18,14,4,-,450000,3293
13683,7630,6053,1355,344300,3301
6679,4570,2109,1363,274100,3303
2853,2580,273,1465,443700,3304
2254,1980,274,1250,315700,3307
10062,5227,4835,1279,233900,3431
1061,856,205,1057,271400,3440
137,77,60,-,303800,3441
660,449,211,1132,249700,3442
238,238,0,-,299300,3443
603,488,115,1185,381000,3444
279,261,18,1150,210600,3445
2823,2045,778,1581,251200,3446
969,919,50,937,273800,3447
268,251,17,1575,216800,3448
783,670,113,982,423100,3449
412,386,26,-,360300,3450
1691,1340,351,1084,181800,3451
2063,1605,458,1051,244900,3452
930,625,305,1242,251600,3455
334,309,25,1144,283100,3456
279,243,36,1375,350800,3457
3116,1813,1303,1304,368100,3458
1997,1749,248,1143,343800,3461
705,531,174,-,313700,3462
384,366,18,-,291100,3464
784,605,179,1119,233600,3465
556,481,75,-,316200,3466
900,793,107,1179,322700,3467
1900,1395,505,1106,250100,3470
2782,1551,1231,886,249000,3561
3703,2244,1459,804,113500,3570
1069,851,218,1079,268600,3574
0,0,0,-,-,3575
1366,1052,314,783,187400,3576
202,189,13,-,251000,3579
626,521,105,1082,469500,3580
1653,1273,380,786,155700,3581
965,742,223,918,117000,3582
504,445,59,850,308600,3583
1542,1179,363,892,197200,3584
1056,813,243,1161,215400,3585
252,236,16,1208,608600,3586
750,628,122,1003,233600,3588
439,376,63,761,169600,3590
494,454,40,943,253400,3592
176,142,34,1547,300000,3593
383,331,52,1110,229100,3595
193,140,53,-,-,3597
1475,1050,425,885,204600,3598
116,114,2,-,253100,3601
1022,777,245,864,250200,3602
1968,1488,480,1169,181500,3603
0,0,0,-,-,3604
310,292,18,-,214700,3605
107,91,16,1406,231300,3607
1193,796,397,1125,301000,3608
251,185,66,956,188400,3609
429,383,46,1289,219200,3740
1648,1355,293,1108,241000,3741
5002,2900,2102,1078,172700,3743
782,745,37,1521,277400,3745
2139,1772,367,1403,338500,3748
355,316,39,-,797600,3750
228,196,32,-,249400,3751
308,266,42,1667,226000,3752
1289,1289,0,-,351600,3753
2955,1950,1005,2142,744200,3755
196,196,0,-,296000,3765
4559,2383,2176,1860,348000,3766
648,564,84,1310,651400,3768
149,138,11,2150,529100,3770
302,283,19,1075,257100,3771
3066,2101,965,1238,210600,3773
668,584,84,1434,189400,3774
552,429,123,1605,261700,3777
335,251,84,1138,327700,3779
221,221,0,-,-,3780
700,645,55,1712,389800,3781
1047,860,187,1767,377100,3782
1909,841,1068,1547,340500,3784
780,429,351,1075,196200,3785
10899,5793,5106,1783,647500,3801
1517,1350,167,616,331900,3809
902,879,23,-,572900,3810
2971,2792,179,1188,489100,3811
450,414,36,-,345800,3812
1892,1590,302,1363,215200,3813
978,661,317,1350,316200,3814
574,534,40,-,401000,3816
281,161,120,1034,352100,3817
1647,1091,556,941,284200,3818
1720,1640,80,1188,406800,3819
15021,7715,7306,1540,397900,3820
719,578,141,1549,459300,3823
2901,1891,1010,1432,469900,3824
3452,3119,333,1737,349500,3825
1113,785,328,980,485900,3826
1187,1119,68,1516,536500,3827
716,716,0,-,313200,3830
182,157,25,698,348100,3832
9052,6660,2392,1632,456000,3833
2873,2165,708,963,273000,3835
608,568,40,-,369800,3836
694,650,44,-,365700,3837
509,334,175,1409,401100,3838
1645,1085,560,1361,299800,3839
1619,1415,204,1890,595100,3840
2583,2251,332,1368,465800,3841
7544,5714,1830,1679,491600,3842
873,738,135,1724,664900,3844
730,575,155,1473,298800,3845
487,380,107,1858,672500,3846
94,74,20,-,411900,3847
2692,2135,557,1382,442400,3848
465,360,105,1333,359400,3849
111,111,0,-,423900,3850
1563,1305,258,1503,282500,3851
92,92,0,-,330900,3852
325,277,48,1342,518400,3853
439,402,37,3453,1612700,3854
1040,952,88,1361,307400,3855
631,605,26,1885,617600,3856
4313,2259,2054,1648,384900,3857
1802,1623,179,1618,429400,3858
1947,1208,739,1094,328500,3860
1663,1582,81,1061,449300,3861
2057,1841,216,1950,611800,3862
728,663,65,955,252300,3864
3180,2622,558,1595,382100,3865
9815,6064,3751,1217,259200,3867
2362,1907,455,948,258700,3868
1052,824,228,1300,363200,3869
2171,1747,424,1521,927600,3870
216,205,11,-,1504200,3871
1639,1546,93,950,319900,3872
2223,1852,371,1856,402400,3873
3888,2764,1124,1435,435100,3874
407,394,13,-,387000,3875
5350,3330,2020,1410,295200,3878
545,483,62,947,276500,3882
185,96,89,-,338600,3883
1546,1451,95,1706,402400,3884
3019,2774,245,2265,599500,3885
576,467,109,1142,360900,3886
704,673,31,1375,261100,3887
10,0,10,-,-,3890
2727,2079,648,1093,435300,3894
8,8,0,-,-,3897
3497,3036,461,1237,331300,3901
998,761,237,1883,527400,3902
2832,2340,492,1837,465100,3903
4060,2505,1555,1458,415700,3904
880,775,105,1816,485400,3905
2047,1740,307,1019,385600,3906
612,561,51,1736,799200,3907
2820,2165,655,1535,385000,3908
4550,3704,846,1438,589400,3909
0,0,0,-,-,3910
115,61,54,-,706100,3911
1076,1032,44,-,303200,4001
3123,2792,331,784,321100,4002
53,37,16,-,625000,4003
9982,5195,4787,1186,351700,4005
37,37,0,-,1141700,4006
1240,1131,109,-,335000,4008
2287,1932,355,1196,286600,4009
617,536,81,1542,267200,4010
8754,6463,2291,1341,343600,4011
1653,1520,133,1214,285200,4015
300,201,99,2115,509900,4017
38,31,7,-,838500,4019
755,627,128,1194,244300,4020
2312,2159,153,-,506800,4021
507,459,48,1263,237300,4022
180,155,25,-,239400,4024
2444,2278,166,1237,310000,4027
847,727,120,1302,272900,4029
967,835,132,1321,326700,4030
3566,2735,831,1436,445800,4032
1560,1211,349,870,261100,4037
6305,5206,1099,1567,426300,4038
3568,2968,600,1321,333200,4039
1401,1282,119,795,243600,4040
644,535,109,1059,212900,4041
1849,1632,217,1142,306900,4042
5254,4063,1191,1405,460600,4043
3405,2800,605,1250,559900,4046
705,552,153,1051,251800,4047
1170,1090,80,1153,264200,4048
1616,1489,127,1108,264800,4049
133,115,18,2167,461700,4050
556,473,83,1425,265300,4051
2099,1863,236,1412,257300,4055
60,60,0,-,315400,4056
21,21,0,-,-,4057
1025,978,47,-,223500,4061
7842,6675,1167,1189,370900,4062
365,246,119,558,435000,4063
4855,3304,1551,1142,312700,4064
394,258,136,1402,479400,4066
600,528,72,1038,217400,4068
627,570,57,1638,400000,4069
2104,1844,260,1385,368300,4071
8851,6190,2661,1268,370300,4072
7236,4934,2302,1145,259500,4073
9427,7244,2183,1821,502700,4074
1107,1058,49,1284,324100,4076
2110,1739,371,1309,565500,4079
2095,1554,541,1210,249300,4083
2719,2504,215,972,334800,4084
979,841,138,986,275900,4085
4054,3208,846,1191,327700,4086
747,649,98,1214,236200,4087
584,531,53,835,242700,4088
5006,4437,569,1313,445800,4090
322,281,41,-,242800,4091
8930,5739,3191,1373,341800,4092
3501,2638,863,1413,315500,4093
608,596,12,-,289300,4095
3471,2659,812,1709,572700,4096
1502,1313,189,1615,480000,4097
10323,2337,7986,1457,600600,4101
8139,4093,4046,1435,464100,4102
13364,8180,5184,1571,421800,4103
5006,4260,746,2070,669500,4105
12259,7403,4856,1642,403500,4106
3797,3362,435,2191,659600,4107
427,370,57,1484,488400,4108
102,102,0,-,717700,4109
688,583,105,1718,954900,4110
10430,6162,4268,983,254600,4210
254,237,17,800,157800,4216
1546,1318,228,878,276600,4217
515,460,55,1051,188900,4219
1295,1224,71,744,191900,4220
317,261,56,464,198600,4221
1677,1590,87,-,287800,4222
1181,999,182,674,127000,4224
37,37,0,-,147900,4226
5,5,0,-,-,4227
123,108,15,1156,221400,4231
0,0,0,-,-,4234
1765,1537,228,1106,238700,4236
108,100,8,-,241200,4237
431,404,27,-,236900,4238
2024,1728,296,723,162500,4239
15753,7931,7822,954,214200,4240
1930,1392,538,854,225500,4250
2003,1543,460,1030,245800,4252
883,853,30,-,184900,4253
1510,954,556,823,162500,4254
328,226,102,1271,223300,4255
1143,803,340,1160,224100,4256
1108,852,256,843,104000,4257
1164,1092,72,881,275500,4258
1486,1181,305,1192,282300,4259
2122,1874,248,1270,316800,4260
164,149,15,950,167200,4261
815,741,74,632,244800,4263
338,297,41,1350,163900,4265
8,8,0,-,-,4267
2109,1569,540,758,184700,4268
2359,2068,291,1262,194800,4270
0,0,0,-,-,4271
2344,2016,328,1149,280300,4274
274,263,11,-,119100,4275
2686,1726,960,638,119400,4276
2978,2777,201,1029,175200,4280
2097,1380,717,935,192300,4281
2237,2019,218,588,254400,4282
507,443,64,889,327900,4284
210,194,16,-,233900,4285
0,0,0,-,-,4286
1366,1184,182,-,257300,4287
679,552,127,740,184000,4289
648,593,55,723,121400,4290
408,376,32,-,155300,4292
1561,1211,350,495,183000,4294
12056,7658,4398,912,197600,4330
0,0,0,-,-,4341
719,612,107,1304,236700,4342
1438,862,576,928,205700,4344
5117,3999,1118,956,208700,4345
762,553,209,779,157000,4346
1317,754,563,830,266700,4347
1264,1054,210,1061,230400,4348
613,536,77,992,265200,4349
1561,1477,84,1088,236100,4350
1016,831,185,968,284700,4351
715,619,96,925,228300,4352
970,918,52,870,220200,4353
620,585,35,-,266800,4354
980,873,107,-,300900,4355
1510,1090,420,1058,246900,4357
1855,1688,167,1000,234300,4358
160,68,92,-,198500,4359
233,212,21,-,248600,4360
1051,927,124,1194,215600,4363
2583,2221,362,1031,273100,4364
19090,10452,8638,1048,229600,4401
404,314,90,1074,161900,4406
98,84,14,1063,202200,4408
450,396,54,700,179300,4410
616,517,99,1069,190600,4411
4440,2487,1953,984,218100,4412
108,108,0,-,141700,4413
862,766,96,1039,125700,4414
134,93,41,888,82300,4415
2423,1788,635,833,237700,4416
200,189,11,-,92900,4417
652,549,103,773,119900,4418
1262,1077,185,1173,234600,4419
302,246,56,1028,557700,4421
453,421,32,-,222600,4422
500,424,76,540,109800,4424
2168,1497,671,854,145600,4426
1149,938,211,773,123500,4427
1365,1120,245,1140,213700,4428
2249,2126,123,1316,268200,4429
672,522,150,625,73900,4430
17,9,8,-,-,4431
504,483,21,-,145400,4434
445,416,29,850,155300,4435
524,453,71,1223,187500,4438
933,790,143,666,292900,4441
49,49,0,-,217100,4442
1013,761,252,469,158000,4443
3626,3146,480,1019,270900,4444
580,485,95,938,115600,4448
508,472,36,1135,145800,4449
489,374,115,1009,155300,4450
141,135,6,-,61800,4451
333,255,78,783,128600,4453
5,5,0,-,-,4454
331,319,12,563,152200,4455
1135,903,232,1240,244800,4456
2816,2109,707,647,126100,4457
360,303,57,425,84100,4459
540,442,98,766,84500,4460
1273,1075,198,968,183400,4461
2286,1927,359,553,89700,4462
1278,900,378,942,100000,4463
269,222,47,591,182100,4464
3960,2538,1422,980,182200,4468
0,0,0,-,-,4469
245,229,16,-,153400,4471
841,753,88,1221,261400,4472
3478,1709,1769,1146,217800,4473
1597,1400,197,1072,239200,4474
162,129,33,663,93000,4475
528,469,59,1148,261100,4476
248,219,29,-,368800,4478
575,434,141,762,117700,4479
237,233,4,-,191500,4481
90,82,8,-,216700,4485
380,363,17,-,87100,4487
400,349,51,806,186400,4488
164,109,55,1403,229200,4489
135,130,5,-,116700,4490
84,78,6,-,112500,4491
84,84,0,-,68300,4492
834,763,71,719,161300,4493
157,131,26,729,95800,4495
1639,1504,135,661,243300,4496
163,133,30,975,73400,4497
5428,3720,1708,980,306900,4530
301,276,25,1038,327700,4535
885,839,46,-,357000,4537
874,664,210,727,369600,4538
637,593,44,-,338900,4539
28,28,0,-,366700,4541
931,624,307,974,333000,4543
488,317,171,-,466200,4544
580,516,64,1235,265300,4547
435,353,82,1213,417100,4548
352,321,31,-,420100,4551
738,592,146,1091,406300,4553
341,280,61,-,500000,4554
826,678,148,1034,294900,4555
563,485,78,1345,308000,4556
159,148,11,-,428200,4558
911,729,182,946,335400,4562
699,587,112,1418,370800,4563
238,216,22,-,492300,4564
283,181,102,1375,562500,4568
0,0,0,-,-,4570
280,267,13,-,252200,4571
2713,2237,476,-,271700,4572
184,184,0,-,397600,4573
677,628,49,923,186800,4574
124,124,0,-,-,4575
291,278,13,-,416100,4576
1959,1621,338,1190,301700,4578
1231,1164,67,-,249500,4579
6295,4696,1599,983,230900,4605
510,430,80,856,169100,4606
576,480,96,1315,241900,4607
2416,1781,635,1190,451800,4609
199,166,33,829,259500,4611
268,223,45,967,378900,4612
57,48,9,-,-,4613
1323,1065,258,-,332500,4614
374,335,39,1281,314100,4616
317,286,31,1398,359000,4617
1456,987,469,815,111800,4619
478,354,124,398,153200,4622
450,370,80,920,159400,4623
105,89,16,-,371100,4624
28,22,6,1125,400000,4625
232,225,7,1031,151600,4626
826,697,129,1179,266100,4627
236,197,39,1083,126400,4628
557,450,107,864,180800,4630
623,455,168,538,148200,4631
948,723,225,899,235800,4634
9,9,0,-,-,4635
1089,901,188,1158,237900,4640
121,88,33,1297,-,4642
387,301,86,-,147300,4643
41,31,10,-,662500,4645
55,45,10,1550,402900,4646
229,184,45,1106,109500,4648
576,382,194,-,134300,4649
187,175,12,-,334300,4650
767,621,146,540,182500,4652
268,205,63,1642,335000,4653
1318,870,448,721,164200,4654
417,320,97,1109,193300,4655
170,158,12,-,245500,4657
540,450,90,-,213700,4658
512,462,50,1111,474800,4660
212,152,60,1378,606700,4662
516,412,104,881,209300,4664
552,476,76,1060,119600,4666
518,418,100,268,155900,4667
885,649,236,725,116400,4668
76,58,18,-,261100,4669
246,209,37,1375,223000,4671
101,86,15,-,288200,4673
110,80,30,1240,306300,4674
58,58,0,-,528800,4675
545,434,111,930,280200,4676
147,115,32,1679,266100,4677
752,435,317,926,417800,4679
531,475,56,656,160900,4680
518,404,114,775,212500,4681
0,0,0,-,-,4683
872,774,98,864,278000,4684
189,176,13,-,316300,4685
81,60,21,850,101800,4686
246,208,38,1600,173400,4691
239,200,39,805,187000,4693
1027,827,200,824,116600,4694
4140,2956,1184,701,123500,4730
733,517,216,-,120400,4732
166,108,58,-,127200,4733
291,260,31,808,-,4734
248,198,50,725,102300,4735
4182,3244,938,696,125300,4736
0,0,0,-,-,4737
333,284,49,613,167400,4739
593,486,107,507,120200,4740
1435,1109,326,1098,145400,4742
2096,1637,459,822,136300,4743
380,309,71,872,132800,4745
218,169,49,546,85000,4746
575,482,93,836,116400,4747
802,512,290,781,93000,4750
1636,1056,580,580,157800,4756
1096,930,166,613,184600,4757
607,428,179,483,146400,4758
309,268,41,855,123000,4760
185,152,33,647,252000,4761
215,168,47,404,156900,4762
322,238,84,575,114300,4763
18,15,3,-,-,4764
635,532,103,347,120400,4765
135,121,14,-,119900,4766
195,176,19,1045,198100,4768
4046,2317,1729,875,142400,4769
404,352,52,467,175000,4772
305,262,43,-,104800,4773
343,280,63,-,91700,4774
303,273,30,-,100800,4776
190,171,19,-,89700,4777
161,157,4,-,204500,4779
355,323,32,675,109400,4780
249,216,33,932,197900,4781
212,183,29,893,184200,4783
850,579,271,596,94300,4785
770,605,165,476,104900,4786
148,133,15,788,120400,4787
3386,2135,1251,986,234400,4841
2449,1696,753,1125,486300,4843
670,599,71,1122,301500,4847
364,327,37,938,291300,4848
1774,1523,251,1194,316900,4849
39,39,0,-,425000,4851
53,45,8,925,687500,4852
196,161,35,1188,404700,4853
637,506,131,1042,331500,4854
194,194,0,-,359400,4855
1444,1097,347,1175,415100,4856
596,539,57,1063,305200,4858
367,323,44,-,744000,4859
789,698,91,1556,310000,4860
1361,977,384,891,260100,4861
1743,1519,224,1067,236700,4862
552,485,67,1038,435500,4863
1559,1390,169,1058,215500,4864
11255,6530,4725,957,188800,4901
941,719,222,703,207900,4910
800,636,164,871,104500,4911
347,332,15,533,139200,4912
4175,3000,1175,1009,261900,4915
1316,1213,103,868,304600,4917
0,0,0,-,-,4918
922,731,191,827,108900,4920
757,564,193,958,192900,4921
432,388,44,1219,150000,4922
221,214,7,-,202400,4923
883,744,139,994,151500,4924
45,40,5,-,514700,4925
0,0,0,-,-,4926
1403,1241,162,1122,172100,4927
861,765,96,1292,164700,4928
309,251,58,938,134900,4929
2025,1448,577,891,159200,4930
531,449,82,1286,178000,4932
133,102,31,-,225000,4936
2821,2195,626,943,149700,4937
3999,2513,1486,910,169300,4938
373,314,59,909,145800,4939
0,0,0,-,-,4940
663,570,93,860,193400,4941
544,423,121,-,174600,4942
754,626,128,873,143600,4943
16,16,0,-,-,4944
646,582,64,-,149000,4945
815,738,77,864,246900,4947
415,352,63,469,223900,4949
2264,1357,907,892,154300,4950
448,362,86,1065,214600,4951
802,707,95,933,199000,4952
1489,1109,380,884,213400,4953
612,543,69,908,155800,4955
234,217,17,713,118800,4956
1721,1425,296,928,187300,4957
906,806,100,-,149600,4958
420,396,24,-,145800,4961
3216,2655,561,885,228200,4963
69,69,0,-,326900,4964
835,688,147,763,123800,4965
679,570,109,430,156600,4966
1633,1161,472,879,145200,4967
493,452,41,722,188000,4969
726,514,212,698,287100,4970
827,708,119,913,185700,4971
598,551,47,779,259900,4973
1293,838,455,891,242200,4974
36,36,0,-,159400,4975
4552,3104,1448,869,159300,4976
421,381,40,1107,231300,4978
396,360,36,788,179500,4979
1189,1004,185,1375,220900,4981
184,83,101,675,235900,4982
717,657,60,744,169100,4983
234,221,13,1375,177500,4984
80,76,4,-,261500,4985
694,556,138,1087,172500,4986
411,377,34,1322,194100,4987
690,492,198,798,189800,4988
2005,1673,332,1030,217900,4989
0,0,0,-,-,4992
4131,2710,1421,1169,270200,5001
0,0,0,-,-,5009
64,64,0,-,-,5030
18,18,0,-,-,5031
1135,875,260,1287,234500,5032
1326,1058,268,1133,247900,5033
108,40,68,-,219400,5034
362,342,20,1167,186300,5035
489,432,57,1188,316400,5036
402,369,33,1129,338900,5037
561,479,82,1194,229900,5038
413,392,21,-,221400,5039
269,226,43,1362,210000,5040
89,28,61,1111,234400,5041
255,227,28,1156,229800,5042
447,393,54,1154,265300,5043
864,718,146,1125,265200,5045
520,460,60,419,255400,5046
998,905,93,-,327700,5048
64,41,23,961,226800,5050
432,354,78,875,219600,5051
193,140,53,-,360000,5052
113,96,17,-,327600,5053
1227,904,323,1337,568700,5055
143,105,38,1188,341700,5056
108,89,19,-,429700,5058
257,242,15,-,345800,5059
1963,1311,652,944,237800,5060
746,545,201,1570,304600,5061
250,217,33,992,286500,5062
415,313,102,1152,265600,5065
83,66,17,-,450000,5067
1344,988,356,1129,239900,5068
297,278,19,-,250600,5069
191,150,41,1330,407100,5070
68,58,10,-,-,5071
302,276,26,-,425800,5072
27,27,0,-,-,5073
607,553,54,1667,386700,5075
229,210,19,1275,192700,5076
419,350,69,1275,282800,5077
400,323,77,1145,185300,5079
365,244,121,770,266000,5081
83,72,11,-,-,5083
48,48,0,-,564800,5084
254,222,32,941,204500,5086
426,279,147,-,229000,5088
2181,1492,689,997,225100,5089
1519,1139,380,1267,516300,5091
1913,1237,676,1081,187700,5101
59,39,20,-,253600,5141
237,202,35,1375,268400,5142
1992,1628,364,961,248400,5143
280,258,22,1154,295300,5146
691,620,71,1145,369200,5148
1021,745,276,1124,324500,5149
247,247,0,-,153300,5150
587,573,14,959,271600,5151
172,128,44,1192,444400,5152
293,242,51,1150,293100,5153
224,78,146,1150,172700,5154
340,250,90,1060,265200,5155
3776,2457,1319,1013,182100,5156
418,389,29,915,223800,5158
281,261,20,1000,551900,5161
6161,3824,2337,1098,206200,5201
1459,1248,211,1108,276800,5250
564,536,28,1554,463500,5251
184,153,31,1401,208800,5252
291,235,56,822,378800,5253
169,132,37,-,481300,5254
1582,1276,306,695,393800,5255
843,651,192,1155,293400,5257
152,152,0,-,205900,5260
889,816,73,-,231500,5261
733,684,49,742,245700,5262
7590,4896,2694,1057,265200,5301
304,258,46,890,382100,5340
289,189,100,633,297900,5341
163,156,7,-,278900,5342
462,410,52,1083,289000,5343
0,0,0,-,-,5344
765,606,159,1485,253300,5345
2064,1697,367,851,289000,5346
370,291,79,704,199500,5350
107,101,6,-,262500,5351
360,346,14,1208,279300,5352
526,425,101,1181,257900,5353
947,690,257,1043,260900,5354
303,293,10,1250,278800,5355
344,293,51,-,325700,5356
145,120,25,797,240600,5358
286,233,53,1175,292600,5359
117,84,33,1375,266700,5360
344,294,50,-,243800,5361
92,83,9,-,328400,5362
1050,756,294,1053,285000,5363
13361,3846,9515,1614,463300,5401
9285,5568,3717,1755,399100,5403
3841,1467,2374,1635,350700,5404
8,8,0,-,-,5405
4344,3205,1139,1573,369400,5408
0,0,0,-,-,5439
816,732,84,1400,239800,5440
221,221,0,-,242400,5441
197,174,23,1688,234400,5442
2793,2329,464,1280,335500,5443
692,605,87,1160,342800,5444
1754,1656,98,1520,659800,5445
6837,4937,1900,1323,357100,5446
56,31,25,-,156300,5447
391,363,28,1208,247300,5448
2049,1650,399,974,252800,5450
9649,6650,2999,1463,404200,5452
1988,1615,373,1054,361000,5454
462,422,40,-,322400,5455
392,346,46,1569,419400,5456
693,572,121,871,245100,5457
879,789,90,1395,381000,5458
789,609,180,-,266900,5459
2177,1860,317,1588,450900,5461
798,685,113,993,313500,5462
247,226,21,1042,251500,5463
1171,801,370,1091,326100,5464
2266,2092,174,1721,460700,5465
4923,4288,635,1537,340800,5468
398,305,93,-,279500,5471
817,666,151,1190,345100,5472
632,544,88,1682,380000,5473
529,518,11,1656,404100,5474
1222,895,327,1172,190300,5476
1918,1494,424,1188,403800,5477
6449,4462,1987,1255,297900,5478
0,0,0,-,-,5481
3341,2483,858,1244,515800,5482
662,587,75,1750,244400,5483
0,0,0,-,-,5485
607,533,74,1717,508200,5486
595,542,53,1255,240900,5487
2924,2281,643,1186,267200,5488
1381,1127,254,954,406800,5489
2364,1865,499,1157,306000,5491
345,294,51,968,249400,5492
672,606,66,1923,367900,5494
4687,3578,1109,1752,431600,5495
5595,3754,1841,1184,341700,5602
99,88,11,-,313000,5640
7729,5424,2305,1024,241700,5641
447,391,56,960,240100,5647
228,193,35,1156,373100,5648
160,112,48,-,183300,5649
351,310,41,1500,325600,5650
609,538,71,1027,324300,5651
298,224,74,1430,178100,5652
253,210,43,813,215700,5653
484,301,183,1103,205800,5654
1246,1054,192,1083,195500,5655
1349,916,433,964,189100,5656
571,487,84,1403,221800,5658
769,654,115,1213,409900,5660
3001,1957,1044,1176,268400,5661
2315,1703,612,988,260700,5663
0,0,0,-,-,5664
9,9,0,-,-,5666
974,745,229,1184,285300,5667
298,264,34,636,248100,5669
38,0,38,-,-,5670
2462,1811,651,1349,599100,5672
1100,882,218,1341,434200,5673
728,614,114,1545,486500,5674
454,432,22,972,201700,5675
2152,1427,725,1083,347000,5676
833,769,64,-,474000,5677
58,25,33,-,-,5678
1257,1072,185,1685,233200,5679
844,693,151,988,233800,5680
55,50,5,-,228900,5681
505,441,64,1089,254200,5682
9257,5377,3880,963,202800,5701
208,180,28,-,334500,5730
18,10,8,-,-,5731
594,377,217,734,238500,5732
2456,2051,405,1020,240400,5733
562,449,113,1148,326600,5734
1237,1048,189,1310,226800,5735
227,124,103,986,193500,5736
277,256,21,988,268500,5737
443,405,38,1328,297800,5738
565,501,64,950,260800,5739
255,237,18,-,276100,5742
1658,1307,351,968,176400,5743
237,126,111,942,146600,5744
0,0,0,-,-,5746
159,145,14,900,203600,5747
214,126,88,940,186600,5748
378,287,91,1125,477500,5751
3619,2581,1038,1199,383100,5753
302,270,32,1208,240200,5757
296,256,40,1636,231300,5758
825,666,159,971,215700,5759
416,379,37,1089,293200,5760
464,403,61,1307,312100,5761
190,151,39,997,251400,5762
1286,1118,168,905,219000,5763
1177,853,324,859,208700,5764
692,573,119,997,199300,5765
201,177,24,-,329700,5766
736,639,97,914,230100,5767
14,3,11,-,-,5768
508,454,54,1458,347800,5769
493,394,99,1065,291100,5770
415,367,48,1025,262100,5772
859,685,174,883,257900,5773
430,366,64,1272,210000,5774
226,192,34,981,171600,5775
141,125,16,-,267100,5776
1401,1118,283,1085,193400,5777
376,277,99,1201,272300,5778
3976,2585,1391,902,190200,5819
130,128,2,-,200000,5820
402,339,63,1103,249500,5821
866,703,163,794,206900,5822
544,454,90,983,169400,5824
42,30,12,-,222700,5825
321,277,44,1240,246100,5826
210,166,44,1093,327600,5827
896,756,140,-,278700,5828
812,612,200,1096,213800,5829
712,584,128,1104,195100,5830
397,365,32,-,290700,5832
18,14,4,-,-,5833
557,534,23,-,203700,5836
151,138,13,1694,144200,5837
239,211,28,836,233000,5839
18,18,0,-,120000,5840
160,134,26,825,414300,5841
236,195,41,1073,214400,5842
1072,791,281,694,181100,5843
571,519,52,906,231400,5845
554,344,210,798,164100,5846
397,370,27,936,179200,5847
75,75,0,-,403800,5850
2527,2106,421,1123,219300,5851
331,275,56,1120,259800,5853
3262,2272,990,866,194200,5855
603,486,117,925,247500,5857
134,121,13,-,143800,5858
892,790,102,800,216000,5859
1156,871,285,748,187000,5860
189,162,27,-,253800,5862
294,248,46,1104,158500,5866
276,228,48,1406,204700,5867
35,35,0,-,179200,5868
565,510,55,850,238700,5871
392,358,34,1339,185000,5872
365,285,80,-,244900,5873
246,230,16,883,283300,5874
213,213,0,-,251000,5875
5,5,0,-,-,5901
48,41,7,-,104200,5902
352,315,37,733,165100,5903
92,63,29,-,127800,5904
458,420,38,775,242900,5905
526,453,73,1000,155500,5906
53,53,0,-,183900,5907
7759,6430,1329,1774,456900,6001
8992,6338,2654,1681,269000,6002
24745,15994,8751,1307,252300,6010
3252,3017,235,1235,393900,6013
2921,2106,815,1630,301400,6016
1075,634,441,1270,256800,6018
4106,3507,599,1397,395700,6019
0,0,0,-,-,6020
601,555,46,1281,332400,6021
15,15,0,-,-,6022
659,550,109,1395,369500,6023
222,222,0,-,208600,6024
1919,1566,353,1181,354400,6026
573,533,40,1292,336300,6027
6302,4468,1834,1681,352300,6029
590,485,105,1802,465100,6031
7866,5792,2074,1828,419200,6032
11981,9660,2321,1656,399500,6033
3149,2828,321,1375,339000,6035
7672,6264,1408,1429,345600,6037
732,429,303,1354,656500,6039
14692,7946,6746,1361,238900,6040
10359,5830,4529,1724,219200,6042
1951,1722,229,1112,348700,6043
12156,3912,8244,1100,198300,6051
3406,2337,1069,1232,243900,6052
13772,6547,7225,1288,201800,6053
2405,2145,260,1184,350900,6057
763,575,188,1207,379900,6058
97,97,0,-,474400,6059
848,848,0,-,401800,6060
247,140,107,-,183600,6061
8117,5480,2637,1090,247600,6062
1207,1085,122,1228,355500,6063
246,246,0,-,345500,6065
13497,7355,6142,1412,255000,6066
8918,6048,2870,1705,329500,6067
745,539,206,1868,821100,6068
1379,988,391,1813,434000,6069
5754,4458,1296,1967,414400,6070
3480,3114,366,1069,379300,6071
0,0,0,-,-,6072
2186,2020,166,1369,528600,6073
9720,8203,1517,1679,354500,6074
4868,3849,1019,1122,246600,6076
3946,3328,618,1425,415400,6078
0,0,0,-,-,6079
0,0,0,-,-,6080
652,401,251,1213,270300,6081
16862,12844,4018,1481,239800,6082
5225,4753,472,1459,332300,6084
2842,2271,571,1269,395400,6085
2219,1672,547,1319,192100,6088
1592,765,827,2248,407300,6089
376,359,17,-,429200,6090
88,70,18,-,300000,6091
1288,1240,48,1750,469200,6092
1380,1316,64,796,372900,6093
11360,9299,2061,1587,283800,6095
5354,4277,1077,1290,236800,6096
4983,3248,1735,1189,238700,6098
2042,83,1959,1677,319000,6103
9998,1818,8180,1100,365400,6105
14849,3616,11233,1237,201600,6106
8067,6586,1481,1839,455700,6107
9497,4136,5361,1161,218800,6108
11333,9294,2039,1303,300500,6109
5266,3255,2011,1542,269300,6110
12754,9960,2794,1487,279900,6111
7587,3051,4536,1229,203300,6112
9847,3546,6301,1296,228300,6114
5901,4748,1153,1902,437000,6117
11022,7961,3061,1259,213200,6118
6813,2988,3825,1646,361700,6119
4983,732,4251,1183,183000,6120
7186,2503,4683,1084,181100,6226
1359,1257,102,1553,377400,6231
1173,1102,71,1165,375200,6232
2924,2305,619,1149,275400,6234
876,737,139,1136,243500,6235
2122,1775,347,869,321500,6237
4881,4399,482,1350,318000,6238
4727,3142,1585,1133,261000,6239
2571,1967,604,938,272200,6241
480,399,81,907,310000,6242
25,25,0,-,-,6243
927,845,82,1262,283300,6247
2093,1812,281,1737,359900,6248
2821,2356,465,1449,337700,6249
1862,1454,408,1724,286500,6250
725,621,104,700,288200,6254
1972,1479,493,877,298100,6255
807,712,95,-,181500,6256
0,0,0,-,-,6258
1735,1393,342,1321,389500,6259
4122,2450,1672,1124,257800,6260
410,359,51,-,213200,6262
98,17,81,-,-,6263
82,44,38,-,292300,6264
143,100,43,-,225000,6266
3435,1557,1878,1442,328600,6268
111,30,81,2337,-,6269
1607,1422,185,1802,274500,6277
1871,1521,350,1230,315700,6278
2589,1628,961,1151,287800,6279
1514,1013,501,1717,238200,6280
3035,2512,523,1155,396300,6281
552,448,104,-,333300,6282
11583,4634,6949,1304,234800,6320
1178,803,375,1262,266200,6330
2236,1952,284,816,294800,6331
479,260,219,1215,231900,6332
2816,2148,668,1722,432600,6333
929,789,140,1371,293800,6334
2078,1731,347,1893,296800,6335
9,9,0,-,425000,6336
17,17,0,-,-,6338
3421,3014,407,1242,284400,6339
12946,5469,7477,1492,275500,6340
38,33,5,-,238300,6350
6527,5250,1277,1115,276200,6351
145,60,85,1253,-,6353
2279,1713,566,1208,290100,6354
5393,4436,957,1722,416600,6355
5078,3909,1169,1476,369600,6357
2051,1889,162,1224,374800,6359
15717,8711,7006,1207,233500,6360
1885,1740,145,1628,343200,6365
2663,2435,228,964,304500,6370
3994,3533,461,1891,468200,6371
54,45,9,-,239300,6373
3193,2432,761,1279,234900,6374
1395,1184,211,998,294600,6375
29,29,0,-,887500,6376
1001,803,198,1565,256600,6377
2609,1977,632,1720,576200,6378
3915,2665,1250,1183,364700,6379
1104,372,732,1177,187000,6380
3769,2946,823,1228,250100,6382
1188,979,209,1170,333700,6384
6671,5317,1354,1593,334900,6385
90,30,60,-,205600,6387
19,19,0,-,-,6389
17,3,14,-,-,6390
7496,4409,3087,1405,268400,6401
2651,2211,440,1886,323900,6403
13103,8759,4344,1529,388300,6405
379,327,52,1448,366800,6409
10044,8789,1255,1288,419200,6410
1585,1147,438,1367,404000,6412
5439,4576,863,1346,357000,6413
120,120,0,-,329400,6414
6381,5032,1349,1398,340700,6415
5868,4711,1157,1536,311300,6416
2057,1412,645,1219,349300,6417
5734,3551,2183,1453,243500,6418
2425,2414,11,-,388500,6419
1720,1509,211,1495,369800,6420
3038,2788,250,1520,405100,6422
2102,1992,110,1611,374300,6423
4927,4210,717,1338,322700,6424
1621,1307,314,1860,719500,6426
8770,7448,1322,1754,491300,6437
1022,842,180,1579,376500,6438
36,36,0,-,589300,6439
2076,1914,162,1369,379700,6441
1041,724,317,1419,450600,6442
6879,6230,649,2046,534800,6443
102,102,0,-,251600,6444
2151,1940,211,1282,373000,6447
14635,9148,5487,1267,220400,6450
10074,5650,4424,1207,223400,6451
1094,1027,67,1110,392500,6455
155,129,26,-,428800,6456
20831,11061,9770,1392,279500,6457
7,0,7,-,-,6459
16293,11849,4444,1804,372900,6460
5805,5122,683,1964,395800,6461
205,111,94,-,339700,6467
6238,5869,369,1466,477000,6468
1243,850,393,1179,307400,6469
5370,4697,673,2000,514900,6470
2811,2481,330,1723,364900,6471
2204,1943,261,1541,371800,6472
9758,7953,1805,1578,359800,6473
4460,3810,650,1823,479100,6475
5252,4671,581,2016,466800,6477
4929,4492,437,1411,454900,6478
4222,3547,675,1858,334900,6479
3632,2989,643,1115,305800,6480
643,456,187,"3,500+",341200,6481
4126,3836,290,1871,465400,6482
6287,4637,1650,1511,344900,6483
15741,11950,3791,1661,435700,6484
8123,7090,1033,1906,381800,6488
12791,10500,2291,1440,360600,6489
18684,13516,5168,1346,328400,6492
3510,2701,809,1349,423500,6498
2532,152,2380,1908,495500,6510
21719,4366,17353,1534,313400,6511
12125,8607,3518,1464,265200,6512
15669,5983,9686,1208,226600,6513
10195,6351,3844,1633,250300,6514
6962,2950,4012,1410,284200,6515
20730,10589,10141,1389,265200,6516
6264,3972,2292,1351,313000,6517
6646,4049,2597,2044,307900,6518
5658,1456,4202,1356,247600,6519
1816,1738,78,1500,418900,6524
3185,2935,250,1896,546400,6525
11892,4174,7718,1419,231300,6604
10002,2996,7006,1423,273100,6605
17939,10368,7571,1434,272100,6606
2460,1020,1440,1398,218500,6607
4498,1164,3334,1311,222900,6608
8707,4305,4402,1364,224700,6610
11886,10576,1310,2292,495300,6611
2601,2218,383,2719,727200,6612
13707,12109,1598,1733,342700,6614
6972,4805,2167,1515,348800,6615
1676,66,1610,720,-,6702
11891,5112,6779,1202,178500,6704
11206,5371,5835,1165,177700,6705
5415,2329,3086,1233,171400,6706
12136,6665,5471,1275,196700,6708
3663,1174,2489,1135,219600,6710
3276,3093,183,1888,350700,6712
6021,5239,782,1650,299400,6716
644,409,235,693,325300,6750
1332,907,425,1149,392300,6751
703,643,60,1809,610100,6752
24,24,0,-,-,6753
698,587,111,1188,434800,6754
374,290,84,2206,477500,6755
1146,1001,145,1464,431700,6756
960,673,287,680,359600,6757
14,14,0,-,350000,6758
2334,1972,362,1313,430100,6759
2861,2534,327,-,452000,6762
906,835,71,1208,376800,6763
12555,8579,3976,1309,241500,6770
10103,8142,1961,1598,380800,6776
681,580,101,-,450400,6777
527,508,19,1013,298000,6778
3295,2430,865,1292,248300,6779
766,693,73,1413,284500,6782
1029,847,182,1739,709200,6783
1609,1542,67,1740,518600,6784
339,263,76,-,730900,6785
3843,2953,890,1141,237200,6786
3043,2461,582,1008,259800,6787
15198,10106,5092,1101,196100,6790
2166,1983,183,1574,344900,6791
519,358,161,1716,1071900,6793
389,298,91,1359,462200,6794
5265,4462,803,1301,331200,6795
377,338,39,-,480700,6796
4329,3413,916,1649,440600,6798
7538,5955,1583,1458,426500,6801
6644,5640,1004,1920,452300,6804
2783,1889,894,2622,1228000,6807
20872,8994,11878,1816,351400,6810
11678,8901,2777,1754,405800,6811
4500,4061,439,1926,455900,6812
7111,5908,1203,"3,500+",1728400,6820
12121,10248,1873,2271,827200,6824
7555,5961,1594,1928,601400,6825
9521,5323,4198,2296,1685700,6830
5117,4007,1110,"3,500+",1483500,6831
7021,5870,1151,"3,500+",1534100,6840
7884,4326,3558,2283,562900,6850
11457,6888,4569,2009,565100,6851
1261,1031,230,1736,1402000,6853
11552,5368,6184,1898,453400,6854
3322,1940,1382,1957,492400,6855
2726,2241,485,"3,500+",1579200,6870
9249,7794,1455,1918,799400,6877
2697,2261,436,2367,1899000,6878
9720,8465,1255,2369,1244200,6880
3549,3475,74,"3,500+",968400,6883
1735,1527,208,3193,1087100,6890
3461,3099,362,1639,686400,6896
6203,5448,755,1725,891300,6897
5775,715,5060,2266,446200,6901
28392,11607,16785,2139,515000,6902
4836,4472,364,2899,893900,6903
8166,4966,3200,2330,608700,6905
3427,1720,1707,2207,576200,6906
3525,2239,1286,2302,555900,6907
5629,2799,2830,1839,351200,7001
28325,10604,17721,1593,446100,7002
21075,10985,10090,1775,447600,7003
3003,2382,621,2576,651800,7004
5745,4076,1669,1779,565900,7005
9934,7303,2631,1973,667300,7006
8332,4607,3725,2012,370100,7008
4974,4149,825,1693,600800,7009
10615,5291,5324,1783,577200,7010
13688,6184,7504,1613,403200,7011
5545,3063,2482,1695,459300,7012
11660,8544,3116,1696,462700,7013
1790,1309,481,1912,413400,7014
9410,7377,2033,2116,635800,7016
16018,5020,10998,1346,316700,7017
12098,2694,9404,1410,314100,7018
7009,2876,4133,2645,723400,7020
724,701,23,"3,500+",976300,7021
5580,1944,3636,1597,512100,7022
2776,2400,376,2368,610600,7023
18515,10647,7868,2257,422200,7024
11541,5237,6304,1612,454300,7026
2054,1125,929,1603,509800,7027
2564,2383,181,2395,725600,7028
9820,1909,7911,2036,433100,7029
27654,9421,18233,2819,872100,7030
6646,3082,3564,1706,464700,7031
14756,6706,8050,1649,431700,7032
2880,2097,783,2119,521100,7033
4352,2645,1707,1426,402500,7034
4190,3273,917,1824,422700,7035
16059,9556,6503,1622,385100,7036
10425,8988,1437,2953,746100,7039
8659,6658,2001,2184,684600,7040
2579,1756,823,1969,935900,7041
11067,5570,5497,2017,733100,7042
4179,3601,578,2287,948300,7043
5840,4543,1297,2125,595000,7044
3613,3533,80,"3,500+",647200,7045
1418,1377,41,2941,915100,7046
23784,9828,13956,1702,466800,7047
12548,2972,9576,1427,336200,7050
17463,12267,5196,1791,527200,7052
12134,6050,6084,1725,569000,7054
20434,4798,15636,1392,406500,7055
4905,1900,3005,1568,493700,7057
2213,1499,714,2360,686300,7058
5632,4996,636,2099,899200,7059
15350,5821,9529,1629,369400,7060
4802,2984,1818,1794,374200,7062
4063,2493,1570,1742,363000,7063
1160,1080,80,-,415500,7064
12155,6493,5662,1764,362300,7065
5949,4527,1422,1793,570400,7066
6193,5465,728,1964,473200,7067
2445,1989,456,3293,640600,7068
2369,2076,293,2571,838000,7069
6955,4386,2569,1859,580800,7070
9363,5608,3755,1719,496000,7071
2639,1610,1029,1503,523800,7072
4177,1493,2684,1867,453500,7073
937,647,290,1131,450800,7074
3821,2469,1352,1886,532900,7075
8751,7094,1657,1816,696900,7076
1258,892,366,1382,414900,7077
4420,3908,512,3363,1627300,7078
5953,3903,2050,2067,808100,7079
8270,7041,1229,1928,444100,7080
6615,4122,2493,2135,590600,7081
2079,1976,103,2726,686800,7082
19916,14825,5091,1938,425600,7083
8176,2467,5709,2422,875300,7086
25782,5271,20511,1489,446800,7087
1140,618,522,2046,343700,7088
10676,8568,2108,2211,930500,7090
2540,2206,334,"3,500+",755600,7092
25598,6307,19291,1619,390300,7093
8525,4200,4325,2197,557800,7094
7733,4093,3640,2077,361200,7095
6254,347,5907,1141,293900,7102
12864,3005,9859,1289,259300,7103
20827,5176,15651,1343,337400,7104
19425,3324,16101,1600,445900,7105
12753,4411,8342,1221,321400,7106
15279,4995,10284,1259,353300,7107
11414,1977,9437,1098,326900,7108
14151,7975,6176,1596,405500,7109
11575,7936,3639,1698,489900,7110
22166,6494,15672,1324,291500,7111
10809,3237,7572,1334,306100,7112
4234,962,3272,616,384700,7114
9512,1893,7619,1476,413000,7201
15284,4008,11276,1508,358000,7202
8206,4247,3959,1499,336500,7203
5236,3122,2114,1585,405800,7204
7125,5037,2088,1712,363200,7205
9141,2467,6674,1543,339200,7206
11995,3296,8699,1364,425600,7208
28070,6816,21254,2960,853700,7302
19841,5160,14681,1572,489400,7304
26319,11201,15118,1610,418200,7305
22988,5416,17572,1619,502600,7306
17345,6066,11279,1708,574000,7307
7363,788,6575,3456,880300,7310
1206,0,1206,"3,500+",-,7311
2332,1805,527,2648,764600,7401
2981,2078,903,1773,396600,7403
6800,5425,1375,1526,552500,7405
7267,4171,3096,2025,456000,7407
12150,9629,2521,1908,532700,7410
2615,1629,986,1346,263600,7416
3778,3333,445,3328,1218500,7417
881,875,6,-,347800,7418
4409,3442,967,1721,297300,7419
1840,1282,558,1788,344700,7420
3000,2696,304,2221,375500,7421
2124,2078,46,-,282100,7422
1425,1297,128,2375,1032800,7423
10948,7276,3672,1771,477300,7424
9756,7934,1822,2301,590400,7430
3001,2086,915,1837,586200,7432
1103,830,273,2091,465200,7435
4388,4028,360,1466,566900,7436
4303,3825,478,1335,417800,7438
857,759,98,1390,311900,7439
1598,1409,189,981,514600,7440
4142,3298,844,1822,411100,7442
4699,3894,805,3297,488200,7444
5248,4395,853,2009,665700,7446
8816,7394,1422,2340,882700,7450
3678,3341,337,1938,817300,7452
4154,3966,188,1934,434800,7456
1988,1419,569,2351,384500,7457
3995,3546,449,"3,500+",1187100,7458
1220,1109,111,-,340800,7460
7116,5718,1398,1456,338500,7461
3177,2615,562,1614,252600,7462
3434,3019,415,3189,576200,7463
2552,2155,397,2008,381900,7465
18697,14691,4006,2126,596700,7470
5813,5223,590,1433,362200,7480
5897,5363,534,2092,908900,7481
12335,1971,10364,1442,304400,7501
4662,2471,2191,1492,347200,7502
6225,1665,4560,1605,314900,7503
3944,1511,2433,1426,369600,7504
1593,26,1567,1113,-,7505
7613,5190,2423,1828,499200,7506
8329,5223,3106,1749,444600,7508
3892,2962,930,1703,507700,7512
3189,991,2198,1606,387400,7513
6265,1920,4345,1472,314400,7514
7019,1477,5542,1458,264000,7522
4422,961,3461,1386,360200,7524
20305,7802,12503,1794,370300,7601
3125,2142,983,1893,443400,7603
4360,3065,1295,1605,508500,7604
3366,2341,1025,2122,634500,7605
932,479,453,1906,514700,7606
3814,2625,1189,1932,495700,7607
35,0,35,1911,-,7608
517,481,36,2357,"2,000,000+",7620
9430,6656,2774,1744,469200,7621
2632,2159,473,2651,820100,7624
3085,2488,597,2311,764800,7626
1695,1520,175,"3,500+",965400,7627
6491,4686,1805,1778,469900,7628
2641,2353,288,1926,626000,7630
11258,5935,5323,1925,497500,7631
1930,1617,313,"3,500+",1232700,7632
1776,1706,70,-,709200,7640
1053,1001,52,-,815300,7641
3393,3063,330,1720,656800,7642
4539,1957,2582,1798,388500,7643
9381,3880,5501,1675,449200,7644
3086,2596,490,2241,688500,7645
6157,3860,2297,1722,554800,7646
1761,1361,400,1853,588800,7647
1981,1589,392,2446,676400,7648
2687,2410,277,2202,702400,7649
7375,2740,4635,1976,704400,7650
8420,6877,1543,2845,736000,7652
3256,2678,578,1995,666200,7656
4082,1910,2172,1935,609700,7657
5113,2930,2183,1633,459400,7660
4377,3320,1057,1811,637500,7661
2309,1850,459,1666,470200,7662
5358,3562,1796,2018,473700,7663
13406,10307,3099,1850,496400,7666
5222,3768,1454,3143,974300,7670
9651,7666,1985,2347,680600,7675
3317,3130,187,2230,640600,7676
2123,1882,241,2629,901800,7677
10736,7015,3721,1971,551500,7701
1492,1255,237,3300,735900,7702
0,0,0,-,-,7703
2072,1914,158,3500,943300,7704
613,471,142,2033,1075900,7711
17810,8505,9305,1496,578300,7712
3763,2604,1159,1863,621700,7716
878,577,301,1891,1349000,7717
2566,2438,128,1847,490100,7718
9232,6775,2457,1754,628700,7719
2020,975,1045,1710,857200,7720
1687,921,766,1945,387500,7721
3623,3346,277,2895,871400,7722
340,226,114,1422,1341500,7723
9974,6943,3031,1640,487300,7724
16379,14279,2100,1973,603000,7726
2767,2339,428,1794,585900,7727
20513,15812,4701,1941,490000,7728
6612,5935,677,1149,452500,7730
13755,12451,1304,2619,454900,7731
2642,1695,947,1841,396800,7732
6193,5669,524,"3,500+",814000,7733
4834,2879,1955,1638,310000,7734
7938,6056,1882,1520,384700,7735
1497,1383,114,1439,468500,7737
2445,2160,285,843,719000,7738
2252,2155,97,"3,500+",870700,7739
13105,5447,7658,1744,521900,7740
6023,5772,251,2688,654700,7746
12788,9550,3238,1840,464100,7747
10229,8929,1300,1483,568000,7748
1503,1221,282,2169,918100,7750
7398,6699,699,2636,663100,7751
15810,10970,4840,1740,390900,7753
1973,1568,405,2448,655000,7755
1716,1058,658,1212,764200,7756
2490,2328,162,1310,685800,7757
1627,1272,355,1203,478900,7758
3521,3110,411,2108,1275000,7760
4034,2640,1394,1775,871400,7762
2771,1982,789,1936,631300,7764
9184,4437,4747,1747,369400,7801
1389,1228,161,1873,377800,7803
0,0,0,-,-,7820
3472,3204,268,1646,401900,7821
310,310,0,-,421300,7822
3522,2307,1215,948,314600,7823
3427,3133,294,1692,410700,7825
2206,1935,271,1628,370900,7826
1671,1481,190,1307,298000,7827
5847,3180,2667,1483,433200,7828
2729,2601,128,1771,622400,7830
20,20,0,-,-,7831
1345,1212,133,1756,326000,7832
30,24,6,-,220000,7833
6686,5737,949,1707,552300,7834
4686,3139,1547,1872,517800,7836
1317,1158,159,2054,409600,7838
12757,9033,3724,1469,373000,7840
26,26,0,-,-,7842
4462,3898,564,1616,316900,7843
45,9,36,1263,-,7844
12,12,0,-,440000,7846
677,537,140,2068,337600,7847
1613,1419,194,1438,412500,7848
3325,3109,216,1594,412800,7849
2580,2059,521,1711,387100,7850
126,123,3,-,322500,7851
1591,1250,341,1476,424900,7852
4209,3997,212,1745,601000,7853
2070,1408,662,2374,389500,7856
1821,963,858,1396,344300,7857
10389,8361,2028,1437,336600,7860
1601,1423,178,1624,276300,7863
1044,861,183,1885,373500,7865
8687,7035,1652,1604,434200,7866
9016,6935,2081,1772,636400,7869
22,22,0,-,-,7870
7880,7140,740,1831,462900,7871
3226,2984,242,1735,336000,7874
3268,3064,204,2299,481300,7876
316,316,0,-,436000,7878
77,77,0,-,406100,7880
0,0,0,-,-,7881
6048,4327,1721,1411,333800,7882
4761,2966,1795,1961,345200,7885
9004,6212,2792,2209,958700,7901
10632,8927,1705,2330,769300,7920
3990,3162,828,2160,431000,7921
4291,4117,174,1986,697000,7922
2614,2349,265,2155,733800,7924
23,11,12,-,-,7926
1754,1067,687,2802,610100,7927
6690,5501,1189,2441,965800,7928
2790,2598,192,1404,758400,7930
1239,1043,196,3469,1084200,7931
4553,3159,1394,3009,719400,7932
1163,1080,83,-,638000,7933
603,515,88,2146,816400,7934
241,201,40,2870,690300,7935
4045,3820,225,2745,668500,7936
31,0,31,-,-,7939
5566,3575,1991,2248,883200,7940
3487,3198,289,3432,894200,7945
1015,956,59,"3,500+",754600,7946
8304,6273,2031,2549,571300,7950
18335,11346,6989,2173,701100,7960
0,0,0,-,-,7961
73,73,0,-,-,7970
4696,3890,806,2042,726000,7974
148,92,56,-,1375000,7976
238,147,91,-,798600,7977
64,64,0,-,-,7979
824,569,255,1662,660900,7980
3687,3279,408,2619,611300,7981
335,324,11,-,282400,8001
9287,6220,3067,1895,301200,8002
11527,9821,1706,1991,418000,8003
4080,3388,692,1169,255500,8004
10591,9452,1139,1949,356200,8005
205,189,16,-,1105600,8006
2566,1407,1159,1088,237200,8007
3378,3069,309,1664,1083100,8008
5564,4305,1259,1392,291500,8009
4623,3321,1302,1472,227700,8010
17,17,0,-,-,8011
15742,10682,5060,1589,268500,8012
101,101,0,-,258100,8014
7195,5958,1237,1190,215100,8015
12972,9483,3489,1343,308000,8016
351,317,34,2063,363700,8019
1011,973,38,-,339100,8020
20566,9985,10581,1288,192200,8021
3521,3407,114,1971,394900,8022
94,74,20,-,175800,8023
802,726,76,-,278200,8026
1970,1681,289,1295,230500,8027
8251,5076,3175,1554,278500,8028
2178,1627,551,782,220500,8029
4968,3022,1946,1498,169700,8030
4918,3155,1763,1141,216500,8031
62,62,0,-,305000,8032
6499,4808,1691,1449,581700,8033
7923,6127,1796,1707,335700,8034
3163,2462,701,1179,353700,8035
2507,2289,218,1453,397800,8036
9058,6963,2095,1297,307700,8037
164,101,63,1714,175900,8038
12,12,0,-,-,8039
354,342,12,-,481400,8041
30,30,0,-,241700,8042
12360,7830,4530,1718,390600,8043
1196,801,395,1034,215100,8045
10745,8780,1965,1941,240000,8046
4779,3516,1263,1667,414600,8048
2157,1632,525,1204,227300,8049
11075,9907,1168,1756,377100,8050
4511,3609,902,1691,249000,8051
8791,4182,4609,1574,235500,8052
19281,13877,5404,1939,368100,8053
19283,14695,4588,1966,341400,8054
10685,9510,1175,1502,456000,8055
1688,1688,0,-,412900,8056
7872,6562,1310,1485,626400,8057
2265,1516,749,1458,231100,8059
9597,7117,2480,1619,292000,8060
1588,1540,48,-,384000,8061
5618,5190,428,1097,468600,8062
1083,910,173,1380,207100,8063
38,38,0,-,-,8064
3283,2285,998,1680,216600,8065
3159,2023,1136,1092,166600,8066
585,499,86,1750,312500,8067
2716,1678,1038,1100,256000,8068
5134,2853,2281,1221,184000,8069
5260,4103,1157,1209,194400,8070
3756,2778,978,1488,258400,8071
83,64,19,-,-,8072
9,9,0,-,-,8073
0,0,0,-,-,8074
11470,7809,3661,1427,288200,8075
7327,6153,1174,2046,359400,8077
3026,2154,872,1375,215400,8078
4323,2521,1802,1057,180300,8079
14455,12547,1908,1674,330400,8080
17433,14563,2870,1551,262200,8081
3848,3032,816,1236,254400,8083
2544,1846,698,1172,238200,8084
7192,5920,1272,1856,351000,8085
3771,2666,1105,1689,258800,8086
10736,8902,1834,1760,323500,8087
9632,9139,493,1793,344900,8088
1430,1352,78,888,248900,8089
3035,2731,304,-,265300,8090
2524,1788,736,1346,247700,8091
1213,1010,203,1408,473600,8092
4125,2294,1831,1230,192800,8093
15269,12608,2661,1420,260200,8094
0,0,0,-,-,8095
13924,10132,3792,1446,248400,8096
1129,1065,64,1353,254600,8097
3220,2428,792,1239,297600,8098
2987,778,2209,1057,79500,8102
4420,1474,2946,1203,103800,8103
8421,2752,5669,1105,87600,8104
8222,3468,4754,1215,113100,8105
3850,2571,1279,1083,286500,8106
5748,3010,2738,1257,261700,8107
8663,5537,3126,1680,358100,8108
8816,6381,2435,1142,227200,8109
6290,4601,1689,1192,194400,8110
4086,2611,1475,1818,237100,8201
844,802,42,1615,1566700,8202
3954,2958,996,1499,485000,8203
8090,6381,1709,1149,399200,8204
11172,8923,2249,1527,263300,8205
7406,6007,1399,1538,337700,8210
84,84,0,-,987200,8212
5436,4074,1362,1525,266500,8215
21,21,0,-,-,8217
2612,2352,260,2070,351100,8221
1846,1687,159,1642,353400,8223
53,53,0,-,287500,8224
3299,2897,402,1554,275900,8225
5619,4070,1549,1670,719100,8226
2274,2173,101,1757,406900,8230
6466,3233,3233,1210,179900,8232
16931,14197,2734,1466,285700,8234
3,3,0,-,-,8240
457,434,23,2104,412500,8241
1852,1461,391,1486,306200,8242
1125,1055,70,-,1019500,8243
4860,2434,2426,1266,278500,8244
16,16,0,-,-,8245
26,26,0,-,-,8246
520,446,74,1588,1773800,8247
75,75,0,-,934000,8248
4767,4103,664,1468,275800,8251
6951,4450,2501,1182,441300,8260
3155,2587,568,1145,298800,8270
14711,8454,6257,1351,202000,8302
678,519,159,1075,-,8310
604,504,100,1311,195400,8311
3219,2360,859,1204,248000,8312
200,190,10,-,203400,8314
27,27,0,-,-,8316
597,482,115,-,301400,8317
4422,3743,679,1173,271300,8318
450,445,5,-,293100,8319
0,0,0,-,-,8320
90,77,13,-,213200,8321
3508,3108,400,1504,280400,8322
310,286,24,953,247500,8323
90,50,40,-,258300,8324
486,359,127,1490,244900,8326
192,153,39,-,166300,8327
526,426,100,-,231100,8328
117,117,0,-,165800,8329
11994,8572,3422,1576,230700,8330
14299,9589,4710,1223,195900,8332
399,300,99,1247,242800,8340
812,443,369,948,207100,8341
1440,1326,114,1625,324900,8343
2051,1860,191,1431,212600,8344
383,351,32,1594,196700,8345
189,189,0,-,221900,8346
101,43,58,-,-,8348
899,564,335,1670,124600,8349
287,287,0,-,235600,8350
69,40,29,-,175000,8352
113,104,9,880,198300,8353
16023,10208,5815,1164,199600,8360
6535,5339,1196,1407,271300,8361
16568,4971,11597,1086,189600,8401
2625,2356,269,1368,645200,8402
535,501,34,2554,1040300,8403
4496,2822,1674,1460,345300,8406
2437,2228,209,1457,530100,8501
4049,3320,729,2511,766000,8502
7407,5159,2248,1586,353200,8505
1856,1819,37,-,645200,8510
344,209,135,1151,369600,8511
5042,3080,1962,1584,618300,8512
1900,1737,163,1440,508000,8514
2455,2284,171,2545,518300,8515
2077,1455,622,1253,287900,8518
10692,7404,3288,1556,361800,8520
1912,1638,274,1646,551300,8525
20687,17789,2898,1693,460600,8527
211,195,16,-,234600,8528
3528,2787,741,1641,554000,8530
2493,1880,613,1662,471500,8533
4855,4157,698,2106,573100,8534
1660,1438,222,2279,684200,8535
8566,3779,4787,1908,655100,8536
18037,11438,6599,2083,723400,8540
1220,439,781,2398,754800,8542
12,0,12,-,-,8544
7737,5902,1835,2694,758900,8550
2091,1857,234,2125,580400,8551
319,242,77,1660,608200,8553
1465,1288,177,1835,186400,8554
361,298,63,-,354600,8555
2638,2334,304,1796,853300,8558
1983,1814,169,2070,556000,8559
1373,1291,82,2163,399700,8560
152,63,89,-,479500,8561
1610,1196,414,1048,271200,8562
560,55,505,1009,-,8608
4486,1379,3107,1218,96700,8609
12048,8162,3886,1491,248900,8610
10852,3947,6905,1300,142400,8611
13640,5625,8015,1117,211800,8618
9418,6522,2896,1712,320800,8619
4096,3212,884,1490,341000,8620
4317,2712,1605,1661,358100,8628
4470,3011,1459,1263,149000,8629
9129,5137,3992,1499,226700,8638
901,1,900,2383,-,8640
1340,29,1311,2426,-,8641
11553,7912,3641,1953,395400,8648
7771,6377,1394,1561,362700,8690
6971,5333,1638,1845,523500,8691
31224,15861,15363,1701,430700,8701
251,208,43,-,757000,8720
8241,7009,1232,1595,353900,8721
3965,3573,392,2236,307500,8722
12991,10365,2626,1652,374400,8723
16507,13765,2742,1767,364700,8724
1884,1736,148,2655,815100,8730
8533,7292,1241,2080,360000,8731
725,674,51,2036,496800,8732
1053,645,408,1730,225800,8733
2699,2560,139,1504,387300,8734
1953,1631,322,-,865200,8735
5206,4622,584,1838,849800,8736
602,581,21,-,1418600,8738
754,609,145,1724,342100,8740
1102,1067,35,1219,449900,8741
10502,8333,2169,1879,576300,8742
1562,1304,258,2039,1117800,8750
1928,1225,703,1437,583000,8751
1229,976,253,1402,779000,8752
24945,20316,4629,1742,377200,8753
10467,8520,1947,1484,379600,8755
18035,15583,2452,1714,253200,8757
3239,2837,402,1239,455900,8758
19640,17270,2370,1324,176600,8759
2703,2297,406,2496,501000,8801
1569,1490,79,2194,458500,8802
1174,895,279,-,439100,8804
5453,2546,2907,1859,393900,8805
13869,11465,2404,2092,562400,8807
2261,1770,491,1721,413400,8809
2746,2329,417,1969,471700,8810
4553,3487,1066,1557,435300,8812
16690,13443,3247,2079,502600,8816
16618,8964,7654,1946,411100,8817
12975,9855,3120,1925,597700,8820
140,124,16,-,446700,8821
12028,9672,2356,1685,513900,8822
3445,2307,1138,2242,279400,8823
4691,4154,537,1963,602500,8824
2071,1596,475,1639,471800,8825
2174,1875,299,1474,441600,8826
1593,1384,209,1223,428600,8827
984,648,336,2081,321400,8828
1475,1167,308,1747,298600,8829
6354,4204,2150,2051,394200,8830
23858,21380,2478,1872,489700,8831
868,175,693,1643,328100,8832
3518,3028,490,1811,575400,8833
4300,3114,1186,1837,321100,8835
1412,1402,10,-,786500,8836
7357,3693,3664,1778,432500,8837
6333,4863,1470,1994,517700,8840
15918,13127,2791,2171,537300,8844
5567,4042,1525,1493,414600,8846
3049,2745,304,1521,393800,8848
3097,2466,631,1520,436600,8850
6655,4388,2267,1897,489100,8852
1948,1464,484,2124,638700,8853
17321,11244,6077,1929,423900,8854
15860,10602,5258,1462,459400,8857
0,0,0,-,-,8858
8855,5229,3626,1625,407100,8859
20367,7136,13231,1623,340900,8861
4691,3371,1320,1976,414100,8863
13452,9318,4134,1248,244200,8865
1925,1796,129,-,579700,8867
3209,1714,1495,1927,449200,8869
7382,4359,3023,1594,404300,8872
21641,14562,7079,1942,438600,8873
9547,6025,3522,1776,468400,8876
9226,5504,3722,1633,377700,8879
1829,1039,790,1822,345300,8880
5570,3659,1911,1599,382500,8882
3276,2766,510,1097,358100,8884
2250,2104,146,1846,424000,8886
566,322,244,1817,268200,8887
4393,3945,448,1458,523100,8889
0,0,0,-,-,8890
15905,3462,12443,1790,316800,8901
15532,9045,6487,2055,402400,8902
6518,2533,3985,1881,463600,8904
15097,3570,11527,3024,793000,10001
35771,6660,29111,1207,808500,10002
25080,8701,16379,2772,1137000,10003
1775,630,1145,"3,500+",1866400,10004
5156,880,4276,"3,500+",1387200,10005
2305,402,1903,"3,500+",1125700,10006
3309,1159,2150,"3,500+","2,000,000+",10007
30025,2687,27338,1925,690600,10009
16192,4453,11739,3113,1037900,10010
28277,10180,18097,2868,1165800,10011
11909,2562,9347,2731,1500000,10012
12609,3723,8886,2378,"2,000,000+",10013
17682,5052,12630,2998,1294200,10014
30164,8345,21819,3321,928400,10016
9529,2914,6615,2980,808200,10017
4901,580,4321,"3,500+",947100,10018
26900,5813,21087,2619,1066100,10019
0,0,0,-,-,10020
20319,9165,11154,3002,1529600,10021
18627,9017,9610,2928,1116700,10022
36881,14576,22305,3050,1401800,10023
29447,11398,18049,2965,1746400,10024
41029,12584,28445,2009,1125200,10025
15537,3574,11963,1546,1014100,10026
24509,3846,20663,1609,915000,10027
24901,9447,15454,2702,1600400,10028
33098,2304,30794,1183,818100,10029
13180,1754,11426,1204,810100,10030
21991,3008,18983,1787,678000,10031
21359,1780,19579,1546,545500,10032
19747,3035,16712,1742,709100,10033
15462,1547,13915,1621,518000,10034
15056,1484,13572,1283,663500,10035
18886,1673,17213,2301,988000,10036
10205,912,9293,1406,-,10037
10694,3040,7654,3140,865700,10038
12427,1841,10586,1211,478200,10039
16260,2511,13749,1680,465700,10040
5146,1072,4074,3305,1041300,10044
16706,5542,11164,2828,1368200,10065
3202,935,2267,"3,500+","2,000,000+",10069
12536,5732,6804,2390,1097800,10075
0,0,0,-,-,10103
0,0,0,-,-,10110
0,0,0,-,-,10111
0,0,0,-,-,10112
0,0,0,-,-,10115
0,0,0,-,-,10119
30154,9725,20429,2648,1295600,10128
0,0,0,-,-,10152
0,0,0,-,-,10153
0,0,0,-,-,10154
883,0,883,"3,500+",-,10162
0,0,0,-,-,10165
0,0,0,-,-,10167
0,0,0,-,-,10168
0,0,0,-,-,10169
0,0,0,-,-,10170
0,0,0,-,-,10171
0,0,0,-,-,10172
0,0,0,-,-,10173
0,0,0,-,-,10174
0,0,0,-,-,10177
0,0,0,-,-,10199
0,0,0,-,-,10271
0,0,0,-,-,10278
62,0,62,"3,500+",-,10279
4222,1368,2854,"3,500+",893800,10280
2584,280,2304,"3,500+","2,000,000+",10282
14430,6435,7995,1697,657000,10301
6159,3493,2666,1800,586300,10302
8742,5448,3294,1520,457600,10303
15900,7856,8044,1516,659900,10304
15637,10158,5479,1656,627200,10305
19846,14143,5703,1743,675400,10306
5135,4285,850,1618,799100,10307
10323,8231,2092,1729,648800,10308
12108,9535,2573,1907,745500,10309
8982,5078,3904,1638,623300,10310
0,0,0,-,-,10311
21366,17426,3940,1911,698900,10312
31419,23446,7973,1726,665500,10314
21414,2919,18495,1269,263500,10451
28397,951,27446,1367,263000,10452
28462,1404,27058,1393,580100,10453
14910,948,13962,1064,780800,10454
16366,1692,14674,1130,348700,10455
32601,2144,30457,1194,428800,10456
26715,1667,25048,1400,336900,10457
28856,1134,27722,1548,515700,10458
17919,2119,15800,1285,589500,10459
22734,2431,20303,1332,589300,10460
19078,5990,13088,1741,640400,10461
29538,6755,22783,1711,372100,10462
29575,10342,19233,1611,352200,10463
2081,1434,647,1993,667600,10464
16221,9109,7112,1774,602000,10465
25262,10255,15007,1528,605300,10466
38210,5195,33015,1505,425500,10467
28608,2442,26166,1594,259400,10468
23582,11942,11640,1653,640400,10469
6625,2851,3774,1656,500400,10470
9205,5292,3913,1729,406500,10471
21950,3445,18505,1445,632500,10472
22734,6442,16292,1131,586800,10473
3917,330,3587,1406,-,10474
18692,8388,10304,1221,31900,10475
469,453,16,-,801900,10501
1879,1585,294,"3,500+",819100,10502
63,63,0,-,677600,10503
2540,2410,130,1910,1150700,10504
495,343,152,1398,859500,10505
2225,2152,73,3188,1097800,10506
1805,1169,636,1877,628500,10507
7326,5727,1599,1836,430200,10509
3734,3080,654,2438,842900,10510
817,715,102,1670,492000,10511
9170,7616,1554,1607,401800,10512
4076,3593,483,2758,1069100,10514
2289,1666,623,1798,625400,10516
165,111,54,1571,597500,10517
374,359,15,-,795500,10518
107,0,107,-,-,10519
4989,3461,1528,1938,669900,10520
3853,2401,1452,2346,719300,10522
3320,1808,1512,3004,526000,10523
1613,1332,281,2313,549600,10524
722,666,56,2306,795200,10526
191,173,18,-,778300,10527
4959,2667,2292,2683,934100,10528
6493,5555,938,2334,445600,10530
1822,1588,234,"3,500+",675300,10532
2587,2146,441,2444,907600,10533
196,50,146,1844,333300,10535
3434,3037,397,2418,854000,10536
811,670,141,2298,367500,10537
6715,5260,1455,2115,1185300,10538
0,0,0,-,-,10540
8950,7806,1144,1967,472600,10541
0,0,0,-,-,10542
7566,4558,3008,2030,710000,10543
0,0,0,-,-,10545
456,407,49,"3,500+",831500,10546
2787,1850,937,2363,479200,10547
1228,979,249,1534,445900,10548
5807,4320,1487,1686,652800,10549
15837,4394,11443,1451,482600,10550
9442,6093,3349,1770,331400,10552
3693,1700,1993,1771,490000,10553
1642,1397,245,2240,656600,10560
12230,7490,4740,2118,486700,10562
10806,6308,4498,1895,376800,10566
6587,6114,473,1913,532600,10567
4285,3674,611,1958,862400,10570
13951,7910,6041,1940,649900,10573
1814,1696,118,"3,500+",1014900,10576
729,712,17,-,1461400,10577
568,568,0,-,607700,10578
3011,2720,291,2723,515000,10579
6178,4447,1731,2764,1834100,10580
14050,11956,2094,2476,1131700,10583
1108,723,385,1281,522400,10588
3536,3212,324,"3,500+",521200,10589
2628,2482,146,2262,727600,10590
10094,5133,4961,1943,661800,10591
1792,1599,193,2148,683600,10594
2360,1725,635,1626,725200,10595
389,239,150,1769,448900,10596
194,194,0,-,1108300,10597
10299,9113,1186,2286,591300,10598
5313,2003,3310,1975,396800,10601
7277,4577,2700,1905,499600,10603
4273,2296,1977,1968,814600,10604
7933,5909,2024,2195,761200,10605
6420,2411,4009,2452,667900,10606
2224,1844,380,2303,624300,10607
27163,7563,19600,1694,412900,10701
7553,4080,3473,1702,477500,10703
12032,7622,4410,1898,508100,10704
14995,5453,9542,1602,445600,10705
3357,2673,684,1999,866200,10706
3957,2227,1730,2051,718400,10707
9425,7122,2303,2161,496800,10708
3690,2851,839,1955,844000,10709
9979,7060,2919,1797,534000,10710
16030,6237,9793,1742,555000,10801
4239,3423,816,2242,961300,10803
5267,4996,271,2114,894100,10804
8530,3663,4867,2018,338100,10805
9273,6737,2536,1746,490700,10901
0,0,0,-,-,10910
8,0,8,-,-,10911
1518,1479,39,2325,621600,10913
156,156,0,-,440500,10914
0,0,0,-,-,10915
1468,1361,107,1196,468000,10916
480,422,58,-,553000,10917
4185,3423,762,1652,424700,10918
539,539,0,-,418800,10919
2869,2545,324,2061,533800,10920
1564,1334,230,1836,375200,10921
543,287,256,1403,381500,10922
2866,1775,1091,1827,459100,10923
4671,3687,984,1668,433600,10924
1755,1420,335,1620,342600,10925
1409,925,484,2040,319000,10926
3910,2020,1890,1741,361800,10927
2277,1352,925,1717,307800,10928
3423,3164,259,1890,399700,10930
383,203,180,2109,467600,10931
7,7,0,-,-,10932
99,70,29,-,231400,10933
18680,11883,6797,1600,301400,10940
5428,3221,2207,1640,325700,10941
16009,9966,6043,1693,458800,10950
11031,4778,6253,1715,786300,10952
0,0,0,-,-,10953
9590,6597,2993,2184,502300,10954
9592,9009,583,2256,629200,10956
816,751,65,2125,369600,10958
6212,3455,2757,2148,662600,10960
1646,1430,216,1655,653300,10962
1178,799,379,925,313400,10963
514,474,40,-,686600,10964
5605,4264,1341,2036,560200,10965
1122,716,406,2019,615700,10968
425,408,17,-,397700,10969
3959,3082,877,1877,362800,10970
755,655,100,1788,379400,10973
1228,1022,206,2491,429600,10974
125,46,79,2159,208900,10975
603,381,222,1075,658300,10976
16360,7507,8853,1711,602300,10977
43,43,0,-,-,10979
4816,4207,609,1748,475200,10980
1899,1757,142,2237,593200,10983
916,837,79,1726,541700,10984
6,6,0,-,-,10985
592,508,84,1583,594700,10986
1446,1145,301,1486,682800,10987
222,134,88,1532,319600,10988
3179,2810,369,2017,512700,10989
7774,6013,1761,1387,462100,10990
3303,2758,545,1438,389300,10992
1462,828,634,1544,323600,10993
2131,2075,56,1622,618900,10994
1118,0,1118,"3,500+",-,10996
1203,1038,165,1824,442200,10998
8508,7283,1225,2196,714600,11001
12068,9710,2358,2315,576500,11003
5093,3539,1554,1967,661900,11004
1535,1476,59,2179,620200,11005
8380,7038,1342,2096,647300,11010
1770,1530,240,2845,1155600,11020
8116,5541,2575,2184,734200,11021
3117,2547,570,-,1143800,11023
2166,1775,391,2467,1633700,11024
6035,5414,621,2221,1800900,11030
13884,12326,1558,2388,795300,11040
0,0,0,-,-,11042
11656,8161,3495,2454,990800,11050
2553,1252,1301,1944,604900,11096
19049,3043,16006,2740,995500,11101
13176,1923,11253,2248,779800,11102
16211,2676,13535,2120,1003500,11103
12234,2627,9607,1924,665700,11104
16068,3855,12213,2211,1089000,11105
18970,3264,15706,2032,639200,11106
3638,729,2909,"3,500+",526000,11109
33141,11776,21365,3207,1131700,11201
30149,11890,18259,1566,677700,11203
25306,8943,16363,1751,1097200,11204
17272,5007,12265,2307,892800,11205
33696,3670,30026,1558,822100,11206
35309,9492,25817,1443,657400,11207
34486,8921,25565,1563,638200,11208
30376,10879,19497,1857,905700,11209
21440,9075,12365,1734,817600,11210
27497,4520,22977,2357,1118600,11211
32588,4512,28076,1231,549400,11212
27060,4189,22871,1607,1184400,11213
31006,10520,20486,1710,1007400,11214
29747,12162,17585,2803,1674700,11215
26664,6207,20457,2180,1398400,11216
19543,5640,13903,2800,1614200,11217
26053,9880,16173,1966,914300,11218
24476,6363,18113,1678,1086000,11219
28336,7824,20512,1688,1021200,11220
36032,7804,28228,2055,1061400,11221
20277,3586,16691,2595,1245600,11222
26433,9453,16980,1653,1063200,11223
19991,5654,14337,905,512900,11224
24747,4544,20203,1733,1218300,11225
39305,5303,34002,1751,866300,11226
15105,8259,6846,1828,1131700,11228
30924,14541,16383,1666,812200,11229
31802,9452,22350,1734,863400,11230
16810,5203,11607,2474,1678900,11231
9336,2258,7078,1972,782500,11232
32784,7573,25211,1613,1013000,11233
32178,21652,10526,1771,746800,11234
35333,13081,22252,1649,723900,11235
33318,16816,16502,1637,710300,11236
17723,2001,15722,2109,1063700,11237
27371,7691,19680,2511,1146000,11238
8320,625,7695,1016,580400,11239
17621,3019,14602,2982,1326700,11249
21275,8641,12634,1766,521000,11354
30651,9185,21466,1664,711500,11355
8372,4122,4250,2160,893100,11356
15755,12027,3728,2228,920200,11357
13209,7966,5243,2086,967200,11358
0,0,0,-,-,11359
8822,6639,2183,2329,692600,11360
11229,6782,4447,2315,900700,11361
7093,5477,1616,2548,634500,11362
2890,2076,814,2235,1019400,11363
13753,9710,4043,2330,770100,11364
16024,7701,8323,1869,911800,11365
4518,3078,1440,2101,950200,11366
14716,7050,7666,1774,519800,11367
29859,6590,23269,1925,751700,11368
10131,5611,4520,1983,734900,11369
8764,4266,4498,2071,843600,11370
0,0,0,-,-,11371
25384,8773,16611,1795,454400,11372
32373,8962,23411,1913,683200,11373
19503,7761,11742,1957,484500,11374
33217,17214,16003,2126,572800,11375
33371,9815,23556,1802,670300,11377
13013,6966,6047,1932,832700,11378
13897,8070,5827,1989,886600,11379
37586,11389,26197,1959,842800,11385
6518,5530,988,1605,621500,11411
12095,8989,3106,1630,633800,11412
13712,9967,3745,2038,631700,11413
11523,8826,2697,1991,612800,11414
8967,3812,5155,1909,367900,11415
7501,3780,3721,1964,733500,11416
9371,5472,3899,1853,731900,11417
11608,5668,5940,1788,772800,11418
13020,8063,4957,1920,678800,11419
13975,10026,3949,2032,673700,11420
11986,6300,5686,1901,682800,11421
10341,7062,3279,2327,629100,11422
9824,5643,4181,1706,717300,11423
0,0,0,-,-,11424
6379,4479,1900,2158,676100,11426
8121,5281,2840,1697,690200,11427
6022,4415,1607,1827,666200,11428
8227,5856,2371,1605,646200,11429
0,0,0,-,-,11430
20404,7549,12855,1841,826100,11432
10965,5127,5838,1529,625600,11433
22737,11090,11647,1409,585600,11434
19928,7080,12848,1820,550300,11435
6289,4113,2176,2079,602800,11436
0,0,0,-,-,11439
0,0,0,-,-,11451
8788,5805,2983,2267,627200,11501
2296,2028,268,2528,799800,11507
744,679,65,3125,991000,11509
11111,9775,1336,1695,578600,11510
1677,1273,404,2302,713700,11514
3141,2190,951,2204,818600,11516
4077,3108,969,2306,590800,11518
14129,10061,4068,1984,480600,11520
9539,8499,1040,"3,500+",987800,11530
10879,5963,4916,2350,659300,11542
4358,3937,421,2220,1028900,11545
328,262,66,2029,916700,11547
421,363,58,"3,500+",700900,11548
0,0,0,-,-,11549
18025,8669,9356,1647,446500,11550
7477,6773,704,3185,615800,11552
7215,5379,1836,2122,486100,11553
11727,10514,1213,2539,613900,11554
0,0,0,-,-,11556
2624,2480,144,2287,708400,11557
3133,1996,1137,2212,601500,11558
2630,1980,650,2031,1108200,11559
2418,1994,424,2467,937500,11560
16554,10639,5915,2462,676600,11561
7644,5705,1939,2173,595500,11563
3239,3082,157,1861,628500,11565
11563,11046,517,2803,679000,11566
1011,951,60,"3,500+","2,000,000+",11568
509,431,78,"3,500+",1049100,11569
10724,8113,2611,1804,786600,11570
10460,9601,859,2118,627300,11572
4442,3386,1056,2579,457100,11575
4441,4007,434,2239,1214500,11576
4287,3979,308,2037,945000,11577
1759,1441,318,2268,926500,11579
12912,10801,2111,1852,602500,11580
7108,5886,1222,2198,652700,11581
15146,11710,3436,2209,616500,11590
3375,2809,566,2102,801500,11596
3806,3368,438,2405,1000200,11598
22382,6465,15917,1444,649400,11691
7981,2654,5327,1274,650000,11692
5405,2491,2914,1198,473200,11693
8046,4062,3984,1787,839000,11694
1668,1626,42,-,684100,11697
9033,6090,2943,2307,489000,11701
5470,4557,913,2369,598600,11702
5516,4704,812,2206,469900,11703
12924,9524,3400,2089,485400,11704
2948,2522,426,2193,618300,11705
19324,14458,4866,1885,464300,11706
2580,2231,349,1974,670500,11709
11301,10246,1055,2495,647000,11710
3136,2121,1015,3021,474500,11713
7828,7059,769,2211,586400,11714
1650,1435,215,2200,593500,11715
3359,2828,531,2425,508500,11716
1033,994,39,1986,710600,11718
1120,810,310,1987,564600,11719
8734,7489,1245,2377,471600,11720
2436,2338,98,3220,704900,11721
9877,7606,2271,2094,407100,11722
977,926,51,2692,1571600,11724
9189,8525,664,2358,643000,11725
6102,4521,1581,1913,451300,11726
11266,7493,3773,2504,410300,11727
8661,7324,1337,1889,496100,11729
5070,4312,758,2508,577600,11730
10717,9786,931,2261,622100,11731
1465,964,501,2782,753400,11732
6073,5147,926,2386,653100,11733
11167,9145,2022,2285,572000,11735
5585,4438,1147,2789,455000,11738
462,443,19,-,840400,11739
3650,2942,708,-,686900,11740
8998,6969,2029,2434,504000,11741
4508,3675,833,2224,475600,11742
15665,13931,1734,2397,748200,11743
21661,18416,3245,1907,664900,11746
7575,6664,911,"3,500+",747900,11747
1241,1195,46,1781,451700,11749
5010,4177,833,2238,501900,11751
3048,2647,401,2512,482300,11752
3938,3329,609,2628,950100,11753
6821,5869,952,1837,595300,11754
4052,3246,806,2197,558900,11755
13933,13093,840,2361,557300,11756
14350,12096,2254,2091,479500,11757
18802,17588,1214,2153,624800,11758
7627,7510,117,2886,623000,11762
9602,8599,1003,2327,435200,11763
4212,3348,864,1221,589400,11764
255,215,40,"3,500+","2,000,000+",11765
3863,3743,120,3183,632900,11766
4898,4458,440,2029,615800,11767
8213,7559,654,2222,779700,11768
3357,2895,462,2344,585800,11769
52,44,8,-,730800,11770
3700,2658,1042,1961,921300,11771
17246,12116,5130,2015,450600,11772
8065,6323,1742,2220,462500,11776
3628,2694,934,2261,655900,11777
4768,4481,287,1948,410900,11778
13091,9915,3176,2103,465400,11779
5576,4833,743,2322,702900,11780
5387,4111,1276,2338,614300,11782
7090,6614,476,2806,626700,11783
8441,7218,1223,2273,435600,11784
1895,1815,80,1955,539900,11786
11834,10223,1611,2349,642200,11787
5581,4661,920,2689,635700,11788
2802,2372,430,2787,384300,11789
4503,4036,467,2652,590000,11790
8046,7464,582,3091,918900,11791
3044,3008,36,-,557700,11792
10430,9974,456,2169,633600,11793
0,0,0,-,-,11794
8026,7684,342,2660,598800,11795
1273,1071,202,2519,572100,11796
3162,2744,418,3315,1005500,11797
12871,11331,1540,2992,611400,11801
10324,9619,705,3026,732000,11803
1429,1285,144,-,772900,11804
11404,7986,3418,2195,437500,11901
316,267,49,-,1997100,11930
11,0,11,-,-,11931
313,265,48,-,1951100,11932
3069,2589,480,2375,429500,11933
2750,2537,213,1853,556600,11934
1199,1064,135,2176,885900,11935
8633,6610,2023,2904,1009100,11937
751,659,92,2509,830900,11939
2051,1386,665,2273,626400,11940
887,784,103,-,635900,11941
2399,2049,350,1785,801100,11942
2043,1298,745,2048,822200,11944
6503,5083,1420,2288,691300,11946
100,69,31,-,-,11947
303,303,0,-,909200,11948
4998,4329,669,2191,546300,11949
4753,3892,861,1994,372900,11950
4953,4021,932,2313,321200,11951
2044,1908,136,2081,714800,11952
5410,3509,1901,1935,358400,11953
1618,1305,313,2061,1186400,11954
1402,593,809,2215,466500,11955
142,123,19,-,1033700,11956
656,634,22,-,923500,11957
321,228,93,-,830600,11958
240,184,56,3389,1781300,11959
429,429,0,-,1230500,11960
5575,4972,603,1984,402600,11961
265,252,13,-,1933100,11962
3543,2942,601,3189,1116600,11963
1096,1029,67,-,998700,11964
285,225,60,-,1092200,11965
8486,7745,741,2157,386300,11967
5539,4753,786,2068,1171100,11968
224,224,0,-,729000,11970
2637,2237,400,2240,762700,11971
125,76,49,-,851600,11972
0,0,0,-,-,11973
210,201,9,-,"2,000,000+",11975
1140,1036,104,3200,"2,000,000+",11976
1021,971,50,2031,1039300,11977
1623,1373,250,2079,1045100,11978
2416,1732,684,2814,409500,11980
136,129,7,-,325000,12007
201,201,0,-,267300,12008
3122,2442,680,1282,321500,12009
11277,7196,4081,952,161500,12010
1518,1286,232,1192,268300,12015
214,201,13,917,-,12017
2836,2374,462,1339,318800,12018
6559,5302,1257,1191,381900,12019
14473,10105,4368,1562,299600,12020
401,322,79,1073,179700,12022
824,683,141,1154,261900,12023
45,43,2,-,-,12024
2347,1877,470,882,222900,12025
1690,1449,241,2117,312900,12027
387,336,51,888,217600,12028
492,417,75,1431,374700,12029
86,67,19,704,286300,12031
354,323,31,-,163800,12032
3507,2771,736,1380,267500,12033
202,180,22,-,187500,12035
96,89,7,-,140600,12036
1727,1225,502,1006,345400,12037
20,20,0,-,309100,12040
162,132,30,956,196500,12041
111,78,33,-,-,12042
2930,1915,1015,853,171900,12043
138,116,22,-,-,12045
272,223,49,1170,270100,12046
9756,4615,5141,1213,237200,12047
1503,971,532,910,318400,12051
705,649,56,1276,228900,12052
1821,1618,203,788,258600,12053
7030,5299,1731,1658,334800,12054
789,716,73,1277,346400,12056
773,674,99,1109,206300,12057
588,518,70,1179,260200,12058
672,607,65,1094,306700,12059
787,687,100,2043,352800,12060
3984,3058,926,1741,311300,12061
764,617,147,1222,234600,12062
299,299,0,-,272300,12063
123,106,17,-,100000,12064
18206,12936,5270,1419,356900,12065
770,663,107,1004,174600,12066
498,452,46,1238,318100,12067
1000,849,151,848,170700,12068
117,117,0,-,151800,12069
771,541,230,840,163900,12070
99,76,23,719,189500,12071
979,824,155,964,185200,12072
1187,1081,106,1600,287600,12074
1076,887,189,1375,384700,12075
578,543,35,983,218200,12076
2668,2042,626,1533,345900,12077
9845,6041,3804,908,122400,12078
3,3,0,-,-,12082
1225,965,260,833,265400,12083
2211,533,1678,1589,325800,12084
112,15,97,1309,-,12085
699,591,108,890,208200,12086
608,575,33,1683,234800,12087
2262,1646,616,834,187900,12090
641,451,190,1007,204200,12092
592,533,59,883,162000,12093
826,800,26,-,240400,12094
5290,3521,1769,860,159700,12095
952,824,128,1359,278000,12106
170,114,56,956,275000,12108
8014,5221,2793,1431,306100,12110
41,41,0,-,-,12115
616,535,81,1100,141800,12116
1281,1053,228,843,195200,12117
7526,5158,2368,1105,315100,12118
241,223,18,-,269200,12120
722,714,8,-,260200,12121
1737,1364,373,1019,172800,12122
2071,1713,358,959,275000,12123
116,116,0,-,328400,12124
449,345,104,983,247500,12125
133,116,17,-,218500,12130
90,74,16,1125,158300,12131
93,93,0,-,310600,12132
1747,1349,398,859,197500,12134
370,351,19,-,399500,12136
847,679,168,"3,500+",267200,12137
1173,1067,106,1234,181800,12138
116,98,18,-,270600,12139
620,561,59,1005,305400,12140
2166,1699,467,1022,222400,12143
9552,5649,3903,1379,235300,12144
227,214,13,-,235100,12147
1810,1485,325,1134,406100,12148
946,711,235,818,147300,12149
283,279,4,-,199700,12150
438,379,59,1655,313100,12151
339,336,3,-,304200,12153
1223,1091,132,862,253200,12154
711,627,84,1010,147100,12155
318,280,38,1139,218800,12156
1755,1496,259,934,218400,12157
2767,1946,821,1678,300600,12158
3825,2758,1067,1632,430800,12159
338,268,70,1069,159800,12160
23,11,12,-,-,12161
225,170,55,1045,185200,12164
116,109,7,-,384100,12165
554,511,43,-,187500,12166
965,701,264,838,192400,12167
680,561,119,-,216000,12168
209,170,39,-,184200,12169
2073,1625,448,1246,252500,12170
56,1,55,-,-,12172
734,592,142,1113,219700,12173
250,195,55,-,-,12174
296,269,27,-,146300,12175
155,133,22,-,197300,12176
146,139,7,-,-,12177
21967,10441,11526,1188,233000,12180
6604,3303,3301,1012,195300,12182
1485,373,1112,1081,137300,12183
2917,2299,618,1131,311200,12184
687,543,144,925,208700,12185
2630,2227,403,1132,338200,12186
292,274,18,-,225000,12187
4916,3561,1355,1097,278100,12188
8681,3593,5088,1084,199600,12189
239,201,38,763,253400,12190
491,412,79,915,229600,12192
887,794,93,-,266000,12193
70,62,8,-,232000,12194
81,67,14,-,-,12195
1301,1188,113,1084,338400,12196
780,743,37,783,163300,12197
2933,2206,727,1184,282200,12198
4559,1170,3389,1012,139800,12202
13472,6549,6923,1342,258800,12203
3933,1174,2759,1294,226300,12204
11496,8147,3349,1405,264200,12205
6451,1681,4770,1189,162300,12206
1288,17,1271,689,242500,12207
10596,4727,5869,1291,255300,12208
4485,2966,1519,1165,200800,12209
5366,1293,4073,1110,217500,12210
4321,3964,357,2685,396400,12211
54,0,54,2222,-,12222
0,0,0,-,-,12226
11491,8559,2932,1207,240700,12302
11786,8503,3283,1120,227500,12303
9210,5489,3721,1049,171500,12304
3754,514,3240,1067,162500,12305
11697,8151,3546,1221,212700,12306
3137,849,2288,1110,95900,12307
5955,2645,3310,1159,180100,12308
12837,10616,2221,1472,301100,12309
15150,8599,6551,1300,285700,12401
1694,1365,329,1132,367300,12404
210,193,17,-,175400,12405
328,230,98,816,260000,12406
66,46,20,1200,230000,12407
442,377,65,1583,662300,12409
253,228,25,-,252200,12410
157,141,16,-,287500,12411
260,246,14,-,273700,12412
1416,845,571,1278,208200,12413
4108,2876,1232,1040,241900,12414
86,86,0,-,267300,12416
392,388,4,-,238500,12417
149,123,26,-,261600,12418
396,311,85,1375,304400,12419
129,129,0,-,206000,12420
135,96,39,-,317600,12421
225,201,24,-,229700,12422
402,348,54,715,216700,12423
166,145,21,-,264000,12424
125,125,0,-,330600,12427
2789,1732,1057,1073,200800,12428
56,0,56,-,-,12429
531,479,52,941,277500,12430
652,567,85,871,257900,12431
289,92,197,2033,324400,12432
199,189,10,-,-,12433
405,328,77,920,167500,12434
68,68,0,-,262900,12435
245,199,46,-,241800,12436
26,26,0,-,-,12438
151,140,11,-,170800,12439
675,565,110,1071,389000,12440
47,18,29,-,283300,12441
216,152,64,1165,378600,12442
1576,1450,126,1183,325400,12443
164,156,8,-,352900,12444
2180,1755,425,1151,274200,12446
84,68,16,-,923900,12448
1095,621,474,1571,226900,12449
89,65,24,-,217900,12450
408,371,37,1260,253500,12451
19,14,5,-,-,12452
91,73,18,-,-,12453
131,124,7,-,441200,12454
895,684,211,1297,219600,12455
291,237,54,-,182700,12456
509,357,152,1500,386100,12457
857,718,139,1688,206300,12458
37,37,0,-,207500,12459
119,119,0,-,213100,12460
673,568,105,2077,404200,12461
727,561,166,1002,246900,12463
588,413,175,955,368400,12464
159,146,13,-,335300,12465
804,718,86,1677,272500,12466
636,538,98,704,231700,12468
399,399,0,-,221700,12469
242,197,45,944,220100,12470
274,245,29,-,225900,12471
643,366,277,1162,284200,12472
248,224,24,-,306000,12473
450,417,33,840,213300,12474
271,174,97,-,350000,12475
8321,5547,2774,1239,292100,12477
207,194,13,-,295700,12480
555,513,42,2292,236200,12481
229,107,122,919,165400,12482
38,38,0,-,-,12483
1371,1255,116,1367,441500,12484
262,163,99,1212,385400,12485
652,474,178,1727,299300,12486
1500,1160,340,1606,273100,12487
72,47,25,-,245200,12489
0,0,0,-,-,12490
813,787,26,-,331900,12491
114,110,4,-,402700,12492
75,56,19,-,-,12493
341,332,9,-,361700,12494
175,148,27,-,345500,12495
573,503,70,-,288200,12496
2371,1845,526,1679,542300,12498
1002,571,431,1295,305600,12501
423,405,18,1114,332800,12502
282,236,46,793,458300,12503
0,0,0,-,-,12504
86,30,56,2196,-,12507
8367,4843,3524,1700,401500,12508
115,98,17,-,435300,12512
144,127,17,-,405800,12513
1358,1273,85,1117,411900,12514
550,416,134,1059,328100,12515
708,635,73,2008,227000,12516
108,83,25,1142,425000,12517
2340,1642,698,1720,358200,12518
1242,932,310,1457,458700,12520
801,740,61,1571,327800,12521
1791,1185,606,1339,282000,12522
1032,811,221,1163,331600,12523
6437,4230,2207,1806,373000,12524
654,433,221,1496,363400,12525
1519,1239,280,981,374800,12526
19,19,0,-,-,12527
5771,4043,1728,1642,337400,12528
1103,825,278,1191,387900,12529
42,42,0,-,-,12530
901,751,150,-,434500,12531
8800,7915,885,1643,440800,12533
7855,4833,3022,1296,260800,12534
5382,3677,1705,1190,287900,12538
3173,2738,435,2077,443800,12540
2265,1719,546,1833,356300,12542
1401,758,643,1492,234500,12543
22,22,0,-,-,12544
2093,1216,877,1207,414800,12545
1191,976,215,1277,317200,12546
1256,880,376,1897,384300,12547
333,270,63,1914,327800,12548
3714,2977,737,1606,377300,12549
20116,11220,8896,1466,297400,12550
10620,7482,3138,1612,351200,12553
6444,3787,2657,1603,411600,12561
2197,1855,342,1868,358200,12563
2895,2226,669,1309,420900,12564
570,338,232,1036,215700,12565
4069,3163,906,1414,333700,12566
1083,872,211,1455,329700,12567
4043,2761,1282,1925,349900,12569
2166,1901,265,1762,453800,12570
4044,3286,758,1338,386300,12571
4273,2992,1281,1631,458500,12572
196,185,11,-,589300,12574
553,478,75,-,412500,12575
620,539,81,1422,460100,12577
949,760,189,1522,351500,12578
1624,1450,174,1073,377400,12580
897,678,219,1122,374600,12581
1704,1507,197,1849,444600,12582
805,550,255,1616,390700,12583
478,426,52,-,510700,12585
4367,3056,1311,1576,335600,12586
5468,4218,1250,1149,342400,12589
14224,9782,4442,1674,365900,12590
426,313,113,854,264900,12592
1485,1138,347,1173,363600,12594
17095,7554,9541,1376,275800,12601
16970,12189,4781,1626,342000,12603
59,0,59,-,-,12604
4859,2027,2832,989,178300,12701
451,399,52,-,263500,12719
101,101,0,-,404700,12720
2427,1846,581,1432,307800,12721
0,0,0,-,-,12722
779,634,145,-,232800,12723
36,33,3,-,293400,12724
72,64,8,-,320000,12725
545,495,50,748,308300,12726
540,378,162,1400,296500,12729
465,440,25,1045,241000,12732
84,12,72,1699,-,12733
300,190,110,635,241700,12734
81,74,7,-,150000,12736
672,626,46,876,280600,12737
119,52,67,-,-,12738
784,602,182,1031,279000,12740
140,75,65,1156,356500,12741
56,46,10,-,325800,12742
155,155,0,-,341700,12743
6,6,0,-,-,12745
240,209,31,-,215300,12746
803,543,260,929,302000,12747
726,565,161,967,236300,12748
117,97,20,-,-,12749
26,24,2,-,-,12750
463,245,218,1361,119100,12751
170,112,58,944,385700,12752
2840,1409,1431,905,190700,12754
1978,1713,265,938,171000,12758
448,230,218,1148,77500,12759
148,144,4,-,187500,12760
138,97,41,1354,413400,12762
391,330,61,1591,237500,12763
849,701,148,897,228600,12764
329,304,25,-,403300,12765
226,205,21,-,362300,12766
51,48,3,-,408300,12767
313,269,44,-,271300,12768
177,150,27,-,-,12769
101,95,6,-,350000,12770
5628,3479,2149,1310,246100,12771
980,825,155,1466,406100,12775
757,673,84,1234,238800,12776
321,314,7,-,329500,12777
217,175,42,-,179500,12778
793,393,400,968,275200,12779
1043,750,293,1252,215000,12780
60,60,0,-,436200,12781
640,506,134,1354,209500,12783
0,0,0,-,-,12784
318,318,0,-,227600,12785
261,235,26,-,167000,12786
79,77,2,-,529200,12787
916,635,281,907,255900,12788
1020,549,471,941,159900,12789
1855,1483,372,1414,203400,12790
213,188,25,-,-,12791
101,95,6,-,263000,12792
6819,3464,3355,1050,196000,12801
3637,2128,1509,1194,222600,12803
12458,9228,3230,1209,284400,12804
147,144,3,-,344000,12808
1463,1287,176,1100,222700,12809
214,208,6,-,185800,12810
65,65,0,-,268300,12811
89,89,0,-,392900,12812
659,571,88,1238,240900,12814
534,430,104,1028,233200,12815
2085,1731,354,1064,213300,12816
964,792,172,876,304500,12817
122,94,28,1097,148200,12819
7,7,0,-,-,12820
132,68,64,857,212000,12821
2426,1853,573,971,187500,12822
225,213,12,-,195200,12823
460,439,21,-,441000,12824
1556,1313,243,1113,205700,12827
3745,3118,627,1147,213600,12828
7050,5393,1657,1361,308700,12831
2615,2083,532,705,155300,12832
2184,1887,297,1227,323000,12833
2766,2258,508,1154,234900,12834
1268,1076,192,1023,222800,12835
264,229,35,592,350000,12836
341,284,57,1092,165300,12837
297,234,63,1158,144400,12838
5779,3531,2248,1018,161300,12839
66,66,0,-,1031300,12841
451,358,93,717,227400,12842
280,266,14,-,172000,12843
95,86,9,-,1037500,12844
1959,1491,468,1064,371700,12845
1579,1286,293,942,197400,12846
280,251,29,725,261700,12847
118,84,34,-,290000,12849
978,896,82,940,294600,12850
133,129,4,-,129800,12851
164,156,8,-,221400,12852
585,483,102,938,199000,12853
40,40,0,-,-,12854
98,92,6,-,157500,12855
170,88,82,-,223300,12856
319,283,36,746,187500,12857
87,87,0,-,346300,12858
657,569,88,1351,300300,12859
147,122,25,-,214300,12860
210,196,14,-,264700,12861
95,48,47,-,176300,12862
309,251,58,881,312300,12863
4,4,0,-,-,12864
1359,1110,249,952,170300,12865
18056,11293,6763,1460,419200,12866
780,641,139,760,255200,12870
1677,1229,448,1103,246900,12871
0,0,0,-,-,12872
343,229,114,864,216400,12873
84,65,19,-,475000,12874
284,243,41,894,165200,12878
2082,1358,724,848,162300,12883
222,130,92,984,160700,12884
2165,1704,461,1042,149000,12885
87,87,0,-,345900,12886
1754,1241,513,991,121600,12887
14282,7736,6546,957,182100,12901
874,471,403,1550,192700,12903
670,531,139,892,108300,12910
33,12,21,-,-,12911
758,662,96,829,187400,12912
473,356,117,525,192700,12913
358,243,115,765,89800,12914
36,25,11,-,-,12915
916,665,251,739,90200,12916
450,373,77,850,117200,12917
1191,1082,109,-,208200,12918
1099,817,282,1032,170800,12919
1032,859,173,945,127300,12920
990,840,150,968,195300,12921
17,15,2,-,193800,12922
228,178,50,438,107300,12923
111,15,96,891,-,12924
1074,865,209,819,115100,12926
169,157,12,-,-,12927
771,724,47,827,155400,12928
341,255,86,946,127600,12929
337,299,38,950,96500,12930
599,481,118,766,175900,12932
3,3,0,-,-,12933
462,332,130,784,111100,12934
541,422,119,927,107300,12935
315,267,48,1050,221600,12936
546,455,91,808,103300,12937
97,61,36,-,278100,12939
626,574,52,1092,200000,12941
259,246,13,1583,427300,12942
121,84,37,1575,222400,12943
1591,1223,368,1070,150900,12944
197,197,0,-,255500,12945
2346,1688,658,982,443800,12946
339,273,66,1148,146200,12950
107,63,44,629,41500,12952
4796,3106,1690,821,123100,12953
218,190,28,933,159100,12955
583,417,166,-,117400,12956
788,474,314,768,87700,12957
746,682,64,-,147300,12958
879,815,64,-,193800,12959
450,441,9,-,140300,12960
78,78,0,-,-,12961
2293,1951,342,1026,169000,12962
27,24,3,-,-,12964
142,120,22,792,88600,12965
1188,1016,172,815,119200,12966
461,375,86,819,96300,12967
129,98,31,-,104700,12969
180,130,50,1453,300000,12970
2804,2488,316,1178,195600,12972
55,55,0,-,98800,12973
837,586,251,-,154900,12974
84,70,14,1075,97000,12975
119,95,24,-,291700,12976
8,8,0,-,-,12977
81,81,0,-,-,12978
1256,677,579,731,180500,12979
528,476,52,705,98100,12980
838,731,107,935,141900,12981
3520,2007,1513,845,207800,12983
326,278,48,-,157700,12985
2313,1623,690,683,132400,12986
95,84,11,-,223700,12987
482,440,42,641,196500,12989
1706,1318,388,895,173100,12992
776,614,162,952,193500,12993
875,735,140,692,234600,12996
527,440,87,1095,272800,12997
141,141,0,-,-,12998
41,36,5,-,265900,13020
16973,10652,6321,874,169300,13021
0,0,0,-,-,13024
534,408,126,1263,202000,13026
14779,10323,4456,1258,226500,13027
334,321,13,-,149200,13028
2961,2275,686,938,236000,13029
1440,1258,182,792,195400,13030
7108,5430,1678,1281,207100,13031
5229,4222,1007,920,148900,13032
1320,1129,191,950,166300,13033
809,695,114,940,177500,13034
3033,2576,457,1202,276600,13035
3618,2858,760,960,173900,13036
3701,2789,912,826,211000,13037
6825,5750,1075,1055,228800,13039
1035,825,210,818,126600,13040
4560,4076,484,1479,199200,13041
773,699,74,1272,131100,13042
1138,1063,75,883,144600,13044
11238,6517,4721,905,162700,13045
35,35,0,-,-,13051
646,541,105,805,133500,13052
1967,1348,619,922,229200,13053
476,421,55,985,208900,13054
6504,4807,1697,990,159800,13057
1250,1116,134,968,116600,13060
319,293,26,633,222600,13061
122,83,39,-,252800,13062
796,716,80,852,216000,13063
74,74,0,-,96200,13065
5455,4470,985,1218,265900,13066
1973,1410,563,1011,207900,13068
9819,6509,3310,878,112600,13069
289,221,68,963,179600,13071
335,279,56,836,99700,13072
2651,1964,687,983,167900,13073
1739,1400,339,1105,137300,13074
987,946,41,631,175100,13076
2981,2333,648,1133,168800,13077
3849,3251,598,1291,279200,13078
1354,1095,259,826,160500,13080
491,429,62,1300,259100,13081
1627,1530,97,646,178900,13082
772,599,173,1021,134500,13083
1571,1195,376,1285,200900,13084
94,94,0,-,193400,13087
10799,6226,4573,1104,166500,13088
12219,8421,3798,1294,196600,13090
1015,836,179,1102,174100,13092
949,734,215,858,123800,13101
33,33,0,-,-,13102
122,106,16,-,-,13103
6473,5219,1254,1074,296300,13104
2726,2149,577,993,232800,13108
906,816,90,1042,244000,13110
621,560,61,813,126300,13111
684,561,123,1118,181300,13112
20,20,0,-,112500,13113
2935,2342,593,811,152500,13114
81,61,20,1188,137500,13115
1408,1123,285,1084,170300,13116
78,62,16,580,109100,13117
2034,1689,345,880,161900,13118
0,0,0,-,-,13119
772,701,71,1635,108900,13120
0,0,0,-,-,13121
598,523,75,950,285300,13122
35,35,0,-,-,13123
43,40,3,-,172500,13124
13616,9005,4611,992,134600,13126
1203,1023,180,1030,134000,13131
1657,1541,116,1121,190100,13132
27,27,0,-,89300,13134
2387,1753,634,965,166900,13135
160,135,25,808,103000,13136
75,75,0,-,-,13138
1652,1301,351,976,111900,13140
247,223,24,1104,159900,13141
2626,1950,676,852,157500,13142
889,806,83,1096,121300,13143
441,381,60,720,101400,13144
810,593,217,781,138900,13145
743,593,150,734,99100,13146
379,307,72,867,154300,13147
4966,3378,1588,910,129700,13148
3276,2560,716,990,427600,13152
161,161,0,-,206600,13153
13,13,0,-,-,13154
269,222,47,929,92500,13155
984,844,140,567,159800,13156
328,234,94,969,114200,13157
539,400,139,762,168500,13158
2055,1780,275,972,219500,13159
839,624,215,1000,187500,13160
115,112,3,-,204300,13162
118,118,0,-,167000,13163
916,836,80,1068,211300,13164
4153,2825,1328,926,118600,13165
2432,1973,459,1117,150800,13166
1268,1116,152,1228,164200,13167
3249,295,2954,807,79300,13202
7974,2806,5168,953,148700,13203
8817,2479,6338,1054,97400,13204
7330,3417,3913,898,96300,13205
7815,4339,3476,952,130300,13206
5269,3575,1694,1111,110500,13207
9188,4352,4836,999,110300,13208
5877,4145,1732,968,146200,13209
8117,2191,5926,1081,167200,13210
2512,1974,538,1073,115700,13211
8770,6836,1934,1027,157400,13212
3054,2172,882,998,218900,13214
5576,4737,839,1254,272500,13215
6268,5302,966,1039,173400,13219
3630,2421,1209,1029,215100,13224
5,0,5,-,-,13244
0,0,0,-,-,13290
48,48,0,-,320000,13301
609,504,105,1032,123500,13302
595,492,103,797,151600,13303
710,552,158,1264,254500,13304
167,137,30,-,96300,13305
1701,1471,230,1040,124600,13308
2540,1829,711,751,196800,13309
278,208,70,762,118200,13310
157,138,19,-,231000,13312
249,170,79,721,81500,13313
34,34,0,-,106300,13314
485,417,68,665,190200,13315
2774,2387,387,800,158900,13316
1249,1015,234,869,119700,13317
397,369,28,789,161100,13318
253,159,94,672,-,13319
717,648,69,805,191600,13320
511,298,213,1079,-,13321
397,361,36,1125,203600,13322
4377,3007,1370,1126,231600,13323
793,713,80,867,144800,13324
413,360,53,806,135300,13325
1913,1369,544,1120,308600,13326
778,623,155,793,158700,13327
564,504,60,863,200800,13328
1413,997,416,838,120600,13329
98,98,0,-,290000,13331
869,751,118,1110,121600,13332
17,14,3,-,175000,13333
410,304,106,586,133800,13334
462,340,122,775,121800,13335
357,188,169,982,287500,13337
608,543,65,611,156900,13338
2208,1708,500,839,93000,13339
3265,2655,610,872,143900,13340
83,79,4,-,-,13342
693,610,83,799,164100,13343
83,65,18,-,116600,13345
1737,1231,506,1099,222300,13346
616,504,112,956,187500,13348
4221,2585,1636,821,136400,13350
1,1,0,-,-,13352
31,28,3,-,125000,13353
1241,1123,118,822,198700,13354
318,277,41,864,180500,13355
4488,3086,1402,751,105200,13357
73,71,2,-,295300,13360
240,191,49,586,178400,13361
927,883,44,-,183500,13363
131,131,0,-,127000,13364
3367,2633,734,800,121000,13365
3624,2714,910,790,170700,13367
420,388,32,611,110300,13368
541,440,101,694,140500,13402
1952,1576,376,1209,207700,13403
63,37,26,-,92300,13404
168,162,6,800,139100,13406
2088,1660,428,724,134200,13407
786,658,128,1065,177800,13408
869,768,101,875,126100,13409
321,204,117,631,55700,13410
1169,913,256,688,120200,13411
7091,5430,1661,1133,218900,13413
45,45,0,-,157300,13415
859,723,136,738,160000,13416
1653,759,894,778,160200,13417
67,34,33,1625,125000,13418
430,375,55,-,348900,13420
5573,3788,1785,846,147800,13421
956,802,154,888,205100,13424
741,565,176,827,117800,13425
650,482,168,421,169100,13428
742,619,123,793,207700,13431
691,529,162,717,114900,13433
122,110,12,-,104400,13435
48,32,16,-,275000,13436
131,116,15,1089,90000,13437
1412,1206,206,818,177300,13438
1403,1104,299,827,184300,13439
17645,11108,6537,863,155800,13440
92,0,92,-,-,13441
68,47,21,-,-,13450
1878,1438,440,768,106500,13452
335,309,26,786,-,13454
25,25,0,-,-,13455
1539,1246,293,822,254600,13456
27,14,13,-,82000,13457
789,595,194,1096,158000,13459
1615,1212,403,811,119400,13460
1378,995,383,1115,207100,13461
495,435,60,1125,80200,13464
115,84,31,-,-,13468
441,393,48,1162,247300,13469
263,217,46,771,146600,13470
1041,898,143,1103,110400,13471
115,115,0,-,369100,13472
411,394,17,933,150000,13473
27,17,10,-,145800,13475
1191,730,461,909,177100,13476
600,485,115,728,118000,13477
1436,1305,131,850,189600,13478
1344,964,380,880,168100,13480
29,29,0,-,171600,13482
130,63,67,855,-,13483
49,49,0,-,-,13484
557,467,90,918,136800,13485
308,275,33,1070,144400,13486
72,62,10,-,90000,13488
188,157,31,794,187500,13489
483,483,0,-,211300,13490
1298,1061,237,803,144300,13491
4787,3677,1110,920,192200,13492
828,699,129,909,109700,13493
127,124,3,-,208300,13494
918,561,357,1067,148100,13495
15230,7652,7578,865,136100,13501
13700,8245,5455,965,149600,13502
16401,8134,8267,974,170100,13601
0,0,0,-,-,13602
5106,166,4940,1567,-,13603
2013,1511,502,744,188200,13605
883,759,124,1160,185000,13606
1070,661,409,649,168100,13607
712,551,161,821,121000,13608
123,97,26,-,197400,13611
1239,861,378,942,195000,13612
1113,840,273,733,116800,13613
105,68,37,775,-,13614
239,176,63,763,182100,13615
820,276,544,1356,147800,13616
4423,2559,1864,901,148900,13617
762,663,99,962,196500,13618
4103,2327,1776,984,171700,13619
815,587,228,893,178800,13620
255,190,65,343,160300,13621
762,703,59,1011,226100,13622
43,43,0,-,114800,13623
1856,1221,635,982,224000,13624
698,625,73,381,161900,13625
933,745,188,948,183400,13626
78,61,17,1304,116500,13628
412,391,21,-,85100,13630
24,24,0,-,-,13632
139,134,5,-,90000,13633
1552,1276,276,731,214800,13634
438,359,79,765,96300,13635
56,40,16,819,175000,13636
2248,675,1573,1318,189600,13637
106,71,35,-,165500,13638
20,20,0,-,-,13639
141,141,0,-,330500,13640
43,43,0,-,326900,13641
3591,2513,1078,851,116200,13642
10,10,0,-,-,13643
0,0,0,-,-,13645
851,659,192,803,133000,13646
68,21,47,1107,-,13647
956,803,153,1023,112500,13648
22,22,0,-,-,13649
584,458,126,797,206700,13650
74,74,0,-,338500,13651
643,509,134,925,96900,13652
870,723,147,761,127500,13654
1305,941,364,1025,196500,13655
1042,787,255,487,145500,13656
912,802,110,818,114000,13658
140,134,6,-,151100,13659
688,577,111,827,121000,13660
743,664,79,-,173100,13661
7067,4755,2312,712,118300,13662
152,109,43,1122,149100,13664
287,270,17,-,142600,13665
89,52,37,781,47800,13666
1379,928,451,790,111400,13667
1333,1133,200,872,119500,13668
5966,4394,1572,769,101800,13669
166,150,16,-,61700,13670
178,110,68,1019,92600,13672
714,469,245,798,171300,13673
61,61,0,-,-,13674
16,16,0,-,-,13675
5221,3108,2113,868,148800,13676
19,0,19,-,-,13678
468,410,58,-,200600,13679
446,386,60,625,134600,13680
382,315,67,1214,72800,13681
299,251,48,967,215600,13682
19,0,19,-,-,13683
458,395,63,800,111200,13684
1061,638,423,1364,286300,13685
195,190,5,-,165600,13687
272,225,47,731,81900,13690
1173,872,301,985,158700,13691
80,74,6,-,291300,13692
160,155,5,-,212500,13693
526,416,110,718,207500,13694
48,48,0,-,233300,13695
89,36,53,-,-,13696
850,684,166,1103,144900,13697
0,0,0,-,-,13699
1280,940,340,811,119500,13730
548,478,70,1000,270000,13731
3056,2636,420,984,182400,13732
2315,2043,272,828,122200,13733
909,858,51,1306,134400,13734
793,715,78,1042,138300,13736
8,8,0,-,-,13738
341,280,61,1438,169700,13739
252,229,23,783,350800,13740
1294,998,296,879,159100,13743
425,376,49,904,119200,13744
1061,900,161,789,133900,13746
0,0,0,-,-,13747
1735,1334,401,1055,133900,13748
235,223,12,788,168500,13750
93,93,0,-,213000,13751
364,276,88,1057,237500,13752
1854,1284,570,955,213400,13753
1205,964,241,753,126400,13754
346,255,91,742,166800,13755
295,251,44,1660,148900,13756
511,428,83,1345,209600,13757
19350,12548,6802,883,150700,13760
95,91,4,-,131900,13774
794,647,147,747,178900,13775
170,140,30,1118,150000,13776
166,150,16,975,215000,13777
2244,1639,605,756,161700,13778
330,294,36,-,124100,13780
316,247,69,873,237700,13782
1036,795,241,1029,152800,13783
142,99,43,1116,-,13784
214,199,15,-,145800,13786
1366,1158,208,678,132900,13787
413,332,81,740,222000,13788
8388,4556,3832,985,117300,13790
1497,1207,290,941,139700,13795
401,304,97,932,144400,13796
808,623,185,695,114400,13797
684,591,93,918,148400,13801
605,479,126,-,78900,13802
1505,1267,238,798,134300,13803
110,82,28,1192,129500,13804
66,66,0,-,187500,13806
471,388,83,838,167600,13807
586,469,117,673,157000,13808
670,543,127,872,178900,13809
510,408,102,788,218900,13810
1716,1476,240,921,131500,13811
912,737,175,1189,135700,13812
308,299,9,-,183500,13813
8,8,0,-,-,13814
5554,3638,1916,835,127200,13815
8156,5225,2931,983,176300,13820
1232,942,290,890,183500,13825
39,33,6,-,-,13826
4770,3292,1478,901,142600,13827
1981,1673,308,836,116500,13830
193,181,12,-,136200,13832
1479,1141,338,1020,122700,13833
65,56,9,-,-,13834
527,434,93,732,105000,13835
1705,857,848,815,118200,13838
528,473,55,850,108900,13839
188,142,46,1125,115000,13841
218,206,12,900,218200,13842
738,658,80,909,165800,13843
195,169,26,1550,89800,13844
145,126,19,-,215400,13846
12,12,0,-,-,13847
1897,1532,365,830,120800,13849
9392,7286,2106,1111,185700,13850
2748,2026,722,764,144100,13856
48,32,16,-,-,13859
87,65,22,-,-,13860
292,168,124,-,183100,13861
1468,1098,370,833,138400,13862
177,163,14,822,103500,13863
763,520,243,821,133300,13864
2584,2256,328,765,162000,13865
8641,4780,3861,806,152800,13901
0,0,0,-,-,13902
7858,5234,2624,863,144700,13903
3644,2287,1357,884,111200,13904
11572,5675,5897,993,137700,13905
3994,3175,819,744,221000,14001
4235,3617,618,754,236300,14004
643,564,79,988,172600,14005
4153,3662,491,956,154800,14006
632,490,142,559,190200,14008
2727,2123,604,802,157600,14009
2185,1733,452,775,173900,14011
1132,1001,131,742,166100,14012
631,530,101,935,152800,14013
10371,6636,3735,915,148100,14020
620,523,97,735,138100,14024
1529,1334,195,950,237400,14025
307,245,62,2197,201100,14026
57,40,17,-,185000,14027
670,602,68,981,169700,14028
19,17,2,-,-,14029
743,622,121,743,204100,14030
4129,3303,826,930,324700,14031
3786,3474,312,1837,483500,14032
660,576,84,1077,293400,14033
789,693,96,921,150100,14034
26,26,0,-,-,14035
2396,2045,351,923,184400,14036
382,340,42,-,260200,14037
49,39,10,-,158800,14039
600,576,24,-,217600,14040
86,55,31,1042,-,14041
1819,1366,453,865,105800,14042
11224,7901,3323,1072,192800,14043
2571,2076,495,964,180800,14047
6775,4256,2519,905,98400,14048
8211,6606,1605,1840,386500,14051
7090,6070,1020,992,312000,14052
555,421,134,885,164900,14054
682,605,77,817,177700,14055
104,104,0,-,-,14056
3090,2755,335,837,237800,14057
865,758,107,1006,142800,14058
3630,3043,587,1316,323800,14059
167,146,21,-,97900,14060
36,31,5,-,157500,14061
1330,1127,203,1035,121600,14062
5309,3481,1828,852,178500,14063
670,606,64,471,138500,14065
471,422,49,706,131000,14066
1750,1573,177,814,178400,14067
3189,2118,1071,1546,348400,14068
251,197,54,-,212100,14069
2216,1666,550,740,100600,14070
8874,7058,1816,1222,302800,14072
19527,14478,5049,1129,246100,14075
1931,1598,333,748,255700,14080
1085,900,185,888,126700,14081
175,174,1,-,276600,14082
10,10,0,-,-,14083
3044,2978,66,-,274700,14085
15124,12631,2493,983,263600,14086
522,444,78,1732,240800,14091
4997,3598,1399,979,246300,14092
21548,15519,6029,869,186100,14094
1124,905,219,869,145100,14098
769,670,99,1050,104400,14101
655,607,48,-,244000,14102
4464,3212,1252,911,127100,14103
1917,1587,330,594,154900,14105
2165,1804,361,853,146100,14108
0,0,0,-,-,14109
1302,972,330,903,177400,14111
12,12,0,-,-,14112
282,247,35,-,157000,14113
19314,13821,5493,932,205300,14120
1449,927,522,858,137800,14125
94,72,22,-,290400,14126
13050,9574,3476,1196,328700,14127
467,410,57,1056,120300,14129
40,33,7,-,81700,14130
2007,1754,253,856,204800,14131
2266,2017,249,950,259000,14132
30,30,0,-,105000,14134
53,45,8,-,-,14135
2257,1829,428,928,143700,14136
790,558,232,829,114200,14138
837,751,86,850,242600,14139
3216,2468,748,738,195800,14141
482,410,72,728,177400,14143
535,442,93,786,192700,14145
19397,13743,5654,1094,181900,14150
75,75,0,-,139200,14166
840,740,100,710,138600,14167
39,39,0,-,103100,14168
74,74,0,-,"10,000-",14169
841,719,122,950,295400,14170
791,745,46,639,145500,14171
1375,1171,204,786,179800,14172
87,87,0,-,-,14173
2425,1876,549,1152,235400,14174
5954,1200,4754,953,327900,14201
2204,539,1665,709,495800,14202
1690,44,1646,1167,-,14203
4326,1292,3034,814,151700,14204
9584,5892,3692,886,111600,14206
10356,3517,6839,943,111200,14207
4667,2551,2116,932,118900,14208
4186,1429,2757,1025,408600,14209
7140,3270,3870,925,124300,14210
9685,4328,5357,1008,91600,14211
4924,2584,2340,829,89900,14212
9305,3476,5829,1059,192300,14213
8422,3600,4822,1072,234600,14214
17139,8178,8961,993,102800,14215
11859,5496,6363,1152,260700,14216
10855,7283,3572,970,193200,14217
8755,4832,3923,829,135000,14218
5298,3954,1344,928,181800,14219
10297,7382,2915,974,180200,14220
24193,17956,6237,1560,298500,14221
6817,2598,4219,1168,408100,14222
10247,8303,1944,976,202200,14223
18448,14017,4431,1077,219800,14224
15739,11544,4195,937,154500,14225
12614,9134,3480,1093,237500,14226
10075,6661,3414,1084,190400,14227
10119,5470,4649,1264,246100,14228
0,0,0,-,-,14260
0,0,0,-,-,14261
5924,2554,3370,722,79200,14301
115,0,115,-,-,14302
2871,1401,1470,845,78200,14303
12915,9477,3438,901,151500,14304
7253,4420,2833,798,109200,14305
5052,3691,1361,888,108500,14411
14,14,0,-,-,14413
2859,2078,781,926,189700,14414
42,28,14,1393,81400,14415
1505,1316,189,868,167200,14416
450,409,41,846,196300,14418
7657,4807,2850,951,178600,14420
638,571,67,832,147200,14422
2046,1605,441,1010,181800,14423
12896,8334,4562,1228,250400,14424
5186,3741,1445,1512,222500,14425
872,661,211,721,115600,14427
3306,2806,500,1060,215100,14428
2126,1700,426,696,150900,14432
1640,1315,325,773,101000,14433
1093,971,122,1113,211100,14435
3983,3261,722,877,119300,14437
108,88,20,913,115200,14441
3486,2152,1334,1130,151200,14445
18398,14255,4143,1258,281000,14450
0,0,0,-,-,14453
3432,1874,1558,1000,217900,14454
8183,5233,2950,967,166700,14456
264,230,34,900,214500,14462
122,122,0,-,147700,14463
2650,2310,340,916,142300,14464
643,617,26,675,197700,14466
4490,3114,1376,1139,212000,14467
6981,6167,814,1160,213900,14468
2623,2178,445,874,188700,14469
3333,2756,577,775,139900,14470
1339,1068,271,1164,171600,14471
3466,2700,766,1055,330100,14472
105,105,0,-,355700,14475
946,819,127,963,162800,14476
666,589,77,925,165600,14477
340,285,55,961,391900,14478
31,31,0,-,-,14479
266,232,34,889,-,14480
802,696,106,893,153500,14481
3705,2804,901,944,159600,14482
1601,1311,290,809,198700,14485
133,73,60,-,177300,14486
2260,1927,333,786,211200,14487
2672,1962,710,966,101100,14489
4607,3844,763,999,219200,14502
710,570,140,1188,106500,14504
2095,1754,341,536,178800,14505
434,390,44,1577,296000,14506
472,440,32,1607,160400,14507
1940,1523,417,806,97800,14510
168,150,18,-,-,14511
2016,1738,278,858,172000,14512
5876,4074,1802,1027,133500,14513
2589,1633,956,1507,217200,14514
93,93,0,-,85300,14515
829,726,103,1303,142100,14516
1147,854,293,835,118800,14517
5082,4283,799,927,222200,14519
1186,943,243,875,150400,14521
4023,3049,974,940,148500,14522
1028,914,114,805,154200,14525
7857,6513,1344,1168,256600,14526
4836,3498,1338,758,199800,14527
35,26,9,-,-,14529
2415,1660,755,745,131900,14530
1680,1425,255,1139,159700,14532
707,473,234,866,190100,14533
12699,11447,1252,1676,343800,14534
307,192,115,912,102900,14536
126,114,12,-,138800,14537
47,41,6,-,161800,14539
845,573,272,1200,223700,14541
20,20,0,-,-,14542
1368,1321,47,-,242500,14543
925,623,302,1207,184800,14544
54,54,0,-,88300,14545
1989,1242,747,1260,173800,14546
1572,1218,354,959,146600,14548
148,148,0,-,-,14549
571,450,121,731,107700,14550
2344,1835,509,845,123600,14551
604,527,77,-,234700,14555
0,0,0,-,-,14556
49,49,0,-,111100,14557
7136,5574,1562,1150,218900,14559
1069,881,188,1120,181700,14560
943,868,75,1153,197400,14561
6762,5356,1406,1431,337800,14564
2593,2471,122,924,192400,14568
2953,1945,1008,872,149300,14569
408,408,0,-,158900,14571
1795,1505,290,840,110200,14572
23728,17016,6712,1387,253000,14580
107,79,28,-,-,14585
4795,3646,1149,1562,254900,14586
0,0,0,-,-,14588
3093,2531,562,815,173500,14589
2330,1859,471,758,93900,14590
634,564,70,781,156300,14591
57,57,0,-,160100,14592
1952,64,1888,1253,705100,14604
4454,1121,3333,815,81000,14605
10907,6799,4108,978,150500,14606
10936,1843,9093,1129,304100,14607
5964,1343,4621,898,180300,14608
17784,11053,6731,1122,144500,14609
7233,3935,3298,1181,238200,14610
7246,2360,4886,1024,77900,14611
15328,11071,4257,1069,187500,14612
5713,1745,3968,939,108200,14613
140,4,136,1431,-,14614
7880,4224,3656,1065,121900,14615
11518,7937,3581,1087,136100,14616
9300,8005,1295,1197,179100,14617
8614,6589,2025,1407,301300,14618
5376,3276,2100,1238,112500,14619
11956,3434,8522,1193,197700,14620
13090,4415,8675,989,83300,14621
5848,4738,1110,1032,160400,14622
8877,4522,4355,1221,167800,14623
15421,12348,3073,1249,172200,14624
4834,4084,750,1442,233000,14625
12945,8834,4111,1206,185300,14626
0,0,0,-,-,14627
0,0,0,-,-,14642
17004,9844,7160,769,98400,14701
2576,2067,509,789,170300,14706
58,43,15,-,46600,14707
48,48,0,-,58200,14708
525,448,77,813,78900,14709
1287,1136,151,582,152800,14710
628,527,101,530,88900,14711
1477,1337,140,775,219000,14712
195,180,15,681,190600,14714
985,737,248,756,73500,14715
714,476,238,760,107500,14716
327,309,18,668,149000,14717
726,649,77,926,99100,14718
1399,1082,317,712,107600,14719
346,173,173,924,61300,14720
87,66,21,1086,139300,14721
133,102,31,-,732100,14722
430,400,30,842,101900,14723
953,855,98,719,163500,14724
605,513,92,1038,100900,14726
2083,1634,449,785,107600,14727
364,298,66,1084,165900,14728
380,315,65,879,177700,14729
576,435,141,908,255200,14731
13,8,5,-,-,14732
1413,1022,391,675,102000,14733
916,776,140,806,103700,14735
84,74,10,-,187500,14736
1697,1486,211,806,99900,14737
1390,1191,199,884,130300,14738
1030,858,172,889,65900,14739
470,363,107,1208,116100,14740
813,765,48,-,126500,14741
59,31,28,-,116800,14742
839,626,213,749,95200,14743
442,287,155,933,146100,14744
861,656,205,642,90400,14747
232,186,46,581,88600,14748
1954,1269,685,1145,158400,14750
77,77,0,-,175900,14752
436,319,117,692,75900,14753
294,246,48,619,70500,14754
1154,876,278,694,116100,14755
0,0,0,-,-,14756
1338,1053,285,677,179400,14757
7987,4876,3111,777,99400,14760
792,676,116,736,128800,14767
322,276,46,632,162000,14769
1242,1044,198,706,103100,14770
1671,1459,212,682,112800,14772
70,50,20,963,77500,14774
898,698,200,628,103400,14775
169,153,16,-,83500,14777
0,0,0,-,-,14778
2851,1664,1187,713,82700,14779
753,617,136,810,126700,14781
901,730,171,711,109800,14782
49,40,9,-,-,14783
352,275,77,633,126000,14784
0,0,0,-,-,14785
2338,1690,648,685,116100,14787
26,10,16,-,-,14788
1922,1558,364,815,111200,14801
583,309,274,800,169100,14802
574,461,113,830,138900,14803
542,487,55,969,113900,14804
339,313,26,838,131300,14805
769,634,135,773,88800,14806
1168,1046,122,903,119400,14807
240,219,21,-,75300,14808
993,742,251,924,110200,14809
5351,3707,1644,737,113300,14810
1221,1087,134,883,120200,14812
953,783,170,688,89900,14813
737,602,135,1385,216800,14814
321,268,53,852,150000,14815
225,210,15,-,111100,14816
1301,776,525,1429,218500,14817
815,714,101,1435,197100,14818
234,179,55,1321,83600,14819
215,177,38,871,118800,14820
1143,978,165,1083,133200,14821
360,311,49,979,84000,14822
1439,1154,285,764,112700,14823
309,262,47,1426,145000,14824
332,241,91,694,155500,14825
847,753,94,742,115800,14826
0,0,0,-,-,14827
8493,5622,2871,997,168100,14830
483,460,23,771,100000,14836
2030,1659,371,717,137700,14837
834,769,65,725,130900,14838
250,212,38,850,109700,14839
1203,1050,153,754,223200,14840
352,246,106,1068,297300,14841
306,210,96,851,-,14842
5540,3361,2179,766,104300,14843
8890,6551,2339,1175,183900,14845
355,322,33,636,126300,14846
929,767,162,1125,202000,14847
28527,12600,15927,1446,334800,14850
0,0,0,-,-,14853
58,58,0,-,-,14854
300,247,53,638,114200,14855
0,0,0,-,-,14856
525,464,61,1010,142800,14858
414,376,38,1300,144200,14859
480,307,173,682,152800,14860
556,451,105,1120,141100,14861
522,478,44,-,125000,14864
1020,767,253,740,135300,14865
2304,1777,527,1163,163800,14867
446,335,111,915,151900,14869
4157,3112,1045,1128,164000,14870
1829,1576,253,1069,169800,14871
254,167,87,731,-,14872
777,678,99,967,118100,14873
56,45,11,1607,132500,14874
219,172,47,688,114900,14877
248,238,10,-,170700,14878
861,721,140,903,110300,14879
700,620,80,675,110200,14880
86,28,58,936,-,14881
1576,1196,380,1348,274800,14882
1849,1332,517,980,191800,14883
160,148,12,940,116900,14884
264,216,48,906,141300,14885
2945,2364,581,1041,243500,14886
535,449,86,917,138100,14889
2057,1296,761,775,146300,14891
3346,2344,1002,911,139500,14892
6,6,0,-,-,14893
480,392,88,1067,83600,14894
3819,2891,928,645,93800,14895
300,249,51,621,64000,14897
521,396,125,740,119000,14898
5550,2950,2600,835,90300,14901
3071,2053,1018,943,123900,14903
6419,4111,2308,1005,87200,14904
3859,2617,1242,1112,169600,14905
14293,10958,3335,1014,178300,15001
5220,3255,1965,886,119000,15003
149,141,8,-,107900,15004
4127,3587,540,726,207800,15005
19,3,16,-,-,15006
108,69,39,-,-,15007
6739,5126,1613,725,245400,15009
11476,8355,3121,833,196600,15010
6894,5141,1753,814,187500,15012
1562,1097,465,763,87700,15014
508,506,2,-,481800,15015
7922,5753,2169,1099,238600,15017
344,316,28,-,79300,15018
572,498,74,615,152900,15019
221,221,0,-,260500,15020
2830,2272,558,796,179800,15021
4081,2918,1163,785,113000,15022
3751,3038,713,1078,217000,15024
6701,5043,1658,1097,234600,15025
1737,1364,373,1207,248100,15026
1082,721,361,906,176600,15027
88,84,4,-,87600,15028
479,288,191,894,78700,15030
170,98,72,923,113500,15031
2368,1349,1019,842,58200,15033
844,450,394,635,98300,15034
980,670,310,741,80000,15035
4242,3614,628,912,163800,15037
113,36,77,-,92300,15038
3442,2916,526,1598,231800,15042
748,633,115,985,220300,15043
10807,10104,703,1196,372700,15044
1869,1195,674,844,82400,15045
1026,914,112,1083,181900,15046
89,89,0,-,122900,15047
473,391,82,1046,128900,15049
897,833,64,1331,216700,15050
223,164,59,1117,158300,15051
1246,1057,189,1024,179000,15052
41,41,0,-,170500,15053
266,187,79,-,136600,15054
677,617,60,1292,229700,15055
550,292,258,990,135000,15056
6351,5606,745,1032,331100,15057
1598,988,610,761,124500,15059
386,326,60,758,124100,15060
5309,3634,1675,955,199400,15061
3182,2324,858,678,87100,15062
4612,3690,922,862,149000,15063
131,67,64,1330,-,15064
5016,3893,1123,770,147200,15065
5425,3655,1770,771,138700,15066
1103,831,272,729,106100,15067
16425,11913,4512,749,166000,15068
5157,3754,1403,1476,249300,15071
55,0,55,-,-,15072
3922,2675,1247,748,131400,15074
20,12,8,-,-,15075
364,219,145,696,136900,15076
85,68,17,1313,152800,15077
201,123,78,-,134300,15078
174,130,44,1050,125000,15081
65,65,0,-,181300,15082
535,480,55,768,147700,15083
4468,3406,1062,741,111500,15084
3407,3005,402,970,193700,15085
287,186,101,1193,300000,15086
41,31,10,-,211300,15087
164,128,36,806,76600,15088
2924,2204,720,690,163900,15089
9291,7374,1917,1778,455800,15090
10745,8300,2445,1211,315500,15101
13512,10686,2826,1220,260700,15102
3748,1669,2079,642,56700,15104
9396,6247,3149,990,190700,15106
17191,12545,4646,1161,255200,15108
2101,918,1183,725,57500,15110
1529,656,873,777,89100,15112
5852,5033,819,1064,251100,15116
8334,5171,3163,835,118900,15120
8359,6404,1955,795,131400,15122
0,0,0,-,-,15123
3061,2416,645,833,214600,15126
4526,3521,1005,1341,236900,15129
4057,2898,1159,999,147700,15131
8730,4266,4464,791,71300,15132
2820,2221,599,923,89000,15133
2012,1608,404,1113,198000,15135
10393,6541,3852,1077,190100,15136
4769,3334,1435,869,115300,15137
3303,1920,1383,1125,317700,15139
1376,494,882,765,68600,15140
797,492,305,1757,601300,15142
8611,6988,1623,1356,434900,15143
1880,1320,560,906,140100,15144
2966,1298,1668,818,98400,15145
12316,8446,3870,1163,197500,15146
7765,5304,2461,1010,135800,15147
1118,494,624,799,61700,15148
6937,3859,3078,1538,257300,15201
9579,4915,4664,955,197900,15202
6062,2411,3651,1458,251900,15203
3469,2378,1091,1035,109800,15204
11518,6069,5449,1166,171500,15205
14475,6048,8427,1284,288300,15206
4807,3144,1663,1041,133400,15207
4203,2077,2126,1020,273200,15208
5602,4218,1384,1042,218300,15209
10604,5839,4765,994,91800,15210
5936,2756,3180,1355,207200,15211
14033,6889,7144,1114,167200,15212
9120,2342,6778,1243,247500,15213
6277,4039,2238,1054,173500,15214
5293,3872,1421,1089,303400,15215
10029,6284,3745,1078,193700,15216
11661,6069,5592,1412,431600,15217
6759,3768,2991,1114,203200,15218
5678,1200,4478,894,193100,15219
9134,4938,4196,1190,216400,15220
15027,6706,8321,954,157100,15221
2969,437,2532,1963,557800,15222
3392,2145,1247,1000,154800,15223
5531,1990,3541,1191,240600,15224
559,295,264,913,165800,15225
6242,4374,1868,1166,174900,15226
12809,9340,3469,875,175400,15227
7262,5104,2158,1130,363400,15228
6455,4689,1766,1120,232200,15229
6101,1620,4481,1388,522000,15232
1431,684,747,1032,305600,15233
6229,4512,1717,1004,199700,15234
15590,11410,4180,1048,132800,15235
13352,10279,3073,1087,224200,15236
18314,14189,4125,1327,306900,15237
5649,4372,1277,1189,452300,15238
8351,6915,1436,1182,214700,15239
8266,6887,1379,1713,390200,15241
5804,5030,774,1356,270700,15243
0,0,0,-,-,15260
0,0,0,-,-,15275
0,0,0,-,-,15282
0,0,0,-,-,15290
21738,14521,7217,927,205800,15301
117,99,18,983,152100,15310
408,381,27,-,261600,15311
1461,1171,290,914,206200,15312
162,155,7,-,152500,15313
1383,1048,335,621,164700,15314
355,296,59,1103,56100,15315
86,78,8,-,112500,15316
17654,14235,3419,1180,329600,15317
2042,1729,313,688,147600,15320
710,568,142,1610,309500,15321
703,622,81,845,96800,15322
1564,1272,292,734,197000,15323
310,215,95,996,-,15324
165,105,60,-,-,15325
502,402,100,923,105200,15327
561,458,103,909,239900,15329
2266,2078,188,981,338800,15330
345,225,120,1039,93500,15331
3675,3148,527,915,192600,15332
735,598,137,802,206500,15333
61,52,9,-,218800,15334
207,178,29,736,206800,15337
611,524,87,1000,96700,15338
561,495,66,769,323200,15340
247,183,64,475,138300,15341
2270,1904,366,1067,251000,15342
709,623,86,-,146300,15344
653,564,89,1094,141200,15345
282,234,48,1027,88000,15346
143,116,27,-,173800,15347
43,43,0,-,-,15348
675,520,155,676,198100,15349
244,109,135,655,72000,15350
458,282,176,-,92600,15351
341,289,52,-,140300,15352
26,26,0,-,243300,15353
681,594,87,1043,163900,15357
384,275,109,901,108200,15358
67,45,22,935,138300,15359
629,572,57,728,228500,15360
46,46,0,-,124000,15361
272,231,41,575,156500,15362
274,204,70,807,169800,15363
290,253,37,684,183800,15364
61,53,8,-,121900,15365
271,125,146,-,227300,15366
3367,3127,240,1068,556100,15367
163,96,67,948,58400,15368
4984,3456,1528,687,182700,15370
570,459,111,963,203700,15376
306,256,50,1063,225400,15377
0,0,0,-,-,15378
22,22,0,-,107500,15379
293,241,52,515,118800,15380
14048,8992,5056,761,151600,15401
388,359,29,-,-,15410
282,249,33,900,205800,15411
96,64,32,-,89500,15412
199,108,91,-,34000,15413
197,160,37,-,297200,15416
3488,2398,1090,693,100500,15417
1075,364,711,804,121600,15419
108,75,33,-,-,15420
49,49,0,-,229900,15421
130,64,66,871,-,15422
735,610,125,983,171700,15423
954,735,219,700,131800,15424
8013,5633,2380,697,129000,15425
442,358,84,897,167200,15427
719,581,138,860,122900,15428
174,168,6,-,63300,15429
107,101,6,-,81900,15430
1826,1505,321,795,105800,15431
165,118,47,1156,99100,15432
352,293,59,-,127600,15433
128,95,33,967,129700,15434
62,62,0,-,-,15435
1036,659,377,739,134600,15436
741,472,269,1168,217900,15437
840,694,146,734,117800,15438
96,96,0,-,116900,15440
1077,795,282,1041,98700,15442
123,40,83,-,45900,15443
233,201,32,-,132800,15444
1221,1018,203,1069,171600,15445
35,35,0,-,-,15446
55,55,0,-,28000,15447
76,76,0,-,81600,15448
292,276,16,-,-,15449
142,142,0,-,117500,15450
293,220,73,640,69300,15451
87,42,45,-,-,15454
129,129,0,-,-,15455
1071,928,143,673,110300,15456
883,659,224,1357,115000,15458
635,439,196,772,181500,15459
38,36,2,-,76700,15460
1435,1095,340,471,114000,15461
24,24,0,-,-,15462
98,89,9,-,43000,15463
621,542,79,993,115000,15464
252,252,0,-,115300,15465
190,171,19,-,74600,15466
46,42,4,-,67100,15467
1003,733,270,788,89900,15468
1009,816,193,767,131000,15469
318,293,25,-,260100,15470
46,0,46,-,-,15472
1524,1288,236,784,191200,15473
804,587,217,885,115400,15474
391,183,208,904,91000,15475
23,13,10,-,-,15476
352,309,43,950,110300,15477
2423,1970,453,822,145700,15478
901,646,255,1023,215700,15479
683,521,162,1008,115400,15480
244,142,102,754,137000,15482
170,121,49,750,108800,15483
250,241,9,-,-,15484
955,823,132,916,154200,15486
44,44,0,-,-,15488
69,69,0,-,84000,15489
178,178,0,-,257700,15490
41,27,14,-,86100,15492
6646,4642,2004,731,162300,15501
57,47,10,-,454200,15502
0,0,0,-,-,15510
80,80,0,-,107700,15520
734,670,64,1056,192700,15521
4948,3633,1315,805,197900,15522
2036,1569,467,779,145700,15530
1628,1266,362,680,122900,15531
56,43,13,656,77400,15532
545,400,145,755,178800,15533
386,307,79,648,152200,15534
764,638,126,758,187300,15535
176,143,33,653,194600,15536
3462,2558,904,763,171000,15537
300,252,48,688,163400,15538
149,132,17,-,142600,15539
159,140,19,-,178600,15540
1304,1173,131,819,157500,15541
449,410,39,746,105400,15542
135,119,16,-,114700,15544
1088,868,220,717,118900,15545
201,198,3,-,61600,15546
236,193,43,858,203900,15547
693,533,160,638,160600,15550
232,194,38,725,164800,15551
2079,1649,430,681,128800,15552
1044,864,180,444,191100,15554
39,39,0,-,81700,15555
1370,1130,240,697,123900,15557
675,505,170,792,123800,15558
973,728,245,1017,230300,15559
55,51,4,725,94200,15560
58,48,10,-,115000,15561
83,66,17,1138,143800,15562
1086,924,162,615,119400,15563
45,27,18,631,112500,15564
11,11,0,-,-,15565
24293,18020,6273,868,209400,15601
1820,1549,271,846,221200,15610
107,81,26,777,131300,15611
236,185,51,-,127100,15612
5330,4411,919,870,167800,15613
91,91,0,-,136300,15615
206,197,9,-,312100,15616
125,110,15,789,123100,15617
1076,878,198,729,115000,15618
200,172,28,-,-,15619
253,185,68,1007,133200,15620
507,445,62,-,228600,15622
390,309,81,-,192800,15623
254,185,69,-,-,15624
48,48,0,-,-,15625
2591,1769,822,787,228100,15626
2716,2163,553,815,149900,15627
206,142,64,-,156600,15628
303,206,97,942,67400,15629
303,175,128,925,79400,15631
3670,3071,599,1120,278100,15632
194,194,0,-,268200,15633
239,155,84,795,92900,15634
115,28,87,627,-,15635
1483,1267,216,-,351400,15636
760,638,122,1149,257000,15637
34,0,34,-,-,15638
935,601,334,1482,203400,15639
121,91,30,-,88900,15640
207,144,63,815,123000,15641
19426,16478,2948,960,236000,15642
8536,6601,1935,860,160100,15644
84,79,5,-,-,15646
8,0,8,-,-,15647
11604,8429,3175,824,175500,15650
201,122,79,848,146400,15655
4155,3311,844,724,155100,15656
3771,3204,567,1006,234600,15658
61,31,30,-,118100,15660
344,274,70,1643,144100,15661
363,363,0,-,112600,15662
191,170,21,675,215000,15663
545,533,12,-,179400,15665
7140,5632,1508,802,154700,15666
5670,5327,343,1303,315000,15668
1366,1203,163,821,189500,15670
288,191,97,996,-,15671
1481,1036,445,1031,235800,15672
571,484,87,870,130800,15673
102,83,19,-,183400,15674
426,355,71,883,106700,15675
236,193,43,-,274300,15676
222,196,26,-,223500,15677
183,153,30,-,96700,15678
1311,1164,147,975,188100,15679
150,142,8,-,72300,15680
1844,1528,316,928,131800,15681
88,83,5,-,140600,15682
3659,2575,1084,677,136400,15683
128,103,25,993,104000,15684
475,464,11,-,205600,15686
543,467,76,557,203000,15687
253,238,15,-,88900,15688
28,21,7,-,-,15689
3912,2463,1449,807,113100,15690
97,97,0,-,222500,15691
389,318,71,-,153800,15692
96,96,0,-,105300,15693
101,101,0,-,141400,15695
104,79,25,917,121900,15696
1427,860,567,826,158900,15697
355,221,134,789,120600,15698
13245,7729,5516,799,175100,15701
0,0,0,-,-,15705
103,74,29,-,86700,15710
149,119,30,923,104000,15711
51,48,3,-,-,15712
41,41,0,-,-,15713
2043,1506,537,522,94700,15714
224,150,74,860,102000,15715
232,161,71,418,55600,15716
4064,3053,1011,685,154500,15717
108,84,24,920,113900,15720
73,61,12,-,61700,15721
900,836,64,621,128800,15722
10,10,0,-,-,15723
814,701,113,731,108700,15724
556,426,130,543,159700,15725
78,66,12,-,70000,15727
1345,950,395,836,112100,15728
476,394,82,675,-,15729
71,60,11,-,142100,15730
98,82,16,-,72000,15731
613,529,84,768,162500,15732
37,37,0,-,221600,15733
84,75,9,-,-,15734
181,138,43,732,118100,15736
51,48,3,-,74600,15737
72,70,2,-,48300,15738
138,100,38,929,81000,15739
23,17,6,-,-,15741
339,286,53,739,115300,15742
17,17,0,-,97500,15744
94,90,4,-,52000,15745
53,38,15,-,83300,15746
684,623,61,572,191400,15747
2757,2165,592,837,147000,15748
140,129,11,-,114400,15750
37,32,5,-,70000,15752
175,145,30,800,102300,15753
142,98,44,-,80000,15754
50,36,14,1063,90000,15756
563,474,89,700,101200,15757
1004,773,231,750,164700,15759
42,42,0,-,-,15760
35,18,17,-,50000,15761
346,318,28,1107,209200,15762
16,9,7,-,82500,15763
62,57,5,-,141100,15764
556,466,90,711,186200,15765
5877,4137,1740,823,125700,15767
83,75,8,-,115800,15770
331,296,35,233,151700,15771
546,409,137,892,119200,15772
176,157,19,950,78300,15773
1229,1055,174,771,161400,15774
219,219,0,-,99600,15775
20,17,3,-,-,15776
18,18,0,-,83600,15777
65,64,1,-,70000,15778
89,89,0,-,177300,15779
30,27,3,-,78300,15780
35,33,2,-,-,15781
22,16,6,-,86000,15783
28,25,3,-,151100,15784
8360,6167,2193,854,170200,15801
44,37,7,-,152500,15821
591,502,89,653,140500,15823
2080,1645,435,717,146600,15824
3953,2817,1136,729,150300,15825
130,130,0,-,76500,15827
150,119,31,-,108100,15828
527,428,99,844,125600,15829
20,5,15,-,-,15831
153,115,38,825,119300,15832
2019,1366,653,698,86800,15834
774,590,184,960,118900,15840
91,76,15,-,48000,15841
1390,1086,304,673,74700,15845
1406,1149,257,659,160400,15846
21,16,5,-,72000,15847
404,346,58,880,131800,15848
532,420,112,917,106300,15849
2725,2108,617,665,113400,15851
2727,2091,636,640,108000,15853
398,360,38,838,162900,15856
5747,4368,1379,756,144600,15857
534,445,89,693,147800,15860
55,52,3,-,108300,15861
59,59,0,-,75000,15863
709,552,157,873,144500,15864
538,349,189,546,89400,15865
58,53,5,-,106700,15866
677,598,79,631,132000,15868
536,497,39,617,106800,15870
1953,803,1150,476,19200,15901
5073,3257,1816,684,58400,15902
6659,4836,1823,856,172200,15904
8642,6567,2075,893,118600,15905
4795,3207,1588,567,53000,15906
2040,1682,358,780,105200,15909
265,245,20,940,185100,15920
124,83,41,-,55300,15921
29,26,3,-,57500,15922
612,541,71,-,94100,15923
362,319,43,778,81200,15924
41,34,7,-,80000,15925
1028,895,133,747,105200,15926
277,218,59,-,89500,15927
997,892,105,1338,199400,15928
37,22,15,-,-,15929
178,178,0,-,-,15930
3811,3023,788,857,176400,15931
0,0,0,-,-,15934
1035,957,78,913,95800,15935
625,561,64,463,103900,15936
291,271,20,-,-,15937
909,834,75,850,136700,15938
676,589,87,720,236400,15940
717,650,67,962,185800,15942
1650,1157,493,727,86300,15943
1210,1037,173,671,160200,15944
56,56,0,-,55600,15945
2863,2375,488,635,116100,15946
176,162,14,-,130800,15948
269,240,29,1085,75200,15949
291,221,70,1000,-,15951
513,338,175,-,147300,15952
51,51,0,-,94500,15953
1082,893,189,595,79000,15954
947,877,70,840,123400,15955
1138,1004,134,696,75400,15956
124,120,4,-,101900,15957
866,766,100,805,139100,15958
91,77,14,-,77500,15960
356,286,70,900,91300,15961
119,95,24,714,105400,15962
4444,3597,847,752,120000,15963
18013,12245,5768,864,191400,16001
6420,5506,914,787,256200,16002
434,405,29,950,206900,16020
130,88,42,820,136400,16022
1624,1167,457,1104,249400,16023
106,83,23,1167,149300,16024
1896,1570,326,742,208400,16025
148,107,41,1333,228100,16027
856,611,245,725,156800,16028
358,293,65,900,131000,16029
110,81,29,705,107500,16030
3331,2581,750,1149,307700,16033
808,696,112,850,196300,16034
56,39,17,-,237500,16035
123,83,40,833,168800,16036
1954,1761,193,879,331200,16037
1266,986,280,885,175900,16038
341,294,47,883,168800,16040
738,636,102,958,149200,16041
459,274,185,1060,118800,16045
7123,5926,1197,1713,481400,16046
70,48,22,825,112500,16048
1184,969,215,747,131100,16049
441,354,87,995,123800,16050
1333,1243,90,800,197000,16051
847,777,70,885,233100,16052
1560,1296,264,1288,283200,16053
153,134,19,1050,104300,16054
3487,3186,301,1147,291000,16055
1891,1418,473,886,269600,16056
5157,2834,2323,858,242200,16057
3915,3567,348,-,361100,16059
954,829,125,1080,192500,16061
3506,2363,1143,1166,294100,16063
13753,10457,3296,1619,395900,16066
13177,9081,4096,706,109600,16101
2124,1664,460,948,97900,16102
6638,4999,1639,965,175100,16105
145,132,13,-,106800,16110
382,325,57,1208,163900,16111
560,484,76,909,140900,16112
157,134,23,-,214000,16113
219,194,25,488,169200,16114
1449,1216,233,829,182600,16115
1220,1134,86,541,123300,16116
7370,5724,1646,856,143000,16117
872,728,144,694,166800,16120
2116,1247,869,879,76500,16121
969,873,96,1044,236600,16123
615,484,131,791,165200,16124
7150,5113,2037,773,125700,16125
5349,3976,1373,863,199500,16127
777,647,130,815,152000,16130
365,309,56,893,159600,16131
208,171,37,-,115100,16132
559,499,60,990,180700,16133
1757,1482,275,750,136700,16134
341,256,85,925,101700,16136
4421,3607,814,635,176800,16137
121,101,20,-,95300,16140
737,634,103,675,145000,16141
1911,1441,470,797,214100,16142
796,724,72,727,196700,16143
1172,956,216,765,168000,16145
6023,3154,2869,780,78900,16146
7798,5742,2056,868,186000,16148
3184,2327,857,810,135800,16150
23,18,5,-,91400,16151
963,748,215,834,149100,16153
994,961,33,-,167400,16154
33,0,33,950,-,16155
1241,1043,198,1089,209200,16156
1250,959,291,653,150700,16157
2122,1634,488,800,169700,16159
469,293,176,769,101300,16160
305,171,134,796,64600,16161
0,0,0,-,-,16172
7112,5295,1817,821,166600,16201
240,209,31,583,115100,16210
38,35,3,-,120800,16211
140,130,10,650,77300,16212
56,41,15,758,68800,16213
3322,1606,1716,872,169100,16214
39,37,2,-,235400,16217
415,362,53,445,181800,16218
25,25,0,-,-,16220
1045,938,107,596,136900,16222
32,20,12,-,104200,16223
363,302,61,694,171700,16224
3692,2934,758,829,120100,16226
170,154,16,1313,100000,16228
2208,1699,509,781,206300,16229
195,152,43,775,91400,16230
1639,1258,381,751,129900,16232
478,445,33,-,167300,16233
609,553,56,720,209100,16235
92,74,18,-,83100,16236
180,148,32,700,150000,16238
749,476,273,818,109800,16239
584,478,106,682,151100,16240
1765,1282,483,707,119700,16242
152,111,41,979,90800,16244
124,107,17,597,80200,16245
59,45,14,1063,89200,16246
1307,951,356,670,112700,16248
718,573,145,1026,154900,16249
78,59,19,-,80500,16250
59,27,32,692,128100,16253
1335,1084,251,933,155200,16254
718,538,180,831,130400,16255
411,372,39,880,152100,16256
810,562,248,764,162500,16258
912,753,159,644,136500,16259
132,129,3,-,193800,16260
1220,1030,190,1009,196100,16262
156,118,38,-,117400,16263
6317,4459,1858,809,84800,16301
192,178,14,708,115400,16311
0,0,0,-,-,16312
750,616,134,671,100000,16313
2221,1935,286,744,166300,16314
2191,1713,478,782,161600,16316
561,440,121,1000,117200,16317
473,452,21,692,132500,16319
9,8,1,-,108300,16321
50,46,4,-,-,16322
6247,4442,1805,762,120400,16323
137,106,31,788,222400,16326
987,864,123,730,151700,16327
91,75,16,800,77200,16328
176,141,35,776,94200,16329
56,42,14,-,256300,16331
37,23,14,-,127100,16332
96,94,2,-,71800,16333
210,159,51,596,174300,16334
11114,6694,4420,892,149500,16335
749,671,78,744,120500,16340
791,727,64,695,109700,16341
983,877,106,721,113700,16342
204,177,27,-,110700,16343
164,97,67,1057,57000,16344
1476,1365,111,672,183800,16345
1512,1101,411,766,131800,16346
593,481,112,572,77800,16347
862,743,119,755,178900,16350
702,533,169,499,93100,16351
113,81,32,944,96100,16352
1044,877,167,608,125400,16353
4444,3145,1299,636,97400,16354
520,429,91,613,151800,16360
19,14,5,-,-,16361
425,361,64,625,161300,16362
495,434,61,956,165100,16364
7823,5549,2274,778,118300,16365
95,95,0,-,99300,16370
1277,920,357,676,107500,16371
240,145,95,624,95300,16372
1313,1065,248,753,138800,16373
810,693,117,784,120000,16374
1602,1295,307,636,152100,16401
234,212,22,-,85900,16402
2385,1988,397,663,147600,16403
1246,1043,203,948,141600,16404
232,221,11,-,109900,16405
1283,1036,247,839,163500,16406
4698,3518,1180,694,127900,16407
688,633,55,917,171500,16410
506,402,104,794,144200,16411
4167,2789,1378,883,221900,16412
3720,3422,298,1229,286300,16415
65,65,0,-,324100,16416
3824,2940,884,666,179900,16417
197,186,11,975,95800,16420
930,554,376,809,191700,16421
35,35,0,-,154200,16422
1619,1479,140,806,157800,16423
1933,1591,342,745,128300,16424
1406,1202,204,975,219300,16426
88,71,17,643,113800,16427
4952,3792,1160,758,188100,16428
50,38,12,-,-,16430
1868,1578,290,721,173300,16433
877,753,124,909,138300,16434
726,551,175,868,113300,16435
329,262,67,610,155600,16436
3092,2285,807,743,134400,16438
313,262,51,593,159200,16440
3852,3322,530,950,219800,16441
1113,996,117,1301,193300,16442
444,386,58,1360,168000,16443
0,0,0,-,-,16444
0,0,0,-,-,16475
1245,40,1205,411,-,16501
6892,2353,4539,831,90100,16502
5636,2106,3530,837,55400,16503
6456,4583,1873,966,109600,16504
7434,5572,1862,871,196600,16505
9859,6871,2988,1176,224200,16506
3412,1131,2281,1016,66300,16507
6937,4560,2377,852,121800,16508
12263,8716,3547,1074,207500,16509
10054,7984,2070,796,158700,16510
4573,3372,1201,871,162100,16511
0,0,0,-,-,16546
0,0,0,-,-,16550
0,0,0,-,-,16563
13524,9368,4156,790,138900,16601
11527,7788,3739,842,120200,16602
968,857,111,1034,166600,16611
688,657,31,491,141100,16613
37,28,9,-,141700,16616
1096,812,284,883,133500,16617
117,110,7,-,109100,16619
147,122,25,1268,120800,16620
240,201,39,771,116600,16621
35,30,5,-,166700,16622
189,176,13,-,165500,16623
76,72,4,-,122700,16624
1388,1016,372,887,158600,16625
847,723,124,817,90100,16627
1905,1359,546,657,139700,16630
23,16,7,-,210000,16631
84,71,13,-,89300,16633
130,111,19,1125,91300,16634
5183,4000,1183,1014,186900,16635
336,316,20,1264,163000,16636
1040,884,156,973,115900,16637
26,17,9,788,215600,16638
577,541,36,583,128800,16639
378,358,20,-,125000,16640
993,847,146,685,105300,16641
93,90,3,-,-,16645
866,771,95,603,116400,16646
310,270,40,694,283300,16647
6329,4841,1488,1062,215300,16648
688,574,114,769,152200,16650
1483,1192,291,651,99400,16651
5726,4100,1626,840,198800,16652
11,8,3,-,-,16654
553,443,110,741,161200,16655
504,444,60,698,99600,16656
543,490,53,684,199400,16657
73,45,28,477,158000,16659
374,348,26,-,112700,16661
2197,1692,505,855,212400,16662
691,615,76,838,170500,16664
115,77,38,890,165300,16665
1286,1201,85,1000,110600,16666
516,434,82,814,134900,16667
1475,1156,319,481,111000,16668
834,704,130,775,206500,16669
33,29,4,-,-,16670
189,161,28,788,98100,16671
84,60,24,950,90000,16672
2081,1617,464,850,154700,16673
222,176,46,750,114700,16674
40,38,2,-,71800,16675
115,85,30,-,116000,16677
1077,850,227,641,140600,16678
246,206,40,910,83800,16679
155,140,15,-,89500,16680
109,101,8,-,-,16682
158,145,13,1656,229200,16683
77,68,9,-,-,16684
106,99,7,-,225000,16685
5240,3823,1417,806,166500,16686
136,125,11,-,176600,16689
144,140,4,-,238200,16691
324,269,55,1056,112500,16692
1533,1238,295,671,151700,16693
99,94,5,-,125000,16694
327,274,53,1008,163300,16695
0,0,0,-,-,16699
6800,5250,1550,758,97600,16701
513,431,82,784,92800,16720
26,23,3,-,97500,16724
53,40,13,-,110200,16725
258,239,19,1375,129200,16726
59,21,38,-,85000,16727
294,244,50,803,98200,16729
16,16,0,-,-,16730
1131,915,216,643,101800,16731
133,123,10,-,56500,16732
69,54,15,-,81700,16733
74,56,18,1068,53900,16734
2685,1980,705,773,88000,16735
457,395,62,845,117300,16738
350,313,37,707,75200,16740
1550,1149,401,756,116100,16743
82,61,21,-,118100,16744
299,296,3,-,104400,16745
470,408,62,660,95600,16746
1079,816,263,744,102700,16748
1518,1259,259,782,115000,16749
223,213,10,-,81200,16750
17166,7494,9672,1221,400400,16801
66,0,66,-,-,16802
10590,4667,5923,1363,395800,16803
437,376,61,-,258100,16820
58,58,0,-,115800,16821
773,664,109,691,195600,16822
11168,7905,3263,1013,258100,16823
145,109,36,-,116300,16825
219,169,50,877,183800,16826
2182,1728,454,1230,418800,16827
2044,1754,290,993,275800,16828
275,215,60,730,178100,16829
5968,3846,2122,745,119900,16830
121,114,7,-,163600,16832
2226,1840,386,670,120700,16833
258,242,16,-,229700,16834
92,73,19,-,136300,16835
505,457,48,967,122000,16836
63,63,0,-,-,16837
777,605,172,871,121700,16838
161,156,5,-,147600,16839
123,107,16,-,77700,16840
2279,1917,362,987,207100,16841
89,63,26,-,-,16843
990,917,73,913,222300,16844
283,264,19,700,140000,16845
97,57,40,-,142800,16847
102,91,11,-,159300,16848
55,55,0,-,-,16849
404,251,153,-,367100,16851
75,49,26,740,176600,16852
168,101,67,1019,131700,16853
324,269,55,921,221300,16854
39,31,8,-,113500,16855
90,49,41,-,-,16856
1775,1521,254,692,165900,16858
220,206,14,-,134300,16859
275,275,0,-,-,16860
144,139,5,-,242500,16861
262,208,54,831,95000,16863
45,45,0,-,-,16864
756,585,171,-,252900,16865
3647,2426,1221,681,136900,16866
509,494,15,-,311800,16868
2781,2467,314,924,392800,16870
15,6,9,-,112500,16871
429,324,105,925,197200,16872
509,428,81,878,168400,16874
1439,1243,196,905,273100,16875
96,81,15,950,85000,16876
665,597,68,1048,288300,16877
746,637,109,983,120800,16878
136,119,17,-,93800,16879
908,836,72,870,105500,16881
177,158,19,-,250000,16882
4354,3309,1045,863,210500,16901
28,16,12,825,98300,16910
103,99,4,-,145200,16911
853,620,233,990,135800,16912
903,767,136,983,225400,16914
2372,1832,540,805,174400,16915
553,420,133,930,161000,16917
717,535,182,864,136700,16920
268,236,32,763,188200,16921
759,573,186,902,160700,16922
582,511,71,763,167100,16923
1288,1066,222,888,185400,16925
322,259,63,967,186300,16926
225,196,29,840,137500,16927
559,415,144,897,117200,16928
1003,796,207,842,155300,16929
475,372,103,883,210400,16930
247,217,30,-,265800,16932
2703,1679,1024,783,200600,16933
474,412,62,-,194800,16935
869,691,178,932,166600,16936
60,60,0,-,-,16937
352,317,35,838,187500,16938
81,64,17,850,93600,16939
10,3,7,-,-,16940
32,32,0,-,110000,16941
317,258,59,817,132700,16942
183,160,23,893,162500,16943
1067,888,179,888,157000,16946
1701,1250,451,703,165900,16947
616,492,124,619,145500,16948
1363,1111,252,653,121600,16950
165,139,26,725,181700,17002
4265,3349,916,1088,242200,17003
1648,1192,456,717,198500,17004
127,109,18,792,144100,17005
347,259,88,993,168000,17006
2217,1755,462,920,370500,17007
739,550,189,742,132400,17009
62,26,36,-,-,17010
14430,10086,4344,1270,261900,17011
15174,9348,5826,1018,221800,17013
53,53,0,-,166900,17014
9646,7932,1714,1168,281100,17015
380,142,238,2813,164600,17016
684,564,120,709,200000,17017
1791,1530,261,1011,226000,17018
7411,6162,1249,1088,277200,17019
3583,2859,724,875,216200,17020
472,375,97,850,197500,17021
12540,8428,4112,1381,272700,17022
1355,1069,286,712,200400,17023
640,569,71,1135,270400,17024
7500,5479,2021,1155,242000,17025
1361,1212,149,846,246900,17026
178,163,15,-,266500,17027
1317,1153,164,1026,261700,17028
92,83,9,-,-,17029
296,84,212,768,235000,17030
3180,2668,512,747,212400,17032
6443,3449,2994,1311,340900,17033
1449,646,803,993,120100,17034
372,316,56,819,204100,17035
9498,6934,2564,1362,316900,17036
341,279,62,1031,215800,17037
3350,2470,880,922,241100,17038
10,10,0,-,-,17039
931,744,187,989,247500,17040
82,82,0,-,-,17041
15921,11366,4555,1096,222200,17042
2956,1683,1273,968,216300,17043
8909,5591,3318,791,126000,17044
1504,1199,305,766,215300,17045
12588,7924,4664,1036,180500,17046
985,749,236,682,261500,17047
1579,1080,499,809,136300,17048
1178,795,383,668,209600,17049
16583,12932,3651,1452,350800,17050
1828,1492,336,819,173900,17051
590,515,75,850,133000,17052
2237,1931,306,930,211000,17053
84,58,26,870,147500,17054
18197,12903,5294,1320,266400,17055
15,10,5,-,-,17056
9938,6773,3165,1122,187300,17057
593,332,261,725,182100,17058
2954,2059,895,739,216500,17059
384,331,53,739,170400,17060
2932,2166,766,829,165500,17061
1486,1298,188,836,233300,17062
1181,1024,157,689,113500,17063
268,236,32,1317,360000,17064
1571,1184,387,991,225900,17065
2076,1324,752,674,117500,17066
5936,4471,1465,1183,229500,17067
1666,1449,217,983,200400,17068
106,65,41,961,210900,17069
7292,5573,1719,1046,240200,17070
55,34,21,650,165900,17071
2145,1765,380,1389,259400,17073
2874,2139,735,777,212400,17074
57,42,15,1148,60000,17075
40,40,0,-,-,17076
25,6,19,-,-,17077
9134,6385,2749,1252,278300,17078
108,86,22,675,117600,17080
141,141,0,-,160600,17081
1063,831,232,743,207500,17082
1800,1425,375,806,173500,17084
798,575,223,588,180200,17086
879,741,138,860,222400,17087
251,166,85,929,209700,17088
2318,1872,446,793,247100,17090
345,316,29,-,169500,17093
938,747,191,714,186700,17094
294,240,54,967,80800,17097
1114,826,288,802,113300,17098
527,405,122,839,61000,17099
1999,21,1978,984,-,17101
4566,1623,2943,1062,172900,17102
4685,1909,2776,933,113100,17103
7797,3153,4644,953,102200,17104
11007,5807,5200,1234,203200,17109
11477,7129,4348,1400,206200,17110
14432,9741,4691,1309,225500,17111
15715,13177,2538,1400,290400,17112
4722,2821,1901,1091,141300,17113
0,0,0,-,-,17120
12180,5890,6290,1109,206800,17201
12341,9920,2421,1094,257700,17202
93,82,11,-,217900,17210
182,154,28,484,146400,17211
255,228,27,-,226200,17212
235,201,34,-,189100,17213
535,294,241,842,291400,17214
60,56,4,-,193200,17215
42,34,8,-,270000,17217
248,237,11,-,-,17219
173,155,18,933,241800,17220
217,196,21,684,203800,17221
4553,3932,621,930,236100,17222
164,116,48,667,186100,17223
866,809,57,1125,261100,17224
7834,6681,1153,969,266100,17225
426,344,82,728,177900,17228
570,475,95,749,184600,17229
13,11,2,-,-,17232
2293,1620,673,775,200900,17233
169,127,42,-,249100,17235
3339,2665,674,986,250100,17236
624,459,165,1291,189500,17237
747,565,182,863,198500,17238
96,77,19,-,216300,17239
1146,984,162,1354,257300,17240
4267,3369,898,978,208400,17241
435,330,105,748,147700,17243
850,686,164,898,186900,17244
186,186,0,-,-,17246
208,67,141,1572,-,17247
131,104,27,1102,142500,17249
27,27,0,-,-,17250
9,4,5,-,-,17251
1418,1105,313,1052,202300,17252
157,144,13,591,112000,17253
202,202,0,-,270700,17254
400,366,34,833,143800,17255
10665,7242,3423,1058,219200,17257
439,363,76,670,214800,17260
0,0,0,-,-,17261
318,296,22,670,221800,17262
249,192,57,-,204700,17263
998,875,123,658,167000,17264
118,82,36,690,141700,17265
167,122,45,842,195300,17266
1100,911,189,717,242600,17267
11998,8333,3665,1081,225900,17268
186,113,73,578,221600,17271
1516,1280,236,1103,235100,17301
1046,797,249,-,250800,17302
177,122,55,898,186600,17303
992,820,172,1153,255600,17304
210,161,49,1156,173700,17306
2181,1745,436,862,230000,17307
739,599,140,1166,255300,17309
69,47,22,1125,144000,17311
4467,2618,1849,1078,229000,17313
2302,2009,293,1018,255500,17314
11057,9890,1167,1189,222400,17315
3283,2882,401,977,282500,17316
168,151,17,850,190200,17317
53,21,32,-,-,17318
4272,3924,348,1147,230100,17319
3193,2823,370,1252,283000,17320
895,810,85,1336,273900,17321
2439,2322,117,1275,242700,17322
45,14,31,886,157100,17323
1815,1535,280,881,236800,17324
11148,8283,2865,956,278800,17325
3252,2401,851,1165,306100,17327
1049,1028,21,-,299100,17329
22361,17093,5268,1127,228700,17331
2664,2289,375,1235,288600,17339
4322,3442,880,1179,276700,17340
132,103,29,-,311600,17342
14,14,0,-,-,17343
1446,864,582,1365,203600,17344
3416,2656,760,1150,204900,17345
2374,2228,146,1375,228800,17347
2913,2594,319,1592,346300,17349
5315,3957,1358,1237,234600,17350
460,385,75,1264,322800,17352
1049,812,237,898,247800,17353
125,49,76,1026,211400,17355
8984,6693,2291,966,228000,17356
2290,1990,300,1119,284800,17360
2579,2087,492,1121,292300,17361
5371,4617,754,1183,258700,17362
3313,2789,524,905,307500,17363
1581,1280,301,913,204400,17364
1070,944,126,764,267600,17365
2230,1728,502,1231,193700,17366
2679,2218,461,1059,198700,17368
2608,2352,256,1157,220900,17370
134,130,4,-,195600,17371
1520,1243,277,1114,248000,17372
7408,2518,4890,940,84500,17401
14422,10495,3927,1307,247800,17402
15525,9796,5729,1072,206900,17403
15076,10664,4412,1136,176200,17404
9208,7373,1835,1362,218000,17406
926,739,187,1893,288900,17407
10060,7207,2853,1539,240000,17408
1958,1231,727,1122,246400,17501
1019,920,99,1036,225800,17502
34,34,0,-,205300,17504
475,291,184,1609,373600,17505
143,85,58,-,295200,17506
115,10,105,-,-,17507
342,320,22,-,328200,17508
1463,971,492,1074,293300,17509
7792,4986,2806,1067,221100,17512
2033,1819,214,941,290600,17516
5385,4537,848,1229,281200,17517
442,298,144,723,314700,17518
2561,1781,780,1494,321000,17519
2221,1981,240,1370,252800,17520
13630,9025,4605,1171,263600,17522
2123,1559,564,1319,297700,17527
1423,862,561,1162,351000,17529
1222,1097,125,938,319200,17532
0,0,0,-,-,17534
667,486,181,1297,346700,17535
1106,984,122,1321,329500,17536
3074,2743,331,1088,293100,17538
3913,2344,1569,1329,319800,17540
18029,13157,4872,1347,321900,17543
9226,7677,1549,1325,271600,17545
3493,2501,992,1139,243000,17547
146,128,18,-,-,17550
3774,2132,1642,1412,273000,17551
8386,5984,2402,1225,275600,17552
3024,2073,951,1346,270600,17554
2092,1820,272,1484,358900,17555
5240,3705,1535,1273,262100,17557
1844,1638,206,1065,231100,17560
1182,903,279,1087,340800,17562
1171,935,236,1357,302500,17563
871,825,46,1182,323100,17565
4260,3011,1249,1229,284300,17566
0,0,0,-,-,17568
2566,2401,165,1074,266100,17569
77,77,0,-,243000,17570
1201,933,268,1050,300300,17572
41,23,18,-,-,17576
2554,1987,567,1115,289900,17578
2182,1790,392,1056,323500,17579
86,43,43,860,-,17581
687,637,50,-,288500,17582
4669,2711,1958,2022,296800,17584
22603,16234,6369,1477,324000,17601
18699,10755,7944,1272,250600,17602
26801,16732,10069,1265,244500,17603
212,37,175,2339,-,17606
18262,9934,8328,869,176200,17701
4327,3221,1106,935,193500,17702
138,132,6,613,-,17720
748,602,146,812,149300,17721
25,17,8,-,193800,17723
1855,1236,619,730,168900,17724
22,22,0,-,-,17727
2013,1754,259,835,235800,17728
95,87,8,833,82100,17729
38,11,27,-,-,17730
104,86,18,825,246700,17731
2722,1974,748,887,199300,17737
13,11,2,-,231300,17739
4458,3762,696,855,182200,17740
20,10,10,-,162500,17742
1132,950,182,870,185400,17744
7206,4496,2710,810,181800,17745
1083,891,192,982,201700,17747
67,65,2,-,-,17748
85,48,37,875,172400,17749
50,23,27,-,139600,17750
2873,2240,633,853,208100,17751
1881,1496,385,926,181100,17752
4933,3710,1223,968,249400,17754
4385,3431,954,934,214600,17756
423,386,37,792,177100,17758
193,174,19,867,111700,17760
263,215,48,778,180100,17762
130,91,39,1063,112500,17763
1207,808,399,676,83300,17764
478,444,34,-,204500,17765
143,134,9,850,140800,17768
23,23,0,-,544600,17769
1222,1069,153,905,193500,17771
1028,908,120,800,232100,17772
413,344,69,930,223300,17774
76,73,3,-,176000,17776
2517,1944,573,832,195500,17777
38,31,7,-,158900,17778
63,63,0,-,164600,17779
6722,4513,2209,733,140800,17801
692,571,121,944,207300,17810
628,415,213,779,163900,17812
778,619,159,877,188200,17813
1888,1581,307,919,217000,17814
11082,6926,4156,968,216700,17815
2315,1794,521,774,210500,17820
7926,5366,2560,1078,241600,17821
0,0,0,-,-,17822
483,405,78,1000,213800,17823
1699,1574,125,639,247000,17824
323,258,65,1031,175000,17827
88,69,19,800,135400,17829
767,671,96,702,185900,17830
304,227,77,1131,88000,17832
1536,1254,282,807,86500,17834
34,34,0,-,180700,17835
80,60,20,738,175000,17836
6076,3892,2184,959,262700,17837
69,59,10,-,-,17840
1815,1561,254,805,161200,17841
3219,2417,802,877,194100,17842
4070,2848,1222,961,213700,17844
701,533,168,860,198400,17845
1422,1140,282,696,219200,17846
4894,3076,1818,835,185400,17847
296,192,104,763,178400,17850
2973,2271,702,802,73200,17851
1082,850,232,867,220400,17853
366,314,52,1116,210900,17855
1272,1193,79,975,188400,17856
3481,2605,876,948,191800,17857
21,21,0,-,237500,17858
1060,954,106,808,213300,17859
1062,1045,17,-,249800,17860
51,43,8,-,211600,17861
147,94,53,1043,181300,17862
768,615,153,942,211900,17864
8,8,0,-,183300,17865
3616,2908,708,712,85900,17866
71,68,3,-,150000,17867
357,313,44,912,208200,17868
5249,3719,1530,904,230300,17870
3874,2704,1170,659,79400,17872
754,531,223,976,197600,17876
585,522,63,825,195800,17878
4,0,4,-,-,17880
594,477,117,688,112300,17881
107,38,69,861,165600,17884
91,76,15,-,279400,17885
388,221,167,637,172200,17886
280,240,40,-,158800,17887
187,170,17,-,116700,17888
1051,889,162,923,281500,17889
9700,6864,2836,819,130600,17901
100,95,5,-,146100,17920
2468,1922,546,751,136400,17921
1957,1856,101,1102,234300,17922
207,141,66,-,76500,17923
140,121,19,1125,115200,17925
585,419,166,855,149500,17929
121,87,34,933,88800,17930
2104,1704,400,704,116500,17931
96,46,50,-,-,17933
147,144,3,-,32200,17934
688,550,138,613,44400,17935
389,284,105,746,111800,17936
1131,932,199,786,214200,17938
277,223,54,773,210200,17941
54,11,43,-,-,17943
105,97,8,-,102800,17944
152,128,24,-,42600,17945
70,70,0,-,162500,17946
1605,1058,547,932,39600,17948
97,69,28,-,38200,17949
130,130,0,-,159500,17951
98,87,11,-,57400,17952
140,121,19,625,111800,17953
1840,910,930,737,81800,17954
135,125,10,-,210600,17957
632,496,136,575,81400,17959
1724,1476,248,936,216700,17960
2725,2150,575,925,223700,17961
3964,3203,761,882,203300,17963
319,261,58,735,209000,17964
846,683,163,848,105100,17965
927,838,89,684,183300,17967
113,102,11,-,160000,17968
1466,1109,357,887,71600,17970
4539,3371,1168,901,165800,17972
123,106,17,-,124000,17974
2411,1780,631,827,47800,17976
192,118,74,875,233300,17978
29,29,0,-,-,17979
1244,979,265,850,128300,17980
974,765,209,829,85000,17981
193,154,39,1292,101000,17982
610,508,102,1018,147000,17983
558,488,70,987,183100,17985
2063,1792,271,1780,279100,18011
19,19,0,-,-,18012
6784,4993,1791,1088,245700,18013
4621,3890,731,1126,277700,18014
11881,5938,5943,1310,243100,18015
16376,11034,5342,1535,310600,18017
14076,7626,6450,1261,224000,18018
7700,6573,1127,1493,348900,18020
218,132,86,808,179600,18030
4150,3150,1000,1886,358900,18031
3994,2990,1004,1078,213500,18032
3109,2784,325,1399,398300,18034
7,7,0,-,-,18035
5892,5129,763,1121,381700,18036
3179,2654,525,1152,240500,18037
1474,1413,61,1689,248200,18038
6643,6024,619,1410,347800,18040
2333,1739,594,1284,286300,18041
16394,9046,7348,1245,205900,18042
11926,9564,2362,1802,301300,18045
54,54,0,-,-,18046
7380,5543,1837,1316,282500,18049
1280,1124,156,1197,443700,18051
11663,7249,4414,1387,247100,18052
935,816,119,1328,294100,18053
1721,1436,285,1716,408800,18054
4727,3795,932,1273,293800,18055
434,310,124,1667,38300,18056
3610,3145,465,1409,220100,18058
295,279,16,-,421300,18059
10059,8002,2057,1828,364300,18062
143,87,56,790,203900,18063
10254,7834,2420,1235,354700,18064
232,221,11,-,-,18065
2211,1902,309,1078,322500,18066
7925,6130,1795,1244,265400,18067
3190,2917,273,2225,407200,18069
150,141,9,-,274700,18070
4853,3423,1430,949,195200,18071
2622,1917,705,1525,244100,18072
4218,3761,457,1413,342300,18073
2181,2107,74,972,388000,18074
1251,895,356,990,253500,18076
901,736,165,1168,381200,18077
2697,2288,409,1265,361200,18078
125,110,15,-,117400,18079
4658,3731,927,808,254200,18080
62,48,14,-,-,18081
194,155,39,1375,264400,18083
393,279,114,1375,275000,18085
167,154,13,-,262300,18086
246,75,171,1149,339400,18087
3280,2930,350,1236,241200,18088
2477,1562,915,1290,249800,18091
1249,1080,169,1282,390300,18092
2428,186,2242,1337,153800,18101
17141,5121,12020,1224,146600,18102
18778,11637,7141,1333,242400,18103
18135,12620,5515,1620,296800,18104
2637,2118,519,1554,361200,18106
7006,3687,3319,1239,180200,18109
0,0,0,-,-,18195
12137,6140,5997,1019,131900,18201
5118,3682,1436,1029,182200,18202
3300,2985,315,1241,216800,18210
534,498,36,-,250900,18211
23,23,0,-,-,18212
1040,959,81,757,205000,18214
497,373,124,1141,126900,18216
897,717,180,838,69300,18218
524,373,151,931,219100,18219
100,90,10,838,62500,18220
204,162,42,-,188500,18221
3610,3129,481,1436,227600,18222
25,25,0,-,-,18223
2758,1870,888,922,114900,18224
0,0,0,-,-,18225
3794,3263,531,931,215400,18229
62,62,0,-,99300,18230
172,149,23,819,115500,18231
1613,805,808,963,48700,18232
365,211,154,-,221200,18234
8010,6361,1649,1003,218000,18235
1573,1004,569,1021,90400,18237
0,0,0,-,-,18239
1469,921,548,970,135200,18240
175,139,36,763,100800,18241
179,156,23,-,110200,18242
116,93,23,1048,169000,18244
125,125,0,-,112300,18245
42,42,0,-,122100,18246
172,150,22,-,107600,18248
1589,1366,223,1341,279800,18249
1217,974,243,1172,99100,18250
4511,3094,1417,922,153000,18252
273,228,45,1463,116700,18254
1706,1373,333,863,173100,18255
88,83,5,-,154700,18256
9429,7079,2350,1350,246100,18301
6189,5350,839,1238,219400,18302
598,522,76,1268,193200,18321
915,795,120,992,274000,18322
81,81,0,-,-,18323
3758,3347,411,2011,194500,18324
1016,886,130,-,241800,18325
1351,1143,208,945,244300,18326
301,186,115,1065,250000,18327
3356,3031,325,1128,216400,18328
2941,2741,200,1809,251300,18330
290,219,71,-,276800,18331
971,875,96,1178,237700,18332
23,0,23,-,-,18333
1820,1573,247,1078,240900,18334
455,443,12,-,274500,18335
1839,1211,628,1215,244700,18336
6015,5053,962,1507,284200,18337
36,20,16,-,-,18340
350,146,204,992,237200,18342
1622,1336,286,1179,274300,18343
1453,955,498,890,171600,18344
868,843,25,875,182900,18346
1755,1415,340,1176,168900,18347
79,62,17,-,-,18349
311,311,0,-,218000,18350
238,88,150,1354,258600,18351
4607,4053,554,1344,262300,18353
430,385,45,-,244800,18354
528,346,182,1675,238700,18355
0,0,0,-,-,18356
71,71,0,-,-,18357
11512,8168,3344,1314,286200,18360
405,249,156,804,226800,18370
266,266,0,-,245500,18371
985,633,352,1714,306400,18372
2803,2140,663,940,212900,18403
1015,896,119,675,211300,18405
6123,3919,2204,826,142600,18407
8907,7108,1799,1253,274200,18411
55,55,0,-,-,18413
2128,1864,264,1232,279600,18414
593,560,33,-,327600,18415
413,351,62,747,222000,18417
1895,1488,407,905,213900,18419
32,18,14,-,225000,18420
1888,1473,415,869,169100,18421
2037,1783,254,994,191800,18424
408,369,39,996,194100,18425
1320,1135,185,1279,268700,18426
5370,4390,980,1195,263300,18428
21,20,1,-,-,18430
5403,3987,1416,1013,222000,18431
3031,2446,585,929,201800,18433
1784,1164,620,902,164300,18434
431,431,0,-,317400,18435
5117,4519,598,890,222000,18436
59,45,14,-,215000,18437
792,733,59,-,352600,18438
179,163,16,925,243100,18439
19,19,0,-,-,18440
166,139,27,1097,315000,18441
156,156,0,-,219400,18443
5358,4554,804,1015,249400,18444
1001,810,191,858,244400,18445
1346,1110,236,808,200000,18446
4451,3241,1210,971,194600,18447
203,197,6,-,327500,18451
2241,1561,680,960,189200,18452
497,436,61,1141,285400,18453
43,41,2,-,342500,18454
77,68,9,825,206700,18455
126,116,10,963,300000,18456
9,9,0,-,-,18457
1376,1272,104,1320,262800,18458
64,47,17,1063,189600,18460
131,114,17,-,187500,18461
207,183,24,1375,191500,18462
94,80,14,-,303600,18463
603,549,54,1474,319900,18464
531,418,113,1313,230000,18465
5967,4525,1442,1795,181300,18466
198,181,17,-,349500,18469
1015,870,145,789,233800,18470
216,212,4,-,298100,18471
1627,1176,451,979,233600,18472
169,127,42,-,-,18473
792,26,766,933,259400,18503
8538,5195,3343,970,144200,18504
8531,4689,3842,954,139800,18505
2150,1352,798,1284,242200,18507
4636,2311,2325,1034,120700,18508
5206,2449,2757,991,176300,18509
5162,2166,2996,1040,178000,18510
5827,3691,2136,927,173500,18512
1940,1445,495,1163,176000,18517
3750,2669,1081,862,169700,18518
2438,1499,939,924,165300,18519
134,130,4,1750,365500,18602
8336,6037,2299,789,164500,18603
1311,1076,235,1491,222800,18610
6077,4996,1081,1150,250700,18612
966,765,201,733,186300,18614
774,687,87,641,216300,18615
330,258,72,743,218300,18616
816,446,370,888,84500,18617
1537,1302,235,1446,236400,18618
58,51,7,-,197900,18619
1845,1688,157,1243,190600,18621
97,97,0,-,174700,18622
948,679,269,916,174200,18623
277,277,0,-,424400,18624
60,47,13,-,-,18625
184,173,11,950,268000,18626
0,0,0,-,-,18627
83,80,3,-,120000,18628
776,610,166,1038,203700,18629
1161,904,257,897,216800,18630
510,441,69,990,214900,18631
154,105,49,812,119500,18632
5616,3560,2056,798,108600,18634
1556,1291,265,900,187300,18635
668,567,101,950,175900,18636
7337,4225,3112,890,135200,18640
2729,1991,738,956,142500,18641
1861,1317,544,1122,154100,18642
5695,4118,1577,956,156900,18643
3468,2586,882,920,167000,18644
3706,2049,1657,930,90400,18651
2434,2036,398,889,167000,18655
879,820,59,927,207100,18656
4640,3330,1310,934,210300,18657
1352,1250,102,875,192300,18660
2371,1971,400,1231,182500,18661
1148,107,1041,842,245700,18701
17120,9777,7343,971,115700,18702
13282,8120,5162,935,154600,18704
6238,3983,2255,1006,122800,18705
6655,4421,2234,883,121900,18706
6214,5582,632,864,277500,18707
3959,3373,586,1085,246900,18708
1501,864,637,780,113700,18709
3164,2441,723,903,226000,18801
2712,1525,1187,838,202100,18810
644,574,70,1019,238500,18812
75,59,16,913,217900,18814
38,25,13,-,164800,18816
50,50,0,-,235000,18817
531,400,131,839,231100,18818
21,21,0,-,-,18820
462,339,123,800,164600,18821
1290,991,299,806,166900,18822
60,51,9,258,252100,18823
525,453,72,850,172600,18824
53,47,6,-,246900,18825
567,509,58,1352,246400,18826
106,101,5,-,231700,18828
287,245,42,793,213400,18829
266,220,46,893,230800,18830
411,353,58,831,189100,18831
754,632,122,833,141800,18832
842,689,153,932,193700,18833
1328,978,350,970,202600,18834
1032,788,244,946,179000,18837
4587,3113,1474,906,170500,18840
56,44,12,-,191700,18842
159,85,74,-,203800,18843
530,475,55,867,250500,18844
185,161,24,870,200600,18845
301,269,32,1261,241100,18846
1997,1495,502,805,155600,18847
3686,2540,1146,883,178300,18848
809,646,163,968,183300,18850
248,221,27,975,213100,18851
1655,1240,415,881,213700,18853
643,526,117,1042,191300,18854
10946,7538,3408,1890,544200,18901
8034,7411,623,2143,637700,18902
174,149,25,-,"2,000,000+",18912
91,91,0,-,1007400,18913
7734,6676,1058,1991,477200,18914
631,551,80,1674,504000,18915
992,594,398,1342,356100,18917
214,159,55,-,606500,18920
78,78,0,-,385200,18921
485,414,71,2259,414700,18923
2195,2079,116,2667,669300,18925
148,39,109,-,-,18927
3201,3073,128,1713,605100,18929
923,853,70,726,495800,18930
215,156,59,-,466000,18932
80,73,7,-,1885400,18933
131,111,20,-,338300,18935
91,82,9,-,282500,18936
6058,5314,744,2005,701700,18938
11476,9875,1601,2227,623300,18940
1076,984,92,1392,485800,18942
9766,7959,1807,1383,411200,18944
184,170,14,-,632400,18946
2486,2307,179,2057,604000,18947
48,48,0,-,-,18950
14155,11424,2731,1341,339000,18951
3769,3712,57,1991,585200,18954
510,380,130,1375,315500,18955
4929,3662,1267,1361,373300,18960
167,158,9,-,345700,18962
5395,3687,1708,1358,339700,18964
13704,12130,1574,1840,466900,18966
6063,4899,1164,1358,365700,18969
296,169,127,1341,312900,18970
1297,1078,219,1407,454700,18972
17413,13043,4370,1634,407300,18974
8168,6503,1665,1643,502200,18976
1763,1675,88,-,712600,18977
35,20,15,-,550000,18980
6384,5256,1128,1355,343000,19001
11907,9485,2422,1605,558800,19002
6175,3941,2234,1602,441400,19003
4216,3023,1193,1791,616000,19004
8453,6327,2126,1430,518500,19006
9282,5411,3871,1029,264800,19007
6955,5916,1039,1633,469900,19008
349,248,101,1516,667600,19009
7849,5131,2718,1890,788700,19010
2237,1879,358,1226,320600,19012
13204,5252,7952,1083,85200,19013
7898,6788,1110,1335,297300,19014
6921,5389,1532,1170,232800,19015
106,75,31,-,553600,19017
9667,6276,3391,1346,215400,19018
22838,13271,9567,1549,344400,19020
3909,2643,1266,1303,264900,19021
1628,770,858,1112,124400,19022
8402,4346,4056,1240,117200,19023
2701,2119,582,2894,606000,19025
12896,8607,4289,1316,243000,19026
8417,5377,3040,1439,348700,19027
1775,1129,646,1340,186300,19029
4695,3603,1092,1259,344300,19030
2045,1648,397,1377,519000,19031
2597,1885,712,1363,140000,19032
2822,2260,562,1284,264300,19033
2484,1900,584,1523,611400,19034
1361,1148,213,"3,500+",1388300,19035
4978,3817,1161,1268,191700,19036
11633,9802,1831,1407,387800,19038
7901,5725,2176,1657,367700,19040
2353,1521,832,2250,908600,19041
1309,1046,263,1171,249800,19043
6855,4093,2762,1434,372900,19044
7659,5212,2447,1433,446800,19046
12822,9301,3521,1770,441200,19047
11970,7498,4472,1166,188700,19050
206,190,16,-,354900,19052
10693,9056,1637,1401,382300,19053
6530,5186,1344,1535,330200,19054
4894,3977,917,1550,275300,19055
5923,4265,1658,1409,360000,19056
6323,5046,1277,1518,299900,19057
3708,3656,52,-,516400,19060
8136,5127,3009,1215,229700,19061
15280,10643,4637,1623,505500,19063
8616,8096,520,1511,389600,19064
1790,1602,188,2319,871300,19066
20800,16606,4194,1599,483000,19067
2691,2002,689,1300,283900,19070
4252,3079,1173,1956,776500,19072
8423,6694,1729,1987,581400,19073
2275,1671,604,1247,227500,19074
2959,2676,283,1204,415400,19075
2554,1467,1087,1154,239300,19076
4781,3266,1515,1318,244500,19078
3237,1978,1259,1212,159800,19079
3727,3019,708,1452,333600,19081
15628,7550,8078,1178,155400,19082
13548,11989,1559,1386,424100,19083
1701,1690,11,-,1007400,19085
4445,3943,502,1788,425200,19086
12132,8774,3358,2130,693200,19087
7584,5027,2557,1606,338000,19090
1783,1260,523,1287,244000,19094
3454,1818,1636,1776,419400,19095
5821,4532,1289,2107,711600,19096
4057,829,3228,2249,412200,19102
17206,5746,11460,1955,551700,19103
19948,3543,16405,1329,268200,19104
8819,4009,4810,2219,528700,19106
9127,1457,7670,1691,452500,19107
103,60,43,-,362500,19108
0,0,0,-,-,19109
25851,14306,11545,1221,244000,19111
0,0,0,-,-,19112
0,0,0,-,-,19113
14111,9016,5095,1369,276400,19114
14665,9099,5566,1230,330500,19115
13589,8146,5443,1214,321400,19116
4782,2392,2390,1772,688000,19118
13024,8240,4784,1291,326600,19119
24208,16659,7549,1186,143500,19120
16567,5482,11085,1082,250100,19121
9102,3222,5880,1294,341000,19122
9991,3343,6648,1687,544700,19123
24760,15500,9260,1063,155000,19124
12039,7226,4813,1743,373600,19125
7146,4350,2796,1116,214300,19126
3314,1459,1855,1765,298900,19127
17931,10182,7749,1563,330800,19128
5862,2893,2969,1471,297400,19129
16578,6420,10158,1836,483500,19130
19689,8664,11025,1312,163900,19131
13930,7171,6759,1055,73000,19132
9401,4022,5379,919,85100,19133
21813,11733,10080,1179,127500,19134
13323,8283,5040,1197,182900,19135
13269,7853,5416,1200,215000,19136
3129,2641,488,1205,212700,19137
12823,8250,4573,1172,167300,19138
19518,7693,11825,1110,118700,19139
20557,11231,9326,1085,101100,19140
15201,7874,7327,1009,143400,19141
11754,5708,6046,1269,110400,19142
27135,13535,13600,1235,152000,19143
21686,7621,14065,1110,224600,19144
19139,11289,7850,1343,290100,19145
19029,9996,9033,1708,452200,19146
19329,10581,8748,1679,524900,19147
21102,13951,7151,1492,296800,19148
19436,11237,8199,1484,198200,19149
10288,8148,2140,1282,225400,19150
13203,8388,4815,1167,181200,19151
13322,7506,5816,1236,270000,19152
5726,3016,2710,1341,198700,19153
12689,10184,2505,1396,274400,19154
3146,2583,563,1802,537300,19301
912,759,153,1392,289300,19310
3831,3241,590,1397,524700,19311
4391,3718,673,1678,805400,19312
29,29,0,-,-,19316
4057,3485,572,2003,588600,19317
169,169,0,-,569900,19319
20039,14669,5370,1427,302700,19320
2062,1833,229,1139,389500,19330
3039,2014,1025,1833,688700,19333
19877,15893,3984,1647,464400,19335
8784,4422,4362,2045,486900,19341
7771,5624,2147,2298,579400,19342
3066,2682,384,1816,543800,19343
4667,3630,1037,1348,303900,19344
0,0,0,-,-,19345
8815,6268,2547,1588,518200,19348
3781,3449,332,1405,494300,19350
3310,3182,128,1604,458700,19352
11240,8084,3156,1960,662200,19355
70,31,39,1308,161300,19358
2229,1900,329,1273,291800,19362
5948,4255,1693,1217,341900,19363
2751,2040,711,1256,300000,19365
38,27,11,-,-,19367
94,42,52,-,-,19369
879,422,457,2061,292900,19372
747,747,0,-,710500,19373
237,173,64,954,288800,19374
106,89,17,-,614300,19375
20694,15054,5640,1820,530400,19380
20897,14955,5942,1788,542400,19382
162,0,162,-,-,19383
4321,3480,841,1221,377700,19390
16793,7419,9374,1392,225700,19401
18973,13925,5048,1640,355700,19403
2061,1016,1045,1483,314700,19405
13212,6846,6366,1983,393600,19406
7946,6303,1643,2151,572600,19422
5532,4993,539,2460,621700,19425
13679,12031,1648,1932,471200,19426
9417,4928,4489,1900,445900,19428
27,21,6,-,235000,19435
367,74,293,"3,500+",-,19436
145,145,0,-,-,19437
9326,7442,1884,1697,455100,19438
7371,4786,2585,1391,413100,19440
0,0,0,-,-,19442
4507,3501,1006,2178,497800,19444
24213,16096,8117,1738,415400,19446
724,437,287,1761,255600,19453
11031,8697,2334,1762,438200,19454
84,78,6,-,587500,19456
46,46,0,-,-,19457
18053,12548,5505,1622,426000,19460
6520,5005,1515,1771,452400,19462
18599,12132,6467,1226,231700,19464
7202,5768,1434,1421,383300,19465
11047,8459,2588,1688,383500,19468
22,22,0,-,440000,19472
6595,5780,815,1400,454500,19473
144,144,0,-,327000,19474
4895,3468,1427,948,362900,19475
43,43,0,-,-,19477
150,150,0,-,1213800,19490
488,113,375,2646,435200,19492
362,273,89,1023,226700,19501
467,339,128,1220,232700,19503
2092,1960,132,1063,345800,19504
1415,1107,308,1147,298800,19505
2603,2251,352,1152,302100,19506
1229,1026,203,1026,279600,19507
6096,4950,1146,1108,242100,19508
3064,2826,238,1149,272500,19510
57,57,0,-,257600,19511
6449,4692,1757,1146,247500,19512
86,32,54,775,266700,19516
5988,5140,848,1324,331100,19518
2473,2019,454,1111,403600,19520
5528,4547,981,1202,255300,19522
9,9,0,-,-,19523
6033,5619,414,1117,392500,19525
5025,3894,1131,1072,209800,19526
1135,990,145,1236,346100,19529
4482,2998,1484,1158,265000,19530
3164,2836,328,1027,263300,19533
801,689,112,961,288300,19534
17,0,17,-,-,19535
235,165,70,1071,170200,19536
52,46,6,-,190500,19538
1591,1457,134,975,264300,19539
4340,3537,803,999,290500,19540
1556,1390,166,1438,285900,19541
1990,1717,273,1273,335200,19543
61,61,0,-,198900,19544
277,277,0,-,141600,19545
1944,1567,377,1178,296500,19547
117,87,30,1221,127600,19549
165,99,66,1099,-,19550
1823,1509,314,1006,248800,19551
169,128,41,973,256900,19554
1429,1025,404,1107,239600,19555
123,113,10,-,161300,19559
3745,3021,724,1566,176800,19560
1239,725,514,1149,212200,19562
106,80,26,-,-,19564
3585,2959,626,1283,262900,19565
2046,1630,416,1176,230500,19567
12788,4768,8020,986,110700,19601
6697,1792,4905,978,73000,19602
9438,4653,4785,1100,110800,19604
7697,6581,1116,1310,218500,19605
13930,10821,3109,1282,229400,19606
9505,6179,3326,1283,210800,19607
8884,7044,1840,1485,311600,19608
4084,3406,678,1307,222000,19609
6996,4694,2302,1669,320100,19610
4269,2073,2196,1098,161900,19611
16798,13430,3368,1732,337800,19701
21551,12970,8581,1549,331200,19702
6818,3642,3176,1305,266500,19703
734,556,178,1420,244600,19706
6298,5434,864,2230,534300,19707
17649,15232,2417,1571,444900,19709
0,0,0,-,-,19710
18982,12425,6557,1516,376300,19711
12143,7589,4554,1293,267500,19713
0,0,0,-,-,19716
0,0,0,-,-,19717
23102,15523,7579,1282,242600,19720
207,175,32,1344,299300,19730
247,226,21,-,347500,19731
85,85,0,-,704900,19732
75,55,20,-,220500,19733
4454,3973,481,1342,426300,19734
0,0,0,-,-,19735
13,13,0,-,-,19736
8041,2345,5696,1126,196000,19801
10504,5000,5504,1236,188400,19802
8723,7854,869,1736,436200,19803
7627,5773,1854,1157,244700,19804
15952,9056,6896,1203,220200,19805
6144,3131,3013,1329,370500,19806
3538,2432,1106,1600,895400,19807
15587,12322,3265,1357,309700,19808
6236,4324,1912,1373,308900,19809
10599,8431,2168,1517,420300,19810
14363,7771,6592,1353,258400,19901
0,0,0,-,-,19902
14777,9165,5612,1240,281000,19904
1481,1450,31,1542,798300,19930
184,181,3,-,276300,19931
4153,3223,930,1021,231300,19933
5050,4166,884,1510,311200,19934
70,47,23,1135,116300,19936
3160,2797,363,1624,335800,19938
3214,2960,254,1375,365100,19939
2351,1941,410,938,225700,19940
1161,896,265,1054,225500,19941
5307,4635,672,1262,287200,19943
315,279,36,-,1160100,19944
3785,3313,472,1229,410000,19945
2081,1762,319,1282,263400,19946
6356,4306,2050,1298,294000,19947
3229,2388,841,1304,272800,19950
795,789,6,-,427900,19951
4172,3133,1039,1183,274000,19952
1700,1259,441,1063,244200,19953
648,476,172,1205,283800,19954
88,74,14,-,220000,19955
6013,3949,2064,923,233500,19956
14358,11923,2435,1654,488900,19958
2303,1896,407,1306,276200,19960
4521,4073,448,1205,357000,19962
9372,5894,3478,1161,291200,19963
674,624,50,-,334000,19964
15130,12481,2649,1293,282100,19966
1188,1108,80,1730,450100,19967
6093,5500,593,1408,418600,19968
3891,3540,351,1458,489500,19970
7915,6989,926,1383,561300,19971
9927,7253,2674,1131,254300,19973
4921,4343,578,1098,430000,19975
9258,7694,1564,1366,311800,19977
217,178,39,1708,265600,19979
66,57,9,-,284800,19980
23831,8043,15788,2464,844500,20001
34558,12858,21700,2140,813700,20002
18835,7243,11592,2630,954200,20003
1251,510,741,2945,650700,20004
8691,2535,6156,2223,636000,20005
762,62,700,2035,255700,20006
11849,6798,5051,2066,1202900,20007
16701,5948,10753,2202,894100,20008
29175,10091,19084,2346,727800,20009
14463,5770,8693,1815,868400,20010
27402,14767,12635,1636,722200,20011
7150,4487,2663,1638,838200,20012
6250,4869,1381,2088,1208700,20015
13916,8990,4926,2105,1206200,20016
8673,4976,3697,1793,686400,20017
9027,4896,4131,1245,672100,20018
26523,10805,15718,1174,437600,20019
23509,7275,16234,1317,442500,20020
10056,3207,6849,2121,497100,20024
17802,3983,13819,1285,391400,20032
3789,1621,2168,2301,442400,20036
7302,2554,4748,2420,743700,20037
0,0,0,-,-,20045
7,0,7,-,-,20052
0,0,0,-,-,20057
0,0,0,-,-,20059
0,0,0,-,-,20064
10447,9337,1110,2745,807400,20105
1537,1304,233,1648,487900,20106
14926,6738,8188,1928,411700,20109
15781,11641,4140,1863,445300,20110
11483,7778,3705,2020,449400,20111
9392,9131,261,2158,615700,20112
2860,1992,868,1897,657900,20115
1403,1085,318,1762,947700,20117
1315,1101,214,1808,597400,20119
14447,10827,3620,2244,620100,20120
9703,6888,2815,2240,488200,20121
4856,4504,352,2307,870200,20124
152,141,11,-,1205800,20129
93,62,31,-,-,20130
6058,5538,520,2225,704100,20132
1286,1147,139,1513,546400,20135
9099,8379,720,2872,585500,20136
653,638,15,-,700000,20137
2550,2294,256,1400,676700,20141
263,246,17,-,1022700,20143
574,475,99,1190,699600,20144
24591,16899,7692,2394,679600,20147
20259,16169,4090,2647,843800,20148
6920,5499,1421,2245,647400,20151
11104,9345,1759,2853,708400,20152
12534,10677,1857,2648,630400,20155
1576,1333,243,-,771200,20158
12716,9844,2872,2031,526700,20164
11903,9233,2670,2480,661300,20165
5214,2698,2516,2227,576400,20166
9395,8759,636,2809,676600,20169
13613,9412,4201,2224,625600,20170
18634,10465,8169,2276,770200,20171
12354,9180,3174,2039,717700,20175
16347,12936,3411,2089,702400,20176
2546,2352,194,2071,629400,20180
3175,2881,294,1694,671400,20181
238,48,190,1880,-,20184
5824,3861,1963,1541,485000,20186
6617,6018,599,1873,601700,20187
11319,5426,5893,2241,568500,20190
12007,8333,3674,1983,616700,20191
5721,4101,1620,2303,792200,20194
802,708,94,-,988900,20197
891,582,309,-,1131300,20198
0,0,0,-,-,20204
0,0,0,-,-,20220
0,0,0,-,-,20230
0,0,0,-,-,20240
0,0,0,-,-,20245
0,0,0,-,-,20250
0,0,0,-,-,20260
0,0,0,-,-,20317
0,0,0,-,-,20319
34,0,34,-,-,20373
0,0,0,-,-,20388
0,0,0,-,-,20390
0,0,0,-,-,20408
0,0,0,-,-,20415
0,0,0,-,-,20418
0,0,0,-,-,20422
0,0,0,-,-,20427
0,0,0,-,-,20431
0,0,0,-,-,20510
0,0,0,-,-,20515
0,0,0,-,-,20520
0,0,0,-,-,20530
0,0,0,-,-,20535
0,0,0,-,-,20540
0,0,0,-,-,20542
0,0,0,-,-,20551
0,0,0,-,-,20560
0,0,0,-,-,20565
0,0,0,-,-,20566
0,0,0,-,-,20591
10011,7896,2115,2154,380700,20601
10659,7189,3470,1803,360800,20602
11518,9462,2056,2021,430700,20603
88,88,0,-,464100,20606
4172,4094,78,3066,522900,20607
231,163,68,880,356500,20608
409,375,34,-,474700,20609
430,404,26,-,395400,20611
42,30,12,-,-,20612
5563,5348,215,2288,511600,20613
160,160,0,-,478900,20615
2537,2431,106,2110,345400,20616
168,146,22,-,490000,20617
582,478,104,1606,291900,20618
5739,3622,2117,2015,364200,20619
387,328,59,1360,369200,20620
437,426,11,-,562500,20621
1425,1345,80,1659,416400,20622
968,954,14,-,452400,20623
401,357,44,1183,423700,20624
398,339,59,-,244400,20625
118,110,8,-,-,20626
326,292,34,-,412100,20628
464,436,28,-,459500,20629
188,128,60,-,584600,20630
158,143,15,-,491200,20632
2538,1734,804,1689,334800,20634
3400,2978,422,1158,470300,20636
2138,2001,137,2904,533100,20637
4981,4595,386,1588,528400,20639
3972,3124,848,1752,307900,20640
276,264,12,-,516400,20645
7657,6519,1138,1486,435100,20646
5644,4282,1362,1726,464000,20650
10864,5964,4900,1579,341900,20653
55,31,24,-,-,20656
7280,6372,908,1716,317600,20657
364,309,55,1560,290200,20658
8101,7328,773,1781,388400,20659
16,16,0,-,-,20660
0,0,0,-,-,20661
900,807,93,-,381900,20662
1178,904,274,1660,433100,20664
21,21,0,-,-,20667
401,0,401,2232,-,20670
242,187,55,1707,398600,20674
711,684,27,-,436900,20675
1371,1199,172,1733,471800,20676
751,728,23,-,525400,20677
4744,3748,996,1408,428100,20678
282,203,79,-,392400,20680
355,336,19,-,375500,20684
2356,2227,129,1515,431200,20685
0,0,0,-,-,20686
133,95,38,-,771600,20687
637,321,316,3000,-,20688
635,562,73,1805,468400,20689
412,343,69,1490,558900,20690
171,171,0,-,381700,20692
330,312,18,-,428900,20693
4461,3797,664,1949,446700,20695
387,0,387,2147,-,20701
8723,5719,3004,1777,423000,20705
13230,9527,3703,1797,408600,20706
14321,7877,6444,1880,411200,20707
10527,3700,6827,1796,431500,20708
3269,594,2675,1658,335000,20710
2421,2337,84,1577,390200,20711
4107,956,3151,1442,531100,20712
1855,1391,464,1829,362900,20714
8970,8306,664,2523,437600,20715
9270,6498,2772,2140,405900,20716
8464,7939,525,3162,545800,20720
11019,9816,1203,2394,561500,20721
2191,1480,711,1505,378600,20722
12359,8601,3758,1986,508000,20723
7376,4409,2967,2199,392500,20724
4185,3670,515,1578,426300,20732
1016,929,87,-,396500,20733
13318,12202,1116,1915,401000,20735
3285,3105,180,1755,570900,20736
6979,3462,3517,1619,370300,20737
11671,4581,7090,1788,417100,20740
36,0,36,-,-,20742
15577,10407,5170,1614,317100,20743
19726,16080,3646,1751,418100,20744
12196,5304,6892,1564,351500,20745
13164,4404,8760,1735,325000,20746
15984,8012,7972,1635,325400,20747
16374,9262,7112,1586,355600,20748
974,911,63,-,447700,20751
2275,2109,166,2602,601300,20754
3093,25,3068,2380,-,20755
201,201,0,-,604400,20758
2031,1940,91,"3,500+",888200,20759
870,9,861,2747,-,20762
1095,546,549,2140,406300,20763
1372,1127,245,2204,376800,20764
237,208,29,-,480600,20765
2255,2155,100,2788,571400,20769
12006,5446,6560,1823,249400,20770
0,0,0,-,-,20771
18911,16951,1960,2045,443500,20772
20815,15881,4934,2213,439500,20774
1189,1065,124,-,588400,20776
1040,1007,33,2893,808700,20777
739,726,13,-,718100,20778
439,411,28,-,508500,20779
4458,2437,2021,1695,453100,20781
12644,5546,7098,1789,431300,20782
13852,5717,8135,1701,400400,20783
10188,5862,4326,1769,356500,20784
15473,7753,7720,1764,346000,20785
4060,2476,1584,1940,393700,20794
108,101,7,"3,500+",1128500,20812
14171,7454,6717,2329,976500,20814
13207,8776,4431,2408,1230700,20815
6457,5250,1207,2723,1166100,20816
13584,11186,2398,3155,1142300,20817
595,560,35,-,1273300,20818
8424,7254,1170,2429,601300,20832
2576,2469,107,2254,762200,20833
2333,2159,174,1879,701000,20837
102,100,2,-,807100,20838
58,44,14,-,900000,20839
2915,2683,232,2794,771400,20841
692,543,149,1745,709300,20842
21131,10880,10251,2277,687200,20850
5071,2877,2194,1924,523800,20851
21640,9022,12618,2212,646100,20852
9713,8192,1521,1944,605800,20853
16542,14875,1667,3180,1105300,20854
6042,4709,1333,2405,614900,20855
759,649,110,1446,665000,20860
966,952,14,-,956200,20861
175,175,0,-,804200,20862
5056,3961,1095,2203,434400,20866
114,114,0,-,564800,20868
8763,7629,1134,2312,628800,20871
4625,4122,503,1675,478300,20872
22512,14842,7670,1938,385300,20874
8935,6001,2934,2081,456500,20876
12880,5660,7220,1862,462500,20877
24337,16875,7462,2188,675200,20878
8850,6270,2580,1895,433500,20879
287,274,13,-,594200,20880
4602,4502,100,1686,705800,20882
12314,8346,3968,1863,366400,20886
23,0,23,-,-,20889
0,0,0,-,-,20892
0,0,0,-,-,20894
6944,5537,1407,2075,744000,20895
320,304,16,2750,994200,20896
89,0,89,835,-,20899
13495,9319,4176,1785,571300,20901
17982,11637,6345,2088,531200,20902
7243,2900,4343,1831,467900,20903
21245,10827,10418,1893,533500,20904
5699,4974,725,2015,640400,20905
26242,17522,8720,1945,440600,20906
22067,7638,14429,1992,690900,20910
9737,4196,5541,1452,671400,20912
10581,7003,3578,1391,267400,21001
843,9,834,1962,-,21005
12738,10356,2382,1680,335100,21009
46,0,46,2795,-,21010
8112,6888,1224,2171,552000,21012
1964,1816,148,1165,577700,21013
14565,11201,3364,1571,407800,21014
11169,10104,1065,1730,418400,21015
2643,1847,796,1706,241700,21017
37,30,7,-,625000,21023
985,835,150,1733,476400,21028
4072,3735,337,"3,500+",904700,21029
10787,4728,6059,1600,435500,21030
18,0,18,-,-,21031
3065,2765,300,2371,643000,21032
1161,1059,102,1226,348400,21034
2717,2579,138,2920,801400,21035
800,771,29,-,843200,21036
7906,7059,847,2276,530900,21037
9870,6771,3099,1420,231100,21040
14958,12778,2180,2253,674700,21042
17246,11614,5632,1964,607300,21043
18391,11270,7121,2096,541100,21044
15368,10599,4769,1768,438500,21045
6100,3825,2275,2099,469000,21046
4852,4701,151,2482,516700,21047
3653,3429,224,1500,423900,21048
6400,5717,683,1646,439200,21050
47,47,0,-,562500,21051
108,108,0,-,268300,21052
1327,1282,45,-,445300,21053
5292,4401,891,2351,587700,21054
130,130,0,-,"2,000,000+",21056
1556,1348,208,1672,609000,21057
15696,11931,3765,1620,352800,21060
22181,12467,9714,1661,326000,21061
115,115,0,-,451800,21071
6052,5206,846,1212,349900,21074
12956,8356,4600,2108,439400,21075
9297,6168,3129,2337,492100,21076
76,66,10,-,425000,21077
8313,6432,1881,1331,355500,21078
227,214,13,-,525400,21082
2798,2572,226,1332,445200,21084
6560,5383,1177,1593,327300,21085
2140,1973,167,-,505200,21087
3852,3240,612,1910,374300,21090
15666,12323,3343,1581,466200,21093
4448,3954,494,1498,374600,21102
1931,1872,59,-,659700,21104
12,0,12,-,-,21105
6339,5518,821,2030,543200,21108
1857,1778,79,1458,585400,21111
15491,9839,5652,2152,401900,21113
9489,7683,1806,2128,479700,21114
24363,13020,11343,1817,370700,21117
2560,2429,131,1338,552400,21120
22733,19582,3151,2077,412100,21122
5428,4540,888,1644,424200,21128
48,13,35,-,-,21130
2467,2441,26,-,662900,21131
1026,1005,21,-,511500,21132
12488,8625,3863,1518,302000,21133
13231,10356,2875,1471,380200,21136
1434,1400,34,2071,598200,21140
12942,10520,2422,1958,468400,21144
9888,8779,1109,1619,643600,21146
2532,1798,734,1639,529200,21152
234,207,27,-,988200,21153
2535,2185,350,1209,458800,21154
1047,867,180,1367,537700,21155
83,83,0,-,486500,21156
14646,11111,3535,1236,394100,21157
8370,6674,1696,1735,375100,21158
901,730,171,1760,364000,21160
1892,1748,144,1867,442000,21161
1435,1262,173,-,463400,21162
2536,2132,404,1370,598700,21163
10703,1176,9527,1282,221900,21201
10932,2274,8658,1497,307700,21202
8564,3980,4584,1894,571800,21204
5227,1909,3318,1052,94900,21205
20457,11234,9223,1215,213700,21206
19608,11978,7630,1390,248400,21207
15561,10386,5175,1672,313400,21208
11608,6643,4965,1640,418800,21209
5048,3091,1957,1498,521700,21210
8394,4782,3612,1577,274000,21211
12787,8678,4109,1328,357900,21212
11563,6149,5414,1253,134900,21213
8466,6625,1841,1188,250700,21214
21005,11199,9806,1177,189900,21215
11667,5472,6195,1160,148800,21216
14952,4881,10071,1065,175900,21217
18344,9011,9333,1239,229800,21218
3726,3259,467,1336,370800,21219
16220,11107,5113,1621,279900,21220
17143,10174,6969,1305,266800,21221
22385,14188,8197,1390,200800,21222
8300,2791,5509,1110,93700,21223
20320,12140,8180,1782,281400,21224
12917,6931,5986,1118,214000,21225
2829,1785,1044,1338,318500,21226
13687,9096,4591,1347,272400,21227
19614,14038,5576,1631,389200,21228
18517,10271,8246,1210,184900,21229
16003,7931,8072,1771,327700,21230
7789,2727,5062,1710,336500,21231
0,0,0,-,-,21233
27258,17770,9488,1542,276000,21234
15627,10813,4814,1591,306800,21236
12291,7623,4668,1440,280400,21237
11796,6614,5182,1337,191200,21239
0,0,0,-,-,21240
14376,6890,7486,1538,271200,21244
0,0,0,-,-,21250
0,0,0,-,-,21251
11,0,11,-,-,21252
0,0,0,-,-,21285
9519,5929,3590,1597,402000,21286
0,0,0,-,-,21287
17980,11229,6751,2106,580600,21401
358,0,358,2690,-,21402
14408,10086,4322,1872,566900,21403
197,186,11,-,944000,21405
7260,6560,700,2007,499700,21409
16659,11649,5010,771,151400,21502
847,670,177,681,275500,21520
628,588,40,917,130900,21521
65,57,8,-,104500,21523
258,177,81,1046,140700,21524
278,203,75,-,145200,21529
675,548,127,880,194100,21530
1101,935,166,672,169500,21531
5207,3441,1766,839,175600,21532
1597,1258,339,649,202800,21536
306,253,53,760,-,21538
814,565,249,822,108700,21539
37,30,7,638,50000,21540
643,481,162,691,245900,21541
55,17,38,707,85500,21542
196,177,19,775,186000,21543
674,521,153,920,111300,21545
5926,4610,1316,724,210300,21550
679,522,157,1054,205900,21555
671,517,154,-,99900,21557
0,0,0,-,-,21560
1180,1078,102,-,288800,21561
1226,962,264,461,113200,21562
10389,6981,3408,1229,370300,21601
161,116,45,1637,405100,21607
141,107,34,1063,219000,21610
221,217,4,-,573400,21612
7610,3979,3631,965,279700,21613
3947,3100,847,1327,460900,21617
2441,1746,695,1845,459100,21619
5674,4030,1644,1149,318700,21620
183,164,19,"3,500+",247600,21622
864,733,131,1108,383300,21623
65,45,20,-,395800,21624
605,467,138,1703,355800,21625
69,69,0,-,708300,21626
15,15,0,-,-,21627
150,150,0,-,168300,21628
3559,2543,1016,1086,293700,21629
974,822,152,1528,307800,21631
2606,1565,1041,990,192800,21632
174,174,0,-,275000,21634
960,744,216,1060,387600,21635
362,281,81,1590,257100,21636
1900,1571,329,1630,491000,21638
1682,1201,481,1017,270300,21639
528,507,21,1625,260200,21640
61,34,27,955,241700,21641
2013,1699,314,739,220000,21643
22,22,0,-,-,21644
452,338,114,1180,298700,21645
170,164,6,-,493800,21647
40,39,1,-,171200,21648
533,453,80,1583,199200,21649
53,53,0,-,-,21650
1010,819,191,1245,259500,21651
105,105,0,-,516300,21652
73,73,0,-,531300,21653
585,508,77,1479,802000,21654
1846,1518,328,1313,291200,21655
541,460,81,1750,354400,21657
1448,1288,160,1775,471300,21658
502,396,106,876,202100,21659
1497,1087,410,1008,322500,21660
1156,888,268,1146,258800,21661
238,191,47,1905,708300,21662
1624,1278,346,993,633300,21663
236,159,77,1135,172100,21664
92,92,0,-,525900,21665
5520,4496,1024,1755,478500,21666
131,115,16,-,-,21667
759,585,174,-,349300,21668
51,51,0,-,410000,21669
385,340,45,-,339400,21671
74,74,0,-,85300,21672
1154,845,309,1360,351400,21673
27,27,0,-,-,21675
207,207,0,-,668800,21676
211,183,28,-,439300,21677
924,836,88,2046,306900,21678
157,157,0,-,543700,21679
17662,11873,5789,1607,404900,21701
17730,11196,6534,1722,384800,21702
15235,10442,4793,1887,364300,21703
6136,4989,1147,2395,585900,21704
0,0,0,-,-,21705
1657,1407,250,2391,582100,21710
407,407,0,-,274100,21711
3939,3164,775,1224,348300,21713
45,45,0,-,314700,21714
12,12,0,-,-,21715
2717,2324,393,1097,335000,21716
96,86,10,-,430000,21717
66,47,19,1104,446900,21718
476,429,47,-,230500,21719
2262,2009,253,877,298400,21722
221,209,12,-,914800,21723
1694,1304,390,824,304000,21727
466,401,65,-,316300,21733
456,277,179,802,241900,21734
689,634,55,-,1032800,21737
1166,1150,16,-,889100,21738
24928,13750,11178,1031,241600,21740
13315,8870,4445,1267,280100,21742
0,0,0,-,-,21746
1646,1192,454,972,212700,21750
2489,2381,108,1745,619700,21754
2106,1786,320,1268,493700,21755
1263,1202,61,1345,360900,21756
1068,881,187,1345,414300,21757
1601,1411,190,1696,388200,21758
77,77,0,-,-,21762
279,215,64,780,192400,21766
528,294,234,834,220100,21767
4316,3777,539,1600,490800,21769
2394,2345,49,-,599700,21770
10879,10107,772,2117,532200,21771
1893,1764,129,1699,475700,21773
5430,5068,362,2322,508100,21774
2280,2097,183,998,433600,21776
750,747,3,-,441300,21777
331,315,16,-,415700,21778
476,273,203,1208,551400,21779
701,524,177,1135,419900,21780
0,0,0,-,-,21781
1613,1304,309,1124,295900,21782
3657,2856,801,1060,330100,21783
13216,11503,1713,1673,478200,21784
4262,3392,870,870,344800,21787
4821,3933,888,1015,342700,21788
8,0,8,-,-,21790
1865,1559,306,1320,370300,21791
3941,3396,545,1489,416400,21793
678,675,3,-,977200,21794
3803,2618,1185,1190,275500,21795
2936,2639,297,1241,713400,21797
860,701,159,932,466100,21798
11171,6326,4845,1058,286800,21801
15229,7508,7721,1343,230200,21804
59,59,0,-,233500,21810
10698,8713,1985,1398,362500,21811
1321,1082,239,979,562600,21813
95,95,0,-,-,21814
1853,1286,567,729,159600,21817
342,307,35,1356,151700,21821
996,793,203,877,220100,21822
106,85,21,-,109000,21824
1990,1266,724,1346,211200,21826
146,134,12,-,183300,21829
1802,1555,247,1413,244900,21830
208,150,58,-,-,21835
1186,1026,160,1142,206100,21837
726,674,52,1516,179200,21838
193,151,42,-,-,21840
397,251,146,1677,326200,21841
5792,4261,1531,1258,415900,21842
1405,1031,374,1168,233600,21849
1586,1369,217,1059,224000,21850
3108,2028,1080,828,186700,21851
3793,2067,1726,973,167000,21853
320,258,62,-,242700,21856
314,266,48,1118,186700,21861
21,0,21,-,-,21862
1961,1464,497,1058,245500,21863
252,211,41,-,173100,21864
169,169,0,-,165200,21865
65,65,0,-,95700,21866
19,19,0,-,-,21867
313,267,46,1313,202900,21869
733,654,79,950,201500,21871
300,276,24,-,385700,21872
714,509,205,1480,219500,21874
3295,2332,963,1320,226600,21875
0,0,0,-,-,21890
7184,5394,1790,1418,342800,21901
52,0,52,-,-,21902
2322,1763,559,1053,271700,21903
2417,2041,376,1245,318800,21904
3984,3253,731,1205,313900,21911
677,611,66,-,385600,21912
380,253,127,882,233800,21913
350,253,97,1490,300600,21914
1164,1012,152,858,353200,21915
692,683,9,-,362200,21917
1608,1421,187,1008,293800,21918
1489,1328,161,1665,347900,21919
352,278,74,-,338600,21920
17493,11954,5539,1413,296000,21921
8,8,0,-,-,21930
18917,13289,5628,1988,694300,22003
14794,12591,2203,2441,666500,22015
6296,5465,831,2205,497700,22025
6284,4415,1869,1802,436300,22026
590,571,19,-,1041900,22027
21247,12330,8917,2242,700700,22030
14777,7078,7699,2267,710400,22031
9848,8421,1427,2269,736500,22032
15649,9829,5820,2253,621600,22033
0,0,0,-,-,22035
5856,5640,216,2426,973800,22039
11159,5789,5370,1913,432800,22041
12045,7873,4172,2178,666700,22042
9798,5966,3832,2136,868600,22043
5365,2689,2676,1814,711400,22044
7108,4320,2788,2216,963600,22046
2806,267,2539,3154,647900,22060
5696,5437,259,"3,500+",1240100,22066
11760,8962,2798,2457,600800,22079
10896,9191,1705,3407,1282800,22101
13230,6294,6936,2471,1003700,22102
6881,6008,873,2469,979900,22124
436,319,117,2000,485200,22125
1480,61,1419,2263,237500,22134
9381,5991,3390,2631,617600,22150
5478,4695,783,2502,636200,22151
9534,7992,1542,2495,620200,22152
10993,9918,1075,2723,652300,22153
3696,2401,1295,1588,509600,22172
9639,6540,3099,2335,916900,22180
5435,4499,936,2756,928400,22181
9950,7129,2821,2618,1086600,22182
24791,14524,10267,2069,432600,22191
20490,15656,4834,2012,465500,22192
24581,19824,4757,1868,427200,22193
20041,6305,13736,2468,760700,22201
15704,3307,12397,2448,838400,22202
13441,4223,9218,2318,809700,22203
22940,9644,13296,1871,672100,22204
6713,5164,1549,1843,1070500,22205
10986,5041,5945,2332,569700,22206
12202,9622,2580,2305,1201800,22207
8185,2384,5801,2171,799900,22209
25,0,25,"3,500+",-,22211
1685,1167,518,"3,500+",1049500,22213
0,0,0,-,-,22214
6091,3385,2706,2368,997800,22301
8844,4912,3932,2039,630600,22302
8003,3901,4102,2050,547300,22303
23363,9597,13766,1934,496000,22304
7669,2563,5106,1902,817200,22305
10950,5484,5466,1750,583200,22306
4529,3419,1110,1906,752700,22307
4769,4459,310,"3,500+",870700,22308
12621,7994,4627,1749,539700,22309
10853,8499,2354,2396,627400,22310
8198,1636,6562,1909,691900,22311
10414,5392,5022,2009,593600,22312
19705,8898,10807,2312,856400,22314
11150,8392,2758,2396,609000,22315
11405,4744,6661,1518,461600,22401
12325,10570,1755,1931,413100,22405
9473,7408,2065,1895,483200,22406
22388,17042,5346,1758,376200,22407
12114,9395,2719,1771,353500,22408
1445,876,569,868,293000,22427
158,134,24,-,-,22432
109,109,0,-,336300,22433
1010,865,145,729,202200,22435
308,295,13,-,222600,22436
225,180,45,-,321300,22437
94,62,32,-,222500,22438
4252,3280,972,896,243200,22443
202,0,202,1940,-,22448
975,686,289,976,226500,22454
813,658,155,1182,199700,22460
941,777,164,1291,243900,22469
0,0,0,-,-,22472
2294,2182,112,682,259500,22473
182,173,9,-,-,22476
521,308,213,1054,382400,22480
1746,1176,570,815,347600,22482
9675,7517,2158,1373,395900,22485
435,283,152,999,516800,22488
1933,1651,282,1092,257300,22503
62,47,15,-,-,22504
6099,5689,410,1693,368200,22508
62,62,0,-,116700,22509
485,424,61,-,410900,22511
985,737,248,963,251200,22514
2058,1757,301,968,242700,22520
42,42,0,-,-,22529
1128,926,202,1710,307700,22534
261,236,25,1732,334100,22535
118,118,0,-,331800,22538
785,758,27,-,412300,22539
836,775,61,2176,314300,22542
6565,5589,976,1532,279400,22546
25,25,0,-,-,22548
8113,7095,1018,1356,372600,22551
5660,4574,1086,1870,438700,22553
19921,15968,3953,2000,482600,22554
9646,7582,2064,1765,453700,22556
2636,1661,975,969,247100,22560
966,782,184,985,323100,22567
2353,1552,801,979,219800,22572
820,754,66,1273,335700,22576
1193,1007,186,1096,482700,22578
1895,1585,310,1402,302400,22580
11843,5020,6823,1316,321800,22601
11319,8894,2425,1367,351400,22602
6903,5174,1729,1695,332000,22603
703,684,19,1297,294700,22610
3422,2674,748,1351,577900,22611
975,859,116,1230,494600,22620
233,155,78,-,238400,22623
986,834,152,1179,403400,22624
1180,1108,72,2046,291700,22625
315,251,64,1576,1027600,22627
13394,9905,3489,1183,329500,22630
871,565,306,1138,361400,22637
280,253,27,-,477300,22639
153,86,67,1635,-,22640
81,63,18,-,218500,22641
1598,1406,192,1568,313500,22642
67,52,15,-,-,22643
1030,982,48,1381,285200,22644
1693,1304,389,1018,389100,22645
0,0,0,-,-,22646
399,393,6,-,257900,22650
543,437,106,-,325000,22652
440,440,0,-,384000,22654
8011,6143,1868,1432,352900,22655
1887,1606,281,2185,411300,22656
4719,3649,1070,998,268600,22657
614,481,133,748,246200,22660
502,431,71,829,412400,22663
3712,1977,1735,979,282500,22664
13100,8960,4140,1386,376100,22701
435,407,28,-,360200,22709
34,26,8,-,-,22711
3077,2484,593,1399,372700,22712
721,648,73,-,367600,22713
326,249,77,-,546400,22714
542,541,1,-,329800,22715
500,500,0,-,628600,22716
305,245,60,-,355000,22718
124,64,60,-,644200,22719
429,388,41,-,537900,22720
148,148,0,-,238900,22722
30,30,0,-,590900,22723
790,714,76,-,502100,22724
28,28,0,-,-,22725
215,164,51,1833,358700,22726
2301,1684,617,1074,350800,22727
1131,949,182,883,495100,22728
135,85,50,-,344700,22729
63,57,6,-,298700,22730
98,85,13,-,351700,22731
128,92,36,-,-,22732
713,519,194,-,275000,22733
1339,785,554,1387,361400,22734
794,684,110,1319,292000,22735
292,285,7,-,315200,22736
1071,1043,28,850,378000,22737
341,322,19,-,284500,22738
370,284,86,1354,398800,22740
149,119,30,-,441100,22741
565,463,102,1331,425000,22742
110,84,26,-,32100,22743
113,113,0,-,566600,22746
530,374,156,1339,490900,22747
125,68,57,-,-,22749
14640,6582,8058,1235,340600,22801
11196,6250,4946,1101,259500,22802
2,0,2,-,-,22807
288,278,10,-,279500,22810
178,105,73,-,181300,22811
3382,2437,945,1158,342100,22812
3564,2494,1070,1005,249700,22815
84,64,20,-,187500,22820
2334,1781,553,979,252000,22821
2427,1899,528,966,268700,22824
4381,3413,968,850,237900,22827
786,654,132,1024,184000,22830
188,151,37,-,193200,22831
386,346,40,-,325200,22832
403,321,82,1140,349300,22834
5034,3588,1446,836,245900,22835
2064,1751,313,1536,355700,22840
1200,1008,192,1172,358300,22841
2147,1592,555,1024,206500,22842
960,782,178,738,246600,22843
2073,1400,673,877,263300,22844
54,54,0,-,-,22845
545,477,68,1394,439300,22846
234,153,81,945,240300,22847
1899,1471,428,1023,178400,22849
453,360,93,1300,328400,22850
2099,1439,660,843,192100,22851
1688,1169,519,961,207100,22853
16636,9486,7150,1612,473500,22901
11334,5976,5358,1572,392800,22902
16009,6572,9437,1479,510500,22903
21,0,21,1104,-,22904
0,0,0,-,-,22908
7741,5463,2278,1882,427400,22911
1705,1434,271,1075,357200,22920
869,767,102,-,209800,22922
2632,1840,792,1759,369000,22923
76,54,22,825,703100,22931
3499,2771,728,1713,552200,22932
407,394,13,-,443100,22935
2298,2074,224,1807,511800,22936
684,489,195,1202,276400,22937
391,315,76,1317,249700,22938
2795,1941,854,1586,323700,22939
286,198,88,-,418200,22940
4289,3221,1068,1148,300000,22942
258,151,107,628,597200,22943
48,48,0,-,340900,22946
2172,1872,300,1087,698600,22947
48,48,0,-,358300,22948
557,398,159,-,259100,22949
591,565,26,950,236600,22952
0,0,0,-,-,22957
1150,979,171,1653,490400,22958
661,566,95,831,554900,22959
4132,2693,1439,1085,274700,22960
6487,5989,498,1419,294600,22963
98,71,27,-,401400,22964
917,652,265,911,255900,22967
3816,3107,709,1206,318000,22968
588,519,69,-,253800,22969
876,616,260,1032,272700,22971
111,111,0,-,707100,22972
2563,1953,610,1244,257600,22973
1415,1270,145,1108,311700,22974
74,63,11,-,-,22976
13808,9328,4480,968,256000,22980
31,0,31,-,-,22989
4249,3422,827,1004,233000,23002
338,265,73,733,123700,23004
7184,5248,1936,1236,376400,23005
2972,2702,270,1167,281700,23009
381,371,10,-,368200,23011
1590,1436,154,-,430800,23015
0,0,0,-,-,23021
429,347,82,944,209000,23022
141,94,47,-,285000,23023
4131,3506,625,1114,330300,23024
315,265,50,-,583900,23025
587,524,63,-,244800,23027
1966,1685,281,996,237500,23030
101,101,0,-,252500,23032
657,588,69,828,433600,23035
648,624,24,1469,345200,23038
423,423,0,-,419900,23039
2065,1378,687,936,187900,23040
747,640,107,1134,340000,23043
48,48,0,-,114600,23045
643,568,75,1180,419200,23047
229,221,8,-,348900,23050
441,179,262,-,159600,23055
93,55,38,-,344600,23056
15231,11968,3263,1840,573800,23059
14057,11115,2942,1696,384800,23060
8827,7701,1126,1199,297100,23061
855,497,358,1100,260500,23062
1685,1372,313,1315,345100,23063
677,558,119,1302,263600,23065
281,171,110,-,408500,23066
137,137,0,-,385300,23068
1256,1136,120,1583,338500,23069
315,315,0,-,499100,23070
834,781,53,1263,408800,23071
5019,3591,1428,1066,282500,23072
3484,2169,1315,1252,198900,23075
262,241,21,-,514800,23076
189,169,20,-,172200,23079
0,0,0,-,-,23081
866,707,159,784,279900,23083
658,557,101,1558,262600,23084
158,135,23,-,-,23085
1423,1268,155,983,290700,23086
2126,1826,300,1532,383600,23089
248,148,100,-,216900,23091
324,260,64,-,255800,23092
5694,4357,1337,1144,269200,23093
1238,1106,132,1398,466000,23102
2738,2604,134,959,605300,23103
375,375,0,-,267500,23106
23,17,6,-,-,23108
969,814,155,-,262700,23109
359,273,86,-,242100,23110
15116,11842,3274,1558,324600,23111
20871,16944,3927,1706,366500,23112
9993,8329,1664,1736,580200,23113
8442,6562,1880,1695,377300,23114
12035,10904,1131,1983,405900,23116
4166,3772,394,1032,272700,23117
62,62,0,-,258300,23119
5387,5215,172,2570,516800,23120
691,420,271,950,159100,23123
1828,1780,48,1868,378200,23124
191,166,25,-,278100,23126
173,173,0,-,245100,23128
159,146,13,-,680000,23129
39,39,0,-,-,23130
479,404,75,2054,270800,23138
10006,9294,712,1153,370400,23139
2828,2594,234,1575,332600,23140
3081,2739,342,1513,358000,23141
1268,1201,67,1758,442900,23146
0,0,0,-,-,23147
617,478,139,990,201700,23148
895,629,266,1325,251800,23149
5263,3971,1292,1185,264600,23150
485,412,73,-,401700,23153
485,424,61,963,216400,23156
0,0,0,-,-,23160
94,41,53,-,-,23161
41,25,16,-,-,23163
3136,2837,299,1590,383300,23168
418,394,24,-,258300,23169
0,0,0,-,-,23173
878,667,211,-,335000,23175
266,207,59,-,250400,23176
331,256,75,976,192400,23177
228,204,24,721,300000,23180
2229,1876,353,1329,265800,23181
19664,14416,5248,1425,413500,23185
18549,13834,4715,1541,409100,23188
2281,1922,359,1107,368500,23192
2854,218,2636,1439,287500,23219
15150,4968,10182,1354,468900,23220
7428,3749,3679,1480,544400,23221
10677,6158,4519,1181,252000,23222
24926,11011,13915,1224,236300,23223
16482,5711,10771,1268,189200,23224
19346,9371,9975,1311,292800,23225
7284,5527,1757,1725,496300,23226
11618,6373,5245,1306,329700,23227
15809,8014,7795,1410,267300,23228
13574,9738,3836,1385,468800,23229
4624,1683,2941,1608,343500,23230
16270,11019,5251,1272,270400,23231
12606,7981,4625,1779,442100,23233
16951,9863,7088,1321,237300,23234
14190,10230,3960,1663,324800,23235
10364,8968,1396,1805,306800,23236
9575,6609,2966,1290,243100,23237
11211,6731,4480,1679,392500,23238
0,0,0,-,-,23250
14,0,14,1625,-,23284
8281,2967,5314,1553,279600,23294
0,0,0,-,-,23298
744,417,327,948,262100,23301
0,0,0,-,-,23302
173,167,6,-,264200,23303
5,5,0,-,-,23304
453,263,190,1260,283600,23306
299,210,89,893,145500,23307
843,546,297,1028,113600,23308
2284,1438,846,795,344700,23310
3818,2859,959,1791,371400,23314
724,566,158,1125,255900,23315
20,20,0,-,218800,23316
25180,16234,8946,1654,323800,23320
14220,10993,3227,1434,352000,23321
21766,19431,2335,1870,448000,23322
14789,12071,2718,1590,360500,23323
8875,4816,4059,1145,242000,23324
7645,4690,2955,1437,262600,23325
1750,1310,440,1102,326400,23336
152,94,58,-,192900,23337
194,142,52,478,-,23347
1300,711,589,674,180100,23350
208,208,0,-,493100,23354
793,749,44,-,227400,23356
193,110,83,1549,207400,23357
108,108,0,-,-,23358
268,255,13,1075,-,23359
40,40,0,-,-,23389
263,219,44,-,138000,23395
9,0,9,-,-,23398
112,58,54,1598,-,23401
598,496,102,-,343100,23405
157,157,0,-,134000,23407
0,0,0,-,-,23408
43,36,7,-,137500,23409
976,644,332,967,197600,23410
304,162,142,590,-,23413
0,0,0,-,-,23414
985,552,433,877,166000,23415
92,70,22,-,"10,000-",23416
1885,1245,640,1035,251400,23417
313,242,71,885,250000,23418
991,683,308,799,142000,23420
1837,1156,681,811,205000,23421
94,74,20,-,-,23422
144,112,32,-,117000,23423
10,10,0,-,-,23426
109,103,6,1063,89100,23427
7475,6494,981,1162,347700,23430
566,503,63,-,376700,23432
516,502,14,-,513500,23433
20164,13590,6574,1242,293600,23434
12700,8746,3954,1838,374500,23435
360,360,0,-,503000,23436
2056,1691,365,999,287300,23437
676,640,36,1159,251300,23438
147,142,5,-,135900,23440
0,0,0,-,-,23441
392,307,85,1078,120200,23442
21605,11552,10053,1697,591300,23451
22558,14346,8212,1571,324000,23452
12623,8763,3860,1723,322100,23453
23146,14955,8191,1600,401900,23454
21058,12854,8204,1610,397700,23455
20407,18229,2178,1928,455500,23456
1673,1444,229,1155,556900,23457
0,0,0,-,-,23459
0,0,0,-,-,23460
0,0,0,-,-,23461
28158,14876,13282,1652,269400,23462
28572,19710,8862,1644,339300,23464
193,170,23,2045,191700,23480
122,94,28,-,-,23486
2341,1891,450,1014,242500,23487
42,42,0,-,-,23488
8357,4019,4338,1335,244800,23502
14177,6942,7235,1195,273100,23503
8554,3005,5549,872,259500,23504
12788,4639,8149,1279,318600,23505
3281,1474,1807,1422,560700,23507
6530,3321,3209,1381,384800,23508
5269,3264,2005,1259,238500,23509
4495,901,3594,1574,349700,23510
283,0,283,2081,-,23511
12072,6641,5431,1187,226900,23513
2784,696,2088,1397,355800,23517
12715,7163,5552,1348,280200,23518
3123,1065,2058,986,222000,23523
29,29,0,-,-,23551
11556,6496,5060,1231,235600,23601
18013,9287,8726,1446,270200,23602
1525,926,599,1430,253100,23603
805,6,799,1828,-,23604
6328,2557,3771,1187,178400,23605
12198,5748,6450,1327,296900,23606
9266,2766,6500,1104,146400,23607
17592,9045,8547,1245,243300,23608
244,0,244,2054,-,23651
5927,4146,1781,1224,200000,23661
4657,3967,690,1634,403000,23662
5816,3014,2802,1248,187700,23663
4354,3160,1194,1303,280700,23664
1527,32,1495,1887,-,23665
23452,11871,11581,1439,241600,23666
0,0,0,-,-,23667
0,0,0,-,-,23668
16254,9544,6710,1202,246400,23669
0,0,0,-,-,23681
1536,1105,431,936,351000,23690
36,0,36,-,-,23691
7525,5843,1682,1862,404500,23692
9003,6326,2677,1741,468400,23693
1366,1254,112,2052,411700,23696
9644,6398,3246,1313,218900,23701
4876,2198,2678,1228,188600,23702
9962,6999,2963,1377,273700,23703
8651,3288,5363,1279,197400,23704
6518,3674,2844,1076,222100,23707
8,0,8,-,-,23708
0,0,0,-,-,23709
1441,33,1408,1813,-,23801
16396,8308,8088,1132,208700,23803
8592,4998,3594,1207,208200,23805
671,516,155,911,98100,23821
2796,1745,1051,1055,220100,23824
463,302,161,960,144800,23827
217,213,4,-,159600,23828
599,457,142,852,249400,23829
588,537,51,629,283900,23830
14817,11071,3746,1560,300200,23831
14039,11974,2065,1851,334800,23832
802,744,58,1073,325900,23833
10772,7841,2931,1214,236100,23834
5383,3856,1527,1622,338700,23836
1730,1157,573,939,195700,23837
6156,5908,248,1454,431400,23838
323,257,66,1750,193000,23839
656,493,163,1292,253800,23840
1325,1192,133,1252,258900,23841
2670,2391,279,982,255000,23842
245,232,13,-,117000,23843
245,182,63,1588,-,23844
145,127,18,-,274500,23845
269,244,25,-,242900,23846
4924,2734,2190,1010,134400,23847
477,471,6,-,260100,23850
5398,3284,2114,1006,222700,23851
457,297,160,912,87000,23856
172,94,78,-,160700,23857
11167,6783,4384,1103,187800,23860
744,569,175,1261,232000,23866
892,685,207,1034,167800,23867
1772,956,816,786,138800,23868
0,0,0,-,-,23870
966,814,152,982,206100,23872
399,311,88,889,138300,23874
4799,3544,1255,1238,254200,23875
175,168,7,-,238800,23876
540,527,13,-,232400,23878
242,157,85,-,211800,23879
967,759,208,565,301800,23881
853,652,201,690,160800,23882
771,631,140,1357,247100,23883
0,0,0,-,-,23884
1200,1109,91,832,271600,23885
377,302,75,-,234100,23887
971,667,304,959,196400,23888
331,276,55,1104,105900,23889
1657,1205,452,914,194000,23890
0,0,0,-,-,23891
198,190,8,-,155600,23893
173,118,55,-,187500,23894
317,114,203,1133,164300,23897
891,610,281,714,293800,23898
197,171,26,1031,186700,23899
5513,3229,2284,878,220200,23901
0,0,0,-,-,23909
433,321,112,1325,137900,23915
1106,945,161,525,176300,23917
1094,955,139,758,260700,23919
1535,1162,373,1123,147500,23920
883,709,174,841,205100,23921
791,635,156,-,139200,23922
976,669,307,676,166100,23923
2511,1855,656,743,122700,23924
2194,1722,472,755,264400,23927
2204,1641,563,952,165800,23930
230,230,0,-,208300,23934
2291,1798,493,827,172600,23936
809,539,270,814,80200,23937
117,93,24,-,75600,23938
541,419,122,724,223400,23942
0,0,0,-,-,23943
1530,1111,419,884,130700,23944
1511,1016,495,658,148300,23947
1513,983,530,824,187500,23950
21,21,0,-,-,23952
929,513,416,693,160400,23954
10,10,0,-,-,23955
1165,927,238,1138,207000,23958
492,461,31,914,142500,23959
923,652,271,725,193400,23960
218,161,57,869,85800,23962
140,122,18,-,223200,23963
397,306,91,718,128600,23964
920,632,288,1019,188700,23966
441,274,167,536,165600,23967
390,276,114,-,100800,23968
3467,2070,1397,1041,157500,23970
1682,1160,522,780,131100,23974
58,18,40,-,-,23976
590,41,549,1091,839300,24011
12348,6739,5609,1002,177000,24012
2596,1175,1421,1017,111500,24013
7282,4975,2307,949,260300,24014
7136,4473,2663,884,251000,24015
4664,883,3781,972,118800,24016
10004,5244,4760,966,139800,24017
16186,11938,4248,1221,327600,24018
11852,9119,2733,1207,237900,24019
0,0,0,-,-,24020
0,0,0,-,-,24022
959,679,280,890,159200,24053
2235,1731,504,898,123200,24054
5087,3975,1112,524,113900,24055
135,123,12,-,169600,24058
388,388,0,-,224400,24059
19092,8050,11042,1266,412300,24060
0,0,0,-,-,24061
1855,1718,137,1172,246300,24064
2769,2266,503,817,241200,24065
2149,1813,336,947,200100,24066
853,657,196,678,186100,24067
663,575,88,1071,148700,24069
563,563,0,-,217900,24070
517,474,43,1469,221100,24072
13041,8638,4403,1150,247200,24073
491,378,113,-,120500,24076
413,254,159,707,321300,24077
2881,1719,1162,725,122300,24078
601,434,167,849,207600,24079
140,140,0,-,-,24082
1549,1257,292,1775,370500,24083
4433,3146,1287,830,187500,24084
1056,975,81,647,140900,24085
76,70,6,-,139300,24086
1679,1179,500,1044,140500,24087
1787,1358,429,658,127100,24088
938,758,180,709,85500,24089
1851,1618,233,887,267100,24090
3302,2793,509,830,244800,24091
1246,1003,243,728,214800,24092
41,38,3,-,112500,24093
1550,1380,170,1250,228000,24095
2545,2180,365,977,285300,24101
612,547,65,533,172900,24102
1491,1413,78,883,290500,24104
182,182,0,-,182900,24105
12849,8845,4004,770,119200,24112
870,696,174,722,197700,24120
4794,4309,485,1227,353100,24121
636,565,71,-,189700,24122
1646,1345,301,677,113100,24124
1460,1163,297,728,179300,24127
705,634,71,656,252900,24128
115,115,0,-,-,24129
6,6,0,-,-,24131
215,174,41,-,129600,24132
1035,802,233,672,131300,24133
2226,1695,531,829,157200,24134
1384,1090,294,773,162500,24136
1256,1114,142,936,197500,24137
483,419,64,945,225700,24138
364,271,93,-,-,24139
8469,4761,3708,999,230000,24141
0,0,0,-,-,24142
508,325,183,630,108800,24147
3032,2552,480,770,131100,24148
1481,1284,197,600,190100,24149
308,272,36,-,118700,24150
7499,5232,2267,769,190800,24151
15095,10823,4272,1058,251400,24153
131,123,8,-,120800,24161
881,524,357,813,151200,24162
656,528,128,1091,150400,24165
85,47,38,-,159400,24167
65,65,0,-,-,24168
3585,2635,950,689,135700,24171
958,856,102,478,185400,24174
3080,2618,462,947,274300,24175
659,614,45,1326,592000,24176
7944,5817,2127,898,217100,24179
1807,1538,269,674,221800,24184
362,336,26,-,202500,24185
6850,4205,2645,763,160700,24201
5172,4313,859,850,195200,24202
7454,5042,2412,794,201400,24210
4250,3531,719,985,280600,24211
1002,680,322,674,54300,24216
201,155,46,-,156500,24217
3877,2722,1155,808,161300,24219
301,301,0,-,110000,24220
256,253,3,-,121300,24221
2123,1597,526,726,112800,24224
846,536,310,391,106600,24225
696,431,265,697,83000,24226
2675,1922,753,744,105200,24228
2848,2180,668,725,104900,24230
1300,956,344,728,139300,24236
414,334,80,1357,86900,24237
8,0,8,-,-,24239
515,471,44,-,140100,24243
1989,1454,535,578,112700,24244
388,231,157,512,90600,24245
64,21,43,-,-,24246
1100,891,209,719,79900,24248
547,489,58,-,73200,24250
3479,2745,734,643,133000,24251
1079,777,302,682,100400,24256
591,520,71,-,117500,24258
1991,1405,586,654,96500,24260
2469,1788,681,619,106100,24263
255,229,26,-,92700,24265
3618,2873,745,643,131800,24266
124,117,7,-,-,24269
123,112,11,-,201800,24270
1125,918,207,690,152400,24271
239,209,30,-,84600,24272
2396,1494,902,678,105600,24273
2067,1274,793,764,81200,24277
1710,1452,258,666,98900,24279
266,227,39,-,259000,24280
832,623,209,860,131300,24281
229,194,35,-,-,24282
864,575,289,548,111700,24283
839,532,307,803,165100,24290
158,112,46,-,84000,24292
4011,3114,897,801,119500,24293
5745,3704,2041,781,161400,24301
746,551,195,771,85500,24311
725,420,305,816,138600,24312
316,316,0,-,-,24313
614,464,150,-,158200,24314
1315,1065,250,684,171600,24315
17,17,0,-,-,24316
1568,1201,367,749,106800,24317
184,175,9,-,48500,24318
2747,1900,847,775,145400,24319
11,11,0,-,-,24322
358,328,30,-,146300,24323
1014,887,127,912,212600,24324
572,487,85,-,139900,24325
355,310,45,-,155400,24326
0,0,0,-,-,24327
968,816,152,541,168800,24328
1233,1074,159,648,116800,24330
7227,5334,1893,713,135300,24333
2323,1741,582,785,174500,24340
3715,2807,908,674,139900,24343
729,645,84,722,150500,24347
1755,1247,508,621,146200,24348
471,443,28,-,98100,24350
240,165,75,-,117100,24351
479,321,158,443,158100,24352
5841,3855,1986,686,142100,24354
2454,2066,388,844,211200,24360
1771,1362,409,904,173400,24361
494,468,26,-,115400,24363
168,161,7,-,63000,24366
1994,1738,256,725,163200,24368
2308,1776,532,597,100700,24370
285,228,57,997,91300,24374
733,604,129,694,77300,24375
154,154,0,-,111800,24377
467,446,21,825,115500,24378
1332,1083,249,782,214200,24380
1379,1111,268,588,155200,24381
6826,4738,2088,706,167300,24382
16657,10594,6063,1002,253700,24401
3,3,0,-,-,24411
115,115,0,-,-,24412
156,156,0,-,181100,24413
25,25,0,-,-,24415
3563,2186,1377,1073,158500,24416
1546,1272,274,1081,348600,24421
2256,1615,641,691,114400,24422
5882,4673,1209,808,113600,24426
679,359,320,667,146400,24430
961,849,112,-,176000,24431
221,213,8,-,164900,24432
32,32,0,-,227300,24433
767,728,39,-,192900,24435
602,602,0,-,298400,24437
496,405,91,809,163400,24439
969,766,203,1091,273400,24440
2542,1951,591,986,250400,24441
31,29,2,-,-,24442
998,708,290,864,163800,24445
195,179,16,-,83900,24448
6376,4259,2117,1017,294200,24450
108,59,49,-,124500,24457
118,118,0,-,199000,24458
210,152,58,-,410000,24459
505,399,106,688,177900,24460
118,15,103,-,562500,24464
564,467,97,863,209300,24465
992,816,176,709,379900,24467
0,0,0,-,-,24469
652,614,38,-,347400,24471
939,830,109,891,239700,24472
352,317,35,-,318700,24473
113,113,0,-,96900,24474
133,121,12,-,207400,24476
4784,3780,1004,1107,260900,24477
760,696,64,-,324700,24479
1849,1388,461,1075,233700,24482
322,315,7,-,210900,24483
242,224,18,373,216000,24484
168,158,10,-,275000,24485
1242,989,253,1045,284100,24486
218,155,63,-,324600,24487
9986,4546,5440,936,155800,24501
16352,8786,7566,1166,214300,24502
7913,5925,1988,972,320500,24503
4084,2191,1893,998,183400,24504
0,0,0,-,-,24515
1975,1383,592,855,133700,24517
994,789,205,710,132500,24520
4078,3179,899,830,233600,24521
4070,3067,1003,923,181700,24522
8577,6700,1877,839,227600,24523
574,456,118,850,201100,24526
1151,964,187,893,135900,24527
1476,1161,315,796,135300,24528
620,486,134,535,167300,24529
392,349,43,-,171900,24530
3374,2687,687,773,149400,24531
697,565,132,559,124400,24534
92,92,0,-,300000,24536
1986,1693,293,770,166700,24538
117,73,44,-,162300,24539
13486,8273,5213,828,146100,24540
12288,6569,5719,818,134800,24541
1705,1428,277,1123,134000,24549
3086,2390,696,806,201700,24550
10554,8615,1939,1087,345600,24551
706,554,152,838,163600,24553
1426,1221,205,956,141900,24554
928,694,234,708,165800,24555
1070,981,89,-,368800,24556
3419,2408,1011,792,132300,24557
2438,1843,595,814,159800,24558
279,221,58,-,285600,24562
2155,1532,623,794,133900,24563
426,321,105,840,133200,24565
578,539,39,-,107600,24566
350,318,32,-,146600,24569
0,0,0,-,-,24570
906,740,166,850,144900,24571
6729,5189,1540,837,187300,24572
1469,1268,201,950,219300,24574
2017,1502,515,828,155700,24577
237,211,26,-,205400,24578
494,368,126,-,139200,24579
282,193,89,692,107700,24580
0,0,0,-,-,24581
1786,1426,360,1021,147000,24586
3550,2567,983,688,204300,24588
890,659,231,644,98800,24589
3096,2558,538,1055,259600,24590
5482,3347,2135,759,156100,24592
908,761,147,957,215900,24593
577,449,128,962,158900,24594
60,15,45,-,-,24595
328,283,45,859,119200,24597
518,438,80,1366,154000,24598
449,397,52,-,-,24599
0,0,0,-,-,24601
295,172,123,639,58900,24602
160,160,0,-,-,24603
88,88,0,-,-,24604
3617,2658,959,823,144600,24605
106,106,0,-,39300,24606
157,138,19,-,44400,24607
2872,2212,660,801,154000,24609
81,57,24,-,-,24612
164,128,36,-,-,24613
2690,2294,396,777,117700,24614
804,697,107,-,66300,24620
289,240,49,-,78400,24622
2416,1634,782,767,107900,24630
490,321,169,814,62300,24631
156,150,6,-,109700,24634
156,113,43,725,50200,24635
1396,1111,285,759,159800,24637
1301,905,396,692,107300,24639
2315,1542,773,823,103900,24641
395,386,9,-,76000,24646
823,661,162,2548,94400,24649
2183,1624,559,490,117700,24651
1105,918,187,635,90400,24656
91,22,69,1146,-,24657
7713,4899,2814,775,100000,24701
614,534,80,1020,178300,24712
37,37,0,-,276600,24714
109,103,6,-,230900,24715
112,41,71,-,-,24716
42,42,0,-,-,24719
29,25,4,-,76100,24724
112,92,20,-,-,24726
32,32,0,-,-,24729
12,0,12,-,-,24731
137,137,0,-,266500,24733
302,247,55,565,38000,24736
485,258,227,521,120700,24737
0,0,0,-,-,24738
5786,4458,1328,850,122400,24739
6837,4318,2519,831,133200,24740
1345,994,351,914,99700,24747
1135,833,302,832,52100,24801
286,234,52,-,29400,24808
191,120,71,-,164300,24811
60,60,0,-,-,24813
166,144,22,-,-,24815
14,14,0,-,-,24816
583,490,93,538,50100,24817
645,523,122,-,81300,24818
440,390,50,-,124500,24822
165,139,26,-,-,24823
62,0,62,-,-,24826
400,343,57,-,211200,24827
239,230,9,-,44600,24828
32,32,0,-,-,24830
87,87,0,-,45800,24831
428,428,0,-,103300,24834
175,156,19,-,58900,24836
142,110,32,-,-,24839
14,14,0,-,-,24843
425,366,59,-,65700,24844
219,195,24,-,95800,24845
131,97,34,-,80100,24846
74,74,0,-,-,24847
48,38,10,-,-,24848
67,67,0,-,-,24849
0,0,0,-,-,24850
119,99,20,-,83100,24851
246,136,110,605,-,24853
270,194,76,-,45800,24854
15,15,0,-,-,24855
289,228,61,-,45500,24857
144,110,34,-,-,24860
36,0,36,-,-,24861
313,242,71,666,-,24862
239,239,0,-,17300,24866
27,27,0,-,-,24867
447,406,41,685,39200,24868
116,116,0,-,72800,24869
826,596,230,882,58600,24870
193,138,55,-,39200,24871
342,264,78,-,-,24872
107,86,21,-,181100,24873
755,547,208,502,98100,24874
103,64,39,-,28600,24878
132,83,49,-,66200,24879
228,187,41,-,114900,24880
40,40,0,-,-,24881
372,372,0,-,-,24882
39,30,9,-,-,24884
0,0,0,-,-,24887
35,35,0,-,61900,24888
557,231,326,723,37600,24892
119,87,32,-,29400,24894
8,8,0,-,-,24895
87,87,0,-,-,24898
4221,2702,1519,926,243700,24901
1550,1199,351,806,118700,24910
241,178,63,768,55200,24915
173,159,14,-,334800,24916
476,311,165,664,180300,24918
122,98,24,-,76800,24920
282,249,33,-,157200,24924
199,199,0,-,201400,24925
206,164,42,-,59700,24927
582,447,135,921,124800,24931
173,128,45,-,241300,24934
169,154,15,-,-,24935
587,506,81,-,172500,24938
379,321,58,722,116100,24941
54,54,0,-,205000,24943
141,123,18,-,160600,24944
113,113,0,-,91300,24945
341,317,24,-,173600,24946
646,566,80,-,174300,24951
1237,1021,216,666,132200,24954
211,197,14,-,311300,24957
35,35,0,-,-,24962
1514,1277,237,847,133900,24963
509,453,56,378,126600,24966
1858,1406,452,842,111900,24970
135,135,0,-,79400,24974
425,341,84,-,177500,24976
140,114,26,-,94200,24977
303,168,135,-,47000,24981
751,631,120,588,219700,24983
86,68,18,-,-,24984
43,38,5,-,200000,24985
2258,1658,600,794,124000,24986
232,232,0,-,126400,24991
27,27,0,-,-,24993
0,0,0,-,-,25002
823,569,254,738,106200,25003
93,93,0,-,141800,25005
246,246,0,-,258800,25007
67,56,11,-,-,25008
267,239,28,-,94100,25009
197,160,37,815,114100,25011
1586,1168,418,1077,106900,25015
200,169,31,-,54900,25019
197,185,12,-,78800,25021
16,16,0,-,-,25022
219,152,67,648,63900,25024
43,18,25,-,-,25025
119,116,3,-,79100,25028
159,133,26,-,-,25030
395,201,194,533,84800,25031
716,627,89,724,110300,25033
186,133,53,-,71300,25035
148,81,67,-,40800,25036
263,231,32,-,67700,25039
186,128,58,-,98200,25040
463,245,218,667,-,25043
147,109,38,-,-,25044
1620,1246,374,924,105800,25045
50,50,0,-,-,25047
56,45,11,-,38000,25048
162,133,29,-,81600,25049
83,83,0,-,81700,25051
1419,1005,414,709,128400,25053
97,33,64,-,-,25054
53,53,0,-,-,25057
134,111,23,-,-,25059
19,0,19,-,-,25060
220,213,7,-,82300,25061
124,124,0,-,-,25062
652,553,99,-,108500,25063
4396,2679,1717,902,117700,25064
295,203,92,907,87600,25067
755,606,149,1011,208900,25070
4461,3253,1208,750,159100,25071
292,105,187,-,28600,25075
34,34,0,-,"10,000-",25076
475,450,25,-,165700,25081
768,768,0,-,251300,25082
150,137,13,-,57400,25083
256,196,60,800,96300,25085
322,265,57,894,98100,25086
110,110,0,-,15800,25088
53,25,28,-,-,25090
56,26,30,-,-,25093
129,121,8,-,51300,25102
126,64,62,-,81500,25103
193,162,31,831,-,25106
187,180,7,-,68000,25107
232,232,0,-,177700,25108
306,279,27,-,167600,25109
179,179,0,-,-,25110
107,102,5,-,79500,25111
0,0,0,-,-,25112
202,185,17,-,95000,25113
127,119,8,-,-,25114
18,18,0,-,-,25115
100,27,73,-,-,25118
129,129,0,-,53600,25119
382,318,64,442,-,25121
1162,896,266,654,138300,25123
760,748,12,-,142000,25124
323,258,65,510,127900,25125
71,71,0,-,28300,25126
1254,883,371,1059,98200,25130
139,74,65,-,38300,25132
241,165,76,430,115600,25133
157,157,0,-,-,25134
813,349,464,628,110300,25136
194,194,0,-,260500,25139
420,275,145,-,44500,25140
108,108,0,-,-,25141
96,96,0,-,-,25142
3709,2721,988,878,119300,25143
161,161,0,-,81700,25148
54,46,8,-,"10,000-",25149
191,191,0,-,83200,25152
407,269,138,-,101300,25154
48,48,0,-,-,25156
1640,1333,307,643,155400,25159
263,207,56,-,28700,25160
237,237,0,-,68300,25161
137,105,32,775,128700,25162
317,305,12,-,123900,25164
257,236,21,-,108900,25165
1139,1015,124,1051,198000,25168
187,126,61,945,-,25169
27,27,0,-,-,25173
149,149,0,-,67300,25174
9783,6944,2839,837,129100,25177
69,69,0,-,115700,25180
520,489,31,-,86600,25181
39,39,0,-,-,25183
0,0,0,-,-,25185
381,232,149,496,73400,25186
362,346,16,-,232300,25187
91,70,21,808,76600,25193
22,22,0,-,-,25201
448,387,61,-,178300,25202
52,17,35,-,-,25203
55,48,7,-,39300,25204
56,56,0,-,120500,25205
83,44,39,-,56900,25206
261,173,88,664,43500,25208
253,224,29,654,77000,25209
41,41,0,-,14500,25211
2488,2078,410,1020,248800,25213
362,282,80,-,-,25214
0,0,0,-,-,25231
239,213,26,819,133800,25234
395,308,87,565,135700,25235
508,469,39,1006,160800,25239
746,590,156,671,224000,25241
286,262,24,-,112500,25243
249,228,21,-,103500,25244
299,299,0,-,145500,25245
211,163,48,750,70500,25247
1325,1071,254,723,187900,25248
208,154,54,650,187100,25251
475,405,70,-,169200,25252
909,814,95,-,135600,25253
276,216,60,-,190500,25259
649,505,144,870,91600,25260
69,69,0,-,88100,25261
458,447,11,-,134900,25262
213,153,60,-,187000,25264
692,582,110,491,108700,25265
267,209,58,-,190700,25266
211,166,45,-,-,25267
226,182,44,-,106800,25268
340,263,77,-,206300,25270
3607,2482,1125,596,156700,25271
841,692,149,-,150200,25275
3147,2252,895,672,109600,25276
263,181,82,-,176500,25285
568,496,72,-,110900,25286
188,132,56,-,184100,25287
1396,252,1144,488,188100,25301
6369,3918,2451,875,148500,25302
3055,2126,929,1036,167500,25303
3364,2294,1070,1017,227100,25304
0,0,0,-,-,25305
2952,2034,918,1311,97000,25306
5373,3774,1599,767,142700,25309
4384,2437,1947,875,113100,25311
3698,3159,539,810,126400,25312
5395,3990,1405,940,148300,25313
6664,5499,1165,1080,243900,25314
1395,979,416,879,83400,25315
1885,1385,500,764,153300,25320
2070,1443,627,1029,85700,25387
6305,3364,2941,1014,221500,25401
6246,5096,1150,1381,301800,25403
9454,5563,3891,1228,226900,25404
5689,4790,899,1549,254700,25405
5049,3985,1064,853,222700,25411
3224,2631,593,1307,249300,25413
7797,5968,1829,1036,365500,25414
5012,4154,858,1229,250700,25419
2058,1661,397,768,274600,25420
17,17,0,-,-,25421
707,698,9,-,160200,25422
5479,4582,897,1173,303800,25425
6419,5793,626,1218,257900,25427
5156,4539,617,1378,233900,25428
2973,2389,584,1333,279500,25430
92,78,14,-,180200,25431
43,22,21,-,190000,25432
964,804,160,785,168300,25434
84,64,20,-,-,25437
2765,1931,834,1112,228700,25438
884,792,92,1155,352900,25442
2497,2015,482,1013,395400,25443
112,103,9,-,227500,25444
410,374,36,-,365100,25446
505,451,54,-,110800,25501
205,183,22,-,-,25502
257,240,17,-,70400,25503
4830,3811,1019,885,181000,25504
144,144,0,-,151300,25505
2084,1526,558,786,86900,25506
469,361,108,700,137200,25507
3414,2665,749,644,131600,25508
2138,1782,356,861,167900,25510
354,309,45,-,130500,25511
518,406,112,698,91800,25512
1469,1151,318,908,55500,25514
842,736,106,-,155600,25515
580,479,101,776,53500,25517
656,608,48,-,85200,25520
349,283,66,-,95600,25521
856,581,275,689,130400,25523
1005,869,136,-,87400,25524
9084,7301,1783,904,231800,25526
372,275,97,883,78200,25529
2824,2060,764,817,144400,25530
52,52,0,-,86200,25534
850,733,117,1045,218600,25535
726,430,296,749,177900,25537
128,117,11,-,37200,25540
3902,3197,705,896,177400,25541
43,43,0,-,109200,25544
1781,1618,163,944,191400,25545
210,130,80,-,105800,25547
3874,2997,877,637,126800,25550
647,428,219,820,105800,25555
692,566,126,823,-,25557
671,524,147,-,125000,25559
3346,2718,628,1520,257200,25560
456,353,103,-,250500,25564
371,271,100,-,112200,25565
273,198,75,-,96600,25567
2289,1841,448,822,117100,25570
773,554,219,720,125300,25571
177,105,72,-,-,25573
1911,1202,709,875,97000,25601
281,206,75,1321,86700,25606
344,193,151,534,69300,25607
316,296,20,-,100000,25608
410,380,30,-,-,25611
135,135,0,-,-,25612
79,64,15,-,-,25617
784,646,138,781,77600,25621
171,171,0,-,110800,25624
369,369,0,-,89200,25625
209,133,76,949,-,25628
142,133,9,-,108100,25630
259,221,38,-,-,25632
519,464,55,-,104000,25634
607,416,191,909,120500,25635
530,395,135,697,73100,25637
113,78,35,-,62900,25638
294,249,45,-,-,25639
223,145,78,-,-,25644
311,258,53,-,93100,25646
110,60,50,-,48300,25647
574,378,196,-,112200,25649
20,20,0,-,-,25650
182,139,43,-,81000,25651
545,469,76,1024,75200,25652
41,41,0,-,-,25653
62,62,0,-,-,25654
1940,1047,893,558,89900,25661
17,17,0,-,-,25666
161,95,66,903,-,25667
344,277,67,-,-,25669
1387,1144,243,800,78800,25670
558,336,222,526,-,25671
210,181,29,-,94000,25672
810,589,221,893,83800,25674
486,413,73,-,111100,25676
612,391,221,381,91500,25678
156,146,10,-,-,25685
134,31,103,587,75000,25688
214,157,57,-,114500,25690
527,458,69,290,95300,25692
534,392,142,815,77500,25696
0,0,0,-,-,25699
10121,5732,4389,869,153700,25701
3087,1671,1416,845,79900,25702
2097,336,1761,869,77500,25703
6032,4108,1924,920,119000,25704
8968,5761,3207,917,159900,25705
34,0,34,-,-,25755
12619,8234,4385,842,151000,25801
0,0,0,-,-,25810
17,17,0,-,-,25811
567,433,134,725,73000,25812
2450,2162,288,1015,147600,25813
27,27,0,-,-,25817
127,61,66,-,84100,25818
218,218,0,-,330200,25820
198,138,60,-,-,25823
919,837,82,-,134100,25825
181,181,0,-,36300,25826
725,657,68,-,203800,25827
468,347,121,-,92300,25831
1911,1654,257,-,196100,25832
365,325,40,-,176000,25836
184,184,0,-,141900,25837
219,150,69,-,70600,25839
3123,2454,669,880,119000,25840
125,125,0,-,146600,25841
534,378,156,928,264700,25843
277,207,70,-,67600,25844
272,186,86,-,-,25845
41,41,0,-,-,25846
37,20,17,-,-,25848
200,95,105,-,-,25849
0,0,0,-,-,25851
26,26,0,-,-,25853
235,204,31,-,176800,25854
119,82,37,-,-,25855
13,13,0,-,-,25857
176,176,0,-,233000,25862
54,54,0,-,-,25864
616,548,68,618,163200,25865
122,101,21,-,-,25866
248,239,9,-,127400,25868
48,48,0,-,-,25870
378,248,130,989,85600,25871
399,350,49,-,130500,25873
175,144,31,-,168800,25875
32,32,0,-,-,25876
506,416,90,-,-,25878
101,89,12,-,31500,25879
2091,1382,709,975,108700,25880
786,669,117,580,79700,25882
4166,3026,1140,817,112200,25901
134,134,0,-,-,25902
267,231,36,-,56000,25904
46,46,0,-,-,25907
66,0,66,-,-,25908
368,338,30,-,114400,25909
90,90,0,-,46400,25911
64,64,0,-,-,25913
108,89,19,-,-,25915
49,49,0,-,-,25916
663,548,115,-,84700,25917
1679,1559,120,938,185600,25918
47,47,0,-,-,25920
1092,643,449,814,99600,25921
45,45,0,-,-,25922
100,100,0,-,-,25928
52,52,0,-,-,25932
5,0,5,-,-,25936
596,493,103,-,99500,25938
41,41,0,-,-,25942
0,0,0,-,-,25943
2418,1865,553,890,117800,25951
208,173,35,-,74000,25958
1415,988,427,730,96000,25962
22,22,0,-,160900,25966
584,542,42,-,188300,25969
590,590,0,-,143600,25971
93,54,39,-,51800,25972
1022,887,135,669,117300,25976
8,8,0,-,-,25977
220,219,1,-,166400,25978
254,248,6,-,148800,25979
372,267,105,687,37300,25981
753,545,208,593,76400,25984
122,76,46,-,110400,25985
117,117,0,-,146600,25986
158,91,67,-,186000,25989
18193,12435,5758,823,164500,26003
226,179,47,795,62800,26030
687,453,234,840,93500,26031
202,148,54,814,85400,26032
824,640,184,696,152800,26033
2223,1786,437,769,117400,26034
828,767,61,-,150500,26035
197,176,21,-,-,26036
2673,1855,818,623,130800,26037
1236,1127,109,907,202400,26038
160,108,52,-,195000,26039
744,476,268,545,88000,26040
6200,4706,1494,823,128400,26041
2330,1803,527,692,145500,26047
681,391,290,661,82900,26050
515,471,44,850,-,26055
77,77,0,-,76400,26056
30,25,5,-,-,26058
1239,961,278,908,168200,26059
558,491,67,1067,198200,26060
9478,6581,2897,747,122800,26062
3352,2725,627,552,126900,26070
180,132,48,956,158300,26074
228,206,22,843,63100,26075
12197,8098,4099,759,107300,26101
7429,5434,1995,720,164600,26104
5235,3957,1278,859,162100,26105
487,446,41,-,220000,26133
272,192,80,608,116300,26134
124,110,14,-,-,26136
325,296,29,-,152600,26137
52,52,0,-,-,26138
212,174,38,473,74800,26141
884,823,61,794,98000,26142
1392,1159,233,577,97200,26143
459,352,107,850,165000,26146
812,657,155,481,95000,26147
136,124,12,-,76700,26148
877,755,122,688,123600,26149
2443,1734,709,873,172100,26150
191,148,43,-,104100,26151
12,0,12,-,-,26152
3186,2603,583,701,123000,26155
1014,800,214,830,101700,26159
456,436,20,-,148200,26160
211,211,0,-,176500,26161
0,0,0,-,-,26162
2948,2239,709,900,136500,26164
278,257,21,-,104800,26167
355,275,80,-,114700,26169
2197,1833,364,731,126100,26170
1192,999,193,683,112200,26175
122,55,67,-,153100,26178
798,621,177,953,118200,26180
2372,2110,262,1043,200200,26181
882,802,80,643,175000,26184
2712,2360,352,865,183100,26187
7722,5944,1778,782,162600,26201
125,125,0,-,-,26202
155,110,45,-,"10,000-",26203
1048,772,276,607,97300,26205
916,707,209,675,74600,26206
311,257,54,713,67000,26208
35,29,6,-,225000,26209
9,9,0,-,-,26210
54,54,0,-,-,26215
70,30,40,-,212500,26217
1031,880,151,931,138600,26218
95,75,20,-,117700,26222
91,73,18,-,91700,26224
0,0,0,-,-,26228
70,61,9,-,-,26230
523,511,12,-,201700,26234
0,0,0,-,-,26236
188,188,0,-,110700,26237
553,553,0,-,133500,26238
5645,4028,1617,831,143100,26241
1684,1311,373,817,107800,26250
1159,871,288,675,159100,26253
54,54,0,-,207900,26254
301,271,30,-,142700,26257
37,37,0,-,227500,26259
563,463,100,650,205500,26260
1225,1005,220,628,64400,26261
111,111,0,-,74100,26263
260,208,52,694,132700,26264
47,47,0,-,-,26266
243,167,76,-,216100,26267
16,16,0,-,-,26268
480,472,8,-,155100,26269
349,318,31,618,159500,26270
177,142,35,679,110500,26271
292,267,25,1083,115800,26273
200,140,60,659,75000,26275
247,237,10,-,153600,26276
240,209,31,-,119500,26278
557,425,132,842,141300,26280
105,105,0,-,74500,26282
590,530,60,578,146400,26283
157,157,0,-,95500,26285
1171,905,266,725,125300,26287
1169,872,297,522,88300,26288
4,4,0,-,-,26289
13,13,0,-,-,26291
264,162,102,818,152900,26292
257,193,64,-,253500,26293
203,203,0,-,84300,26294
20,20,0,-,-,26296
24,24,0,-,58800,26298
11754,7856,3898,772,123500,26301
319,308,11,-,79100,26320
106,83,23,-,-,26321
224,104,120,763,68500,26323
113,90,23,-,-,26325
30,30,0,-,-,26327
6248,4769,1479,1101,260900,26330
459,350,109,751,101100,26335
340,301,39,475,88800,26337
200,173,27,-,115500,26338
71,65,6,-,189000,26339
248,234,14,-,-,26342
168,154,14,-,-,26343
206,173,33,577,124700,26346
829,706,123,871,-,26347
135,126,9,-,73200,26348
84,48,36,-,-,26349
1093,730,363,866,87300,26351
4056,3450,606,472,129300,26354
27,6,21,-,-,26361
1161,946,215,625,110000,26362
4,4,0,-,-,26366
145,80,65,-,125000,26369
281,220,61,1141,410100,26372
708,686,22,-,142600,26374
198,173,25,-,230400,26376
283,254,29,-,116300,26377
1884,1604,280,662,172500,26378
134,116,18,-,179300,26384
1142,1053,89,933,155100,26385
900,742,158,742,162900,26386
97,97,0,-,65200,26404
322,285,37,-,98800,26405
810,696,114,578,236100,26408
315,289,26,1284,112800,26410
277,189,88,828,152500,26411
268,234,34,-,-,26412
1025,931,94,822,105800,26415
2947,2273,674,792,136500,26416
249,168,81,-,95100,26419
77,53,24,-,-,26421
128,123,5,-,102300,26422
81,63,18,-,-,26424
407,311,96,673,91000,26425
2445,2120,325,563,117700,26426
160,119,41,-,117500,26430
2289,1615,674,898,138700,26431
8,8,0,-,-,26435
65,39,26,-,58900,26436
184,148,36,-,93900,26437
89,42,47,-,-,26438
499,460,39,-,187100,26440
111,111,0,-,-,26443
1380,1183,197,640,111000,26444
488,341,147,705,182000,26447
381,356,25,-,85400,26448
186,157,29,578,130500,26451
3952,2488,1464,750,112500,26452
1220,1081,139,756,172300,26456
110,61,49,-,201000,26463
8690,5186,3504,914,213000,26501
16392,5448,10944,942,265100,26505
25,25,0,-,-,26506
15691,11806,3885,984,287700,26508
831,602,229,698,111200,26519
179,179,0,-,201300,26520
65,58,7,-,112500,26521
62,46,16,-,157000,26524
2213,1941,272,826,203300,26525
403,229,174,813,135400,26534
2349,1735,614,676,169000,26537
1441,1304,137,911,228200,26541
877,747,130,850,152300,26542
26,26,0,-,-,26543
0,0,0,-,-,26544
177,134,43,-,-,26546
1091,850,241,842,185900,26547
17512,12713,4799,931,181800,26554
638,588,50,988,159000,26559
51,51,0,-,93500,26560
233,194,39,-,-,26562
99,63,36,-,80500,26563
214,187,27,-,84700,26568
1232,1080,152,534,152500,26570
622,559,63,690,133200,26571
101,50,51,1117,54500,26572
159,139,20,-,90300,26574
295,263,32,475,90300,26575
350,350,0,-,113800,26576
417,390,27,-,-,26581
1734,1436,298,734,101000,26582
206,178,28,-,206300,26585
34,34,0,-,280600,26586
49,49,0,-,58300,26587
1131,903,228,788,179800,26588
257,233,24,-,-,26590
458,360,98,745,112300,26591
1315,1001,314,547,121200,26601
374,267,107,741,96300,26610
57,49,8,-,94100,26611
46,35,11,-,-,26615
164,164,0,-,116700,26617
190,162,28,-,106500,26619
370,272,98,711,112500,26621
502,478,24,-,-,26623
1014,729,285,436,89100,26624
67,42,25,-,196900,26627
157,121,36,-,110700,26629
111,103,8,-,-,26631
78,78,0,-,-,26636
94,82,12,-,50800,26638
3802,3041,761,760,156500,26651
160,104,56,-,157100,26656
114,114,0,-,223900,26660
243,243,0,-,160000,26662
14,14,0,-,54500,26667
121,121,0,-,102300,26671
124,124,0,-,111700,26676
524,524,0,-,113900,26678
554,461,93,1064,175100,26679
154,148,6,-,98000,26680
461,438,23,-,57000,26681
109,109,0,-,-,26684
265,230,35,-,51700,26690
245,141,104,-,155800,26691
2045,1854,191,-,224000,26704
303,205,98,-,154300,26705
151,128,23,715,78500,26707
851,723,128,725,191800,26710
980,862,118,1169,230100,26711
113,103,10,-,210200,26714
350,208,142,926,156300,26716
394,381,13,-,87800,26717
892,707,185,775,197900,26719
14,14,0,-,-,26720
160,117,43,1183,-,26722
4978,3645,1333,629,168400,26726
114,84,30,-,332300,26731
240,190,50,-,147200,26739
853,786,67,-,232400,26743
335,220,115,496,44500,26750
2420,2087,333,880,214400,26753
250,230,20,-,165100,26755
2517,1766,751,586,191700,26757
330,257,73,-,79700,26761
555,484,71,-,225200,26763
1717,1322,395,778,133500,26764
137,127,10,-,210700,26767
513,406,107,-,165200,26801
409,333,76,758,170400,26802
191,152,39,575,153600,26804
803,656,147,716,223800,26807
306,260,46,-,240000,26808
154,148,6,-,120800,26810
684,593,91,1099,140900,26812
139,139,0,-,181300,26814
176,149,27,670,132500,26815
120,120,0,-,-,26817
377,232,145,663,116300,26818
66,9,57,-,-,26823
1040,961,79,-,171400,26833
2645,1959,686,816,152900,26836
34,34,0,-,-,26838
317,288,29,-,201100,26845
2204,1587,617,599,169000,26847
867,739,128,846,195400,26851
362,350,12,-,180600,26852
272,250,22,-,150000,26855
104,86,18,-,-,26865
341,282,59,778,207400,26866
80,64,16,-,176300,26884
99,72,27,811,-,26886
6618,5876,742,1025,319700,27006
847,674,173,710,190300,27007
1248,1170,78,1207,244300,27009
2319,1858,461,734,161100,27011
12370,9987,2383,1147,314500,27012
2437,2055,382,790,196300,27013
369,265,104,964,139300,27014
930,807,123,-,159600,27016
3524,2651,873,676,138800,27017
2965,2427,538,723,223700,27018
1518,1279,239,779,186500,27019
2368,1925,443,778,149300,27020
7297,5231,2066,912,203600,27021
489,359,130,809,144300,27022
5261,4567,694,1030,315000,27023
1082,938,144,596,182300,27024
5005,4021,984,709,168900,27025
1982,1236,746,646,116500,27027
9782,7825,1957,837,198400,27028
15382,10748,4634,727,153100,27030
4757,4353,404,1530,259100,27040
3155,2472,683,796,214900,27041
78,78,0,-,136800,27042
2732,2478,254,834,211600,27043
4219,3340,879,1077,181800,27045
1143,926,217,573,185600,27046
501,458,43,-,192400,27047
3539,3027,512,827,152200,27048
1545,1303,242,856,185800,27050
2973,2286,687,1151,193900,27051
4111,3214,897,737,182500,27052
1468,1281,187,719,191200,27053
1047,1002,45,-,209500,27054
5268,4001,1267,771,195200,27055
10120,3378,6742,970,201500,27101
16156,8766,7390,1113,220600,27103
13985,8438,5547,1135,329300,27104
15018,8165,6853,888,151300,27105
19808,10469,9339,1090,286000,27106
18990,12912,6078,889,201700,27107
0,0,0,-,-,27109
0,0,0,-,-,27110
16474,10746,5728,1088,189900,27127
55,41,14,-,159200,27201
30,30,0,-,-,27202
9219,4013,5206,852,141100,27203
14428,11374,3054,789,191900,27205
1559,1331,228,588,188800,27207
674,588,86,-,167800,27208
1341,834,507,614,121200,27209
532,321,211,854,176400,27212
38,38,0,-,-,27213
5443,3911,1532,1178,298200,27214
20082,12248,7834,1112,241700,27215
14604,8998,5606,859,164900,27217
1078,817,261,947,101700,27229
993,791,202,1054,217300,27231
1236,1074,162,830,215800,27233
2079,1631,448,1932,281200,27235
3446,2826,620,824,175400,27239
691,459,232,702,117900,27242
2125,1938,187,873,264200,27243
4920,3917,1003,831,248500,27244
58,26,32,-,-,27247
1496,1191,305,1003,168800,27248
5528,4472,1056,840,220100,27249
529,470,59,900,168100,27252
13666,9076,4590,975,212300,27253
74,74,0,-,-,27256
2565,2118,447,856,198000,27258
11,11,0,-,-,27259
9807,3994,5813,796,111900,27260
9014,5332,3682,1054,212500,27262
8358,5798,2560,924,171900,27263
21366,14477,6889,1123,239400,27265
0,0,0,-,-,27268
11504,8897,2607,1294,380000,27278
1264,1067,197,971,289400,27281
6257,4654,1603,1374,267400,27282
1235,1093,142,1159,199700,27283
23559,16995,6564,1086,259500,27284
9738,5806,3932,828,129200,27288
750,698,52,612,254500,27291
16044,10771,5273,831,193300,27292
15641,11819,3822,866,191900,27295
3882,2530,1352,887,183000,27298
1787,1448,339,951,200000,27299
3784,3238,546,1630,227200,27301
13739,9544,4195,1130,275400,27302
534,480,54,1202,138300,27305
2450,1935,515,780,148700,27306
2973,2780,193,-,495500,27310
1341,903,438,613,111300,27311
9892,7783,2109,933,423200,27312
3186,2720,466,873,211800,27313
270,270,0,-,160400,27314
815,589,226,1276,134300,27315
2643,1967,676,830,141600,27316
6634,5043,1591,793,170100,27317
16016,11976,4040,776,170700,27320
2434,1974,460,646,109900,27325
1519,1200,319,636,147000,27326
15512,9456,6056,966,213000,27330
12676,9470,3206,1086,224000,27332
41,11,30,-,-,27340
1916,1668,248,741,155300,27341
20,20,0,-,182100,27342
629,532,97,-,375000,27343
7131,5076,2055,1072,176800,27344
2518,2074,444,778,202100,27349
2383,2044,339,953,159900,27350
44,44,0,-,-,27351
852,500,352,747,132100,27355
1042,674,368,752,155400,27356
3729,3077,652,856,259600,27357
5353,4885,468,1101,410000,27358
19265,13165,6100,853,174500,27360
5566,4821,745,904,172600,27370
3089,2170,919,584,157300,27371
127,44,83,-,-,27374
3873,3341,532,984,314700,27376
4246,2887,1359,1204,259300,27377
1778,1126,652,608,155600,27379
8104,2876,5228,883,138300,27401
7700,4083,3617,998,218600,27403
19938,9767,10171,1002,150600,27405
25974,14276,11698,1103,191800,27406
21905,10350,11555,1113,203800,27407
7532,5420,2112,1139,331000,27408
8511,2779,5732,1173,189200,27409
23928,15543,8385,1307,308200,27410
0,0,0,-,-,27411
0,0,0,-,-,27412
12096,8650,3446,1231,324200,27455
8607,6633,1974,1008,251100,27501
16803,13673,3130,1786,491900,27502
1335,1202,133,-,369300,27503
6406,4964,1442,995,217400,27504
2848,1994,854,975,190900,27505
16,0,16,-,-,27506
726,602,124,-,171900,27507
837,685,152,859,252600,27508
1351,863,488,1177,207000,27509
6927,1964,4963,1360,439200,27510
13337,8995,4342,1436,416600,27511
19726,12467,7259,1491,468300,27513
10096,5064,5032,1491,628700,27514
17210,12383,4827,1446,508400,27516
12299,8290,4009,1518,571900,27517
8206,5378,2828,1537,594900,27518
23756,16406,7350,1854,614100,27519
17624,13449,4175,1430,282200,27520
2649,1774,875,912,201700,27521
5410,4249,1161,1082,253600,27522
7119,4919,2200,1805,585900,27523
5197,3675,1522,1011,210900,27524
6307,5302,1005,1011,258300,27525
21689,17503,4186,1591,372300,27526
12620,10708,1912,1617,360700,27527
20789,15127,5662,1379,325600,27529
15691,9130,6561,827,176500,27530
18,0,18,-,-,27531
0,0,0,-,-,27533
13820,7381,6439,1106,187700,27534
6258,2344,3914,841,120600,27536
8777,6060,2717,915,150800,27537
8674,7180,1494,1781,494400,27539
15415,13025,2390,1718,474700,27540
1492,1242,250,1579,237900,27541
3879,2771,1108,769,180800,27542
1527,1124,403,817,163400,27544
12270,8618,3652,1560,301300,27545
7075,4626,2449,1079,227000,27546
9750,6856,2894,954,191400,27549
794,680,114,1018,172500,27551
700,460,240,735,257700,27553
285,152,133,748,212500,27555
47,34,13,-,82200,27556
2896,2188,708,851,167300,27557
1172,988,184,1341,347000,27559
15828,7011,8817,1760,466900,27560
1515,1422,93,-,590100,27562
2136,1263,873,703,87300,27563
9289,6420,2869,903,193400,27565
544,439,105,881,233100,27568
3184,2169,1015,967,194000,27569
0,0,0,-,-,27570
2852,2604,248,982,442300,27571
2694,2531,163,777,253300,27572
5109,2836,2273,761,159800,27573
5903,4942,961,986,183200,27574
7259,5067,2192,874,178200,27576
9888,6643,3245,802,230200,27577
1358,1201,157,1101,214000,27581
127,93,34,736,156300,27582
2679,2325,354,817,253800,27583
83,32,51,-,-,27584
29199,23666,5533,1415,452400,27587
2834,1858,976,830,99700,27589
9587,7319,2268,1280,288100,27591
6778,5839,939,940,335100,27592
0,0,0,-,-,27593
36,36,0,-,-,27594
7717,6548,1169,1147,343200,27596
10807,8626,2181,985,272000,27597
0,0,0,-,-,27599
4275,1184,3091,1499,572600,27601
21659,13181,8478,1496,347000,27603
18572,10213,8359,1386,293100,27604
3842,1223,2619,1577,440300,27605
19416,7206,12210,1369,423900,27606
9280,4201,5079,1529,639200,27607
5262,3892,1370,1487,911000,27608
17049,8712,8337,1393,441100,27609
27695,16740,10955,1319,260300,27610
19523,10508,9015,1544,481500,27612
18407,13154,5253,1478,478600,27613
13518,9501,4017,1548,530100,27614
19224,14125,5099,1533,441100,27615
23066,12845,10221,1514,314800,27616
9744,4405,5339,1679,448300,27617
0,0,0,-,-,27695
0,0,0,-,-,27697
11787,3456,8331,1279,457600,27701
25387,16545,8842,1469,340500,27703
16076,9340,6736,1306,270000,27704
21786,9725,12061,1422,398500,27705
21509,10146,11363,1364,371500,27707
0,0,0,-,-,27708
0,0,0,-,-,27709
9364,8326,1038,1614,324400,27712
25068,14871,10197,1460,380500,27713
7208,3318,3890,850,108600,27801
8694,5291,3403,889,168600,27803
12979,6990,5989,977,177600,27804
1419,1144,275,689,93000,27805
867,708,159,575,111200,27806
2160,1712,448,881,142900,27807
941,783,158,1237,384500,27808
1706,1206,500,767,156800,27809
1635,1248,387,1057,187500,27810
1010,671,339,792,118700,27812
273,177,96,950,111400,27813
764,724,40,817,150000,27814
0,0,0,-,-,27815
1279,873,406,821,112100,27816
2989,2295,694,826,169400,27817
487,373,114,782,86400,27818
120,49,71,1077,79000,27819
908,702,206,771,134800,27820
23,23,0,-,-,27821
3274,2637,637,854,157800,27822
2565,1580,985,652,87100,27823
588,445,143,888,102700,27824
37,12,25,850,78000,27825
164,127,37,814,154900,27826
70,70,0,-,45800,27827
3494,2316,1178,947,156000,27828
834,643,191,703,87400,27829
1597,906,691,807,159600,27830
1336,992,344,802,75800,27831
1130,766,364,706,87500,27832
24419,9023,15396,941,161700,27834
2487,1946,541,911,130500,27837
1418,1019,399,867,94400,27839
127,114,13,-,62300,27840
27,0,27,688,-,27841
684,641,43,1156,482100,27842
339,265,74,769,94300,27843
1387,1001,386,692,90500,27844
773,591,182,750,87200,27845
1130,801,329,703,102900,27846
443,300,143,1098,59500,27847
531,414,117,952,71000,27849
3083,2564,519,622,177800,27850
2091,1472,619,775,127200,27851
1162,967,195,867,137200,27852
238,156,82,-,74300,27853
2224,1416,808,883,99800,27855
6171,4323,1848,866,181100,27856
599,354,245,-,84700,27857
23563,10298,13265,1042,233200,27858
446,318,128,963,110900,27860
66,61,5,-,72800,27861
357,293,64,709,221300,27862
4764,3684,1080,887,177600,27863
1779,1085,694,857,119300,27864
861,802,59,-,180500,27865
178,125,53,-,-,27866
741,585,156,548,89600,27869
10225,6085,4140,835,117300,27870
1623,1157,466,759,114200,27871
125,96,29,1115,98900,27872
120,86,34,647,95000,27873
1912,1247,665,570,79500,27874
250,205,45,-,94800,27875
647,465,182,532,77800,27876
5,5,0,-,-,27877
449,212,237,963,102500,27878
115,95,20,825,113400,27879
1617,1437,180,992,206400,27880
14,7,7,-,23500,27881
3100,2109,991,822,161700,27882
1581,1103,478,900,110100,27883
467,407,60,-,-,27884
431,322,109,1385,112300,27885
7805,5141,2664,751,121800,27886
663,509,154,678,119400,27888
11057,6713,4344,847,184100,27889
953,459,494,728,91800,27890
1579,1227,352,1007,128400,27891
5711,3915,1796,720,114100,27892
16074,6837,9237,894,153000,27893
7953,5930,2023,1093,213600,27896
583,276,307,836,74300,27897
15420,10044,5376,1146,223400,27909
4429,2874,1555,785,112500,27910
266,239,27,-,292400,27915
484,413,71,-,366500,27916
263,97,166,1024,-,27917
338,244,94,728,165400,27919
637,482,155,1295,385400,27920
1864,1389,475,1216,300100,27921
350,242,108,763,125800,27922
252,231,21,-,311200,27923
914,727,187,837,109800,27924
1335,1030,305,612,132400,27925
730,607,123,-,237700,27926
592,524,68,1368,609600,27927
724,560,164,594,183900,27928
1120,1037,83,1667,367300,27929
5379,3624,1755,790,206700,27932
514,375,139,950,166200,27935
345,329,16,-,430100,27936
1222,1064,158,1238,146000,27937
770,632,138,-,119200,27938
1174,881,293,1092,304000,27939
287,241,46,-,364100,27941
314,223,91,-,99600,27942
166,92,74,-,-,27943
4959,3703,1256,1085,216600,27944
494,426,68,-,198600,27946
386,377,9,-,305100,27947
5482,4208,1274,1539,398100,27948
3393,2821,572,1364,600700,27949
854,767,87,1331,236500,27950
535,302,233,1158,202800,27953
2890,2259,631,1313,374200,27954
89,65,24,-,347200,27956
574,437,137,834,115300,27957
4701,4271,430,1138,380600,27958
1626,1262,364,1005,451100,27959
390,262,128,1412,472200,27960
2991,2041,950,826,96500,27962
203,203,0,-,325000,27964
242,223,19,-,279500,27965
550,448,102,1346,328700,27966
191,184,7,-,78700,27967
207,137,70,-,431300,27968
89,55,34,-,308300,27969
1328,939,389,1021,105100,27970
94,68,26,-,366700,27972
540,425,115,1422,316500,27973
452,433,19,-,167700,27974
1366,1317,49,-,304300,27976
87,55,32,-,267200,27978
455,355,100,-,181400,27979
714,586,128,-,194600,27980
703,515,188,1031,257100,27981
52,52,0,-,-,27982
3010,2097,913,748,112500,27983
124,32,92,1203,87800,27985
434,274,160,879,128400,27986
10805,7224,3581,823,194200,28001
521,474,47,1453,242000,28006
309,217,92,747,98800,28007
469,331,138,841,130500,28009
10969,7513,3456,1288,324400,28012
5121,3531,1590,880,187600,28016
0,0,0,-,-,28017
2302,1992,310,800,152400,28018
0,0,0,-,-,28019
808,698,110,775,177100,28020
5558,4126,1432,874,196300,28021
6032,4794,1238,942,209700,28023
16,16,0,-,-,28024
20552,14542,6010,1223,264100,28025
27649,18202,9447,1433,341900,28027
13088,9436,3652,1587,497400,28031
1498,1134,364,1016,273900,28032
1230,1071,159,918,204800,28033
7484,5490,1994,841,221000,28034
7461,6227,1234,1709,579100,28036
10892,9149,1743,1126,455700,28037
12,0,12,-,-,28039
2922,2493,429,697,148000,28040
4,4,0,-,-,28041
94,43,51,728,91300,28042
8151,5235,2916,744,176100,28043
13734,7246,6488,1058,173500,28052
16893,7900,8993,1150,220200,28054
13618,10803,2815,1097,283800,28056
1278,1118,160,765,209500,28071
224,177,47,617,187300,28072
2177,1503,674,870,125800,28073
12,12,0,-,-,28074
6514,6082,432,2257,444000,28075
97,68,29,-,-,28076
122,42,80,821,130700,28077
26408,19057,7351,1722,441700,28078
13848,11152,2696,1895,352000,28079
2907,2531,376,1135,231300,28080
11142,7877,3265,1080,257300,28081
10284,6613,3671,1120,194300,28083
10402,7674,2728,879,181600,28086
1124,900,224,751,225500,28088
14,11,3,-,-,28089
2741,2005,736,680,140200,28090
824,570,254,865,128200,28091
16047,11240,4807,937,220700,28092
2770,2264,506,861,281200,28097
1634,1229,405,1152,153300,28098
455,431,24,1167,342000,28101
35,13,22,-,-,28102
4026,3169,857,1006,230900,28103
12245,11386,859,1705,482200,28104
17010,11533,5477,1663,389100,28105
3297,2726,571,1197,352000,28107
16,16,0,-,-,28108
168,144,24,672,185700,28109
18785,14168,4617,1313,302600,28110
10490,7480,3010,1124,272300,28112
2777,2017,760,707,132400,28114
16196,11883,4313,1193,330500,28115
19074,12767,6307,1593,567200,28117
1053,718,335,858,100900,28119
9946,7159,2787,1179,272500,28120
2114,1844,270,1078,267500,28124
1007,881,126,1083,305400,28125
2852,2311,541,853,235400,28127
2817,1964,853,828,179700,28128
2383,2067,316,872,241100,28129
979,662,317,975,160500,28133
5028,3221,1807,1694,336200,28134
1273,859,414,962,211900,28135
35,12,23,-,-,28136
1023,853,170,1085,250600,28137
4025,2785,1240,1015,204300,28138
7836,6210,1626,842,195300,28139
10818,5855,4963,982,205900,28144
12635,10357,2278,888,227600,28146
9341,5900,3441,1036,241600,28147
11068,7559,3509,793,195600,28150
9573,6482,3091,904,188200,28152
1268,786,482,1042,160300,28159
1770,846,924,692,121300,28160
2107,1726,381,755,267100,28163
6069,5059,1010,1161,268800,28164
4005,3415,590,1280,302300,28166
940,909,31,-,215800,28167
4277,3572,705,821,176100,28168
45,35,10,-,-,28169
3925,2430,1495,825,109900,28170
19956,17849,2107,1700,558500,28173
2739,2013,726,1069,212400,28174
9360,2498,6862,1862,425900,28202
10454,3253,7201,1829,708600,28203
5716,1478,4238,1694,576900,28204
22820,9533,13287,1376,410800,28205
6678,2197,4481,1225,239700,28206
4106,3419,687,1579,1348900,28207
16057,6381,9676,1173,198300,28208
12299,6226,6073,1606,596000,28209
20727,11443,9284,1444,486000,28210
13201,7582,5619,1660,701900,28211
16030,5934,10096,1274,236300,28212
18475,8526,9949,1341,251700,28213
14948,11113,3835,1570,258400,28214
23687,15558,8129,1349,273800,28215
22986,11702,11284,1464,246100,28216
12682,3930,8752,1498,238500,28217
0,0,0,-,-,28223
15733,10604,5129,1477,560100,28226
21806,15041,6765,1412,313900,28227
0,0,0,-,-,28244
21027,6365,14662,1481,297300,28262
31217,19521,11696,1607,300300,28269
12245,9254,2991,1662,543600,28270
18201,9469,8732,1671,304900,28273
0,0,0,-,-,28274
28537,17340,11197,1814,507600,28277
13052,9926,3126,1736,413400,28278
0,0,0,-,-,28280
0,0,0,-,-,28282
7185,2598,4587,926,109900,28301
13926,6367,7559,1125,174900,28303
14728,7971,6757,1218,154300,28304
3025,1713,1312,1029,242600,28305
16199,10265,5934,1115,218900,28306
4052,31,4021,1440,-,28307
0,0,0,-,-,28308
0,0,0,-,-,28310
14618,7420,7198,1122,195700,28311
7869,5758,2111,961,207300,28312
22545,10557,11988,1197,172000,28314
5899,4032,1867,1131,279700,28315
1689,1441,248,765,118300,28318
3110,2257,853,763,103200,28320
1754,1349,405,992,211800,28323
197,94,103,805,100000,28325
8277,5390,2887,1489,244500,28326
7122,5635,1487,1362,299500,28327
9171,5724,3447,795,152100,28328
111,111,0,-,-,28330
7,7,0,-,-,28331
288,200,88,692,109600,28332
3699,2397,1302,859,92800,28333
8853,6229,2624,826,171300,28334
3629,2267,1362,682,179600,28337
1465,1197,268,600,161200,28338
2848,2181,667,1006,158200,28339
3700,2378,1322,776,81900,28340
1042,796,246,810,120300,28341
22,22,0,-,183300,28342
650,350,300,766,57100,28343
1289,1021,268,780,124200,28344
4659,2859,1800,652,95700,28345
384,291,93,758,98600,28347
13562,9885,3677,1111,203700,28348
1609,1290,319,861,106700,28349
80,46,34,-,-,28350
1738,1203,535,818,92100,28351
8471,4657,3814,771,112300,28352
0,0,0,-,-,28355
2225,1707,518,731,214900,28356
1059,814,245,862,104000,28357
12626,7178,5448,837,106200,28358
7,0,7,-,-,28359
4602,3230,1372,763,107000,28360
19,15,4,-,112500,28362
456,304,152,734,99000,28363
4890,3645,1245,757,76100,28364
5608,4268,1340,922,119000,28365
1690,1306,384,942,127600,28366
31,10,21,-,37500,28367
36,31,5,-,-,28368
773,587,186,758,75700,28369
2345,1627,718,1081,151100,28371
4238,2508,1730,728,100900,28372
1051,863,188,882,230800,28373
8993,7666,1327,1691,440400,28374
69,60,9,-,92500,28375
15433,10979,4454,1091,208100,28376
4057,2793,1264,665,88900,28377
22,0,22,-,-,28378
9957,6210,3747,813,137100,28379
2317,1854,463,962,119400,28382
2699,2060,639,783,74400,28383
3642,2613,1029,808,92500,28384
1054,918,136,546,129400,28385
1869,1410,459,684,65300,28386
7597,4314,3283,1137,366600,28387
8676,4239,4437,1151,195200,28390
2200,1718,482,875,184300,28391
795,578,217,742,107800,28392
771,647,124,890,69500,28393
1978,1549,429,1130,275300,28394
948,746,202,1071,226200,28395
979,719,260,594,150200,28396
2306,1271,1035,833,86000,28398
598,337,261,779,136400,28399
10776,4364,6412,1183,263000,28401
18610,6617,11993,1293,337600,28403
15567,8934,6633,1405,337000,28405
14061,11777,2284,1445,382900,28409
15663,12523,3140,1685,363600,28411
19449,11213,8236,1326,342600,28412
1120,808,312,1029,205100,28420
806,576,230,669,109000,28421
3444,3011,433,1460,295000,28422
834,712,122,939,120600,28423
42,18,24,713,69000,28424
4084,3200,884,989,206300,28425
3110,2447,663,1515,490100,28428
3687,3257,430,870,231900,28429
756,472,284,594,121000,28430
2706,1759,947,736,89700,28431
549,413,136,871,113700,28432
1543,1108,435,891,151700,28433
352,256,96,580,152000,28434
706,605,101,581,154900,28435
634,413,221,1131,190500,28436
578,436,142,638,176200,28438
422,273,149,690,104000,28439
1095,791,304,928,104800,28441
471,452,19,-,109300,28442
9868,8016,1852,1372,356500,28443
955,692,263,631,-,28444
4235,3367,868,1318,332500,28445
457,452,5,-,194300,28447
357,273,84,-,130400,28448
886,687,199,1356,643400,28449
813,681,132,983,266800,28450
18282,15019,3263,1465,315300,28451
328,165,163,683,-,28452
1167,833,334,676,108900,28453
1172,1019,153,1665,193400,28454
866,593,273,765,78700,28455
1460,1220,240,841,153600,28456
4210,3458,752,866,233300,28457
2452,1488,964,701,114600,28458
5642,4209,1433,1544,310000,28460
10767,9054,1713,1356,388800,28461
5400,4488,912,859,229800,28462
2396,1743,653,673,120000,28463
797,482,315,925,174600,28464
4169,3696,473,1154,436200,28465
3935,2808,1127,851,179800,28466
6624,5935,689,1346,281000,28467
2537,2229,308,1379,362300,28468
4384,3792,592,948,413200,28469
4719,3619,1100,1060,252500,28470
6777,4790,1987,788,141000,28472
2043,1791,252,751,168700,28478
2507,2052,455,1336,298100,28479
1292,1049,243,1892,1049500,28480
7827,3817,4010,717,78600,28501
8621,5338,3283,905,124500,28504
785,538,247,931,48100,28508
0,0,0,-,-,28509
728,581,147,1102,261300,28510
257,234,23,-,154900,28511
1793,1432,361,1008,529400,28512
4255,3009,1246,778,150500,28513
898,670,228,598,137000,28515
5485,3681,1804,869,292300,28516
3200,2512,688,841,162900,28518
195,109,86,1082,135800,28519
87,64,23,-,222700,28520
638,587,51,-,106300,28521
1132,810,322,667,167700,28523
131,123,8,-,180100,28524
1182,880,302,756,80200,28525
992,773,219,867,118600,28526
545,455,90,1567,174500,28527
243,209,34,-,247300,28528
880,687,193,751,138100,28529
3099,1894,1205,810,122900,28530
436,367,69,968,295500,28531
7446,4104,3342,1270,193200,28532
0,0,0,-,-,28533
6,6,0,-,-,28537
964,471,493,865,86100,28538
7234,5290,1944,1176,207200,28539
18869,11144,7725,1014,201700,28540
77,0,77,1607,-,28542
1782,59,1723,1425,-,28543
1842,561,1281,1165,136700,28544
19492,10893,8599,1174,212200,28546
2033,0,2033,1454,-,28547
5149,3675,1474,714,119700,28551
94,94,0,-,95400,28552
210,164,46,-,173200,28553
46,46,0,-,-,28554
2254,1613,641,950,147000,28555
415,324,91,-,340000,28556
7628,4839,2789,1143,331800,28557
11747,8360,3387,992,191600,28560
17217,12857,4360,1131,246400,28562
8793,6740,2053,951,245300,28570
1339,1184,155,1106,365100,28571
2546,1790,756,914,120700,28572
799,589,210,693,152000,28573
6859,5212,1647,1123,204500,28574
69,58,11,-,242900,28575
109,64,45,1042,441700,28577
1419,994,425,834,87100,28578
266,243,23,-,416000,28579
3723,2308,1415,835,116200,28580
54,47,7,-,172500,28581
623,536,87,985,310700,28582
6026,4793,1233,1300,308000,28584
1569,1205,364,746,116000,28585
3138,2362,776,828,100600,28586
100,90,10,-,95000,28587
21,21,0,-,-,28589
11088,8267,2821,1076,243400,28590
1819,1511,308,1688,563600,28594
21244,14475,6769,951,236100,28601
11535,7638,3897,830,180300,28602
2956,2262,694,932,319200,28604
1620,1155,465,1105,449500,28605
750,655,95,-,78700,28606
12645,6323,6322,1081,339200,28607
2816,2432,384,1090,229000,28609
4425,3356,1069,867,159400,28610
163,163,0,-,-,28611
4803,3696,1107,787,159400,28612
9554,7069,2485,822,208400,28613
925,642,283,681,152700,28615
21,21,0,-,222500,28616
722,573,149,743,198700,28617
890,667,223,1057,308000,28618
182,79,103,590,201000,28619
4228,2954,1274,764,147500,28621
1180,910,270,702,171100,28622
789,660,129,774,181400,28623
629,438,191,561,-,28624
15420,11228,4192,996,216000,28625
1389,1267,122,1266,301300,28626
549,376,173,678,190300,28627
25,22,3,-,-,28628
15,0,15,-,-,28629
8023,6211,1812,808,197800,28630
271,195,76,-,-,28631
1944,1592,352,929,125700,28634
1363,1300,63,-,141600,28635
1927,1536,391,781,209500,28636
666,429,237,734,189400,28637
4545,3412,1133,693,174800,28638
2080,1440,640,736,252200,28640
31,0,31,-,-,28641
2396,1610,786,565,131600,28642
1640,1322,318,1238,133500,28643
594,392,202,874,251500,28644
19093,13682,5411,726,157800,28645
226,186,40,-,394300,28646
506,300,206,648,121900,28649
4974,4152,822,793,209800,28650
2104,1760,344,641,181700,28651
49,49,0,-,-,28652
25,25,0,-,-,28653
1395,1110,285,941,234400,28654
22141,16094,6047,827,170400,28655
3594,2935,659,748,223600,28657
10204,7671,2533,933,192500,28658
8632,5702,2930,714,151700,28659
963,732,231,921,189500,28660
0,0,0,-,-,28662
277,245,32,-,204300,28663
22,22,0,-,-,28664
1072,859,213,620,165900,28665
76,76,0,-,-,28666
104,34,70,732,133300,28667
84,84,0,-,-,28668
1197,1098,99,-,137700,28669
883,606,277,707,161000,28670
108,79,29,-,189600,28671
76,76,0,-,178400,28672
2878,2559,319,1157,447200,28673
3074,2343,731,717,202100,28675
1354,1082,272,526,226700,28676
14467,9679,4788,861,207000,28677
1906,1753,153,830,203100,28678
1004,875,129,1049,282400,28679
9747,7866,1881,719,188000,28681
581,478,103,1519,595100,28682
551,402,149,678,155400,28683
844,761,83,1152,295300,28684
851,705,146,786,134300,28685
778,588,190,1006,165200,28689
4414,3560,854,670,185000,28690
2242,1653,589,985,289200,28692
533,476,57,917,167900,28693
3500,2757,743,757,239800,28694
5426,3703,1723,763,190700,28697
893,781,112,663,224800,28698
1621,1355,266,1115,290500,28701
159,121,38,-,316300,28702
8635,5144,3491,1369,343600,28704
2803,2244,559,855,202200,28705
263,173,90,531,203900,28707
141,135,6,-,260400,28708
960,708,252,1500,360000,28709
0,0,0,-,-,28710
5282,3715,1567,1319,358400,28711
8915,6120,2795,939,372900,28712
3673,2725,948,707,231300,28713
7163,5517,1646,803,216200,28714
10197,7302,2895,1208,291900,28715
6911,5186,1725,961,223600,28716
769,659,110,1323,410200,28717
285,270,15,-,232700,28718
2749,2061,688,673,144700,28719
70,47,23,1358,361100,28720
4455,3352,1103,1069,251500,28721
2680,1829,851,1225,277600,28722
3848,1368,2480,842,308800,28723
42,10,32,983,-,28725
1450,839,611,945,178600,28726
1376,1151,225,1654,305600,28729
2775,2479,296,1256,357300,28730
3822,3147,675,947,361700,28731
7234,6018,1216,1206,341900,28732
38,33,5,-,270200,28733
13923,10665,3258,779,203700,28734
118,118,0,-,349200,28735
507,479,28,-,294900,28736
9298,7316,1982,995,358800,28739
940,694,246,956,202100,28740
2295,1677,618,862,596100,28741
1254,1086,168,843,330200,28742
981,760,221,573,150900,28743
194,178,16,-,365900,28745
1366,1184,182,983,433100,28746
900,842,58,-,256000,28747
4245,3199,1046,1078,298200,28748
45,45,0,-,-,28749
1875,1574,301,1048,289000,28751
12383,8893,3490,712,166100,28752
4029,3256,773,711,246700,28753
3407,2600,807,841,289700,28754
0,0,0,-,-,28755
1793,1429,364,662,275000,28756
21,10,11,-,-,28757
43,43,0,-,-,28758
2964,2569,395,1611,364900,28759
3064,2589,475,1052,171600,28761
2990,2136,854,757,176300,28762
1099,912,187,764,253000,28763
510,427,83,1125,292800,28766
2788,2362,426,819,299500,28768
0,0,0,-,-,28770
3189,2597,592,582,153800,28771
587,420,167,965,257500,28772
1221,1069,152,1243,359900,28773
733,641,92,1629,723200,28774
333,234,99,1120,417600,28775
3717,2858,859,686,206300,28777
3739,2978,761,1004,273800,28778
8079,5379,2700,803,234200,28779
572,455,117,691,261000,28781
3060,2351,709,1255,289700,28782
622,396,226,940,265200,28783
3487,2905,582,1100,282000,28785
9873,6911,2962,1084,266800,28786
8918,6886,2032,1198,379300,28787
78,58,20,1167,352900,28788
2728,1754,974,939,220900,28789
1396,1298,98,1242,412100,28790
6736,5292,1444,1182,352400,28791
16001,9602,6399,1131,249300,28792
6081,2232,3849,1130,481400,28801
13884,7421,6463,1455,408600,28803
9411,6466,2945,1399,528500,28804
8683,5477,3206,1198,360600,28805
16954,9703,7251,1224,335800,28806
2611,2120,491,739,170500,28901
430,401,29,776,259000,28902
4589,3605,984,784,266500,28904
1305,1108,197,-,213800,28905
8936,7510,1426,872,219800,28906
212,185,27,-,223200,28909
762,557,205,725,146300,29001
2234,1712,522,825,101500,29003
3655,2872,783,829,136900,29006
982,818,164,1081,96400,29009
4279,2915,1364,784,104500,29010
515,511,4,-,164800,29014
551,475,76,545,113000,29015
11201,9317,1884,1265,330900,29016
1337,997,340,744,115400,29018
9346,7123,2223,842,208800,29020
683,607,76,590,174500,29030
610,463,147,963,96500,29031
1820,1404,416,824,97000,29032
6408,3798,2610,1342,156400,29033
10089,9315,774,1901,378100,29036
354,308,46,-,121500,29037
1050,806,244,738,121600,29038
1382,1056,326,1059,53000,29039
3428,2460,968,970,166300,29040
1219,787,432,782,92300,29042
1983,1664,319,1084,112600,29044
10860,9164,1696,1318,241200,29045
36,36,0,-,-,29046
1712,1373,339,769,147600,29047
1926,1446,480,788,96000,29048
169,158,11,-,169200,29051
678,598,80,975,75300,29052
7948,5430,2518,947,116700,29053
4095,3722,373,880,278300,29054
1631,1388,243,781,85500,29055
969,638,331,834,73900,29056
1808,1407,401,761,179500,29058
2047,1510,537,698,111100,29059
4859,3572,1287,1303,162300,29061
9,9,0,-,-,29062
14085,11237,2848,1599,239300,29063
285,251,34,-,94000,29065
3993,3044,949,858,115000,29067
1933,1481,452,863,112700,29069
6220,5181,1039,939,188400,29070
25541,21092,4449,1317,304200,29072
19326,15820,3506,1046,198100,29073
120,105,15,-,-,29074
1287,1172,115,777,234400,29075
6246,5509,737,893,183100,29078
20,20,0,-,-,29079
1041,899,142,807,110600,29080
618,515,103,704,89700,29081
171,141,30,1069,109400,29082
1021,818,203,875,100600,29101
6700,4609,2091,729,159700,29102
578,363,215,840,108000,29104
545,476,69,1024,-,29105
1140,815,325,835,82600,29107
7706,4912,2794,846,127900,29108
541,467,74,799,117900,29111
1630,1264,366,749,83100,29112
636,545,91,863,88000,29113
668,489,179,845,101600,29114
10519,5341,5178,779,95600,29115
0,0,0,-,-,29117
6154,3976,2178,967,160900,29118
19,6,13,-,175000,29122
2928,2231,697,888,145400,29123
1087,799,288,700,119800,29125
994,915,79,921,188100,29126
3950,3179,771,944,233900,29127
1786,1257,529,968,105000,29128
1794,1509,285,853,130200,29129
2977,2480,497,890,246200,29130
407,298,109,732,128600,29133
3447,2728,719,1011,151200,29135
1020,810,210,650,124000,29137
3679,2604,1075,780,111200,29138
1770,1499,271,944,167000,29142
269,228,41,-,56500,29145
498,357,141,748,92800,29146
2316,1778,538,700,153400,29148
15115,8827,6288,951,157000,29150
647,32,615,1377,-,29152
6170,4856,1314,906,120400,29153
11698,8544,3154,1107,182600,29154
3056,2647,409,966,122100,29160
4219,2913,1306,897,126200,29161
882,665,217,703,135100,29162
544,412,132,629,59100,29163
2021,1560,461,786,186200,29164
295,227,68,694,115600,29166
1185,739,446,987,65900,29168
10208,5652,4556,1081,189900,29169
9033,7515,1518,1026,191100,29170
3888,3007,881,1065,167500,29172
151,151,0,-,-,29175
0,0,0,-,-,29177
1398,1158,240,796,81900,29178
4958,3452,1506,917,113600,29180
9543,2633,6910,1207,238200,29201
16050,7691,8359,1041,121600,29203
7659,4524,3135,993,185800,29204
10937,5739,5198,1100,335200,29205
8567,5541,3026,1367,328600,29206
10,10,0,-,168800,29207
0,0,0,-,-,29208
14865,8774,6091,1252,183200,29209
17378,6446,10932,1076,183000,29210
12473,8740,3733,1359,222200,29212
22513,13026,9487,1217,183800,29223
0,0,0,-,-,29225
19373,13913,5460,1528,230800,29229
13596,8548,5048,1126,200800,29301
7597,5302,2295,1031,264000,29302
9435,4570,4865,968,143600,29303
6979,3237,3742,913,159100,29306
8017,5593,2424,1043,207800,29307
11999,9490,2509,1133,227700,29316
230,93,137,953,78500,29320
1159,871,288,668,61900,29321
3908,3158,750,862,232100,29322
5640,4455,1185,838,187700,29323
33,33,0,-,-,29324
5125,3426,1699,864,162900,29325
89,56,33,-,-,29329
3463,2509,954,842,145500,29330
59,59,0,-,92600,29331
1279,1126,153,948,133300,29332
134,0,134,1419,-,29333
6823,5088,1735,1221,267300,29334
2005,1603,402,446,121000,29335
66,0,66,-,-,29338
8456,6275,2181,773,110000,29340
7418,5338,2080,857,171300,29341
66,41,25,-,93800,29346
14160,12522,1638,917,233400,29349
628,398,230,597,107800,29351
1576,1250,326,507,110500,29353
292,236,56,787,98700,29355
3941,3269,672,632,273500,29356
8369,5443,2926,808,151500,29360
258,203,55,744,22400,29364
5004,4265,739,1208,230500,29365
120,44,76,-,-,29368
6241,5648,593,1429,233700,29369
233,174,59,-,-,29370
1663,1397,266,786,101100,29372
89,36,53,1045,-,29373
1118,1030,88,876,207400,29374
41,36,5,-,241700,29375
3303,2689,614,970,219800,29376
141,55,86,-,"10,000-",29377
98,30,68,681,-,29378
8009,5189,2820,789,103000,29379
1571,1326,245,641,148600,29384
3029,2336,693,1029,207300,29385
6404,4954,1450,848,216700,29388
4087,2345,1742,1838,1165900,29401
10398,3646,6752,1658,624000,29403
549,0,549,1844,-,29404
11328,5313,6015,1196,266200,29405
12960,5413,7547,1305,209700,29406
16874,9849,7025,1388,407300,29407
24,7,17,-,-,29409
7866,5322,2544,1324,339800,29410
16769,12159,4610,1744,458000,29412
19098,11702,7396,1639,380600,29414
10990,6066,4924,1277,234500,29418
9068,5679,3389,1506,283900,29420
64,0,64,-,-,29424
0,0,0,-,-,29425
704,604,100,1337,210500,29426
1638,1540,98,2817,479300,29429
2657,2140,517,1075,214400,29431
1021,641,380,809,144800,29432
236,224,12,-,-,29434
1712,1535,177,887,161500,29435
1761,1584,177,-,106800,29436
917,832,85,619,181900,29437
1376,1226,150,1019,556300,29438
447,404,43,1930,1004300,29439
10672,8724,1948,912,160400,29440
21849,15451,6398,1441,256000,29445
461,307,154,-,59800,29446
986,797,189,758,185500,29448
3009,2758,251,1050,404600,29449
1254,1151,103,1713,171200,29450
2009,1823,186,3236,1197800,29451
79,51,28,-,89100,29452
550,336,214,1615,199400,29453
11616,10028,1588,1489,499500,29455
14918,9360,5558,1473,244400,29456
923,780,143,971,347200,29458
15528,12695,2833,1229,273100,29461
23496,15565,7931,1973,672400,29464
16860,14138,2722,2175,659300,29466
932,661,271,-,95000,29468
297,297,0,-,352200,29469
2238,1881,357,971,243800,29470
582,422,160,930,116100,29471
3525,2991,534,935,246000,29472
751,557,194,956,131300,29474
1113,933,180,927,79500,29475
2968,2375,593,919,75300,29477
2357,1851,506,878,104900,29479
645,524,121,549,103000,29481
817,691,126,2402,"2,000,000+",29482
21621,17045,4576,1220,303400,29483
21798,15835,5963,1473,311300,29485
18295,14164,4131,1612,329300,29486
1063,963,100,1409,442100,29487
8988,5912,3076,862,155700,29488
9056,5435,3621,1924,727800,29492
67,62,5,-,89500,29493
18400,11589,6811,995,220800,29501
9661,6943,2718,1084,174100,29505
7100,3730,3370,802,114400,29506
3482,2682,800,744,109300,29510
2364,2036,328,1014,216700,29511
6189,3735,2454,687,79200,29512
220,173,47,863,-,29516
442,291,151,930,151100,29518
125,53,72,-,182200,29519
5300,3623,1677,805,98600,29520
728,541,187,600,53000,29525
18123,13874,4249,943,232100,29526
10310,7665,2645,962,197000,29527
957,591,366,753,116000,29530
8211,5211,3000,885,120400,29532
5971,3333,2638,681,87300,29536
1650,1374,276,798,66900,29540
3692,2959,733,963,156100,29541
103,86,17,-,73900,29543
2749,2171,578,926,192200,29544
700,343,357,737,107900,29545
1075,734,341,677,97000,29546
962,633,329,779,92700,29547
11746,8592,3154,851,169200,29550
3555,2729,826,986,101800,29554
1911,1399,512,709,118900,29555
4640,3310,1330,703,100700,29556
5336,3057,2279,702,108000,29560
887,608,279,535,100700,29563
519,401,118,769,78600,29564
2427,1652,775,655,70400,29565
9787,7832,1955,1488,275600,29566
169,87,82,547,55000,29567
6786,5809,977,1241,234900,29568
6410,4397,2013,776,190300,29569
1526,787,739,573,54600,29570
5334,3100,2234,648,99000,29571
5697,4491,1206,1148,385100,29572
4072,2496,1576,705,77600,29574
8739,6949,1790,1234,278800,29575
16047,13991,2056,1467,315700,29576
16093,9550,6543,1130,273700,29577
20814,15048,5766,1466,320400,29579
419,336,83,-,86300,29580
1682,1329,353,819,98300,29581
9839,7980,1859,1194,370700,29582
1876,1233,643,547,103800,29583
1019,877,142,-,75000,29584
7662,6640,1022,1599,423700,29585
19769,15268,4501,1220,241700,29588
40,0,40,-,-,29589
1021,859,162,645,74700,29590
1661,1176,485,678,58900,29591
504,362,142,-,46000,29592
682,547,135,1040,73500,29593
78,31,47,-,101600,29594
923,797,126,844,58400,29596
7196,2267,4929,1406,583200,29601
15946,11096,4850,1049,228300,29605
20073,9156,10917,1339,315100,29607
13535,8332,5203,1078,303800,29609
13154,7024,6130,1092,163600,29611
0,0,0,-,-,29613
0,0,0,-,-,29614
18123,9688,8435,1203,348600,29615
10879,7122,3757,1046,217600,29617
5003,3690,1313,592,179800,29620
17695,13240,4455,1023,252700,29621
5808,2999,2809,778,80100,29624
12095,8569,3526,1015,210100,29625
5749,4677,1072,871,161800,29626
6488,5197,1291,890,154200,29627
1046,682,364,491,81800,29628
6824,3187,3637,966,220300,29630
6353,2652,3701,954,361500,29631
0,0,0,-,-,29634
498,472,26,-,200900,29635
1378,1088,290,858,143700,29638
454,331,123,934,215800,29639
12800,9429,3371,952,197200,29640
14532,11981,2551,915,267700,29642
1191,1112,79,-,265000,29643
8793,6369,2424,1060,234400,29644
4452,3538,914,906,163700,29645
11258,6921,4337,818,130900,29646
10547,6801,3746,937,207700,29649
16030,12181,3849,1344,332300,29650
20524,16801,3723,1021,264200,29651
1729,1413,316,941,107000,29653
3729,2981,748,924,138400,29654
3078,2653,425,814,140300,29655
6242,5300,942,869,170900,29657
138,122,16,-,-,29658
65,34,31,520,-,29659
2654,2169,485,857,193600,29661
6389,4398,1991,1342,229600,29662
766,597,169,1012,219100,29664
186,186,0,-,-,29665
2623,2133,490,843,165400,29666
90,78,12,-,170700,29667
5196,4321,875,831,190200,29669
4613,3167,1446,1039,227600,29670
7251,6049,1202,917,202100,29671
5181,4299,882,948,394200,29672
11630,8611,3019,1024,225300,29673
2754,2640,114,935,403600,29676
10311,6425,3886,943,205600,29678
13291,10308,2983,1473,279200,29680
24067,20405,3662,1615,325700,29681
1600,1511,89,782,215600,29682
107,107,0,-,132600,29683
2002,1630,372,915,170100,29684
939,920,19,-,355900,29685
337,306,31,-,250000,29686
17111,13103,4008,1170,247400,29687
1861,1618,243,845,337100,29689
9352,7608,1744,964,267400,29690
4943,3511,1432,792,179700,29691
2065,1469,596,744,95200,29692
5789,4501,1288,838,168600,29693
2107,1867,240,681,184600,29696
5798,4417,1381,968,185800,29697
3632,2677,955,724,120300,29702
1348,1183,165,1205,242700,29704
7797,5789,2008,864,142200,29706
14104,13091,1013,1687,439400,29707
15825,11979,3846,1588,479800,29708
2427,1892,535,796,108100,29709
14889,11815,3074,1396,330900,29710
846,750,96,-,199100,29712
1125,842,283,1260,186500,29714
15966,12890,3076,1491,416100,29715
609,400,209,1114,160800,29717
1558,1222,336,618,116700,29718
20376,15837,4539,845,212800,29720
0,0,0,-,-,29724
766,617,149,743,242800,29726
897,550,347,586,80800,29727
3736,2430,1306,766,108500,29728
913,774,139,1091,94200,29729
24323,14232,10091,1234,239200,29730
23630,17255,6375,1293,301300,29732
0,0,0,-,-,29733
680,600,80,742,92800,29741
981,853,128,1103,200100,29742
689,592,97,778,232800,29743
12936,10427,2509,961,242200,29745
11321,7455,3866,1070,163900,29801
16409,13499,2910,1146,271000,29803
2050,1788,262,806,207900,29805
885,680,205,695,128700,29809
1700,1117,583,678,66200,29810
4182,3113,1069,656,105100,29812
314,188,126,783,85600,29816
1553,1090,463,910,80200,29817
399,339,60,1313,77400,29819
386,360,26,957,251200,29821
2537,1817,720,914,123400,29824
77,68,9,-,-,29826
1271,756,515,710,59600,29827
160,85,75,785,188700,29828
4344,3455,889,1073,225600,29829
1906,1577,329,606,164000,29831
2110,1351,759,638,112800,29832
170,73,97,733,-,29834
2978,2456,522,589,195300,29835
183,169,14,-,55500,29836
260,241,19,-,353600,29838
155,155,0,-,83000,29840
14138,9834,4304,1050,186000,29841
3058,2461,597,860,112700,29842
359,299,60,958,68200,29843
53,39,14,638,220800,29844
544,431,113,920,92900,29845
1673,1411,262,794,179200,29847
388,365,23,527,161700,29848
59,56,3,-,154200,29849
3308,2465,843,1011,152800,29851
2619,1769,850,686,100800,29853
1112,1025,87,875,152700,29856
6897,6200,697,1104,248900,29860
0,0,0,-,-,29899
6072,3970,2102,1157,306000,29902
4,0,4,-,-,29904
0,0,0,-,-,29905
9995,4816,5179,1377,236900,29906
5904,5149,755,1706,399600,29907
11678,10777,901,2174,416700,29909
19055,14648,4407,1848,420200,29910
523,337,186,1027,124100,29911
10,10,0,-,-,29912
389,381,8,-,-,29915
680,508,172,-,98900,29916
1621,1260,361,743,88600,29918
4371,3961,410,960,285200,29920
211,152,59,-,83000,29921
386,363,23,-,52400,29922
81,55,26,664,91900,29923
1898,1368,530,796,145400,29924
10942,8593,2349,1448,600300,29926
4146,3027,1119,1447,349500,29927
7898,6594,1304,1806,776600,29928
455,396,59,-,89200,29929
74,61,13,-,-,29932
163,156,7,-,218300,29934
1925,639,1286,1353,252000,29935
5516,3783,1733,1186,202300,29936
40,37,3,-,-,29939
1562,1362,200,-,118000,29940
134,126,8,-,"2,000,000+",29941
168,168,0,-,-,29943
1588,1104,484,943,96100,29944
1821,1399,422,825,113100,29945
2710,1767,943,1123,510900,30002
24976,18877,6099,1839,583700,30004
14276,10215,4061,1929,587400,30005
11800,6965,4835,1416,269600,30008
8701,5588,3113,2030,611800,30009
6568,5458,1110,1489,287800,30011
11690,6775,4915,1134,199900,30012
10696,6431,4265,1447,274300,30013
14919,9281,5638,1199,253900,30014
20640,16686,3954,1585,218700,30016
7767,6184,1583,1878,392200,30017
33,27,6,-,276600,30018
15013,12957,2056,2010,389000,30019
6828,1775,5053,1265,256000,30021
23365,17719,5646,1966,589400,30022
28362,22278,6084,1872,491400,30024
3871,3395,476,1108,275300,30025
11506,10010,1496,2101,429000,30028
12605,7921,4684,1683,598400,30030
15530,8981,6549,1364,245000,30032
13258,8588,4670,1752,430900,30033
16312,11386,4926,1427,228200,30034
6980,3830,3150,1522,217100,30035
14694,9111,5583,1535,234900,30038
16100,13152,2948,1850,274900,30039
26656,22487,4169,1883,474400,30040
25521,22091,3430,1862,522900,30041
29286,20446,8840,1787,344900,30043
30769,19633,11136,1753,295300,30044
13991,11841,2150,2277,332800,30045
13836,7371,6465,1488,302600,30046
21916,16581,5335,1681,325600,30047
25938,20897,5041,1749,325200,30052
4047,3318,729,1229,271000,30054
1579,1462,117,1217,291800,30055
824,692,132,979,272200,30056
22167,13434,8733,1478,221200,30058
13545,6473,7072,1344,282200,30060
23336,19023,4313,1761,456500,30062
18402,15425,2977,1635,420300,30064
22667,17197,5470,1760,373500,30066
19405,8259,11146,1583,430700,30067
12589,10888,1701,1711,564400,30068
41,41,0,-,166100,30070
9092,4890,4202,1588,333700,30071
403,223,180,1280,286000,30072
21186,17602,3584,1790,575200,30075
17023,11211,5812,1673,461300,30076
13211,10884,2327,1641,316600,30078
1492,808,684,1094,280000,30079
25183,11648,13535,1660,409700,30080
10871,7866,3005,1702,393400,30082
20795,10716,10079,1356,221400,30083
14501,9698,4803,1617,332000,30084
13073,11092,1981,1778,312200,30087
10345,6150,4195,1438,208200,30088
0,0,0,-,-,30090
15648,7506,8142,1634,465800,30092
19000,5352,13648,1574,245900,30093
11917,9079,2838,1610,266600,30094
27831,12014,15817,1741,342700,30096
17015,12222,4793,1876,592300,30097
21002,16790,4212,1679,376200,30101
15198,11928,3270,1444,292100,30102
5107,4319,788,1025,228800,30103
1636,1132,504,875,156700,30104
917,665,252,582,281800,30105
9097,5061,4036,1425,254600,30106
6280,5524,756,1120,364300,30107
2834,2050,784,854,225000,30108
5359,3902,1457,861,238700,30110
0,0,0,-,-,30111
2329,1746,583,911,189600,30113
20948,14128,6820,1654,408800,30114
18105,15105,3000,1739,439600,30115
8522,6333,2189,1113,222700,30116
14195,7338,6857,1066,239600,30117
13,0,13,-,-,30118
15056,11263,3793,1205,276200,30120
9991,6494,3497,1254,258700,30121
10907,5095,5812,1496,225000,30122
1135,769,366,1041,204200,30124
8599,5487,3112,843,160800,30125
15917,12401,3516,1415,347800,30126
24367,20726,3641,1800,322800,30127
17539,13683,3856,1514,332700,30132
15718,10512,5206,1272,244500,30134
22419,17441,4978,1550,277400,30135
642,471,171,1361,191600,30137
1645,1275,370,1007,135600,30139
8571,6124,2447,1706,254800,30141
10360,8182,2178,1085,324900,30143
21662,13331,8331,1745,310400,30144
3265,2938,327,1021,222200,30145
1785,1222,563,932,121900,30147
333,306,27,-,406700,30148
23,0,23,-,-,30149
16252,12991,3261,1695,385300,30152
6596,4381,2215,1015,184500,30153
17462,14640,2822,1485,261000,30157
13116,7927,5189,1006,185000,30161
15580,8982,6598,949,209500,30165
9030,4515,4515,1364,229400,30168
1147,943,204,970,210500,30170
1033,850,183,1314,358800,30171
2710,1974,736,1083,165900,30173
2315,1864,451,987,283600,30175
2913,1971,942,914,179600,30176
400,313,87,-,216500,30177
1556,1259,297,785,284800,30178
6434,5628,806,1129,217800,30179
14350,10653,3697,1464,257200,30180
1319,1000,319,891,191600,30182
2342,1961,381,1356,427800,30183
2461,2074,387,896,290900,30184
1518,1360,158,750,168000,30185
2858,2565,293,994,288100,30187
25667,20509,5158,1736,389100,30188
15714,11647,4067,1780,370200,30189
5088,3739,1349,908,173300,30204
1187,1092,95,1063,492100,30205
1126,940,186,1115,253200,30206
16352,10053,6299,1751,281300,30213
11826,9530,2296,1599,338300,30214
13297,11393,1904,1813,378300,30215
1342,828,514,970,205500,30216
3640,2620,1020,797,170500,30217
643,495,148,1397,187400,30218
1968,1694,274,1278,209000,30220
1683,1100,583,857,115700,30222
14674,9153,5521,1025,186900,30223
10814,7096,3718,1105,210200,30224
16972,12626,4346,1549,263300,30228
25,25,0,-,239100,30229
3399,2189,1210,1127,170200,30230
8331,6054,2277,950,230700,30233
839,684,155,678,200500,30234
17647,10016,7631,1233,219700,30236
13580,8133,5447,1438,208200,30238
11578,6782,4796,1035,221800,30240
9492,4835,4657,1077,167600,30241
10697,8890,1807,1470,275000,30248
0,0,0,-,-,30250
869,655,214,874,203800,30251
15633,13808,1825,1819,326900,30252
21590,13253,8337,1627,281000,30253
1086,899,187,945,195400,30256
1384,1163,221,931,230200,30257
824,709,115,1313,265400,30258
1388,1223,165,1316,342000,30259
8821,3932,4889,1391,189800,30260
22299,15185,7114,1332,278200,30263
14663,10948,3715,1623,331900,30265
3888,2557,1331,1224,252300,30268
15148,11095,4053,1910,459400,30269
0,0,0,-,-,30272
6121,4478,1643,1441,184500,30273
13190,6363,6827,1241,157100,30274
81,81,0,-,-,30275
6822,6396,426,1227,372300,30276
8160,7565,595,1279,364200,30277
27653,16811,10842,1427,235700,30281
2,0,2,-,-,30284
202,176,26,-,-,30285
9158,5543,3615,781,150700,30286
2687,2129,558,1168,225100,30288
6,6,0,-,-,30289
3358,3046,312,795,417000,30290
10654,4424,6230,1237,190100,30291
2273,2001,272,1055,280600,30292
1004,868,136,891,91900,30293
14797,11421,3376,1622,233300,30294
1658,1231,427,968,255800,30295
10113,7002,3111,1527,184700,30296
10473,3716,6757,1144,121400,30297
1484,393,1091,1705,250200,30303
15319,7899,7420,1914,703500,30305
11568,6797,4771,1796,797400,30306
9646,5722,3924,2001,704100,30307
14709,5047,9662,1824,387300,30308
18865,8619,10246,2123,414700,30309
11942,6061,5881,1099,295800,30310
14882,6505,8377,1120,270000,30311
14837,5117,9720,1594,493800,30312
3383,1494,1889,1696,365200,30313
7873,3313,4560,991,210300,30314
13210,5646,7564,989,266200,30315
15614,9476,6138,1570,401800,30316
6389,4355,2034,1619,510600,30317
26024,10906,15118,1702,395100,30318
20217,11362,8855,1861,708700,30319
0,0,0,-,-,30322
16111,6322,9789,1759,505300,30324
5430,1824,3606,2012,451300,30326
9859,7639,2220,1932,1067200,30327
18607,10426,8181,1943,551600,30328
11476,3132,8344,1748,483700,30329
24967,12648,12319,1264,277900,30331
0,0,0,-,-,30332
0,0,0,-,-,30334
299,120,179,1443,344200,30336
4881,1295,3586,1109,311900,30337
16272,10052,6220,1812,592600,30338
19494,6393,13101,1820,437300,30339
10794,4650,6144,1529,312600,30340
13933,6644,7289,1746,438500,30341
15337,7680,7657,1810,804300,30342
15306,6499,8807,1315,240700,30344
9809,5206,4603,1714,529300,30345
3065,282,2783,1923,450600,30346
30994,18077,12917,1323,236800,30349
18298,8413,9885,1645,512800,30350
6382,2888,3494,1221,229600,30354
5618,3175,2443,1623,398500,30360
2304,1357,947,2001,386800,30363
4966,2778,2188,776,86400,30401
694,539,155,900,150600,30410
1043,722,321,565,75100,30411
33,33,0,-,140300,30412
647,539,108,827,115400,30413
17,8,9,-,-,30414
2499,1869,630,893,186000,30415
4021,2615,1406,715,142800,30417
664,440,224,738,148000,30420
1178,954,224,640,85300,30421
30,17,13,-,123400,30423
502,460,42,631,116000,30425
332,312,20,-,45200,30426
3941,2799,1142,696,155700,30427
598,373,225,505,80600,30428
21,8,13,-,-,30429
1852,1294,558,722,106800,30434
4477,3049,1428,695,95900,30436
3983,2495,1488,696,131400,30439
784,475,309,707,73700,30441
3033,2592,441,666,82500,30442
978,656,322,630,91200,30445
617,440,177,642,133300,30446
5,5,0,-,37500,30448
10,3,7,-,-,30449
839,567,272,959,112200,30450
17,17,0,-,-,30451
521,359,162,975,136600,30452
2248,1526,722,695,107400,30453
125,111,14,-,95000,30454
335,263,72,-,76100,30455
981,729,252,633,80100,30456
1941,1137,804,643,94400,30457
17565,6566,10999,947,190100,30458
0,0,0,-,-,30460
6637,4835,1802,1108,232500,30461
33,9,24,-,-,30464
3897,2766,1131,624,121800,30467
405,282,123,833,138500,30470
1591,1020,571,642,78800,30471
972,839,133,682,106300,30473
6308,4018,2290,746,143200,30474
1052,763,289,545,64800,30477
11412,4480,6932,1152,249900,30501
9212,5186,4026,1266,294800,30504
16373,13875,2498,1323,363100,30506
8607,6041,2566,1163,236200,30507
2627,1850,777,630,184600,30510
1189,901,288,1031,233900,30511
10334,8491,1843,838,274300,30512
5420,3731,1689,814,294500,30513
684,454,230,870,184200,30516
6427,5267,1160,1810,377200,30517
18096,13833,4263,1611,367000,30518
18101,13445,4656,1816,377900,30519
1615,1338,277,837,109200,30520
2051,1620,431,743,166400,30521
345,302,43,-,230300,30522
5035,4224,811,933,244200,30523
3041,2363,678,910,267100,30525
1431,1276,155,918,306200,30527
8490,6412,2078,1028,258900,30528
4135,2543,1592,1050,234100,30529
2675,1897,778,967,215000,30530
4099,2705,1394,951,195300,30531
9651,7421,2230,1080,270300,30533
11916,9325,2591,1426,336600,30534
3062,2157,905,1041,210000,30535
3584,2879,705,1063,301900,30536
726,550,176,1351,292600,30537
1282,1152,130,710,149200,30538
71,58,13,-,132800,30539
8069,6432,1637,943,267600,30540
801,780,21,-,204600,30541
13620,10671,2949,1605,346000,30542
1812,1423,389,1272,237300,30543
353,281,72,842,308700,30545
3919,3198,721,877,322700,30546
1148,800,348,974,273000,30547
8607,7527,1080,1282,415600,30548
9950,8303,1647,964,325500,30549
831,744,87,1139,282500,30552
3322,2587,735,776,168800,30553
3261,2516,745,985,239400,30554
1308,1080,228,850,133000,30555
1868,1464,404,875,162000,30557
1903,1621,282,791,214300,30558
1889,1702,187,1068,286700,30559
1885,1603,282,996,308500,30560
296,180,116,1025,165000,30562
1986,1618,368,892,215600,30563
1839,1466,373,952,311300,30564
1655,1257,398,1063,221800,30565
3548,2121,1427,1240,267000,30566
1489,1274,215,1086,291300,30567
813,619,194,894,271500,30568
1642,1477,165,884,298500,30571
499,417,82,985,287800,30572
107,68,39,1076,-,30573
531,414,117,679,275300,30575
1164,845,319,1402,289000,30576
8576,6028,2548,812,168900,30577
19,19,0,-,-,30581
2124,1658,466,695,287500,30582
0,0,0,-,-,30597
13,0,13,-,-,30598
10608,3772,6836,1198,213300,30601
0,0,0,-,-,30602
17661,5994,11667,1104,279200,30605
21618,9456,12162,1222,332600,30606
4338,2839,1499,1012,235000,30607
0,0,0,-,-,30609
663,572,91,850,202400,30619
5375,4343,1032,1555,294100,30620
2106,1894,212,1128,420600,30621
4079,3302,777,1603,379400,30622
43,39,4,-,403600,30623
1496,1059,437,793,85100,30624
1120,1012,108,915,352700,30625
707,601,106,-,212500,30627
2211,1909,302,922,242400,30628
1667,1243,424,911,173600,30629
932,638,294,687,184100,30630
684,539,145,738,61100,30631
2975,2454,521,813,189900,30633
782,554,228,1032,153900,30634
6522,4513,2009,866,117900,30635
7,7,0,-,-,30639
687,625,62,1125,402800,30641
6263,5065,1198,978,423700,30642
6909,5080,1829,781,225900,30643
3311,2408,903,953,196800,30646
1013,841,172,879,158300,30648
5148,3549,1599,1104,314300,30650
9696,6545,3151,1099,290900,30655
6078,5285,793,1188,307200,30656
377,309,68,-,113700,30660
3092,2122,970,769,173900,30662
1278,1052,226,1105,295900,30663
11,11,0,-,182500,30664
70,46,24,590,73600,30665
3563,3027,536,1138,285300,30666
394,364,30,-,181100,30667
859,539,320,927,120500,30668
948,659,289,867,98700,30669
2900,1981,919,719,108900,30673
7462,6259,1203,1403,394800,30677
536,451,85,921,102800,30678
16657,13090,3567,1169,244700,30680
2914,2192,722,1063,235100,30683
15195,10434,4761,841,210900,30701
12279,9160,3119,827,179300,30705
6378,5309,1069,888,207500,30707
133,133,0,-,100300,30708
2697,2214,483,1084,234800,30710
1419,1038,381,714,121800,30711
9258,5543,3715,965,225600,30720
18719,12095,6624,898,172500,30721
6,6,0,-,-,30724
1810,1555,255,780,204100,30725
0,0,0,-,-,30726
7472,5171,2301,820,133700,30728
639,544,95,1082,88900,30730
1064,769,295,825,132800,30731
981,750,231,754,159600,30733
1105,891,214,1286,304600,30734
2200,1686,514,988,181500,30735
16232,13676,2556,957,233600,30736
1304,1212,92,-,224500,30738
2125,1898,227,886,217700,30739
3003,2615,388,727,241600,30740
12247,8589,3658,965,156700,30741
3236,1172,2064,931,184800,30742
493,476,17,-,214300,30746
5976,3929,2047,736,110700,30747
1376,1197,179,961,348000,30750
47,15,32,-,-,30751
3771,2803,968,890,155700,30752
2277,1656,621,690,87500,30753
3835,2652,1183,799,184800,30755
3,3,0,-,-,30756
655,404,251,683,137700,30757
2029,1751,278,1001,294200,30802
310,287,23,813,89300,30803
906,629,277,765,130400,30805
74,66,8,-,20400,30807
1572,1026,546,901,152400,30808
16735,14564,2171,1659,346600,30809
758,533,225,816,150200,30810
0,0,0,-,-,30812
15555,11248,4307,1404,270300,30813
3844,3048,796,502,212500,30814
14400,10446,3954,1155,168300,30815
976,770,206,753,125000,30816
2965,2275,690,736,169400,30817
170,119,51,-,145500,30818
386,309,77,-,81700,30820
490,389,101,663,57100,30821
0,0,0,-,-,30822
625,366,259,750,83800,30823
6668,4333,2335,810,158500,30824
1239,927,312,681,94000,30828
5122,3359,1763,835,145900,30830
1434,841,593,702,120000,30833
7110,1662,5448,805,92200,30901
9567,4495,5072,953,185400,30904
837,0,837,1624,-,30905
21255,11181,10074,1051,115000,30906
17793,12416,5377,1211,232000,30907
18320,9165,9155,1196,237600,30909
0,0,0,-,-,30912
881,563,318,585,82700,31001
1037,716,321,449,113300,31002
84,78,6,-,161700,31003
0,0,0,-,-,31004
7060,5486,1574,1248,247800,31005
1549,825,724,703,83000,31006
390,261,129,696,77000,31007
7763,6559,1204,1103,202500,31008
414,293,121,641,90500,31009
264,211,53,683,143400,31011
449,365,84,378,139600,31012
4397,3230,1167,752,119700,31014
7489,3897,3592,741,125000,31015
675,568,107,492,184700,31016
606,518,88,1250,105100,31017
483,365,118,763,-,31018
1073,926,147,892,106900,31019
709,652,57,931,103700,31020
10422,6067,4355,741,178500,31021
640,545,95,960,172400,31022
5100,3310,1790,696,115500,31023
9630,7877,1753,1065,213900,31024
497,488,9,-,261300,31025
3878,2673,1205,818,89700,31027
2059,1433,626,1141,262600,31028
6399,5002,1397,884,226300,31029
6195,3945,2250,839,125000,31030
2627,2221,406,664,121000,31031
5217,4445,772,1013,192400,31032
909,810,99,1008,152800,31033
27,0,27,-,-,31034
473,370,103,856,80600,31035
3604,2494,1110,786,156200,31036
755,570,185,-,69500,31037
334,247,87,-,110400,31038
0,0,0,-,-,31039
289,156,133,757,43800,31041
627,545,82,853,85500,31042
999,821,178,549,99100,31044
47,13,34,-,-,31045
1211,1097,114,-,250800,31046
6733,5839,894,1514,278200,31047
650,513,137,692,79800,31049
441,398,43,-,321000,31050
49,22,27,643,133300,31051
3212,2858,354,933,216600,31052
503,445,58,1021,112700,31054
1401,946,455,647,139800,31055
635,408,227,418,85000,31057
759,548,211,333,82200,31058
626,508,118,807,77300,31060
15237,9518,5719,864,167700,31061
0,0,0,-,-,31062
1608,1010,598,670,99000,31063
3797,3117,680,1020,223100,31064
530,375,155,1010,231800,31065
317,252,65,-,148100,31066
64,58,6,-,-,31067
1276,771,505,622,68100,31068
8684,6349,2335,997,205500,31069
386,332,54,734,92500,31070
350,302,48,713,53100,31071
364,306,58,647,78300,31072
917,771,146,704,89400,31075
1135,833,302,774,84900,31076
329,268,61,-,161500,31077
1371,974,397,651,112200,31078
1030,777,253,605,79600,31079
56,56,0,-,-,31081
4059,2646,1413,831,127500,31082
51,38,13,-,55000,31083
0,0,0,-,-,31084
435,381,54,955,112700,31085
2969,2327,642,671,88100,31087
22050,13681,8369,1224,189700,31088
1591,905,686,852,99100,31089
350,277,73,918,92100,31090
1118,886,232,769,84100,31091
2014,1129,885,795,133500,31092
11644,6214,5430,966,137900,31093
414,368,46,-,177500,31094
2355,1771,584,678,87200,31096
459,388,71,645,166700,31097
834,12,822,1438,-,31098
3745,808,2937,912,151400,31201
12940,5728,7212,917,123700,31204
8645,3637,5008,898,84700,31206
0,0,0,-,-,31207
13737,7564,6173,1260,259600,31210
6331,3673,2658,918,159600,31211
0,0,0,-,-,31213
6089,5017,1072,1107,192900,31216
6192,4277,1915,858,95700,31217
5866,3490,2376,1306,198200,31220
1623,613,1010,884,183300,31301
3028,2116,912,1072,199000,31302
1020,834,186,697,200500,31303
2306,1667,639,789,144200,31305
521,434,87,-,270700,31307
3102,2619,483,1199,150200,31308
176,148,28,-,84200,31309
8196,7147,1049,1394,264700,31312
15394,7540,7854,1143,173100,31313
0,0,0,-,-,31314
2424,5,2419,1557,-,31315
4477,3165,1312,989,206500,31316
200,150,50,-,275000,31318
3933,3139,794,1077,215900,31320
2946,2158,788,984,145600,31321
11717,7134,4583,1629,284300,31322
625,474,151,1134,109900,31323
11858,9018,2840,1764,364200,31324
8898,6550,2348,1141,244300,31326
19,19,0,-,-,31327
1615,1447,168,1205,615200,31328
3193,2345,848,1141,221800,31329
2439,2138,301,698,199300,31331
101,0,101,797,-,31333
8784,2887,5897,1428,477600,31401
12830,6149,6681,1199,193100,31404
15191,7825,7366,1431,304800,31405
14163,8267,5896,1340,260800,31406
8814,4792,4022,1726,223100,31407
4100,1703,2397,1080,160600,31408
0,0,0,-,-,31409
9471,7438,2033,1702,367700,31410
4279,3907,372,2673,765000,31411
4164,1699,2465,973,112300,31415
22492,12705,9787,1344,239600,31419
9,9,0,-,-,31421
5325,2658,2667,752,100000,31501
7633,5171,2462,823,108100,31503
3396,2450,946,797,105900,31510
828,701,127,625,150500,31512
6150,4262,1888,714,80000,31513
5951,4679,1272,823,132200,31516
239,207,32,-,215000,31518
1281,910,371,663,152900,31519
8915,3853,5062,936,135100,31520
8226,7051,1175,1723,498300,31522
5517,4829,688,1023,276200,31523
0,0,0,-,-,31524
11225,6859,4366,1137,198700,31525
659,539,120,1467,522100,31527
277,214,63,583,76700,31532
6593,3274,3319,683,131400,31533
4548,3194,1354,810,118300,31535
3370,2567,803,884,120900,31537
5095,3499,1596,669,108400,31539
964,673,291,477,117000,31542
1797,1620,177,865,-,31543
178,145,33,953,69000,31544
5993,3887,2106,834,146800,31545
2650,1718,932,858,188000,31546
0,0,0,-,-,31547
8832,5922,2910,1144,225500,31548
561,392,169,444,-,31549
404,374,30,-,-,31550
389,358,31,-,-,31551
336,306,30,-,-,31552
1827,1402,425,715,94800,31553
1663,1309,354,781,79900,31554
1116,805,311,1122,102900,31555
16,16,0,-,-,31556
1294,993,301,739,115100,31557
8985,4789,4196,1205,250700,31558
1137,758,379,718,107500,31560
61,61,0,-,"2,000,000+",31561
736,646,90,-,-,31562
529,464,65,775,101400,31563
0,0,0,-,-,31564
877,759,118,1033,231300,31565
1543,1054,489,526,88100,31566
475,374,101,466,-,31567
306,259,47,-,281700,31568
1971,1628,343,892,220000,31569
0,0,0,-,-,31599
12176,5694,6482,872,112600,31601
13666,6100,7566,1046,197100,31602
9108,5960,3148,1230,211900,31605
1353,1094,259,769,188300,31606
4087,2626,1461,901,137600,31620
722,565,157,777,94700,31622
64,43,21,-,74100,31623
556,362,194,903,89300,31624
432,258,174,686,228300,31625
1233,823,410,916,172700,31626
93,54,39,1175,75000,31627
311,237,74,-,87600,31629
286,257,29,853,87900,31630
317,241,76,658,82100,31631
5603,4569,1034,984,250500,31632
1876,1243,633,419,101300,31634
2495,1716,779,864,168900,31635
4272,2778,1494,814,204200,31636
1144,867,277,834,112500,31637
318,242,76,710,152500,31638
4040,2755,1285,723,132800,31639
560,493,67,1097,178100,31641
1757,1167,590,751,80300,31642
3638,2526,1112,757,97200,31643
1696,1151,545,1005,121900,31645
1071,582,489,888,109200,31647
337,214,123,1018,76100,31648
285,205,80,1068,221300,31649
1318,800,518,586,59600,31650
0,0,0,-,-,31698
0,0,0,-,-,31699
7279,2556,4723,812,97400,31701
0,0,0,-,-,31704
10469,5254,5215,852,101900,31705
10982,4776,6206,934,131900,31707
5913,2602,3311,904,130600,31709
305,208,97,618,87800,31711
458,383,75,-,39300,31712
2385,1409,976,653,97300,31714
1251,1044,207,792,124200,31716
2818,1617,1201,748,104400,31719
158,114,44,755,54000,31720
8005,5484,2521,1174,209900,31721
200,148,52,800,-,31722
0,0,0,-,-,31727
3443,1892,1551,790,93200,31730
545,431,114,1069,117900,31733
355,264,91,-,221300,31735
1189,795,394,769,149900,31738
114,96,18,2208,46700,31743
1182,799,383,873,117300,31744
65,36,29,900,-,31747
1008,661,347,1002,87300,31749
7593,4606,2987,706,118000,31750
14,6,8,-,-,31753
540,513,27,-,119200,31756
4281,3252,1029,1126,208000,31757
10234,7308,2926,1146,224800,31763
813,757,56,534,203000,31764
1009,800,209,754,115600,31765
8415,4832,3583,724,134000,31768
2226,1594,632,936,85600,31771
273,273,0,-,163300,31772
1671,1295,376,919,196800,31773
2470,1577,893,792,95900,31774
885,707,178,688,78600,31775
1064,889,175,860,99200,31778
2857,1905,952,738,115300,31779
604,488,116,783,184200,31780
653,488,165,1088,97200,31781
599,467,132,617,97300,31783
275,228,47,684,92900,31784
529,417,112,921,236600,31787
3757,2387,1370,853,141200,31788
571,397,174,1037,98900,31789
731,634,97,771,113600,31790
4388,2936,1452,781,112500,31791
9516,4825,4691,1014,190300,31792
3808,2843,965,778,189600,31793
10341,5606,4735,795,111900,31794
607,431,176,848,119000,31795
484,368,116,740,151500,31796
387,378,9,-,84400,31798
1176,1088,88,807,173500,31801
1871,1265,606,724,120200,31803
1914,1823,91,988,287900,31804
967,694,273,921,99500,31805
1558,1226,332,753,154100,31806
899,813,86,732,290000,31807
3148,2976,172,1383,285100,31808
78,66,12,-,-,31810
2068,1776,292,1028,266400,31811
189,153,36,640,109900,31812
2,2,0,-,-,31814
811,574,237,-,45500,31815
2075,1286,789,904,140700,31816
5146,4562,584,1655,344300,31820
70,60,10,-,-,31821
2033,1469,564,902,244600,31822
302,215,87,635,209500,31823
464,370,94,560,92800,31824
1141,663,478,597,85300,31825
838,573,265,1208,167800,31826
869,694,175,1013,90900,31827
635,594,41,-,352300,31829
958,724,234,751,128900,31830
1412,1257,155,765,238500,31831
21,21,0,-,-,31832
2501,1869,632,746,135600,31833
391,355,36,613,106900,31836
3131,1003,2128,893,208800,31901
7768,2128,5640,873,75500,31903
14035,7100,6935,1036,216100,31904
3034,19,3015,1600,-,31905
8601,3977,4624,872,170400,31906
23632,13408,10224,1103,142000,31907
16155,8250,7905,1271,205800,31909
11297,9793,1504,1918,387400,32003
2442,2070,372,937,167600,32008
1405,1226,179,832,239500,32009
5915,5069,846,1000,234800,32011
12,12,0,-,-,32013
7924,6763,1161,980,201700,32024
8326,4794,3532,943,184900,32025
0,0,0,-,-,32026
2057,1844,213,1805,278700,32033
17718,15085,2633,1399,484200,32034
3894,3341,553,879,179300,32038
2956,2531,425,1011,203900,32040
12342,10079,2263,1370,292300,32043
890,620,270,1270,93500,32044
3754,2909,845,809,214600,32046
2339,1684,655,823,110200,32052
1279,994,285,845,121900,32053
3667,2797,870,811,166700,32054
6439,3946,2493,873,161200,32055
1397,1165,232,1053,169600,32058
1191,934,257,870,90000,32059
7715,6195,1520,735,158200,32060
21,4,17,-,-,32061
730,557,173,-,221800,32062
4798,3955,843,1313,231000,32063
2864,1421,1443,908,164300,32064
14032,10425,3607,1675,278500,32065
2090,1656,434,880,137100,32066
20726,16291,4435,1411,264300,32068
1311,1117,194,672,136100,32071
32,32,0,-,333300,32072
16462,10125,6337,1392,258100,32073
139,0,139,1750,-,32079
10360,8370,1990,1631,497500,32080
9526,7878,1648,3444,590200,32081
12602,10284,2318,1862,732700,32082
615,404,211,968,116900,32083
14514,9478,5036,1534,295000,32084
13996,10966,3030,1536,342000,32086
1178,940,238,835,243900,32087
5524,3506,2018,823,175200,32091
16772,14821,1951,2087,464800,32092
1088,810,278,885,181300,32094
6432,5834,598,1576,485700,32095
1238,1056,182,753,111800,32096
9281,7315,1966,1724,293300,32097
1235,1134,101,-,142500,32102
3514,2522,992,1213,221200,32110
3077,2048,1029,743,150000,32112
2201,1870,331,779,161400,32113
14905,4843,10062,1171,174900,32114
12546,6436,6110,1392,175500,32117
9859,6280,3579,1283,339500,32118
10867,6539,4328,1371,215200,32119
3162,2858,304,1676,434000,32124
12989,10180,2809,1324,301800,32127
9319,7523,1796,1497,378500,32128
10538,7171,3367,1538,241500,32129
1911,1590,321,1181,269900,32130
1785,1396,389,998,222300,32131
3795,3167,628,1316,234900,32132
220,220,0,-,335000,32133
3202,2885,317,643,145500,32134
3982,3487,495,1469,438300,32136
20375,17680,2695,1790,360600,32137
333,308,25,-,129400,32139
620,529,91,1122,122600,32140
8341,7729,612,1481,244000,32141
2083,1630,453,1079,194400,32145
693,693,0,-,114300,32147
4623,3781,842,737,87800,32148
349,259,90,-,136600,32157
16714,13557,3157,1370,272100,32159
31444,29376,2068,1497,358100,32162
16690,15957,733,1969,472600,32163
21170,16137,5033,1724,308100,32164
14215,10892,3323,1608,310200,32168
5953,5206,747,1754,485400,32169
23922,19386,4536,1316,315100,32174
7115,5818,1297,1436,368400,32176
10544,6674,3870,940,158800,32177
3798,3014,784,1075,162700,32179
1295,993,302,961,224100,32180
942,650,292,792,101900,32181
19,19,0,-,-,32182
620,536,84,-,124400,32187
2713,1701,1012,819,118200,32189
492,454,38,-,-,32190
0,0,0,-,-,32192
620,487,133,941,271800,32193
1354,1267,87,-,147500,32195
2384,231,2153,1024,229100,32202
0,0,0,-,-,32203
4700,1175,3525,1132,342700,32204
14379,8046,6333,1190,257900,32205
7156,3385,3771,866,153500,32206
16336,8320,8016,1139,254800,32207
13518,7306,6212,1180,139500,32208
14336,6845,7491,1042,92300,32209
26705,14708,11997,1205,205300,32210
13850,7915,5935,1104,208900,32211
179,3,176,2096,-,32212
0,0,0,-,-,32214
18286,8614,9672,1311,244800,32216
8944,5030,3914,1190,291300,32217
25154,16269,8885,1416,260300,32218
5529,4569,960,1348,205100,32219
4878,4236,642,1188,229200,32220
10906,8316,2590,1660,244500,32221
6815,4917,1898,1740,294000,32222
10414,8318,2096,1500,377500,32223
15835,8631,7204,1690,425500,32224
21729,14726,7003,1673,324300,32225
7161,6581,580,2062,340500,32226
565,0,565,1817,-,32227
0,0,0,-,-,32228
9919,5884,4035,1541,396100,32233
3128,2707,421,921,227400,32234
24584,13580,11004,1366,221400,32244
23897,13687,10210,1697,281800,32246
12742,8760,3982,1805,526000,32250
5466,2762,2704,1111,85100,32254
25681,10179,15502,1586,360200,32256
17391,10416,6975,1441,305000,32257
15773,9700,6073,1849,347500,32258
22025,19601,2424,2268,480800,32259
3283,2372,911,1481,613500,32266
12971,6543,6428,1297,256600,32277
14429,4102,10327,1200,211900,32301
22200,11054,11146,1324,204900,32303
18972,2459,16513,1132,147000,32304
7582,4406,3176,923,154500,32305
0,0,0,-,-,32306
0,0,0,-,-,32307
11319,5648,5671,1327,291800,32308
13116,10899,2217,1363,351800,32309
5967,2990,2977,1025,118000,32310
9339,5768,3571,1497,288900,32311
12167,10248,1919,1505,406200,32312
0,0,0,-,-,32313
5582,4998,584,1502,344200,32317
1702,1140,562,1137,239800,32320
1763,1406,357,972,130600,32321
1269,972,297,1231,213100,32322
28,0,28,-,-,32323
1505,1056,449,606,79400,32324
10610,8964,1646,1126,215500,32327
1618,1396,222,850,341000,32328
298,123,175,730,141100,32330
1679,1472,207,838,80100,32331
459,213,246,636,67900,32332
4786,3911,875,917,211000,32333
721,555,166,935,102000,32334
449,393,56,1153,79000,32336
38,38,0,-,-,32337
3866,2497,1369,814,115900,32340
1254,1107,147,1002,207500,32343
5072,3751,1321,776,208600,32344
960,802,158,1468,233500,32346
2699,1831,868,839,124600,32347
3986,2804,1182,932,96300,32348
608,503,105,-,177100,32350
5882,3839,2043,838,119600,32351
2301,1774,527,1051,158600,32352
137,109,28,980,270800,32355
59,59,0,-,-,32356
781,632,149,1246,245200,32358
628,606,22,-,141900,32359
70,70,0,-,101700,32360
162,110,52,879,114400,32361
0,0,0,-,-,32399
8771,5164,3607,1194,207000,32401
28,0,28,1955,-,32403
15804,11528,4276,1355,239700,32404
12197,7294,4903,1418,255100,32405
6613,4031,2582,1792,403500,32407
8949,6101,2848,1453,352400,32408
4016,3681,335,1097,221500,32409
253,184,69,2049,362900,32410
7575,5274,2301,1629,384000,32413
1191,1082,109,775,118800,32420
1486,1216,270,803,115600,32421
517,492,25,-,170600,32423
2271,1610,661,598,158700,32424
4832,3608,1224,844,109900,32425
245,223,22,788,87200,32426
382,192,190,733,127800,32427
6382,5173,1209,896,157900,32428
370,314,56,-,118600,32430
1989,1483,506,1108,152200,32431
0,0,0,-,-,32432
6944,5089,1855,1045,152000,32433
2556,2118,438,742,185600,32435
247,193,54,929,113500,32437
2002,1694,308,725,127900,32438
5928,4411,1517,1657,343900,32439
2272,1491,781,827,85000,32440
1367,934,433,777,113600,32442
1049,904,145,907,111000,32443
7678,5388,2290,1494,292700,32444
542,406,136,638,101000,32445
3852,2889,963,958,128600,32446
3408,2340,1068,837,107800,32448
304,222,82,-,-,32449
1607,1301,306,821,110600,32455
3554,2886,668,1363,338100,32456
9285,7167,2118,2165,613100,32459
1573,1199,374,788,109600,32460
1567,1342,225,2665,947700,32461
1341,1059,282,814,174600,32462
93,56,37,791,93800,32463
1574,1438,136,-,110800,32464
2540,2015,525,645,154400,32465
2161,1614,547,1248,166500,32466
4686,2346,2340,964,277500,32501
1996,1156,840,1313,229000,32502
13057,8811,4246,1226,270500,32503
9763,5984,3779,1257,242400,32504
10406,5027,5379,1053,120300,32505
14621,8746,5875,1280,200500,32506
13608,8775,4833,1238,267100,32507
500,0,500,1781,-,32508
0,0,0,-,-,32509
0,0,0,-,-,32511
0,0,0,-,-,32512
17733,9143,8590,1358,241300,32514
17191,13201,3990,1287,230400,32526
6,6,0,-,-,32530
3069,2573,496,888,291700,32531
11447,9685,1762,1021,262500,32533
7035,4041,2994,1350,192500,32534
1645,1090,555,731,124700,32535
8836,6225,2611,1351,280300,32536
11498,9030,2468,1323,272300,32539
8366,5700,2666,1976,498600,32541
968,0,968,1888,-,32542
544,0,544,1959,-,32544
14714,8389,6325,1421,299400,32547
10108,5794,4314,1281,291000,32548
4059,3130,929,2108,679800,32550
4179,3381,798,1535,576100,32561
11423,9227,2196,1692,362500,32563
855,670,185,-,123700,32564
2063,1658,405,945,214700,32565
15922,13061,2861,1782,361000,32566
1713,1488,225,-,231000,32567
1291,1187,104,658,222000,32568
5214,3554,1660,1456,296400,32569
14033,9597,4436,1233,240800,32570
14302,12282,2020,1186,281600,32571
1891,1676,215,1027,226800,32577
13426,10477,2949,1744,414900,32578
4525,3093,1432,1582,430400,32579
1686,1109,577,1268,348600,32580
10559,8878,1681,1307,229700,32583
10113,2400,7713,1092,284200,32601
2200,229,1971,1141,290500,32603
10904,8342,2562,1505,264700,32605
10495,4756,5739,1664,319300,32606
14204,4892,9312,1222,297800,32607
22968,9374,13594,1357,340200,32608
7736,4064,3672,1159,174500,32609
0,0,0,-,-,32610
0,0,0,-,-,32612
6331,4916,1415,1131,289000,32615
69,0,69,-,-,32616
1500,1308,192,1041,211200,32617
3258,2699,559,1064,195000,32618
1938,1644,294,615,177600,32619
2306,1942,364,596,114200,32621
565,333,232,688,201000,32622
679,613,66,918,267200,32625
3694,2674,1020,844,160900,32626
1613,1252,361,645,96600,32628
138,138,0,-,209300,32631
8,8,0,-,-,32634
74,74,0,-,-,32639
4299,3624,675,959,153600,32640
5157,3048,2109,1034,123600,32641
4011,3413,598,1515,254900,32643
107,107,0,-,176100,32648
6427,5397,1030,1130,273700,32653
5680,4658,1022,1068,202900,32656
61,48,13,-,-,32658
203,150,53,-,400000,32664
2558,2277,281,519,206000,32666
1616,1354,262,1079,275900,32667
2109,1828,281,629,209000,32668
6495,5536,959,1657,308000,32669
4106,3476,630,887,95300,32680
98,86,12,-,-,32681
121,76,45,-,-,32683
2305,1495,810,862,279000,32686
39,39,0,-,-,32692
4377,3601,776,919,182300,32693
1000,731,269,673,121300,32694
5592,4458,1134,827,202800,32696
60,28,32,1225,156300,32697
11171,5614,5557,1609,258100,32701
1233,752,481,"3,500+",92700,32702
20496,13929,6567,1579,314800,32703
16844,11204,5640,1573,305000,32707
19220,14089,5131,1782,352600,32708
637,548,89,-,293200,32709
16262,13977,2285,1995,389900,32712
9448,8102,1346,1479,306800,32713
15240,7471,7769,1641,292300,32714
12701,8878,3823,1177,280600,32720
0,0,0,-,-,32723
17083,12888,4195,1184,283100,32724
18465,14429,4036,1533,255700,32725
9835,6822,3013,1027,230400,32726
2871,1093,1778,1448,284800,32730
1794,1695,99,1122,466500,32732
2101,1850,251,1723,252500,32735
4192,3851,341,1136,352100,32736
16224,13353,2871,1608,257700,32738
1281,1095,186,1150,371100,32744
18900,12284,6616,1912,420200,32746
9971,7574,2397,1633,350600,32750
9991,6200,3791,1841,433100,32751
4498,4138,360,1004,260700,32754
13103,9782,3321,1474,325800,32757
1097,885,212,1316,266600,32759
10916,6800,4116,1449,239700,32763
1180,1110,70,-,328200,32764
22207,15884,6323,1870,418600,32765
5003,4436,567,2150,529600,32766
1017,924,93,1168,140000,32767
0,0,0,-,-,32768
22242,13714,8528,1584,332500,32771
12619,7136,5483,1482,259600,32773
0,0,0,-,-,32775
4501,3929,572,928,374000,32776
11130,8687,2443,1384,241500,32778
11151,8992,2159,1925,458700,32779
16186,11556,4630,1258,250800,32780
3972,3171,801,1082,237300,32784
11681,7576,4105,1667,695000,32789
22295,10185,12110,1612,343500,32792
8193,6955,1238,1305,243700,32796
1140,1034,106,-,148300,32798
10146,2886,7260,1773,397600,32801
11145,5929,5216,1823,421300,32803
9142,5931,3211,1717,498700,32804
7077,3299,3778,1112,226100,32805
11486,7780,3706,1500,415800,32806
12867,6443,6424,1471,247700,32807
19845,8384,11461,1375,218600,32808
9531,5069,4462,1368,281000,32809
13584,6733,6851,1545,260000,32810
14229,4712,9517,1483,199100,32811
14014,8613,5401,1561,342800,32812
4224,1457,2767,2224,751400,32814
0,0,0,-,-,32816
12205,6887,5318,1741,327800,32817
17886,10460,7426,1486,278800,32818
11073,6172,4901,1947,454000,32819
3425,2894,531,2053,386300,32820
9350,3294,6056,1782,300300,32821
24573,10369,14204,1609,222000,32822
17283,12864,4419,1759,354200,32824
20590,13345,7245,1738,327900,32825
9738,4653,5085,1478,224100,32826
6563,4296,2267,2163,615700,32827
24531,15937,8594,1830,403700,32828
6567,4739,1828,1858,348800,32829
12,12,0,-,108300,32830
20,11,9,-,-,32831
11881,8449,3432,2186,445700,32832
3587,2916,671,1422,390500,32833
17978,8162,9816,1764,333000,32835
9040,5310,3730,1978,637300,32836
16968,9828,7140,1905,365100,32837
18887,4837,14050,1429,250800,32839
0,0,0,-,-,32899
11363,5831,5532,1349,244500,32901
6043,5119,924,1700,495700,32903
13863,10562,3301,1763,334400,32904
10655,6055,4600,1361,206200,32905
16603,14269,2334,1693,253700,32907
4856,4315,541,1822,265500,32908
13235,11018,2217,1502,261400,32909
5894,3602,2292,1161,323900,32920
6966,3756,3210,1057,176100,32922
513,0,513,1950,-,32925
9395,7715,1680,1297,251400,32926
10613,9664,949,1344,261800,32927
7298,5617,1681,1533,478300,32931
7625,6833,792,1782,392300,32934
18125,10829,7296,1404,240500,32935
11338,9332,2006,1718,421300,32937
20206,17027,3179,1904,444100,32940
1723,1368,355,1079,196200,32948
1043,1009,34,-,497200,32949
1844,1735,109,1813,443100,32950
5852,4984,868,1690,495700,32951
8586,7323,1263,1353,404000,32952
9611,7098,2513,1300,394300,32953
16506,12762,3744,1656,327000,32955
13364,11272,2092,1388,279100,32958
5,5,0,-,-,32959
9670,5501,4169,1171,254400,32960
10076,8101,1975,1184,247700,32962
7831,7449,382,2000,894900,32963
9668,7380,2288,1442,264300,32966
10444,8001,2443,1425,394800,32967
5829,5374,455,1716,357800,32968
91,51,40,-,-,32970
5144,4816,328,1340,158800,32976
131,90,41,1563,602900,33001
7621,3242,4379,1616,336200,33004
20826,11312,9514,1576,248300,33009
15845,4825,11020,1318,346500,33010
25275,12106,13169,1562,355600,33012
9232,5741,3491,1488,407400,33013
14731,6468,8263,1720,398400,33014
23010,12354,10656,1841,384000,33015
15693,7804,7889,1753,295800,33016
17594,12712,4882,2066,436300,33018
6201,4745,1456,1983,631800,33019
19568,6784,12784,1444,306700,33020
19689,13211,6478,1707,395800,33021
0,0,0,-,-,33022
20995,13705,7290,1621,344500,33023
25063,15896,9167,1724,365200,33024
28577,13296,15281,1945,339400,33025
12082,9964,2118,1932,382700,33026
25542,20119,5423,1788,403400,33027
9060,7128,1932,2417,521600,33028
13575,12291,1284,2324,575900,33029
10704,4302,6402,1307,382200,33030
2324,2027,297,1816,467100,33031
18300,10859,7441,1626,374700,33032
20690,11271,9419,1648,364700,33033
6067,2142,3925,1283,310700,33034
6304,3003,3301,1855,310500,33035
1660,1344,316,1846,995600,33036
5806,4586,1220,1896,660700,33037
0,0,0,-,-,33039
15049,7276,7773,2079,766400,33040
2974,2329,645,2252,759600,33042
1982,1636,346,2017,563700,33043
4268,2544,1724,1611,705600,33050
307,214,93,1849,834800,33051
9709,4730,4979,1346,291700,33054
11641,8737,2904,1624,341800,33055
11706,7553,4153,1659,332400,33056
13727,6803,6924,1406,354100,33060
14390,9806,4584,1888,511800,33062
24591,18117,6474,1790,270100,33063
23546,14758,8788,1689,293100,33064
20140,9802,10338,1833,416800,33065
8483,7001,1482,1677,212000,33066
8522,6386,2136,2128,652000,33067
18626,11579,7047,1893,288600,33068
12081,5937,6144,1685,253000,33069
2443,1928,515,1866,695000,33070
13432,8557,4875,2092,537100,33071
11975,6868,5107,2193,453700,33073
13393,11363,2030,3243,745400,33076
0,0,0,-,-,33101
367,346,21,-,"2,000,000+",33109
836,92,744,2437,1284700,33122
21512,5574,15938,1427,377600,33125
18353,6791,11562,1651,299800,33126
9398,2609,6789,1394,398800,33127
4229,103,4126,1316,-,33128
6946,2973,3973,2241,573900,33129
17027,2533,14494,1656,479800,33130
13125,4665,8460,2847,621700,33131
9699,2698,7001,2534,545100,33132
14897,7771,7126,1945,906800,33133
16096,8875,7221,1818,660200,33134
14745,3133,11612,1315,396700,33135
7123,871,6252,1337,352700,33136
12545,3351,9194,2338,532900,33137
12544,6227,6317,1647,686300,33138
19569,6629,12940,1745,480500,33139
8373,4947,3426,2020,863600,33140
16640,5820,10820,1739,434500,33141
20369,6003,14366,1289,298000,33142
13821,7463,6358,1823,768900,33143
9135,4907,4228,1730,440600,33144
11696,6444,5252,1769,560300,33145
5828,3519,2309,2774,1141800,33146
14823,7680,7143,1359,301300,33147
5003,3474,1529,"3,500+",1231500,33149
11181,3323,7858,1179,377700,33150
5592,3358,2234,2245,741400,33154
15073,9984,5089,1871,505000,33155
12124,8784,3340,1936,1063100,33156
21641,14189,7452,1493,478300,33157
2070,1976,94,"3,500+",935800,33158
20048,11858,8190,1990,360200,33160
17261,7319,9942,1494,376500,33161
15303,8082,7221,1535,345000,33162
17337,12703,4634,1796,476100,33165
10131,5027,5104,1766,489200,33166
6664,4409,2255,1345,341300,33167
6426,4909,1517,1576,329000,33168
13675,7339,6336,1536,352800,33169
4438,2652,1786,1511,426200,33170
14570,6371,8199,1926,260200,33172
11627,8054,3573,1935,460500,33173
11129,5614,5515,1786,379000,33174
17203,13385,3818,1943,456600,33175
19266,11961,7305,1666,568400,33176
16735,12719,4016,2080,399000,33177
20016,9702,10314,2609,499300,33178
19009,10769,8240,1736,281400,33179
13741,8483,5258,2480,471400,33180
8547,3246,5301,1665,315200,33181
4172,3411,761,2329,473200,33182
12408,8499,3909,1880,372000,33183
6500,4412,2088,1926,418200,33184
9064,7229,1835,2769,496700,33185
23560,16201,7359,2021,422300,33186
5737,5042,695,2065,501800,33187
8549,5233,3316,1539,409500,33189
5506,2852,2654,1777,371200,33190
15820,9356,6464,1789,422600,33193
1865,1418,447,2765,468200,33194
17298,11561,5737,2114,457300,33196
10759,3914,6845,2341,751600,33301
9747,3926,5821,1727,556400,33304
6965,4873,2092,1850,558200,33305
1621,1235,386,1369,469800,33306
15052,10637,4415,1850,536900,33308
13755,7748,6007,1829,309100,33309
24527,11745,12782,1385,276600,33311
18829,11881,6948,1566,397800,33312
22536,9909,12627,1608,236300,33313
11236,4246,6990,2034,347600,33314
5683,3133,2550,1789,492400,33315
6172,3326,2846,2047,793500,33316
12817,9454,3363,1986,449900,33317
20985,13951,7034,1633,228000,33319
22009,17147,4862,1846,259200,33321
18659,15263,3396,2095,258300,33322
8473,6026,2447,2512,449600,33323
20276,11528,8748,2152,350500,33324
10490,7984,2506,2052,406900,33325
11157,7954,3203,2381,529500,33326
6524,5138,1386,3202,691700,33327
10141,8171,1970,2171,523600,33328
4634,4373,261,2618,715000,33330
7765,6574,1191,2849,666900,33331
3467,2925,542,3456,821500,33332
12905,7278,5627,1615,430500,33334
12724,7225,5499,1881,352500,33351
0,0,0,-,-,33388
14832,5508,9324,1774,430900,33401
5009,2393,2616,1426,340100,33403
11590,6533,5057,1507,305600,33404
8286,4851,3435,1432,401200,33405
8595,5524,3071,1677,358300,33406
12804,6098,6706,1551,290500,33407
9756,7352,2404,1885,502900,33408
11949,5582,6367,1633,282900,33409
15327,11087,4240,2193,469100,33410
28173,21544,6629,1887,400900,33411
5656,4878,778,1902,560800,33412
5649,3786,1863,2016,405900,33413
20513,14901,5612,2326,533800,33414
18427,10632,7795,1597,220800,33415
16470,9664,6806,1533,159300,33417
18505,14244,4261,2304,608500,33418
11024,6724,4300,1981,298500,33426
16021,10728,5293,2349,433300,33428
6229,2230,3999,860,142200,33430
7597,5130,2467,2361,575700,33431
10637,6202,4435,2226,943400,33432
20579,14456,6123,2320,414400,33433
10686,8347,2339,1500,379300,33434
14523,9226,5297,1846,306900,33435
19780,14874,4906,1883,327100,33436
18091,15518,2573,1968,391000,33437
184,104,80,1275,87100,33438
7391,5307,2084,898,159900,33440
12658,7101,5557,1544,381700,33441
15101,10717,4384,1952,231400,33442
8885,4722,4163,1712,425200,33444
13987,9848,4139,1991,282500,33445
14399,12815,1584,1792,415000,33446
3209,2924,285,2892,625500,33449
9458,7926,1532,1193,395600,33455
20944,15636,5308,2090,550700,33458
12945,5779,7166,1411,333200,33460
15800,7948,7852,1615,263400,33461
12673,8470,4203,1659,323600,33462
20614,14793,5821,1721,326600,33463
22489,19485,3004,1975,413600,33467
6659,5919,740,1786,552500,33469
10877,10110,767,2576,532200,33470
2318,1660,658,862,105700,33471
7984,7394,590,2264,410700,33472
4238,4185,53,-,729800,33473
2047,869,1178,899,143800,33476
6796,5850,946,2576,612700,33477
5277,5095,182,2701,653000,33478
6450,5393,1057,1840,1218500,33480
6573,4686,1887,2306,755700,33483
14063,11472,2591,1876,220100,33484
8989,6419,2570,2226,636400,33486
9932,7470,2462,2382,573100,33487
821,506,315,1067,121100,33493
10547,8613,1934,2469,563600,33496
5598,5126,472,"3,500+",597100,33498
72,72,0,-,462500,33503
11337,7238,4099,1365,274600,33510
22685,12341,10344,1684,324900,33511
4495,3480,1015,1089,213900,33513
779,600,179,883,200000,33514
244,200,44,989,99500,33521
6899,5295,1604,1020,231700,33523
7760,5964,1796,1045,228700,33525
5318,3954,1364,944,347300,33527
10,10,0,-,-,33530
5739,3819,1920,1364,274000,33534
2702,1935,767,1005,157200,33538
4745,4168,577,978,120600,33540
10543,8935,1608,1243,111300,33541
10421,7278,3143,1049,129900,33542
13025,11065,1960,2138,365000,33543
9798,6893,2905,1926,399200,33544
8334,6863,1471,2196,363000,33545
9571,8053,1518,2114,477300,33547
2933,2383,550,1805,523000,33548
7233,5683,1550,1582,339400,33549
0,0,0,-,-,33550
11637,9966,1671,1744,589700,33556
11179,8252,2927,1423,479300,33558
7036,4300,2736,1421,343700,33559
9890,5966,3924,1226,197500,33563
6227,5428,799,1133,237600,33565
7959,5567,2392,1333,290600,33566
3851,3059,792,1289,288700,33567
9842,8235,1607,2167,330700,33569
11754,8784,2970,1217,255400,33570
9666,7987,1679,2057,430900,33572
15251,12795,2456,1951,270600,33573
0,0,0,-,-,33574
2873,2668,205,1199,330500,33576
23808,13870,9938,1766,298000,33578
14459,11925,2534,2106,374600,33579
10077,7557,2520,1379,280700,33584
470,397,73,854,213900,33585
4275,2591,1684,1134,247900,33592
13202,10343,2859,1684,300300,33594
10034,8227,1807,2236,396100,33596
3574,3120,454,829,214500,33597
9286,8046,1240,1279,352800,33598
10787,3339,7448,2119,560400,33602
8709,5067,3642,1320,344100,33603
15521,8611,6910,1326,264900,33604
7451,3003,4448,1122,235100,33605
9367,3945,5422,1931,796000,33606
11575,4502,7073,1771,316100,33607
8357,5425,2932,1818,526000,33609
16467,8101,8366,1307,210600,33610
17247,9333,7914,1681,449200,33611
19058,6986,12072,1259,249600,33612
15877,5264,10613,1178,219700,33613
18058,7623,10435,1399,295700,33614
18881,10544,8337,1586,291500,33615
6488,3211,3277,1794,369900,33616
20004,8570,11434,1337,267200,33617
11737,8198,3539,1400,379200,33618
14271,7516,6755,1618,220300,33619
4,0,4,-,-,33620
490,0,490,2657,-,33621
15337,10363,4974,1658,353300,33624
11508,7613,3895,1797,341600,33625
11778,8091,3687,2127,506600,33626
10465,8229,2236,1758,764100,33629
7650,4457,3193,1719,310900,33634
7521,4801,2720,1760,309800,33635
7720,3164,4556,1531,213800,33637
26825,16182,10643,1784,437600,33647
10332,3904,6428,1531,590900,33701
14127,9573,4554,1369,293700,33702
11110,8884,2226,1569,395200,33703
7856,5352,2504,1398,657400,33704
11500,6674,4826,1457,321500,33705
8569,6429,2140,1646,616800,33706
12645,8869,3776,1512,344600,33707
8052,6088,1964,1961,463700,33708
11144,8486,2658,1317,190300,33709
14901,12044,2857,1577,312500,33710
6697,4756,1941,1819,253100,33711
10082,5776,4306,1440,300600,33712
14468,10100,4368,1387,279000,33713
8275,5420,2855,1270,177500,33714
3986,3642,344,2843,539700,33715
10194,2035,8159,1732,163500,33716
0,0,0,-,-,33744
10572,6095,4477,1340,300200,33755
12948,7983,4965,1382,335800,33756
7722,3977,3745,1771,295000,33759
7594,3684,3910,1446,245800,33760
8635,6779,1856,1711,271100,33761
2591,2069,522,1711,332000,33762
9919,7216,2703,1447,215900,33763
12624,8498,4126,1622,302500,33764
6126,3308,2818,1585,290700,33765
4096,3467,629,2033,704800,33767
11190,6798,4392,1481,245200,33770
13179,8364,4815,1379,145600,33771
10298,7566,2732,1454,327000,33772
7015,5215,1800,1567,280600,33773
8336,6511,1825,1498,315200,33774
4966,4523,443,2291,436700,33776
7252,6197,1055,1682,298500,33777
6613,5509,1104,1697,267800,33778
10723,6843,3880,1197,251200,33781
9351,6988,2363,1767,253700,33782
2506,1943,563,1804,689500,33785
693,654,39,2955,1022700,33786
11782,5920,5862,1100,138700,33801
12588,7832,4756,1337,236200,33803
10235,4917,5318,1179,173800,33805
11633,7420,4213,1492,248700,33809
19364,14804,4560,1407,245300,33810
10240,7848,2392,1256,289800,33811
4871,3843,1028,1520,335000,33812
13969,10805,3164,1637,330100,33813
6197,3598,2599,1078,42700,33815
13507,9617,3890,1068,234300,33823
10407,7739,2668,902,152400,33825
851,727,124,1196,213000,33827
10901,7466,3435,1017,207900,33830
1483,990,493,1049,104200,33834
44,26,18,-,-,33835
15223,12516,2707,1739,297700,33837
1855,1214,641,1600,230100,33838
1349,1046,303,1479,234600,33839
0,0,0,-,-,33840
3039,2118,921,860,138700,33841
4249,3526,723,864,107900,33843
16873,11801,5072,1158,212700,33844
162,93,69,691,-,33847
107,73,34,-,-,33848
225,211,14,-,281200,33849
3921,2887,1034,1072,215700,33850
309,281,28,-,175400,33851
9784,7942,1842,1063,205800,33852
4706,2624,2082,965,198100,33853
262,109,153,595,80700,33854
17,17,0,-,-,33855
230,6,224,619,-,33856
476,442,34,-,132400,33857
126,16,110,-,-,33858
4430,3348,1082,1232,200300,33859
8719,6102,2617,1150,221400,33860
189,93,96,-,-,33865
53,53,0,-,-,33867
4213,3661,552,1092,235600,33868
11092,7773,3319,977,154300,33870
6127,5531,596,1157,193900,33872
4982,3494,1488,944,128500,33873
4835,4019,816,1130,216500,33875
2779,2412,367,892,161500,33876
237,237,0,-,189100,33877
15071,9912,5159,1128,200900,33880
14889,10361,4528,1153,177400,33881
13832,10521,3311,1523,269400,33884
1537,1257,280,969,140700,33890
8631,4053,4578,1969,307200,33896
10263,7146,3117,1880,279100,33897
7327,6076,1251,1122,161500,33898
9430,4179,5251,1291,280400,33901
11671,9650,2021,1152,135400,33903
14782,11364,3418,1665,347100,33904
14906,9590,5316,1509,260400,33905
11132,4809,6323,1502,236700,33907
19836,14336,5500,1829,346200,33908
12801,9280,3521,1773,292800,33909
8609,7469,1140,1653,367800,33912
11523,10431,1092,1914,439200,33913
18054,14368,3686,1714,408800,33914
10426,3580,6846,1363,242300,33916
14912,12499,2413,1320,170100,33917
14987,11532,3455,1621,291500,33919
2839,2654,185,1119,376000,33920
327,327,0,-,"2,000,000+",33921
1749,1492,257,1110,330100,33922
44,44,0,-,-,33924
14289,12157,2132,1959,418900,33928
358,319,39,-,606500,33930
4630,4171,459,1500,475100,33931
7732,5850,1882,996,192500,33935
10044,6861,3183,1260,205500,33936
107,107,0,-,85200,33944
1357,1239,118,870,626500,33946
5094,4250,844,1359,352300,33947
7932,6854,1078,1384,279500,33948
12281,10211,2070,1192,393500,33950
14600,11310,3290,1249,224900,33952
2971,2907,64,1817,332200,33953
4735,3866,869,1830,304000,33954
5061,4608,453,1559,321500,33955
1852,1658,194,2259,284800,33956
3309,3031,278,747,912200,33957
331,280,51,1028,205700,33960
78,0,78,1350,-,33965
5452,3489,1963,1743,362400,33966
10036,7331,2705,1695,321800,33967
8284,6611,1673,1678,271900,33971
4738,3776,962,1537,290300,33972
4086,874,3212,1432,334800,33973
5393,3755,1638,1698,272800,33974
5124,3679,1445,1733,270200,33976
6102,4558,1544,1216,221200,33980
6341,5704,637,1198,355600,33981
4798,4218,580,1104,285400,33982
7796,6220,1576,1357,324100,33983
13606,9721,3885,1643,330500,33990
9862,7790,2072,1914,351100,33991
11160,9894,1266,2057,319500,33993
0,0,0,-,-,34101
5434,4072,1362,1491,1422000,34102
5535,4827,708,2039,938200,34103
11521,7773,3748,1742,348600,34104
7885,5254,2631,2041,515600,34105
8461,7244,1217,2099,972400,34108
11991,8170,3821,1873,628700,34109
12765,9522,3243,2068,529700,34110
13191,10216,2975,1529,293000,34112
10689,7782,2907,1888,450700,34113
10205,8614,1591,1993,469900,34114
10345,5899,4446,1663,392700,34116
5540,4870,670,1771,416300,34117
14640,12038,2602,1998,665000,34119
14400,13107,1293,2067,456300,34120
8673,7081,1592,1814,659600,34134
20405,16417,3988,1790,419200,34135
173,173,0,-,160100,34137
309,258,51,-,220100,34138
129,80,49,1987,358800,34139
52,36,16,-,-,34140
51,17,34,-,-,34141
8647,4376,4271,989,296400,34142
8433,7578,855,1955,866200,34145
1872,1739,133,"3,500+",621700,34201
10795,8488,2307,2111,620700,34202
16885,12376,4509,1437,302500,34203
13317,7687,5630,1323,236900,34205
14716,9189,5527,1270,122100,34207
14667,8602,6065,1409,303600,34208
14814,11749,3065,1847,357300,34209
8109,4979,3130,1552,279500,34210
7827,6458,1369,1940,601300,34211
9337,7857,1480,1799,478000,34212
362,334,28,-,722200,34215
489,466,23,-,1154400,34216
2092,1845,247,1657,636300,34217
11155,9942,1213,1836,420400,34219
20419,16441,3978,1459,298200,34221
6209,5078,1131,1525,194300,34222
10021,8673,1348,1288,358000,34223
7829,6316,1513,1219,262200,34224
4172,3907,265,2969,959200,34228
3516,3121,395,2008,635800,34229
15529,10240,5289,1707,363400,34231
15335,10533,4802,1836,332600,34232
8366,6074,2292,1787,364300,34233
8989,5342,3647,1352,222900,34234
7002,5110,1892,1729,338200,34235
7954,4561,3393,2010,917100,34236
7365,3192,4173,1524,234400,34237
11596,8773,2823,1828,532800,34238
6865,5159,1706,1522,418300,34239
6416,5578,838,2306,622100,34240
5983,5242,741,1797,479700,34241
4136,3730,406,2408,995900,34242
13577,10230,3347,1960,395000,34243
190,190,0,-,921100,34250
2193,1987,206,1194,506300,34251
10205,6757,3448,907,144600,34266
34,34,0,-,-,34267
122,122,0,-,-,34268
2295,2112,183,994,188800,34269
10933,9438,1495,1459,435600,34275
10405,8325,2080,1485,295400,34285
8230,6807,1423,2111,318100,34286
11705,9175,2530,1296,235400,34287
5847,4696,1151,1951,333400,34288
1498,1118,380,1769,338400,34289
3032,2478,554,1798,327200,34291
8338,6607,1731,1924,417400,34292
23281,20526,2755,1831,368100,34293
7372,5375,1997,909,192600,34420
4331,3257,1074,890,236100,34428
4243,3512,731,1070,220300,34429
3945,3412,533,858,185200,34431
5800,4911,889,1077,223900,34432
3127,2672,455,1322,217100,34433
4090,3579,511,1226,211500,34434
3588,3073,515,715,201400,34436
7976,6868,1108,965,295900,34442
17,17,0,-,-,34445
8564,8014,550,938,231700,34446
4696,4074,622,941,166000,34448
1539,1087,452,775,143900,34449
5053,4112,941,973,210200,34450
5727,4784,943,1182,207200,34452
4666,3887,779,1046,174500,34453
4844,4230,614,1190,287200,34461
8541,6934,1607,1146,233000,34465
9241,5715,3526,1124,171500,34470
10877,6448,4429,1225,292200,34471
12978,10216,2762,1232,185900,34472
8411,6631,1780,1406,242400,34473
8358,3808,4550,1605,177800,34474
4800,2323,2477,871,170300,34475
11940,10598,1342,1303,260300,34476
5431,3801,1630,1252,190400,34479
8901,6938,1963,1238,248400,34480
13352,12081,1271,1154,213000,34481
7965,6576,1389,861,247600,34482
2472,1575,897,-,375800,34484
0,0,0,-,-,34487
5080,3604,1476,1098,75300,34488
14070,12178,1892,1102,253100,34491
296,240,56,1110,307800,34498
10294,7276,3018,1066,151500,34601
3612,3157,455,1284,241300,34602
4597,4194,403,1162,272300,34604
12466,9668,2798,1192,227700,34606
3933,3216,717,1226,343100,34607
14230,11390,2840,1207,237400,34608
17063,14169,2894,1593,275900,34609
5827,4872,955,1265,254100,34610
8696,7805,891,1108,181800,34613
3201,3073,128,1194,272100,34614
3603,3325,278,1747,385700,34637
11381,9402,1979,2204,378200,34638
10606,8550,2056,1949,361100,34639
11760,7502,4258,1189,198400,34652
15824,10252,5572,1222,180900,34653
9340,7293,2047,1449,257500,34654
18765,14712,4053,1696,353000,34655
174,88,86,-,144400,34661
15114,11635,3479,1189,214200,34667
20627,13092,7535,1278,168800,34668
5879,4941,938,1285,219200,34669
8914,7005,1909,1484,352200,34677
66,40,26,-,-,34679
502,452,50,-,680500,34681
13868,11160,2708,1655,424200,34683
12686,9093,3593,1781,293800,34684
7286,5588,1698,1884,479400,34685
3322,3039,283,1397,477100,34688
12323,10078,2245,1207,311500,34689
5518,3554,1964,1225,152200,34690
9405,6102,3303,1208,172100,34691
7293,6310,983,1680,418200,34695
18161,12952,5209,1571,335800,34698
1115,902,213,1067,241500,34705
25763,19409,6354,1817,369900,34711
9507,4797,4710,1642,343600,34714
8342,6833,1509,2067,407900,34715
12,12,0,-,-,34729
5088,4196,892,1157,185900,34731
1229,1050,179,1989,351600,34734
9425,8317,1108,1535,335300,34736
1778,1575,203,1785,348700,34737
371,234,137,-,186800,34739
18973,6817,12156,1591,270200,34741
12154,8518,3636,1738,277700,34743
20747,14072,6675,1426,326700,34744
18184,13269,4915,1793,328500,34746
10522,5632,4890,1812,455600,34747
21147,15518,5629,1181,226200,34748
2215,1762,453,1536,285100,34753
1413,1147,266,1449,535900,34756
12792,9862,2930,1780,280000,34758
14864,11615,3249,1670,271400,34759
236,225,11,-,401200,34760
14153,10502,3651,1806,363100,34761
187,187,0,-,271000,34762
9800,6421,3379,1400,271800,34769
9781,8333,1448,1695,427500,34771
10962,9152,1810,1823,352400,34772
1794,1536,258,2068,312500,34773
5681,3831,1850,1082,210500,34785
15082,11111,3971,2239,621300,34786
30658,22017,8641,1994,475000,34787
9374,7705,1669,1384,168900,34788
582,565,17,-,387700,34797
1788,1635,153,747,285500,34945
2721,1601,1120,1000,128100,34946
4197,1932,2265,1125,202700,34947
4214,3471,743,1484,427500,34949
7001,2532,4469,1121,175900,34950
7078,6036,1042,1186,229600,34951
17919,13013,4906,1635,242100,34952
26723,22833,3890,1902,326800,34953
2186,1514,672,927,203500,34956
11235,8488,2747,1518,378500,34957
5979,3911,2068,994,193300,34972
10564,8456,2108,958,162900,34974
1984,1160,824,1402,369100,34981
10978,8140,2838,1254,228300,34982
16723,14018,2705,1739,293500,34983
6743,5790,953,1888,324900,34984
12393,10614,1779,1600,368300,34986
7822,6394,1428,1994,430100,34987
11970,10763,1207,1958,558300,34990
8264,4854,3410,1558,248900,34994
5720,4886,834,1334,409400,34996
19185,15996,3189,1520,335200,34997
4625,3515,1110,1555,218100,35004
3116,2770,346,1074,138100,35005
1296,1207,89,764,116900,35006
10163,8523,1640,1348,231800,35007
8102,5628,2474,702,129500,35010
20,3,17,-,-,35013
1476,1346,130,-,119100,35014
6701,5073,1628,758,192900,35016
967,836,131,926,120800,35019
10076,5663,4413,856,90900,35020
9715,7845,1870,991,241300,35022
8641,6964,1677,1216,153400,35023
2761,2091,670,771,135100,35031
26,19,7,-,75000,35032
1366,1257,109,1097,172800,35033
1487,1075,412,822,151700,35034
527,412,115,-,-,35035
77,10,67,-,-,35036
7061,5627,1434,1441,210600,35040
2248,1724,524,517,139600,35042
4942,4483,459,1279,347500,35043
3456,2377,1079,792,120000,35044
6241,4409,1832,926,164100,35045
1886,1574,312,809,154700,35046
1661,1215,446,928,182500,35049
3324,2613,711,879,248300,35051
0,0,0,-,-,35052
1127,1063,64,924,242700,35053
1773,1565,208,1289,274200,35054
9575,6030,3545,934,195400,35055
5513,4711,802,845,191300,35057
4206,3110,1096,872,193600,35058
111,111,0,-,111300,35060
460,257,203,1151,162500,35061
3153,2718,435,695,180500,35062
1341,1141,200,915,92700,35063
3768,2224,1544,997,119900,35064
3833,2613,1220,1180,188400,35068
46,46,0,-,152800,35070
6794,5289,1505,1183,239500,35071
1851,1426,425,667,99000,35072
1258,835,423,965,115700,35073
68,0,68,-,-,35074
5378,3902,1476,822,157000,35077
789,688,101,899,190600,35078
3384,2989,395,854,194400,35079
6644,6069,575,1611,278500,35080
0,0,0,-,-,35082
1446,1218,228,834,173200,35083
3193,2489,704,872,122300,35085
969,829,140,895,167400,35087
805,650,155,-,107400,35089
1379,1301,78,889,284900,35091
5796,4503,1293,976,222200,35094
3297,3012,285,914,176700,35096
735,648,87,1054,133300,35097
468,292,176,736,177300,35098
7565,7023,542,1128,263800,35111
20,20,0,-,-,35112
2695,2449,246,1056,280400,35114
5884,4230,1654,807,165800,35115
1815,1675,140,844,228200,35116
2036,1898,138,1081,195300,35117
1110,885,225,972,156900,35118
0,0,0,-,-,35119
6153,5180,973,967,210900,35120
6024,4363,1661,704,168800,35121
9953,8313,1640,1575,282600,35124
4052,2765,1287,985,179900,35125
7768,6947,821,1257,189100,35126
3547,2786,761,1153,189100,35127
4095,3442,653,1185,240100,35128
1356,1060,296,564,103300,35130
1391,1068,323,726,96300,35131
1147,1017,130,795,167200,35133
756,568,188,1120,243800,35135
788,680,108,391,153700,35136
1286,1060,226,752,212200,35143
4658,4021,637,746,255100,35146
2427,2174,253,1626,283300,35147
999,736,263,765,145500,35148
0,0,0,-,-,35149
7493,4321,3172,721,135500,35150
3116,2790,326,1129,138700,35151
10609,7099,3510,772,129300,35160
1335,1000,335,837,190700,35171
1125,928,197,773,111000,35172
11383,10180,1203,1303,327500,35173
2052,1756,296,892,183100,35175
301,196,105,911,114100,35176
1166,969,197,873,152300,35178
3161,2760,401,763,175600,35179
5029,4322,707,895,198600,35180
13,13,0,-,-,35181
378,318,60,-,100900,35183
1951,1589,362,928,109800,35184
0,0,0,-,-,35185
1939,1565,374,1276,289400,35186
806,705,101,920,198100,35188
1770,491,1279,954,288600,35203
4099,1852,2247,716,81600,35204
9720,3037,6683,1005,292000,35205
6436,3054,3382,990,122500,35206
3095,1577,1518,775,74800,35207
5763,3630,2133,951,91900,35208
12985,6497,6488,1246,465600,35209
6305,4295,2010,1164,247600,35210
11774,4750,7024,1044,94500,35211
4508,1825,2683,754,210400,35212
6573,5158,1415,1749,753400,35213
6846,4533,2313,987,149600,35214
16993,9211,7782,1080,146900,35215
14940,8177,6763,1314,376200,35216
5278,2548,2730,835,113800,35217
2471,902,1569,897,79500,35218
1519,986,533,1012,72600,35221
3814,2267,1547,1086,374600,35222
4368,3854,514,1372,744400,35223
1971,1178,793,1063,81600,35224
14086,11671,2415,1467,387100,35226
3894,2385,1509,1080,79200,35228
0,0,0,-,-,35229
2369,188,2181,1526,332100,35233
1725,898,827,783,77700,35234
7908,5278,2630,1220,165900,35235
23721,17353,6368,1430,452300,35242
8782,4658,4124,1632,484400,35243
14381,10312,4069,1413,390900,35244
0,0,0,-,-,35249
0,0,0,-,-,35254
13422,4217,9205,911,141100,35401
8600,3845,4755,986,175700,35404
19889,11004,8885,1057,224900,35405
7545,5659,1886,1352,467000,35406
307,294,13,-,78000,35441
1628,882,746,671,121700,35442
711,579,132,396,55700,35443
1657,1447,210,875,181300,35444
658,499,159,823,106900,35446
1271,1025,246,580,128500,35447
1710,1525,185,950,180500,35452
4502,3798,704,969,190300,35453
1575,1101,474,1078,159800,35456
54,54,0,-,-,35457
277,212,65,-,188600,35458
378,307,71,-,65500,35459
258,244,14,-,56000,35460
856,811,45,-,179000,35461
1706,1007,699,-,96700,35462
692,685,7,-,194100,35463
153,60,93,725,50600,35464
1984,1690,294,623,119600,35466
184,159,25,-,-,35469
1295,834,461,933,154200,35470
8208,4841,3367,922,249900,35473
2683,2366,317,861,187700,35474
7110,6599,511,963,310200,35475
3208,1222,1986,940,196800,35476
46,46,0,-,-,35477
512,488,24,-,260500,35480
1263,857,406,424,93400,35481
0,0,0,-,-,35487
1636,1431,205,736,167800,35490
0,0,0,-,-,35491
3569,2169,1400,782,150300,35501
3701,3077,624,678,159500,35503
5142,4044,1098,809,196200,35504
927,777,150,668,117100,35540
1639,1327,312,885,181900,35541
446,427,19,-,93900,35542
470,337,133,640,127600,35543
350,269,81,842,117400,35544
33,23,10,-,110400,35545
1335,1142,193,553,153600,35546
755,583,172,418,64600,35548
1356,1096,260,433,58100,35549
1869,1374,495,636,84700,35550
296,235,61,376,90200,35552
1784,1427,357,449,98700,35553
459,399,60,-,104900,35554
3679,2629,1050,624,123500,35555
18,8,10,-,-,35559
1454,1118,336,505,112100,35563
825,642,183,575,91700,35564
4366,3153,1213,703,79900,35565
3731,2671,1060,563,120600,35570
295,262,33,625,93000,35571
561,528,33,-,-,35572
6,6,0,-,-,35573
407,362,45,667,98800,35574
447,336,111,781,72300,35575
1343,1153,190,706,116500,35576
2,2,0,-,-,35577
2201,1968,233,1055,96500,35578
1292,1063,229,593,109900,35579
1412,1210,202,1002,103900,35580
2039,1556,483,706,105400,35581
1980,1322,658,568,113800,35582
118,64,54,919,-,35584
592,487,105,787,220800,35585
1238,936,302,556,101700,35586
333,275,58,-,-,35587
1692,1062,630,490,126900,35592
567,486,81,658,112800,35593
2845,2144,701,703,144300,35594
13867,8029,5838,860,148100,35601
13552,9970,3582,857,235600,35603
629,587,42,950,123400,35610
12090,7390,4700,796,201700,35611
9259,8042,1217,1284,291300,35613
2620,1971,649,1022,178200,35614
0,0,0,-,-,35615
1582,1160,422,820,94100,35616
809,600,209,564,106100,35618
1992,1692,300,993,150000,35619
4083,3509,574,903,190800,35620
1168,1043,125,1029,186400,35621
2479,1952,527,880,174400,35622
14739,6441,8298,783,153300,35630
0,0,0,-,-,35632
8351,6814,1537,792,177500,35633
4169,3375,794,911,262800,35634
10218,8182,2036,767,196600,35640
1300,1099,201,732,112700,35643
5289,4347,942,1006,212500,35645
1783,1516,267,475,114200,35646
334,324,10,-,241400,35647
1245,1048,197,623,127800,35648
27,27,0,-,416700,35649
5285,4449,836,680,176000,35650
479,413,66,-,184700,35651
3916,3291,625,799,178600,35652
3791,2772,1019,733,117800,35653
3284,2204,1080,634,158300,35654
4437,2613,1824,850,129000,35660
7850,5747,2103,917,189700,35661
2691,2015,676,765,165200,35670
595,478,117,672,251400,35671
2217,1802,415,679,124700,35672
3006,2414,592,730,191400,35673
8034,5696,2338,768,176700,35674
657,611,46,642,190400,35677
2207,1781,426,782,199900,35739
1536,1010,526,519,110300,35740
1893,1534,359,1308,293700,35741
808,588,220,789,170000,35744
72,57,15,-,104200,35745
386,371,15,-,126700,35746
2480,2215,265,663,219100,35747
2881,2540,341,743,330600,35748
9898,8975,923,1294,270300,35749
5248,4389,859,1079,186200,35750
57,57,0,-,226400,35751
999,681,318,944,108200,35752
2228,1885,343,736,174900,35754
213,118,95,784,420000,35755
8322,6878,1444,1710,350600,35756
6796,5439,1357,1435,298800,35757
19622,13700,5922,1375,336700,35758
4657,4257,400,1242,272200,35759
1762,1486,276,790,164500,35760
5195,4320,875,975,215300,35761
7117,6488,629,2455,368300,35763
249,214,35,-,85700,35764
1707,1394,313,824,150300,35765
81,46,35,-,82300,35766
4885,3225,1660,791,132800,35768
4019,3201,818,787,193900,35769
1242,995,247,726,111300,35771
1929,1410,519,645,148500,35772
5464,4924,540,1141,199000,35773
51,51,0,-,93300,35774
211,211,0,-,74200,35775
1326,1150,176,588,131100,35776
10300,6970,3330,1130,399700,35801
11418,6073,5345,1051,319900,35802
12570,10276,2294,1221,259100,35803
9349,3158,6191,800,108200,35805
13485,6534,6951,1287,318800,35806
374,8,366,1690,-,35808
11963,7896,4067,1097,126100,35810
11253,8816,2437,1048,249900,35811
7002,1903,5099,875,114100,35816
4541,2513,2028,1268,378000,35824
0,0,0,-,-,35896
7237,4716,2521,747,174200,35901
6839,4557,2282,823,170000,35903
5079,3551,1528,792,100100,35904
2368,1962,406,715,188600,35905
3996,2598,1398,998,199500,35906
3203,2934,269,1131,203500,35907
7130,4857,2273,808,149500,35950
4956,3677,1279,688,147400,35951
3368,2626,742,661,120400,35952
2654,2223,431,1111,197600,35953
4683,3830,853,681,130600,35954
3100,2498,602,816,170900,35956
5976,4106,1870,679,142500,35957
1125,964,161,765,140700,35958
1979,1548,431,750,193400,35959
4026,3006,1020,741,176100,35960
2001,1442,559,569,89300,35961
2756,2189,567,749,130200,35962
536,443,93,554,107500,35963
1485,1218,267,808,145000,35966
6713,4776,1937,678,155700,35967
1648,1369,279,679,116800,35968
1851,1347,504,745,118900,35971
549,549,0,-,89500,35972
1147,935,212,660,99000,35973
686,530,156,655,162500,35974
543,504,39,-,181800,35975
6306,4837,1469,792,254700,35976
2021,1567,454,747,123900,35978
352,341,11,-,129900,35979
2145,1753,392,748,168600,35980
597,494,103,-,101000,35981
1391,1249,142,811,157400,35983
685,577,108,-,107800,35984
3164,2680,484,656,207600,35986
960,850,110,693,144600,35987
786,526,260,628,128800,35988
1329,1062,267,730,89500,35989
0,0,0,-,-,35990
1001,870,131,425,111700,36003
583,484,99,934,101000,36005
768,723,45,1034,198600,36006
0,0,0,-,-,36008
921,711,210,671,122600,36009
2217,1614,603,703,108300,36010
78,78,0,-,376500,36013
1249,858,391,636,75300,36016
766,484,282,448,77500,36017
460,381,79,1029,183800,36020
5522,4827,695,924,235400,36022
2699,2172,527,781,228900,36024
1439,1118,321,1182,167400,36025
592,572,20,-,285900,36026
5968,3940,2028,661,126500,36027
625,387,238,584,129600,36028
313,267,46,-,214500,36029
75,50,25,-,-,36030
36,36,0,-,"10,000-",36031
939,632,307,460,75000,36032
1458,1089,369,646,102000,36033
233,204,29,778,82200,36034
802,674,128,647,107200,36035
754,597,157,995,143400,36036
5046,3271,1775,729,101200,36037
67,29,38,-,131300,36038
84,59,25,-,-,36039
1389,934,455,801,68300,36040
572,475,97,670,117000,36041
455,424,31,-,114000,36042
1150,932,218,965,179300,36043
551,470,81,833,110700,36046
499,452,47,-,-,36047
615,452,163,604,103500,36048
1945,1335,610,678,124000,36049
1069,941,128,1037,58700,36051
372,334,38,-,549200,36052
909,738,171,688,104900,36053
5739,3965,1774,1012,172700,36054
0,0,0,-,-,36057
4683,4106,577,1588,379300,36064
8982,5573,3409,1300,220900,36066
10084,7569,2515,985,180100,36067
884,662,222,922,95200,36069
276,228,48,656,96400,36071
741,631,110,944,112200,36075
5206,3764,1442,842,175200,36078
3796,2773,1023,969,166700,36079
950,791,159,1132,209700,36080
5657,2702,2955,833,182600,36081
0,0,0,-,-,36082
3457,1945,1512,692,89100,36083
1087,511,576,710,100600,36088
2576,1483,1093,631,69900,36089
1598,1329,269,689,132500,36091
8233,6178,2055,1024,189600,36092
4128,3864,264,910,289800,36093
0,0,0,-,-,36101
4125,1062,3063,787,121200,36104
4181,2689,1492,965,79600,36105
6323,3561,2762,1138,207400,36106
3158,1164,1994,883,69800,36107
6393,3993,2400,786,73700,36108
10092,6747,3345,1108,134900,36109
3992,1881,2111,1014,81200,36110
4871,2890,1981,1052,152000,36111
7,0,7,1125,-,36112
253,0,253,1985,-,36113
0,0,0,-,-,36114
237,0,237,1441,-,36115
17734,8431,9303,1056,137000,36116
21806,13607,8199,1209,225900,36117
0,0,0,-,-,36130
7088,4244,2844,709,75900,36201
7286,5263,2023,891,166000,36203
549,206,343,519,265300,36205
4176,2638,1538,785,128000,36206
8010,6108,1902,890,195000,36207
1599,1413,186,-,182400,36250
2072,1530,542,442,158200,36251
440,392,48,-,141000,36255
579,513,66,630,164200,36256
700,637,63,-,101600,36258
1603,1326,277,742,152800,36260
580,536,44,746,150000,36262
145,129,16,-,121300,36263
3259,2458,801,766,155500,36264
8347,5278,3069,794,163500,36265
2597,1955,642,671,185000,36266
16,16,0,-,-,36267
2179,1890,289,731,84900,36268
574,416,158,1053,126100,36269
2245,2091,154,808,134000,36271
5056,3900,1156,808,123200,36272
1263,1094,169,917,182000,36273
4270,3168,1102,594,121300,36274
832,644,188,807,190000,36276
1845,1566,279,1034,139800,36277
1968,1698,270,648,252100,36278
1151,955,196,1172,167700,36279
1685,1395,290,813,223400,36280
15567,9073,6494,886,156100,36301
12068,7086,4982,855,175600,36303
6812,4606,2206,1120,236000,36305
2543,1894,649,706,123400,36310
987,800,187,712,126300,36311
2323,1750,573,865,158300,36312
83,83,0,-,-,36313
228,186,42,-,-,36314
856,707,149,588,187100,36316
268,260,8,-,110100,36317
544,480,64,746,127300,36318
913,738,175,766,165800,36319
1360,1059,301,675,130700,36320
811,605,206,842,178500,36321
3751,2346,1405,777,115200,36322
3277,2380,897,675,108400,36323
14869,9651,5218,1055,198600,36330
2096,1494,602,663,109500,36340
590,449,141,884,95000,36343
2042,1475,567,802,158800,36344
3270,2721,549,797,179900,36345
514,460,54,814,138200,36346
2975,1667,1308,780,169300,36350
1595,1323,272,663,159500,36351
2052,1678,374,810,200400,36352
668,582,86,938,98100,36353
7953,5368,2585,750,138200,36360
1464,15,1449,1402,-,36362
396,363,33,573,100500,36370
202,156,46,744,120400,36371
191,155,36,-,-,36373
284,237,47,962,171700,36374
3053,2539,514,797,123800,36375
843,629,214,799,103900,36376
2869,2027,842,807,102500,36401
3944,2899,1045,659,163900,36420
3700,2930,770,772,156400,36421
307,220,87,-,82200,36425
5492,3994,1498,696,124700,36426
810,670,140,721,53600,36432
189,152,37,-,77300,36435
237,175,62,852,134600,36436
47,40,7,-,-,36439
1234,820,414,767,118800,36441
1341,978,363,739,119800,36442
192,175,17,-,97900,36444
1848,1428,420,744,107900,36445
141,93,48,-,109300,36446
1754,1289,465,782,130800,36451
1006,866,140,691,96500,36453
4,4,0,-,-,36454
132,74,58,654,72700,36455
654,530,124,533,80000,36456
3774,2329,1445,648,119600,36460
4008,2965,1043,725,119900,36467
0,0,0,-,-,36470
283,177,106,748,58300,36471
85,53,32,762,129200,36473
975,837,138,740,105400,36474
778,633,145,783,113500,36475
21,6,15,-,-,36476
1790,1409,381,738,99400,36477
488,449,39,-,153500,36480
59,55,4,-,135900,36481
338,276,62,-,76400,36482
232,193,39,-,144300,36483
5952,3892,2060,707,129400,36502
0,0,0,-,-,36503
329,291,38,534,163300,36505
7674,5701,1973,872,160800,36507
507,328,179,722,84400,36509
484,257,227,-,-,36511
0,0,0,-,-,36512
194,194,0,-,112000,36513
781,645,136,388,167600,36518
2090,1947,143,959,168700,36521
2513,1737,776,732,151500,36522
930,784,146,863,191300,36523
418,328,90,703,99300,36524
721,607,114,1065,197600,36525
12900,9657,3243,1353,311000,36526
6966,5230,1736,1373,348200,36527
876,858,18,1750,387400,36528
104,93,11,-,201000,36529
3017,2410,607,1093,251900,36530
15213,12556,2657,1374,395300,36532
16788,13446,3342,1168,250800,36535
130,56,74,-,100900,36538
177,167,10,-,176900,36539
324,274,50,-,-,36540
5693,4936,757,919,164200,36541
7947,5476,2471,1365,366600,36542
5,5,0,-,-,36543
4059,3056,1003,757,116400,36544
3163,2241,922,640,141200,36545
0,0,0,-,-,36547
363,292,71,-,161800,36548
2526,2268,258,845,198000,36549
165,90,75,-,-,36550
3756,2958,798,1151,236900,36551
1101,923,178,450,186900,36553
453,406,47,1154,392700,36555
0,0,0,-,-,36556
1707,1502,205,620,142600,36558
141,141,0,-,-,36559
1028,853,175,1009,111200,36560
4438,2960,1478,1346,529100,36561
544,435,109,-,143400,36562
0,0,0,-,-,36564
5645,4205,1440,943,220400,36567
5,0,5,-,-,36568
276,268,8,-,131900,36569
6964,5321,1643,1072,210100,36571
2464,2091,373,1224,201100,36572
618,515,103,-,193600,36574
7861,6602,1259,1063,193600,36575
1928,1602,326,985,235600,36576
436,436,0,-,209700,36578
518,508,10,-,241400,36579
2488,2091,397,1043,238000,36580
139,104,35,-,305500,36581
9593,7591,2002,916,170400,36582
284,268,16,-,158700,36583
329,309,20,-,-,36584
287,248,39,960,-,36585
3912,3162,750,976,142200,36587
644,137,507,596,258300,36602
3004,986,2018,704,107400,36603
3790,2093,1697,892,236700,36604
9723,5111,4612,1026,97800,36605
8117,3847,4270,938,141300,36606
2509,1404,1105,999,125000,36607
15707,8590,7117,1045,234400,36608
11256,4851,6405,1072,201800,36609
3688,1687,2001,675,56400,36610
2323,1158,1165,945,110300,36611
1326,797,529,800,79500,36612
3985,2823,1162,1233,145100,36613
0,0,0,-,-,36615
4899,2410,2489,1061,75800,36617
6752,5001,1751,1102,155500,36618
5685,4124,1561,1070,172300,36619
0,0,0,-,-,36652
0,0,0,-,-,36663
50,0,50,-,-,36688
7615,5185,2430,1090,199000,36693
19902,13751,6151,1192,234200,36695
8732,5349,3383,823,111000,36701
4507,2453,2054,711,74400,36703
239,209,30,-,75900,36720
58,35,23,-,33800,36722
105,93,12,-,-,36723
1665,1278,387,937,107300,36726
106,106,0,-,"10,000-",36727
272,255,17,485,45400,36728
3505,2040,1465,690,182400,36732
461,387,74,-,109000,36736
280,184,96,783,76000,36738
413,330,83,729,96300,36740
0,0,0,-,-,36741
941,795,146,674,130600,36742
2464,1662,802,716,151200,36744
1048,641,407,753,92000,36748
319,231,88,-,-,36749
1093,949,144,1004,134500,36750
192,163,29,-,-,36751
656,610,46,-,136600,36752
0,0,0,-,-,36753
84,76,8,-,-,36754
1920,1254,666,616,98400,36756
636,538,98,754,86200,36758
687,490,197,-,61100,36759
386,307,79,761,50400,36761
52,52,0,-,53800,36763
0,0,0,-,-,36764
333,317,16,-,79100,36765
6,6,0,-,-,36766
460,370,90,397,95500,36767
331,220,111,917,-,36768
844,648,196,598,75000,36769
128,116,12,-,264000,36773
570,389,181,-,111100,36775
684,517,167,-,46800,36776
883,786,97,914,60600,36782
228,173,55,1038,75800,36783
2219,1445,774,851,122200,36784
404,329,75,850,100900,36785
931,640,291,480,64300,36786
149,136,13,-,-,36790
319,259,60,-,130800,36792
245,208,37,-,99100,36793
10254,6566,3688,926,211400,36801
7441,5673,1768,802,178100,36804
20475,11498,8977,1033,346600,36830
11313,5466,5847,1018,222900,36832
0,0,0,-,-,36849
1078,876,202,671,69400,36850
0,0,0,-,-,36851
925,801,124,852,164800,36852
3554,2800,754,939,257000,36853
6237,4293,1944,1021,146300,36854
756,700,56,925,176900,36855
2774,2553,221,1054,252700,36856
211,168,43,928,143800,36858
671,507,164,532,59000,36860
1135,1023,112,696,278100,36861
2457,1774,683,642,138800,36862
4417,3162,1255,739,113100,36863
28,2,26,978,-,36865
1468,1204,264,801,107800,36866
9322,4377,4945,963,188000,36867
8999,5249,3750,895,129200,36869
7450,6024,1426,972,178100,36870
355,318,37,-,112000,36871
3910,3670,240,629,189900,36874
1562,1219,343,698,167000,36875
4363,3496,867,1072,195800,36877
1044,935,109,768,303700,36879
109,64,45,-,-,36901
1690,1195,495,718,138100,36904
708,575,133,1156,85000,36907
699,569,130,852,89500,36908
40,40,0,-,-,36910
599,563,36,960,87400,36912
25,25,0,-,-,36913
362,332,30,-,-,36915
241,184,57,376,82500,36916
668,586,82,287,96600,36919
524,458,66,511,117900,36921
232,232,0,-,88000,36922
1604,973,631,738,72600,36925
1797,1705,92,970,345200,37010
860,619,241,676,230500,37012
38239,20745,17494,1450,294000,37013
1383,1383,0,-,651400,37014
7540,5905,1635,1244,259500,37015
362,309,53,1105,198400,37016
814,643,171,1250,211000,37018
258,182,76,-,257400,37019
2009,1944,65,1364,302500,37020
2193,1877,316,1113,244000,37022
600,496,104,1250,188800,37023
2360,2177,183,880,249500,37025
944,826,118,925,183600,37026
22663,18746,3917,2141,844500,37027
230,195,35,-,153800,37028
2462,2278,184,916,362100,37029
3167,2254,913,918,226000,37030
1669,1550,119,1005,303200,37031
2049,1733,316,1075,253900,37032
3344,2445,899,935,199800,37033
3265,2752,513,1307,306200,37034
1377,1209,168,-,237300,37035
2179,2040,139,878,254900,37036
3124,2794,330,1808,351000,37037
23146,13560,9586,1177,242400,37040
32625,19587,13038,1196,220700,37042
21104,14770,6334,1208,325400,37043
2503,2226,277,"3,500+",842900,37046
937,780,157,893,236500,37047
2417,2167,250,865,382400,37048
1425,1197,228,1076,357900,37049
684,577,107,769,180500,37050
1361,1075,286,851,229700,37051
787,754,33,-,198100,37052
11185,8369,2816,1034,258200,37055
282,255,27,1259,223200,37057
2907,2412,495,744,197300,37058
588,405,183,1010,222700,37059
1183,1078,105,1368,414900,37060
1877,1425,452,642,170000,37061
4908,3984,924,1302,344600,37062
24255,18916,5339,1810,664000,37064
24461,15903,8558,1305,376100,37066
13198,6796,6402,1860,686200,37067
6978,6093,885,2091,713200,37069
13365,9081,4284,1359,340900,37072
5255,4369,886,1157,339100,37073
3204,2297,907,772,256100,37074
28028,20505,7523,1552,403400,37075
17827,9890,7937,1438,348300,37076
270,161,109,1696,265800,37078
952,798,154,730,146900,37079
3085,2596,489,1123,325600,37080
2246,1874,372,1275,358200,37082
6134,4480,1654,821,231400,37083
1980,1909,71,-,411800,37085
12551,8773,3778,1716,268700,37086
20279,14362,5917,1134,359900,37087
6989,4955,2034,1410,392800,37090
8924,6556,2368,885,230700,37091
792,531,261,941,196500,37095
2043,1501,542,732,107600,37096
864,693,171,813,135800,37097
2172,1416,756,845,202300,37098
2275,1908,367,775,208700,37101
13167,9202,3965,767,178900,37110
18621,8403,10218,1263,271100,37115
440,382,58,-,456300,37118
23699,19247,4452,1840,451800,37122
7279,5468,1811,1274,329300,37127
27607,18043,9564,1514,364100,37128
22515,15363,7152,1597,371100,37129
23165,11274,11891,1157,347100,37130
0,0,0,-,-,37132
946,809,137,840,141900,37134
7589,7144,445,2217,629100,37135
959,826,133,783,139400,37137
9456,7512,1944,1427,347500,37138
93,93,0,-,-,37140
563,471,92,1335,236300,37141
730,677,53,1259,199100,37142
1521,1367,154,1238,342300,37143
1391,1166,225,890,212000,37144
1015,882,133,885,171600,37145
2867,2540,327,1497,342800,37146
9175,6886,2289,1082,273200,37148
946,864,82,1039,308300,37149
1658,1134,524,751,148200,37150
197,169,28,-,253800,37151
1807,1580,227,944,408600,37153
13415,8378,5037,924,257700,37160
16,8,8,-,137500,37165
6220,4080,2140,768,183600,37166
22705,13703,9002,1359,330600,37167
472,353,119,1028,-,37171
11626,8066,3560,1132,282000,37172
19014,14165,4849,1724,450300,37174
379,332,47,-,107800,37175
859,794,65,914,144300,37178
5626,4858,768,2054,501500,37179
1394,1240,154,694,273800,37180
635,518,117,722,172900,37181
1259,1137,122,885,205200,37183
2707,2233,474,944,288200,37184
3627,2767,860,827,182100,37185
3622,2457,1165,970,193400,37186
3287,2560,727,952,283100,37187
6729,5229,1500,1394,305900,37188
1459,1241,218,1082,357700,37189
3528,2584,944,760,238000,37190
1460,1308,152,1117,247400,37191
826,380,446,1944,391900,37201
13207,2553,10654,1881,519600,37203
7404,4004,3400,1703,832000,37204
11685,8073,3612,1819,890000,37205
13284,6769,6515,1564,529400,37206
17318,9741,7577,1200,332500,37207
9377,3105,6272,1527,417200,37208
19536,8743,10793,1580,495500,37209
8293,2208,6085,1250,334800,37210
31731,15051,16680,1444,374200,37211
6811,2846,3965,1565,928500,37212
12,0,12,-,-,37213
14663,9088,5575,1567,315000,37214
10295,7804,2491,1870,959100,37215
8938,6408,2530,1507,404100,37216
12618,5664,6954,1313,279400,37217
6073,4315,1758,1368,295400,37218
1499,433,1066,2104,393800,37219
2277,2040,237,1468,746000,37220
18925,13316,5609,1778,432900,37221
1537,16,1521,1347,-,37228
0,0,0,-,-,37232
0,0,0,-,-,37238
533,488,45,895,130800,37301
2041,1518,523,950,371600,37302
10311,7068,3243,815,196800,37303
333,328,5,-,78500,37305
907,792,115,-,225700,37306
2010,1662,348,683,187800,37307
1130,959,171,744,238200,37308
905,748,157,904,159000,37309
1457,1161,296,848,223000,37310
11641,5355,6286,890,205800,37311
14212,10100,4112,1080,270500,37312
610,575,35,575,151600,37313
0,0,0,-,-,37315
0,0,0,-,-,37316
1101,927,174,659,117500,37317
773,481,292,715,132200,37318
7952,5577,2375,819,168000,37321
3411,2429,982,821,184800,37322
11834,9316,2518,908,213900,37323
2249,1328,921,844,207700,37324
743,665,78,-,163100,37325
217,103,114,527,105400,37326
4675,3422,1253,843,217600,37327
682,631,51,815,141600,37328
2440,1984,456,763,161800,37329
2832,2485,347,846,192000,37330
2985,2305,680,837,171000,37331
938,861,77,1192,188500,37332
238,163,75,-,114600,37333
9459,6823,2636,790,207800,37334
1157,1055,102,662,209100,37335
1869,1691,178,1089,216100,37336
538,404,134,-,164300,37337
1184,842,342,750,121900,37338
518,459,59,1059,145400,37339
132,118,14,-,-,37340
5768,4827,941,1229,264300,37341
1482,1227,255,-,223900,37342
17861,13885,3976,1258,275300,37343
1015,848,167,1087,182600,37345
3415,2745,670,798,141600,37347
434,358,76,-,278500,37348
803,747,56,1465,761600,37350
207,183,24,-,170100,37351
1257,947,310,702,252600,37352
1962,1648,314,976,221000,37353
6904,5049,1855,796,209100,37354
11270,8109,3161,908,238000,37355
952,659,293,745,278900,37356
2074,1561,513,781,167800,37357
470,356,114,928,234100,37359
736,558,178,795,241700,37360
928,803,125,745,116100,37361
1351,1243,108,717,116600,37362
15856,12000,3856,1495,349600,37363
554,510,44,552,97600,37365
391,350,41,956,160600,37366
3758,2965,793,781,170400,37367
240,208,32,-,118000,37369
1999,1669,330,721,208000,37370
1058,913,145,1072,295800,37373
649,570,79,722,239600,37374
1062,902,160,1238,323700,37375
189,61,128,-,87700,37376
6259,5382,877,1389,483800,37377
11101,8897,2204,988,277600,37379
2570,1909,661,921,185000,37380
4024,3176,848,761,208600,37381
0,0,0,-,-,37383
3044,2545,499,575,189500,37385
1546,1216,330,393,123200,37387
10884,7444,3440,856,230900,37388
621,508,113,-,185300,37391
44,42,2,-,264300,37394
48,48,0,-,-,37396
3962,3074,888,754,160700,37397
6536,5020,1516,879,225200,37398
2631,140,2491,673,460000,37402
1965,446,1519,1253,444000,37403
4849,2601,2248,999,235300,37404
8642,4205,4437,1276,416900,37405
5216,2461,2755,944,150300,37406
3038,1220,1818,891,84600,37407
1546,508,1038,1338,460000,37408
1531,882,649,1138,245900,37409
1469,334,1135,695,133800,37410
8026,4870,3156,1031,216800,37411
9488,5511,3977,1120,182600,37412
11031,6591,4440,1240,261900,37415
6202,3508,2694,1086,229600,37416
2736,2249,487,979,302800,37419
22200,13464,8736,1313,299600,37421
0,0,0,-,-,37450
16881,9158,7723,892,187000,37601
17406,8502,8904,950,231900,37604
0,0,0,-,-,37614
9221,7110,2111,966,261200,37615
2151,1654,497,786,189800,37616
5677,4687,990,841,225000,37617
5494,4311,1183,880,174000,37618
16466,11781,4685,809,175500,37620
1638,1381,257,674,154400,37640
3657,3012,645,597,184600,37641
5955,4947,1008,923,178000,37642
14435,10606,3829,733,156200,37643
2011,1780,231,804,179700,37645
5543,4113,1430,636,156000,37650
1445,1291,154,830,231900,37656
337,300,37,-,214200,37657
1604,1260,344,609,116100,37658
11838,9476,2362,1034,241700,37659
17849,11396,6453,833,177800,37660
6245,5221,1024,886,224900,37663
12642,9105,3537,817,204900,37664
1976,1420,556,937,110300,37665
267,200,67,-,367100,37680
2507,2126,381,749,169800,37681
53,53,0,-,-,37682
5024,3898,1126,628,175100,37683
3470,2704,766,1117,306300,37686
1655,1470,185,730,148000,37687
535,492,43,-,154400,37688
1889,1656,233,867,221400,37690
288,173,115,-,283000,37691
2191,1531,660,698,199500,37692
722,675,47,675,166300,37694
3901,2600,1301,1101,239600,37701
1918,1692,226,1280,310800,37705
2781,2055,726,621,161800,37708
1477,1140,337,911,238600,37709
501,418,83,671,82500,37710
2257,1915,342,760,115500,37711
516,466,50,821,136600,37713
1648,1290,358,862,192900,37714
387,314,73,500,140000,37715
10511,7873,2638,887,220500,37716
19,19,0,-,-,37719
5539,4650,889,960,218900,37721
2895,2264,631,892,175500,37722
608,504,104,645,130300,37723
1221,663,558,800,144800,37724
6854,5273,1581,932,235200,37725
770,704,66,480,166500,37726
782,699,83,1040,99900,37727
499,407,92,-,93000,37729
19,19,0,-,130200,37730
288,254,34,-,-,37731
0,0,0,-,-,37732
0,0,0,-,-,37733
2597,2160,437,1029,293900,37737
1930,1328,602,1090,275000,37738
2705,2456,249,1051,270000,37742
9498,7307,2191,729,195400,37743
8274,5960,2314,677,194400,37745
7080,5284,1796,760,173600,37748
2417,1627,790,768,163800,37752
429,286,143,620,78300,37753
1739,1468,271,995,186900,37754
1145,810,335,946,111300,37755
1336,815,521,608,96300,37756
4276,2993,1283,732,201800,37757
5266,3163,2103,844,233900,37760
1236,714,522,428,151400,37762
6883,5719,1164,811,234000,37763
4363,3317,1046,1095,226200,37764
200,154,46,-,95000,37765
7680,4715,2965,747,160500,37766
2517,1816,701,700,192600,37769
1281,1190,91,736,129900,37770
7146,5087,2059,946,236700,37771
5813,4844,969,1292,367300,37772
9263,7983,1280,929,329600,37774
5418,3868,1550,814,297200,37777
1386,1175,211,829,160500,37779
11262,8042,3220,1061,268700,37801
13486,11010,2476,1107,312800,37803
9875,7503,2372,1155,224400,37804
1277,907,370,827,176100,37806
4250,3249,1001,868,185100,37807
825,447,378,723,129400,37809
760,514,246,660,200500,37810
1699,1451,248,711,152300,37811
6801,4588,2213,813,158400,37813
14064,9026,5038,859,192200,37814
2083,1697,386,767,141800,37818
257,170,87,539,108300,37819
3025,2481,544,853,193500,37820
9349,6163,3186,789,127800,37821
3538,2456,1082,684,146500,37825
1546,1327,219,835,210900,37826
751,586,165,1072,307000,37828
634,546,88,1088,130300,37829
13480,8762,4718,1076,234500,37830
3996,3066,930,630,185100,37840
3773,2700,1073,763,147300,37841
1874,1451,423,788,164600,37843
59,59,0,-,-,37845
1485,1152,333,780,200000,37846
1116,859,257,641,109300,37847
39,39,0,-,-,37848
10800,8622,2178,1097,263600,37849
0,0,0,-,-,37851
1139,952,187,492,109400,37852
1422,972,450,811,225000,37853
4932,3395,1537,783,154600,37854
8171,6401,1770,650,164500,37857
1518,1216,302,709,182300,37860
3441,2820,621,634,202200,37861
8889,5377,3512,956,283800,37862
2457,1243,1214,933,253400,37863
9547,7980,1567,1351,276900,37865
894,819,75,544,278300,37866
1999,1355,644,578,125800,37869
1572,1334,238,671,144500,37870
3274,2573,701,803,190000,37871
707,528,179,947,120000,37872
1832,1463,369,736,140100,37873
6967,4629,2338,635,171900,37874
13577,10540,3037,997,257800,37876
3571,3014,557,978,214400,37877
300,210,90,-,295100,37878
5057,3861,1196,749,136200,37879
1723,1520,203,711,217300,37880
802,630,172,805,124000,37881
1345,1094,251,1032,292400,37882
2737,2079,658,843,287800,37885
1461,1186,275,973,207000,37886
1780,1385,395,682,149100,37887
1243,1029,214,820,130100,37888
2908,2272,636,846,204300,37890
1654,1255,399,786,157400,37891
753,595,158,668,112000,37892
1491,291,1200,1322,570700,37902
7753,3694,4059,1156,273900,37909
9903,5200,4703,1050,185600,37912
8960,6008,2952,988,204300,37914
3265,789,2476,519,206400,37915
3047,92,2955,1176,270000,37916
12417,5976,6441,1063,189100,37917
18940,12855,6085,1102,237500,37918
14131,7686,6445,1247,453000,37919
18018,10835,7183,1092,231300,37920
11518,7009,4509,1147,204300,37921
14386,12191,2195,1672,468600,37922
12992,7764,5228,1303,292500,37923
5611,4330,1281,1020,217300,37924
0,0,0,-,-,37929
12169,8634,3535,1450,317100,37931
8446,5907,2539,1516,431200,37932
10570,9077,1493,1810,473600,37934
6877,6167,710,1091,287400,37938
1694,1051,643,791,119900,38001
15152,12575,2577,1695,363000,38002
4299,3700,599,1282,283200,38004
2011,1360,651,893,161300,38006
0,0,0,-,-,38007
3811,2536,1275,841,123700,38008
3581,2809,772,977,203800,38011
5375,2784,2591,727,129800,38012
932,755,177,859,177600,38015
18365,10851,7514,1407,261700,38016
19969,15928,4041,1489,469600,38017
14215,8919,5296,1594,255300,38018
5969,3765,2204,912,195400,38019
3,3,0,-,-,38021
1940,1575,365,1161,229500,38023
10507,6311,4196,757,171100,38024
2709,2547,162,1258,461700,38028
18,18,0,-,-,38029
117,50,67,1261,171400,38030
1310,1086,224,738,131800,38034
31,15,16,825,187500,38036
608,401,207,595,89000,38037
549,416,133,824,135300,38039
2084,1156,928,735,107600,38040
1017,745,272,701,90400,38041
277,215,62,1005,144300,38042
302,240,62,838,225000,38044
6,6,0,-,366700,38046
42,0,42,-,-,38047
1599,1091,508,1060,149500,38049
221,155,66,845,93600,38050
1495,1158,337,774,129800,38052
9724,6431,3293,1105,195100,38053
0,0,0,-,-,38054
1395,1070,325,887,298000,38057
3852,3303,549,1085,224800,38058
3333,2261,1072,804,146400,38059
4903,4237,666,1478,293500,38060
353,275,78,-,127700,38061
6072,3851,2221,731,137600,38063
1450,1304,146,818,323500,38066
763,673,90,680,118200,38067
3920,2750,1170,775,258300,38068
1162,841,321,794,115500,38069
80,72,8,-,185000,38070
1454,943,511,910,110800,38075
339,295,44,1023,249400,38076
0,0,0,-,-,38077
1186,580,606,438,153400,38079
957,391,566,613,80200,38080
8020,2473,5547,1575,380900,38103
12946,5095,7851,1073,301100,38104
3241,438,2803,928,75400,38105
9126,3325,5801,915,66400,38106
6659,2560,4099,999,128600,38107
6569,3094,3475,921,62600,38108
16706,9089,7617,1000,76600,38109
17866,8160,9706,1077,165200,38111
6554,3460,3094,969,206900,38112
0,0,0,-,-,38113
9614,4438,5176,897,79000,38114
16067,3694,12373,1129,129700,38115
15388,6765,8623,1035,125800,38116
11393,8686,2707,1353,287500,38117
13261,5017,8244,1105,95700,38118
9792,5897,3895,1336,279100,38119
6230,4566,1664,1552,421500,38120
9305,4531,4774,1127,108200,38122
15549,8081,7468,1440,230400,38125
2698,421,2277,794,59000,38126
14183,6475,7708,1104,82500,38127
16131,6777,9354,1150,123900,38128
0,0,0,-,-,38131
0,0,0,-,-,38132
8047,5626,2421,1449,234800,38133
14698,7198,7500,1147,184400,38134
10925,8836,2089,1580,270100,38135
10232,8157,2075,1716,393600,38138
5780,5598,182,2359,540600,38139
8030,4880,3150,1389,146100,38141
0,0,0,-,-,38152
3723,2595,1128,669,155900,38201
749,648,101,768,92400,38220
1421,982,439,661,118600,38221
815,778,37,-,165300,38222
311,258,53,-,137800,38224
2566,1831,735,738,111800,38225
123,123,0,-,86000,38226
1021,804,217,641,144700,38229
1553,1252,301,734,95600,38230
750,550,200,719,86800,38231
989,794,195,758,81100,38232
1085,783,302,673,90900,38233
88,56,32,906,106800,38235
441,310,131,-,119600,38236
5927,3262,2665,808,194100,38237
840,548,292,929,98900,38240
316,245,71,584,105600,38241
7905,5459,2446,759,157400,38242
1348,1202,146,639,124800,38251
355,266,89,838,192600,38253
0,0,0,-,-,38254
1046,776,270,616,105200,38255
1479,1267,212,-,151100,38256
1822,1337,485,776,116500,38257
557,457,100,689,92800,38258
279,235,44,773,100700,38259
1644,1297,347,780,117100,38260
6431,3889,2542,759,141900,38261
13421,6687,6734,958,119400,38301
21347,13910,7437,1201,221200,38305
2297,1846,451,710,165800,38310
402,371,31,-,178200,38311
1473,1321,152,-,200400,38313
1505,1276,229,756,129400,38315
1202,974,228,699,117200,38316
1188,944,244,669,113800,38317
224,186,38,1067,127100,38318
4363,3194,1169,816,124600,38320
1039,868,171,654,125000,38321
1359,1222,137,958,189100,38326
302,234,68,850,136800,38327
360,360,0,-,141800,38328
1229,979,250,756,141400,38329
1462,1019,443,789,118700,38330
534,488,46,629,157400,38332
142,106,36,-,-,38333
593,515,78,656,130300,38334
533,354,179,835,191300,38337
26,21,5,-,-,38338
173,130,43,780,120700,38339
4221,3084,1137,741,142000,38340
1099,987,112,664,124300,38341
537,392,145,560,108200,38342
6457,4103,2354,768,164200,38343
3445,2473,972,876,133300,38344
475,332,143,922,224600,38345
155,155,0,-,190100,38347
426,336,90,689,97700,38348
6911,4652,2259,809,159000,38351
273,175,98,-,-,38352
3174,2648,526,1166,263800,38355
1034,745,289,644,156400,38356
1133,1003,130,782,166100,38357
4552,2889,1663,808,157900,38358
132,123,9,-,87000,38359
476,415,61,-,140600,38361
422,309,113,1152,143300,38362
2166,1438,728,720,105700,38363
0,0,0,-,-,38365
974,823,151,908,122000,38366
1070,845,225,950,156600,38367
965,783,182,609,186900,38368
714,589,125,718,104400,38369
429,368,61,725,119200,38370
411,337,74,819,118300,38371
6820,4959,1861,759,153600,38372
835,582,253,660,148400,38374
3443,2571,872,677,143500,38375
131,106,25,-,-,38376
600,448,152,908,169300,38379
183,177,6,-,144300,38380
558,433,125,787,113000,38381
3571,2212,1359,789,114600,38382
180,149,31,-,163400,38387
551,444,107,676,172900,38388
16,14,2,-,78600,38389
423,358,65,933,120900,38390
496,398,98,1188,97500,38391
250,215,35,-,43400,38392
25964,18640,7324,1084,295200,38401
711,516,195,731,113100,38425
1295,1036,259,1022,219400,38449
1159,901,258,623,80300,38450
1624,1489,135,1121,268800,38451
419,395,24,-,141000,38452
157,120,37,-,789500,38453
374,302,72,-,120700,38454
29,27,2,-,212500,38455
1418,1239,179,-,202500,38456
174,121,53,-,172900,38457
176,156,20,-,252000,38459
720,692,28,744,177100,38460
491,450,41,-,344300,38461
4198,3430,768,804,151900,38462
986,949,37,597,135800,38463
9470,6745,2725,750,164900,38464
1959,1564,395,1060,194600,38468
1663,1443,220,680,161900,38469
87,87,0,-,-,38471
974,809,165,735,288000,38472
376,296,80,1046,216300,38473
3347,2499,848,793,228200,38474
237,229,8,-,118900,38475
299,272,27,-,-,38476
1037,910,127,911,204300,38477
7269,4876,2393,829,195500,38478
372,309,63,625,122400,38481
692,639,53,-,305200,38482
2277,1728,549,747,205800,38483
2466,1917,549,578,129700,38485
541,382,159,-,127500,38486
323,291,32,-,330700,38487
924,806,118,635,244400,38488
17453,8616,8837,856,245100,38501
0,0,0,-,-,38503
263,263,0,-,-,38504
0,0,0,-,-,38505
12370,8804,3566,1032,256100,38506
742,591,151,1020,200400,38541
0,0,0,-,-,38542
149,125,24,-,186000,38543
2831,2230,601,904,222500,38544
644,475,169,851,104600,38545
703,690,13,-,228700,38547
419,391,28,833,213100,38548
1647,1298,349,760,166700,38549
0,0,0,-,-,38550
1758,1213,545,528,121900,38551
109,73,36,561,206300,38552
1030,944,86,960,164400,38553
324,252,72,-,135000,38554
9224,6114,3110,794,221400,38555
5329,3938,1391,587,147300,38556
4796,4302,494,1365,319900,38558
448,344,104,932,148100,38559
431,295,136,783,202700,38560
2658,2181,477,705,129600,38562
845,618,227,839,232400,38563
227,199,28,-,206100,38564
413,395,18,-,-,38565
386,280,106,624,330300,38567
762,643,119,-,188500,38568
125,102,23,-,334800,38569
4081,3086,995,792,155100,38570
5946,4972,974,836,208800,38571
5133,4709,424,853,194900,38572
856,715,141,832,147400,38573
3326,2730,596,800,175900,38574
395,336,59,-,152700,38575
471,461,10,-,109400,38577
72,45,27,754,163200,38578
605,553,52,929,219500,38579
635,512,123,966,204400,38580
1738,1486,252,849,161500,38581
744,701,43,612,242000,38582
10059,7760,2299,851,199400,38583
1701,1366,335,705,137500,38585
582,521,61,-,202600,38587
419,322,97,656,169800,38588
168,164,4,-,-,38589
825,650,175,750,219800,38601
1129,1028,101,543,127800,38603
5469,4075,1394,912,147500,38606
988,755,233,877,98800,38610
6192,4713,1479,1185,206500,38611
6519,3266,3253,762,91000,38614
360,139,221,251,65300,38617
4364,3478,886,1032,139600,38618
1910,1080,830,-,127700,38619
1242,1029,213,937,105600,38620
601,344,257,850,89500,38621
258,169,89,429,51800,38622
90,45,45,-,-,38623
601,334,267,-,153000,38625
462,391,71,1029,149700,38626
593,563,30,-,137500,38627
577,504,73,700,119300,38629
465,215,250,430,72800,38631
11287,9968,1319,1203,287100,38632
963,628,335,728,108800,38633
5359,4273,1086,793,158800,38635
9913,5881,4032,1293,158900,38637
196,117,79,608,56800,38639
884,823,61,-,217500,38641
732,613,119,639,116200,38642
642,310,332,604,69000,38643
33,22,11,-,75000,38644
357,234,123,619,88400,38645
1115,780,335,597,90800,38646
358,250,108,-,74200,38647
1555,1123,432,748,181100,38650
3166,2898,268,705,288900,38651
5829,4142,1687,918,162400,38652
20757,17668,3089,1570,284400,38654
16301,9824,6477,1100,275500,38655
989,687,302,960,128800,38658
874,670,204,861,83200,38659
764,686,78,-,210300,38661
4460,3495,965,685,137600,38663
1151,129,1022,1029,168200,38664
1243,788,455,877,169000,38665
2612,1680,932,732,86600,38666
5062,3453,1609,872,222800,38668
508,408,100,730,53100,38670
14200,8932,5268,1319,176300,38671
5503,4978,525,2197,290600,38672
455,436,19,-,259800,38673
468,404,64,-,86800,38674
2013,936,1077,869,183500,38676
0,0,0,-,-,38677
2630,1802,828,1206,192900,38680
1449,1058,391,563,113100,38683
493,460,33,-,-,38685
8637,4654,3983,790,118200,38701
4226,2254,1972,869,77500,38703
258,206,52,-,62500,38720
411,281,130,604,78600,38721
83,49,34,437,77500,38722
0,0,0,-,-,38723
327,249,78,495,74600,38725
149,116,33,705,81300,38726
622,463,159,1025,86300,38730
0,0,0,-,-,38731
6540,3921,2619,776,163000,38732
0,0,0,-,-,38733
126,116,10,867,129200,38736
1167,509,658,653,81500,38737
29,14,15,-,-,38738
166,148,18,780,-,38740
235,186,49,-,101400,38744
47,33,14,-,-,38745
197,86,111,369,70000,38746
1052,642,410,683,88300,38748
3795,2102,1693,760,126200,38751
512,311,201,585,134300,38753
563,344,219,663,87700,38754
2750,1810,940,668,109700,38756
589,458,131,634,146200,38759
330,222,108,652,79500,38760
603,435,168,775,59400,38761
806,340,466,572,78800,38762
112,79,33,389,85600,38764
71,24,47,-,-,38765
24,24,0,-,-,38767
24,14,10,-,-,38768
744,379,365,343,74400,38769
852,441,411,651,96100,38771
40,40,0,-,184600,38772
1074,768,306,542,97100,38773
761,463,298,654,82400,38774
0,0,0,-,-,38776
518,238,280,431,84600,38778
88,33,55,351,133800,38781
11550,7042,4508,954,187600,38801
6856,4349,2507,858,201600,38804
4926,3740,1186,757,157600,38821
3003,2446,557,598,94300,38824
2647,1878,769,953,205100,38826
1406,940,466,759,147600,38827
1448,1169,279,894,144500,38828
6828,5379,1449,629,121800,38829
1013,769,244,752,133900,38833
11561,7193,4368,730,139300,38834
374,374,0,-,80600,38838
26,18,8,-,102500,38839
1348,949,399,841,180600,38841
4429,3352,1077,816,141800,38843
90,87,3,-,-,38844
855,726,129,676,123100,38846
1442,1178,264,770,88500,38847
288,288,0,-,185700,38848
2000,1632,368,938,147000,38849
1246,1007,239,690,78500,38850
3323,2354,969,758,119300,38851
4286,3374,912,568,133200,38852
2130,1708,422,854,133600,38855
608,528,80,-,112100,38856
1372,1081,291,1025,184200,38857
2201,1652,549,893,109200,38858
201,190,11,-,133200,38859
2313,1466,847,651,101100,38860
808,563,245,841,136900,38862
7050,4763,2287,882,138900,38863
565,489,76,-,205000,38864
1773,1412,361,805,85100,38865
4512,3842,670,870,216300,38866
1890,1422,468,850,138600,38868
110,63,47,686,142500,38869
1075,962,113,760,120800,38870
898,761,137,847,96500,38871
1175,986,189,559,98800,38873
485,431,54,766,121300,38876
1107,883,224,589,78400,38878
25,25,0,-,108000,38879
7363,4461,2902,811,139400,38901
177,142,35,-,155000,38913
212,166,46,781,73300,38914
1602,1084,518,648,86600,38915
1895,1308,587,658,80800,38916
1311,905,406,-,97800,38917
304,247,57,-,63500,38920
1737,1107,630,628,101700,38921
1279,909,370,692,85500,38922
369,344,25,-,117700,38923
185,119,66,933,70200,38924
774,658,116,595,111300,38925
398,398,0,-,57100,38927
89,31,58,728,-,38928
807,572,235,871,99100,38929
8632,4931,3701,694,108000,38930
604,489,115,-,102800,38940
1253,484,769,650,84200,38941
265,232,33,-,-,38943
85,40,45,-,56200,38944
66,43,23,917,102500,38946
28,28,0,-,222200,38947
886,634,252,949,66400,38948
98,98,0,-,231700,38949
248,248,0,-,70300,38950
421,338,83,942,56100,38951
155,118,37,577,-,38952
195,195,0,-,95300,38953
308,217,91,875,75500,38954
153,67,86,667,159700,38957
197,186,11,-,105800,38961
13,13,0,-,-,38962
984,448,536,920,71100,38963
25,8,17,-,-,38964
3446,2545,901,655,121500,38965
300,222,78,646,85000,38966
2682,1837,845,676,124700,38967
2022,1143,879,632,84600,39038
1013,869,144,993,150600,39039
1435,939,496,935,200400,39040
1386,1046,340,705,167000,39041
13787,11743,2044,1045,249200,39042
1059,951,108,909,141600,39044
542,496,46,888,-,39045
11689,6846,4843,879,210900,39046
15675,13350,2325,1491,265300,39047
5401,4138,1263,691,113000,39051
112,73,39,-,51700,39054
10369,7208,3161,1135,220700,39056
759,746,13,-,153200,39057
0,0,0,-,-,39058
4446,3380,1066,690,117700,39059
0,0,0,-,-,39061
162,109,53,740,90900,39062
1044,662,382,493,59600,39063
1800,1528,272,774,142900,39066
400,351,49,1073,94500,39067
1276,863,413,440,74400,39069
2517,1795,722,624,268800,39071
7748,6635,1113,886,180900,39073
5030,3384,1646,795,114700,39074
342,236,106,368,182400,39078
367,122,245,372,99000,39079
490,443,47,-,-,39082
3168,2133,1035,562,87200,39083
501,308,193,-,38600,39086
10,10,0,-,-,39088
4434,3086,1348,774,114000,39090
1215,1080,135,449,-,39092
1617,1352,265,801,100300,39094
2443,1584,859,604,93400,39095
498,448,50,1083,92200,39096
264,159,105,907,114100,39097
786,679,107,745,71900,39108
17357,16205,1152,1979,342600,39110
3293,2319,974,794,119200,39111
125,48,77,247,75000,39113
3786,3199,587,846,116100,39114
43,43,0,-,55800,39115
780,675,105,894,149800,39116
3278,2435,843,957,103900,39117
2109,1655,454,657,90200,39119
11701,7799,3902,720,106500,39120
925,841,84,911,106500,39140
242,224,18,-,64200,39144
2092,1818,274,863,172200,39145
1172,821,351,910,71200,39146
0,0,0,-,-,39148
468,402,66,-,91900,39149
1985,1492,493,629,85300,39150
232,209,23,-,-,39152
1037,874,163,578,103700,39153
3201,2857,344,883,217200,39154
327,291,36,-,55100,39156
10621,5083,5538,1205,259900,39157
888,568,320,609,143800,39159
1061,911,150,640,84600,39160
78,76,2,-,180000,39162
147,100,47,436,117700,39166
0,0,0,-,-,39167
2363,1943,420,701,97400,39168
1046,520,526,574,48800,39169
3490,3043,447,972,235700,39170
0,0,0,-,-,39173
0,0,0,-,-,39174
1509,1289,220,1060,97900,39175
952,749,203,383,88800,39176
55,42,13,-,158600,39177
484,360,124,978,-,39179
11532,8117,3415,917,144900,39180
4957,3566,1391,852,157800,39183
1115,782,333,876,88900,39189
2649,2150,499,897,118700,39191
537,473,64,-,79200,39192
6,0,6,-,-,39193
5763,2628,3135,789,108400,39194
642,13,629,1341,-,39201
3595,1126,2469,876,211300,39202
1891,638,1253,739,53000,39203
5672,1818,3854,890,68200,39204
9798,4616,5182,1084,117400,39206
13070,8127,4943,1157,173900,39208
10187,4797,5390,969,74600,39209
9,9,0,-,-,39210
10243,6551,3692,1273,198300,39211
10531,6618,3913,1128,105500,39212
8245,3846,4399,773,73600,39213
1573,608,965,1128,249600,39216
63,0,63,-,-,39217
2744,1993,751,1146,135100,39218
3954,2146,1808,1412,293000,39232
0,0,0,-,-,39269
5670,4469,1201,1339,175900,39272
8828,5240,3588,888,105800,39301
8728,5793,2935,1016,185600,39305
6120,3244,2876,814,79600,39307
0,0,0,-,-,39309
593,531,62,-,185800,39320
858,774,84,-,58300,39322
479,398,81,1379,80500,39323
0,0,0,-,-,39324
2239,2016,223,988,181400,39325
131,131,0,-,53200,39326
1607,1246,361,828,137800,39327
1978,1506,472,412,78900,39328
1078,939,139,863,121000,39330
620,454,166,870,107400,39332
982,712,270,1128,141300,39335
466,392,74,732,57000,39336
702,605,97,-,94800,39337
1484,1384,100,130,59400,39338
5812,3918,1894,634,129800,39339
2543,1914,629,595,88900,39341
579,327,252,1091,189800,39342
2244,1550,694,715,84600,39345
842,645,197,839,91900,39346
523,454,69,380,205300,39347
107,107,0,-,55000,39348
8382,6312,2070,740,96900,39350
127,79,48,-,84700,39352
611,552,59,-,88000,39354
2804,2332,472,870,124700,39355
379,226,153,-,169000,39356
265,168,97,-,-,39358
76,42,34,813,100000,39359
1396,1215,181,752,54100,39360
470,415,55,414,54800,39361
1021,876,145,-,58100,39362
562,411,151,905,86500,39363
1147,909,238,735,176900,39364
2835,2158,677,703,97400,39365
527,505,22,-,82900,39366
5219,4531,688,762,89800,39367
17545,7471,10074,932,120100,39401
17392,10233,7159,1183,255400,39402
0,0,0,-,-,39406
1045,989,56,704,108600,39421
1804,1464,340,615,98000,39422
1221,1116,105,338,93500,39423
752,723,29,530,192100,39425
6926,6310,616,848,202200,39426
402,365,37,-,-,39427
3418,2620,798,642,99500,39428
6230,4733,1497,585,133700,39429
4274,3326,948,780,173900,39437
1921,1658,263,844,115100,39439
7668,4425,3243,856,112300,39440
8550,6873,1677,742,142200,39443
1491,1075,416,836,111300,39451
10821,9101,1720,867,166600,39452
3503,3013,490,749,102700,39455
265,246,19,654,128300,39456
1490,1242,248,504,152200,39459
136,53,83,-,-,39461
473,381,92,-,165600,39462
1057,846,211,777,122700,39464
7918,6218,1700,921,166300,39465
10875,8242,2633,907,161400,39466
4465,3833,632,888,166600,39470
2425,1770,655,714,86500,39474
5500,4392,1108,933,192300,39475
2307,1871,436,627,134400,39476
227,199,28,838,102200,39477
829,709,120,1105,112000,39478
2319,1773,546,546,115200,39479
742,631,111,845,159100,39480
497,394,103,1113,182200,39481
4367,3785,582,853,193900,39482
1881,1532,349,920,83500,39483
8784,3416,5368,962,115300,39501
20595,14048,6547,1087,193000,39503
7580,3926,3654,1121,220600,39507
7002,5147,1855,1067,202600,39520
4205,3753,452,1571,236700,39525
0,0,0,-,-,39529
3636,1936,1700,821,149600,39530
7880,2969,4911,1066,193700,39531
14129,8821,5308,1098,227400,39532
0,0,0,-,-,39534
5049,2828,2221,1177,199000,39540
6544,4791,1753,1070,154900,39553
2691,2422,269,1125,140600,39556
7325,4974,2351,1196,210800,39560
738,649,89,-,186700,39561
7000,5827,1173,976,158100,39562
4788,3614,1174,1039,107800,39563
18125,12902,5223,1314,220000,39564
7182,6414,768,1112,204500,39565
4067,2617,1450,917,136500,39567
5521,4590,931,1004,233000,39571
497,462,35,-,108100,39572
3336,2869,467,740,201100,39573
4530,3862,668,942,191500,39574
2907,1758,1149,722,216200,39576
3976,2946,1030,858,112800,39577
4616,1874,2742,892,125000,39581
0,0,0,-,-,39595
8843,6232,2611,772,121000,39601
2459,1932,527,800,138400,39629
325,192,133,825,79600,39630
1693,1274,419,540,58200,39631
250,179,71,428,48300,39633
0,0,0,-,-,39635
1618,1320,298,574,85000,39638
2225,1841,384,931,120000,39641
479,419,60,-,110100,39643
1881,1592,289,773,94800,39645
248,227,21,-,155800,39647
7857,4328,3529,870,107700,39648
3569,2893,676,685,83900,39652
1135,874,261,412,96500,39653
1718,1312,406,711,108800,39654
246,220,26,-,157100,39656
759,571,188,826,84100,39657
875,735,140,1091,81100,39661
562,479,83,1284,84800,39662
928,759,169,834,95900,39663
998,853,145,773,100000,39664
445,355,90,-,52400,39665
4021,3269,752,855,155400,39666
4189,3222,967,664,124700,39667
525,486,39,-,110900,39668
1968,1707,261,1047,91100,39669
5437,2514,2923,849,121400,39701
8586,5733,2853,868,142900,39702
5240,3298,1942,1046,225900,39705
4654,3366,1288,651,84000,39730
1493,1050,443,727,138500,39735
164,89,75,393,113700,39736
155,94,61,-,167900,39737
792,559,233,910,75800,39739
1978,1556,422,743,154500,39740
582,461,121,628,96900,39741
829,706,123,1078,95700,39743
2188,1725,463,538,101600,39744
297,215,82,589,114700,39745
1190,901,289,761,97500,39746
637,490,147,670,90400,39747
1619,1230,389,615,85800,39750
663,556,107,611,97400,39751
930,719,211,822,113700,39752
0,0,0,-,-,39753
329,268,61,-,126500,39755
547,540,7,-,73300,39756
19623,8882,10741,879,241100,39759
0,0,0,-,-,39762
1072,748,324,1050,129100,39766
276,236,40,-,-,39767
593,458,135,736,159400,39769
60,47,13,833,107500,39771
926,874,52,523,85800,39772
6220,4202,2018,727,128300,39773
599,378,221,868,73200,39776
800,522,278,765,114300,39813
548,433,115,912,58300,39815
3765,2289,1476,833,145700,39817
4755,2727,2028,871,168500,39819
3222,2186,1036,783,136700,39823
247,213,34,575,57100,39824
694,458,236,1128,142900,39825
248,171,77,675,95000,39826
1864,1176,688,944,159100,39827
5692,3295,2397,746,129600,39828
0,0,0,-,-,39832
633,502,131,684,150000,39834
136,113,23,-,-,39836
2463,1658,805,695,118800,39837
1958,861,1097,492,89800,39840
333,315,18,-,80900,39841
2862,1499,1363,728,108800,39842
3306,2405,901,830,108400,39845
638,344,294,525,78800,39846
833,595,238,581,98500,39851
1020,848,172,734,101800,39854
395,324,71,540,144700,39859
421,334,87,795,159400,39861
384,342,42,822,112000,39862
177,117,60,-,90200,39866
56,29,27,-,101800,39867
734,497,237,618,112500,39870
150,127,23,700,101500,39877
12,12,0,-,-,39885
467,296,171,675,96200,39886
1485,1121,364,698,123200,39897
799,695,104,1125,330600,40003
12425,8974,3451,946,224600,40004
1857,1609,248,695,183700,40006
25,25,0,-,237500,40007
1551,1305,246,970,228800,40008
620,558,62,679,58200,40009
201,161,40,1524,486400,40010
842,641,201,825,157000,40011
275,229,46,910,208500,40012
2482,2379,103,1086,241500,40013
7800,6958,842,1117,381500,40014
1671,1117,554,794,202200,40019
128,115,13,-,-,40020
292,243,49,-,376200,40022
2281,2214,67,1199,430200,40023
249,232,17,-,1201900,40025
1987,1834,153,2022,425600,40026
8141,6659,1482,1120,316300,40031
4723,3271,1452,733,160000,40033
81,73,8,-,57900,40036
1105,1049,56,726,212100,40037
294,245,49,1333,143900,40040
263,44,219,999,592900,40041
1260,1035,225,944,146400,40045
469,455,14,-,215400,40046
8561,7601,960,935,259600,40047
0,0,0,-,-,40049
747,582,165,707,132700,40050
1684,1396,288,768,177100,40051
203,175,28,-,130900,40052
891,751,140,1096,193900,40055
1143,1062,81,1479,319400,40056
1595,1230,365,1250,179300,40057
7,7,0,-,-,40058
7930,6992,938,1844,533800,40059
509,440,69,629,163500,40060
0,0,0,-,-,40061
76,49,27,1322,113000,40062
0,0,0,-,-,40063
11962,8249,3713,1002,254200,40065
2297,1919,378,813,336100,40067
991,844,147,1030,291000,40068
3198,2428,770,665,172800,40069
169,92,77,975,188300,40070
5831,4954,877,941,297900,40071
403,365,38,-,167900,40075
1045,845,200,786,222200,40076
258,175,83,862,197700,40077
881,728,153,1057,161600,40078
402,382,20,-,122900,40104
850,636,214,936,192800,40107
4773,3660,1113,836,216200,40108
918,821,97,-,239900,40109
180,101,79,-,167800,40110
718,529,189,329,117100,40111
277,248,29,-,157100,40115
793,717,76,881,165600,40117
4015,2690,1325,1020,140900,40118
818,747,71,-,154600,40119
2202,16,2186,1234,-,40121
294,262,32,-,156800,40140
816,577,239,984,144600,40142
2261,1706,555,721,133500,40143
681,622,59,-,204200,40144
285,234,51,-,77900,40145
1323,1001,322,766,144000,40146
1901,1581,320,813,166400,40150
331,331,0,-,171300,40152
442,207,235,909,77300,40155
339,305,34,-,306600,40157
9060,4761,4299,889,161500,40160
118,84,34,-,344000,40161
2046,1876,170,731,243500,40162
14529,11906,2623,939,242700,40165
106,84,22,-,325000,40170
133,92,41,-,83200,40171
5843,4427,1416,1258,205500,40175
404,347,57,-,117900,40176
668,489,179,741,120700,40177
169,169,0,-,103800,40178
3282,270,3012,881,340000,40202
8965,2216,6749,828,179300,40203
7679,3944,3735,1225,314700,40204
10287,7611,2676,1095,361900,40205
10639,5421,5218,1142,276100,40206
13638,9436,4202,1248,401500,40207
5442,1503,3939,914,153100,40208
296,155,141,1083,128200,40209
5693,2343,3350,822,93400,40210
9055,3755,5300,925,97900,40211
6451,3211,3240,917,78100,40212
7260,4735,2525,952,169000,40213
18527,10088,8439,950,176700,40214
7890,3331,4559,976,106500,40215
17892,11729,6163,883,154500,40216
6315,3748,2567,1150,220700,40217
13787,7060,6727,1059,195600,40218
15917,8124,7793,967,186000,40219
15273,9737,5536,1187,249700,40220
0,0,0,-,-,40221
10188,5701,4487,1326,347000,40222
9920,7171,2749,1431,343600,40223
7341,5861,1480,1370,220200,40228
15297,11250,4047,1294,197300,40229
0,0,0,-,-,40231
13165,9295,3870,1433,349200,40241
4805,3322,1483,1239,293200,40242
5708,3667,2041,1260,297900,40243
14652,11578,3074,1605,432900,40245
10539,7612,2927,1146,173100,40258
14401,10619,3782,1147,169700,40272
5,0,5,-,-,40280
16512,12502,4010,1161,264700,40291
16955,12507,4448,1290,274900,40299
210,137,73,946,122700,40310
2776,1974,802,642,124700,40311
2278,1509,769,710,148300,40312
1119,705,414,954,116200,40313
152,96,56,-,105100,40316
1291,896,395,634,119000,40322
19524,13612,5912,1188,262700,40324
415,383,32,668,83200,40328
8417,6461,1956,780,187000,40330
0,0,0,-,-,40334
5271,3816,1455,672,114500,40336
1855,1457,398,802,116800,40337
48,43,5,-,109000,40339
9329,7235,2094,870,212600,40342
239,200,39,-,164800,40346
1386,1044,342,1011,318400,40347
308,126,182,653,127400,40348
15,15,0,-,-,40350
8459,5312,3147,775,163000,40351
9003,5724,3279,794,179600,40353
139,102,37,-,217000,40355
16992,12004,4988,1020,246300,40356
40,9,31,838,95000,40357
495,411,84,605,142800,40358
2715,2340,375,656,164300,40359
2772,1853,919,586,108500,40360
7281,4749,2532,793,216700,40361
5,5,0,-,-,40363
1086,939,147,998,274100,40370
947,801,146,698,110800,40371
834,738,96,691,234400,40372
795,597,198,617,107500,40374
11,11,0,-,-,40376
1656,1433,223,927,223700,40379
2372,1716,656,768,133700,40380
9705,6950,2755,998,279400,40383
920,741,179,675,176000,40385
713,550,163,621,98900,40387
2288,1324,964,833,219000,40390
14815,10585,4230,884,197200,40391
860,705,155,829,89300,40402
10141,7118,3023,827,180800,40403
0,0,0,-,-,40404
1444,1005,439,687,115700,40409
1747,1389,358,670,136200,40419
9757,6373,3384,774,214300,40422
16,16,0,-,-,40434
1883,1615,268,751,123500,40437
975,820,155,730,126000,40440
315,272,43,-,107400,40442
5550,4431,1119,785,194100,40444
265,218,47,474,85700,40445
3064,2305,759,705,102000,40447
0,0,0,-,-,40448
3542,2589,953,678,140600,40456
410,376,34,-,80000,40460
959,759,200,788,190700,40461
356,322,34,-,135700,40464
803,691,112,850,148600,40468
613,437,176,843,96000,40472
26046,15404,10642,863,232700,40475
89,67,22,-,128400,40481
5132,3812,1320,688,154200,40484
1035,932,103,-,121900,40486
1536,1368,168,691,117500,40489
13080,7510,5570,1068,483600,40502
12587,7751,4836,1110,280000,40503
12158,4066,8092,888,209400,40504
10936,6581,4355,914,166300,40505
1627,351,1276,642,391000,40507
9980,2864,7116,900,174900,40508
18775,11613,7162,1317,338200,40509
426,306,120,-,725000,40510
14015,8632,5383,1159,233400,40511
4509,3375,1134,1413,448100,40513
6477,4653,1824,1549,289900,40514
15248,9174,6074,1234,317400,40515
1101,903,198,1166,249800,40516
17170,6326,10844,1092,196300,40517
0,0,0,-,-,40526
0,0,0,-,-,40536
22685,14649,8036,944,199900,40601
12024,7957,4067,733,162500,40701
2242,1843,399,713,95400,40729
1389,1086,303,674,112400,40734
550,476,74,770,134900,40737
1327,844,483,773,124200,40740
9044,6413,2631,825,155600,40741
7388,5402,1986,772,157000,40744
1115,868,247,719,85300,40759
147,117,30,-,51500,40763
6227,3897,2330,729,94100,40769
643,281,362,100-,80200,40771
0,0,0,-,-,40801
29,29,0,-,-,40803
775,584,191,696,111600,40806
234,215,19,723,55500,40807
5,5,0,-,-,40808
554,475,79,491,63600,40810
140,89,51,475,162500,40813
389,327,62,-,65900,40815
0,0,0,-,-,40816
46,41,5,-,-,40818
294,263,31,-,91600,40819
36,36,0,-,22000,40820
1453,835,618,637,75800,40823
223,117,106,599,44800,40824
232,198,34,-,43300,40826
385,236,149,-,84800,40827
1577,1207,370,821,53500,40828
24,12,12,-,-,40829
99,99,0,-,52100,40830
2083,1182,901,567,106500,40831
175,175,0,-,71500,40840
21,21,0,-,-,40843
45,45,0,-,-,40844
235,113,122,830,98600,40845
65,47,18,-,-,40847
9,3,6,-,-,40849
382,211,171,640,74500,40854
303,198,105,775,55700,40855
359,274,85,-,81900,40856
68,68,0,-,-,40858
210,132,78,654,85600,40862
271,223,48,-,52500,40863
159,159,0,-,69000,40865
384,314,70,-,88800,40868
260,229,31,648,128800,40870
924,701,223,863,87400,40873
28,19,9,-,-,40874
248,136,112,338,-,40902
297,238,59,-,50000,40903
4009,2496,1513,660,120900,40906
119,52,67,100-,-,40913
316,216,100,-,45300,40914
272,110,162,445,"10,000-",40915
47,26,21,-,45800,40921
316,220,96,682,130700,40923
291,239,52,618,63100,40927
798,526,272,681,50900,40935
75,75,0,-,-,40939
153,123,30,-,45000,40940
53,25,28,-,-,40941
272,204,68,-,99800,40943
10,10,0,-,-,40946
154,127,27,-,136200,40949
211,164,47,-,82400,40953
185,138,47,-,-,40958
6251,4906,1345,713,95100,40962
66,37,29,588,-,40964
4973,2833,2140,664,84500,40965
501,403,98,-,53300,40972
3048,1942,1106,500,83700,40977
0,0,0,-,-,40979
0,0,0,-,-,40981
127,94,33,-,137100,40982
66,59,7,-,-,40983
145,145,0,-,59700,40988
35,35,0,-,-,40995
152,117,35,-,47700,40997
7067,6411,656,1113,265100,41001
1023,699,324,702,118100,41002
1001,765,236,661,144200,41003
1511,1241,270,776,108100,41004
9028,7012,2016,1408,243900,41005
1502,1126,376,705,187600,41006
1536,1484,52,1024,295500,41007
2764,1544,1220,848,142000,41008
1328,1128,200,638,177100,41010
12576,5836,6740,1011,269400,41011
3144,1640,1504,979,149400,41014
8295,5991,2304,857,176500,41015
2602,1838,764,1034,151300,41016
15759,12317,3442,985,278100,41017
11342,7443,3899,1044,173700,41018
2102,1505,597,868,241700,41030
6383,4476,1907,765,193900,41031
635,563,72,774,220300,41033
404,385,19,556,82100,41034
4296,3118,1178,864,185300,41035
1087,870,217,556,116000,41039
2847,2036,811,862,142900,41040
3058,2085,973,653,114400,41041
22751,15368,7383,1240,210500,41042
579,527,52,852,214700,41043
398,287,111,995,119400,41044
498,380,118,873,170600,41045
536,419,117,1082,194800,41046
5459,4726,733,1350,306800,41048
879,741,138,731,138500,41049
11335,9793,1542,1219,241600,41051
117,101,16,-,145800,41052
663,545,118,809,211500,41055
5813,3754,2059,716,158700,41056
1270,1034,236,709,212400,41059
1018,924,94,890,223500,41063
772,591,181,590,124700,41064
9838,5144,4694,1047,186000,41071
2716,1856,860,1124,186200,41073
2466,1512,954,1086,144100,41074
6697,4694,2003,1096,298700,41075
7280,5481,1799,1132,203800,41076
645,621,24,-,212100,41080
676,607,69,958,176600,41083
273,192,81,574,112800,41085
840,671,169,869,166900,41086
7772,7222,550,1599,364300,41091
1147,1028,119,971,199000,41092
798,724,74,-,79600,41093
5020,4116,904,1133,264500,41094
1414,835,579,788,165500,41095
2564,2025,539,803,166100,41097
567,458,109,950,73100,41098
8213,4847,3366,907,120100,41101
7567,5686,1881,790,152900,41102
850,810,40,-,127800,41121
428,301,127,709,83400,41124
3570,2783,787,685,152700,41129
200,112,88,-,101600,41132
124,79,45,-,91500,41135
3344,2663,681,914,109900,41139
946,782,164,1051,68900,41141
32,32,0,-,-,41142
5250,3954,1296,688,141200,41143
3485,2904,581,843,130000,41144
231,182,49,1023,-,41146
124,102,22,-,135000,41149
159,133,26,688,-,41159
4864,4046,818,588,102900,41164
381,330,51,-,85400,41166
1221,1111,110,928,137800,41168
2349,1851,498,807,169900,41169
1290,1079,211,381,99800,41171
386,311,75,616,179500,41174
2270,1642,628,719,110800,41175
2675,2026,649,635,86400,41179
357,297,60,529,81100,41180
49,49,0,-,-,41181
788,541,247,876,116200,41183
819,686,133,857,104300,41189
137,76,61,-,44300,41201
174,174,0,-,51300,41203
198,163,35,-,106300,41204
136,53,83,-,85900,41214
559,442,117,931,128800,41216
688,523,165,783,104400,41219
1081,867,214,623,115200,41222
1515,1309,206,550,89300,41224
123,65,58,-,-,41226
4778,3656,1122,750,110500,41230
543,443,100,764,129700,41231
218,164,54,-,86900,41232
215,191,24,-,174000,41234
296,146,150,853,58400,41238
2658,1314,1344,685,159500,41240
439,390,49,-,71700,41250
208,152,56,-,-,41254
220,127,93,-,-,41255
789,585,204,727,269200,41256
258,116,142,805,178300,41257
325,227,98,652,126300,41260
427,372,55,-,42600,41262
80,73,7,-,116500,41263
236,217,19,-,115000,41264
510,422,88,760,160800,41265
461,200,261,395,69400,41267
403,386,17,-,135000,41268
130,95,35,-,61400,41271
250,140,110,673,-,41274
2286,1608,678,532,76300,41301
0,0,0,-,-,41310
2220,1595,625,585,83500,41311
1641,1185,456,540,92000,41314
227,196,31,-,32300,41317
347,308,39,1017,89200,41332
4206,3079,1127,560,71000,41339
473,328,145,526,23200,41348
13,13,0,-,-,41351
235,222,13,-,105900,41352
163,115,48,-,-,41360
58,58,0,-,"10,000-",41364
267,207,60,-,50500,41365
17,0,17,-,-,41366
67,67,0,-,145300,41367
215,171,44,-,60700,41385
9,9,0,-,-,41386
64,34,30,-,185300,41390
85,77,8,-,-,41397
181,145,36,-,69800,41408
151,141,10,-,-,41421
473,414,59,1278,78400,41425
181,155,26,-,-,41464
4123,3208,915,634,94100,41465
3475,2588,887,657,113600,41472
10018,6276,3742,873,147000,41501
133,97,36,-,167400,41503
239,225,14,-,114900,41512
200,144,56,-,67000,41513
1219,923,296,629,84000,41514
35,35,0,-,-,41517
380,292,88,-,95300,41519
2008,1544,464,803,88800,41522
105,96,9,-,68700,41524
0,0,0,-,-,41526
273,273,0,-,167600,41527
103,72,31,-,71600,41528
467,365,102,581,93400,41531
60,54,6,-,-,41534
289,213,76,559,-,41535
1448,1066,382,531,73700,41537
153,126,27,-,146200,41538
692,595,97,583,60700,41539
92,54,38,-,-,41540
230,139,91,-,-,41543
213,154,59,-,84800,41544
188,172,16,-,80000,41547
375,286,89,-,82000,41548
802,758,44,-,113900,41553
376,376,0,-,104400,41554
330,320,10,-,58200,41555
823,760,63,-,141700,41557
379,286,93,785,78300,41558
172,172,0,-,180500,41559
124,111,13,-,179300,41560
813,600,213,747,87700,41562
141,120,21,-,90000,41563
181,177,4,-,80900,41564
143,133,10,-,111000,41566
25,7,18,-,-,41567
475,475,0,-,-,41568
209,187,22,-,-,41571
1484,1346,138,846,93700,41572
274,222,52,795,86100,41601
262,242,20,-,117100,41602
680,363,317,953,204100,41603
162,151,11,-,65200,41604
287,208,79,731,-,41605
141,97,44,-,-,41606
94,94,0,-,54400,41607
61,61,0,-,71000,41612
210,173,37,-,177200,41615
214,160,54,913,19200,41616
180,105,75,956,82600,41619
65,44,21,-,-,41621
115,103,12,-,-,41622
392,245,147,669,46100,41630
458,305,153,-,-,41631
230,146,84,-,50700,41632
1269,994,275,930,77300,41635
334,263,71,846,67800,41636
461,339,122,-,106800,41640
194,133,61,1088,119800,41642
74,67,7,-,"10,000-",41643
440,367,73,929,93800,41645
496,433,63,-,74300,41647
1054,723,331,383,68800,41649
206,130,76,-,86100,41650
57,9,48,-,-,41651
4677,3198,1479,662,117200,41653
423,169,254,-,64400,41655
447,401,46,-,-,41659
123,113,10,-,-,41660
58,19,39,-,63900,41663
232,175,57,633,-,41666
157,157,0,-,47900,41667
289,219,70,538,56000,41669
6415,3958,2457,802,107500,41701
127,96,31,-,131000,41712
0,0,0,-,-,41713
199,153,46,-,123700,41714
507,324,183,825,-,41719
206,153,53,-,-,41721
440,367,73,780,104200,41722
395,313,82,-,-,41723
77,70,7,-,-,41725
577,560,17,-,81400,41727
10,10,0,-,-,41729
346,265,81,-,52700,41731
89,33,56,-,64600,41735
48,48,0,-,-,41739
285,270,15,-,88300,41740
186,149,37,-,189000,41745
301,285,16,-,65000,41746
908,755,153,380,81500,41749
101,92,9,-,-,41751
354,267,87,-,-,41754
281,205,76,-,-,41759
147,147,0,-,-,41760
97,27,70,-,-,41762
245,223,22,-,-,41763
261,237,24,-,-,41764
225,225,0,-,86900,41766
139,96,43,-,-,41772
513,379,134,473,45200,41773
1017,864,153,945,80500,41774
121,121,0,-,-,41775
363,322,41,-,60300,41776
411,340,71,-,68900,41777
106,106,0,-,161800,41778
381,346,35,-,54800,41804
147,83,64,-,23300,41810
122,93,29,-,77600,41812
324,101,223,-,77700,41815
133,102,31,-,60000,41817
114,101,13,-,63000,41819
138,108,30,-,112800,41821
869,593,276,608,85900,41822
307,263,44,-,52200,41824
115,99,16,-,52100,41825
313,289,24,-,71100,41826
222,174,48,-,59200,41828
461,397,64,575,148100,41831
117,40,77,-,-,41832
28,15,13,-,-,41833
107,34,73,-,-,41834
166,111,55,-,-,41835
378,269,109,-,-,41836
300,262,38,-,110600,41837
326,222,104,-,59700,41838
221,153,68,833,-,41839
354,291,63,679,56400,41840
115,115,0,-,31500,41843
480,202,278,548,72400,41844
128,114,14,-,-,41845
127,93,34,-,-,41847
25,12,13,-,-,41848
55,48,7,-,-,41849
313,281,32,-,-,41855
3094,2150,944,635,101700,41858
98,89,9,-,56500,41859
121,100,21,-,32500,41861
364,269,95,635,77100,41862
13096,8177,4919,916,210100,42001
11534,7990,3544,696,160700,42003
862,741,121,490,185300,42020
471,377,94,895,81600,42021
61,61,0,-,88700,42022
981,777,204,633,114200,42023
546,412,134,579,150000,42024
8087,6845,1242,782,172800,42025
711,637,74,-,183600,42027
195,195,0,-,83600,42028
2454,1675,779,765,145100,42029
1292,912,380,693,98300,42031
77,73,4,-,71100,42032
285,256,29,-,120200,42035
617,554,63,-,119300,42036
15,15,0,-,-,42037
2057,1584,473,889,195700,42038
594,511,83,552,125400,42039
401,363,38,-,183200,42040
1588,1028,560,633,90400,42041
1588,1422,166,674,237400,42044
875,569,306,878,95800,42045
58,11,47,-,-,42047
781,577,204,760,118800,42048
542,380,162,739,157400,42049
1260,841,419,434,76900,42050
819,759,60,745,148400,42051
1898,1515,383,889,162600,42053
410,252,158,1072,154200,42054
1111,976,135,688,150000,42055
564,459,105,-,105500,42056
848,705,143,1116,117300,42058
12,6,6,-,-,42060
51,51,0,-,-,42061
3140,2381,759,658,116100,42064
9343,6787,2556,695,135100,42066
468,416,52,819,170100,42069
11987,7192,4795,841,188700,42071
519,385,134,-,154900,42076
683,592,91,672,78700,42078
466,358,108,771,199100,42079
774,688,86,850,172100,42081
803,773,30,580,166600,42082
188,174,14,-,118800,42083
333,249,84,743,101800,42085
1474,1192,282,985,175300,42086
926,791,135,717,117200,42087
905,652,253,696,127900,42088
23663,11089,12574,905,188200,42101
9631,5942,3689,1104,303700,42103
16773,10318,6455,980,282600,42104
817,773,44,625,165400,42120
1932,1742,190,1272,293700,42122
483,385,98,-,115200,42123
22,22,0,-,-,42124
2832,1515,1317,671,161700,42127
2897,2087,810,546,97100,42129
37,37,0,-,191300,42130
58,58,0,-,270000,42131
570,394,176,713,155700,42133
7342,4787,2555,1002,193300,42134
558,454,104,625,82900,42140
12893,8633,4260,833,170700,42141
117,106,11,-,-,42151
23,23,0,-,115300,42153
258,234,24,-,89100,42154
116,116,0,-,207400,42156
145,113,32,-,155100,42157
802,550,252,1124,263400,42159
809,531,278,779,153400,42160
19,0,19,-,-,42163
6657,4939,1718,747,180100,42164
915,669,246,806,108500,42166
3373,2234,1139,623,125300,42167
555,412,143,1143,307100,42170
2697,2155,542,877,173300,42171
778,544,234,605,135600,42202
324,203,121,-,216600,42204
2126,1744,382,757,154200,42206
438,326,112,710,127100,42207
1705,1329,376,642,115300,42210
5485,4047,1438,775,197500,42211
267,222,45,728,160800,42214
637,497,140,857,187800,42215
1454,1216,238,858,130200,42217
2239,1751,488,851,148000,42220
4207,39,4168,1553,266400,42223
318,301,17,-,167400,42232
881,521,360,696,146600,42234
286,233,53,858,119700,42236
16360,9089,7271,866,147400,42240
11,11,0,-,-,42252
88,72,16,950,108300,42254
2101,1718,383,640,121800,42256
458,406,52,879,167300,42259
3576,2480,1096,643,106700,42261
3519,1573,1946,1224,146500,42262
275,268,7,-,358600,42265
926,665,261,918,221600,42266
253,247,6,850,-,42273
1082,949,133,905,172400,42274
332,280,52,820,195600,42275
6242,4536,1706,741,156500,42276
136,136,0,-,113200,42280
211,178,33,-,120800,42285
556,395,161,874,196200,42286
18377,11197,7180,883,180600,42301
17013,11130,5883,941,183400,42303
3289,2459,830,805,115100,42320
218,193,25,-,85000,42321
0,0,0,-,-,42322
257,176,81,783,169200,42323
531,470,61,-,115100,42324
771,625,146,690,137500,42325
141,120,21,-,157100,42326
1574,1308,266,627,169000,42327
462,396,66,937,91300,42328
3491,2666,825,756,140000,42330
23,23,0,-,-,42332
350,254,96,598,74200,42333
653,610,43,931,71500,42337
6,6,0,-,-,42338
351,314,37,535,114400,42339
502,448,54,488,88500,42343
347,304,43,-,80900,42344
4477,3694,783,649,132000,42345
2336,1735,601,622,123900,42347
1971,1560,411,684,124300,42348
644,557,87,1057,103600,42349
493,441,52,916,128800,42350
1603,1228,375,777,171200,42351
793,577,216,402,148100,42352
92,80,12,725,74500,42354
643,485,158,781,131600,42355
0,0,0,-,-,42356
228,197,31,-,106300,42361
2090,1871,219,895,217700,42366
353,298,55,764,100900,42367
382,354,28,-,133200,42368
76,67,9,755,78200,42369
12,12,0,-,-,42370
165,137,28,-,174300,42371
721,593,128,577,102400,42372
49,36,13,-,119200,42374
2578,2304,274,797,213500,42376
1412,1247,165,888,181500,42378
895,726,169,757,106800,42404
978,831,147,773,173500,42406
2458,1866,592,592,82000,42408
795,640,155,734,141100,42409
427,286,141,780,64400,42410
788,669,119,699,96800,42411
1112,982,130,818,149900,42413
16032,9782,6250,792,164800,42420
10874,7377,3497,858,151800,42431
604,409,195,-,176800,42436
2680,1794,886,827,126900,42437
312,258,54,688,99000,42440
621,548,73,948,136100,42441
1113,880,233,821,109400,42442
0,0,0,-,-,42444
4348,2927,1421,724,111400,42445
1657,1154,503,632,74900,42450
154,95,59,-,-,42451
805,714,91,744,167400,42452
184,137,47,858,90800,42453
1130,651,479,910,108000,42455
709,608,101,980,161100,42456
385,374,11,-,193500,42458
1548,1164,384,642,94300,42459
614,460,154,599,89400,42461
499,433,66,1058,143300,42462
63,46,17,783,70000,42463
728,622,106,523,103400,42464
6647,4185,2462,808,131400,42501
10359,7121,3238,873,198500,42503
222,222,0,-,202300,42516
1119,895,224,838,132300,42518
1118,922,196,839,113500,42519
768,626,142,710,153200,42528
363,226,137,758,115000,42533
3773,2787,986,643,129600,42539
185,185,0,-,-,42541
2407,2120,287,727,157700,42544
2251,1839,412,906,138400,42553
297,229,68,704,176600,42565
164,146,18,-,-,42566
2218,1794,424,788,106100,42567
3728,2688,1040,630,113200,42602
231,215,16,-,93200,42603
2222,1588,634,593,157200,42629
16,16,0,-,-,42631
7536,5337,2199,665,124200,42633
561,502,59,-,54800,42634
1535,922,613,421,102300,42635
86,86,0,-,36000,42638
5076,3749,1327,686,138700,42642
1304,1039,265,598,66300,42647
742,594,148,-,85000,42649
1207,908,299,830,104600,42653
21991,13686,8305,902,235500,42701
749,665,84,546,145600,42712
692,519,173,817,106100,42713
135,87,48,-,199600,42715
710,606,104,740,193700,42716
2446,1772,674,553,130800,42717
10180,6956,3224,688,164900,42718
1428,1178,250,593,124900,42721
142,117,25,-,-,42722
2052,1679,373,921,193400,42724
1876,1370,506,903,192700,42726
6100,4545,1555,776,134100,42728
653,632,21,-,155700,42729
663,549,114,1075,182400,42732
618,482,136,-,142300,42733
818,606,212,776,182700,42740
128,103,25,-,113100,42741
23,23,0,-,-,42742
3481,2588,893,622,117100,42743
827,694,133,675,107700,42746
3385,2548,837,783,177000,42748
2037,1430,607,801,121400,42749
289,274,15,-,112100,42753
5907,4437,1470,616,166400,42754
1180,951,229,807,121800,42757
0,0,0,-,-,42758
0,0,0,-,-,42759
40,26,14,-,117100,42762
194,167,27,-,122800,42764
2465,1617,848,667,139100,42765
750,566,184,1003,185000,42776
354,287,67,610,89800,42782
1203,849,354,868,156100,42784
153,153,0,-,223400,42788
1086,969,117,1213,343100,43001
381,295,86,-,299700,43002
1348,1037,311,986,198300,43003
11094,8698,2396,1393,297500,43004
127,98,29,-,-,43005
253,187,66,850,116100,43006
34,30,4,-,177900,43007
1024,786,238,920,157100,43008
721,662,59,1175,234100,43009
122,112,10,1000,139300,43010
2542,2309,233,741,287300,43011
565,495,70,1094,366300,43013
1255,996,259,-,198600,43014
22188,15454,6734,1207,311900,43015
18821,10551,8270,1530,413200,43016
16043,10540,5503,1563,475200,43017
67,33,34,-,-,43018
3534,2996,538,845,196300,43019
4939,4647,292,1360,524800,43021
854,669,185,860,281600,43022
5010,4340,670,1094,428900,43023
2193,1654,539,817,262800,43025
24924,17238,7686,1430,324300,43026
54,0,54,-,-,43027
2994,2715,279,1090,241300,43028
177,128,49,-,241700,43029
75,75,0,-,665000,43030
5151,4204,947,1005,341300,43031
0,0,0,-,-,43032
162,124,38,1133,158300,43033
12203,9114,3089,1580,423000,43035
124,76,48,970,121300,43036
104,82,22,850,264800,43037
13860,10523,3337,1180,275700,43040
1884,1447,437,797,215000,43044
521,483,38,1191,232000,43045
1335,1046,289,948,282400,43046
0,0,0,-,-,43047
12209,8136,4073,933,199000,43050
10970,7485,3485,1808,483100,43054
25098,15304,9794,920,185300,43055
6924,5410,1514,1109,229900,43056
998,709,289,912,165000,43060
1607,1519,88,1097,387400,43061
11407,9335,2072,1334,292100,43062
6283,5301,982,1395,419300,43064
16645,14659,1986,1811,451700,43065
490,470,20,-,316700,43066
551,465,86,1300,271400,43067
24363,14023,10340,1214,225500,43068
69,69,0,-,-,43070
798,726,72,692,198400,43071
2237,1821,416,812,184000,43072
5828,4724,1104,1563,396600,43074
3499,3009,490,892,274700,43076
72,53,19,1042,178100,43077
8158,6016,2142,909,176300,43078
2016,1368,648,852,221200,43080
27235,16187,11048,1434,297300,43081
12385,10778,1607,1696,433400,43082
294,254,40,764,213000,43084
10537,7640,2897,1405,373300,43085
153,82,71,869,123800,43101
1406,1217,189,838,240300,43102
4523,3294,1229,1052,236900,43103
3471,2753,718,843,311200,43105
559,388,171,945,96900,43106
1302,1101,201,920,228500,43107
69,27,42,1132,237500,43109
16297,10161,6136,1218,284300,43110
70,22,48,-,-,43111
1552,1361,191,955,338100,43112
9829,6450,3379,935,217500,43113
532,441,91,1264,129400,43115
776,743,33,1401,337500,43116
9,9,0,-,-,43117
11068,8200,2868,1321,235900,43119
26547,19556,6991,1279,262400,43123
5996,3406,2590,1193,233200,43125
152,104,48,850,165000,43126
113,101,12,-,-,43127
881,483,398,688,139000,43128
24745,16501,8244,1031,215900,43130
1771,1566,205,640,195700,43135
719,615,104,1532,303200,43136
914,728,186,1297,225400,43137
7548,5702,1846,766,169100,43138
7830,5666,2164,901,228000,43140
56,33,23,950,101300,43142
2149,1707,442,880,209400,43143
154,124,30,783,83700,43144
813,617,196,894,171300,43145
3826,3326,500,1087,292100,43146
15541,13332,2209,1596,315600,43147
722,569,153,1049,235800,43148
983,853,130,1113,227200,43149
898,735,163,858,283100,43150
81,55,26,1100,123200,43151
341,316,25,-,163100,43152
406,285,121,1112,184700,43153
1157,1045,112,1080,228500,43154
1020,836,184,634,233800,43155
79,61,18,838,112500,43156
215,138,77,1082,144700,43157
85,27,58,1081,58400,43158
9080,5525,3555,802,162200,43160
2616,2079,537,973,196200,43162
784,571,213,992,188800,43164
14906,2510,12396,1299,438300,43201
9521,2913,6608,1170,317000,43202
4286,1373,2913,930,282100,43203
17520,8991,8529,1206,170900,43204
5682,2100,3582,1050,290800,43205
11171,5324,5847,1339,280400,43206
19202,11396,7806,1115,156200,43207
11740,6626,5114,1105,373500,43209
55,0,55,728,-,43210
8644,3206,5438,1057,91600,43211
12464,4013,8451,1382,514800,43212
15868,6408,9460,1107,197700,43213
13355,8397,4958,1189,371200,43214
11637,2419,9218,1487,508300,43215
715,63,652,1190,-,43217
0,0,0,-,-,43218
12157,4850,7307,1191,173600,43219
13594,6826,6768,1202,463200,43220
14835,10040,4795,1441,419200,43221
1766,626,1140,752,215900,43222
9547,4313,5234,1063,113600,43223
17556,9058,8498,1025,159800,43224
10254,5260,4994,1105,134300,43227
24193,11014,13179,1169,204000,43228
21780,8818,12962,1082,210600,43229
25026,14811,10215,1407,282800,43230
8432,4660,3772,1127,222500,43231
18657,7261,11396,1048,152700,43232
20009,10505,9504,1412,346500,43235
3406,857,2549,1462,289800,43240
20173,12989,7184,853,139700,43302
1272,1128,144,725,152500,43310
8736,5988,2748,833,183000,43311
1024,762,262,790,179700,43314
2704,2114,590,968,168200,43315
2532,1793,739,816,165900,43316
79,60,19,971,116700,43317
1588,1394,194,1005,204900,43318
459,421,38,-,286800,43319
595,545,50,767,133300,43320
130,108,22,788,141200,43321
155,125,30,728,118900,43322
291,267,24,889,164600,43323
1127,961,166,1021,230900,43324
9,9,0,-,-,43325
5178,3873,1305,702,135700,43326
32,16,16,425,80000,43330
2011,1780,231,886,130300,43331
760,667,93,542,122700,43332
442,434,8,-,263600,43333
2367,2044,323,991,245700,43334
13,13,0,-,-,43336
305,263,42,1025,153700,43337
4022,3121,901,821,212100,43338
668,468,200,935,181500,43340
440,413,27,684,162700,43341
1394,1185,209,993,168600,43342
706,561,145,774,169800,43343
2431,1918,513,845,218300,43344
238,216,22,1330,153300,43345
30,22,8,-,-,43346
389,343,46,1104,156900,43347
884,548,336,763,147900,43348
66,55,11,1196,93000,43350
4448,3194,1254,765,166700,43351
407,331,76,775,263000,43356
1604,1253,351,687,215400,43357
1032,850,182,1113,204400,43358
218,157,61,728,169500,43359
692,590,102,935,248900,43360
14179,6406,7773,875,230500,43402
0,0,0,-,-,43403
706,568,138,668,148900,43406
168,155,13,846,206800,43407
116,99,17,631,120700,43408
4278,3213,1065,733,161800,43410
1542,1427,115,1142,221400,43412
430,349,81,936,123900,43413
94,94,0,-,-,43414
1158,972,186,667,175500,43416
12488,8837,3651,824,142400,43420
1938,1715,223,927,149500,43430
1798,1577,221,662,154600,43431
508,494,14,-,216100,43432
0,0,0,-,-,43433
23,19,4,-,106300,43434
516,441,75,830,167500,43435
0,0,0,-,-,43436
186,130,56,844,147500,43437
92,86,6,-,333300,43438
14,14,0,-,-,43439
2244,1977,267,863,274700,43440
330,274,56,724,173400,43442
567,484,83,919,187300,43443
343,343,0,-,190600,43445
19,19,0,-,-,43446
1264,1055,209,1052,208400,43447
3569,2865,704,821,174600,43449
1483,1049,434,1365,220300,43450
488,304,184,854,176700,43451
6925,5490,1435,937,206800,43452
250,231,19,838,497500,43456
486,398,88,840,152900,43457
111,84,27,790,88000,43458
2698,1728,970,854,172000,43460
428,342,86,991,158700,43462
216,109,107,777,78800,43463
834,609,225,1061,113200,43464
2326,1795,531,990,146200,43465
867,683,184,1091,166000,43466
47,37,10,-,65000,43467
147,136,11,-,210000,43468
1202,995,207,582,187700,43469
317,264,53,883,125000,43501
2715,2140,575,743,191800,43502
408,347,61,591,223900,43504
52,37,15,-,215900,43505
6612,4786,1826,821,154700,43506
26,26,0,-,-,43510
353,325,28,586,201400,43511
11644,8939,2705,851,149300,43512
3086,2647,439,834,175200,43515
1068,866,202,915,150000,43516
1418,1088,330,788,127300,43517
1108,955,153,931,143700,43518
145,133,12,-,112600,43519
11,11,0,-,-,43520
1156,835,321,725,119800,43521
1409,1212,197,1058,196500,43522
22,22,0,-,-,43523
448,386,62,900,167200,43524
458,403,55,967,234300,43525
2171,1749,422,744,152000,43526
899,790,109,787,123600,43527
6560,4882,1678,1030,246500,43528
113,99,14,967,85800,43529
0,0,0,-,-,43530
84,84,0,-,37700,43531
1390,1238,152,1028,202500,43532
654,471,183,900,169800,43533
642,522,120,720,157100,43534
302,227,75,1304,162500,43535
117,117,0,-,109400,43536
12619,8767,3852,1017,235200,43537
548,479,69,1115,173900,43540
82,74,8,-,70000,43541
1480,1391,89,1175,423000,43542
3242,2571,671,745,130100,43543
5918,4674,1244,858,169500,43545
191,182,9,-,235400,43547
342,324,18,-,146800,43548
528,487,41,792,170700,43549
18483,12047,6436,1185,284800,43551
141,128,13,850,140000,43553
961,652,309,640,147100,43554
102,49,53,-,139900,43555
638,558,80,760,164400,43556
1003,857,146,950,150900,43557
5384,4742,642,925,185900,43558
12570,10336,2234,1102,262200,43560
139,106,33,953,160300,43565
3281,2664,617,1378,283500,43566
5000,3939,1061,816,172600,43567
1098,845,253,885,151100,43569
1063,735,328,851,117300,43570
2862,2368,494,923,288800,43571
4995,925,4070,499,59300,43604
9964,4905,5059,847,46000,43605
10196,5487,4709,938,165600,43606
8798,4054,4744,881,73300,43607
5277,2784,2493,828,41100,43608
8912,3933,4979,913,58700,43609
1863,1092,771,895,73400,43610
7999,5600,2399,832,117400,43611
11970,6433,5537,976,89700,43612
13339,9096,4243,895,125300,43613
14083,8171,5912,887,160600,43614
18707,10344,8363,1014,137300,43615
8310,6310,2000,876,190500,43616
3100,2788,312,1145,271900,43617
3029,2376,653,916,171900,43619
2315,673,1642,584,115600,43620
9317,5976,3341,933,167500,43623
23041,14615,8426,819,164200,43701
0,0,0,-,-,43711
2514,1877,637,542,171300,43713
908,715,193,808,121300,43716
61,41,20,736,75300,43717
1061,929,132,1091,225600,43718
1012,767,245,748,183600,43719
481,429,52,-,164500,43720
115,115,0,-,65300,43721
148,111,37,-,127300,43722
1895,1150,745,747,108600,43723
2645,1971,674,695,147100,43724
8761,5717,3044,789,160400,43725
513,449,64,-,158200,43727
454,389,65,696,126400,43728
878,699,179,753,167800,43730
1930,1456,474,768,115400,43731
610,535,75,638,132100,43732
12,12,0,-,-,43733
671,618,53,802,201300,43734
141,31,110,-,-,43735
6,4,2,-,90000,43736
51,49,2,-,120800,43738
898,810,88,1094,287900,43739
102,65,37,819,122600,43740
444,407,37,-,188500,43746
498,378,120,863,209100,43747
1076,869,207,747,163000,43748
1028,952,76,-,123800,43749
54,54,0,-,81000,43750
523,460,63,628,145800,43754
671,567,104,1058,184400,43755
2349,1676,673,759,133800,43756
1127,942,185,759,130600,43758
75,55,20,942,87500,43759
545,424,121,-,225000,43760
17,17,0,-,-,43761
1763,1287,476,804,223200,43762
3044,1955,1089,664,129800,43764
525,368,157,721,89700,43766
500,496,4,900,181500,43767
126,80,46,1208,145800,43768
887,621,266,765,136000,43771
655,482,173,791,116800,43772
979,814,165,982,123100,43773
1709,1213,496,682,125200,43777
584,536,48,957,202600,43778
318,309,9,-,217700,43779
922,793,129,895,199800,43780
191,169,22,633,77600,43782
1859,1604,255,779,217300,43783
37,28,9,-,135700,43786
1036,858,178,823,137400,43787
294,269,25,725,147800,43788
22,11,11,-,-,43791
2096,1563,533,538,136800,43793
465,432,33,639,145500,43802
999,781,218,937,197900,43804
96,88,8,-,139300,43805
250,200,50,950,105000,43811
7930,5059,2871,707,130800,43812
1587,1222,365,928,166100,43821
1823,1335,488,730,177800,43822
1457,1258,199,805,189300,43824
2063,1691,372,925,222400,43830
3070,2054,1016,822,121900,43832
51,40,11,-,97500,43836
701,567,134,944,115700,43837
460,402,58,788,203800,43840
129,129,0,-,127600,43842
282,271,11,-,163200,43843
1555,1359,196,685,140800,43844
1972,1594,378,733,124900,43845
894,691,203,895,107700,43901
29,29,0,-,-,43902
844,665,179,921,142400,43903
253,207,46,-,-,43905
3408,2399,1009,695,106200,43906
2127,1444,683,764,115500,43907
378,317,61,764,86900,43908
16,9,7,-,-,43909
1422,1218,204,-,161000,43910
2629,1884,745,648,115700,43912
470,296,174,546,70400,43913
0,0,0,-,-,43914
600,538,62,788,128600,43915
1075,961,114,836,101800,43917
8820,6083,2737,726,111300,43920
31,31,0,-,-,43925
123,75,48,753,56100,43926
35,35,0,-,-,43928
404,381,23,-,118500,43930
89,89,0,-,-,43931
440,321,119,748,157000,43932
892,848,44,-,163900,43933
34,27,7,-,107200,43934
3406,2213,1193,822,101400,43935
2171,1628,543,954,97400,43938
168,156,12,767,96900,43939
154,117,37,-,-,43940
895,673,222,453,117300,43942
1344,1140,204,681,112700,43943
1058,842,216,956,176300,43944
1045,820,225,792,127700,43945
645,549,96,497,125600,43946
2224,1648,576,816,135500,43947
235,204,31,1000,78700,43948
5744,4335,1409,916,212500,43950
11,0,11,-,-,43951
7302,4196,3106,751,122000,43952
5041,3512,1529,878,140000,43953
113,96,17,729,50900,43961
29,17,12,625,162500,43962
569,358,211,806,98700,43963
4040,3232,808,684,121900,43964
49,49,0,-,128500,43967
2916,2054,862,784,96200,43968
461,317,144,642,116100,43971
82,67,15,-,94600,43972
804,683,121,742,174100,43973
45,45,0,-,60800,43974
610,449,161,900,110600,43976
994,749,245,767,130000,43977
100,88,12,575,114700,43981
164,118,46,-,226700,43983
89,70,19,810,-,43985
652,544,108,692,121300,43986
862,666,196,608,120300,43988
8206,7184,1022,947,221300,44001
1539,1242,297,714,117400,44003
13138,8848,4290,813,120300,44004
479,438,41,856,219500,44010
9425,8312,1113,1446,377100,44011
10471,8612,1859,1500,337200,44012
7009,5129,1880,981,187800,44017
2104,1700,404,926,231500,44021
6778,6200,578,1446,469800,44022
7259,6324,935,2396,421600,44023
9032,7856,1176,1022,298100,44024
4323,3876,447,884,311400,44026
3782,3447,335,1438,313400,44028
6231,4618,1613,757,136300,44030
613,572,41,-,190700,44032
26846,16935,9911,871,147600,44035
13918,12515,1403,1067,254800,44039
1168,1111,57,2417,497600,44040
6012,4308,1704,816,167000,44041
4182,3694,488,995,231200,44044
254,220,34,917,149400,44045
606,549,57,914,202900,44046
3777,2877,900,985,182500,44047
890,806,84,916,143100,44048
85,62,23,863,135700,44049
2649,2309,340,1011,258400,44050
11821,6227,5594,840,104000,44052
8883,5644,3239,827,189500,44053
5727,4342,1385,1059,177600,44054
8240,4381,3859,848,95700,44055
4637,4170,467,2024,294500,44056
7789,6524,1265,1044,170200,44057
26029,21163,4866,1156,227200,44060
4411,3551,860,794,213600,44062
675,641,34,994,237400,44064
1681,1572,109,851,283100,44065
8719,7518,1201,1242,234800,44067
64,35,29,-,176100,44068
13410,10385,3025,1092,202400,44070
1953,1545,408,1191,330300,44072
3692,2520,1172,943,229000,44074
1937,1414,523,772,163000,44076
23543,17250,6293,972,217400,44077
38,38,0,-,-,44080
2608,2409,199,894,238700,44081
528,388,140,1049,108200,44082
1511,1308,203,945,211300,44084
1318,1141,177,797,161900,44085
1018,941,77,941,251500,44086
8922,6785,2137,1333,290500,44087
6945,5654,1291,1102,197900,44089
3890,3149,741,794,229600,44090
7861,5017,2844,1059,167100,44092
553,441,112,581,199600,44093
17386,11427,5959,1155,247600,44094
14714,11174,3540,985,162600,44095
557,522,35,-,191200,44099
0,0,0,-,-,44101
19189,6739,12450,911,99300,44102
6990,2260,4730,720,57600,44103
8585,2207,6378,654,60600,44104
14595,6928,7667,888,56400,44105
11041,2840,8201,1024,241600,44106
26651,11846,14805,1011,241400,44107
8924,4254,4670,910,62000,44108
16457,7950,8507,861,112700,44109
9022,3243,5779,821,62600,44110
17419,9466,7953,938,130000,44111
8620,3656,4964,802,77200,44112
10714,2737,7977,1374,295400,44113
3986,309,3677,1296,112900,44114
5106,425,4681,850,151300,44115
9790,6945,2845,1146,327600,44116
4740,1963,2777,877,137100,44117
16275,9963,6312,1195,205600,44118
6150,3229,2921,927,109700,44119
16992,8152,8840,890,115700,44120
13572,9909,3663,1113,129300,44121
16134,10093,6041,1509,304300,44122
8266,3723,4543,1036,103400,44123
19014,12156,6858,1132,210600,44124
11885,7350,4535,1103,107400,44125
7774,5547,2227,966,225800,44126
1826,747,1079,657,50600,44127
12548,6059,6489,957,90200,44128
12058,8615,3443,1024,150400,44129
22785,14561,8224,1045,184900,44130
8572,8143,429,1512,252400,44131
6327,2986,3341,1031,109600,44132
13684,9727,3957,1061,276200,44133
16506,12756,3750,1108,153500,44134
11369,6683,4686,935,119100,44135
10718,7711,3007,1264,271300,44136
9269,5887,3382,1322,89800,44137
9621,7367,2254,1210,239200,44138
9010,7649,1361,1468,373800,44139
6104,5576,528,889,332500,44140
5516,4698,818,1448,360300,44141
7991,6546,1445,1090,158300,44142
11004,8138,2866,952,252200,44143
9601,5509,4092,923,138000,44144
14574,10613,3961,1480,336100,44145
13984,7737,6247,1000,141800,44146
8598,7013,1585,1075,292500,44147
8382,7905,477,969,289700,44149
2538,2116,422,1000,213700,44201
9176,7725,1451,1701,356000,44202
16868,11751,5117,832,148300,44203
18519,14017,4502,1135,244900,44212
728,608,120,810,212200,44214
996,859,137,1138,202000,44215
3556,3332,224,774,214000,44216
1472,1272,200,869,178000,44217
13543,7958,5585,1026,160400,44221
8448,6375,2073,1056,202600,44223
15776,10922,4854,1190,243500,44224
3448,2936,512,854,194100,44230
3094,2570,524,909,204700,44231
0,0,0,-,-,44232
2793,2685,108,948,425700,44233
1428,1200,228,953,218400,44234
512,434,78,1269,271800,44235
9185,8207,978,2205,436900,44236
16773,8700,8073,989,216000,44240
7624,5121,2503,1372,190700,44241
0,0,0,-,-,44243
665,478,187,1110,103000,44250
415,370,45,-,354000,44251
1367,1262,105,2005,260200,44253
2046,1548,498,818,185700,44254
2767,2445,322,875,180300,44255
25660,20962,4698,1120,292000,44256
5271,4566,705,951,191500,44260
2147,1720,427,-,223800,44262
1315,1211,104,1165,354900,44264
14058,9702,4356,904,159900,44266
3213,2366,847,749,160400,44270
2343,1741,602,1040,241200,44272
2691,2464,227,943,242900,44273
46,32,14,-,-,44274
1204,1034,170,1121,250000,44275
632,543,89,850,220500,44276
7553,6286,1267,1030,225300,44278
2042,1809,233,1828,324000,44280
13758,10115,3643,1031,262200,44281
47,42,5,-,220000,44285
2638,2479,159,1082,388300,44286
3051,2664,387,788,171300,44287
1276,912,364,1048,159200,44288
5875,3525,2350,990,103400,44301
2693,1174,1519,758,112200,44302
3902,2047,1855,896,213600,44303
1278,88,1190,958,70500,44304
9083,5094,3989,974,89900,44305
9188,4218,4970,901,77500,44306
3039,1016,2023,802,75700,44307
431,18,413,733,433300,44308
10023,3942,6081,925,91400,44310
2774,368,2406,790,64000,44311
13658,10213,3445,994,142100,44312
13243,7930,5313,1041,216200,44313
7901,4227,3674,924,83000,44314
9480,7050,2430,1081,188400,44319
8293,4621,3672,915,102600,44320
6339,4895,1444,1423,320400,44321
0,0,0,-,-,44325
8051,6768,1283,1232,362600,44333
999,871,128,740,229400,44401
1117,958,159,592,148600,44402
1785,1565,220,649,145000,44403
599,540,59,900,162300,44404
3340,2300,1040,732,77500,44405
8613,7661,952,826,260600,44406
4873,3271,1602,681,197400,44408
7364,5960,1404,762,174600,44410
756,685,71,1122,168800,44411
1110,1010,100,861,251600,44412
3034,2275,759,797,124100,44413
0,0,0,-,-,44415
634,601,33,841,154500,44417
480,466,14,-,213200,44418
6439,4547,1892,776,115000,44420
883,729,154,1142,182600,44423
33,28,5,-,141200,44424
6098,4963,1135,804,128800,44425
622,544,78,734,-,44427
1249,930,319,747,145100,44428
976,759,217,870,153000,44429
1152,915,237,671,111000,44430
1851,1567,284,791,160900,44431
4188,3034,1154,744,141900,44432
1461,1250,211,617,135400,44436
1663,1379,284,797,143100,44437
2421,1722,699,763,78900,44438
152,124,28,818,168800,44439
2056,1639,417,807,159300,44440
672,650,22,-,212800,44441
1654,1381,273,742,172700,44442
762,552,210,830,226400,44443
4293,3043,1250,725,129000,44444
1155,956,199,558,194300,44445
9348,5416,3932,786,108800,44446
575,466,109,712,159000,44449
724,573,151,749,178400,44450
1161,918,243,694,201500,44451
1138,944,194,738,223800,44452
335,298,37,-,164900,44454
561,496,65,675,159800,44455
10477,7548,2929,770,153200,44460
1664,1491,173,587,147400,44470
4568,3145,1423,845,97100,44471
1705,1389,316,953,174700,44473
4334,3609,725,738,160600,44481
11492,7464,4028,796,100600,44483
9131,6546,2585,840,166100,44484
6533,3465,3068,818,73600,44485
302,181,121,805,98200,44490
1175,1033,142,749,206300,44491
57,21,36,-,-,44493
3587,1880,1707,915,37500,44502
537,0,537,405,-,44503
1985,816,1169,770,74700,44504
6523,3424,3099,644,82100,44505
1201,591,610,599,24200,44506
1700,784,916,785,27200,44507
5018,3039,1979,744,56000,44509
928,324,604,481,-,44510
8713,6754,1959,818,110700,44511
14860,9943,4917,788,158800,44512
9814,8365,1449,973,190100,44514
13406,8755,4651,766,142200,44515
0,0,0,-,-,44555
13124,8133,4991,803,142600,44601
2471,1959,512,672,252800,44606
26,26,0,-,-,44607
978,574,404,1037,159200,44608
1568,1336,232,682,190200,44609
65,25,40,-,-,44610
870,819,51,-,167200,44611
2184,1546,638,792,244200,44612
767,511,256,943,135100,44613
5617,4602,1015,932,201700,44614
4260,3522,738,743,176900,44615
2611,2004,607,842,221200,44618
79,79,0,-,-,44619
651,544,107,835,198000,44620
1770,1157,613,825,119100,44621
7717,5226,2491,981,200000,44622
1727,1530,197,693,287900,44624
380,250,130,1110,143600,44625
1316,1156,160,970,176000,44626
1819,1493,326,788,331000,44627
428,338,90,860,164600,44628
940,741,199,859,144100,44629
42,42,0,-,-,44630
4024,3155,869,999,259200,44632
667,488,179,1074,196700,44633
844,729,115,587,155700,44634
1011,840,171,944,163600,44637
437,332,105,996,168600,44638
98,85,13,-,70700,44639
56,48,8,1333,102800,44640
7773,5765,2008,834,199300,44641
1516,1102,414,924,164100,44643
2101,1390,711,700,184900,44644
1004,880,124,1100,228800,44645
19692,13190,6502,883,181600,44646
7675,6012,1663,946,141700,44647
330,317,13,-,180500,44651
234,112,122,912,261600,44652
318,256,62,855,97200,44653
6352,4844,1508,770,288000,44654
1113,821,292,731,202900,44656
4255,3036,1219,795,157400,44657
34,25,9,632,147900,44659
25,25,0,-,-,44660
151,104,47,783,98000,44661
3923,3184,739,828,175600,44662
11170,7547,3623,859,177100,44663
49,49,0,-,-,44665
1147,1037,110,1599,205100,44666
5057,3551,1506,852,196300,44667
630,455,175,892,203000,44669
69,69,0,-,104800,44670
40,40,0,-,-,44671
2266,1130,1136,1173,98900,44672
920,721,199,1075,161900,44675
1952,1578,374,741,174000,44676
1061,842,219,855,195900,44677
68,68,0,-,-,44678
1762,1258,504,823,202500,44680
2826,2259,567,817,304700,44681
438,308,130,865,161200,44682
3222,1899,1323,828,114900,44683
11175,9268,1907,1346,259900,44685
92,54,38,-,322900,44687
1145,788,357,810,130900,44688
135,99,36,1000,104200,44689
52,28,24,-,-,44690
18117,13013,5104,881,216800,44691
15,11,4,-,98300,44693
547,461,86,575,183400,44695
134,129,5,-,316700,44697
310,236,74,944,180700,44699
625,25,600,296,107600,44702
3838,1250,2588,838,78100,44703
1654,905,749,790,65100,44704
7093,4004,3089,877,74600,44705
7145,4976,2169,899,132200,44706
3453,1668,1785,704,106900,44707
10664,7436,3228,926,164500,44708
8654,5142,3512,818,149400,44709
3621,2116,1505,921,101400,44710
4157,2512,1645,901,143300,44714
5728,4011,1717,871,285500,44718
17044,12094,4950,977,233800,44720
5184,4584,600,868,219600,44721
2575,2054,521,797,153600,44730
358,323,35,740,145300,44802
485,457,28,796,188100,44804
12157,8817,3340,835,165000,44805
923,774,149,614,130800,44807
50,40,10,-,130000,44809
5266,3902,1364,743,156900,44811
3032,2363,669,757,210300,44813
925,718,207,878,231100,44814
302,243,59,633,101100,44815
642,559,83,888,158900,44817
801,658,143,788,139800,44818
7451,5429,2022,742,134100,44820
1276,975,301,948,214900,44822
1656,1422,234,742,176400,44824
50,43,7,813,74400,44825
508,448,60,-,187900,44826
3161,2472,689,744,111800,44827
65,19,46,1076,-,44828
7309,5328,1981,770,109900,44830
7262,4747,2515,772,127700,44833
903,798,105,846,128300,44836
1557,1225,332,731,157500,44837
78,66,12,750,136500,44838
5796,4776,1020,888,234700,44839
1239,1075,164,1035,214400,44840
205,164,41,-,112500,44841
2142,1669,473,665,186600,44842
1216,1079,137,743,201300,44843
335,314,21,-,129300,44844
1236,1036,200,963,235200,44846
1440,1110,330,1015,167200,44847
766,674,92,775,124800,44849
59,59,0,-,-,44850
2074,1647,427,831,154900,44851
567,470,97,569,150000,44853
661,529,132,910,137100,44854
414,350,64,978,165900,44855
41,37,4,750,95500,44856
9918,6969,2949,795,170400,44857
754,754,0,-,199700,44859
47,33,14,-,-,44861
1310,1143,167,882,138700,44864
1114,843,271,871,142600,44865
775,717,58,727,205300,44866
870,652,218,1050,145700,44867
16916,10220,6696,863,148600,44870
128,98,30,838,132100,44874
5702,4285,1417,727,146500,44875
913,693,220,947,181700,44878
1277,1209,68,-,237400,44880
47,41,6,-,95500,44881
971,785,186,881,161200,44882
11905,8370,3535,831,152600,44883
369,319,50,1325,114500,44887
2736,2291,445,962,222800,44889
4152,3046,1106,834,136900,44890
0,0,0,-,-,44901
1805,633,1172,842,58500,44902
10437,7541,2896,811,177900,44903
5785,4347,1438,767,197200,44904
4773,3661,1112,859,111000,44905
7867,4863,3004,783,127700,44906
7364,3881,3483,788,130400,44907
295,118,177,836,122200,45001
5249,3945,1304,1094,281000,45002
312,243,69,783,170600,45003
12647,9291,3356,1005,201200,45005
26612,19774,6838,1005,272000,45011
20406,14937,5469,967,217200,45013
18692,11455,7237,1145,215700,45014
4815,2698,2117,1041,116600,45015
8441,6741,1700,1101,234500,45030
261,194,67,926,150000,45032
169,124,45,-,81400,45033
521,498,23,-,312100,45034
14157,10568,3589,1090,317600,45036
11174,9548,1626,1554,294100,45039
21306,16725,4581,1691,403700,45040
131,131,0,-,-,45041
11682,8389,3293,950,192400,45042
20050,12590,7460,1034,230400,45044
4359,3260,1099,1519,273800,45050
39,0,39,943,-,45051
1646,1437,209,1157,283500,45052
1294,1233,61,1406,322900,45053
1107,1024,83,-,297700,45054
36,24,12,-,-,45055
8152,4100,4052,1004,247700,45056
301,266,35,788,144400,45062
1178,1095,83,-,209400,45064
2302,1805,497,1011,313100,45065
9344,8365,979,1387,362500,45066
5241,4008,1233,1354,214400,45067
4463,3685,778,1252,325000,45068
21014,16452,4562,1585,314300,45069
55,38,17,1250,96000,45070
765,444,321,545,139600,45101
9658,6723,2935,910,218500,45102
14413,9711,4702,1050,242700,45103
71,0,71,-,-,45105
4452,3361,1091,742,203300,45106
3472,2380,1092,918,196300,45107
112,98,14,1667,201500,45111
8,7,1,-,-,45112
1507,1349,158,995,282000,45113
56,35,21,-,-,45115
1371,1157,214,1207,225700,45118
93,82,11,-,-,45119
1056,731,325,733,186600,45120
3819,2815,1004,680,150800,45121
4221,3600,621,1186,210200,45122
3346,2222,1124,746,139100,45123
1303,1089,214,885,229300,45130
110,56,54,731,96400,45131
68,48,20,988,99000,45132
9227,6688,2539,744,162900,45133
1961,1468,493,904,181100,45135
21759,17667,4092,1379,340800,45140
1538,1247,291,744,176000,45142
1724,1223,501,686,121300,45144
452,367,85,877,172300,45146
30,20,10,-,-,45147
659,558,101,864,160300,45148
14140,10555,3585,1033,267900,45150
4509,3979,530,1010,327700,45152
808,669,139,1308,240700,45153
3296,2427,869,859,185100,45154
166,117,49,793,81800,45155
16,12,4,-,76700,45156
3722,3140,582,874,232700,45157
271,226,45,866,218800,45158
1283,990,293,942,155700,45159
283,75,208,-,140200,45160
942,856,86,1315,215300,45162
120,102,18,725,80000,45164
0,0,0,-,-,45166
1429,1052,377,730,162300,45167
592,446,146,1031,157600,45168
1841,1239,602,733,118000,45169
2287,1860,427,929,178500,45171
128,125,3,-,129000,45172
747,714,33,3021,581000,45174
3965,2984,981,870,197400,45176
9092,6313,2779,933,209400,45177
9654,2269,7385,1524,444000,45202
1193,391,802,749,296100,45203
2943,1238,1705,771,93100,45204
7005,2758,4247,855,112600,45205
6151,2055,4096,849,269900,45206
2476,1434,1042,990,192400,45207
8357,5317,3040,1315,491400,45208
6141,2312,3829,1291,386600,45209
15584,7972,7612,915,156600,45211
9886,4713,5173,932,229400,45212
5446,3275,2171,929,259300,45213
4062,988,3074,762,102000,45214
12875,7304,5571,954,200100,45215
3681,1968,1713,815,138200,45216
2445,1576,869,923,149200,45217
1545,970,575,1017,169600,45218
6895,1211,5684,1166,222500,45219
6697,1775,4922,954,385200,45220
6036,2663,3373,914,203800,45223
9462,5707,3755,895,174400,45224
4131,523,3608,639,108400,45225
2969,1860,1109,1244,387200,45226
8763,4856,3907,1220,256400,45227
6747,1946,4801,831,316000,45229
11645,8586,3059,962,237200,45230
16993,12162,4831,1118,164900,45231
3212,657,2555,605,122500,45232
5805,4749,1056,870,270900,45233
11547,7332,4215,1155,218900,45236
10167,4948,5219,863,158700,45237
20685,11832,8853,913,168800,45238
12070,7165,4905,949,155500,45239
11302,6832,4470,1187,176600,45240
10599,7801,2798,1137,292000,45241
9054,6973,2081,1781,421200,45242
5973,5293,680,1962,616900,45243
10763,8773,1990,1075,346100,45244
8636,5305,3331,1123,259500,45245
5751,3216,2535,1231,189700,45246
9519,7720,1799,1095,268300,45247
9543,8456,1087,1053,206200,45248
5535,3608,1927,1476,484500,45249
8057,6103,1954,1193,175900,45251
1991,1867,124,825,312900,45252
9856,6719,3137,1339,279400,45255
0,0,0,-,-,45267
78,78,0,-,115100,45301
1539,1198,341,1068,210400,45302
855,658,197,695,125300,45303
3029,2454,575,809,190000,45304
4394,3507,887,1241,314500,45305
839,684,155,920,237100,45306
89,57,32,967,114600,45307
1643,1355,288,906,164700,45308
4574,3350,1224,905,197100,45309
95,88,7,-,189300,45310
2408,1917,491,802,177200,45311
469,436,33,1071,253500,45312
1387,1066,321,829,276900,45314
2107,1741,366,948,183900,45315
58,43,15,828,232100,45316
405,352,53,-,258900,45317
2279,1747,532,701,176100,45318
124,92,32,820,137500,45319
6546,4965,1581,792,167900,45320
457,392,65,983,129200,45321
8937,6815,2122,1036,165500,45322
2105,1665,440,812,177700,45323
18356,9538,8818,989,177700,45324
1052,986,66,1120,211900,45325
538,457,81,-,149200,45326
3505,2913,592,947,198400,45327
173,115,58,954,106300,45328
345,292,53,850,143000,45330
9842,6380,3462,722,159100,45331
254,213,41,433,112500,45332
627,589,38,-,172500,45333
768,522,246,693,167100,45334
2928,2442,486,852,186500,45335
34,32,2,-,135000,45336
615,538,77,1063,226300,45337
1831,1405,426,863,186400,45338
434,336,98,639,232900,45339
246,232,14,-,208800,45340
1632,1433,199,777,127200,45341
14772,9450,5322,1247,206800,45342
6714,5364,1350,854,159600,45344
2473,1967,506,871,139000,45345
813,599,214,869,162300,45346
1681,1363,318,843,139200,45347
272,222,50,1050,227300,45348
113,101,12,1571,145800,45349
22,21,1,-,-,45350
120,98,22,814,225000,45351
71,41,30,750,62500,45352
71,61,10,-,-,45353
293,220,73,1555,137500,45354
10661,7362,3299,900,144500,45356
141,110,31,883,139300,45358
699,537,162,725,186600,45359
147,117,30,850,103900,45360
105,80,25,1307,116700,45361
491,422,69,625,224000,45362
682,581,101,887,263900,45363
11779,8030,3749,899,173000,45365
1829,1345,484,718,156100,45368
1580,1442,138,912,205300,45369
958,841,117,937,318500,45370
9180,6745,2435,1154,272100,45371
137,109,28,750,124300,45372
14800,10567,4233,933,234400,45373
6532,4243,2289,872,191700,45377
185,168,17,725,115000,45378
2215,1712,503,732,232400,45380
2327,1927,400,726,199500,45381
477,381,96,1121,184100,45382
2890,2200,690,910,149200,45383
234,176,58,-,206500,45384
15947,11339,4608,899,197300,45385
2535,1818,717,889,287900,45387
224,188,36,-,286800,45388
274,245,29,1049,95400,45389
1274,895,379,639,111500,45390
4680,1742,2938,921,105900,45402
6364,2606,3758,742,73900,45403
4278,1689,2589,871,82400,45404
8925,3017,5908,858,74100,45405
8869,4294,4575,879,82300,45406
3066,2169,897,1055,230800,45409
7180,3607,3573,950,97800,45410
9926,6737,3189,867,163200,45414
5270,3651,1619,941,169400,45415
2149,1370,779,1123,76000,45416
11825,6001,5824,861,73000,45417
7093,4581,2512,1006,237700,45419
11970,7551,4419,918,116200,45420
0,0,0,-,-,45423
20535,15533,5002,1096,169000,45424
6435,3513,2922,927,111900,45426
6,0,6,-,-,45428
12147,8529,3618,1007,221200,45429
2992,2385,607,1264,261700,45430
11913,6201,5712,1302,197600,45431
6423,5021,1402,871,181900,45432
415,4,411,1434,-,45433
4616,4270,346,1442,290500,45434
0,0,0,-,-,45435
4986,2482,2504,1001,120100,45439
9565,5973,3592,1122,248200,45440
8325,4936,3389,984,147700,45449
15316,11645,3671,1286,337500,45458
13205,8790,4415,1187,276100,45459
6,0,6,-,-,45469
0,0,0,-,-,45501
6625,5750,875,886,225500,45502
14039,8412,5627,871,153100,45503
6378,4725,1653,889,167700,45504
8140,4332,3808,802,87500,45505
5701,3297,2404,800,101000,45506
21576,14977,6599,858,160800,45601
1954,1507,447,853,130300,45612
1264,949,315,820,149800,45613
1967,1546,421,497,121500,45614
574,446,128,667,181900,45616
0,0,0,-,-,45617
0,0,0,-,-,45618
2846,2275,571,857,146700,45619
290,258,32,-,166400,45620
174,118,56,832,55600,45621
256,248,8,-,-,45622
1219,1057,162,855,139000,45623
0,0,0,-,-,45624
2202,1530,672,936,167500,45628
1206,1040,166,671,171300,45629
72,38,34,-,-,45630
5451,3901,1550,807,138700,45631
708,546,162,681,99100,45634
117,69,48,-,166900,45636
7798,5272,2526,782,118500,45638
6453,4637,1816,769,165800,45640
0,0,0,-,-,45642
1917,1321,596,771,215800,45644
990,921,69,953,83900,45645
82,70,12,-,-,45646
1076,808,268,662,173100,45647
4208,3264,944,849,154600,45648
148,136,12,-,93300,45650
2056,1332,724,661,162400,45651
1300,1158,142,-,136900,45652
1241,979,262,556,166300,45653
323,242,81,-,272200,45654
2401,1938,463,816,117400,45656
691,576,115,819,122900,45657
872,854,18,-,116600,45658
962,775,187,844,104100,45659
2900,2012,888,760,158500,45660
2825,1698,1127,786,127200,45661
11223,5958,5265,756,98100,45662
2827,2065,762,687,122800,45663
4208,3179,1029,953,179000,45669
127,121,6,-,-,45671
531,461,70,-,172500,45672
195,107,88,-,88700,45673
179,33,146,473,183900,45674
17,17,0,-,-,45677
493,385,108,-,90300,45678
1053,763,290,773,161000,45679
4754,3128,1626,690,151400,45680
526,435,91,945,139400,45681
842,648,194,628,124600,45682
646,542,104,961,112400,45684
311,231,80,770,130800,45685
1327,1061,266,932,157200,45686
100,68,32,664,-,45688
5605,3757,1848,922,153500,45690
3277,2282,995,769,112900,45692
3012,2139,873,633,170700,45693
4839,3693,1146,784,197500,45694
323,257,66,-,101800,45695
353,218,135,-,151000,45696
2029,1677,352,680,195300,45697
203,202,1,-,-,45698
0,0,0,-,-,45699
11455,5988,5467,1018,217700,45701
2023,1647,376,920,181300,45710
388,362,26,1094,214500,45711
4266,3005,1261,819,158800,45714
781,467,314,648,162200,45715
158,126,32,613,121900,45716
389,235,154,743,74000,45719
0,0,0,-,-,45720
15,15,0,-,-,45721
1380,1207,173,745,167700,45723
694,527,167,1077,148300,45724
256,239,17,800,109200,45727
721,713,8,-,221700,45729
1688,1294,394,692,89700,45732
158,145,13,-,110200,45734
765,712,53,-,153300,45735
40,40,0,-,-,45739
154,137,17,-,74300,45740
346,325,21,-,96500,45741
1273,1113,160,1177,173700,45742
460,356,104,710,168500,45743
994,923,71,789,170300,45744
465,329,136,1135,100200,45745
104,81,23,1075,92600,45746
11365,7827,3538,838,177600,45750
1634,1152,482,674,82100,45760
638,525,113,699,110500,45761
2890,1657,1233,761,112500,45764
502,448,54,1275,134500,45766
1010,729,281,559,122600,45767
651,617,34,-,198300,45768
2056,1542,514,676,111100,45769
305,217,88,-,120800,45770
1524,982,542,715,149100,45771
609,478,131,-,118000,45772
154,131,23,-,239100,45773
598,582,16,-,113800,45775
326,277,49,-,178600,45776
478,412,66,875,68100,45778
307,230,77,802,115700,45779
1535,803,732,895,246400,45780
155,113,42,689,51900,45782
107,57,50,-,111900,45783
1257,1131,126,824,207700,45784
1261,1079,182,854,194500,45786
312,288,24,-,156700,45788
73,67,6,-,-,45789
8301,4560,3741,865,111600,45801
5936,3401,2535,888,96100,45804
10054,6403,3651,944,153700,45805
4536,3636,900,972,189800,45806
4808,3981,827,967,192800,45807
152,115,37,973,100200,45808
33,30,3,-,99400,45809
2474,1602,872,741,157500,45810
724,505,219,646,118800,45812
1363,1076,287,691,144900,45813
1061,872,189,673,207100,45814
21,21,0,-,-,45815
119,107,12,-,122000,45816
2337,1924,413,842,195100,45817
103,71,32,1138,102900,45819
236,197,39,850,107900,45820
296,276,20,713,122700,45821
8476,6323,2153,822,184600,45822
161,139,22,917,275000,45826
895,805,90,838,204900,45827
2164,1685,479,824,233700,45828
2153,1901,252,815,168200,45830
1431,1323,108,656,157100,45831
1246,1055,191,784,150300,45832
4522,3483,1039,822,156000,45833
220,201,19,-,95600,45835
667,514,153,800,115700,45836
28,26,2,-,114300,45838
23738,15199,8539,934,203800,45840
472,401,71,681,249500,45841
1564,1209,355,855,150900,45843
1121,1011,110,740,225900,45844
1184,1081,103,787,280200,45845
1678,1515,163,711,250300,45846
49,46,3,-,204800,45848
415,331,84,545,97500,45849
1365,1224,141,1264,177900,45850
242,213,29,575,162900,45851
637,456,181,920,199700,45853
143,94,49,743,121700,45854
68,53,15,1304,97500,45855
1842,1489,353,1116,167400,45856
1044,829,215,938,169600,45858
172,131,41,807,59500,45859
748,657,91,691,299700,45860
126,117,9,-,111300,45861
591,495,96,699,112000,45862
537,496,41,683,126000,45863
77,67,10,-,164100,45864
2048,1808,240,879,265700,45865
48,43,5,-,112500,45866
444,370,74,863,159000,45867
249,216,33,1116,145600,45868
1833,1524,309,756,242800,45869
136,136,0,-,115500,45870
750,559,191,838,202600,45871
1851,1493,358,732,113300,45872
874,722,152,-,138400,45873
804,738,66,884,124200,45874
3981,3383,598,810,214300,45875
385,336,49,876,231700,45876
1006,813,193,857,167500,45877
2737,2083,654,778,121900,45879
862,691,171,782,123400,45880
649,537,112,1115,141800,45881
1041,883,158,823,158400,45882
1201,1110,91,743,283200,45883
45,37,8,-,110600,45884
5392,4071,1321,882,153900,45885
169,133,36,681,91700,45886
1716,1310,406,808,185400,45887
130,99,31,-,89200,45888
556,536,20,-,226000,45889
314,261,53,830,185900,45890
6257,4783,1474,744,143100,45891
130,130,0,-,104000,45893
291,260,31,918,157000,45894
7541,5579,1962,846,181700,45895
667,537,130,668,162100,45896
23,23,0,-,-,45897
367,301,66,1069,101500,45898
67,50,17,-,84000,45899
4252,3219,1033,875,136500,46001
6750,5605,1145,1011,168300,46011
8840,6009,2831,982,149400,46012
8404,5474,2930,891,120400,46013
7134,2790,4344,864,66100,46016
2256,1833,423,972,138500,46017
1169,925,244,951,226000,46030
847,672,175,1110,177500,46031
20510,13751,6759,1522,464200,46032
14274,12410,1864,1597,458600,46033
3134,2714,420,1038,292900,46034
463,370,93,778,131700,46035
4687,3345,1342,841,108500,46036
16722,13602,3120,1463,403000,46037
16946,11623,5323,1489,301600,46038
169,158,11,-,108800,46039
5863,5091,772,1344,433800,46040
8984,6350,2634,900,154100,46041
1035,894,141,1021,159000,46044
45,45,0,-,276200,46045
8,8,0,-,-,46047
738,575,163,1392,142200,46048
393,361,32,820,145400,46049
838,695,143,953,183200,46050
1148,834,314,1253,190700,46051
9641,7210,2431,911,200300,46052
5501,4693,808,1596,326300,46055
856,746,110,997,191900,46056
411,319,92,963,199600,46057
824,705,119,796,144300,46058
17630,12164,5466,1215,292400,46060
14251,11505,2746,1458,351000,46062
107,66,41,817,86300,46063
5853,4947,906,1121,256500,46064
1126,920,206,1028,192600,46065
1009,945,64,868,181800,46068
2926,2343,583,861,243400,46069
862,716,146,856,110200,46070
1213,1029,184,925,227600,46071
3713,2811,902,848,169900,46072
16409,13553,2856,1550,400000,46074
3334,2574,760,1797,332100,46075
689,581,108,1009,122400,46076
12754,10732,2022,1672,534600,46077
182,152,30,1014,164800,46102
124,105,19,1056,149200,46103
421,390,31,-,176000,46104
675,567,108,916,224200,46105
3423,2847,576,1546,430500,46106
5321,3454,1867,1051,166600,46107
291,291,0,-,217100,46110
177,139,38,599,116100,46111
15272,12288,2984,1394,295900,46112
6193,4857,1336,1350,225700,46113
562,381,181,694,155600,46115
262,170,92,-,229700,46117
1769,1469,300,987,248300,46118
2836,2108,728,841,166900,46120
2000,1888,112,1333,241600,46121
6217,4776,1441,1112,276800,46122
15892,12462,3430,1467,293000,46123
2910,1895,1015,798,184200,46124
18,18,0,-,-,46125
1770,1499,271,908,232900,46126
150,71,79,584,119100,46127
971,839,132,1109,208800,46128
847,801,46,1045,285400,46130
12407,8946,3461,1114,227800,46131
443,402,41,1110,124700,46133
6693,4231,2462,902,200900,46135
17542,12742,4800,1099,227200,46140
13840,9775,4065,1122,266000,46142
22224,15833,6391,1427,295400,46143
99,83,16,-,136900,46144
34,24,10,-,130000,46146
959,769,190,956,213000,46147
1897,1446,451,849,180900,46148
782,692,90,1107,242400,46149
330,244,86,-,201400,46150
12386,9914,2472,978,219400,46151
15,0,15,-,-,46154
63,19,44,-,-,46155
441,379,62,773,128600,46156
1580,1418,162,819,202100,46157
9527,7780,1747,1024,241500,46158
2479,2193,286,886,237600,46160
909,681,228,959,206700,46161
112,112,0,-,717400,46162
5335,4950,385,1232,313000,46163
1653,1594,59,866,234000,46164
744,686,58,1526,301700,46165
989,864,125,960,148600,46166
2570,2503,67,-,293400,46167
13901,9475,4426,1307,271400,46168
0,0,0,-,-,46170
719,628,91,-,256900,46171
898,756,142,978,123500,46172
4180,2946,1234,852,153900,46173
212,204,8,-,160700,46175
11558,7668,3890,962,172400,46176
405,390,15,788,173700,46180
1925,1757,168,951,278600,46181
626,591,35,1348,196800,46182
41,41,0,-,-,46183
5013,4369,644,1684,205100,46184
758,710,48,615,273600,46186
13874,6511,7363,929,150600,46201
10639,3064,7575,1258,420200,46202
15218,8775,6443,1022,155500,46203
5871,1008,4863,1686,350400,46204
12479,6447,6032,1087,278000,46205
0,0,0,-,-,46206
9182,5082,4100,1075,206000,46208
10436,4867,5569,1116,180200,46214
1509,496,1013,1282,253800,46216
13732,11207,2525,1370,226100,46217
12608,5963,6645,1056,90200,46218
15482,8989,6493,991,177000,46219
16624,10790,5834,1330,329700,46220
10092,6140,3952,1111,174900,46221
13412,6234,7178,1050,104300,46222
15348,5748,9600,1048,166500,46224
2244,1271,973,1104,123600,46225
19431,9025,10406,1045,148900,46226
23856,10784,13072,994,192600,46227
5807,4922,885,1234,241400,46228
11173,6825,4348,1020,170100,46229
3741,2743,998,1575,204200,46231
10473,8288,2185,1524,226400,46234
13081,6889,6192,923,169300,46235
9876,8871,1005,1750,281800,46236
17152,11854,5298,1272,216300,46237
11677,9583,2094,1304,253000,46239
10079,4520,5559,1255,328600,46240
11334,6142,5192,1118,111500,46241
9204,3808,5396,1293,288900,46250
17015,8160,8855,1021,175700,46254
9353,6857,2496,1136,277800,46256
5017,4847,170,1261,304800,46259
14949,7605,7344,1080,271600,46260
11206,5198,6008,1171,208500,46268
3285,3167,118,1172,420200,46278
3649,2196,1453,1691,291100,46280
55,55,0,-,637500,46290
316,311,5,-,581900,46301
26,26,0,-,-,46302
6154,5072,1082,1197,271700,46303
10917,8329,2588,1169,278300,46304
25363,22010,3353,1308,293500,46307
5320,4733,587,1060,213500,46310
8868,8012,856,1221,300000,46311
9987,4403,5584,820,92400,46312
7344,5387,1957,1162,194300,46319
5391,2308,3083,853,115300,46320
9377,8072,1305,1480,312000,46321
10315,7959,2356,1202,219500,46322
8290,5524,2766,1189,149200,46323
8641,5888,2753,1157,141600,46324
3753,2321,1432,1133,116900,46327
605,497,108,780,171000,46340
3932,3341,591,897,248900,46341
12795,9603,3192,1110,193400,46342
47,30,17,1000,197200,46345
522,310,212,805,103100,46346
1782,1566,216,795,241300,46347
431,358,73,1000,157400,46348
1251,950,301,963,198300,46349
17775,13694,4081,920,199800,46350
6974,6224,750,1190,256300,46356
18342,12536,5806,924,155900,46360
298,232,66,-,178300,46365
2027,1729,298,786,139200,46366
15856,11502,4354,1140,213500,46368
1421,1194,227,1694,245500,46371
6565,6435,130,953,375300,46373
376,283,93,720,185000,46374
9724,7994,1730,1250,295400,46375
114,97,17,1063,169300,46376
31,14,17,-,-,46377
121,97,24,-,156300,46379
195,172,23,-,150700,46381
738,738,0,-,190900,46382
17189,11350,5839,1144,258400,46383
15395,13530,1865,1225,305400,46385
1182,1052,130,1280,218400,46390
2025,1677,348,1197,254600,46391
2900,2512,388,954,228200,46392
81,81,0,-,135200,46393
4954,3179,1775,970,162900,46394
2209,836,1373,904,61200,46402
4955,2351,2604,939,154800,46403
6200,3055,3145,995,88300,46404
4191,3028,1163,1136,123600,46405
3303,1550,1753,972,86300,46406
3921,1740,2181,807,55000,46407
6028,3637,2391,1016,96200,46408
2659,1184,1475,1194,73300,46409
16737,10644,6093,1267,192100,46410
1419,1081,338,947,146200,46501
0,0,0,-,-,46502
1140,963,177,861,169800,46504
3742,2825,917,934,224600,46506
3287,2872,415,1065,231300,46507
94,86,8,900,112500,46508
1322,1261,61,944,201500,46510
1687,1311,376,816,218900,46511
0,0,0,-,-,46513
16446,11858,4588,1084,170900,46514
11970,7372,4598,986,150400,46516
8606,5283,3323,942,168500,46517
616,584,32,672,168200,46524
11428,7857,3571,1061,192900,46526
7914,6250,1664,1056,237600,46528
11473,9910,1563,1594,316800,46530
574,539,35,-,150900,46531
520,455,65,880,121900,46532
4319,3410,909,634,159600,46534
1294,1070,224,799,208200,46536
245,223,22,634,125400,46537
1708,1457,251,954,258700,46538
1018,803,215,989,141100,46539
3946,3462,484,1074,297800,46540
1766,1522,244,1092,178400,46542
973,850,123,1074,284400,46543
12610,8377,4233,1018,151100,46544
11848,5850,5998,986,174700,46545
4336,3054,1282,867,232300,46550
2496,2108,388,811,211500,46552
1236,1102,134,1013,245800,46553
1711,1552,159,855,189400,46554
1191,995,196,977,203800,46555
313,10,303,992,-,46556
5404,4641,763,1137,208200,46561
2164,1692,472,795,185900,46562
8917,6619,2298,952,179800,46563
2413,1990,423,806,318800,46565
4103,3282,821,964,228200,46567
380,336,44,730,192900,46570
1705,1375,330,918,312900,46571
58,51,7,-,111200,46572
1270,1167,103,1054,219800,46573
3091,2677,414,839,167000,46574
8285,6205,2080,963,175700,46580
5889,3732,2157,1085,231900,46582
1710,1121,589,1074,242400,46590
13,13,0,-,-,46595
2118,419,1699,784,131600,46601
4047,2217,1830,991,71000,46613
12371,9613,2758,886,174900,46614
6298,3885,2413,971,127800,46615
2581,1531,1050,1019,136400,46616
4540,2646,1894,1422,231400,46617
7853,5769,2084,944,98400,46619
24,0,24,2222,-,46624
10871,7478,3393,1068,164500,46628
2679,2108,571,942,193100,46635
7276,5027,2249,1167,192000,46637
3123,2587,536,835,194300,46701
846,749,97,681,124100,46702
7302,5363,1939,892,221800,46703
39,39,0,-,77100,46704
721,564,157,711,144100,46705
7899,6349,1550,829,194900,46706
1711,1450,261,633,193100,46710
2489,1919,570,773,180200,46711
6144,4359,1785,817,164500,46714
1872,1578,294,810,124300,46721
3154,2697,457,781,198800,46723
9560,7577,1983,907,216700,46725
456,445,11,-,279200,46730
233,196,37,-,254500,46731
1004,733,271,838,166100,46732
7672,6297,1375,818,162500,46733
3055,2720,335,1116,187400,46737
3466,2911,555,855,156300,46738
1197,997,200,643,178900,46740
1377,1233,144,1297,303000,46741
1366,1089,277,898,253300,46742
853,699,154,962,186600,46743
653,642,11,-,233900,46745
1422,1043,379,832,157000,46746
982,909,73,910,156000,46747
2268,2044,224,1147,257700,46748
10981,8140,2841,862,142200,46750
6170,4118,2052,722,160300,46755
139,108,31,-,200000,46759
475,410,65,861,146100,46760
3894,3100,794,766,205200,46761
523,474,49,-,260800,46763
562,529,33,1023,226500,46764
2000,1893,107,1148,281900,46765
206,195,11,-,118800,46766
2963,2208,755,872,186200,46767
1041,895,146,801,203900,46770
64,21,43,-,-,46771
813,745,68,765,200500,46772
1330,1110,220,870,167000,46773
6975,5482,1493,961,169200,46774
661,542,119,736,187500,46776
2667,2058,609,905,185300,46777
46,46,0,-,74600,46778
798,776,22,-,183700,46779
325,297,28,531,184200,46781
2982,2712,270,861,283300,46783
850,752,98,839,190000,46784
488,422,66,788,182100,46785
27,27,0,-,-,46786
1517,1241,276,765,158500,46787
1194,1129,65,2111,233600,46788
65,0,65,-,-,46789
447,428,19,964,245900,46791
1607,1188,419,965,146900,46792
1646,1391,255,840,177500,46793
460,424,36,-,188600,46794
2623,2210,413,831,250500,46795
83,83,0,-,-,46796
1390,1285,105,985,222700,46797
417,349,68,1004,182600,46798
194,162,32,738,155800,46799
4919,1713,3206,880,131600,46802
4115,1727,2388,878,78800,46803
12638,8539,4099,1134,241000,46804
9730,5477,4253,858,131300,46805
9271,4817,4454,924,78000,46806
6355,3811,2544,970,133500,46807
8652,5499,3153,939,127800,46808
3927,2571,1356,804,122800,46809
5570,5136,434,1249,383000,46814
10535,8104,2431,942,186500,46815
7507,4303,3204,813,129100,46816
8020,6877,1143,1274,221000,46818
4090,2777,1313,948,157100,46819
12775,7437,5338,1044,202200,46825
15441,11344,4097,1101,194200,46835
10517,8945,1572,1398,314000,46845
15923,11479,4444,869,131700,46901
16004,10816,5188,929,154400,46902
1118,910,208,876,180700,46910
630,591,39,1548,202800,46911
498,455,43,826,169200,46913
1043,822,221,592,121400,46914
297,247,50,846,139100,46915
797,680,117,520,122200,46917
717,625,92,758,145100,46919
455,442,13,-,270800,46920
0,0,0,-,-,46922
3161,2427,734,924,157600,46923
515,480,35,715,122700,46926
1930,1540,390,805,119400,46928
1326,963,363,781,170500,46929
86,64,22,544,93300,46930
114,81,33,761,93800,46931
1408,1096,312,667,159700,46932
2795,2073,722,858,123400,46933
2360,2058,302,841,206700,46936
8,8,0,-,-,46937
1223,987,236,928,91300,46938
787,711,76,634,106100,46939
1085,900,185,924,119000,46940
337,291,46,935,162800,46941
62,45,17,-,-,46943
0,0,0,-,-,46945
32,10,22,-,-,46946
11047,8109,2938,791,110300,46947
221,207,14,-,115300,46950
700,613,87,1042,131800,46951
7890,5421,2469,785,129000,46952
8829,5793,3036,800,88400,46953
205,145,60,1049,76600,46957
301,261,40,-,91500,46958
262,184,78,459,-,46959
441,362,79,579,130200,46960
19,19,0,-,-,46961
3377,2831,546,679,152500,46962
11,0,11,-,-,46965
48,44,4,-,-,46967
63,63,0,-,73100,46968
8893,6311,2582,822,111200,46970
0,0,0,-,-,46971
610,458,152,821,182900,46974
5633,4372,1261,848,151100,46975
882,746,136,817,120900,46978
1750,1606,144,850,205000,46979
14,14,0,-,-,46980
1089,956,133,1006,175400,46982
7,7,0,-,-,46984
500,382,118,867,111600,46985
757,695,62,957,138700,46986
436,364,72,1080,135700,46987
363,246,117,940,161500,46988
1425,1145,280,751,182900,46989
238,238,0,-,140400,46990
800,648,152,881,105100,46991
7012,5459,1553,697,141800,46992
941,774,167,627,146100,46994
2599,1909,690,690,138800,46996
57,24,33,-,-,46998
4356,3549,807,848,190300,47001
486,402,84,735,155400,47003
4822,3871,951,776,237400,47006
37,37,0,-,235600,47010
535,535,0,-,212800,47011
4552,3393,1159,742,242100,47012
355,316,39,738,222700,47016
194,174,20,-,182500,47017
1842,1477,365,948,190100,47018
421,354,67,-,118100,47020
0,0,0,-,-,47021
1124,1107,17,-,292300,47022
907,723,184,1053,174000,47023
1064,833,231,980,114300,47024
9147,7582,1565,773,231000,47025
483,445,38,-,158000,47030
1941,1507,434,939,188800,47031
1235,1178,57,1558,222800,47032
0,0,0,-,-,47033
68,42,26,844,122500,47034
192,192,0,-,153400,47035
354,299,55,838,392900,47036
1685,1243,442,808,183200,47037
404,341,63,707,122100,47038
2305,1761,544,803,180500,47040
2245,1969,276,834,280200,47041
1721,1352,369,717,178200,47042
1969,1363,606,716,171400,47043
2690,2370,320,885,277600,47060
2785,2093,692,713,121100,47102
8,8,0,-,-,47104
1683,1276,407,956,205000,47106
833,707,126,597,121100,47108
219,212,7,-,176600,47110
6614,5643,971,906,261700,47111
6728,5469,1259,927,236900,47112
219,164,55,863,238700,47114
1078,972,106,655,194800,47115
211,197,14,-,114700,47116
1606,1341,265,843,203400,47117
1710,1455,255,531,117600,47118
4148,3871,277,1280,321500,47119
365,326,39,-,223800,47120
3937,3524,413,902,268200,47122
61,22,39,-,-,47123
1819,1777,42,1149,287300,47124
631,553,78,1006,148900,47125
1588,1455,133,745,261300,47126
8538,4916,3622,1027,162600,47129
20513,14686,5827,1090,203800,47130
414,372,42,-,215200,47135
1617,1507,110,900,239300,47136
526,403,123,645,116300,47137
1704,1532,172,1234,181100,47138
1055,793,262,649,124800,47140
583,503,80,-,198300,47141
226,215,11,-,178000,47142
1300,1189,111,1650,247500,47143
857,658,199,885,122400,47145
512,452,60,1424,227500,47147
20368,12722,7646,984,191800,47150
23,16,7,850,116700,47160
1286,1136,150,800,202100,47161
200,149,51,-,161700,47162
520,492,28,-,182800,47163
1355,1069,286,746,202000,47164
2482,2173,309,835,161800,47165
559,497,62,1366,169200,47166
6085,4833,1252,726,161500,47167
5992,4099,1893,831,148600,47170
7789,6693,1096,1152,249200,47172
36,36,0,-,-,47174
372,353,19,-,115400,47175
635,564,71,950,177500,47177
19696,12789,6907,1159,217600,47201
10338,8081,2257,963,234300,47203
2359,2005,354,732,165700,47220
433,377,56,-,189000,47223
127,114,13,-,274100,47224
66,66,0,-,108500,47225
83,33,50,795,102500,47226
636,494,142,769,166300,47227
1123,971,152,965,151800,47229
721,619,102,815,252000,47230
224,157,67,886,93900,47231
837,769,68,850,185400,47232
646,542,104,-,179300,47234
744,688,56,633,237900,47235
68,36,32,-,-,47236
8634,6314,2320,830,201100,47240
1930,1428,502,922,172000,47243
220,202,18,1031,333800,47244
1250,1029,221,1088,165300,47246
84,73,11,840,119500,47247
9364,6156,3208,857,179900,47250
727,633,94,939,91800,47260
64,44,20,1167,122700,47263
576,505,71,-,130700,47264
8082,6209,1873,916,143700,47265
244,224,20,525,137500,47270
809,665,144,923,131600,47272
746,690,56,1057,173800,47273
12432,8371,4061,956,187800,47274
416,274,142,1133,179400,47280
571,547,24,-,170300,47281
105,81,24,688,82500,47282
1478,1271,207,735,169400,47283
11025,7165,3860,865,70800,47302
10093,5477,4616,883,106600,47303
13485,8933,4552,951,161700,47304
1843,660,1183,744,77300,47305
0,0,0,-,-,47306
1915,1669,246,669,120300,47320
91,46,45,942,75000,47324
185,164,21,-,180800,47325
521,498,23,821,-,47326
1883,1503,380,779,118600,47327
2070,1658,412,825,167800,47330
9212,6445,2767,777,115300,47331
1363,1134,229,823,171800,47334
302,217,85,697,103700,47335
1234,993,241,829,83600,47336
71,49,22,1250,99000,47337
1065,866,199,686,102500,47338
172,140,32,850,98100,47339
1381,1032,349,845,165000,47340
909,740,169,671,159200,47341
956,733,223,913,131000,47342
71,67,4,733,103100,47344
524,454,70,859,144100,47345
1505,1305,200,890,147300,47346
3933,2894,1039,626,98300,47348
154,118,36,1045,103700,47351
264,209,55,911,159400,47352
2141,1748,393,794,158800,47353
491,447,44,872,115600,47354
1342,1060,282,712,102300,47355
2196,1703,493,823,172200,47356
470,429,41,761,131300,47357
366,304,62,648,144500,47358
1306,956,350,727,112400,47359
538,417,121,971,186900,47360
101,72,29,942,131300,47361
10829,7944,2885,792,131800,47362
9,0,9,-,-,47366
55,55,0,-,-,47367
836,661,175,927,103500,47368
599,481,118,675,161800,47369
80,70,10,960,78600,47370
4908,3718,1190,746,116100,47371
815,644,171,858,85600,47373
18639,11982,6657,816,121800,47374
652,541,111,664,84900,47380
75,57,18,1100,95600,47381
57,36,21,680,58800,47382
1002,865,137,928,128400,47383
736,670,66,720,124400,47384
642,479,163,714,140200,47385
647,600,47,-,179200,47386
204,178,26,1682,118800,47387
170,159,11,988,134800,47388
2128,1563,565,655,94100,47390
87,87,0,-,-,47392
485,416,69,874,134100,47393
3251,2561,690,780,110000,47394
3001,2784,217,833,172800,47396
19136,10355,8781,1181,333100,47401
15150,8418,6732,1114,222000,47403
10831,6020,4811,1159,243500,47404
0,0,0,-,-,47405
14,0,14,1188,-,47406
8820,3365,5455,1177,304600,47408
48,48,0,-,-,47420
12324,9672,2652,827,165200,47421
3441,2641,800,824,163600,47424
330,253,77,708,118300,47427
2882,2514,368,753,226200,47429
459,390,69,730,135600,47431
1971,1640,331,784,101900,47432
1437,1014,423,841,158300,47433
13,13,0,-,-,47434
78,78,0,-,-,47435
618,544,74,-,199600,47436
8,0,8,-,-,47437
1701,1270,431,779,97700,47438
3907,2650,1257,754,116900,47441
511,433,78,850,85900,47443
64,64,0,-,110800,47445
3840,3065,775,765,141200,47446
3253,2584,669,1032,245600,47448
153,133,20,-,190600,47449
598,407,191,681,131300,47451
2027,1507,520,848,168000,47452
184,53,131,-,-,47453
3007,2368,639,878,145400,47454
17,17,0,-,-,47455
612,581,31,975,183800,47456
0,0,0,-,-,47457
19,19,0,-,-,47458
1436,1314,122,841,202600,47459
4642,3748,894,888,177600,47460
1844,1691,153,658,190700,47462
155,104,51,709,120000,47464
212,122,90,678,109400,47465
0,0,0,-,-,47467
639,556,83,973,282600,47468
692,540,152,787,164300,47469
515,469,46,1295,191000,47470
1143,938,205,708,111600,47471
7008,4523,2485,857,155600,47501
1752,1216,536,816,71300,47512
702,648,54,688,164600,47513
109,109,0,-,253400,47514
391,372,19,-,198400,47515
395,338,57,625,188500,47516
147,124,23,1042,221200,47519
1226,881,345,729,140700,47520
346,346,0,-,246600,47521
122,29,93,751,-,47522
1230,986,244,781,121500,47523
238,230,8,-,74600,47524
136,121,15,-,194500,47525
806,692,114,785,260700,47527
231,187,44,483,72300,47528
391,300,91,763,127700,47529
433,373,60,-,258300,47531
1748,1467,281,858,196900,47532
272,182,90,-,74000,47535
331,233,98,722,213800,47537
438,367,71,575,150200,47541
4000,3109,891,827,183300,47542
9240,6569,2671,767,232300,47546
225,215,10,-,189600,47550
227,205,22,-,187500,47551
59,59,0,-,177300,47552
3166,2497,669,688,197000,47553
494,384,110,1017,151500,47557
1344,1165,179,814,255500,47558
623,403,220,680,85600,47561
1733,1394,339,553,195600,47562
557,396,161,932,148100,47564
2456,2092,364,643,130700,47567
202,135,67,793,100900,47568
7,7,0,-,-,47573
52,52,0,-,-,47574
445,361,84,-,280100,47575
220,220,0,-,138300,47576
415,289,126,582,209600,47577
279,254,25,600,108500,47578
1080,996,84,1100,249100,47579
86,86,0,-,-,47580
1220,1042,178,606,124900,47581
67,55,12,833,105900,47584
300,269,31,-,143600,47585
4914,3472,1442,665,137900,47586
316,278,38,906,112800,47588
188,158,30,-,208300,47590
10531,6506,4025,794,140800,47591
43,43,0,-,93200,47596
328,288,40,729,140000,47597
1263,1105,158,841,99800,47598
5277,4289,988,843,184900,47601
2151,1844,307,942,161500,47610
381,331,50,725,171600,47611
298,250,48,493,111500,47612
864,826,38,757,218300,47613
687,573,114,877,168100,47615
71,65,6,1042,77900,47616
698,623,75,811,157000,47619
5296,4028,1268,755,215600,47620
15003,12153,2850,1108,255200,47630
861,714,147,875,184300,47631
982,866,116,720,135700,47633
879,817,62,1146,140900,47634
2382,1701,681,666,159700,47635
472,414,58,842,165000,47637
1506,1305,201,916,263300,47638
1730,1444,286,894,257200,47639
387,351,36,768,110200,47640
1986,1563,423,906,193300,47648
609,502,107,743,163400,47649
4,4,0,-,-,47654
1837,1331,506,922,132600,47660
1503,1241,262,958,200100,47665
553,460,93,843,124200,47666
4695,3204,1491,959,140400,47670
23,17,6,650,112500,47683
421,82,339,1154,241400,47708
8206,4344,3862,857,131700,47710
13010,9759,3251,982,156200,47711
9847,6209,3638,933,173500,47712
4639,1765,2874,931,85200,47713
14155,8277,5878,951,124800,47714
13485,6919,6566,1009,191900,47715
7010,6145,865,1019,206800,47720
7660,7443,217,1632,270700,47725
13466,8196,5270,865,165800,47802
8872,6237,2635,895,146600,47803
4500,2758,1742,904,87700,47804
5460,4470,990,795,151900,47805
5537,1470,4067,910,58400,47807
0,0,0,-,-,47809
0,0,0,-,-,47831
497,423,74,1023,167500,47832
341,300,41,-,180200,47833
7667,5818,1849,866,135900,47834
0,0,0,-,-,47836
321,307,14,945,137100,47837
808,674,134,772,121100,47838
716,606,110,825,150700,47840
1049,796,253,722,102900,47841
4103,2901,1202,800,114100,47842
24,24,0,-,-,47845
283,273,10,-,130100,47846
402,322,80,759,57000,47847
558,430,128,670,97600,47848
176,156,20,-,156400,47849
830,655,175,666,97100,47850
0,0,0,-,-,47851
51,35,16,945,134700,47853
362,327,35,-,164100,47854
335,213,122,890,79300,47855
104,86,18,623,98400,47857
302,144,158,-,132800,47858
396,321,75,1110,107900,47859
184,106,78,591,56000,47860
255,224,31,975,168400,47861
586,474,112,894,88900,47862
92,92,0,-,-,47863
1,1,0,-,-,47865
205,194,11,-,177500,47866
1290,1058,232,953,151600,47868
6,6,0,-,-,47869
0,0,0,-,-,47870
172,121,51,921,92700,47871
2840,2279,561,684,149700,47872
1234,1092,142,673,130600,47874
0,0,0,-,-,47875
0,0,0,-,-,47876
1380,1089,291,734,93600,47879
10,10,0,-,-,47880
97,76,21,850,90900,47881
3454,2421,1033,846,142900,47882
84,79,5,-,78300,47884
3338,2732,606,715,154900,47885
2668,260,2408,954,257400,47901
7169,2959,4210,965,118700,47904
17432,10882,6550,1101,215500,47905
26288,11686,14602,1157,280900,47906
0,0,0,-,-,47907
17845,11762,6083,1091,203600,47909
12,10,2,-,60000,47916
132,121,11,-,204400,47917
2200,1623,577,823,150100,47918
919,802,117,983,263100,47920
461,376,85,900,168200,47921
513,383,130,1092,106100,47922
1459,1238,221,858,180200,47923
46,46,0,-,-,47924
11,11,0,-,-,47925
317,286,31,889,130400,47926
721,603,118,921,98500,47928
311,247,64,825,175700,47929
462,357,105,644,189000,47930
2148,1500,648,835,171600,47932
11499,8647,2852,822,176400,47933
595,492,103,771,149100,47940
482,377,105,956,169300,47941
326,276,50,763,116700,47942
334,290,44,-,339500,47943
1437,1146,291,883,129900,47944
749,560,189,681,155100,47946
522,438,84,475,98600,47948
561,496,65,1038,106700,47949
345,268,77,-,121400,47950
1047,835,212,828,102400,47951
1158,771,387,758,105500,47952
932,815,117,863,179000,47954
390,319,71,648,116600,47955
715,547,168,753,131700,47957
70,59,11,480,152200,47958
890,635,255,923,126700,47959
6317,4973,1344,852,179300,47960
850,640,210,843,158100,47963
40,39,1,-,88500,47964
227,185,42,968,151500,47965
167,143,24,569,61000,47966
316,303,13,1063,119600,47967
469,388,81,1091,205800,47968
99,77,22,1302,84300,47969
969,749,220,901,162700,47970
660,557,103,714,129900,47971
534,373,161,831,120200,47974
272,227,45,807,137500,47975
972,815,157,830,163200,47977
3992,3001,991,867,180900,47978
411,331,80,800,155400,47980
310,299,11,-,173300,47981
44,38,6,-,77800,47982
126,126,0,-,99800,47983
0,0,0,-,-,47986
1596,1403,193,784,139100,47987
497,452,45,-,114900,47989
537,444,93,950,111000,47990
566,361,205,581,127700,47991
638,551,87,1083,204200,47992
1436,1157,279,888,124700,47993
199,155,44,638,111200,47994
636,539,97,870,136900,47995
76,53,23,560,121500,47997
5174,4324,850,921,250000,48001
1301,1266,35,783,294600,48002
2383,2199,184,925,275200,48003
1830,1689,141,1141,294200,48005
1467,1373,94,1077,225900,48006
9337,7114,2223,1891,712000,48009
1740,1500,240,827,208400,48014
3702,2123,1579,627,145300,48015
5732,4213,1519,1255,251600,48017
13400,9232,4168,1335,129100,48021
1065,1034,31,942,246200,48022
2117,1759,358,1277,236600,48023
5568,5253,315,2397,514500,48025
6506,4731,1775,827,193600,48026
1170,1061,109,853,242800,48027
562,543,19,-,339100,48028
6799,4188,2611,1221,141200,48030
740,690,50,1017,239600,48032
8406,4257,4149,1242,195100,48033
7878,1922,5956,1275,259400,48034
14930,9433,5497,1111,181300,48035
9471,6702,2769,1018,201000,48036
20699,12945,7754,1255,246400,48038
3280,2926,354,879,170800,48039
4341,3718,623,955,185500,48040
1721,1517,204,867,296200,48041
11767,11274,493,1569,374100,48042
6772,4184,2588,896,169000,48043
19753,17671,2082,1340,349400,48044
11517,8164,3353,1085,243000,48045
16017,12944,3073,1109,297600,48047
3248,2674,574,1365,194800,48048
2183,1957,226,1075,226000,48049
530,478,52,-,329300,48050
6997,5931,1066,1064,247500,48051
2992,2539,453,896,277300,48054
6535,5375,1160,956,199200,48059
16684,10385,6299,1005,152000,48060
3527,2856,671,882,249000,48062
1558,1373,185,1208,297500,48063
1429,1354,75,845,280400,48064
4574,3760,814,1047,341000,48065
21156,13653,7503,1175,142700,48066
12923,8724,4199,1435,309200,48067
1173,1119,54,1795,435500,48069
2325,2235,90,2266,470600,48070
13685,8735,4950,1138,190300,48071
6852,5874,978,1436,289200,48072
16466,10807,5659,1245,302800,48073
3736,3356,380,1139,191800,48074
9850,5840,4010,1284,218900,48075
10503,7611,2892,1451,251300,48076
5202,4277,925,1090,276600,48079
11086,8848,2238,1070,188800,48080
9148,7767,1381,1272,202400,48081
7240,6301,939,1265,200600,48082
9866,6285,3581,1277,293300,48083
6979,3278,3701,1648,420000,48084
9117,8368,749,2213,395300,48085
9500,8266,1234,1144,205400,48088
12471,6876,5595,1187,117300,48089
11274,7418,3856,1231,138700,48091
10708,8361,2347,1186,205300,48092
10123,7490,2633,1123,197100,48093
7934,6437,1497,1339,399100,48094
2063,1986,77,796,393200,48095
1632,1360,272,1083,380500,48096
2207,1773,434,891,174800,48097
7407,6818,589,1720,485300,48098
11822,10190,1632,1181,174500,48101
24202,16029,8173,1760,455100,48103
17396,6284,11112,1548,481600,48104
15472,7925,7547,1603,485600,48105
12105,6694,5411,1316,378300,48108
95,0,95,-,-,48109
17957,12335,5622,1162,239400,48111
7915,7291,624,1333,384800,48114
11534,9889,1645,1229,355800,48116
4110,3643,467,1081,276600,48117
5611,4448,1163,1576,348500,48118
2612,999,1613,1407,236800,48120
4328,2597,1731,1116,113100,48122
13900,11140,2760,1280,192100,48124
8215,5711,2504,1298,119300,48125
15298,8721,6577,1222,200600,48126
13771,10022,3749,1231,217000,48127
4466,3887,579,1556,236900,48128
6151,5403,748,1681,453100,48130
3608,2495,1113,1112,246300,48131
2414,2209,205,851,181400,48133
9284,7786,1498,1106,252500,48134
11015,8725,2290,991,162400,48135
1933,1728,205,1135,280600,48137
4233,3860,373,1388,343000,48138
61,46,15,-,177100,48139
1170,1093,77,931,246000,48140
9569,4383,5186,1127,75700,48141
43,43,0,-,-,48143
4106,3866,240,1116,241200,48144
1242,1014,228,1038,227700,48145
15048,10509,4539,972,117400,48146
10516,9315,1201,1328,228600,48150
12493,10275,2218,1293,284300,48152
14707,13409,1298,1197,285800,48154
603,478,125,397,176000,48157
3110,2754,356,900,298100,48158
1077,903,174,1012,236300,48159
4948,4041,907,1097,251800,48160
11434,8560,2874,955,173200,48161
11807,9049,2758,912,192200,48162
3465,3294,171,1495,313700,48164
3358,2556,802,1583,352300,48165
4978,4034,944,1203,217000,48166
10104,7356,2748,1580,430500,48167
8955,8167,788,2248,546300,48168
8298,7560,738,1365,344500,48169
17370,13637,3733,1114,400800,48170
5121,4298,823,1130,232600,48173
12095,9048,3047,1053,151500,48174
8739,7354,1385,1161,384700,48176
169,169,0,-,181500,48177
13920,12723,1197,1231,392300,48178
1374,1071,303,1328,232900,48179
25256,16630,8626,1036,141200,48180
8361,6946,1415,1306,239800,48182
17390,13312,4078,1009,214000,48183
7077,4099,2978,924,142400,48184
22200,12500,9700,1123,183500,48185
13443,9267,4176,1083,167600,48186
19413,14105,5308,1435,341400,48187
16328,13453,2875,1536,356700,48188
5989,4755,1234,1228,286200,48189
51,51,0,-,219600,48190
1606,1421,185,1367,275500,48191
10718,7876,2842,995,159700,48192
6330,4142,2188,1088,205400,48193
12352,8174,4178,1102,165400,48195
27315,14606,12709,1203,274100,48197
16477,9651,6826,1197,178300,48198
7873,887,6986,841,401500,48201
7437,2241,5196,894,193700,48202
8544,4173,4371,799,76100,48203
8583,4502,4081,970,53600,48204
12759,5302,7457,1149,55700,48205
6577,3375,3202,923,102300,48206
11277,2910,8367,1040,193800,48207
3944,1372,2572,842,186700,48208
9111,5334,3777,843,82800,48209
8200,4696,3504,968,60100,48210
1684,752,932,985,66900,48211
11849,7238,4611,935,98200,48212
7528,4511,3017,837,52100,48213
9677,4108,5569,818,120500,48214
4362,2138,2224,897,105400,48215
2708,965,1743,860,225300,48216
2675,1611,1064,1083,45100,48217
3078,1628,1450,759,56100,48218
17939,10144,7795,1037,84500,48219
11242,7254,3988,1191,229700,48220
15472,10065,5407,1174,138700,48221
9248,5133,4115,1013,87700,48223
13471,7293,6178,1213,77900,48224
5925,3802,2123,1304,140800,48225
4149,378,3771,1714,307700,48226
15514,8773,6741,1034,70900,48227
18979,9430,9549,1086,55100,48228
3585,2323,1262,879,59300,48229
6891,5355,1536,1451,448200,48230
0,0,0,-,-,48233
12293,6704,5589,965,57100,48234
18562,10460,8102,1151,79400,48235
12596,11496,1100,1588,353000,48236
12722,7544,5178,1354,198500,48237
10289,4842,5447,950,58700,48238
14178,11102,3076,1355,145900,48239
6859,5089,1770,1326,120700,48240
0,0,0,-,-,48242
0,0,0,-,-,48243
5748,5004,744,1878,670600,48301
6692,5823,869,2048,624200,48302
6670,5891,779,1492,481500,48304
9666,9039,627,1645,522200,48306
18447,12486,5961,1499,329400,48307
11121,9052,2069,1625,394700,48309
14854,11717,3137,1368,263100,48310
13856,10437,3419,1176,253700,48312
13615,10107,3508,1152,248800,48313
9082,6991,2091,1397,309700,48314
11119,9693,1426,1181,357700,48315
11518,9239,2279,1380,362100,48316
12294,7043,5251,1227,248700,48317
2072,1519,553,1153,317900,48320
12843,9780,3063,1975,374000,48322
6163,5584,579,1776,467000,48323
6377,5858,519,1448,407500,48324
11347,5842,5505,1411,235300,48326
9467,6787,2680,1058,241600,48327
11326,7466,3860,1041,210800,48328
9919,8918,1001,1323,245800,48329
8946,6835,2111,1743,383200,48331
8098,5011,3087,1511,327200,48334
11147,4871,6276,1451,366500,48335
11570,8416,3154,1141,247600,48336
11276,4897,6379,1096,105800,48340
7684,3914,3770,917,124600,48341
6683,2556,4127,851,90600,48342
9508,6739,2769,1360,295200,48346
8898,8266,632,1231,421300,48348
2807,2406,401,1310,351600,48350
2948,2748,200,1529,290900,48353
3115,2851,264,838,314500,48356
3147,2719,428,1121,327100,48357
4287,2997,1290,1360,329500,48359
4731,4169,562,1377,362400,48360
5970,5125,845,1095,313600,48362
2402,2317,85,-,568400,48363
1626,1534,92,1133,386500,48367
544,535,9,-,393400,48370
9651,8532,1119,1244,352500,48371
5560,5042,518,2849,551500,48374
9955,7077,2878,1880,348900,48375
9117,4608,4509,1439,332000,48377
2649,2640,9,-,438700,48380
5449,4428,1021,1146,386800,48381
8550,7895,655,1685,404700,48382
4855,4595,260,1143,305300,48383
7341,6057,1284,1480,295000,48386
10541,7710,2831,1575,287900,48390
9649,5033,4616,975,309100,48393
620,500,120,972,161200,48401
48,42,6,775,107100,48410
29,29,0,-,-,48411
2192,2085,107,1273,228600,48412
3057,2270,787,731,143400,48413
1106,1025,81,892,182800,48414
3377,2998,379,895,197900,48415
1905,1593,312,854,212700,48416
1030,936,94,875,163700,48417
1713,1593,120,1193,246500,48418
986,848,138,1018,180100,48419
8804,7114,1690,797,177800,48420
2510,2331,179,698,208100,48421
2667,2270,397,807,162000,48422
14508,9645,4863,953,209400,48423
383,331,52,805,119500,48426
1199,965,234,805,132900,48427
2015,1838,177,1116,307000,48428
3618,3015,603,833,151600,48429
15347,12687,2660,1382,308500,48430
244,213,31,881,142200,48432
10135,8707,1428,982,197400,48433
71,54,17,-,134400,48434
867,798,69,1068,142200,48435
1475,1362,113,1125,251800,48436
266,161,105,738,114200,48437
2691,2584,107,1353,309000,48438
21286,15995,5291,1035,250800,48439
39,39,0,-,315200,48440
1611,1335,276,700,148200,48441
9352,7297,2055,1243,252500,48442
3823,2914,909,800,237200,48444
515,423,92,694,117600,48445
12136,9640,2496,976,206300,48446
996,875,121,1111,141400,48449
2369,1992,377,855,200900,48450
5833,5438,395,973,268600,48451
1945,1473,472,851,156500,48453
498,442,56,694,177500,48454
3036,2860,176,1202,353900,48455
315,272,43,842,145800,48456
3265,2624,641,864,164500,48457
8037,5450,2587,896,87100,48458
1044,909,135,713,200100,48460
3128,2742,386,900,193300,48461
5128,4879,249,940,318100,48462
1765,1602,163,835,179000,48463
855,788,67,1367,186600,48464
216,190,26,875,175000,48465
635,551,84,747,135800,48466
1261,1058,203,682,156700,48467
578,530,48,719,120000,48468
631,512,119,824,166700,48469
258,223,35,871,178500,48470
2412,1730,682,733,129700,48471
593,508,85,909,154200,48472
9447,8060,1387,1092,191700,48473
1020,900,120,823,158700,48475
238,230,8,1063,122200,48476
160,0,160,886,-,48502
9688,4888,4800,842,75400,48503
9937,5969,3968,895,48500,48504
7351,3652,3699,749,28300,48505
9875,6928,2947,897,91200,48506
12436,7127,5309,923,101200,48507
3963,3396,567,1061,127700,48509
3267,2253,1014,890,157800,48519
3925,2490,1435,1003,74000,48529
8214,4953,3261,929,157300,48532
13435,8878,4557,836,54900,48601
10849,6757,4092,902,70200,48602
12298,8104,4194,1019,181800,48603
4100,3048,1052,928,93200,48604
648,208,440,1017,44500,48607
5288,4623,665,903,166400,48609
1429,1314,115,788,125900,48610
2673,2258,415,901,166500,48611
3674,3083,591,694,156700,48612
417,387,30,1042,155200,48613
389,354,35,817,124700,48614
1086,876,210,808,129100,48615
2994,2494,500,744,153400,48616
3355,2544,811,826,154500,48617
2188,1826,362,760,120200,48618
239,216,23,775,125000,48619
34,34,0,-,110800,48620
468,360,108,731,135900,48621
2294,2034,260,754,123600,48622
5225,4612,613,1176,230300,48623
6963,6134,829,689,154000,48624
5377,4754,623,615,95900,48625
2286,2079,207,935,208600,48626
60,60,0,-,-,48627
835,791,44,1125,188200,48628
3825,3205,620,784,142300,48629
33,33,0,-,-,48630
1801,1402,399,772,164400,48631
2009,1866,143,846,130300,48632
108,108,0,-,246700,48633
1976,1880,96,754,156800,48634
725,691,34,-,135400,48635
402,370,32,-,135700,48636
1246,1132,114,736,140000,48637
5959,3827,2132,948,161200,48638
13425,10164,3261,928,191000,48640
13969,10350,3619,1100,194100,48642
1571,1338,233,587,122800,48647
603,552,51,785,151500,48649
2718,2388,330,750,136400,48650
2026,1487,539,797,156000,48651
716,704,12,-,160900,48652
4674,4197,477,801,161800,48653
1118,962,156,635,134200,48654
2332,2040,292,633,157100,48655
1884,1618,266,729,108800,48656
3195,2828,367,948,171400,48657
1969,1535,434,682,112400,48658
1008,874,134,857,118900,48659
4632,3610,1022,839,166500,48661
541,480,61,-,130000,48662
605,504,101,864,98000,48701
1487,1272,215,622,158700,48703
235,233,2,-,133400,48705
16835,13012,3823,887,142300,48706
11410,7898,3512,703,98500,48708
0,0,0,-,-,48710
432,388,44,695,119400,48720
211,211,0,-,186300,48721
1265,1203,62,1057,136100,48722
4774,3796,978,737,131300,48723
386,112,274,-,68100,48724
1059,932,127,541,167900,48725
2141,1802,339,788,121300,48726
365,328,37,833,153800,48727
190,169,21,990,168100,48728
618,555,63,641,146800,48729
2320,1766,554,608,139900,48730
668,493,175,841,105600,48731
5033,3437,1596,759,160200,48732
675,566,109,938,100000,48733
3409,2616,793,830,285100,48734
440,382,58,729,118300,48735
583,497,86,913,121000,48737
559,498,61,810,153700,48738
1686,1525,161,798,170600,48739
1145,1000,145,782,138300,48740
777,676,101,879,146100,48741
858,732,126,650,165400,48742
9,9,0,-,-,48743
1788,1637,151,806,141900,48744
566,484,82,1095,141400,48745
3304,2945,359,923,166300,48746
596,567,29,1135,121300,48747
708,650,58,637,142700,48748
472,441,31,870,116900,48749
4314,3490,824,675,110500,48750
381,346,35,775,108300,48754
1322,1070,252,921,160000,48755
1712,1445,267,851,85300,48756
1562,1352,210,909,172600,48757
1506,1269,237,694,116200,48759
581,536,45,856,150500,48760
441,383,58,-,113000,48761
496,476,20,-,198900,48762
1920,1697,223,851,154100,48763
247,230,17,575,142500,48765
551,490,61,818,94200,48766
869,745,124,942,126600,48767
3765,3198,567,719,137900,48768
691,585,106,665,101300,48770
4969,3658,1311,795,120300,48801
664,513,151,968,145600,48806
296,259,37,832,103500,48807
2904,2222,682,1246,243600,48808
4204,3153,1051,839,189900,48809
1872,1449,423,766,157800,48811
7621,6167,1454,870,178500,48813
728,655,73,-,237500,48815
194,31,163,-,137500,48816
2377,1742,635,879,164200,48817
963,832,131,752,185000,48818
915,870,45,823,219000,48819
6874,5872,1002,1098,318400,48820
2444,2329,115,1003,237700,48821
850,794,56,1332,282900,48822
21117,9264,11853,1127,261100,48823
0,0,0,-,-,48824
3,0,3,-,-,48825
6203,5158,1045,978,206600,48827
1260,1019,241,786,150300,48829
1381,1216,165,805,155400,48831
519,484,35,770,146300,48832
824,673,151,993,171500,48834
1053,956,97,793,202000,48835
5397,4803,594,1068,262700,48836
8352,6837,1515,1034,239300,48837
6880,5045,1835,910,190400,48838
6209,3707,2502,1032,261800,48840
319,270,49,903,176300,48841
9012,5928,3084,1245,211500,48842
18460,14255,4205,1221,323100,48843
339,309,30,754,147700,48845
7143,4987,2156,804,172300,48846
2301,1826,475,819,164400,48847
2894,2570,324,880,249200,48848
2016,1739,277,772,212900,48849
1607,1365,242,665,170700,48850
856,788,68,1088,136900,48851
67,62,5,-,94000,48852
288,211,77,432,109900,48853
7460,6151,1309,1136,240600,48854
6050,5370,680,1485,317200,48855
292,232,60,700,141900,48856
1211,1057,154,1223,130300,48857
17426,8508,8918,862,168000,48858
0,0,0,-,-,48859
507,368,139,771,162800,48860
746,704,42,1051,173500,48861
16,16,0,-,72500,48862
9141,6016,3125,1281,358100,48864
614,463,151,782,123400,48865
1746,1471,275,868,158500,48866
11278,8345,2933,834,145600,48867
76,76,0,-,93200,48870
832,694,138,965,205400,48871
2628,2138,490,972,217600,48872
437,407,30,775,198800,48873
61,61,0,-,108900,48874
4143,3185,958,1088,213000,48875
1692,1234,458,953,187900,48876
846,790,56,637,107400,48877
590,498,92,580,139300,48878
7081,5754,1327,884,215100,48879
2407,1937,470,853,134000,48880
1898,1515,383,675,219400,48881
2678,2364,314,841,154600,48883
1622,1499,123,912,168700,48884
444,402,42,1110,182400,48885
675,605,70,1111,124600,48886
2425,1929,496,899,147300,48888
632,536,96,990,137500,48889
734,559,175,1057,170000,48890
1042,926,116,872,123300,48891
1895,1605,290,807,195700,48892
2121,1993,128,1475,171000,48893
796,750,46,839,250400,48894
4767,4190,577,1005,272500,48895
68,68,0,-,178700,48896
650,545,105,811,208000,48897
11201,7813,3388,1033,128600,48906
15702,9156,6546,1003,117600,48910
16827,9428,7399,933,136900,48911
8229,3564,4665,1037,139900,48912
4360,2644,1716,1087,112600,48915
15367,9173,6194,1085,211300,48917
1913,176,1737,919,130200,48933
8787,4685,4102,1055,139600,49001
8248,5788,2460,910,223000,49002
7336,5423,1913,1059,183500,49004
11061,3660,7401,991,198000,49006
4300,1088,3212,1017,103400,49007
6612,4318,2294,1005,202400,49008
19196,12379,6817,1089,330300,49009
6569,5594,975,1061,204200,49010
904,768,136,933,140300,49011
1261,1083,178,845,248000,49012
1753,1393,360,757,140100,49013
8244,5941,2303,997,159100,49014
11764,8294,3470,980,171000,49015
8622,6286,2336,946,134800,49017
2363,2035,328,1023,182300,49021
12671,7402,5269,797,140500,49022
12715,8561,4154,1208,248700,49024
683,597,86,918,161400,49026
75,62,13,907,216200,49027
2369,1849,520,880,129300,49028
568,512,56,788,202700,49029
863,720,143,1076,119300,49030
3449,2727,722,847,217700,49031
1111,918,193,791,160100,49032
704,648,56,956,247600,49033
816,725,91,880,205300,49034
9319,6962,2357,913,155000,49036
8673,5184,3489,843,90600,49037
3690,2718,972,944,196200,49038
1399,1152,247,793,123800,49040
1825,1389,436,780,161500,49042
968,534,434,792,144600,49043
2259,1891,368,824,170900,49045
2859,2619,240,1064,268100,49046
6183,4476,1707,750,182000,49047
9654,5754,3900,1032,158300,49048
550,507,43,907,257500,49050
1062,1020,42,822,257000,49051
363,324,39,842,188600,49052
2689,2342,347,970,222800,49053
2523,2137,386,878,161900,49055
1272,1109,163,555,150600,49056
2225,1734,491,746,111300,49057
7678,6351,1327,928,210600,49058
1021,865,156,742,-,49060
684,605,79,876,201200,49061
40,40,0,-,-,49063
1467,1102,365,756,163400,49064
2931,2383,548,856,235400,49065
238,205,33,1071,187500,49066
1598,1382,216,903,186800,49067
6400,5072,1328,904,196800,49068
820,747,73,756,200700,49070
4296,3944,352,1161,261900,49071
1135,1017,118,974,169000,49072
1880,1570,310,861,165400,49073
45,0,45,423,-,49074
54,38,16,-,63300,49075
1445,1142,303,904,185800,49076
4035,3293,742,1106,189600,49078
5296,4107,1189,841,214600,49079
6054,5007,1047,982,234400,49080
2525,2145,380,831,159300,49082
3050,2831,219,973,329800,49083
19,13,6,-,169600,49084
10174,7902,2272,1099,287300,49085
2251,2026,225,968,279800,49087
1414,1351,63,-,261900,49088
740,638,102,841,121400,49089
5866,4580,1286,914,251500,49090
7514,5331,2183,817,173800,49091
752,647,105,1100,138300,49092
7390,5406,1984,824,174000,49093
1403,1025,378,778,127000,49094
1031,902,129,1092,250800,49095
1199,1068,131,889,173600,49096
4634,3908,726,933,224400,49097
2297,1711,586,1253,150500,49098
2337,1786,551,879,172400,49099
1270,1083,187,1040,225500,49101
666,603,63,1028,250300,49102
4251,2689,1562,878,224500,49103
0,0,0,-,-,49104
2016,1556,460,1139,243400,49106
4238,3358,880,987,174500,49107
1315,1067,248,617,164400,49111
4179,3377,802,998,231600,49112
771,609,162,806,158900,49113
76,76,0,-,272400,49115
50,44,6,-,-,49116
1812,1381,431,749,448400,49117
59,40,19,1013,168800,49119
14691,11528,3163,911,166800,49120
868,772,96,803,300000,49125
557,458,99,738,162500,49126
4417,3440,977,1103,287000,49127
1475,1245,230,984,247000,49128
310,289,21,-,586900,49129
533,432,101,838,332600,49130
16598,12274,4324,945,202900,49201
8735,4755,3980,915,104100,49202
15303,10299,5004,992,150900,49203
974,833,141,803,205100,49220
15601,10768,4833,986,158700,49221
4369,3140,1229,846,119800,49224
488,409,79,733,172300,49227
2130,1793,337,972,178300,49228
1329,1184,145,1034,217200,49229
4554,4140,414,1116,252800,49230
946,788,158,819,213800,49232
1120,1027,93,927,219400,49233
998,913,85,1166,280800,49234
766,670,96,1051,172100,49235
1895,1655,240,853,199500,49236
1168,1067,101,806,179300,49237
729,629,100,1203,192700,49238
3762,3525,237,1178,272300,49240
842,763,79,1031,223000,49241
5648,4050,1598,770,182900,49242
1549,1215,334,822,146900,49245
1245,1137,108,773,230100,49246
2147,1780,367,906,138600,49247
351,312,39,1271,143800,49248
1393,1270,123,862,220900,49249
2280,1880,400,774,159300,49250
2360,2022,338,1083,193600,49251
1051,839,212,741,121500,49252
1305,1234,71,1109,226300,49253
1653,1417,236,1038,167300,49254
609,539,70,954,121300,49255
1456,1161,295,778,112800,49256
5,2,3,-,-,49258
1019,902,117,945,201100,49259
74,47,27,-,218800,49261
491,440,51,1034,122500,49262
0,0,0,-,-,49263
568,507,61,744,200200,49264
2129,1934,195,903,245100,49265
1245,1142,103,930,155900,49266
1532,1306,226,858,244500,49267
405,368,37,-,165600,49268
1977,1785,192,967,200100,49269
2126,1938,188,761,269700,49270
942,776,166,947,140600,49271
1036,999,37,-,196700,49272
1463,1193,270,742,160800,49274
382,359,23,1219,201800,49276
1019,954,65,1726,201500,49277
362,337,25,1067,167500,49279
50,46,4,-,37300,49282
1206,948,258,1253,206000,49283
1037,844,193,869,148900,49284
2549,2103,446,814,208100,49285
5933,4704,1229,954,221800,49286
804,726,78,773,235800,49287
565,411,154,889,131800,49288
25,24,1,-,108300,49289
7176,6806,370,2074,510000,49301
2997,2896,101,1056,387100,49302
272,233,39,724,190200,49303
1780,1301,479,854,110700,49304
1125,966,159,800,122800,49305
4155,3950,205,1068,340700,49306
6977,4385,2592,877,179600,49307
786,701,85,713,124600,49309
1048,948,100,1033,171300,49310
77,63,14,864,123200,49312
9141,8501,640,1297,357600,49315
9446,8450,996,1299,338800,49316
484,418,66,1176,215100,49318
6964,6266,698,1060,247600,49319
90,65,25,719,121400,49320
6315,4261,2054,1073,244300,49321
434,382,52,1559,146300,49322
3708,3661,47,1339,271900,49323
779,725,54,914,309700,49325
1392,1299,93,1044,194500,49326
3204,2798,406,796,189600,49327
1540,1418,122,812,209400,49328
3373,2969,404,870,190900,49329
1926,1604,322,1027,253200,49330
6901,5886,1015,1109,293600,49331
1545,1368,177,813,177200,49332
4738,4269,469,1129,295900,49333
48,48,0,-,-,49335
1565,1310,255,985,127100,49336
5103,4341,762,1021,191000,49337
679,546,133,947,152900,49338
833,783,50,697,233700,49339
1076,888,188,697,150000,49340
14622,13240,1382,1251,347700,49341
644,524,120,963,142300,49342
2155,1902,253,694,236200,49343
1751,1457,294,1289,272900,49344
4913,4156,757,968,261400,49345
2206,1954,252,861,222800,49346
508,455,53,981,174300,49347
5086,4065,1021,1123,247200,49348
3170,2721,449,846,139300,49349
8525,4768,3757,1083,298700,49401
673,637,36,857,162200,49402
913,822,91,1125,258900,49403
3271,2638,633,1041,271200,49404
626,585,41,817,143200,49405
448,425,23,-,470500,49406
3896,3427,469,918,210300,49408
50,50,0,-,165600,49409
693,598,95,892,162000,49410
793,755,38,1051,221400,49411
4537,3824,713,860,180600,49412
2501,2412,89,1113,230600,49415
13581,10599,2982,1101,287800,49417
12258,8742,3516,1218,296300,49418
2925,2639,286,-,301800,49419
2397,1939,458,777,153300,49420
2232,1928,304,734,148000,49421
17738,13137,4601,1143,254800,49423
18991,14445,4546,1157,270000,49424
1242,1085,157,698,165800,49425
13467,11938,1529,1199,338100,49426
10123,8584,1539,1373,276100,49428
30,30,0,-,-,49430
7465,5396,2069,850,218600,49431
42,42,0,-,-,49434
1352,1251,101,1041,299800,49435
807,737,70,956,232100,49436
2583,2274,309,772,201100,49437
694,194,500,791,163100,49440
14826,11273,3553,1080,194000,49441
16116,11209,4907,889,116100,49442
0,0,0,-,-,49443
10094,7065,3029,941,159200,49444
8299,7413,886,1163,209800,49445
808,720,88,856,191500,49446
1652,1437,215,738,266200,49448
1256,1101,155,719,282400,49449
1033,726,307,1205,128100,49450
2227,1982,245,951,197100,49451
816,748,68,800,114700,49452
1180,1048,132,766,487400,49453
1858,1418,440,792,174000,49454
1938,1547,391,697,144900,49455
8757,7240,1517,1184,294500,49456
4332,3983,349,1071,194000,49457
45,42,3,-,55600,49458
525,453,72,1037,98300,49459
3161,2905,256,1145,358700,49460
3768,3249,519,874,245600,49461
10787,9430,1357,976,316700,49464
17335,6505,10830,1207,224100,49503
17339,10065,7274,1145,222600,49504
13649,8824,4825,1248,227900,49505
12676,9622,3054,1305,338600,49506
13274,8048,5226,1114,179600,49507
15986,9764,6222,1179,257900,49508
10191,7120,3071,983,183400,49509
8435,3671,4764,1229,279900,49512
11128,6281,4847,1176,220300,49519
12330,9663,2667,1335,292500,49525
9326,6454,2872,1161,270200,49534
4149,2666,1483,1119,247500,49544
12968,8887,4081,1275,389100,49546
12585,9222,3363,1129,149500,49548
8912,7027,1885,856,166500,49601
113,103,10,-,-,49611
646,555,91,858,252300,49612
266,259,7,-,230100,49613
1178,1124,54,963,203900,49614
1997,1720,277,775,257000,49615
906,825,81,594,204100,49616
1441,1342,99,657,268000,49617
343,301,42,1313,152300,49618
406,381,25,1250,135800,49619
993,842,151,1118,207000,49620
1442,1300,142,1059,342300,49621
1140,1004,136,1020,209900,49622
449,399,50,775,119600,49623
549,509,40,979,163700,49625
123,121,2,-,117300,49626
137,112,25,-,550000,49627
58,56,2,-,272400,49628
1084,905,179,1032,347100,49629
715,636,79,1042,440200,49630
2362,1949,413,796,120700,49631
442,411,31,850,125300,49632
1534,1386,148,1110,174000,49633
65,56,9,-,93100,49634
1447,1188,259,918,332300,49635
312,294,18,-,744100,49636
1225,1077,148,1309,228100,49637
346,314,32,1063,114900,49638
999,880,119,744,136900,49639
596,550,46,805,285000,49640
424,310,114,703,109500,49642
2891,2532,359,900,247300,49643
858,797,61,860,178400,49644
730,595,135,948,129300,49645
3849,3217,632,712,167500,49646
1152,1017,135,1257,506400,49648
2340,1947,393,1041,246900,49649
1249,1136,113,1303,238400,49650
3006,2553,453,879,165100,49651
791,766,25,889,532100,49653
269,228,41,-,691400,49654
1253,1196,57,813,171800,49655
793,632,161,922,120600,49656
1360,1072,288,806,181700,49657
3143,2695,448,792,141700,49659
5864,4845,1019,787,170500,49660
2200,1859,341,795,144400,49663
932,853,79,1368,436700,49664
1624,1413,211,788,139000,49665
247,189,58,793,130700,49667
1432,1238,194,1077,146100,49668
771,725,46,1375,455600,49670
83,83,0,-,643300,49674
452,387,65,725,272300,49675
1597,1447,150,951,241200,49676
2794,2180,614,713,122900,49677
537,503,34,1023,168300,49679
722,679,43,1090,155400,49680
1770,1535,235,1227,367400,49682
900,731,169,785,173500,49683
9366,6219,3147,1216,375700,49684
8361,6689,1672,1338,309200,49685
11687,8306,3381,1209,295500,49686
887,763,124,1094,163300,49688
717,661,56,763,141200,49689
2563,2364,199,1279,329100,49690
4080,3762,318,1309,289300,49696
368,281,87,694,217000,49701
283,246,37,634,172200,49705
2139,1687,452,943,208500,49706
9999,7643,2356,642,134900,49707
1752,1615,137,718,132500,49709
158,149,9,-,184800,49710
3837,3159,678,955,252400,49712
933,816,117,889,204600,49713
1314,1137,177,585,164100,49715
377,345,32,-,252100,49716
26,26,0,-,-,49717
269,211,58,950,183500,49718
663,549,114,763,219300,49719
4452,3528,924,985,265100,49720
5706,4763,943,753,170000,49721
34,27,7,-,496400,49722
439,392,47,1140,163300,49724
327,321,6,-,216500,49725
602,549,53,824,250500,49726
2954,2544,410,821,187700,49727
181,147,34,-,118600,49728
628,560,68,1056,199100,49729
876,834,42,877,185200,49730
790,695,95,791,148500,49733
9065,6925,2140,876,200800,49735
228,212,16,-,141700,49736
4388,3454,934,855,153200,49738
3193,2835,358,997,332600,49740
396,377,19,675,129900,49743
326,286,40,961,208100,49744
442,346,96,716,117700,49745
1683,1419,264,644,143300,49746
923,883,40,875,170200,49747
104,97,7,-,108100,49748
2247,1930,317,862,202600,49749
850,765,85,863,175500,49751
282,251,31,-,126800,49752
772,706,66,839,147400,49753
848,731,117,894,171400,49755
2144,1852,292,889,154000,49756
204,99,105,1164,834600,49757
748,685,63,775,164600,49759
379,336,43,1090,134700,49760
319,299,20,-,144500,49762
37,0,37,-,-,49764
1831,1532,299,753,114300,49765
1009,920,89,691,155400,49766
201,168,33,572,198600,49768
662,519,143,989,152800,49769
7530,5335,2195,1077,309900,49770
783,735,48,850,168000,49774
18,18,0,-,250000,49775
707,605,102,434,124200,49776
942,913,29,867,220700,49777
2240,1961,279,622,110400,49779
632,554,78,708,139300,49780
1887,1280,607,707,150000,49781
388,362,26,817,322400,49782
7837,5160,2677,782,146400,49783
0,0,0,-,-,49784
847,406,441,839,99000,49788
70,67,3,-,225000,49791
98,98,0,-,164300,49793
819,641,178,918,162700,49795
138,107,31,-,267700,49796
898,819,79,682,164800,49799
5453,4441,1012,667,157800,49801
2643,2028,615,861,109300,49802
200,176,24,-,115600,49805
241,229,12,-,258500,49806
1275,1160,115,1003,170800,49807
96,88,8,-,254000,49808
355,318,37,1042,156100,49812
447,436,11,-,142900,49814
128,128,0,-,119100,49815
329,311,18,683,174100,49816
226,213,13,-,181000,49817
477,475,2,-,161100,49818
97,81,16,517,105400,49820
476,443,33,725,145100,49821
124,96,28,920,322000,49822
119,119,0,-,208000,49825
34,34,0,-,166700,49826
419,310,109,848,118100,49827
7639,5147,2492,667,139000,49829
262,252,10,-,123200,49831
54,54,0,-,124100,49833
221,196,25,842,127100,49834
336,307,29,825,160800,49835
479,430,49,627,179000,49836
4006,3373,633,782,145300,49837
246,225,21,-,168800,49838
157,143,14,-,155100,49839
360,335,25,1250,190800,49840
2931,2084,847,731,150000,49841
475,380,95,528,116700,49847
55,46,9,-,125000,49848
4908,3956,952,769,145600,49849
49,42,7,-,-,49852
580,506,74,725,189500,49853
3016,2549,467,653,117500,49854
14311,8754,5557,992,245100,49855
5473,4118,1355,691,127100,49858
257,249,8,-,229200,49861
1670,1318,352,718,150900,49862
62,62,0,-,81400,49863
19,12,7,-,175000,49864
3295,2785,510,900,191700,49866
1854,1405,449,809,98400,49868
1506,1129,377,789,100600,49870
192,169,23,629,75600,49871
91,84,7,-,164300,49872
39,39,0,-,164600,49873
431,351,80,567,196300,49874
604,583,21,-,117200,49876
27,26,1,-,137500,49877
1423,1361,62,875,165200,49878
562,493,69,905,89800,49879
468,434,34,682,130400,49880
161,149,12,-,209400,49881
67,57,10,730,208000,49883
265,186,79,686,140800,49884
769,735,34,1308,218200,49885
197,191,6,-,123700,49886
1057,909,148,691,150200,49887
229,216,13,1375,140900,49891
921,836,85,847,187200,49892
594,563,31,742,176700,49893
353,353,0,-,141600,49894
395,321,74,438,164200,49895
547,401,146,418,165300,49896
145,141,4,-,74500,49901
122,106,16,633,33300,49902
147,135,12,333,56700,49903
704,627,77,1000,169300,49905
1057,696,361,475,115800,49908
149,135,14,-,303100,49910
1265,998,267,529,109500,49911
430,387,43,717,114300,49912
3153,2447,706,678,92700,49913
270,217,53,772,69400,49915
1328,1139,189,770,190500,49916
91,84,7,850,93300,49917
64,53,11,-,285400,49918
79,74,5,-,115600,49919
1913,1729,184,916,119800,49920
90,74,16,-,-,49921
290,244,46,800,120600,49922
323,274,49,-,117000,49925
133,129,4,-,65500,49927
87,84,3,-,58800,49929
2779,1827,952,749,211900,49930
3063,1365,1698,853,221200,49931
467,431,36,784,81500,49934
2722,2203,519,445,103800,49935
3829,2994,835,590,95500,49938
59,59,0,-,96000,49942
1284,993,291,495,142800,49945
1663,1288,375,606,119500,49946
326,318,8,-,193800,49947
258,235,23,-,99600,49948
550,511,39,594,221600,49950
46,40,6,-,107100,49952
1194,974,220,557,103300,49953
163,158,5,-,87800,49955
393,375,18,-,157100,49958
136,110,26,-,48300,49959
105,103,2,-,59800,49960
60,60,0,-,83800,49961
113,103,10,-,189800,49962
281,216,65,765,83300,49963
232,219,13,-,222900,49965
211,197,14,-,90500,49967
993,853,140,662,79000,49968
565,492,73,481,245800,49969
137,135,2,-,116300,49970
218,207,11,-,59700,49971
213,183,30,1408,352300,50001
615,502,113,852,190300,50002
3522,2715,807,858,380800,50003
364,344,20,810,129500,50005
648,446,202,577,117200,50006
186,186,0,-,294300,50007
317,277,40,583,122500,50008
8458,5949,2509,1201,261800,50009
14065,7613,6452,981,243200,50010
0,0,0,-,-,50012
0,0,0,-,-,50013
13244,4883,8361,1083,312700,50014
564,496,68,681,121400,50020
11910,8856,3054,1434,295000,50021
3709,2444,1265,763,145600,50022
17216,12116,5100,1191,327200,50023
1403,1006,397,711,103500,50025
238,183,55,595,102300,50026
93,50,43,818,100000,50027
717,594,123,697,197400,50028
275,221,54,917,72900,50029
18,16,2,-,58800,50031
243,209,34,-,-,50032
7,4,3,-,-,50033
153,129,24,-,113300,50034
3323,3035,288,1097,297100,50035
6710,5291,1419,804,172900,50036
85,85,0,-,-,50038
157,104,53,890,-,50039
77,62,15,533,72700,50040
39,12,27,-,-,50041
96,75,21,765,117000,50042
413,355,58,539,115100,50044
668,595,73,1005,225000,50046
2307,1904,403,1144,223400,50047
305,245,60,857,110300,50048
2685,2057,628,731,123700,50049
306,267,39,919,102300,50050
118,116,2,-,-,50051
31,26,5,-,-,50052
1124,891,233,842,197400,50054
443,383,60,847,195400,50055
498,426,72,1054,184300,50056
112,112,0,-,213100,50057
778,596,182,723,147500,50058
951,691,260,725,109200,50060
789,765,24,1406,516600,50061
292,247,45,-,163100,50062
1011,828,183,1023,262900,50063
43,29,14,635,158000,50064
208,158,50,731,75800,50065
106,91,15,-,206500,50066
122,119,3,-,112100,50067
115,113,2,-,118300,50068
372,330,42,933,216800,50069
575,489,86,883,187500,50070
337,258,79,678,71800,50071
1042,902,140,835,298500,50072
469,423,46,678,275700,50073
121,114,7,-,435300,50074
313,216,97,-,140400,50075
606,530,76,650,102700,50076
50,40,10,590,75700,50078
30,16,14,-,41700,50101
46,46,0,-,61100,50102
170,152,18,650,90000,50103
55,44,11,825,191700,50104
552,482,70,887,265100,50105
478,432,46,650,112000,50106
356,249,107,857,79400,50107
197,138,59,575,46300,50108
1282,1121,161,923,337400,50109
17,17,0,-,-,50110
6269,4428,1841,1156,285700,50111
4752,3270,1482,863,198100,50112
1220,976,244,797,139600,50115
74,68,6,-,152800,50116
58,40,18,886,215000,50117
349,327,22,1138,177100,50118
156,130,26,938,98900,50119
188,163,25,-,177700,50120
550,473,77,688,110100,50122
372,305,67,546,106800,50123
1679,1413,266,1260,299900,50124
7559,5641,1918,975,248700,50125
2670,1765,905,904,118100,50126
0,0,0,-,-,50127
183,151,32,536,106300,50128
2411,1763,648,753,154700,50129
683,580,103,840,143100,50130
9659,6984,2675,1284,347100,50131
175,123,52,575,120300,50132
246,172,74,784,132100,50133
321,248,73,971,277500,50134
618,447,171,791,178800,50135
157,128,29,975,105000,50136
46,29,17,-,164600,50137
4764,3801,963,815,169900,50138
455,423,32,1021,137500,50139
1024,617,407,715,120300,50140
228,213,15,713,139000,50141
369,328,41,739,124300,50142
224,209,15,770,300800,50143
1093,697,396,544,122200,50144
45,45,0,-,232700,50145
171,102,69,963,264700,50146
166,129,37,463,58100,50147
162,135,27,1025,96400,50148
311,244,67,858,143900,50149
329,291,38,783,119200,50150
286,265,21,1703,142700,50151
49,42,7,-,179500,50152
390,347,43,594,155600,50153
235,188,47,629,173500,50154
56,49,7,-,93900,50155
1785,1541,244,865,219500,50156
299,212,87,773,101000,50157
11722,8203,3519,865,130500,50158
260,197,63,863,176400,50160
823,729,94,846,204600,50161
553,360,193,1301,182900,50162
290,259,31,-,97700,50163
295,272,23,-,151600,50164
16,16,0,-,125000,50165
727,678,49,835,235700,50166
288,236,52,850,170500,50167
342,292,50,825,232800,50168
1089,939,150,789,211100,50169
1223,954,269,772,193500,50170
1173,831,342,822,188700,50171
287,231,56,1104,205400,50173
421,368,53,796,109600,50174
3581,2622,959,908,186500,50201
202,162,40,589,115900,50206
1044,732,312,577,156500,50207
8005,5549,2456,830,161900,50208
596,537,59,1250,314100,50210
6203,5341,862,883,293800,50211
1311,1089,222,729,207000,50212
3149,2040,1109,838,164600,50213
326,282,44,-,354600,50214
1164,967,197,1032,199400,50216
214,184,30,718,151400,50217
124,118,6,700,106600,50218
5355,3722,1633,995,272600,50219
3610,2409,1201,883,146200,50220
157,148,9,917,233800,50222
121,92,29,594,86300,50223
1406,1164,242,830,172700,50225
2490,2286,204,746,390600,50226
34,27,7,-,73200,50227
843,699,144,796,197200,50228
434,421,13,-,365200,50229
462,392,70,495,147700,50230
68,62,6,825,106300,50231
262,198,64,939,256500,50232
557,502,55,781,198600,50233
210,191,19,436,162500,50234
155,114,41,750,192900,50235
779,663,116,1097,185900,50236
1366,1307,59,765,326300,50237
500,461,39,739,82600,50238
69,59,10,-,-,50239
871,761,110,939,297200,50240
52,40,12,1300,168800,50241
156,118,38,866,233300,50242
126,114,12,1200,175000,50243
741,661,80,877,235600,50244
294,213,81,571,117900,50246
888,700,188,749,167200,50247
1840,1424,416,963,218500,50248
566,479,87,725,109400,50249
1115,879,236,700,202700,50250
559,474,85,905,171500,50251
113,110,3,-,364300,50252
60,60,0,-,168800,50254
20,20,0,-,-,50255
287,287,0,-,135400,50256
360,320,40,836,218000,50257
403,328,75,825,100000,50258
1040,879,161,979,318600,50261
121,112,9,688,77400,50262
10874,7609,3265,1296,332500,50263
216,161,55,787,-,50264
14418,9516,4902,1065,267600,50265
17387,8716,8671,1285,325100,50266
400,309,91,822,80100,50268
55,47,8,-,49000,50269
271,220,51,660,137500,50271
79,70,9,-,47500,50272
3738,2884,854,948,216100,50273
103,81,22,1118,126800,50274
255,227,28,492,192500,50275
866,788,78,484,243400,50276
178,150,28,940,85500,50277
310,252,58,936,170400,50278
6562,769,5793,1166,286900,50309
13349,9124,4225,1043,213800,50310
6697,3214,3483,1019,228000,50311
7771,5016,2755,1057,274400,50312
7124,5273,1851,1077,161800,50313
4014,1863,2151,977,146700,50314
15395,9421,5974,977,164000,50315
5427,3607,1820,963,137300,50316
14297,10137,4160,1079,165200,50317
0,0,0,-,-,50319
8724,6585,2139,1110,207700,50320
3478,2103,1375,1098,294100,50321
12604,8976,3628,1151,263900,50322
5718,5050,668,1479,456600,50323
2066,1608,458,1355,251800,50324
7101,5241,1860,1099,379000,50325
4792,3767,1025,1219,303000,50327
13298,9074,4224,868,134100,50401
167,115,52,394,77500,50420
1254,1012,242,805,121400,50421
1077,886,191,989,110200,50423
723,523,200,643,109200,50424
41,34,7,775,62500,50426
90,90,0,-,85900,50427
4091,3121,970,769,253900,50428
214,174,40,944,70800,50430
79,54,25,644,82000,50431
108,94,14,830,86000,50432
56,56,0,-,55000,50433
259,244,15,869,-,50434
303,229,74,625,148400,50435
2288,1717,571,761,164300,50436
1755,1354,401,795,176500,50438
125,116,9,-,91400,50439
144,102,42,655,99300,50440
2238,1611,627,623,124000,50441
159,130,29,781,151500,50444
219,185,34,725,163300,50446
449,388,61,515,82400,50447
322,272,50,618,123800,50448
342,278,64,629,98600,50449
1345,996,349,640,157500,50450
256,210,46,850,53400,50451
364,236,128,1016,108100,50452
218,186,32,860,162500,50453
67,53,14,-,-,50454
144,137,7,669,118500,50455
719,513,206,689,119100,50456
184,155,29,667,94200,50457
821,683,138,808,145100,50458
1246,1047,199,690,148000,50459
169,116,53,520,220000,50460
2335,1854,481,748,158800,50461
230,197,33,830,167000,50464
92,78,14,792,34200,50465
764,540,224,792,160900,50466
29,19,10,967,160400,50467
664,492,172,776,139600,50468
646,538,108,543,188900,50469
124,116,8,-,67800,50470
290,218,72,866,112900,50471
1114,927,187,843,196600,50472
94,78,16,-,141000,50473
578,473,105,648,155600,50475
280,235,45,623,120300,50476
91,55,36,633,75000,50477
385,301,84,709,94400,50478
322,277,45,775,112200,50479
382,349,33,443,79300,50480
301,249,52,1058,220800,50482
276,250,26,675,150000,50483
153,139,14,-,111100,50484
12139,8117,4022,779,139700,50501
419,317,102,758,104400,50510
3186,2266,920,892,180600,50511
557,467,90,611,128600,50514
123,96,27,1188,26700,50515
311,262,49,763,128000,50516
391,290,101,567,110700,50517
135,126,9,495,144200,50518
286,199,87,525,114400,50519
60,53,7,-,46500,50520
3,0,3,-,-,50521
262,211,51,1050,81300,50522
240,198,42,404,137900,50523
186,170,16,650,200000,50524
1547,1067,480,763,117300,50525
42,33,9,-,83800,50527
136,96,40,666,-,50528
380,293,87,935,119300,50529
463,332,131,542,138900,50530
125,124,1,-,128100,50531
370,274,96,663,169400,50532
1493,1019,474,991,103600,50533
436,335,101,585,87600,50535
1865,1321,544,599,121300,50536
233,187,46,754,70900,50538
217,201,16,710,71100,50539
428,322,106,-,98500,50540
453,332,121,597,97800,50541
381,322,59,535,118200,50542
568,493,75,675,116600,50543
234,212,22,692,150500,50544
71,63,8,-,-,50545
155,125,30,563,-,50546
2438,1732,706,731,177700,50548
21,21,0,-,51400,50551
31,26,5,-,-,50552
712,530,182,738,85600,50554
84,80,4,-,-,50556
337,266,71,633,119800,50557
260,217,43,1086,109700,50558
175,112,63,1025,-,50559
263,160,103,781,77300,50560
255,194,61,641,106500,50561
170,137,33,1146,75500,50562
1074,870,204,648,156500,50563
183,168,15,792,71900,50565
153,134,19,1200,171100,50566
97,90,7,913,168800,50567
527,421,106,717,124300,50568
316,252,64,658,86000,50569
74,52,22,708,114300,50570
166,148,18,-,52300,50571
24,17,7,-,-,50573
990,784,206,801,104700,50574
294,259,35,681,77100,50575
141,111,30,817,106000,50576
203,171,32,696,100700,50577
257,213,44,675,97500,50578
1091,867,224,760,136800,50579
324,272,52,563,78000,50581
95,90,5,775,70000,50582
1167,849,318,620,129200,50583
446,386,60,641,99200,50585
118,104,14,765,108300,50586
4693,3145,1548,836,178800,50588
348,247,101,678,57700,50590
181,155,26,979,169600,50591
49,26,23,1111,32500,50592
18,18,0,-,46000,50593
130,84,46,625,183300,50594
3707,2532,1175,877,129100,50595
489,389,100,604,182800,50597
395,336,59,508,103600,50598
204,181,23,780,200600,50599
1007,833,174,831,114200,50601
616,462,154,615,103600,50602
186,167,19,825,97000,50603
705,597,108,628,150800,50604
70,56,14,-,55000,50605
349,303,46,613,112300,50606
167,160,7,-,153100,50607
25,25,0,-,205400,50608
173,168,5,688,212800,50609
131,111,20,375,77500,50611
115,96,19,-,281500,50612
16751,10843,5908,1176,258300,50613
4184,2976,1208,628,135000,50616
869,675,194,791,147200,50619
23,15,8,-,104700,50620
653,516,137,944,185300,50621
1213,1066,147,825,246300,50622
69,69,0,-,170500,50623
626,565,61,708,243500,50624
391,314,77,525,76600,50625
589,478,111,723,196800,50626
1332,960,372,730,122400,50627
527,380,147,652,140900,50628
820,685,135,724,193900,50629
595,440,155,746,196900,50630
91,81,10,-,100500,50631
507,438,69,628,134300,50632
155,79,76,530,72500,50633
332,292,40,815,187500,50634
657,531,126,893,145000,50635
924,742,182,898,150000,50636
1434,1154,280,681,181000,50638
615,530,85,810,159200,50641
222,189,33,1094,181300,50642
1095,988,107,1090,240800,50643
3590,2786,804,770,174000,50644
623,564,59,806,113000,50645
817,769,48,607,278200,50647
1506,1335,171,923,210800,50648
5,5,0,-,-,50649
296,203,93,992,105400,50650
1363,1086,277,838,172600,50651
43,37,6,-,102900,50652
203,170,33,592,150900,50653
153,120,33,1594,176700,50654
303,224,79,629,139600,50655
47,43,4,-,137500,50657
1047,833,214,742,133700,50658
2314,1859,455,835,187800,50659
431,354,77,982,177100,50660
2837,2227,610,760,108200,50662
73,73,0,-,120200,50664
1069,863,206,877,214700,50665
327,292,35,682,168200,50666
318,292,26,1125,210400,50667
503,435,68,633,171000,50668
1038,783,255,828,165300,50669
850,731,119,750,172100,50670
91,55,36,-,111800,50671
204,148,56,731,127800,50672
82,69,13,-,120800,50673
1552,1242,310,839,156300,50674
909,689,220,1015,148000,50675
851,751,100,875,145200,50676
4691,3490,1201,880,221600,50677
485,451,34,625,123700,50680
188,168,20,925,138500,50681
633,531,102,940,181600,50682
13213,8862,4351,846,183400,50701
9009,5356,3653,926,145800,50702
7506,4331,3175,926,92500,50703
3304,2290,1014,922,142600,50707
3919,2746,1173,676,120700,50801
711,559,152,600,114200,50830
9,8,1,-,-,50831
888,664,224,646,99800,50833
38,22,16,-,-,50835
155,120,35,729,118800,50836
152,145,7,535,107500,50837
28,26,2,-,-,50839
293,225,68,650,147100,50840
1075,810,265,753,116300,50841
37,33,4,-,108900,50842
208,158,50,755,81700,50843
277,249,28,838,104300,50845
518,360,158,825,85400,50846
22,19,3,-,57500,50847
100,75,25,746,73100,50848
1135,763,372,597,127500,50849
820,636,184,925,115500,50851
329,271,58,584,210700,50853
918,677,241,712,151400,50854
66,51,15,-,-,50857
314,271,43,1411,140500,50858
285,237,48,1059,162500,50859
61,58,3,-,-,50860
117,96,21,1068,90000,50861
43,40,3,-,110400,50862
83,68,15,792,90800,50863
793,620,173,737,98600,50864
981,740,241,712,177700,51001
1019,831,188,918,145300,51002
708,623,85,750,226300,51003
419,308,111,1014,100700,51004
640,500,140,754,171700,51005
475,371,104,450,83000,51006
225,225,0,-,227900,51007
75,53,22,1194,136300,51008
55,46,9,475,65000,51009
204,176,28,725,107900,51010
42,34,8,740,-,51011
2690,1811,879,725,127900,51012
274,224,50,1327,132100,51014
24,24,0,-,125000,51015
425,364,61,925,88300,51016
280,223,57,845,312700,51018
195,158,37,813,88000,51019
219,147,72,631,106300,51020
374,343,31,788,169400,51022
1236,872,364,881,148500,51023
829,699,130,1005,317100,51024
791,589,202,833,118100,51025
418,402,16,860,233300,51026
463,387,76,1100,219300,51027
872,706,166,689,195000,51028
104,93,11,-,-,51029
642,531,111,875,267600,51030
5214,3430,1784,903,208900,51031
174,152,22,1281,185000,51033
777,600,177,771,119100,51034
719,592,127,640,182900,51035
225,196,29,817,242200,51036
158,105,53,713,164800,51037
580,492,88,-,181800,51038
1017,869,148,748,226900,51039
1517,1120,397,828,140400,51040
2510,1827,683,808,253600,51041
74,70,4,-,84100,51044
28,26,2,-,155000,51045
694,545,149,804,161200,51046
319,287,32,800,130500,51047
162,124,38,716,105400,51048
248,201,47,636,102700,51049
1033,856,177,1014,219100,51050
21,19,2,-,162500,51051
459,386,73,914,235900,51052
445,395,50,843,96500,51053
1925,1457,468,1232,292600,51054
500,388,112,828,208800,51055
164,161,3,725,150700,51056
434,347,87,546,116100,51058
288,223,65,617,104200,51060
198,153,45,607,90600,51061
211,188,23,1146,284200,51062
468,358,110,913,116400,51063
569,7,562,676,-,51101
6464,4181,2283,887,124400,51103
8679,5616,3063,955,193000,51104
3759,1699,2060,855,84700,51105
11102,7904,3198,1080,186300,51106
2142,1936,206,597,166600,51108
1526,1294,232,916,120400,51109
30,0,30,1016,-,51111
2414,1769,645,842,182500,51201
199,199,0,-,189800,51230
152,142,10,-,179600,51231
319,257,62,1075,97700,51232
424,370,54,771,208000,51234
381,317,64,481,250600,51235
678,579,99,782,131400,51237
539,470,69,698,176000,51238
1018,895,123,1005,231300,51239
642,556,86,1167,193600,51240
770,625,145,843,270100,51241
119,101,18,-,185200,51242
283,258,25,625,88100,51243
61,59,2,-,89700,51244
454,393,61,933,139500,51245
1405,1126,279,773,232900,51246
1901,1305,596,1070,238200,51247
707,547,160,869,154400,51248
1466,1144,322,770,150000,51249
3163,2426,737,907,286000,51250
5556,3861,1695,796,180400,51301
514,450,64,718,415800,51331
175,152,23,985,181600,51333
2869,2150,719,743,104900,51334
428,345,83,752,120400,51338
46,46,0,-,116700,51340
11,11,0,-,62500,51341
576,470,106,480,101500,51342
75,64,11,-,111500,51343
170,69,101,946,129200,51345
941,753,188,721,125800,51346
627,557,70,1008,180600,51347
159,123,36,463,81000,51350
2274,1701,573,904,256100,51351
498,421,77,825,128800,51354
525,375,150,935,441400,51355
345,259,86,785,121300,51357
524,427,97,652,146900,51358
4279,3157,1122,1005,256000,51360
57,56,1,-,74000,51363
359,313,46,1036,131900,51364
166,147,19,-,115300,51365
138,118,20,979,119400,51366
5210,3604,1606,720,192100,51401
363,267,96,816,163800,51430
204,140,64,630,83300,51431
16,15,1,-,76300,51432
210,102,108,733,145000,51433
354,262,92,806,217200,51436
374,270,104,722,86300,51439
121,114,7,-,156300,51440
174,157,17,646,97400,51441
3481,2642,839,763,146200,51442
655,553,102,531,181500,51443
128,125,3,-,148400,51444
1158,944,214,657,117500,51445
209,185,24,700,94200,51446
62,58,4,1125,242900,51447
223,182,41,775,114000,51448
791,629,162,761,119300,51449
676,584,92,633,177200,51450
43,37,6,338,90800,51451
82,70,12,533,119700,51452
189,145,44,910,55700,51453
483,420,63,660,139200,51454
1066,890,176,696,125400,51455
523,420,103,499,150500,51458
25,21,4,-,84200,51459
44,28,16,706,52000,51460
498,402,96,480,159100,51461
403,298,105,906,155800,51462
198,182,16,693,165000,51463
232,203,29,670,119900,51465
476,394,82,632,193300,51466
254,225,29,587,175400,51467
14269,9446,4823,997,140400,51501
15250,10363,4887,964,252600,51503
1389,1171,218,1115,161200,51510
115,105,10,800,141100,51520
857,636,221,883,173100,51521
148,124,24,1281,117600,51523
429,350,79,696,192900,51525
650,588,62,593,331900,51526
159,144,15,-,115300,51527
252,184,68,717,135400,51528
852,643,209,922,139400,51529
355,263,92,716,150700,51530
374,295,79,643,132300,51531
284,223,61,800,91400,51532
358,291,67,1005,133500,51533
3469,2886,583,838,241500,51534
746,618,128,952,135500,51535
200,179,21,794,152700,51536
2664,1954,710,854,161800,51537
104,91,13,-,156300,51540
124,105,19,-,156300,51541
363,345,18,-,362400,51542
169,129,40,850,145800,51543
316,285,31,597,84500,51544
119,101,18,450,81300,51545
1155,929,226,847,201500,51546
170,166,4,-,219000,51548
149,119,30,875,149300,51549
65,59,6,-,107500,51550
658,573,85,867,184300,51551
95,64,31,725,110000,51552
362,322,40,700,207000,51553
36,36,0,-,257100,51554
2106,1599,507,761,180900,51555
135,114,21,975,110000,51556
325,282,43,919,160900,51557
251,210,41,867,70000,51558
721,530,191,980,190700,51559
748,484,264,847,160300,51560
285,250,35,-,381800,51561
244,208,36,939,158000,51562
274,220,54,1066,209000,51563
227,190,37,739,108100,51564
248,152,96,834,117300,51565
3159,2158,1001,783,116200,51566
528,390,138,872,188200,51570
244,206,38,945,225000,51571
188,152,36,622,125000,51572
412,339,73,931,113000,51573
652,546,106,1120,279400,51575
699,629,70,819,291500,51576
473,360,113,831,112700,51577
65,55,10,-,94500,51578
798,615,183,881,182300,51579
2429,1489,940,768,121300,51601
59,59,0,-,217900,51630
178,139,39,853,123800,51631
2466,1749,717,664,135200,51632
198,169,29,633,86500,51636
108,104,4,-,73500,51637
576,459,117,688,115700,51638
382,279,103,758,136800,51639
632,501,131,728,120400,51640
114,108,6,-,117600,51645
297,242,55,827,103400,51646
87,81,6,-,-,51647
132,107,25,-,142100,51648
138,119,19,1087,175900,51649
115,108,7,-,47800,51650
52,43,9,1063,63900,51651
614,500,114,733,140900,51652
501,438,63,690,213200,51653
109,80,29,1322,227500,51654
12,8,4,-,83300,51656
18724,11679,7045,916,168900,52001
7158,5342,1816,1051,273400,52002
5548,4914,634,953,261500,52003
163,122,41,956,122400,52030
2175,1865,310,747,231300,52031
583,507,76,376,260300,52032
1392,1057,335,887,210600,52033
515,400,115,721,131900,52035
59,44,15,613,139500,52036
385,342,43,633,187500,52037
176,154,22,750,168800,52038
384,379,5,-,269900,52039
2286,1927,359,1085,229900,52040
629,509,120,750,211500,52041
678,504,174,788,230400,52042
921,719,202,839,145000,52043
76,71,5,-,-,52044
1047,832,215,896,248900,52045
926,699,227,980,259300,52046
228,194,34,675,101000,52047
106,87,19,-,81500,52048
584,504,80,917,167800,52049
204,172,32,795,211100,52050
1333,1076,257,791,189300,52052
423,325,98,635,281600,52053
347,295,52,1090,209100,52054
91,87,4,-,168300,52056
3510,2838,672,737,168800,52057
3598,2665,933,746,148700,52060
320,266,54,825,133900,52064
275,246,29,763,206900,52065
48,40,8,-,83300,52066
1546,1442,104,1023,345700,52068
648,490,158,798,153500,52069
450,361,89,1025,167300,52070
75,62,13,945,207400,52071
200,101,99,755,113500,52072
550,493,57,1037,257900,52073
70,60,10,-,211400,52074
67,63,4,-,135400,52075
953,711,242,663,139500,52076
126,109,17,779,80500,52077
312,292,20,575,205400,52078
356,344,12,850,248200,52079
5063,3764,1299,813,249500,52101
764,526,238,743,225700,52132
271,256,15,-,208900,52133
101,92,9,513,231300,52134
309,274,35,507,120300,52135
2293,1775,518,721,153300,52136
208,182,26,-,216700,52140
559,492,67,634,96400,52141
746,449,297,869,183200,52142
445,380,65,1102,193800,52144
435,417,18,586,214600,52146
372,312,60,708,151300,52147
864,707,157,588,176400,52151
310,253,57,650,133500,52154
464,408,56,665,122400,52155
246,227,19,925,216800,52156
703,504,199,744,164200,52157
163,143,20,433,132800,52158
1098,823,275,861,149200,52159
421,351,70,345,197400,52160
629,512,117,715,173500,52161
1340,885,455,851,129300,52162
144,126,18,582,106000,52163
85,82,3,-,121200,52164
442,353,89,653,270800,52165
61,60,1,-,115000,52166
203,117,86,929,156600,52168
165,128,37,730,113300,52169
259,244,15,-,226100,52170
441,368,73,950,189300,52171
2655,2020,635,730,158300,52172
1468,1017,451,912,162100,52175
515,440,75,-,181800,52201
482,376,106,739,232600,52202
872,736,136,737,255800,52203
3117,2443,674,922,217000,52205
929,865,64,585,296300,52206
129,111,18,850,45800,52207
1274,1009,265,773,119700,52208
407,313,94,753,200300,52209
327,265,62,940,167900,52210
1140,815,325,920,161300,52211
176,176,0,-,152600,52212
1650,1370,280,894,254400,52213
1137,976,161,825,235400,52214
353,346,7,681,116700,52215
637,419,218,878,165400,52216
215,181,34,1167,87100,52217
669,618,51,594,170500,52218
59,52,7,-,98500,52219
85,62,23,-,171900,52220
116,92,24,1324,226700,52221
288,239,49,-,113100,52222
560,477,83,892,195200,52223
823,689,134,718,168800,52224
177,173,4,-,144300,52225
1110,935,175,973,299600,52227
1407,1305,102,1194,301600,52228
320,250,70,857,169900,52229
196,171,25,730,228700,52231
95,86,9,771,234800,52232
2875,1940,935,846,200500,52233
405,252,153,1179,217800,52235
203,203,0,-,226100,52236
506,426,80,381,135200,52237
15369,7818,7551,1065,241100,52240
9777,5309,4468,1021,286000,52241
23,0,23,-,-,52242
9582,5531,4051,1215,293300,52245
9632,4159,5473,1049,327100,52246
1963,1475,488,806,257400,52247
738,656,82,757,154600,52248
406,351,55,992,154400,52249
199,185,14,492,120700,52251
33,33,0,-,139000,52252
1083,890,193,792,222200,52253
424,287,137,1125,96500,52254
532,413,119,933,137900,52255
101,82,19,-,-,52257
1697,1291,406,752,149200,52301
17199,13326,3873,963,232900,52302
275,237,38,720,162500,52305
605,493,112,594,159700,52306
57,9,48,627,-,52307
86,72,14,550,107100,52308
202,175,27,853,159000,52309
2721,2181,540,664,192800,52310
22,21,1,-,76900,52312
179,148,31,1009,204700,52313
1788,1598,190,886,279800,52314
496,426,70,628,178400,52315
639,490,149,655,151300,52316
8484,5949,2535,1221,314700,52317
426,360,66,1105,186900,52318
460,337,123,742,132400,52320
167,142,25,783,121400,52321
790,679,111,892,249100,52322
362,290,72,771,85000,52323
715,647,68,861,320900,52324
197,174,23,950,230000,52325
297,245,52,742,127200,52326
1357,1016,341,1080,288400,52327
1036,966,70,962,343000,52328
274,217,57,-,171400,52329
363,298,65,907,163900,52330
633,571,62,775,227800,52332
2805,2466,339,1202,347800,52333
54,44,10,-,258300,52334
229,211,18,832,110900,52335
1053,910,143,957,213200,52336
342,266,76,955,148200,52337
1364,1284,80,1067,384600,52338
1499,1014,485,729,117500,52339
2324,1834,490,1336,317900,52340
442,429,13,-,359700,52341
1209,847,362,954,136300,52342
53,18,35,-,-,52344
538,504,34,774,225200,52345
400,350,50,917,245600,52346
519,477,42,742,150600,52347
26,25,1,-,83600,52348
3215,2563,652,838,173800,52349
465,431,34,-,274500,52351
717,586,131,738,209800,52352
3747,2411,1336,912,155700,52353
130,123,7,-,191300,52354
118,104,14,850,113200,52355
1185,886,299,844,205200,52356
1472,1219,253,1010,235900,52358
121,112,9,718,162500,52359
2044,1342,702,758,198000,52361
404,346,58,720,130000,52362
1340,205,1135,783,143800,52401
18558,12044,6514,992,188700,52402
10008,7687,2321,857,190700,52403
17965,12100,5865,885,159700,52404
11436,8421,3015,1043,173600,52405
2911,2852,59,1275,424500,52411
12146,7950,4196,955,109600,52501
367,264,103,573,176300,52530
2344,1932,412,741,140700,52531
470,371,99,1060,110300,52533
183,153,30,729,73900,52534
374,308,66,864,155800,52535
355,300,55,621,140000,52536
2510,2057,453,900,153400,52537
447,363,84,718,106600,52540
221,195,26,1025,110600,52542
161,124,37,-,107300,52543
3362,2149,1213,779,114100,52544
25,23,2,-,82500,52548
181,165,16,817,113400,52549
263,243,20,928,115100,52550
279,255,24,-,96800,52551
273,236,37,850,201900,52552
707,543,164,942,144300,52553
536,457,79,650,94400,52554
79,45,34,992,89300,52555
5413,3298,2115,877,168200,52556
0,0,0,-,-,52557
135,131,4,-,-,52560
391,262,129,675,102200,52561
32,30,2,-,57800,52562
619,487,132,773,115700,52563
729,598,131,707,170800,52565
82,74,8,-,77500,52566
258,203,55,907,179000,52567
36,31,5,-,-,52568
258,257,1,-,71300,52569
334,294,40,550,102000,52570
555,466,89,815,198700,52571
364,260,104,683,89400,52572
63,56,7,-,112500,52573
213,159,54,813,79600,52574
141,139,2,-,143800,52576
5713,3751,1962,880,143700,52577
281,234,47,726,112200,52580
111,77,34,775,163100,52581
156,128,28,1250,104200,52583
216,204,12,788,96100,52584
330,269,61,-,124600,52585
259,188,71,-,107100,52586
49,49,0,-,-,52588
470,393,77,634,128500,52590
1115,704,411,902,119900,52591
56,40,16,-,231300,52593
189,175,14,-,183900,52594
249,136,113,731,88900,52595
12812,9125,3687,921,125500,52601
266,256,10,-,112500,52619
343,266,77,408,166200,52620
223,182,41,967,105000,52621
747,638,109,843,186700,52623
284,246,38,-,194600,52624
893,772,121,753,201100,52625
485,387,98,742,88800,52626
5548,4201,1347,830,111700,52627
89,58,31,1188,50000,52630
29,29,0,-,237500,52631
5102,3346,1756,803,108400,52632
289,205,84,1108,-,52635
1049,845,204,905,183900,52637
181,144,37,772,156300,52638
718,670,48,814,146400,52639
476,423,53,820,126000,52640
4753,3284,1469,812,164100,52641
155,124,31,618,155000,52644
1275,1052,223,772,135000,52645
132,122,10,900,150000,52646
46,20,26,770,137500,52647
306,278,28,775,216700,52649
294,222,72,1197,263300,52650
163,130,33,821,76700,52651
27,27,0,-,170800,52652
1388,985,403,799,152400,52653
660,527,133,808,140400,52654
1776,1263,513,826,138700,52655
953,832,121,575,209000,52656
32,28,4,-,158300,52657
382,344,38,1272,226500,52658
590,473,117,604,108600,52659
144,101,43,-,209400,52660
44,24,20,-,115000,52701
400,355,45,738,233700,52720
327,265,62,1000,180100,52721
16473,12477,3996,1150,300800,52722
2170,1986,184,1022,274100,52726
156,128,28,-,240000,52727
432,339,93,812,118300,52728
324,295,29,638,163900,52729
2100,1643,457,818,175900,52730
337,287,50,739,134900,52731
11197,7580,3617,768,118700,52732
134,130,4,-,104400,52737
1169,982,187,635,135900,52738
332,202,130,957,100000,52739
2958,2352,606,933,241100,52742
216,181,35,786,199300,52745
390,308,82,1174,314800,52746
846,653,193,773,204100,52747
3848,3202,646,905,312400,52748
349,333,16,-,219000,52749
197,176,21,838,178400,52750
395,330,65,1017,169400,52751
193,166,27,750,116700,52752
2294,1781,513,1120,306700,52753
540,488,52,942,196300,52754
800,673,127,960,219800,52755
627,614,13,1479,314800,52756
102,92,10,685,120300,52757
115,90,25,1292,185000,52758
95,77,18,-,255200,52759
373,301,72,-,162500,52760
11887,8707,3180,971,164500,52761
207,175,32,1375,227600,52765
341,281,60,950,122800,52766
109,109,0,-,379300,52767
525,447,78,857,275800,52768
257,184,73,981,304500,52769
52,19,33,-,-,52771
2155,1739,416,812,213600,52772
1052,800,252,815,200600,52773
47,39,8,843,115200,52774
1837,1410,427,748,197900,52776
550,465,85,788,142600,52777
1650,1234,416,851,175700,52778
1020,0,1020,927,-,52801
3896,2796,1100,978,84400,52802
9200,6077,3123,871,157900,52803
11345,7526,3819,909,148400,52804
11541,8087,3454,976,188100,52806
7446,3846,3600,910,323900,52807
788,660,128,804,234000,53001
943,777,166,972,290800,53002
65,65,0,-,192800,53003
1454,1290,164,941,244700,53004
8519,7204,1315,1810,386300,53005
808,647,161,1120,229100,53006
850,410,440,937,216300,53007
3078,2545,533,909,276400,53010
905,758,147,980,244200,53011
7815,5862,1953,1059,390600,53012
1369,1219,150,976,250300,53013
3429,2784,645,744,201700,53014
1066,957,109,888,213900,53015
162,121,41,938,164400,53016
1909,1867,42,-,477300,53017
3225,2486,739,1492,485200,53018
736,611,125,1030,227200,53019
1517,1317,200,1108,322700,53020
1711,1347,364,987,278000,53021
7938,5988,1950,1315,353000,53022
558,527,31,913,215600,53023
8379,5613,2766,1124,353700,53024
9727,7278,2449,1113,290200,53027
8313,6578,1735,1126,449800,53029
18,9,9,-,-,53031
2301,1726,575,835,174200,53032
2455,2375,80,1607,398900,53033
627,446,181,955,214800,53034
948,826,122,1200,270400,53035
1354,1110,244,1151,347100,53036
4277,3184,1093,1128,312000,53037
1618,1310,308,1147,298700,53038
1655,1293,362,906,212200,53039
3215,2756,459,981,312500,53040
2823,2325,498,824,223100,53042
867,762,105,1166,369300,53044
9593,7295,2298,1867,443500,53045
707,588,119,-,255900,53046
33,26,7,-,277800,53047
1518,928,590,1084,215400,53048
958,823,135,489,270900,53049
3042,2384,658,860,195600,53050
16164,12123,4041,1257,341700,53051
733,699,34,688,229800,53057
1367,966,401,1367,505900,53058
739,626,113,880,313200,53059
2181,1694,487,750,182100,53061
635,543,92,751,242300,53063
918,803,115,919,247400,53065
15015,11694,3321,1263,402800,53066
396,374,22,-,398500,53069
1930,1648,282,842,264600,53070
12046,9090,2956,1352,424300,53072
6271,4734,1537,867,237600,53073
5752,3739,2013,1024,276200,53074
1357,1058,299,890,273000,53075
1150,1067,83,1257,450400,53076
749,646,103,1074,343900,53078
598,484,114,900,243200,53079
2320,1369,951,959,291700,53080
19091,11520,7571,866,169700,53081
8938,6621,2317,1001,235500,53083
5090,3738,1352,859,229200,53085
3880,3143,737,1073,363000,53086
126,88,38,713,163300,53088
7727,6116,1611,1270,387100,53089
8952,6868,2084,1132,267500,53090
861,698,163,1013,195800,53091
8325,6455,1870,1962,440200,53092
761,687,74,975,248100,53093
7104,4630,2474,1039,223900,53094
11906,8613,3293,1015,286500,53095
2379,2259,120,-,525600,53097
4521,3065,1456,1100,239700,53098
4,4,0,-,-,53099
1569,1484,85,1069,381200,53103
2231,1972,259,1279,292500,53104
11952,8852,3100,1029,295100,53105
1385,1282,103,1391,282100,53108
8567,5327,3240,977,201000,53110
844,729,115,859,226400,53114
6856,4871,1985,1012,225900,53115
2876,2538,338,1401,367000,53118
2220,2073,147,1037,373600,53119
4361,3399,962,1425,310100,53120
7620,5581,2039,1031,287900,53121
2250,1992,258,1788,470200,53122
794,688,106,1375,576500,53125
2814,2441,373,1009,352400,53126
92,42,50,-,-,53127
3255,2925,330,1147,232700,53128
6000,4122,1878,1177,288400,53129
3157,1837,1320,1274,290400,53130
13702,10795,2907,1380,345600,53132
640,596,44,-,328900,53137
1017,917,100,1275,270100,53139
12922,6865,6057,1018,191400,53140
13359,9738,3621,1319,254300,53142
8280,4944,3336,1157,186600,53143
10350,5620,4730,1136,248200,53144
3061,2943,118,1273,318700,53146
8143,5480,2663,1277,337000,53147
7204,6200,1004,1100,384600,53149
10376,8978,1398,1230,390500,53150
14028,10109,3919,1424,351300,53151
1008,953,55,1117,393800,53153
15164,9000,6164,1397,305100,53154
1341,1043,298,768,235700,53156
0,0,0,-,-,53157
6902,5110,1792,1444,348900,53158
101,55,46,-,325700,53167
3764,3101,663,1268,289500,53168
811,661,150,963,259100,53170
8679,5797,2882,1014,216400,53172
46,46,0,-,-,53176
2443,1970,473,1295,228900,53177
1095,813,282,847,337800,53178
2654,2249,405,1127,265600,53179
3586,2957,629,1051,270700,53181
3294,2198,1096,1067,305700,53182
1048,898,150,1473,383300,53183
1496,883,613,991,279300,53184
7661,6306,1355,1191,357700,53185
14550,7979,6571,1180,277800,53186
14364,9670,4694,1235,317300,53188
10236,8358,1878,1206,372600,53189
7095,3251,3844,990,247000,53190
1391,1097,294,799,369200,53191
95,94,1,-,-,53192
57,49,8,850,173800,53195
16699,3486,13213,1234,298000,53202
1401,195,1206,1671,334600,53203
13840,3660,10180,964,106000,53204
3528,985,2543,803,122100,53205
7611,2489,5122,998,70800,53206
16303,9793,6510,1145,228500,53207
11679,4632,7047,924,196300,53208
18881,7876,11005,980,150200,53209
9231,3867,5364,1044,153400,53210
15239,6215,9024,1225,413500,53211
13603,4402,9201,1038,204300,53212
12196,6987,5209,1228,311200,53213
16179,8783,7396,999,178600,53214
19446,9170,10276,933,148400,53215
11893,5391,6502,970,122800,53216
11687,8882,2805,1519,426100,53217
14649,6135,8514,1034,122200,53218
14947,9487,5460,971,190300,53219
12106,6913,5193,1063,218800,53220
16383,9406,6977,1071,205500,53221
10763,7182,3581,1026,202100,53222
12173,6300,5873,1071,184300,53223
7802,4002,3800,1160,194600,53224
9930,4045,5885,1094,174500,53225
8497,4856,3641,1348,301400,53226
10700,5186,5514,1057,214300,53227
6982,3750,3232,1220,254700,53228
4491,148,4343,846,132900,53233
5009,2731,2278,893,207200,53235
0,0,0,-,-,53295
14516,10383,4133,1049,224200,53402
10575,6250,4325,1029,159100,53403
4666,2289,2377,968,126800,53404
11030,8495,2535,946,173600,53405
11329,8172,3157,990,262000,53406
86,0,86,-,-,53501
995,798,197,886,242500,53502
842,716,126,975,229800,53503
946,787,159,685,195600,53504
174,145,29,1250,258300,53505
394,328,66,814,145200,53506
897,725,172,1217,310900,53507
2322,1985,337,1002,330700,53508
580,438,142,705,229900,53510
18180,11843,6337,995,160000,53511
1062,929,133,988,336400,53515
930,778,152,687,282200,53516
792,581,211,1133,410600,53517
632,568,64,855,147000,53518
3035,2297,738,768,211500,53520
1406,1228,178,1157,365600,53521
389,324,65,820,183000,53522
2131,1765,366,1048,308000,53523
1689,1302,387,1036,229100,53525
214,190,24,1083,176300,53526
4646,3753,893,1531,402500,53527
2510,1953,557,1343,424800,53528
887,651,236,-,374000,53529
1787,1364,423,877,175000,53530
1593,1334,259,1094,334400,53531
6193,4999,1194,1381,355700,53532
3211,2160,1051,976,255200,53533
4786,3676,1110,1102,280100,53534
4021,3177,844,927,274600,53536
382,303,79,723,147400,53537
7856,5930,1926,967,228200,53538
56,29,27,1081,112500,53540
378,318,60,640,220800,53541
735,620,115,659,198900,53543
340,281,59,845,338000,53544
10768,6975,3793,1006,204000,53545
12248,8936,3312,1076,220100,53546
8436,5724,2712,999,226600,53548
4302,3163,1139,1035,247200,53549
457,360,97,945,226600,53550
3601,2743,858,1089,322700,53551
275,224,51,446,168500,53553
376,318,58,750,165900,53554
3852,3346,506,1247,359800,53555
1022,842,180,838,176600,53556
203,151,52,717,169600,53557
5312,4131,1181,1501,377500,53558
2260,1841,419,897,280800,53559
1469,1226,243,1068,328800,53560
813,735,78,1031,407400,53561
13189,7296,5893,1394,495600,53562
4555,3957,598,972,270800,53563
1927,1500,427,805,254200,53565
6535,4454,2081,849,203700,53566
389,331,58,907,198400,53569
1168,870,298,859,233900,53570
140,37,103,-,-,53571
3843,2965,878,1243,381900,53572
1219,971,248,692,169100,53573
1511,1257,254,969,315900,53574
6796,5408,1388,1223,384700,53575
987,755,232,-,206800,53576
531,396,135,970,247800,53577
2645,1892,753,1141,333800,53578
641,524,117,919,228900,53579
182,134,48,750,154200,53580
4259,3064,1195,722,180200,53581
415,361,54,900,231000,53582
2415,1875,540,1078,305200,53583
8,8,0,-,-,53584
831,552,279,1052,206700,53585
896,699,197,977,149900,53586
492,395,97,756,165300,53587
1723,1427,296,956,273600,53588
8707,6632,2075,1150,318300,53589
17890,11895,5995,1375,354700,53590
12041,8577,3464,1530,464700,53593
2214,1577,637,990,236900,53594
8120,6038,2082,1336,462900,53597
1490,995,495,1470,373300,53598
47,42,5,-,87400,53599
20143,2876,17267,1445,472000,53703
21798,11656,10142,1231,289000,53704
12353,5900,6453,1322,446500,53705
25,0,25,900,-,53706
22675,14066,8609,1357,387600,53711
11242,3447,7795,1173,259100,53713
7812,4616,3196,1220,275000,53714
5105,992,4113,1533,436100,53715
8357,5996,2361,1264,325400,53716
6316,3400,2916,1385,404600,53717
8096,4770,3326,1606,328500,53718
15701,7868,7833,1429,349300,53719
2425,854,1571,1408,600500,53726
0,0,0,-,-,53792
418,338,80,-,128400,53801
32,14,18,725,206300,53802
490,395,95,1025,152200,53803
488,418,70,653,163600,53804
2081,1425,656,687,147300,53805
743,627,116,668,145100,53806
1728,1408,320,797,209900,53807
412,279,133,699,183200,53808
1776,1322,454,728,183000,53809
149,112,37,492,151900,53810
1261,868,393,908,219300,53811
105,105,0,-,194500,53812
2279,1684,595,803,204900,53813
309,258,51,859,207500,53816
121,103,18,690,139800,53817
5708,2927,2781,887,214200,53818
950,787,163,786,203600,53820
3154,2190,964,842,162500,53821
174,142,32,720,143800,53825
542,423,119,725,159400,53826
153,134,19,900,150000,53827
5936,4039,1897,969,214300,53901
1457,1007,450,732,117900,53910
557,458,99,1237,285500,53911
9651,6698,2953,951,214500,53913
10424,6642,3782,932,212200,53916
849,688,161,814,210800,53919
225,198,27,1009,234000,53920
421,370,51,681,265200,53922
852,672,180,689,211200,53923
537,451,86,820,208900,53924
3632,2688,944,852,258400,53925
610,459,151,1057,216200,53926
39,37,2,-,137500,53928
1112,886,226,910,185800,53929
561,458,103,821,210400,53930
132,109,23,1100,130200,53931
965,720,245,1148,277400,53932
1358,951,407,1121,228200,53933
2233,1887,346,832,166700,53934
108,86,22,738,147200,53935
553,526,27,888,113400,53936
330,280,50,970,261700,53937
104,93,11,750,130800,53939
0,0,0,-,-,53940
1185,1034,151,794,252500,53941
49,39,10,683,119600,53942
444,367,77,1000,230600,53943
907,762,145,987,189200,53944
1750,1451,299,736,233000,53946
118,80,38,889,211100,53947
3434,2518,916,842,167000,53948
2828,2301,527,797,202200,53949
2272,1759,513,807,165900,53950
961,728,233,910,186100,53951
1299,1146,153,817,182800,53952
89,78,11,-,120000,53953
2595,2102,493,904,248500,53954
2524,2101,423,791,285100,53955
1218,994,224,750,214100,53956
5561,3916,1645,954,240500,53959
1352,1086,266,889,247200,53960
370,318,52,1125,200000,53961
16,5,11,485,112500,53962
4569,3186,1383,839,182900,53963
1417,1055,362,788,213000,53964
4948,3737,1211,938,211700,53965
862,724,138,843,188900,53968
132,102,30,506,200000,53969
3422,2780,642,1082,239200,54001
2610,2035,575,1200,275600,54002
400,393,7,-,321800,54003
879,767,112,833,235300,54004
1184,980,204,943,241500,54005
361,322,39,650,203500,54006
409,338,71,914,247300,54007
1001,864,137,1110,238600,54009
2703,2018,685,976,277700,54011
1455,1161,294,1116,269400,54013
829,753,76,993,285200,54014
1466,1154,312,951,285900,54015
13291,10530,2761,1431,425900,54016
7510,5663,1847,1140,301900,54017
3254,2495,759,1058,262100,54020
2941,2337,604,1285,344600,54021
8452,5978,2474,1059,349700,54022
1686,1414,272,1587,352500,54023
2162,1642,520,909,248900,54024
2921,2407,514,1134,342700,54025
884,799,85,1100,304500,54026
420,381,39,995,323600,54027
970,678,292,898,249000,54028
844,750,94,-,480300,54082
1162,1112,50,795,264700,54101
402,370,32,519,148600,54102
223,189,34,-,184100,54103
519,505,14,-,162100,54104
2103,1851,252,764,254500,54106
1359,1086,273,716,195800,54107
2202,1800,402,801,218300,54110
963,771,192,929,222100,54111
1099,792,307,726,173100,54112
1470,1281,189,1081,235800,54113
2627,2209,418,658,174700,54114
19693,13003,6690,1071,307800,54115
203,162,41,867,155600,54119
104,102,2,-,200000,54120
1496,1335,161,923,176800,54121
88,75,13,-,-,54123
1404,1193,211,765,131700,54124
210,173,37,623,102600,54125
1514,1368,146,889,258800,54126
18,17,1,-,132500,54127
801,595,206,472,164200,54128
1440,1254,186,1027,240800,54129
11113,8638,2475,969,242300,54130
956,677,279,638,112400,54135
2991,1758,1233,1038,193000,54136
446,423,23,621,234700,54137
392,365,27,-,206000,54138
1257,1044,213,720,183700,54139
3467,2246,1221,1009,204000,54140
1122,1059,63,906,269000,54141
6845,5293,1552,765,135800,54143
606,569,37,1625,192700,54149
293,212,81,569,68500,54150
1511,1301,210,804,130300,54151
104,44,60,925,146900,54152
3188,2317,871,810,165500,54153
2546,1863,683,684,194000,54154
2763,1776,987,1255,344900,54155
696,599,97,782,123600,54156
2585,1914,671,768,169900,54157
569,542,27,1125,169700,54159
117,102,15,810,169000,54160
1167,1048,119,720,192400,54161
3518,2769,749,797,258600,54162
2949,2292,657,937,232200,54165
7272,5244,2028,787,169700,54166
1203,1168,35,1208,336800,54169
1530,1321,209,832,221200,54170
1398,1317,81,971,299900,54171
1468,1264,204,1250,340000,54173
1408,1242,166,828,178400,54174
568,550,18,444,253000,54175
1384,1176,208,710,167500,54177
1260,1015,245,1272,275200,54180
2179,1839,340,823,174800,54201
862,719,143,1111,383600,54202
804,701,103,953,324500,54204
789,740,49,838,235800,54205
72,58,14,-,176900,54207
2275,1985,290,745,245300,54208
738,668,70,1324,383900,54209
462,415,47,850,356100,54210
175,160,15,958,465500,54211
421,383,38,900,481100,54212
566,488,78,665,186500,54213
288,243,45,631,237500,54214
105,67,38,729,148000,54215
2663,2251,412,776,173300,54216
2931,2456,475,956,255200,54217
17386,12139,5247,790,159500,54220
713,661,52,592,237800,54227
1205,954,251,765,181600,54228
1905,1415,490,1110,278100,54229
1719,1500,219,650,205100,54230
534,480,54,613,128400,54232
1097,746,351,1140,419600,54234
8645,6589,2056,998,267700,54235
6410,5009,1401,757,146000,54241
874,752,122,925,206800,54245
391,340,51,664,277100,54246
1039,867,172,909,212200,54247
10037,6591,3446,929,205900,54301
13031,6504,6527,881,164500,54302
12408,5959,6449,859,160100,54303
12501,7012,5489,935,200800,54304
0,0,0,-,-,54307
14656,9793,4863,1063,272400,54311
15754,13100,2654,1088,294300,54313
13285,8811,4474,969,186100,54401
10413,6787,3626,942,179400,54403
965,683,282,886,152500,54405
1715,1480,235,858,267300,54406
562,509,53,1011,306500,54407
471,430,41,583,159400,54408
5647,4072,1575,744,115800,54409
882,831,51,704,202600,54410
1920,1642,278,812,210800,54411
802,700,102,648,211400,54412
97,84,13,-,98000,54413
1312,1119,193,611,185800,54414
668,551,117,550,124100,54416
5,5,0,-,-,54417
385,345,40,819,175900,54418
464,363,101,544,172500,54420
1241,878,363,820,178800,54421
433,312,121,695,135900,54422
849,812,37,789,290700,54423
642,620,22,875,221700,54424
704,528,176,808,175000,54425
1749,1497,252,743,204700,54426
498,429,69,794,176000,54427
446,379,67,632,178400,54428
36,36,0,-,156300,54430
682,578,104,692,175000,54433
861,764,97,706,211400,54435
773,632,141,675,172400,54436
1188,901,287,697,148600,54437
1131,1012,119,844,201100,54440
340,309,31,675,206500,54441
590,512,78,936,223700,54442
851,769,82,850,258800,54443
1150,919,231,768,153000,54446
199,170,29,850,161900,54447
1702,1494,208,757,239300,54448
11705,8091,3614,812,194400,54449
180,144,36,867,82900,54450
4515,3376,1139,815,198500,54451
8367,6397,1970,777,162500,54452
527,447,80,767,170500,54454
7714,6275,1439,1041,226500,54455
2503,1957,546,719,168600,54456
3812,3296,516,718,169500,54457
55,43,12,875,139600,54458
563,518,45,914,128700,54459
917,764,153,793,156700,54460
180,168,12,-,193000,54462
430,334,96,807,231500,54463
24,17,7,-,91300,54464
361,351,10,-,232300,54465
1092,930,162,650,178900,54466
6068,3840,2228,1042,244400,54467
707,553,154,877,143900,54469
875,719,156,697,160200,54470
593,568,25,1525,275400,54471
984,853,131,772,229400,54473
1865,1264,601,934,184200,54474
607,548,59,663,181900,54475
8272,5362,2910,972,211300,54476
1397,1159,238,563,175100,54479
555,448,107,767,169500,54480
12034,6717,5317,853,191700,54481
3896,3157,739,994,265800,54482
2431,2127,304,953,233700,54484
197,192,5,-,227500,54485
903,772,131,925,150700,54486
4347,3730,617,612,223700,54487
455,351,104,808,138300,54488
601,493,108,933,174700,54489
378,344,34,575,190500,54490
786,615,171,719,160500,54491
311,282,29,938,215400,54493
11792,9230,2562,954,170800,54494
3397,1907,1490,804,117900,54495
815,622,193,914,144700,54498
1124,880,244,729,173300,54499
8973,7451,1522,831,194900,54501
598,550,48,675,154300,54511
649,487,162,924,280700,54512
241,224,17,688,176800,54513
815,688,127,633,158700,54514
279,248,31,1200,108900,54515
78,78,0,-,417500,54517
602,526,76,883,242100,54519
1649,1220,429,570,165900,54520
4002,3374,628,913,275900,54521
348,227,121,530,160200,54524
133,113,20,738,93500,54525
308,270,38,875,122500,54526
481,419,62,545,119100,54527
471,447,24,950,263700,54529
354,315,39,703,104000,54530
608,570,38,1045,322600,54531
1174,941,233,634,108700,54534
84,76,8,-,65400,54536
245,212,33,-,113100,54537
1266,907,359,548,271300,54538
597,532,65,778,241300,54539
464,412,52,779,223800,54540
545,467,78,613,154000,54541
241,216,25,-,157300,54542
515,396,119,1107,647500,54545
496,435,61,608,133500,54546
699,621,78,525,278500,54547
2748,2093,655,935,307700,54548
300,286,14,750,107300,54550
2168,1722,446,882,127500,54552
512,439,73,730,222600,54554
2159,1746,413,836,172900,54555
541,443,98,721,127600,54556
500,485,15,-,408800,54557
1154,926,228,856,234500,54558
388,319,69,471,163100,54559
287,274,13,1063,218200,54560
37,37,0,-,229200,54561
891,800,91,964,291800,54562
341,313,28,850,195500,54563
191,170,21,394,170800,54564
23,22,1,-,125000,54565
672,583,89,588,177600,54566
2114,1877,237,791,262100,54568
21336,11623,9713,998,220200,54601
6698,3416,3282,936,175500,54603
717,532,185,776,195100,54610
487,389,98,890,159500,54611
2064,1373,691,977,189700,54612
983,859,124,672,162800,54613
1055,808,247,898,238200,54614
4387,3149,1238,782,190200,54615
966,724,242,816,170700,54616
826,666,160,823,165000,54618
1372,1179,193,841,216600,54619
461,378,83,787,255300,54621
946,861,85,736,181300,54622
792,684,108,992,248600,54623
715,636,79,778,184000,54624
232,204,28,733,182300,54625
613,500,113,777,228300,54626
873,762,111,775,217100,54627
454,412,42,658,187900,54628
1109,925,184,864,209400,54629
1752,1290,462,975,261700,54630
743,566,177,829,165100,54631
486,437,49,743,206100,54632
1585,1276,309,739,180800,54634
709,614,95,705,187700,54635
6415,4754,1661,1145,290600,54636
74,54,20,663,146400,54637
603,515,88,530,259200,54638
1027,794,233,680,180700,54639
854,724,130,800,195600,54642
2,2,0,-,-,54643
477,466,11,-,263300,54644
51,32,19,683,130000,54645
1536,1282,254,925,145200,54646
566,451,115,824,173000,54648
10756,7298,3458,1109,279100,54650
442,357,85,671,198000,54651
388,307,81,746,142600,54652
468,393,75,1063,253500,54653
65,64,1,-,79600,54654
658,520,138,750,211000,54655
7203,5185,2018,924,201400,54656
137,99,38,783,201900,54657
1075,877,198,1021,228800,54658
432,342,90,804,208500,54659
6884,4553,2331,931,188000,54660
1610,1206,404,1122,252000,54661
608,505,103,961,177900,54664
3614,2782,832,858,222600,54665
1014,811,203,1055,192700,54666
1921,1658,263,872,209500,54667
3018,2509,509,1156,288600,54669
566,498,68,464,216700,54670
17301,10267,7034,963,265000,54701
18064,11359,6705,986,224600,54703
3736,2113,1623,1156,223300,54720
485,401,84,949,195600,54721
1498,1185,313,812,220300,54722
439,370,69,875,181600,54723
2836,2230,606,787,231400,54724
1304,1094,210,857,204500,54725
674,557,117,1036,177100,54726
1886,1516,370,840,209000,54727
2412,2080,332,897,214200,54728
14671,10389,4282,1022,263900,54729
2151,1598,553,768,228600,54730
291,244,47,1200,160300,54731
1065,890,175,800,173300,54732
499,425,74,775,168500,54733
307,267,40,900,209000,54734
1809,1453,356,794,166900,54736
221,189,32,954,212900,54737
1273,919,354,872,277400,54738
1915,1430,485,1043,240700,54739
755,593,162,853,225800,54740
668,566,102,733,156900,54741
1764,1540,224,1069,272100,54742
932,815,117,968,227300,54745
284,238,46,1054,118100,54746
1161,751,410,871,175900,54747
552,489,63,970,222300,54748
557,404,153,925,195800,54749
412,377,35,925,269100,54750
9767,5552,4215,953,232500,54751
604,503,101,875,163300,54754
2904,2173,731,843,218400,54755
407,325,82,781,196100,54756
1464,1291,173,898,216000,54757
1928,1579,349,853,209500,54758
605,509,96,867,216200,54759
70,44,26,660,207100,54760
436,310,126,783,186500,54761
511,414,97,731,172600,54762
456,361,95,633,166000,54763
709,616,93,834,135900,54766
1369,1165,204,881,243700,54767
1980,1343,637,760,190400,54768
250,231,19,820,283100,54769
822,698,124,875,212700,54770
1464,1191,273,861,178300,54771
415,370,45,1038,186600,54772
1319,966,353,748,166200,54773
2876,2133,743,812,198500,54801
671,524,147,664,171200,54805
4939,3425,1514,709,172900,54806
1180,1023,157,1047,258000,54810
2332,1711,621,908,163500,54812
256,233,23,763,223200,54813
1277,951,326,628,235700,54814
986,876,110,613,259100,54817
1056,832,224,719,154000,54819
372,323,49,864,235900,54820
721,621,100,831,274200,54821
2038,1616,422,954,223100,54822
888,653,235,848,193500,54824
335,300,35,950,229800,54826
168,168,0,-,250000,54827
309,236,73,393,218100,54828
2319,1839,480,892,214900,54829
1694,1547,147,767,242500,54830
220,173,47,1007,227900,54832
491,389,102,586,180900,54835
365,346,19,1263,195600,54836
1573,1329,244,902,211500,54837
536,500,36,917,235700,54838
146,133,13,-,168800,54839
1784,1497,287,833,180800,54840
125,98,27,-,133800,54841
76,69,7,825,196300,54842
6035,4533,1502,687,233500,54843
142,126,16,1354,246700,54844
46,40,6,-,112500,54845
255,227,28,842,147300,54846
1180,956,224,890,253900,54847
2688,1807,881,828,138100,54848
820,740,80,838,254200,54849
180,163,17,713,272100,54850
1518,1243,275,856,214100,54853
326,287,39,694,182900,54854
312,273,39,745,191400,54855
658,612,46,1113,182700,54856
12,9,3,-,-,54857
745,576,169,688,208000,54858
1081,879,202,888,207600,54859
54,12,42,441,-,54861
152,144,8,967,195000,54862
553,533,20,993,221900,54864
254,220,34,-,169200,54865
211,188,23,672,132700,54867
6822,4799,2023,850,199300,54868
785,733,52,1148,275700,54870
1300,1050,250,740,215100,54871
1103,894,209,735,210600,54872
1454,1326,128,836,232800,54873
1471,1343,128,966,206500,54874
603,530,73,825,158300,54875
752,630,122,915,262900,54876
13242,8448,4794,901,176700,54880
615,551,64,738,216000,54888
1316,1003,313,872,230300,54889
1455,1184,271,788,200600,54891
1865,1526,339,716,213200,54893
397,347,50,625,182700,54895
781,671,110,950,180000,54896
13882,7000,6882,932,164000,54901
10015,6034,3981,859,163900,54902
9645,7715,1930,915,258900,54904
835,724,111,969,187500,54909
10477,6239,4238,1010,199100,54911
9784,6842,2942,1158,365400,54913
13524,8472,5052,936,210200,54914
17894,12984,4910,974,247900,54915
544,491,53,763,190700,54921
487,411,76,867,179900,54922
3774,2650,1124,815,180400,54923
73,60,13,-,73800,54926
203,169,34,1188,235500,54927
177,171,6,-,193800,54928
4001,3011,990,875,157900,54929
701,594,107,824,181800,54930
157,144,13,-,194200,54931
467,449,18,877,255900,54932
61,42,19,630,86700,54933
17778,10593,7185,880,166400,54935
8889,6512,2377,1097,262000,54937
1820,1594,226,980,286300,54940
1235,968,267,743,270200,54941
4015,3562,453,1156,336500,54942
936,791,145,683,205300,54943
3479,3077,402,820,318400,54944
1538,1215,323,758,198000,54945
0,0,0,-,-,54946
926,852,74,911,266700,54947
86,80,6,-,121600,54948
1542,1183,359,835,192200,54949
1141,945,196,732,151900,54950
11987,8003,3984,906,190000,54952
19438,13474,5964,1005,238200,54956
1306,1148,158,794,205500,54960
5870,4099,1771,841,196600,54961
442,391,51,608,194700,54962
2936,2383,553,926,218700,54963
349,319,30,942,233200,54964
536,512,24,925,189800,54965
803,686,117,800,152500,54966
209,157,52,475,183700,54967
1188,951,237,770,180300,54968
1426,1184,242,823,150900,54970
4625,3238,1387,708,182800,54971
580,536,44,631,249500,54974
616,564,52,967,242900,54977
28,25,3,-,120200,54978
628,530,98,1352,262300,54979
144,136,8,-,164500,54980
6770,5025,1745,800,204100,54981
3092,2479,613,752,183400,54982
1755,1340,415,910,214100,54983
1511,1099,412,856,191600,54984
0,0,0,-,-,54985
2181,1821,360,905,280500,54986
1168,1146,22,-,654000,55001
1213,1035,178,1773,363200,55003
1666,1482,184,1791,324600,55005
1460,1157,303,945,209100,55006
915,851,64,955,223500,55007
6532,5019,1513,1255,267400,55008
3382,2807,575,1010,311400,55009
3859,3658,201,1932,380000,55011
732,656,76,1337,367500,55012
2813,2164,649,1156,366000,55013
10885,9170,1715,1553,324700,55014
13793,12198,1595,1653,358800,55016
308,282,26,1700,278200,55017
398,347,51,1337,316300,55018
826,791,35,1214,316200,55019
1427,1417,10,-,452700,55020
11352,8100,3252,1044,267600,55021
12539,11148,1391,1427,350500,55024
10026,7416,2610,1355,385800,55025
147,126,21,1700,278600,55026
986,867,119,941,290400,55027
12,9,3,-,218800,55029
530,488,42,892,214900,55030
660,618,42,1156,393400,55031
1250,1162,88,1203,363200,55032
11571,9079,2492,1174,335800,55033
20,17,3,-,91000,55036
2045,1601,444,975,206100,55037
9149,8298,851,1844,408000,55038
5258,4599,659,1298,287700,55040
3280,2705,575,992,265300,55041
4815,4464,351,2204,594000,55042
1490,1337,153,1617,360600,55043
21891,19209,2682,1730,464500,55044
2787,2527,260,993,373500,55045
2071,1812,259,1256,331100,55046
964,910,54,2250,478800,55047
926,779,147,1250,233100,55049
3905,3112,793,970,220000,55051
768,652,116,1161,266700,55052
339,321,18,1275,338100,55053
891,800,91,2311,399300,55054
2001,1353,648,1080,331300,55055
5497,4640,857,1190,297600,55056
8093,6039,2054,1042,338800,55057
12022,9380,2642,1018,239300,55060
3987,3230,757,763,239000,55063
460,411,49,1486,372100,55065
8282,6047,2235,958,237800,55066
11521,10008,1513,1610,379500,55068
2057,1602,455,893,279800,55069
2947,2424,523,1148,301700,55070
2335,1858,477,2116,256200,55071
1486,1093,393,1025,188900,55072
1404,1240,164,989,470400,55073
858,768,90,962,283700,55074
8313,5989,2324,1128,267000,55075
9244,7671,1573,1340,308900,55076
5369,3370,1999,1514,496800,55077
3257,3020,237,1547,335400,55079
1172,1058,114,1353,337700,55080
14478,11227,3251,1439,459500,55082
724,599,125,992,294300,55084
172,149,23,1021,291400,55085
170,162,8,617,233800,55087
608,603,5,-,494400,55088
632,581,51,1025,373200,55089
157,137,20,1500,305200,55090
4133,3873,260,1182,336600,55092
5136,1178,3958,1573,252700,55101
10460,4816,5644,1295,280400,55102
5245,2231,3014,1040,240400,55103
18588,10022,8566,1159,290900,55104
11423,7686,3737,1240,453300,55105
19130,11542,7588,1230,233000,55106
5835,3532,2303,1335,259900,55107
6743,3567,3176,1344,365400,55108
12760,8304,4456,1316,291200,55109
15492,12005,3487,1494,347100,55110
100,0,100,930,-,55111
17326,11946,5380,1322,338800,55112
17917,11898,6019,1353,331200,55113
2431,524,1907,1588,296900,55114
3219,2673,546,1510,481900,55115
12140,6181,5959,1279,405900,55116
16744,10259,6485,1178,262700,55117
13065,8744,4321,1215,331800,55118
16150,10341,5809,1351,262700,55119
2104,1289,815,1543,484700,55120
4100,1720,2380,1630,299500,55121
13541,9367,4174,1594,342700,55122
10199,8243,1956,1593,442000,55123
21460,15662,5798,1676,354200,55124
17500,13332,4168,1805,396600,55125
11625,9369,2256,1507,366400,55126
7586,6281,1305,1764,409400,55127
11845,9237,2608,1451,300700,55128
11046,8940,2106,1888,517800,55129
5902,2582,3320,1151,220300,55130
71,56,15,850,330000,55150
0,0,0,-,-,55155
4581,4101,480,1458,324000,55301
2895,2513,382,997,312200,55302
19715,14973,4742,1348,338700,55303
17024,16047,977,1628,402600,55304
9885,5790,4095,1774,442200,55305
6543,4322,2221,1610,366300,55306
1244,969,275,866,226800,55307
3199,2941,258,812,304200,55308
7242,6600,642,1463,335500,55309
616,510,106,638,144100,55310
13921,12003,1918,1894,466400,55311
540,488,52,879,214100,55312
9145,7451,1694,1150,321000,55313
440,353,87,739,167700,55314
2451,2233,218,1359,433400,55315
8699,7785,914,1597,338400,55316
8329,6892,1437,1763,505300,55317
11325,8037,3288,1430,389200,55318
1941,1863,78,950,349300,55319
2134,1800,334,1130,307200,55320
1870,1471,399,960,265100,55321
1409,1273,136,808,391900,55322
449,429,20,763,316400,55324
1722,1470,252,875,288100,55325
2166,2037,129,1346,486500,55327
3625,3012,613,927,382600,55328
837,710,127,896,214700,55329
16123,13593,2530,1356,355200,55330
7557,6579,978,1208,707000,55331
695,579,116,447,135800,55332
295,261,34,872,115900,55333
1119,772,347,750,178300,55334
669,561,108,1010,137000,55335
3264,2538,726,921,235600,55336
19310,12874,6436,1463,327800,55337
417,400,17,1325,260000,55338
384,319,65,873,302400,55339
3376,3139,237,1431,607600,55340
1156,1061,95,1806,421500,55341
787,636,151,1014,148100,55342
13351,6223,7128,1427,350700,55343
6880,2553,4327,1725,351600,55344
8433,7280,1153,1444,478800,55345
6684,5757,927,1823,463800,55346
11875,10929,946,2020,493200,55347
1489,1236,253,952,287100,55349
7781,5753,2028,934,238600,55350
3381,2992,389,1128,379700,55352
1171,1045,126,768,320600,55353
1111,989,122,761,243600,55354
4030,3041,989,929,210200,55355
2170,1887,283,1732,712800,55356
1252,1140,112,1146,491200,55357
2017,1723,294,1048,299100,55358
2553,2160,393,1203,573700,55359
1129,1067,62,1233,340100,55360
7414,5462,1952,1458,324400,55362
1959,1520,439,1344,273000,55363
6207,5049,1158,1128,411200,55364
182,151,31,775,142000,55366
397,352,45,1075,304500,55367
745,546,199,1013,289400,55368
16075,12658,3417,1792,356800,55369
213,204,9,-,332100,55370
6453,5340,1113,946,299100,55371
12293,11127,1166,1406,450100,55372
2345,1988,357,1258,285000,55373
5392,4826,566,1535,438000,55374
1392,1332,60,1139,395600,55375
6972,6407,565,2038,364600,55376
11694,9829,1865,1608,393800,55378
17610,13472,4138,1540,366300,55379
785,691,94,775,233400,55381
1443,1356,87,1244,346900,55382
1238,276,962,1223,598400,55384
493,421,72,735,180500,55385
3583,3299,284,2435,559700,55386
5542,4576,966,1306,418600,55387
2286,1854,432,998,333100,55388
917,773,144,755,252700,55389
1164,1061,103,1227,308500,55390
6638,5397,1241,1498,795600,55391
1207,953,254,812,229400,55395
935,782,153,808,188000,55396
1234,1049,185,1068,334500,55397
6083,5570,513,1201,325000,55398
8279,2401,5878,2010,401500,55401
506,0,506,1650,-,55402
11532,2890,8642,1199,285200,55403
12679,2223,10456,1063,294200,55404
8190,2946,5244,1188,450200,55405
16653,11119,5534,1276,335500,55406
14781,8912,5869,1219,317000,55407
17153,4260,12893,1385,387500,55408
5108,3495,1613,1364,365500,55409
8407,6706,1701,1622,597400,55410
10029,5222,4807,1220,233500,55411
9130,6460,2670,1340,226400,55412
7455,2883,4572,1497,354200,55413
13778,2031,11747,1368,454200,55414
2940,987,1953,1836,581500,55415
17816,8864,8952,1701,457300,55416
10935,9020,1915,1377,368400,55417
13933,9138,4795,1349,332500,55418
11660,9225,2435,1476,479000,55419
9236,6081,3155,1277,306600,55420
12617,7616,5001,1281,260500,55421
12388,8989,3399,1576,314200,55422
16254,10162,6092,1334,320300,55423
3658,3352,306,1786,959800,55424
4413,1603,2810,1537,312900,55425
11691,7581,4110,1512,345000,55426
10656,7163,3493,1443,341700,55427
12889,7268,5621,1291,277900,55428
10140,5768,4372,1253,267900,55429
7916,5348,2568,1370,243800,55430
8249,5574,2675,1704,354300,55431
12969,8434,4535,1308,278600,55432
14065,9446,4619,1345,274500,55433
11891,9714,2177,1703,269600,55434
7529,3591,3938,1716,340600,55435
6127,4600,1527,1855,595500,55436
8664,6030,2634,1624,362600,55437
7147,5671,1476,1554,406200,55438
3539,3199,340,1681,640300,55439
7938,4792,3146,1589,463300,55441
5526,4329,1197,1773,439200,55442
11883,8753,3130,1306,346200,55443
5269,4701,568,1444,306900,55444
4730,3752,978,2053,311000,55445
10539,8664,1875,1932,559100,55446
8637,6603,2034,1663,454500,55447
10745,8963,1782,1706,301100,55448
11367,10023,1344,1723,422600,55449
0,0,0,-,-,55450
3644,361,3283,947,184700,55454
5,0,5,-,-,55455
62,55,7,-,232700,55601
160,157,3,-,222800,55602
248,207,41,696,195800,55603
1728,1384,344,1036,307100,55604
293,155,138,613,139400,55605
120,120,0,-,275000,55606
76,74,2,-,203800,55607
70,70,0,-,-,55609
299,274,25,1013,423300,55612
95,94,1,-,293300,55613
1275,1086,189,1035,172900,55614
165,123,42,1266,235300,55615
3129,2561,568,1045,237000,55616
186,165,21,1175,251300,55702
331,306,25,1271,172600,55703
484,383,101,516,212700,55704
1635,1394,241,471,124600,55705
856,732,124,726,107600,55706
1262,1101,161,915,229600,55707
365,308,57,736,107700,55708
1674,1506,168,925,206300,55709
600,586,14,-,223600,55710
185,160,25,850,192200,55711
288,265,23,1083,159600,55712
452,348,104,1032,117700,55713
122,91,31,645,102600,55716
106,98,8,-,288600,55717
1172,1024,148,878,288400,55718
2247,1740,507,784,121200,55719
7136,5082,2054,976,213300,55720
1401,1250,151,682,267100,55721
396,322,74,905,152600,55722
897,770,127,620,177300,55723
382,355,27,-,206800,55724
41,39,2,-,358300,55725
408,320,88,920,218900,55726
2802,2114,688,641,202900,55731
647,628,19,-,173600,55732
1988,1921,67,1411,300800,55733
2782,2191,591,851,143700,55734
791,731,60,968,233500,55735
590,504,86,691,162300,55736
228,222,6,-,145000,55738
1292,1140,152,671,151900,55741
114,109,5,-,192800,55742
8496,6340,2156,1014,232700,55744
8014,6049,1965,739,127600,55746
580,468,112,904,180400,55748
251,229,22,-,217400,55749
825,779,46,-,90800,55750
598,572,26,783,182900,55751
209,203,6,-,201000,55752
470,367,103,934,76900,55753
131,117,14,-,211700,55756
307,268,39,850,211600,55757
72,65,7,-,109400,55758
1235,1011,224,897,261700,55760
234,214,20,-,167000,55763
195,169,26,708,101500,55764
347,317,30,671,185900,55765
1242,950,292,909,226600,55767
1231,957,274,894,190300,55768
1118,989,129,775,147700,55769
674,582,92,850,167700,55771
34,10,24,838,-,55772
543,506,37,761,229100,55775
1470,1303,167,1637,265100,55779
76,65,11,925,183800,55780
347,331,16,-,366400,55781
208,171,37,-,99400,55782
1061,941,120,1204,240900,55783
56,54,2,-,187500,55784
131,123,8,-,188100,55785
55,50,5,-,-,55786
263,238,25,930,232800,55787
885,779,106,630,297900,55790
4696,2817,1879,795,128200,55792
276,238,38,1150,194300,55793
693,598,95,785,223900,55795
60,47,13,775,95000,55796
569,536,33,986,240900,55797
236,207,29,645,216200,55798
1337,459,878,596,479700,55802
7486,6256,1230,1391,300400,55803
6254,5448,806,1346,286800,55804
4868,1406,3462,984,171100,55805
4459,2016,2443,910,156500,55806
4360,3154,1206,797,164000,55807
2620,1913,707,933,157500,55808
3427,2950,477,1102,223700,55810
11092,7797,3295,1339,299300,55811
3655,1543,2112,1216,301600,55812
0,0,0,-,-,55814
23461,15046,8415,1321,290000,55901
11330,8215,3115,1580,430100,55902
0,0,0,-,-,55903
12221,8039,4182,1253,237200,55904
0,0,0,-,-,55905
8396,6322,2074,1152,350000,55906
543,486,57,597,205800,55909
538,480,58,796,238400,55910
11373,8206,3167,864,161800,55912
1402,1241,161,692,193300,55917
446,397,49,807,147700,55918
450,424,26,675,202200,55919
3224,2703,521,1085,356900,55920
2142,1685,457,825,189600,55921
306,246,60,586,112900,55922
1704,1502,202,709,251100,55923
486,434,52,1111,230800,55924
428,392,36,-,270500,55925
302,231,71,834,215400,55926
1707,1435,272,926,216100,55927
452,405,47,852,299600,55929
169,140,29,539,142500,55931
798,659,139,744,288600,55932
88,80,8,833,207900,55933
1419,1148,271,864,300500,55934
422,346,76,756,232600,55935
699,610,89,725,210000,55936
806,662,144,663,185300,55939
1117,876,241,1009,240700,55940
455,341,114,913,209100,55941
1176,993,183,808,228200,55943
2973,2703,270,1080,269600,55944
576,472,104,881,220800,55945
1331,1153,178,872,240400,55946
3141,2816,325,1015,269300,55947
778,639,139,579,249700,55949
62,55,7,-,110600,55950
574,459,115,700,154300,55951
887,693,194,936,229100,55952
381,314,67,525,168800,55953
572,491,81,819,145800,55954
950,881,69,1510,401100,55955
868,716,152,1121,308500,55956
282,229,53,958,262900,55957
909,706,203,848,204300,55959
1251,1171,80,1494,440400,55960
194,166,28,513,164500,55961
310,276,34,713,266700,55962
2074,1671,403,969,350800,55963
1689,1324,365,777,241900,55964
957,749,208,681,191900,55965
342,325,17,1318,273100,55967
69,51,18,1159,196900,55968
413,359,54,806,260400,55969
403,355,48,879,188200,55970
1196,961,235,842,225100,55971
2004,1693,311,942,256000,55972
97,88,9,-,241200,55973
886,686,200,1035,179300,55974
1846,1531,315,923,201700,55975
3299,2671,628,977,277700,55976
77,61,16,975,234100,55977
381,302,79,1102,250000,55979
1816,1418,398,773,234300,55981
242,223,19,1069,266800,55982
704,554,150,620,277500,55983
670,578,92,792,223400,55985
14363,9026,5337,856,211400,55987
399,318,81,881,214800,55990
585,517,68,882,294600,55991
2293,1823,470,797,260700,55992
19894,10849,9045,1088,263100,56001
6383,4732,1651,920,260800,56003
9049,6883,2166,843,161100,56007
618,543,75,950,187200,56009
469,409,60,825,158400,56010
3441,2942,499,1356,296400,56011
1925,1389,536,926,160700,56013
309,253,56,570,88500,56014
397,343,54,910,199700,56016
717,596,121,858,305600,56017
347,287,60,636,145400,56019
31,31,0,-,95000,56020
441,381,60,964,256000,56021
51,38,13,-,62900,56022
213,189,24,943,132800,56023
1302,902,400,1405,259200,56024
200,180,20,1536,165600,56025
781,694,87,833,221000,56026
356,270,86,907,56800,56027
455,407,48,1093,357900,56028
263,225,38,850,115200,56029
3,3,0,-,-,56030
5394,3696,1698,719,175600,56031
153,134,19,833,101600,56032
163,145,18,825,90400,56033
173,150,23,950,169800,56034
151,129,22,-,166100,56035
736,622,114,863,173000,56036
674,600,74,819,239000,56037
343,292,51,750,151700,56039
433,378,55,817,185700,56041
308,254,54,522,200800,56042
184,160,24,-,189300,56043
795,669,126,964,281800,56044
392,364,28,713,155400,56045
52,49,3,-,102500,56046
1635,1429,206,850,223900,56048
532,463,69,649,308800,56050
310,267,43,950,55700,56051
281,264,17,-,342600,56052
331,305,26,840,200400,56054
1636,1365,271,753,218000,56055
34,32,2,-,72000,56056
1497,1160,337,874,233300,56057
2562,1844,718,881,259800,56058
159,135,24,-,87200,56060
1203,950,253,756,172900,56062
1212,994,218,848,396000,56063
1051,867,184,780,214100,56065
441,337,104,956,160400,56068
2026,1730,296,893,254900,56069
4586,3863,723,1183,373000,56071
870,750,120,775,200000,56072
7228,5626,1602,978,207600,56073
697,531,166,858,265100,56074
68,52,16,667,104200,56075
173,156,17,1575,187500,56078
268,235,33,-,199200,56080
2413,1796,617,810,153400,56081
4904,3228,1676,952,263500,56082
354,311,43,525,118900,56083
2132,1835,297,751,162100,56085
1327,1075,252,777,139900,56087
896,600,296,938,134200,56088
92,72,20,625,-,56089
244,209,35,983,182400,56090
126,118,8,-,151300,56091
5030,3796,1234,829,214800,56093
1237,1023,214,839,245400,56096
1623,1295,328,761,118000,56097
884,698,186,758,134300,56098
2492,1848,644,777,171900,56101
673,558,115,729,197200,56110
169,154,15,1125,113800,56111
96,90,6,-,109100,56113
148,115,33,1063,174000,56114
526,433,93,1057,191900,56115
220,187,33,988,219800,56116
129,84,45,1538,129700,56117
195,187,8,-,251600,56118
375,307,68,720,177900,56119
379,330,49,699,117400,56120
316,245,71,-,85000,56121
236,180,56,817,163200,56122
212,199,13,970,109000,56123
25,25,0,-,51700,56125
210,139,71,775,105700,56127
768,669,99,676,188600,56128
272,227,45,597,118600,56129
955,800,155,806,170800,56131
229,219,10,1000,294600,56132
163,118,45,654,197900,56134
597,499,98,663,210300,56136
464,390,74,738,114400,56137
416,306,110,965,197700,56138
161,130,31,773,125000,56139
36,36,0,-,85200,56140
137,123,14,738,109600,56141
471,391,80,611,87800,56142
2100,1541,559,711,158100,56143
468,384,84,1063,81300,56144
199,182,17,675,94500,56145
28,20,8,733,-,56146
51,49,2,-,119600,56147
544,436,108,681,150800,56149
1202,1050,152,917,128500,56150
298,280,18,738,155400,56151
553,459,94,777,126100,56152
67,64,3,-,133300,56153
212,185,27,644,105400,56155
2611,1956,655,726,200900,56156
284,231,53,1048,214100,56157
141,106,35,757,108900,56158
953,730,223,738,135200,56159
83,77,6,-,70700,56160
136,130,6,1083,108300,56161
107,94,13,1400,95600,56162
2411,1880,531,727,133300,56164
143,115,28,842,207500,56165
67,65,2,-,190600,56166
280,225,55,579,116200,56167
338,287,51,725,163200,56168
303,270,33,675,123000,56169
239,203,36,824,101000,56170
629,551,78,747,154900,56171
1334,1016,318,707,189900,56172
119,89,30,1031,165600,56173
171,135,36,928,99400,56174
1077,900,177,543,154400,56175
434,358,76,623,118200,56176
648,518,130,771,163400,56178
473,346,127,607,126300,56180
503,421,82,705,99700,56181
615,450,165,635,124100,56183
203,173,30,775,162500,56185
192,170,22,-,183600,56186
5001,3290,1711,889,193900,56187
9693,5960,3733,832,199100,56201
94,72,22,482,80000,56207
938,747,191,691,86700,56208
969,800,169,931,220400,56209
2,2,0,-,-,56210
205,165,40,675,96500,56211
221,193,28,542,119600,56212
279,216,63,850,117400,56214
1984,1379,605,940,161400,56215
292,269,23,1352,141800,56216
213,206,7,675,103600,56218
346,254,92,589,169400,56219
1168,1013,155,615,162500,56220
394,327,67,763,115900,56221
782,567,215,1065,151500,56222
546,456,90,779,101400,56223
119,102,17,735,113500,56224
321,259,62,700,107000,56225
80,69,11,-,228300,56226
96,77,19,-,251300,56227
407,351,56,763,120000,56228
725,607,118,904,198400,56229
318,262,56,929,157100,56230
156,150,6,-,213900,56231
915,781,134,618,163000,56232
217,183,34,1125,124500,56235
185,170,15,-,140600,56236
231,201,30,584,156900,56237
228,197,31,936,179900,56239
340,247,93,705,118400,56240
1695,1342,353,805,154500,56241
735,596,139,832,173400,56243
637,517,120,854,137500,56244
209,150,59,628,150000,56245
353,295,58,548,177200,56248
121,104,17,569,156300,56249
396,321,75,827,203200,56251
523,405,118,807,195200,56252
345,305,40,765,195600,56253
172,116,56,644,153800,56255
1108,845,263,906,122400,56256
172,137,35,950,71900,56257
6211,3895,2316,742,210100,56258
437,335,102,750,154000,56260
293,249,44,1096,101300,56262
180,166,14,550,162000,56263
844,680,164,624,178900,56264
3123,2202,921,835,159000,56265
580,480,100,1036,135000,56266
2608,1549,1059,848,201900,56267
450,400,50,830,103700,56270
504,368,136,1015,206600,56271
2017,1744,273,965,299400,56273
81,80,1,-,150000,56274
103,85,18,-,106300,56276
1210,824,386,765,178900,56277
1160,923,237,739,176200,56278
464,380,84,1115,228100,56279
208,166,42,875,169000,56280
253,227,26,939,190300,56281
577,433,144,969,186600,56282
2689,2026,663,823,177200,56283
779,589,190,662,141800,56284
467,417,50,688,123800,56285
31,30,1,-,108300,56287
2014,1748,266,818,380000,56288
277,249,28,735,279200,56289
168,157,11,675,174000,56291
206,192,14,1094,115000,56292
429,360,69,633,175000,56293
45,33,12,-,202300,56294
136,107,29,706,86100,56295
872,702,170,583,98600,56296
343,299,44,695,120300,56297
12597,6369,6228,1103,262500,56301
11144,6903,4241,1001,197900,56303
7057,3113,3944,926,230600,56304
1936,1522,414,596,268600,56307
11906,8641,3265,921,307600,56308
557,459,98,839,270400,56309
1971,1697,274,1064,286600,56310
275,237,38,1283,172700,56311
866,713,153,725,242400,56312
29,27,2,-,133900,56313
486,429,57,950,260300,56314
674,566,108,904,248300,56315
616,515,101,925,208700,56316
479,421,58,771,251500,56318
618,555,63,1054,282000,56319
3286,2699,587,1283,312000,56320
0,0,0,-,-,56321
262,217,45,650,156300,56323
473,437,36,744,246700,56324
87,82,5,-,164100,56325
738,624,114,634,231300,56326
360,356,4,-,352600,56327
77,71,6,625,181500,56328
2741,2272,469,1032,260300,56329
721,674,47,1133,262800,56330
770,692,78,810,270300,56331
706,663,43,-,258800,56332
2529,2046,483,844,258400,56334
92,84,8,-,137500,56335
671,603,68,618,274300,56336
674,612,62,1095,273800,56338
442,315,127,769,195400,56339
936,883,53,1066,286800,56340
1309,1116,193,836,233300,56342
384,343,41,850,232300,56343
6381,4867,1514,751,227800,56345
2929,2302,627,925,178900,56347
328,281,47,967,258700,56349
224,199,25,1119,164000,56350
2417,1912,505,1047,225100,56352
3766,3090,676,882,239600,56353
568,505,63,860,404000,56354
250,190,60,771,307000,56355
88,85,3,-,160200,56356
365,357,8,-,273300,56357
1221,1054,167,1214,240100,56358
1345,959,386,803,205500,56359
1716,1355,361,742,233000,56360
977,829,148,792,219800,56361
2265,1871,394,888,242700,56362
83,67,16,1083,170300,56363
2140,1812,328,929,239500,56364
2680,2457,223,1222,270100,56367
1658,1510,148,822,309500,56368
211,134,77,896,223200,56369
35,22,13,1196,183300,56371
1257,1031,226,842,266700,56373
3454,2555,899,1134,281300,56374
285,273,12,1025,237600,56375
138,110,28,525,212800,56376
8104,5165,2939,1196,282800,56377
3369,2502,867,780,239000,56378
6996,4661,2335,972,251500,56379
1057,866,191,866,226000,56381
564,483,81,760,241400,56382
131,76,55,699,134600,56384
440,396,44,960,217300,56385
307,238,69,890,261700,56386
3323,1616,1707,1072,230500,56387
39,32,7,1313,100000,56389
12990,9607,3383,918,237900,56401
3749,2343,1406,1115,299900,56425
3923,3352,571,883,264800,56431
733,661,72,987,226700,56433
64,55,9,781,177500,56434
1225,1122,103,944,230100,56435
497,415,82,808,110000,56437
1194,931,263,859,184000,56438
540,430,110,738,130100,56440
1664,1109,555,839,193600,56441
1400,1210,190,1071,534100,56442
678,609,69,1068,351000,56443
1406,1218,188,850,318500,56444
606,532,74,814,139100,56446
408,397,11,1583,323000,56447
201,198,3,-,392000,56448
733,707,26,1106,266900,56449
485,414,71,933,190900,56450
969,848,121,784,304200,56452
288,263,25,950,113800,56453
650,502,148,994,200000,56455
120,112,8,-,255600,56458
1308,1226,82,983,240900,56461
1755,1435,320,852,195400,56464
1013,959,54,1598,324500,56465
1349,1143,206,711,217200,56466
1110,1052,58,806,300900,56467
1909,1808,101,995,437000,56468
494,462,32,925,222300,56469
4654,3414,1240,929,260500,56470
3585,3087,498,848,299900,56472
1397,1228,169,1008,262500,56473
1936,1524,412,870,220500,56474
689,605,84,829,209700,56475
1111,895,216,665,171500,56477
2001,1572,429,856,177500,56479
921,804,117,585,165600,56481
3147,2076,1071,699,168000,56482
1385,1091,294,625,292900,56484
7829,5627,2202,942,286900,56501
953,706,247,698,139500,56510
782,694,88,950,373300,56511
1462,1248,214,868,233600,56514
1318,1093,225,950,371100,56515
116,98,18,1125,183300,56516
94,76,18,-,144700,56517
173,144,29,877,150000,56518
120,104,16,-,112500,56519
1695,1231,464,515,152600,56520
315,263,52,732,166800,56521
212,187,25,925,147300,56522
166,134,32,825,144800,56523
309,274,35,1021,285300,56524
31,31,0,-,165600,56525
329,288,41,850,192400,56527
726,630,96,1286,319800,56528
1941,1502,439,1053,268100,56529
785,593,192,785,151600,56531
117,105,12,1292,165800,56533
525,489,36,850,219600,56534
512,379,133,836,215200,56535
181,161,20,611,194200,56536
8439,5958,2481,840,223000,56537
752,641,111,774,185600,56540
24,20,4,-,75000,56541
1009,705,304,800,176800,56542
78,75,3,-,137500,56543
2126,1750,376,882,235900,56544
265,227,38,-,168800,56545
102,96,6,-,230000,56546
966,864,102,638,279400,56547
285,240,45,689,127600,56548
1754,1468,286,750,317500,56549
134,106,28,850,185900,56550
1024,800,224,733,224100,56551
219,191,28,-,167400,56552
135,131,4,-,-,56553
1092,1007,85,795,306200,56554
454,327,127,570,149400,56556
958,650,308,697,121100,56557
18448,11007,7441,1019,248900,56560
16,0,16,-,-,56562
0,0,0,-,-,56563
44,32,12,-,130000,56565
192,102,90,508,109100,56566
1318,1018,300,719,189400,56567
49,44,5,450,154200,56568
460,381,79,725,188600,56569
485,430,55,700,273800,56570
824,732,92,732,316900,56571
2371,1918,453,412,291600,56572
2694,1969,725,805,256900,56573
116,115,1,-,162500,56574
282,224,58,688,268800,56575
393,357,36,925,360800,56576
285,275,10,-,320900,56578
399,364,35,923,210500,56579
485,458,27,780,268200,56580
124,119,5,-,112500,56581
75,57,18,680,208300,56583
573,463,110,1011,125600,56584
479,397,82,757,228100,56585
796,747,49,1021,283500,56586
597,531,66,810,336800,56587
202,190,12,1063,277100,56588
733,631,102,682,207800,56589
166,143,23,747,132800,56590
166,31,135,198,-,56591
193,158,35,813,139600,56592
182,165,17,-,207400,56594
14070,9414,4656,1033,242400,56601
1680,1329,351,736,176700,56621
1212,1027,185,858,227800,56623
92,67,25,776,183800,56626
139,117,22,550,63200,56627
645,569,76,1129,232700,56628
97,76,21,-,217900,56629
816,631,185,785,192800,56630
1577,1081,496,873,157900,56633
614,465,149,767,193400,56634
1913,1680,233,690,195200,56636
87,83,4,-,216300,56637
191,156,35,1268,186100,56639
143,107,36,850,166400,56641
299,246,53,489,154200,56644
160,121,39,1042,212500,56646
314,287,27,883,215500,56647
4271,3440,831,781,143600,56649
406,372,34,575,183900,56650
235,215,20,1125,178000,56651
153,144,9,-,238500,56652
561,474,87,651,145800,56653
16,16,0,-,137500,56654
709,662,47,792,301800,56655
123,123,0,-,394600,56657
0,0,0,-,-,56658
44,41,3,-,341700,56659
119,117,2,-,152900,56660
375,337,38,650,185200,56661
274,266,8,-,389800,56662
100,88,12,-,-,56663
199,115,84,438,113400,56666
313,281,32,-,233100,56667
104,87,17,-,180600,56668
126,126,0,-,237500,56669
274,189,85,539,102400,56670
862,615,247,468,74400,56671
899,766,133,854,266900,56672
224,207,17,1068,136500,56673
771,698,73,993,190600,56676
571,539,32,1575,193300,56678
55,50,5,-,250000,56680
119,87,32,498,177100,56681
281,269,12,695,279400,56683
124,119,5,-,138800,56684
39,38,1,-,235000,56685
390,349,41,-,175300,56686
38,37,1,-,171900,56688
5754,4031,1723,897,189700,56701
174,146,28,1208,129700,56710
41,6,35,-,-,56711
372,299,73,430,192900,56713
457,403,54,767,150900,56714
163,137,26,429,162500,56715
3919,2510,1409,828,178200,56716
5,5,0,-,-,56720
4112,2962,1150,876,247200,56721
129,126,3,-,217300,56722
328,275,53,1037,214400,56723
50,45,5,-,97500,56724
363,334,29,1263,199200,56725
613,551,62,800,160500,56726
356,326,30,733,167200,56727
483,395,88,858,157000,56728
44,42,2,-,205000,56729
64,62,2,-,135000,56731
426,338,88,650,150700,56732
184,163,21,-,87500,56733
231,186,45,647,95000,56734
281,216,65,792,163900,56735
308,279,29,796,336100,56736
345,298,47,400,125000,56737
534,454,80,700,180300,56738
313,268,45,717,121600,56742
224,197,27,933,135100,56744
271,212,59,713,200000,56748
965,820,145,580,162700,56750
2353,1835,518,1039,181800,56751
210,183,27,1115,197100,56754
35,34,1,-,58000,56755
253,235,18,967,189600,56756
355,315,40,1063,113800,56757
160,150,10,-,110400,56758
149,138,11,-,195000,56759
200,190,10,-,196900,56760
188,179,9,-,178000,56761
994,774,220,779,149300,56762
1966,1480,486,830,184700,56763
636,492,144,821,158600,57001
691,558,133,829,224900,57002
730,635,95,1134,261500,57003
1576,1310,266,816,247700,57004
4505,3648,857,985,322600,57005
9761,5130,4631,864,253700,57006
0,0,0,-,-,57007
308,179,129,-,221500,57010
449,383,66,960,163800,57012
1881,1409,472,704,224600,57013
667,571,96,735,217000,57014
273,229,44,850,303300,57015
294,266,28,1107,225600,57016
600,475,125,733,260700,57017
532,431,101,739,241200,57018
582,520,62,1133,285600,57020
139,118,21,-,-,57021
2052,1695,357,940,293800,57022
196,170,26,855,175000,57024
1239,962,277,738,226000,57025
554,380,174,860,203600,57026
82,69,13,-,115400,57027
1274,795,479,661,175400,57028
847,690,157,803,183700,57029
1111,883,228,731,278800,57030
353,328,25,533,138000,57031
3316,2718,598,1351,295600,57032
2237,1854,383,949,280500,57033
293,255,38,-,164000,57034
510,482,28,713,305400,57035
249,220,29,583,145000,57036
372,249,123,844,143000,57037
755,673,82,906,280900,57038
1508,1197,311,925,242700,57039
117,100,17,718,116700,57040
42,42,0,-,-,57041
3249,2085,1164,877,218200,57042
665,550,115,821,198000,57043
448,364,84,504,114400,57045
242,210,32,900,260000,57046
178,141,37,707,49300,57047
485,412,73,560,328300,57048
3287,1995,1292,1160,406300,57049
82,82,0,-,225000,57050
106,90,16,388,100000,57051
125,111,14,-,269600,57052
821,649,172,929,255400,57053
269,231,38,-,108700,57054
463,430,33,-,419600,57055
71,66,5,-,366700,57057
731,559,172,866,199700,57058
545,434,111,581,132800,57059
76,51,25,-,91500,57061
523,407,116,767,160400,57062
370,301,69,540,152200,57063
2522,2070,452,1132,330800,57064
172,136,36,680,166700,57065
601,486,115,805,101900,57066
99,95,4,-,215900,57067
638,545,93,1096,251500,57068
4757,2240,2517,731,225800,57069
600,389,211,683,202000,57070
1349,900,449,1026,243900,57071
240,196,44,683,181600,57072
192,160,32,644,113700,57073
572,507,65,705,430300,57075
166,126,40,742,263900,57076
522,453,69,1177,231700,57077
8557,5994,2563,777,213300,57078
14259,9598,4661,938,244800,57103
12390,5403,6987,849,183700,57104
9847,6413,3434,956,247900,57105
21330,12785,8545,996,268800,57106
4702,3256,1446,1079,250700,57107
13739,8671,5068,1292,401300,57108
8889,5757,3132,1018,365600,57110
0,0,0,-,-,57117
0,0,0,-,-,57197
11442,7550,3892,903,223600,57201
768,623,145,812,229900,57212
171,128,43,1150,144800,57213
58,54,4,-,76000,57214
657,563,94,721,212700,57216
89,77,12,-,102900,57217
134,124,10,720,210000,57218
219,151,68,1032,82500,57219
317,266,51,692,196100,57220
362,277,85,738,229100,57221
494,436,58,1096,229500,57223
80,69,11,-,79400,57224
697,571,126,713,144200,57225
736,559,177,678,175800,57226
150,123,27,-,214600,57227
696,577,119,748,173600,57231
212,200,12,740,289300,57232
49,40,9,-,280000,57233
528,465,63,625,169600,57234
299,275,24,775,224200,57235
39,35,4,-,-,57236
298,268,30,479,154000,57237
156,117,39,783,215200,57238
185,168,17,-,290600,57239
373,264,109,756,136500,57241
134,119,15,681,215600,57242
277,251,26,1063,117000,57243
81,54,27,-,123700,57245
71,70,1,-,90000,57246
94,77,17,-,236600,57247
392,304,88,956,245100,57248
426,341,85,535,202500,57249
38,28,10,-,115600,57251
1878,1485,393,525,184500,57252
189,156,33,505,83300,57255
91,82,9,-,-,57256
204,125,79,571,57600,57257
64,54,10,-,80000,57258
242,210,32,-,-,57259
434,368,66,832,137100,57260
111,70,41,558,114300,57261
1692,901,791,656,121100,57262
185,157,28,671,102200,57263
65,53,12,-,106300,57264
103,71,32,-,122500,57265
196,150,46,738,159400,57266
245,194,51,559,180600,57268
114,110,4,-,411800,57269
232,173,59,653,89100,57270
57,55,2,-,-,57271
56,29,27,589,83100,57272
463,332,131,578,155800,57273
1171,884,287,619,161900,57274
438,376,62,679,178100,57276
253,199,54,745,202700,57278
436,388,48,647,161400,57279
8350,5271,3079,775,191300,57301
481,417,64,729,191900,57311
251,217,34,867,-,57312
459,372,87,806,106900,57313
225,175,50,783,119000,57314
408,305,103,625,107400,57315
226,141,85,545,120300,57317
373,307,66,719,150600,57319
100,100,0,-,252000,57321
97,82,15,-,118800,57322
100,96,4,850,75000,57323
147,143,4,-,225000,57324
1144,792,352,685,208400,57325
454,330,124,975,177900,57328
136,111,25,1042,124200,57329
184,153,31,625,150700,57330
129,98,31,-,226700,57331
272,248,24,619,148200,57332
298,226,72,769,179800,57334
138,121,17,750,121300,57335
42,27,15,-,24600,57337
355,166,189,535,101100,57339
90,83,7,458,225000,57340
46,34,12,-,214300,57341
174,166,8,-,117400,57342
41,38,3,-,-,57344
464,394,70,1000,122000,57345
7,0,7,-,-,57346
272,163,109,690,110600,57348
595,474,121,550,116000,57349
6267,4277,1990,840,180400,57350
336,298,38,700,158800,57353
30,30,0,-,-,57354
502,385,117,772,169400,57355
586,412,174,694,113800,57356
6,6,0,-,-,57358
230,192,38,760,161800,57359
64,29,35,519,-,57361
852,524,328,546,147600,57362
337,232,105,389,207000,57363
4,0,4,-,-,57364
278,232,46,847,259300,57365
1084,820,264,748,173400,57366
107,93,14,775,275000,57367
419,306,113,877,143300,57368
1015,805,210,869,226000,57369
306,228,78,736,187500,57370
92,55,37,-,-,57371
158,93,65,-,114600,57373
120,105,15,425,199200,57374
254,198,56,714,143300,57375
439,325,114,439,112900,57376
46,44,2,-,164300,57379
949,619,330,724,153800,57380
249,159,90,522,113800,57381
569,452,117,457,132100,57382
333,264,69,658,105600,57383
399,316,83,702,162000,57384
557,437,120,625,149700,57385
135,101,34,-,131300,57386
13868,8607,5261,787,216300,57401
82,69,13,-,79800,57420
16,16,0,-,-,57421
74,64,10,-,95000,57422
119,105,14,-,56800,57424
19,19,0,-,256800,57426
230,198,32,-,384100,57427
223,140,83,693,114300,57428
47,44,3,-,112500,57429
800,614,186,788,118400,57430
101,97,4,-,150700,57432
193,185,8,-,-,57433
228,206,22,-,-,57434
156,130,26,1325,209500,57435
203,178,25,680,66700,57436
585,472,113,560,80300,57437
383,280,103,791,116400,57438
1,1,0,-,-,57439
127,119,8,-,103800,57440
216,196,20,700,116000,57441
807,621,186,902,133400,57442
845,659,186,972,185200,57445
206,200,6,-,-,57446
182,163,19,-,57000,57448
82,20,62,-,-,57449
209,172,37,-,126900,57450
958,785,173,1019,221100,57451
79,68,11,-,70000,57452
251,221,30,800,180800,57454
53,38,15,-,73300,57455
228,187,41,850,72100,57456
41,31,10,-,47200,57457
122,105,17,-,271900,57460
119,104,15,-,161100,57461
141,128,13,-,124000,57465
72,68,4,-,39400,57466
117,108,9,-,-,57467
116,96,20,775,103800,57468
1262,825,437,708,152600,57469
34,34,0,-,167900,57470
224,199,25,1075,77900,57471
392,303,89,590,118900,57472
105,102,3,-,158300,57473
70,70,0,-,215900,57474
58,52,6,-,107800,57475
187,170,17,725,123700,57476
47,43,4,-,50600,57477
267,250,17,1057,230000,57479
150,141,9,-,201000,57481
7185,5422,1763,933,222600,57501
83,67,16,850,113800,57520
51,26,25,-,37100,57521
203,119,84,888,179200,57522
402,303,99,548,206500,57523
377,231,146,748,81500,57528
121,119,2,-,278400,57529
38,29,9,-,57200,57531
1231,968,263,896,174700,57532
678,532,146,746,112800,57533
67,42,25,-,116400,57534
103,62,41,622,137500,57536
16,16,0,-,-,57537
90,80,10,-,-,57538
57,39,18,-,269400,57540
57,35,22,695,-,57541
265,177,88,569,159100,57543
200,163,37,664,144300,57544
57,57,0,-,111000,57547
254,104,150,429,48000,57548
754,484,270,734,138300,57551
203,189,14,-,116600,57552
93,82,11,-,166700,57553
1084,578,506,535,73800,57555
279,201,78,531,123600,57559
125,70,55,-,-,57560
25,22,3,-,-,57562
36,16,20,-,-,57563
373,312,61,958,199100,57564
221,56,165,498,10300,57566
417,321,96,739,181900,57567
261,214,47,831,162900,57568
147,109,38,-,114000,57569
500,158,342,558,45000,57570
21,19,2,-,72500,57571
352,186,166,573,35000,57572
56,37,19,-,273300,57574
35,31,4,-,167500,57576
218,89,129,405,58800,57577
430,284,146,818,58800,57579
1689,1227,462,852,141000,57580
56,48,8,-,-,57584
59,32,27,692,103800,57585
1689,1181,508,969,153000,57601
266,205,61,943,92100,57620
57,18,39,575,-,57621
62,21,41,828,-,57622
291,186,105,720,84700,57623
1168,641,527,718,72000,57625
339,259,80,550,162500,57626
16,16,0,-,-,57630
209,189,20,-,106700,57631
313,231,82,631,83100,57632
176,136,40,756,63300,57633
41,35,6,-,93800,57634
32,24,8,-,207100,57636
805,670,135,625,90500,57638
71,10,61,244,-,57639
29,16,13,-,-,57640
110,91,19,613,62500,57641
554,285,269,496,78500,57642
138,108,30,-,203200,57644
74,67,7,-,37100,57645
106,91,15,-,101400,57646
225,178,47,721,97100,57648
89,75,14,-,73200,57649
3,0,3,-,-,57650
38,24,14,-,310000,57651
87,46,41,467,-,57652
342,245,97,567,86800,57656
60,51,9,-,74600,57657
75,43,32,425,81300,57658
7,7,0,-,-,57659
44,36,8,-,102100,57660
42,15,27,603,-,57661
18711,11111,7600,892,229900,57701
15374,11162,4212,1209,341400,57702
6853,5893,960,1394,250300,57703
678,0,678,1657,-,57706
179,44,135,615,110400,57714
99,99,0,-,-,57716
3474,2745,729,937,215000,57717
3083,2722,361,1167,271400,57718
4211,2594,1617,1212,275400,57719
280,226,54,579,128800,57720
104,83,21,-,67500,57722
93,63,30,-,214500,57724
89,67,22,-,275000,57725
2519,2033,486,1070,324300,57730
1097,682,415,725,279300,57732
677,550,127,1011,118100,57735
30,0,30,-,-,57737
216,214,2,-,486400,57738
52,52,0,-,-,57741
870,781,89,1473,350800,57744
644,534,110,1016,323500,57745
3008,2300,708,850,195600,57747
93,65,28,633,235900,57748
108,43,65,913,-,57750
366,315,51,660,388300,57751
481,177,304,578,-,57752
1739,1312,427,849,220100,57754
54,49,5,-,155900,57755
196,18,178,535,-,57756
16,7,9,-,-,57758
131,131,0,-,473500,57759
446,407,39,1067,144000,57760
379,325,54,871,263800,57761
221,172,49,950,-,57762
156,138,18,939,114700,57763
511,304,207,582,41100,57764
50,50,0,-,-,57766
83,83,0,-,-,57767
1592,1378,214,1030,329300,57769
1024,577,447,633,54200,57770
304,206,98,485,-,57772
74,69,5,-,"10,000-",57773
97,78,19,-,179200,57775
0,0,0,-,-,57776
170,170,0,-,240500,57779
56,37,19,-,-,57780
20,19,1,-,259400,57782
7614,4379,3235,946,332300,57783
4423,3132,1291,842,263000,57785
183,122,61,854,-,57787
192,171,21,-,225000,57788
384,324,60,532,187500,57790
62,52,10,-,120000,57791
62,62,0,-,-,57792
745,644,101,925,293400,57793
125,80,45,-,-,57794
0,0,0,-,-,57799
102,101,1,-,156300,58001
5,5,0,-,-,58002
134,121,13,-,176600,58004
285,285,0,-,365800,58005
184,165,19,629,240600,58006
29,28,1,-,300000,58007
76,72,4,-,-,58008
10,10,0,-,-,58009
195,179,16,-,234700,58011
1195,743,452,764,307500,58012
51,48,3,-,253800,58013
106,100,6,-,314300,58015
102,78,24,-,115300,58016
157,101,56,514,83600,58017
151,141,10,-,258700,58018
193,191,2,-,241800,58021
660,538,122,867,150000,58027
28,22,6,-,416700,58029
255,232,23,583,120000,58030
133,121,12,-,79600,58031
335,246,89,748,151700,58032
147,123,24,348,211400,58033
94,94,0,-,237500,58035
111,111,0,-,277200,58036
84,71,13,588,187500,58038
487,304,183,905,179200,58040
618,541,77,450,144700,58041
552,536,16,-,334100,58042
51,44,7,-,96300,58043
950,750,200,646,203900,58045
222,177,45,632,161300,58046
1737,1695,42,963,417800,58047
166,150,16,625,166700,58048
142,134,8,-,113500,58049
557,465,92,661,319100,58051
216,181,35,692,227700,58052
567,456,111,684,101100,58053
1324,927,397,691,196300,58054
117,70,47,-,-,58056
111,106,5,-,112500,58057
57,57,0,-,112500,58058
531,480,51,1222,292900,58059
472,382,90,622,162500,58060
153,134,19,506,167500,58061
56,56,0,-,130200,58062
148,132,16,494,215600,58063
180,141,39,513,260700,58064
8,8,0,-,162500,58065
97,84,13,463,122900,58067
105,93,12,-,75000,58068
64,48,16,-,137500,58069
184,142,42,578,192400,58071
3554,2386,1168,792,170500,58072
25,25,0,-,-,58074
3869,2100,1769,756,178800,58075
0,0,0,-,-,58076
279,248,31,1110,261800,58077
15736,10140,5596,1073,303200,58078
153,153,0,-,289600,58079
363,322,41,-,186100,58081
14587,6665,7922,829,235600,58102
23567,9843,13724,831,239200,58103
21141,10049,11092,1087,346100,58104
20,11,9,-,-,58105
19213,9609,9604,966,274000,58201
124,5,119,1344,-,58202
7414,3263,4151,932,202500,58203
512,5,507,1621,-,58204
11,0,11,-,-,58205
129,116,13,705,89100,58210
176,122,54,-,-,58212
147,133,14,-,-,58214
49,38,11,-,216700,58216
320,279,41,684,245000,58218
44,44,0,-,82700,58219
991,659,332,843,165900,58220
102,89,13,1667,83100,58222
111,100,11,-,327000,58223
25,25,0,-,67900,58224
473,394,79,570,122100,58225
231,191,40,639,107500,58227
337,256,81,735,176600,58228
63,63,0,-,106900,58229
259,189,70,608,101200,58230
177,159,18,-,92300,58231
146,129,17,-,159700,58233
207,193,14,1063,111000,58235
35,33,2,-,-,58236
2132,1493,639,725,154900,58237
50,50,0,-,129200,58238
16,13,3,-,92500,58239
463,384,79,717,161500,58240
77,45,32,1567,97900,58241
208,182,26,930,120200,58243
18,18,0,-,-,58244
1027,824,203,818,145000,58249
95,72,23,569,82500,58250
847,732,115,680,213600,58251
245,188,57,581,106900,58254
0,0,0,-,-,58255
311,277,34,1182,208300,58256
834,407,427,833,198000,58257
128,126,2,-,98500,58258
232,180,52,1044,102500,58259
62,54,8,-,84700,58260
518,483,35,725,118900,58261
31,23,8,725,-,58262
183,166,17,-,103100,58265
48,34,14,-,86700,58266
536,429,107,758,203500,58267
90,70,20,1094,55000,58269
764,574,190,932,145500,58270
233,172,61,675,139100,58271
93,88,5,1042,112500,58272
83,77,6,-,78300,58273
388,336,52,506,195300,58274
331,276,55,1388,216300,58275
208,178,30,545,78500,58276
83,74,9,-,213000,58277
828,779,49,719,314400,58278
34,34,0,-,77300,58281
604,434,170,648,108700,58282
4515,2515,2000,682,205200,58301
5,5,0,-,-,58310
29,22,7,-,94000,58311
31,28,3,-,84300,58313
1680,1059,621,467,82300,58316
104,93,11,375,91700,58317
1603,1220,383,744,218000,58318
41,26,15,-,264300,58321
15,15,0,-,-,58323
574,405,169,757,144600,58324
30,28,2,-,-,58325
121,115,6,-,186100,58327
781,458,323,410,84800,58329
246,149,97,843,81700,58330
79,75,4,-,58900,58331
117,86,31,648,81800,58332
169,94,75,381,36500,58335
49,41,8,-,114400,58338
5,1,4,-,-,58339
1217,854,363,631,131700,58341
29,29,0,-,216200,58343
370,271,99,616,126400,58344
53,53,0,-,-,58345
251,190,61,624,87600,58346
381,266,115,539,77300,58348
177,135,42,638,105600,58351
154,137,17,-,118400,58352
66,46,20,663,175000,58353
11,11,0,-,62500,58355
838,566,272,616,112800,58356
188,164,24,-,52400,58357
87,73,14,825,219300,58361
12,12,0,-,-,58362
37,37,0,-,164800,58363
93,71,22,560,49500,58365
282,218,64,436,141900,58366
519,333,186,695,150200,58367
1503,1151,352,815,151200,58368
363,294,69,694,116700,58369
279,211,68,567,83300,58370
30,30,0,-,-,58372
321,261,60,538,111700,58374
103,88,15,-,157700,58377
64,30,34,806,-,58379
176,134,42,770,-,58380
184,169,15,840,222900,58381
78,62,16,-,-,58382
182,153,29,675,63600,58384
51,43,8,-,-,58385
31,28,3,-,-,58386
7929,4694,3235,742,208400,58401
0,0,0,-,-,58402
4,0,4,-,-,58405
505,368,137,581,67500,58413
65,62,3,-,-,58415
197,152,45,354,120000,58416
175,144,31,600,80800,58418
104,97,7,-,248200,58420
1351,1023,328,759,168500,58421
59,52,7,-,164300,58422
54,54,0,-,152200,58423
121,107,14,871,289300,58424
534,441,93,570,132700,58425
51,41,10,-,102500,58426
119,91,28,-,188100,58428
154,130,24,-,187000,58429
51,51,0,-,131300,58430
40,31,9,-,107500,58431
507,416,91,520,116300,58433
641,446,195,786,177200,58436
354,287,67,605,78800,58438
73,65,8,-,-,58439
61,45,16,-,91900,58440
107,100,7,-,152500,58441
171,150,21,517,111600,58442
68,62,6,625,56300,58443
85,68,17,538,56500,58444
50,49,1,-,120300,58445
135,102,33,675,120000,58448
26,24,2,-,112500,58451
3,3,0,-,-,58452
159,144,15,570,107700,58454
91,84,7,-,127300,58455
257,219,38,742,95000,58456
457,373,84,775,172400,58458
58,52,6,-,53300,58460
212,197,15,630,163800,58461
317,245,72,362,82900,58463
108,108,0,-,155800,58464
200,192,8,617,113700,58466
229,189,40,625,86100,58467
172,167,5,-,188400,58472
1124,908,216,743,165900,58474
59,58,1,-,27100,58475
257,239,18,1292,116600,58476
53,48,5,-,161100,58477
86,77,9,-,-,58478
83,77,6,-,190600,58479
85,67,18,-,-,58480
97,84,13,-,233300,58481
467,355,112,786,168800,58482
167,143,24,-,86100,58483
38,32,6,-,84000,58484
75,63,12,-,97000,58486
190,140,50,806,59000,58487
92,86,6,-,-,58488
107,100,7,-,150000,58490
143,130,13,631,263600,58492
142,107,35,1188,153700,58494
508,426,82,712,104700,58495
89,66,23,825,179800,58496
107,107,0,-,280200,58497
12031,7611,4420,938,276000,58501
15127,11289,3838,1131,383300,58503
11932,8870,3062,940,282100,58504
0,0,0,-,-,58505
114,105,9,-,105700,58520
308,265,43,-,432700,58521
1344,1053,291,1092,199900,58523
42,42,0,-,-,58524
166,58,108,452,111100,58528
289,243,46,621,78000,58529
429,391,38,725,186900,58530
195,195,0,-,262500,58531
167,97,70,1110,212500,58532
442,341,101,649,110300,58533
225,202,23,578,119400,58535
628,243,385,447,82400,58538
1204,1025,179,669,257800,58540
229,201,28,-,232100,58541
106,91,15,1583,102000,58542
228,188,40,875,147200,58544
1484,1145,339,994,208400,58545
93,88,5,-,187500,58549
774,602,172,538,106100,58552
11728,8651,3077,1048,266900,58554
295,252,43,1534,339100,58558
165,139,26,-,281500,58559
91,78,13,788,303000,58560
432,350,82,850,98200,58561
158,141,17,840,80200,58562
752,652,100,850,193100,58563
53,51,2,-,-,58564
108,90,18,-,220500,58565
110,71,39,-,306500,58566
162,102,60,752,98200,58568
40,40,0,-,-,58569
158,154,4,-,134400,58570
315,297,18,-,119300,58571
134,125,9,-,461100,58572
282,231,51,543,98300,58573
413,353,60,779,170400,58575
484,395,89,808,197900,58576
826,608,218,804,248900,58577
436,386,50,838,279200,58579
260,242,18,1125,251800,58580
145,114,31,583,-,58581
11831,7386,4445,968,269200,58601
67,54,13,-,-,58620
486,352,134,867,120800,58621
636,511,125,1087,218300,58622
814,663,151,861,183400,58623
105,100,5,-,294400,58625
184,109,75,972,251700,58626
74,61,13,-,285000,58627
192,149,43,1344,234300,58630
450,379,71,750,122700,58631
91,61,30,442,122000,58632
116,86,30,-,241900,58634
336,263,73,938,121100,58636
385,300,85,869,111700,58638
813,577,236,498,116900,58639
480,355,125,950,286300,58640
27,23,4,-,-,58641
125,86,39,-,275000,58642
56,51,5,-,52500,58643
8,8,0,-,400000,58644
136,95,41,634,347200,58645
499,397,102,644,86300,58646
494,392,102,861,183300,58647
158,127,31,1375,57400,58649
219,187,32,822,135900,58650
250,211,39,2083,159400,58651
476,413,63,588,196700,58652
271,224,47,777,159200,58653
96,95,1,-,-,58654
259,217,42,712,303700,58655
156,143,13,850,253800,58656
14344,8815,5529,875,270200,58701
9362,5895,3467,1030,254800,58703
1329,5,1324,1413,-,58704
0,0,0,-,-,58705
0,0,0,-,-,58707
252,219,33,730,113700,58710
68,63,5,-,179200,58711
39,31,8,-,104200,58712
36,36,0,-,576900,58713
115,113,2,-,251900,58716
474,375,99,675,217200,58718
194,156,38,525,136500,58721
541,428,113,988,241400,58722
94,84,10,-,118800,58723
174,170,4,-,206700,58725
85,79,6,-,257500,58727
598,424,174,1023,153300,58730
154,115,39,-,142200,58731
102,100,2,-,166700,58733
102,102,0,-,166700,58734
155,143,12,1417,330000,58735
226,188,38,746,84300,58736
48,47,1,-,-,58737
295,242,53,1172,207400,58740
289,270,19,641,123800,58741
60,58,2,-,171400,58744
689,539,150,815,148300,58746
52,51,1,-,-,58748
246,169,77,791,217900,58750
149,91,58,728,123200,58752
109,98,11,-,-,58755
85,73,12,608,106300,58756
371,152,219,829,171300,58757
116,113,3,-,112500,58758
264,233,31,1000,177200,58759
100,99,1,-,87900,58760
329,251,78,642,152700,58761
91,67,24,522,113000,58762
1697,935,762,784,219500,58763
117,97,20,1147,95800,58765
129,106,23,-,189300,58768
105,72,33,938,112100,58769
614,347,267,705,181000,58770
256,219,37,1063,165100,58771
94,62,32,678,79100,58772
384,317,67,1051,254600,58773
69,45,24,575,-,58775
109,16,93,1285,-,58776
77,77,0,-,406100,58778
116,89,27,529,58200,58779
258,244,14,1225,263200,58781
192,159,33,458,45000,58782
173,165,8,329,223600,58783
1108,672,436,1125,253200,58784
617,584,33,846,306400,58785
44,37,7,-,-,58787
394,302,92,-,125900,58788
175,155,20,-,118000,58789
576,425,151,732,232500,58790
106,68,38,-,213300,58792
204,174,30,1917,125000,58793
117,79,38,-,-,58794
98,84,14,-,132100,58795
13025,7142,5883,1116,279800,58801
52,52,0,-,181300,58830
411,300,111,1396,384100,58831
71,69,2,-,196100,58833
368,324,44,-,423600,58835
146,102,44,-,250000,58838
259,238,21,1417,296400,58843
55,45,10,-,-,58844
289,249,40,-,181900,58845
131,47,84,-,-,58847
484,343,141,971,239100,58849
870,515,355,1043,207200,58852
147,88,59,639,-,58853
3789,1842,1947,1212,387700,58854
78,43,35,-,248100,58856
723,571,152,1011,312400,59001
53,29,24,1162,430000,59002
504,174,330,632,115600,59003
479,357,122,852,240800,59006
43,22,21,907,200000,59007
156,126,30,-,265500,59008
91,80,11,-,287500,59010
1261,947,314,1061,286200,59011
22,11,11,-,-,59012
75,75,0,-,503300,59013
609,400,209,775,262900,59014
129,113,16,-,228800,59015
277,208,69,349,116700,59016
312,245,67,950,330600,59018
1740,1420,320,921,352900,59019
56,27,29,1225,362500,59020
482,355,127,470,86300,59022
137,99,38,406,190600,59024
25,4,21,-,-,59025
69,46,23,-,345500,59026
418,346,72,824,427400,59027
233,185,48,1396,519100,59028
348,283,65,817,267100,59029
713,348,365,724,539900,59030
77,60,17,-,118800,59031
185,121,64,486,122500,59032
64,64,0,-,-,59033
1762,1085,677,723,178200,59034
94,89,5,-,176200,59035
635,460,175,778,186700,59036
866,769,97,1119,326100,59037
319,214,105,591,206900,59038
6,5,1,-,-,59039
778,634,144,1163,325500,59041
655,362,293,500,114500,59043
5059,3573,1486,983,317200,59044
192,147,45,775,278800,59046
6127,4234,1893,980,420000,59047
355,273,82,619,149200,59050
86,72,14,1219,1350000,59052
144,115,29,-,188300,59053
114,99,15,738,184400,59054
27,9,18,970,-,59055
337,321,16,414,423200,59057
17,17,0,-,243800,59058
91,65,26,-,-,59059
150,117,33,568,329200,59061
27,22,5,-,138600,59062
772,620,152,1107,336800,59063
108,78,30,-,277000,59064
54,49,5,-,793800,59065
170,135,35,675,121100,59066
76,53,23,444,338900,59067
1944,1305,639,795,413900,59068
220,205,15,1705,392400,59069
501,409,92,1200,497900,59070
31,31,0,-,-,59071
1911,1581,330,877,222400,59072
192,165,27,775,131700,59074
74,62,12,-,211300,59075
25,11,14,-,275000,59076
14,11,3,-,265000,59077
59,44,15,-,138600,59078
1562,1500,62,1516,350400,59079
46,44,2,-,562500,59081
6,6,0,-,-,59082
4,4,0,-,-,59083
54,54,0,-,94200,59085
434,330,104,1178,355600,59086
182,140,42,769,167100,59087
462,333,129,961,226000,59088
156,95,61,573,215500,59089
17546,10150,7396,930,243000,59101
21404,14311,7093,1148,307400,59102
13564,10387,3177,1261,314900,59105
7804,6215,1589,1380,483100,59106
1649,1102,547,725,131800,59201
50,45,5,-,-,59211
172,142,30,732,394100,59212
233,185,48,-,74100,59213
19,17,2,-,170800,59214
476,375,101,545,197500,59215
65,65,0,-,-,59217
337,251,86,961,256600,59218
50,46,4,-,114600,59219
813,662,151,880,235100,59221
119,104,15,-,104200,59222
21,21,0,-,443300,59223
156,94,62,331,107100,59225
170,140,30,650,177500,59226
1835,1399,436,800,237700,59230
120,110,10,-,-,59231
12,12,0,-,266700,59240
217,147,70,543,119300,59241
27,25,2,-,122500,59242
130,92,38,1088,311800,59243
14,14,0,-,-,59244
157,120,37,-,90000,59247
398,349,49,900,210900,59248
80,74,6,-,51700,59250
21,21,0,-,103100,59252
25,22,3,-,227800,59253
800,584,216,755,147100,59254
687,461,226,429,79900,59255
67,38,29,-,-,59256
47,39,8,-,-,59257
76,47,29,-,137500,59258
145,116,29,455,121400,59259
58,43,15,-,170800,59260
220,174,46,554,163900,59261
257,165,92,663,272900,59262
552,440,112,585,184400,59263
3567,2442,1125,876,260600,59270
4,3,1,-,-,59273
153,145,8,-,112500,59274
198,184,14,583,80400,59275
10,6,4,-,-,59276
4874,3285,1589,918,202100,59301
66,45,21,-,-,59311
4,4,0,-,-,59312
958,669,289,772,225500,59313
48,33,15,-,-,59314
36,25,11,-,190600,59315
10,10,0,-,-,59316
456,365,91,603,161400,59317
46,36,10,-,206700,59318
20,8,12,-,-,59319
37,16,21,-,-,59322
886,716,170,632,193700,59323
343,226,117,660,138600,59324
113,60,53,873,224300,59326
1006,725,281,763,210200,59327
3450,2474,976,827,188000,59330
79,27,52,-,-,59332
11,10,1,-,184400,59333
72,58,14,-,276900,59336
285,201,84,821,173600,59337
84,80,4,-,275900,59338
67,61,6,-,237500,59339
19,19,0,-,-,59343
141,104,37,770,308000,59344
21,19,2,-,208300,59345
174,149,25,-,-,59347
408,337,71,607,150400,59349
100,81,19,-,112800,59351
473,356,117,964,93500,59353
69,39,30,-,-,59354
6151,3596,2555,767,206100,59401
11019,9448,1571,1034,272300,59404
14053,8386,5667,947,236800,59405
287,187,100,837,227700,59410
181,129,52,1102,271200,59411
574,454,120,825,236100,59412
328,200,128,857,179800,59414
160,100,60,840,165000,59416
2252,1271,981,481,128800,59417
34,9,25,933,562500,59418
27,23,4,-,-,59419
57,47,10,-,147500,59420
907,777,130,1014,337200,59421
1096,753,343,717,224300,59422
29,18,11,-,265400,59424
1428,919,509,869,190500,59425
1597,1195,402,915,161200,59427
208,155,53,1019,210900,59430
68,57,11,-,234400,59432
191,132,59,775,141000,59433
145,108,37,875,171900,59434
12,12,0,-,-,59435
823,643,180,871,271700,59436
143,91,52,-,217100,59440
44,29,15,-,228800,59441
715,539,176,690,209600,59442
265,219,46,-,273100,59443
91,45,46,781,174300,59444
236,182,54,572,118800,59446
136,105,31,-,225000,59447
164,80,84,457,47500,59448
211,146,65,1339,247600,59450
52,45,7,-,119800,59451
234,166,68,515,192100,59452
145,122,23,525,168800,59453
65,59,6,-,-,59454
127,26,101,-,-,59456
4203,2716,1487,877,205500,59457
129,125,4,-,109700,59460
29,26,3,-,-,59461
59,52,7,-,216700,59462
79,73,6,-,333900,59463
209,156,53,823,241700,59464
20,20,0,-,205600,59465
33,23,10,-,86300,59466
24,19,5,-,-,59467
320,288,32,840,236400,59468
46,44,2,-,262500,59469
137,84,53,-,150000,59471
239,202,37,1100,267500,59472
1301,869,432,770,203600,59474
133,110,23,-,193900,59477
347,250,97,410,190400,59479
143,133,10,950,268800,59480
214,146,68,1042,158800,59482
161,158,3,-,425000,59483
26,23,3,-,134400,59484
287,263,24,2200,289000,59485
478,393,85,782,145200,59486
579,491,88,891,213200,59487
170,153,17,561,-,59489
5027,3496,1531,792,201800,59501
432,261,171,610,123900,59520
1028,426,602,374,67800,59521
424,226,198,657,132500,59522
913,665,248,739,200700,59523
245,187,58,517,58500,59524
86,60,26,-,-,59525
794,445,349,667,85400,59526
288,158,130,550,64300,59527
104,69,35,-,132500,59528
62,28,34,-,263300,59529
54,54,0,-,140600,59530
135,117,18,-,102400,59531
57,49,8,-,-,59532
14,5,9,-,-,59535
10,10,0,-,-,59537
1166,849,317,677,174500,59538
171,82,89,645,100000,59540
117,84,33,900,-,59542
91,41,50,267,220800,59544
29,29,0,-,117400,59545
129,125,4,-,-,59546
26,13,13,-,162500,59547
14765,8384,6381,1023,355000,59601
11398,9325,2073,1291,369800,59602
0,0,0,-,-,59623
0,0,0,-,-,59625
155,129,26,-,229300,59631
1012,787,225,691,260600,59632
177,131,46,-,409500,59633
1885,1733,152,1161,500700,59634
3365,2816,549,998,356200,59635
12,0,12,-,-,59636
212,207,5,-,269000,59638
548,469,79,764,294300,59639
53,38,15,-,275000,59640
19,11,8,-,-,59642
315,279,36,-,322200,59643
1837,1380,457,1022,307500,59644
724,603,121,875,283100,59645
154,132,22,-,310700,59647
201,169,32,957,321400,59648
14870,10348,4522,811,219200,59701
117,90,27,-,532300,59710
4683,3306,1377,666,215600,59711
71,39,32,786,450000,59713
9695,6761,2934,1558,490000,59714
15686,8770,6916,1376,755300,59715
849,735,114,1705,868600,59716
18414,10438,7976,1748,579800,59718
206,187,19,-,-,59720
203,151,52,896,615700,59721
1830,1249,581,769,226600,59722
43,18,25,1275,350000,59724
3518,2292,1226,804,279000,59725
123,97,26,936,347900,59727
163,123,40,742,397200,59728
1118,926,192,1447,475200,59729
954,700,254,1469,817600,59730
73,69,4,-,350000,59731
66,40,26,775,-,59732
63,50,13,-,305300,59733
114,90,24,1536,420000,59735
63,34,29,-,281300,59736
137,130,7,-,188800,59739
238,215,23,-,629600,59740
2240,1768,472,1676,562300,59741
88,70,18,943,484600,59743
46,36,10,-,-,59745
49,46,3,-,353300,59746
73,67,6,-,335000,59747
98,98,0,-,270500,59748
758,643,115,778,347600,59749
133,133,0,-,487500,59750
72,56,16,788,200000,59751
1906,1567,339,1218,426600,59752
404,272,132,939,388600,59754
58,49,9,875,288600,59755
8,0,8,-,-,59756
814,537,277,1050,476600,59758
1651,1289,362,872,333000,59759
104,86,18,867,239300,59760
141,102,39,814,300000,59761
110,101,9,788,440400,59762
14887,6075,8812,1086,393400,59801
9364,4930,4434,1021,420200,59802
6576,4825,1751,1194,492900,59803
3361,2189,1172,1138,507300,59804
9526,6024,3502,1236,419800,59808
7,0,7,-,-,59812
786,687,99,1000,332000,59820
942,714,228,962,379700,59821
814,715,99,688,465800,59823
566,447,119,822,325000,59824
924,813,111,1141,327800,59825
294,273,21,933,491900,59826
159,135,24,570,481900,59827
2382,1976,406,1148,428900,59828
1031,786,245,963,400900,59829
50,26,24,-,318800,59830
179,122,57,688,155600,59831
315,247,68,687,303400,59832
2326,2091,235,1055,486600,59833
904,790,114,1620,400000,59834
182,144,38,795,342400,59837
6464,4454,2010,1054,398800,59840
193,130,63,1292,198100,59841
42,37,5,-,-,59842
104,55,49,631,298200,59843
244,185,59,1073,430400,59844
561,391,170,639,174200,59845
521,519,2,-,398400,59846
2745,2087,658,1172,366500,59847
40,31,9,-,441700,59848
43,32,11,-,361500,59851
407,311,96,797,276600,59853
84,63,21,771,475000,59854
219,136,83,758,127200,59855
54,54,0,-,500000,59856
677,466,211,871,349500,59858
1868,1388,480,792,403800,59859
4765,3307,1458,932,386100,59860
82,82,0,-,-,59863
2466,1679,787,841,271700,59864
1247,924,323,520,310400,59865
481,369,112,880,319700,59866
32,32,0,-,-,59867
880,801,79,1028,286800,59868
4857,4070,787,1082,465800,59870
137,109,28,-,441300,59871
1119,906,213,697,314400,59872
1301,1163,138,575,244500,59873
792,706,86,682,481800,59874
1625,1375,250,983,459900,59875
23954,17255,6699,1052,417200,59901
278,202,76,-,606200,59910
3951,3359,592,1158,608000,59911
6024,4662,1362,1052,438000,59912
249,237,12,-,533000,59913
161,113,48,1175,937500,59914
178,126,52,-,-,59915
79,69,10,-,360500,59916
1957,1630,327,1097,295300,59917
218,192,26,1295,286500,59918
265,199,66,-,-,59919
576,507,69,914,668600,59920
1058,803,255,-,549100,59922
4679,3506,1173,726,241400,59923
601,537,64,927,366300,59925
135,91,44,-,-,59926
145,93,52,-,528200,59927
61,55,6,-,-,59928
119,115,4,-,252800,59929
354,305,49,776,252200,59930
95,93,2,-,1015600,59931
829,596,233,1122,617500,59932
3,0,3,-,-,59933
289,214,75,863,301600,59934
1358,1152,206,975,278800,59935
233,162,71,798,562500,59936
6653,4808,1845,1335,654800,59937
9227,7443,1784,1176,287800,60002
20228,15629,4599,1703,415100,60004
12598,7989,4609,1621,376200,60005
12920,9560,3360,1574,334800,60007
8710,6312,2398,1561,295000,60008
16631,14643,1988,2459,622900,60010
4025,3808,217,2162,397100,60012
9626,8513,1113,1489,291000,60013
17662,14228,3434,1429,296100,60014
10242,8693,1549,2284,602700,60015
23847,16331,7516,1406,300700,60016
9812,7076,2736,1174,302400,60018
5025,3619,1406,1228,215700,60020
1801,1568,233,2134,286400,60021
2937,2692,245,2097,1345200,60022
15989,12614,3375,1705,512400,60025
5519,3856,1663,1983,663100,60026
199,195,4,-,957600,60029
14244,11784,2460,1526,276800,60030
14318,10944,3374,1601,322300,60031
4954,3583,1371,1192,198700,60033
739,542,197,1025,254100,60034
11765,9851,1914,1903,594600,60035
1937,949,988,1800,454500,60040
3533,2706,827,976,241100,60041
3107,2540,567,1826,244000,60042
776,746,30,"3,500+",1409800,60043
4284,2953,1331,1672,568500,60044
7497,6684,813,2321,899200,60045
12070,9889,2181,1645,282500,60046
15356,13699,1657,1817,510000,60047
10448,8787,1661,1569,535100,60048
13068,9718,3350,1522,244500,60050
9618,8093,1525,1665,268000,60051
9111,7701,1410,2210,377000,60053
22107,15477,6630,1456,376300,60056
13437,9886,3551,1552,299200,60060
11095,7434,3661,1862,390300,60061
16290,13312,2978,1921,625800,60062
5177,2185,2992,1069,139900,60064
15266,11626,3640,1521,427900,60067
15165,12929,2236,1511,539700,60068
3551,2903,648,2682,569900,60069
6190,3910,2280,1391,343100,60070
1910,1356,554,1189,289800,60071
321,302,19,1021,390200,60072
19930,15584,4346,1461,215200,60073
14375,8750,5625,1429,307800,60074
21,21,0,-,-,60075
11458,9061,2397,1576,381000,60076
10807,7109,3698,1450,327400,60077
3302,3029,273,1204,332800,60081
3562,3339,223,1702,286400,60083
6535,5241,1294,1267,283300,60084
25514,11884,13630,1133,164800,60085
9695,6162,3533,1294,185800,60087
1333,7,1326,1832,-,60088
16052,13081,2971,2042,393000,60089
15201,9292,5909,1578,243500,60090
10223,9026,1197,1968,800100,60091
7215,6566,649,1840,1073700,60093
2797,2393,404,1262,238000,60096
4239,3799,440,1369,215700,60097
12819,9398,3421,1178,257900,60098
11279,7087,4192,1131,190300,60099
13740,9374,4366,1236,315300,60101
11788,10375,1413,1826,320600,60102
14661,12966,1695,1851,353300,60103
6120,4879,1241,1221,219300,60104
7332,3921,3411,1379,265600,60106
13030,11537,1493,1849,258300,60107
9184,6786,2398,1607,367400,60108
193,148,45,1199,304000,60109
11973,8826,3147,1421,224300,60110
94,72,22,-,373500,60111
1612,1250,362,1420,202400,60112
92,68,24,870,179500,60113
16899,7241,9658,1018,205700,60115
6343,4422,1921,1532,340000,60118
4368,3947,421,1620,366300,60119
16532,10845,5687,1250,227000,60120
17481,12478,5003,1226,242200,60123
8708,8177,531,1956,403300,60124
17792,14286,3506,1890,527600,60126
84,69,15,696,177100,60129
7035,3773,3262,1352,293800,60130
5838,4406,1432,1092,261800,60131
11210,8525,2685,1478,260900,60133
10876,9271,1605,1816,427300,60134
2888,2113,775,1038,238000,60135
2907,2491,416,1786,330100,60136
14425,11675,2750,1321,490800,60137
11443,7340,4103,1558,249300,60139
7316,6470,846,1379,316900,60140
169,0,169,572,-,60141
12851,11426,1425,1377,324300,60142
4616,3277,1339,1775,386600,60143
31,23,8,1125,295800,60144
860,735,125,812,251800,60145
904,676,228,1110,209400,60146
20442,14618,5824,1805,328600,60148
687,482,205,1054,183800,60150
1566,1300,266,1649,334200,60151
4487,3556,931,1090,259200,60152
7333,4434,2899,1203,212600,60153
7084,6473,611,1767,297400,60154
3123,1993,1130,1091,240600,60155
9898,8364,1534,1634,296400,60156
920,902,18,-,512500,60157
8321,4768,3553,1194,265000,60160
3050,2109,941,1265,233800,60162
1980,1660,320,1292,223200,60163
7186,5387,1799,1143,240400,60164
1203,656,547,1222,218300,60165
12353,8130,4223,1694,292300,60169
4106,2448,1658,1230,244700,60171
9126,7304,1822,1498,323000,60172
6576,2100,4476,1786,311200,60173
12524,8504,4020,1738,348100,60174
8862,8484,378,2859,476100,60175
4240,2265,1975,1214,276200,60176
8533,6933,1600,1612,296200,60177
8699,6307,2392,1084,262700,60178
729,608,121,1748,290300,60180
11460,7952,3508,1619,294700,60181
5,0,5,-,-,60183
895,848,47,"3,500+",674000,60184
10611,8378,2233,1400,313600,60185
9987,6989,2998,1744,432200,60187
15163,10592,4571,1465,311600,60188
12054,9485,2569,1747,467300,60189
4529,4181,348,1462,367800,60190
5328,4102,1226,1649,307600,60191
5933,5354,579,2852,413500,60192
15709,11750,3959,1699,317900,60193
7884,5701,2183,1897,310600,60194
2335,721,1614,1728,239900,60195
17363,9533,7830,1792,577800,60201
14024,7991,6033,1612,381300,60202
1689,1586,103,1852,469400,60203
0,0,0,-,-,60208
2087,367,1720,2295,230300,60301
14653,9120,5533,1348,450700,60302
6527,4641,1886,1279,470100,60304
4275,3806,469,1411,676900,60305
2885,2449,436,1078,239000,60401
23143,14828,8315,1168,277800,60402
7651,5215,2436,1386,223000,60403
7205,6775,430,1945,319800,60404
9164,4492,4672,1081,166000,60406
626,530,96,1446,178200,60407
2097,1681,416,1089,219800,60408
14678,8199,6479,1138,133600,60409
4514,4066,448,1613,293500,60410
18444,12043,6401,1156,148200,60411
5309,2918,2391,1198,217800,60415
3693,2903,790,1074,222900,60416
5936,5308,628,1362,225900,60417
5016,3873,1143,1300,187600,60418
7919,5700,2219,1399,140500,60419
1841,1297,544,984,161800,60420
1548,1345,203,989,251400,60421
3708,3558,150,2191,304400,60422
10997,10293,704,1455,376500,60423
800,603,197,1041,191600,60424
3088,2416,672,1639,182000,60425
8299,4717,3582,987,88500,60426
3655,2679,976,1686,118900,60428
5116,3545,1571,1440,180800,60429
7302,5812,1490,1419,209100,60430
8942,8146,796,1408,275100,60431
6447,3684,2763,1261,185100,60432
5252,3373,1879,1307,167800,60433
18945,12614,6331,1145,217200,60435
6565,3757,2808,1242,170800,60436
41,39,2,-,168800,60437
11303,7933,3370,1271,168600,60438
8697,7695,1002,1046,466800,60439
17404,13063,4341,1648,262100,60440
12580,10430,2150,1488,287100,60441
4521,4098,423,1225,340100,60442
8323,6457,1866,1377,229000,60443
713,594,119,937,219800,60444
6017,4686,1331,1202,201700,60445
13388,11051,2337,1894,245100,60446
5403,4903,500,1525,295400,60447
8905,8115,790,1400,369700,60448
3606,3496,110,-,269900,60449
8913,5798,3115,1122,266600,60450
12519,11620,899,1304,373100,60451
10182,8077,2105,1287,249100,60452
21745,17940,3805,1310,267900,60453
6241,4095,2146,1139,234400,60455
1916,1393,523,812,152000,60456
5594,4009,1585,1112,278000,60457
5311,2777,2534,1219,223800,60458
9674,7761,1913,1241,258900,60459
534,440,94,971,166500,60460
1835,1580,255,"3,500+",289000,60461
16446,13782,2664,1393,330400,60462
5226,4912,314,2119,343700,60463
3947,3474,473,2058,463100,60464
7327,5831,1496,1267,259200,60465
8301,5384,2917,1341,106100,60466
9646,8989,657,2202,392200,60467
2258,1700,558,1102,282500,60468
1619,1155,464,1478,173900,60469
170,148,22,700,113800,60470
5244,2574,2670,1319,200800,60471
1555,1011,544,1188,114200,60472
7575,6305,1270,1914,200000,60473
278,251,27,1458,166200,60474
4326,2696,1630,1032,137200,60475
790,642,148,1099,146600,60476
15442,12800,2642,1485,262400,60477
5418,4171,1247,1677,180900,60478
290,237,53,1115,214400,60479
2398,2048,350,1328,355600,60480
4610,3410,1200,975,224800,60481
4491,2942,1549,1156,216800,60482
2163,1383,780,1534,140500,60484
9119,8473,646,1428,339600,60487
6362,5716,646,2535,378800,60490
7533,7022,511,1604,404800,60491
3813,2390,1423,1017,227300,60501
8364,6714,1650,1953,389100,60502
5167,4680,487,2222,311300,60503
14009,8600,5409,1861,272800,60504
17327,10008,7319,1230,192500,60505
17681,11876,5805,1305,246700,60506
10961,8569,2392,1285,363000,60510
601,553,48,1494,287100,60511
418,306,112,-,280600,60512
7663,6078,1585,1334,314000,60513
3926,3034,892,1195,568300,60514
11939,9182,2757,1563,453300,60515
11383,8830,2553,1636,423000,60516
12822,8571,4251,1507,342000,60517
1518,1027,491,1051,151200,60518
32,32,0,-,247100,60519
1161,913,248,1333,292600,60520
6000,5354,646,1921,988000,60521
4203,3356,847,776,733300,60523
12288,9785,2503,1475,422500,60525
5074,3766,1308,1413,427800,60526
12123,9440,2683,1553,488300,60527
276,238,38,1102,275900,60530
816,549,267,1532,225800,60531
12702,7147,5555,1576,387800,60532
4118,2675,1443,1149,243500,60534
28,22,6,1100,200000,60536
254,239,15,1104,204800,60537
10138,8058,2080,1845,253900,60538
0,0,0,-,-,60539
15239,11455,3784,1982,504900,60540
1088,939,149,1547,302900,60541
7162,5273,1889,1596,324600,60542
14200,12240,1960,1558,319300,60543
10223,8752,1471,1809,311700,60544
4713,3600,1113,1571,235500,60545
6479,4965,1514,1331,377600,60546
4355,3457,898,1046,240000,60548
250,217,33,-,292000,60549
454,318,136,872,192500,60550
1470,1201,269,888,247300,60551
1864,1581,283,1306,245300,60552
237,204,33,1536,173200,60553
4635,4262,373,1140,366200,60554
5675,4304,1371,1757,271900,60555
754,630,124,967,242900,60556
25,25,0,-,-,60557
4475,4274,201,1932,691300,60558
10389,6148,4241,1491,356400,60559
9732,8128,1604,1626,324900,60560
9278,7356,1922,1684,388800,60561
16200,8660,7540,1786,422900,60563
15804,13731,2073,2172,550400,60564
13822,12220,1602,1764,490100,60565
7635,6992,643,2326,416400,60585
14421,13352,1069,2159,298000,60586
9629,2598,7031,2451,495400,60601
551,255,296,2775,383300,60602
719,461,258,2104,608100,60603
383,164,219,2500,577700,60604
18822,7635,11187,2402,495900,60605
2637,705,1932,2535,366500,60606
15037,6254,8783,2333,494300,60607
30070,12086,17984,1208,341500,60608
23174,9641,13533,1070,251600,60609
27145,9301,17844,2029,543000,60610
23564,10219,13345,2416,608200,60611
14934,4601,10333,1330,331600,60612
28784,10817,17967,1616,397800,60613
34603,15614,18989,2019,730700,60614
22430,7146,15284,1444,305200,60615
25360,9976,15384,1329,387300,60616
30248,16997,13251,1010,168200,60617
37745,18361,19384,1534,538300,60618
28016,12135,15881,1054,213000,60619
25896,12902,12994,1093,187900,60620
11382,2846,8536,1017,161900,60621
25594,10760,14834,1932,622900,60622
27450,10535,16915,1054,221400,60623
13435,3544,9891,1152,223200,60624
31681,12778,18903,1455,396700,60625
24103,6423,17680,1265,269000,60626
23170,13394,9776,1168,158500,60628
34229,20957,13272,1106,236300,60629
21698,14893,6805,1357,362900,60630
12144,9012,3132,1604,431400,60631
27058,15658,11400,1057,240600,60632
4919,3044,1875,1166,182100,60633
27575,20399,7176,1271,333900,60634
11444,5821,5623,1135,150600,60636
22628,5908,16720,1170,243700,60637
20805,16837,3968,1327,283500,60638
26703,12705,13998,1212,289000,60639
37727,11795,25932,1374,363300,60640
25449,13389,12060,1249,373200,60641
11379,3700,7679,2216,604200,60642
18289,13392,4897,1359,233900,60643
18748,5575,13173,1096,238300,60644
16613,8577,8036,1424,308200,60645
11080,8765,2315,1241,493600,60646
38440,14729,23711,1714,557300,60647
24326,6099,18227,1066,199500,60649
20880,9554,11326,1186,262700,60651
13353,11523,1830,1208,235000,60652
16833,5202,11631,856,347800,60653
15955,5493,10462,2571,495900,60654
10817,9023,1794,1468,303300,60655
12392,7962,4430,1388,344400,60656
39636,15040,24596,1839,534500,60657
13612,6186,7426,1391,358800,60659
21349,7984,13365,1286,287500,60660
7475,2243,5232,2403,397700,60661
9292,6903,2389,1242,347600,60706
15486,9961,5525,1309,315300,60707
4593,3878,715,"3,500+",475400,60712
11328,8689,2639,1247,351100,60714
9201,6236,2965,1113,200600,60803
25031,13667,11364,1121,236000,60804
7328,6109,1219,1425,255700,60805
9372,3868,5504,1044,123800,60827
13006,7876,5130,1020,143200,60901
209,166,43,861,141400,60910
480,387,93,833,151900,60911
288,228,60,726,86300,60912
705,620,85,780,252500,60913
9975,7093,2882,1206,240500,60914
4147,2611,1536,1106,143100,60915
175,171,4,-,182200,60917
300,254,46,843,97900,60918
199,153,46,933,151000,60919
58,46,12,975,125000,60920
635,446,189,693,105000,60921
952,696,256,1055,163800,60922
695,540,155,645,148400,60924
26,25,1,-,45800,60926
891,712,179,875,194100,60927
236,195,41,593,114000,60928
264,206,58,940,89600,60929
297,218,79,850,150000,60930
176,158,18,1056,112000,60931
132,124,8,-,588500,60932
112,89,23,1045,81800,60933
91,71,20,950,142000,60934
413,383,30,1147,245900,60935
1884,1342,542,802,151000,60936
809,666,143,702,122900,60938
0,0,0,-,-,60939
1150,949,201,1201,244800,60940
614,455,159,1176,198300,60941
2458,1725,733,806,70000,60942
87,77,10,850,95000,60945
166,132,34,1087,68000,60946
747,724,23,1031,238300,60948
188,115,73,775,99300,60949
5073,3564,1509,1008,244000,60950
336,279,57,750,122700,60951
260,223,37,821,86900,60952
905,709,196,720,98500,60953
2222,1680,542,838,159000,60954
677,602,75,748,105300,60955
40,30,10,720,86700,60956
2363,1775,588,920,122200,60957
651,449,202,900,78100,60958
426,292,134,771,91000,60959
302,219,83,724,65900,60960
373,352,21,1288,160200,60961
224,160,64,1058,67500,60962
548,433,115,790,99900,60963
1897,1469,428,937,178100,60964
722,516,206,707,75700,60966
0,0,0,-,-,60967
201,174,27,753,101600,60968
27,24,3,-,154200,60969
2675,1868,807,816,120700,60970
119,96,23,937,75800,60973
131,99,32,928,91000,60974
576,492,84,1279,260800,61001
622,440,182,863,150900,61006
161,149,12,-,-,61007
12826,10108,2718,953,185200,61008
2810,2277,533,981,218300,61010
993,947,46,1727,285900,61011
737,621,116,800,168800,61012
335,311,24,544,110600,61013
481,424,57,-,110400,61014
299,284,15,-,209400,61015
2091,1878,213,861,224600,61016
419,326,93,744,162800,61018
1309,1100,209,1191,226400,61019
1037,935,102,1000,194800,61020
9010,6556,2454,823,144800,61021
926,725,201,722,153800,61024
2123,1808,315,1008,174400,61025
19,19,0,-,-,61027
815,668,147,775,184800,61028
791,655,136,669,148100,61030
603,433,170,822,148600,61031
13407,8654,4753,769,106800,61032
3469,2763,706,758,258100,61036
48,48,0,-,115500,61037
448,425,23,-,274200,61038
310,231,79,850,145800,61039
646,458,188,769,112300,61041
170,134,36,922,123900,61042
56,46,10,960,122700,61043
113,113,0,-,146800,61044
1134,977,157,703,147600,61046
660,586,74,1000,223100,61047
1648,1407,241,655,170800,61048
194,134,60,1009,183300,61049
104,104,0,-,126900,61050
637,525,112,763,101100,61051
438,393,45,1056,211700,61052
1186,952,234,763,105400,61053
1732,1167,565,-,118500,61054
16,16,0,-,-,61057
74,47,27,1109,74400,61059
599,521,78,689,156800,61060
3036,2252,784,814,202500,61061
686,569,117,775,176100,61062
1704,1437,267,1079,155200,61063
1660,1127,533,799,160700,61064
3479,3220,259,1469,208400,61065
244,215,29,735,195800,61067
5860,3643,2217,955,164900,61068
509,456,53,845,173000,61070
5842,4373,1469,752,104900,61071
4275,3554,721,982,225100,61072
7172,5763,1409,1355,228900,61073
2040,1356,684,807,93900,61074
447,387,60,774,235800,61075
51,51,0,-,-,61077
525,451,74,733,128500,61078
98,84,14,1031,113800,61079
4561,3282,1279,877,172300,61080
8926,6297,2629,791,121000,61081
1269,1109,160,797,204400,61084
1343,1030,313,917,115400,61085
684,634,50,752,109700,61087
2314,2037,277,979,193000,61088
252,180,72,844,118000,61089
0,0,0,-,-,61091
7969,4035,3934,975,89800,61101
6409,3861,2548,850,95300,61102
10046,5062,4984,952,114800,61103
7752,2872,4880,854,83700,61104
12717,8860,3857,1053,165200,61107
11855,7793,4062,986,128300,61108
11031,6892,4139,916,124900,61109
9846,6090,3756,1101,143700,61111
47,0,47,-,-,61112
6349,4530,1819,1284,196000,61114
8427,6764,1663,1111,160700,61115
15844,10024,5820,822,118300,61201
395,348,47,875,150600,61230
2082,1462,620,772,141200,61231
680,614,66,925,174600,61232
107,79,28,843,172500,61233
511,403,108,629,151300,61234
658,521,137,794,131900,61235
17,15,2,-,118800,61236
0,0,0,-,-,61237
1052,945,107,1044,129700,61238
485,138,347,984,102600,61239
2364,2213,151,-,231000,61240
2690,2312,378,888,166500,61241
493,440,53,956,218600,61242
74,63,11,-,220300,61243
9202,6181,3021,828,140600,61244
1204,943,261,850,168500,61250
154,136,18,-,187100,61251
2411,1950,461,946,143400,61252
4928,4043,885,951,217700,61254
875,730,145,1018,182800,61256
358,294,64,1641,116300,61257
67,61,6,-,75000,61258
505,487,18,-,198900,61259
306,212,94,597,83800,61260
305,241,64,1146,114400,61261
390,351,39,825,246300,61262
277,216,61,775,136200,61263
4673,3737,936,832,147700,61264
18860,12526,6334,890,142300,61265
2731,2267,464,981,165000,61270
554,493,61,-,131300,61272
1121,941,180,785,171000,61273
91,91,0,-,130700,61274
1713,1448,265,684,235800,61275
14,14,0,-,-,61276
1101,854,247,735,134000,61277
286,272,14,-,222600,61278
369,346,23,1045,164700,61279
1023,946,77,769,223300,61281
4154,2297,1857,977,159400,61282
464,393,71,718,125600,61283
854,764,90,782,222800,61284
738,606,132,832,165200,61285
4437,2920,1517,1010,117800,61301
1476,1158,318,893,173700,61310
104,87,17,-,116300,61311
190,160,30,888,124300,61312
129,109,20,-,204500,61313
314,254,60,949,76900,61314
110,65,45,1821,53700,61315
87,71,16,950,86800,61316
225,192,33,892,96900,61317
220,173,47,1013,102900,61318
544,489,55,855,171700,61319
287,245,42,970,159400,61320
98,61,37,733,86600,61321
591,429,162,925,64300,61322
66,55,11,813,108700,61323
46,32,14,-,141700,61324
433,392,41,900,179900,61325
896,686,210,778,137000,61326
524,455,69,836,219000,61327
34,34,0,-,-,61328
539,423,116,847,123600,61329
500,396,104,842,150000,61330
0,0,0,-,-,61331
65,57,8,880,82800,61332
101,96,5,-,98000,61333
251,212,39,900,119700,61334
122,100,22,760,135400,61335
226,164,62,790,179800,61336
202,173,29,957,100300,61337
149,117,32,760,90300,61338
244,183,61,856,153600,61340
2882,2172,710,1048,179400,61341
3450,2419,1031,841,132700,61342
124,112,12,1025,69500,61344
328,298,30,770,99200,61345
33,28,5,-,73800,61346
2021,1485,536,691,139100,61348
408,348,60,731,117400,61349
9748,7145,2603,940,157100,61350
450,337,113,853,163600,61353
4578,3449,1129,877,160100,61354
4630,3514,1116,751,146800,61356
174,160,14,860,204000,61358
172,145,27,682,95500,61359
1275,994,281,1057,240800,61360
540,447,93,896,147300,61361
2388,1537,851,1022,135900,61362
150,117,33,908,108200,61363
8315,5670,2645,810,97300,61364
328,180,148,960,185000,61367
558,439,119,844,119400,61368
582,467,115,777,115000,61369
504,425,79,850,153300,61370
27,27,0,-,-,61371
81,71,10,792,186300,61372
784,717,67,1310,222600,61373
27,21,6,-,-,61374
498,469,29,788,162900,61375
932,719,213,881,123700,61376
695,500,195,785,127300,61377
206,140,66,1088,171600,61378
589,474,115,791,99200,61379
13513,8459,5054,724,94900,61401
0,0,0,-,-,61402
1623,1151,472,735,93000,61410
100,78,22,-,96000,61411
533,478,55,894,106600,61412
442,393,49,957,128400,61413
341,326,15,944,122200,61414
766,653,113,768,103300,61415
124,114,10,-,49200,61416
81,81,0,-,78000,61417
278,241,37,1038,110400,61418
68,57,11,-,96300,61419
431,359,72,850,81800,61420
522,413,109,863,78900,61421
1284,891,393,622,71900,61422
305,218,87,929,122100,61423
9,9,0,-,-,61424
225,193,32,-,88200,61425
27,27,0,-,29800,61426
880,722,158,915,106300,61427
486,458,28,630,250000,61428
327,270,57,791,106000,61430
133,122,11,-,-,61431
263,234,29,442,90000,61432
9,9,0,-,-,61433
1224,973,251,777,87400,61434
51,26,25,-,-,61435
359,310,49,-,186500,61436
237,183,54,1318,139200,61437
307,273,34,788,152400,61438
108,80,28,625,97500,61439
318,280,38,776,87800,61440
356,287,69,956,102600,61441
274,232,42,609,65000,61442
5870,4221,1649,782,75900,61443
423,378,45,850,96200,61447
1618,1412,206,656,139700,61448
185,174,11,-,58400,61449
758,611,147,703,95400,61450
87,68,19,-,103100,61451
90,84,6,-,119400,61452
281,226,55,858,85100,61453
180,147,33,-,84700,61454
7583,3986,3597,739,117900,61455
321,258,63,-,88600,61458
126,125,1,-,80400,61459
60,54,6,-,83000,61460
4184,3203,981,657,100900,61462
531,472,59,625,110400,61465
115,115,0,-,90400,61466
436,362,74,850,132700,61467
58,58,0,-,95200,61468
879,792,87,750,104100,61469
202,180,22,-,104100,61470
51,47,4,-,80600,61471
182,163,19,771,149400,61472
555,392,163,794,97000,61473
124,101,23,-,78100,61474
114,101,13,596,158900,61475
246,223,23,1063,127000,61476
200,197,3,-,109200,61477
142,142,0,-,73800,61478
32,32,0,-,207100,61479
516,396,120,929,101200,61480
219,189,30,791,74200,61482
756,593,163,700,112200,61483
328,267,61,456,60200,61484
135,122,13,786,100600,61485
588,536,52,833,126000,61486
544,440,104,634,125000,61488
299,284,15,644,131300,61489
490,369,121,628,144700,61490
983,746,237,693,119300,61491
743,574,169,690,68400,61501
304,296,8,975,123300,61516
1152,976,176,832,269600,61517
101,74,27,577,113200,61519
6496,4741,1755,814,116200,61520
4430,3690,740,907,151600,61523
154,144,10,883,117100,61524
4054,3595,459,1167,314800,61525
332,323,9,-,270300,61526
1098,1033,65,-,305300,61528
1039,818,221,772,155100,61529
2584,1807,777,690,166700,61530
1222,980,242,877,113100,61531
194,139,55,856,110300,61532
912,776,136,769,151900,61533
719,550,169,906,152700,61534
650,638,12,-,222300,61535
1566,1261,305,1224,176400,61536
1100,791,309,697,121200,61537
67,49,18,820,71300,61539
1175,964,211,803,154300,61540
61,42,19,1052,72200,61541
1547,1180,367,683,115100,61542
42,28,14,-,54300,61543
292,246,46,920,95700,61544
358,339,19,1266,188400,61545
1571,1382,189,729,134100,61546
1390,1353,37,583,231400,61547
4498,4122,376,1018,239500,61548
7438,5955,1483,1001,247000,61550
78,78,0,-,93000,61552
92,78,14,839,69400,61553
17298,12367,4931,814,123500,61554
1438,1225,213,1089,171500,61559
324,304,20,-,229800,61560
906,725,181,1091,150400,61561
22,22,0,-,-,61562
243,231,12,1000,60200,61563
377,304,73,741,112900,61564
573,473,100,660,161600,61565
247,205,42,928,133000,61567
1705,1274,431,1033,242800,61568
434,388,46,841,193800,61569
671,541,130,876,110000,61570
9690,7787,1903,996,200300,61571
403,334,69,725,95100,61572
694,119,575,912,222700,61602
6801,3627,3174,976,73100,61603
11964,8150,3814,904,100000,61604
5867,2300,3567,831,44200,61605
2502,1058,1444,907,119800,61606
4526,3874,652,1014,155200,61607
2242,1837,405,855,86500,61610
10108,7986,2122,942,162500,61611
13044,8507,4537,948,169700,61614
10825,6586,4239,1079,206800,61615
2832,1848,984,921,118000,61616
14,0,14,-,-,61625
16281,9218,7063,873,138600,61701
15573,10311,5262,1094,242000,61704
5067,4067,1000,1294,310100,61705
116,99,17,1300,103500,61720
212,194,18,1375,132300,61721
232,188,44,1114,122000,61722
951,768,183,791,148200,61723
178,166,12,875,133700,61724
574,535,39,1318,221600,61725
1072,792,280,858,126800,61726
4020,2811,1209,912,115700,61727
492,396,96,799,152200,61728
382,329,53,950,242500,61729
147,97,50,925,159100,61730
57,46,11,-,182400,61731
779,693,86,1142,213100,61732
390,316,74,1119,191400,61733
962,787,175,790,140200,61734
155,148,7,-,264800,61735
963,846,117,936,283900,61736
177,159,18,917,154900,61737
1596,1304,292,1036,174200,61738
1847,1308,539,753,160400,61739
579,506,73,836,130200,61740
647,548,99,642,154500,61741
523,475,48,1120,243100,61742
64,45,19,775,140600,61743
783,605,178,763,154500,61744
1584,1348,236,1013,209300,61745
594,467,127,881,194600,61747
958,945,13,1146,223700,61748
358,321,37,817,103900,61749
40,4,36,-,-,61750
32,32,0,-,59100,61751
1788,1510,278,791,176100,61752
1242,1082,160,978,190200,61753
447,373,74,1119,146900,61754
1808,1505,303,890,208400,61755
956,750,206,794,183100,61756
506,439,67,718,149800,61759
969,655,314,985,121900,61760
19933,11046,8887,976,200900,61761
5556,3817,1739,835,122200,61764
239,231,8,1125,117600,61769
381,303,78,888,101000,61770
348,333,15,925,270500,61771
59,43,16,-,-,61772
126,99,27,1208,104200,61773
340,289,51,968,131300,61774
125,108,17,967,114100,61775
485,436,49,942,197600,61776
405,338,67,780,139600,61777
215,204,11,-,91200,61778
11200,3418,7782,950,184000,61801
9228,5144,4084,996,158300,61802
98,76,22,775,106700,61810
286,228,58,900,122800,61811
102,96,6,-,143800,61812
741,604,137,686,103600,61813
518,445,73,825,112000,61814
130,91,39,1070,159100,61815
150,125,25,961,137500,61816
1122,834,288,904,126500,61817
625,508,117,875,113400,61818
15379,3082,12297,1077,175900,61820
12433,7697,4736,1001,174800,61821
11394,7781,3613,1265,264600,61822
179,139,40,1292,135200,61830
96,96,0,-,171900,61831
13757,8110,5647,805,78400,61832
924,642,282,837,70300,61833
2523,2182,341,853,162000,61834
245,186,59,831,110300,61839
221,211,10,-,269500,61840
464,398,66,735,127900,61841
1018,901,117,514,152000,61842
746,666,80,850,184300,61843
397,354,43,1031,151700,61844
104,74,30,-,171900,61845
1889,1404,485,738,77800,61846
497,438,59,883,178300,61847
91,71,20,950,77200,61848
748,644,104,956,156300,61849
177,167,10,-,71300,61850
148,133,15,950,136600,61851
94,89,5,-,262000,61852
5008,4196,812,1226,281500,61853
581,485,96,1057,162200,61854
30,27,3,-,-,61855
3329,2874,455,1045,214500,61856
70,66,4,-,76700,61857
1147,876,271,840,123600,61858
449,411,38,1266,174400,61859
201,174,27,647,133800,61862
332,305,27,1500,179400,61863
553,486,67,1063,203600,61864
459,402,57,765,101900,61865
5458,2807,2651,892,111900,61866
485,376,109,695,77800,61870
138,116,22,1047,144600,61871
276,261,15,950,172500,61872
2209,1895,314,942,246300,61873
3414,1973,1441,954,274100,61874
329,269,60,943,270100,61875
290,266,24,900,75000,61876
442,385,57,1140,200200,61877
522,429,93,790,115600,61878
1780,1357,423,881,227300,61880
266,232,34,775,122000,61882
1907,1353,554,765,97000,61883
452,433,19,-,258800,61884
1532,1191,341,809,147500,61910
1719,1288,431,698,167000,61911
548,477,71,763,110000,61912
546,467,79,746,124500,61913
822,634,188,838,114100,61914
180,172,8,-,88600,61917
307,266,41,531,143600,61919
8625,4594,4031,823,144700,61920
822,573,249,754,115700,61924
437,338,99,631,116500,61925
296,228,68,532,118300,61928
329,275,54,761,110100,61929
270,249,21,850,85200,61930
474,363,111,855,125800,61931
241,164,77,915,90600,61932
469,326,143,719,79500,61933
53,45,8,-,80500,61936
749,522,227,829,99200,61937
9330,5710,3620,771,109100,61938
126,82,44,691,50700,61940
61,61,0,-,-,61941
480,433,47,789,109000,61942
726,575,151,528,105200,61943
5512,3987,1525,757,97400,61944
75,67,8,688,76400,61949
2993,2432,561,793,136400,61951
2735,2113,622,835,165100,61953
65,56,9,1175,59200,61955
1277,997,280,894,121200,61956
760,634,126,746,126700,61957
661,541,120,957,208600,62001
13023,8253,4770,941,114300,62002
147,144,3,-,208000,62006
737,512,225,823,84300,62009
4712,3788,924,896,170000,62010
114,114,0,-,-,62011
2287,2068,219,1002,165500,62012
140,110,30,-,136700,62013
1319,1119,200,968,187900,62014
237,195,42,955,101100,62015
1503,1037,466,906,117100,62016
479,412,67,796,102400,62017
1183,819,364,1018,78400,62018
143,110,33,813,102800,62019
410,405,5,-,277700,62021
369,278,91,-,190200,62022
44,44,0,-,65600,62023
4219,3225,994,851,112500,62024
13435,10052,3383,1215,295700,62025
0,0,0,-,-,62026
228,180,48,504,108300,62027
288,147,141,-,167600,62028
25,19,6,-,92500,62030
242,227,15,-,127700,62031
323,255,68,670,66900,62032
1767,1258,509,769,104700,62033
6065,4054,2011,1100,274300,62034
6627,5621,1006,1158,179900,62035
201,188,13,-,221900,62036
734,595,139,-,222900,62037
16895,12529,4366,852,106600,62040
680,518,162,857,106800,62044
141,137,4,-,165600,62045
359,283,76,940,229600,62046
437,379,58,417,144100,62047
680,563,117,925,65800,62048
2664,1994,670,817,106600,62049
115,104,11,763,104700,62050
301,243,58,478,99600,62051
4880,3574,1306,790,156000,62052
94,75,19,550,95000,62053
133,110,23,833,87800,62054
3738,2715,1023,655,119800,62056
352,263,89,641,101800,62058
275,128,147,950,37200,62059
1618,750,868,1019,53600,62060
567,487,80,880,185900,62061
3564,3064,500,975,249500,62062
344,304,40,859,118600,62063
822,734,88,1057,220500,62067
1391,1111,280,711,105700,62069
467,432,35,775,263700,62074
1280,1017,263,811,86700,62075
53,53,0,-,92500,62076
149,128,21,833,60800,62077
26,23,3,-,-,62078
102,81,21,-,234100,62079
1019,872,147,800,85000,62080
92,90,2,-,86000,62081
984,881,103,703,75100,62082
104,104,0,-,206700,62083
727,539,188,949,104300,62084
88,85,3,-,82100,62085
497,460,37,617,101800,62086
826,575,251,821,87200,62087
2802,2296,506,803,142800,62088
275,219,56,593,69900,62089
442,175,267,784,49600,62090
113,112,1,-,152000,62091
917,689,228,688,79400,62092
179,122,57,883,90000,62093
420,320,100,529,62900,62094
4669,3258,1411,919,106700,62095
1068,952,116,-,212600,62097
14,14,0,-,-,62098
2297,961,1336,350,56100,62201
1875,1336,539,970,72700,62203
1978,1363,615,783,48200,62204
2282,1481,801,1015,46200,62205
4858,2800,2058,1021,57700,62206
2649,1107,1542,803,54400,62207
7271,4672,2599,1222,167900,62208
440,403,37,663,175300,62214
794,652,142,1097,205000,62215
1053,874,179,958,235200,62216
282,246,36,-,137500,62217
770,717,53,545,197300,62218
444,331,113,942,111100,62219
7881,5222,2659,976,141300,62220
11896,7903,3993,1078,207200,62221
7174,5476,1698,1026,149600,62223
1555,29,1526,1669,-,62225
11743,7699,4044,946,162500,62226
2703,2197,506,776,209100,62230
2737,2259,478,1043,158400,62231
2818,2123,695,1077,114800,62232
2544,1967,577,645,111500,62233
14028,9818,4210,995,162000,62234
5505,4679,826,1089,300300,62236
1051,981,70,870,132600,62237
206,164,42,1042,88200,62238
1761,1070,691,935,111700,62239
601,476,125,835,84800,62240
366,337,29,725,135800,62241
766,639,127,741,110700,62242
2401,2020,381,1100,268200,62243
430,347,83,1049,207000,62244
733,651,82,645,197900,62245
3621,2445,1176,726,149200,62246
227,169,58,736,153700,62248
7052,5667,1385,779,220000,62249
207,189,18,920,109600,62250
328,261,67,630,100500,62253
2374,1640,734,1100,196600,62254
487,418,69,645,153400,62255
12,9,3,-,154200,62256
870,662,208,621,119200,62257
3617,2545,1072,1231,229500,62258
2800,2406,394,1000,229600,62260
31,31,0,-,-,62261
771,650,121,1008,121600,62262
2103,1619,484,798,149900,62263
1303,1012,291,829,137100,62264
1773,1142,631,1158,173600,62265
29,29,0,-,-,62266
392,334,58,-,130000,62268
13872,9997,3875,1258,274200,62269
754,611,143,713,167200,62271
695,455,240,716,104200,62272
129,88,41,994,105000,62273
2745,2291,454,611,118700,62274
1071,864,207,759,175000,62275
378,314,64,732,125700,62277
2591,2095,496,831,181500,62278
26,26,0,-,271400,62279
171,127,44,-,233600,62280
1066,968,98,1328,287800,62281
272,231,41,788,168800,62282
263,231,32,-,131000,62284
1665,1497,168,859,265300,62285
2321,1593,728,723,148800,62286
1160,905,255,775,166600,62288
185,151,34,815,73900,62289
318,195,123,821,72300,62292
1853,1516,337,912,214500,62293
5736,4330,1406,1069,255700,62294
515,404,111,1242,196500,62295
155,129,26,1079,301700,62297
7124,6003,1121,884,263200,62298
13855,8357,5498,805,124200,62301
7933,6676,1257,887,203500,62305
403,322,81,-,102300,62311
634,466,168,566,96400,62312
158,137,21,-,-,62313
213,154,59,771,150000,62314
309,253,56,-,76000,62316
90,86,4,-,108300,62319
885,703,182,682,169300,62320
1597,1221,376,677,120600,62321
111,98,13,-,131300,62323
511,401,110,828,101100,62324
210,173,37,1236,134200,62325
965,764,201,654,116400,62326
715,610,105,831,83600,62330
87,71,16,-,70800,62334
47,44,3,-,78000,62336
475,454,21,-,173000,62338
438,352,86,713,129200,62339
700,455,245,578,93400,62340
1450,1113,337,882,118200,62341
318,265,53,733,96500,62343
30,22,8,-,71500,62344
119,92,27,595,68700,62345
64,61,3,-,137500,62346
782,715,67,748,199000,62347
79,62,17,-,112500,62348
299,241,58,629,97300,62349
767,676,91,661,150700,62351
75,62,13,1350,73600,62352
1415,947,468,736,143800,62353
532,456,76,828,147000,62354
255,233,22,1016,101900,62355
194,150,44,525,78000,62356
71,35,36,700,131700,62357
189,179,10,-,166200,62358
24,24,0,-,-,62359
665,593,72,967,126300,62360
120,111,9,-,83000,62361
148,118,30,475,83300,62362
2393,1941,452,703,118700,62363
195,186,9,688,122900,62365
456,373,83,642,83700,62366
630,534,96,786,125000,62367
118,103,15,-,91900,62370
107,103,4,-,119300,62373
133,110,23,808,82100,62374
232,223,9,-,136300,62375
524,442,82,883,156600,62376
366,310,56,477,140700,62378
816,666,150,758,95300,62379
165,139,26,582,88500,62380
7943,5941,2002,722,195800,62401
449,428,21,608,114700,62410
1753,1452,301,864,139400,62411
172,172,0,-,-,62413
684,494,190,627,130300,62414
979,750,229,699,85900,62417
705,561,144,785,133400,62418
111,98,13,-,90000,62419
1884,1574,310,738,122000,62420
191,172,19,795,66000,62421
406,295,111,765,123700,62422
248,224,24,-,147900,62423
848,688,160,650,203600,62424
264,264,0,-,107800,62425
400,337,63,581,75100,62426
734,684,50,-,105400,62427
1175,1013,162,645,99100,62428
332,305,27,625,109500,62431
232,227,5,-,275000,62432
468,359,109,785,101900,62433
153,143,10,-,172900,62434
311,296,15,791,108300,62436
97,86,11,-,235900,62438
2962,2024,938,824,98200,62439
498,472,26,800,141900,62440
2999,2385,614,855,139800,62441
1086,885,201,602,84900,62442
684,631,53,-,165800,62443
196,196,0,-,114100,62444
391,365,26,393,181000,62445
124,116,8,-,98200,62446
1249,1046,203,815,153500,62447
2311,1825,486,765,118200,62448
1289,981,308,537,99900,62449
5061,3502,1559,761,111600,62450
837,687,150,743,85500,62451
142,136,6,-,57000,62452
3943,3145,798,813,125700,62454
826,710,116,723,97600,62458
93,84,9,263,103900,62459
364,294,70,804,105700,62460
296,270,26,930,160100,62461
403,356,47,764,144000,62462
486,415,71,857,126000,62463
85,40,45,-,101600,62464
331,298,33,1042,150000,62465
1094,988,106,591,97500,62466
1491,1237,254,803,225500,62467
947,746,201,763,108400,62468
116,64,52,-,98900,62469
3636,2712,924,739,119800,62471
482,386,96,531,117400,62473
314,297,17,910,84700,62474
85,85,0,-,178600,62475
563,496,67,805,88900,62476
313,254,59,1311,152100,62477
120,104,16,-,132100,62478
310,228,82,844,172300,62479
261,227,34,-,113400,62480
128,104,24,-,-,62481
934,874,60,984,189500,62501
746,423,323,753,93500,62510
193,143,50,525,114100,62512
619,531,88,871,125900,62513
163,109,54,-,107100,62514
429,332,97,575,153600,62515
76,52,24,843,80600,62517
140,132,8,-,138200,62518
26,26,0,-,-,62519
594,540,54,805,225300,62520
14003,10391,3612,857,119900,62521
6002,3910,2092,783,108300,62522
288,28,260,333,-,62523
14183,8278,5905,785,91500,62526
642,521,121,839,145300,62530
697,544,153,849,125000,62531
23,23,0,-,114100,62532
402,317,85,773,116500,62533
465,383,82,926,133300,62534
1346,1243,103,1207,289800,62535
376,352,24,-,245900,62536
102,91,11,-,88500,62537
165,133,32,730,83900,62538
535,464,71,675,108300,62539
619,487,132,742,79000,62540
25,25,0,-,-,62541
193,155,38,815,86100,62543
684,596,88,787,143400,62544
572,534,38,781,159900,62545
586,521,65,680,121400,62546
264,247,17,1133,89500,62547
906,782,124,771,121700,62548
2419,2075,344,696,186800,62549
1154,880,274,864,134300,62550
324,269,55,804,118100,62551
137,127,10,900,122300,62553
660,602,58,931,133500,62554
537,445,92,689,143500,62555
143,129,14,719,83800,62556
2827,2064,763,684,93600,62557
1483,1224,259,865,176200,62558
577,423,154,911,97900,62560
2208,1564,644,1034,156400,62561
2053,1980,73,1333,256100,62563
3272,2278,994,737,131900,62565
379,304,75,859,115500,62567
6233,4422,1811,733,119500,62568
242,219,23,541,78200,62570
576,447,129,783,143500,62571
186,149,37,675,201900,62572
454,337,117,809,147400,62573
134,129,5,-,121700,62601
68,57,11,850,53000,62610
462,426,36,825,158800,62611
670,556,114,590,113300,62612
1504,1235,269,911,189200,62613
1889,1579,310,941,154100,62615
285,259,26,750,78800,62617
2709,1863,846,766,86400,62618
465,376,89,673,92200,62621
28,28,0,-,-,62622
139,127,12,-,90300,62624
349,287,62,941,277700,62625
3057,2123,934,749,132700,62626
431,361,70,1025,79200,62627
338,296,42,932,108300,62628
5924,4784,1140,1159,232000,62629
298,294,4,-,123300,62630
110,108,2,-,119700,62631
284,248,36,700,92800,62633
474,370,104,759,138800,62634
272,201,71,847,125800,62635
496,385,111,928,122000,62638
122,81,41,938,64200,62639
1197,846,351,786,165500,62640
585,486,99,618,108800,62642
297,175,122,1010,98600,62643
2048,1586,462,730,104700,62644
165,133,32,718,138600,62649
9802,6604,3198,705,142600,62650
230,190,40,680,116300,62655
7114,4485,2629,807,128900,62656
521,439,82,960,161100,62661
81,77,4,500,85000,62663
1283,1048,235,775,102900,62664
558,418,140,663,59200,62665
203,148,55,728,111700,62666
235,200,35,682,155800,62667
485,434,51,779,123200,62668
1078,813,265,826,188400,62670
195,157,38,848,108600,62671
59,56,3,-,44400,62672
226,196,30,-,134400,62673
503,398,105,695,102600,62674
2585,1959,626,686,192200,62675
826,736,90,888,210600,62677
2137,1671,466,823,106100,62681
282,236,46,925,74400,62682
1952,1800,152,1565,292000,62684
597,516,81,-,116900,62685
342,307,35,1094,136600,62688
261,241,20,880,85800,62689
1489,1111,378,785,112200,62690
1059,771,288,670,107700,62691
875,745,130,771,115200,62692
775,686,89,1055,193800,62693
1271,958,313,661,108000,62694
210,197,13,908,118000,62695
624,12,612,667,-,62701
14487,9325,5162,858,102300,62702
12368,6909,5459,971,93100,62703
18720,11557,7163,924,166900,62704
0,0,0,-,-,62706
3496,3037,459,926,164300,62707
7551,5994,1557,1272,299400,62711
4563,3827,736,1156,244300,62712
7876,5567,2309,785,91100,62801
384,245,139,785,132900,62803
1385,1076,309,816,113500,62806
358,314,44,483,150000,62807
641,510,131,649,140500,62808
95,89,6,-,113000,62809
467,359,108,838,109400,62810
127,101,26,840,46300,62811
4796,3446,1350,796,100900,62812
690,587,103,748,108100,62814
135,82,53,476,81100,62815
537,456,81,903,86300,62816
278,231,47,925,-,62817
173,135,38,850,88800,62818
127,103,24,1025,51800,62819
64,64,0,-,-,62820
2993,2225,768,831,107900,62821
1233,882,351,641,70900,62822
758,626,132,668,120200,62823
654,536,118,598,83700,62824
117,103,14,-,71700,62825
474,344,130,347,79500,62827
628,507,121,439,112700,62828
48,40,8,-,-,62829
596,466,130,475,137300,62830
164,153,11,-,131900,62831
3703,2679,1024,716,94600,62832
115,104,11,-,-,62833
538,473,65,670,102700,62835
317,276,41,810,99400,62836
3716,2775,941,584,105400,62837
563,479,84,735,128000,62838
2686,2211,475,727,90800,62839
50,41,9,-,63600,62841
290,255,35,733,110100,62842
62,25,37,-,-,62843
805,561,244,646,81900,62844
308,216,92,538,89300,62846
234,196,38,811,89500,62848
722,648,74,639,90800,62849
105,90,15,-,-,62850
104,104,0,-,95800,62851
62,54,8,-,58000,62852
359,298,61,982,79700,62853
712,623,89,615,88900,62854
136,126,10,-,56100,62856
1295,940,355,665,106800,62858
2192,1655,537,572,91100,62859
185,164,21,554,114600,62860
38,38,0,-,36700,62861
129,116,13,840,72000,62862
4069,2967,1102,772,104000,62863
9725,6415,3310,882,117600,62864
968,850,118,749,154800,62865
197,143,54,471,50400,62867
663,565,98,546,99300,62868
1050,831,219,525,105100,62869
899,695,204,857,126600,62870
259,228,31,771,87200,62871
401,369,32,-,107600,62872
193,150,43,731,51000,62874
424,374,50,872,103300,62875
71,62,9,900,76700,62876
186,168,18,738,116100,62877
115,107,8,-,76100,62878
9,9,0,-,-,62879
292,251,41,800,128400,62880
4671,3357,1314,750,111500,62881
857,651,206,652,85800,62882
219,203,16,-,143800,62883
1045,851,194,702,93800,62884
227,196,31,-,89200,62885
168,150,18,-,109000,62886
64,53,11,875,39100,62887
772,685,87,792,116400,62888
416,333,83,-,147500,62889
926,728,198,813,99500,62890
297,261,36,1100,68500,62891
95,86,9,625,95000,62892
372,297,75,890,138100,62893
355,310,45,656,106900,62894
912,741,171,642,117100,62895
4604,3326,1278,720,88000,62896
204,158,46,942,85900,62897
779,678,101,906,150000,62898
620,523,97,643,135800,62899
10296,3150,7146,732,137600,62901
1955,1374,581,899,184300,62902
1125,472,653,802,164000,62903
298,235,63,664,114800,62905
2982,2038,944,654,138200,62906
686,604,82,703,179400,62907
147,136,11,-,168800,62908
763,640,123,813,90600,62910
530,468,62,775,103500,62912
663,440,223,282,28900,62914
238,108,130,803,77500,62915
307,266,41,675,116800,62916
1047,849,198,585,75200,62917
4598,3121,1477,909,183200,62918
297,248,49,454,148400,62919
1200,1068,132,-,154200,62920
100,76,24,-,75000,62921
1107,953,154,767,149400,62922
115,97,18,1000,70500,62923
1279,735,544,858,97600,62924
834,606,228,693,104900,62926
137,131,6,-,43600,62927
35,26,9,419,121400,62928
2612,2004,608,655,90500,62930
601,480,121,235,90900,62931
529,360,169,734,81300,62932
513,410,103,843,138500,62933
318,274,44,419,90000,62934
862,710,152,918,123400,62935
990,855,135,415,151000,62938
1235,1134,101,848,161000,62939
204,109,95,724,27500,62940
256,207,49,780,114500,62941
274,195,79,700,37500,62942
131,116,15,-,132000,62943
4919,3414,1505,740,97500,62946
213,198,15,-,171900,62947
5644,3609,2035,1010,112400,62948
366,202,164,376,74300,62949
68,59,9,-,107000,62950
2500,2075,425,854,89600,62951
1210,960,250,727,124300,62952
86,48,38,775,44000,62953
221,200,21,1528,89400,62954
417,369,48,761,107600,62956
209,159,50,931,58300,62957
888,679,209,895,154400,62958
11692,8264,3428,895,166200,62959
4356,3371,985,789,122100,62960
12,12,0,-,-,62961
0,0,0,-,-,62962
234,105,129,783,33800,62963
384,225,159,559,95000,62964
29,23,6,-,-,62965
6042,3828,2214,681,117800,62966
103,103,0,-,143800,62967
125,95,30,-,81900,62969
180,134,46,584,165000,62970
390,381,9,-,173500,62972
594,540,54,933,161600,62974
95,73,22,-,-,62975
173,105,68,656,87700,62976
236,207,29,1304,112100,62977
441,375,66,732,85400,62979
360,263,97,414,59300,62982
728,514,214,901,65900,62983
668,471,197,330,87800,62984
293,270,23,-,156300,62985
589,523,66,730,147700,62987
484,414,70,496,68900,62988
330,303,27,863,122900,62990
292,235,57,523,83900,62992
294,259,35,950,111600,62994
1553,1108,445,590,135900,62995
137,102,35,-,83300,62996
218,169,49,815,66500,62997
103,98,5,-,-,62998
631,438,193,694,52900,62999
7245,6527,718,1570,671300,63005
13877,11063,2814,1074,214100,63010
14376,12031,2345,1624,373600,63011
3897,3558,339,1332,228500,63012
448,441,7,-,304800,63013
219,193,26,788,132800,63014
753,617,136,778,211000,63015
2610,2377,233,1260,206800,63016
17760,13663,4097,1632,452000,63017
1830,1317,513,887,170000,63019
8163,6579,1584,872,172600,63020
22207,17541,4666,1362,324300,63021
1909,1745,164,1054,220200,63023
6522,5580,942,1195,363900,63025
17216,13530,3686,1091,281900,63026
10740,8000,2740,937,221600,63028
109,71,38,-,191900,63030
19431,13894,5537,1351,144500,63031
17200,11237,5963,1150,157400,63033
6453,5913,540,1728,234200,63034
501,448,53,-,211300,63036
1252,1072,180,832,182700,63037
2504,2379,125,2153,537800,63038
281,250,31,-,138200,63039
3275,2892,383,1504,408800,63040
168,168,0,-,-,63041
8668,4591,4077,939,138800,63042
9361,6689,2672,1175,215900,63043
4241,2858,1383,1093,232200,63044
0,0,0,-,-,63045
0,0,0,-,-,63047
1530,1343,187,2158,216300,63048
6646,5742,904,926,209200,63049
6376,5155,1221,1000,255500,63050
4909,4219,690,1010,186300,63051
10452,8958,1494,965,259400,63052
38,29,9,1109,217100,63053
705,584,121,902,254300,63055
666,567,99,1101,196900,63056
871,803,68,1109,163600,63060
54,42,12,-,266700,63061
2251,1951,300,825,209200,63068
6173,4550,1623,913,271200,63069
3100,2336,764,846,209200,63070
493,350,143,829,122900,63071
1268,1198,70,1141,198700,63072
395,395,0,-,803300,63073
7260,3975,3285,1005,119500,63074
4749,3359,1390,869,161800,63077
71,66,5,-,216700,63079
5753,4364,1389,863,169000,63080
7800,5660,2140,852,221800,63084
437,370,67,-,226500,63087
4193,2132,2061,1319,231700,63088
2256,1907,349,1060,211400,63089
9334,6867,2467,873,260700,63090
571,493,78,493,226200,63091
1941,576,1365,1295,228300,63101
1830,122,1708,1253,179100,63102
5182,884,4298,978,205400,63103
9817,4728,5089,1054,249500,63104
6785,3830,2955,1520,735500,63105
3597,427,3170,739,186700,63106
4230,1823,2407,839,57100,63107
11132,2980,8152,1140,337300,63108
14035,8837,5198,929,244900,63109
9151,3871,5280,1183,314600,63110
8721,3468,5253,846,115500,63111
9180,3248,5932,911,216400,63112
5184,2553,2631,914,75600,63113
14958,8654,6304,1082,109700,63114
6763,2938,3825,928,61600,63115
19741,11217,8524,946,161100,63116
4610,2357,2253,1216,330100,63117
11977,5268,6709,952,210900,63118
14904,10584,4320,1275,330800,63119
2765,1232,1533,922,52300,63120
10916,5780,5136,938,93900,63121
16806,13738,3068,1329,449700,63122
21872,16175,5697,987,205300,63123
4920,3682,1238,1812,967300,63124
13706,10146,3560,920,166200,63125
6200,5333,867,1112,287000,63126
2107,1657,450,-,594100,63127
12982,10053,2929,1120,319700,63128
21310,16698,4612,1087,278800,63129
12883,7976,4907,1199,285500,63130
6574,6101,473,1999,734300,63131
6057,3412,2645,1325,403600,63132
2891,1307,1584,1009,59200,63133
5025,2610,2415,1107,92000,63134
8527,4666,3861,1115,95500,63135
17384,7908,9476,1029,77300,63136
8323,4014,4309,1017,79400,63137
7424,3710,3714,1073,124500,63138
11068,6636,4432,1086,199400,63139
169,47,122,833,84000,63140
8825,6055,2770,1456,571900,63141
4767,2279,2488,900,226300,63143
4879,2938,1941,1429,278800,63144
14800,8756,6044,1315,283600,63146
3529,1976,1553,926,70300,63147
0,0,0,-,-,63155
21149,14813,6336,1093,249400,63301
20599,15498,5101,1329,301700,63303
16222,14346,1876,1618,331300,63304
49,36,13,659,-,63330
625,600,25,-,385600,63332
303,252,51,909,88700,63333
2472,1719,753,766,145800,63334
430,338,92,695,144400,63336
376,325,51,725,198200,63339
1271,1232,39,1086,552600,63341
1705,1256,449,933,149300,63343
596,537,59,902,194900,63344
213,182,31,332,57300,63345
910,850,60,871,166400,63347
3867,3333,534,1602,364900,63348
683,567,116,910,222400,63349
264,191,73,750,-,63350
533,378,155,911,207500,63351
443,335,108,620,90700,63352
2054,1418,636,678,101700,63353
2148,1930,218,851,242500,63357
489,376,113,725,172700,63359
1998,1521,477,724,180000,63361
3546,2816,730,994,225000,63362
482,346,136,862,141700,63363
29,27,2,-,-,63365
20558,16678,3880,1274,283900,63366
10530,8527,2003,1654,381000,63367
16948,13799,3149,1442,327700,63368
1048,680,368,1251,320200,63369
282,242,40,1035,206500,63373
29761,24584,5177,1319,255500,63376
1149,1048,101,892,218400,63377
10244,7928,2316,976,238500,63379
334,237,97,950,199500,63380
244,177,67,881,193300,63381
1298,927,371,768,90900,63382
6128,4706,1422,1021,227600,63383
786,690,96,565,113200,63384
17533,15047,2486,1221,321300,63385
169,160,9,1313,156300,63386
33,26,7,744,95000,63387
362,310,52,-,67600,63388
2419,1821,598,941,218500,63389
4049,3389,660,872,244500,63390
8361,5637,2724,824,144400,63401
165,160,5,-,150800,63430
173,173,0,-,-,63431
167,151,16,-,131300,63432
0,0,0,-,-,63433
274,152,122,440,96400,63434
1437,1073,364,550,133800,63435
466,415,51,513,175600,63436
613,453,160,596,77200,63437
60,48,12,-,95200,63438
93,66,27,-,80000,63439
404,315,89,745,127600,63440
408,326,82,-,85600,63441
165,130,35,433,57900,63443
1258,908,350,546,103400,63445
163,150,13,725,275000,63446
285,207,78,575,85000,63447
580,466,114,784,118800,63448
65,38,27,-,158300,63450
119,119,0,-,-,63451
349,306,43,693,88200,63452
114,106,8,-,250000,63453
389,374,15,681,186300,63454
1824,1147,677,691,151300,63456
119,103,16,779,179900,63457
65,58,7,-,73600,63458
1702,1486,216,781,158000,63459
74,63,11,-,85000,63460
2134,1634,500,808,176500,63461
695,569,126,619,152300,63462
269,233,36,-,129700,63463
182,122,60,-,-,63465
0,0,0,-,-,63466
5,5,0,-,-,63467
997,784,213,655,88300,63468
354,268,86,625,102300,63469
271,254,17,-,244200,63471
197,172,25,606,-,63472
127,104,23,-,164800,63473
174,119,55,607,67900,63474
7519,4164,3355,783,159700,63501
410,353,57,668,122900,63530
82,68,14,615,-,63531
543,432,111,665,99200,63532
323,278,45,681,186900,63533
308,269,39,619,105000,63534
17,9,8,-,-,63535
291,248,43,341,127400,63536
627,517,110,666,104800,63537
59,53,6,-,107500,63538
86,84,2,-,-,63539
59,55,4,-,87000,63540
131,118,13,-,124100,63541
94,74,20,-,-,63543
420,353,67,675,144900,63544
339,276,63,680,107300,63545
486,426,60,628,145300,63546
184,163,21,630,80300,63547
321,257,64,425,152900,63548
860,628,232,-,122000,63549
129,129,0,-,223600,63551
3122,2225,897,755,150200,63552
1059,862,197,499,142600,63555
1125,770,355,753,118500,63556
108,108,0,-,258800,63557
261,223,38,585,116700,63558
499,421,78,528,133200,63559
28,15,13,975,-,63560
323,231,92,394,109200,63561
165,153,12,-,187500,63563
1497,1176,321,533,117600,63565
38,36,2,-,103600,63566
23,6,17,-,-,63567
6548,4426,2122,734,114400,63601
418,317,101,620,122200,63620
659,577,82,388,158600,63621
474,290,184,624,105000,63622
292,247,45,721,105500,63623
1350,986,364,702,94200,63624
176,168,8,-,200000,63625
253,253,0,-,118200,63626
1075,985,90,825,241400,63627
5190,4072,1118,698,171000,63628
397,331,66,431,117300,63629
1418,1130,288,807,111600,63630
311,273,38,763,138100,63631
288,199,89,533,131400,63633
218,175,43,846,69800,63636
343,266,77,777,150000,63637
841,608,233,653,92100,63638
10282,6636,3646,857,195900,63640
4168,3119,1049,822,151200,63645
602,487,115,832,93600,63648
1485,1124,361,755,113100,63650
421,265,156,802,51600,63653
293,284,9,-,188800,63654
556,440,116,530,172200,63655
213,173,40,443,128800,63656
907,788,119,704,101300,63660
350,265,85,-,107400,63662
336,188,148,673,110100,63663
3496,2503,993,659,122800,63664
162,143,19,-,-,63665
4658,3648,1010,769,205700,63670
864,703,161,926,217000,63673
32,32,0,-,-,63674
5,5,0,-,-,63675
15871,9550,6321,863,209600,63701
3734,1520,2214,843,127300,63703
1555,1263,292,731,123900,63730
297,224,73,964,177000,63732
322,220,102,404,73000,63735
1464,1086,378,877,168600,63736
0,0,0,-,-,63738
144,112,32,-,133100,63739
2183,1655,528,713,138900,63740
34,31,3,-,80500,63742
8,8,0,-,-,63743
71,60,11,1025,102800,63744
37,37,0,-,107500,63745
11,8,3,-,-,63746
246,246,0,-,-,63747
565,523,42,923,149300,63748
32,32,0,-,300000,63750
382,321,61,-,233200,63751
10325,8052,2273,977,233400,63755
167,94,73,810,189700,63758
211,199,12,-,210400,63760
50,41,9,-,106000,63763
1581,1195,386,711,118600,63764
693,640,53,1099,174400,63766
252,209,43,746,71700,63767
512,477,35,700,191600,63769
74,64,10,-,111100,63770
922,659,263,775,122400,63771
43,17,26,933,65800,63774
6116,4563,1553,925,192100,63775
2350,1714,636,797,158100,63780
655,554,101,588,185100,63781
63,60,3,-,-,63782
51,51,0,-,85700,63783
66,52,14,-,64400,63784
403,397,6,-,171200,63785
223,198,25,-,101400,63787
9034,5840,3194,826,149600,63801
111,97,14,1281,53100,63820
282,187,95,604,62600,63821
1074,778,296,760,102200,63822
491,377,114,636,107600,63823
59,26,33,1007,-,63824
1610,1193,417,770,99700,63825
48,41,7,-,83800,63826
174,142,32,-,70800,63827
72,58,14,-,38900,63828
430,222,208,765,58100,63829
2596,1351,1245,770,136300,63830
83,69,14,-,-,63833
1608,904,704,725,107100,63834
531,320,211,586,55000,63837
142,80,62,689,79200,63839
24,24,0,-,45600,63840
5292,3468,1824,762,161500,63841
2307,1376,931,837,94100,63845
452,363,89,723,97200,63846
62,13,49,-,-,63847
385,283,102,700,61900,63848
91,31,60,-,117300,63849
6,6,0,-,-,63850
1394,756,638,662,74200,63851
521,371,150,614,89100,63852
63,56,7,-,52500,63853
344,272,72,358,66300,63855
4790,2913,1877,599,109500,63857
80,60,20,-,58600,63860
474,306,168,714,80000,63862
2253,1232,1021,716,88700,63863
184,73,111,675,69000,63866
375,276,99,730,106600,63867
342,194,148,560,64300,63868
1409,858,551,678,126200,63869
404,234,170,680,45900,63870
1774,1131,643,755,135800,63873
117,95,22,668,72700,63874
792,553,239,485,98200,63876
1251,743,508,674,151100,63877
41,26,15,-,52000,63878
340,294,46,758,54900,63879
8,0,8,-,-,63880
149,103,46,685,45800,63882
13477,8405,5072,785,143200,63901
358,204,154,894,74000,63932
1163,827,336,666,80700,63933
8,8,0,-,-,63934
2928,2274,654,713,113700,63935
187,117,70,844,158800,63936
959,710,249,682,215900,63937
455,406,49,-,97900,63939
606,537,69,678,130100,63940
78,47,31,-,71800,63941
163,131,32,475,121400,63942
402,299,103,558,78000,63943
551,523,28,450,144700,63944
488,387,101,767,152300,63945
16,16,0,-,-,63950
98,98,0,-,-,63951
112,82,30,-,-,63952
352,264,88,616,84900,63953
381,281,100,525,77600,63954
39,31,8,-,102100,63955
264,164,100,625,176600,63956
2171,1475,696,620,114300,63957
1197,841,356,640,121200,63960
645,427,218,639,91000,63961
0,0,0,-,-,63962
217,170,47,-,-,63964
866,500,366,554,118800,63965
918,775,143,669,116400,63966
652,564,88,664,104900,63967
339,292,47,821,138200,64001
1457,1238,219,599,313400,64011
11891,7941,3950,1232,200900,64012
10835,7386,3449,1301,233200,64014
12563,9029,3534,1148,249500,64015
1731,1394,337,981,205600,64016
122,86,36,-,154200,64017
376,302,74,1173,271000,64018
932,916,16,756,219200,64019
1219,795,424,737,182200,64020
203,170,33,1095,94400,64021
45,38,7,913,177800,64022
5708,4364,1344,916,185200,64024
103,94,9,913,183300,64028
7749,5611,2138,1369,284700,64029
11160,5648,5512,1003,171700,64030
3209,2976,233,1719,311600,64034
446,357,89,981,118000,64035
193,117,76,825,57500,64036
2557,1918,639,859,178700,64037
2312,1847,465,774,220200,64040
1447,1322,125,980,300400,64048
9382,4602,4780,915,137200,64050
9424,5215,4209,1105,131100,64052
2450,1267,1183,929,78400,64053
1323,868,455,1100,98500,64054
15932,11077,4855,1098,173400,64055
6110,3803,2307,1290,176400,64056
6130,3703,2427,1139,235700,64057
2520,2080,440,1265,196300,64058
6396,5297,1099,1096,322100,64060
1115,1050,65,887,240100,64061
2337,1939,398,1063,230700,64062
8758,5360,3398,1151,242800,64063
7471,6169,1302,1416,375800,64064
18,0,18,950,-,64065
29,14,15,1102,-,64066
2262,1621,641,725,183900,64067
13912,10135,3777,1172,268200,64068
1235,1106,129,1120,345200,64070
248,209,39,900,200900,64071
128,105,23,1045,82900,64072
210,181,29,1547,235000,64074
4467,3213,1254,980,233400,64075
3496,2814,682,961,226400,64076
664,563,101,950,159200,64077
3693,3099,594,1180,283700,64078
5205,3611,1594,1349,325800,64079
5420,4451,969,1139,299900,64080
10184,7342,2842,1449,333400,64081
6628,5674,954,1738,380800,64082
9663,7630,2033,1262,316100,64083
563,543,20,-,248800,64084
3408,2182,1226,752,163700,64085
9142,6912,2230,1417,288400,64086
460,445,15,1047,321400,64088
5327,4508,819,1212,307200,64089
57,43,14,708,163800,64090
0,0,0,-,-,64092
10721,5989,4732,867,227500,64093
413,254,159,819,117100,64096
400,331,69,1004,224600,64097
1246,1012,234,893,311200,64098
79,0,79,1270,-,64101
14,0,14,-,-,64102
4377,592,3785,1558,228400,64105
5420,963,4457,1188,220900,64106
5414,1770,3644,1422,286300,64108
4926,1891,3035,919,240000,64109
7567,3756,3811,1155,238200,64110
10644,3218,7426,1184,269500,64111
4881,2143,2738,1425,393900,64112
4888,4622,266,2307,483600,64113
12419,8055,4364,1304,257400,64114
8722,3862,4860,1252,226600,64116
6537,3641,2896,1034,173500,64117
18011,10553,7458,1122,206200,64118
13095,9633,3462,1259,216300,64119
369,55,314,1623,-,64120
4118,2617,1501,961,111100,64123
4123,1936,2187,954,109400,64124
701,466,235,937,93500,64125
2447,1399,1048,967,54800,64126
7542,3532,4010,886,59300,64127
5439,2483,2956,926,64800,64128
3598,2262,1336,1116,112000,64129
8661,4415,4246,1003,71500,64130
9748,4738,5010,1139,217700,64131
4867,2303,2564,1094,90900,64132
14831,9400,5431,1185,165700,64133
8690,4364,4326,1233,122900,64134
654,337,317,1071,178900,64136
4451,2099,2352,1127,179000,64137
10614,6410,4204,1127,164900,64138
899,571,328,1679,393500,64139
2054,1771,283,1735,350100,64145
796,646,150,1606,205200,64146
150,0,150,1101,-,64147
173,130,43,-,350000,64149
1694,759,935,916,323300,64150
11681,7130,4551,1333,292500,64151
11867,9872,1995,1236,333700,64152
2956,1602,1354,1141,330800,64153
5917,2967,2950,1384,351000,64154
10813,7759,3054,1338,284500,64155
2909,2086,823,1464,395000,64156
7567,6907,660,1970,360800,64157
2633,1384,1249,1472,352300,64158
137,94,43,1411,136700,64161
481,264,217,831,206500,64163
55,55,0,-,-,64164
55,55,0,-,-,64165
128,128,0,-,425600,64166
96,96,0,-,371900,64167
599,585,14,825,241500,64401
943,681,262,534,101700,64402
16,13,3,-,208300,64420
302,248,54,1279,90000,64421
152,136,16,-,-,64422
384,313,71,-,148400,64423
1422,941,481,634,119700,64424
191,142,49,795,28200,64426
253,193,60,808,176600,64427
272,213,59,-,101500,64428
4056,2640,1416,1038,186300,64429
351,311,40,926,227700,64430
186,141,45,544,146300,64431
13,13,0,-,112500,64432
23,19,4,-,106300,64433
243,222,21,465,193800,64434
316,264,52,1658,267900,64436
183,164,19,-,115600,64437
60,54,6,-,-,64438
583,507,76,755,201900,64439
314,249,65,867,191800,64440
45,39,6,-,111700,64441
333,293,40,617,119200,64442
529,423,106,927,315800,64443
567,418,149,596,217900,64444
139,94,45,772,100000,64445
468,335,133,552,102000,64446
406,380,26,-,198700,64448
183,161,22,783,102900,64449
181,132,49,542,87500,64451
56,54,2,-,-,64453
955,844,111,840,237800,64454
153,106,47,423,81400,64455
534,408,126,362,90600,64456
114,109,5,-,100700,64457
51,51,0,-,-,64458
209,192,17,-,184700,64459
381,327,54,588,106300,64461
498,348,150,663,128600,64463
1517,1152,365,858,180900,64465
245,193,52,475,110400,64466
67,63,4,-,237500,64467
5585,2951,2634,772,200300,64468
876,627,249,766,147600,64469
622,477,145,728,157000,64470
214,137,77,800,75300,64471
491,388,103,591,120800,64473
338,229,109,772,133700,64474
169,111,58,373,99500,64475
117,105,12,917,109400,64476
1423,1088,335,775,220900,64477
402,322,80,761,134400,64479
162,148,14,-,187500,64480
411,315,96,533,103600,64481
838,631,207,673,115800,64482
185,167,18,767,184600,64483
380,287,93,820,123600,64484
3207,2308,899,837,188700,64485
115,82,33,290,55700,64486
268,219,49,688,85700,64487
781,589,192,721,164500,64489
714,604,110,891,203800,64490
745,515,230,610,90700,64491
694,566,128,957,206000,64492
122,102,20,865,212500,64493
424,343,81,930,122200,64494
95,61,34,-,104500,64496
193,165,28,577,340800,64497
125,124,1,-,71000,64498
72,72,0,-,96100,64499
4253,2014,2239,823,97400,64501
5005,3453,1552,926,133500,64503
3962,2796,1166,918,115100,64504
5253,3753,1500,976,186000,64505
8966,5272,3694,908,220500,64506
5369,3658,1711,890,134000,64507
4640,3052,1588,756,145000,64601
185,172,13,850,267400,64620
223,156,67,497,81400,64622
149,136,13,856,62200,64623
647,554,93,720,108900,64624
312,210,102,619,77000,64625
2384,1795,589,661,115600,64628
213,169,44,733,124500,64630
339,276,63,475,115400,64631
179,160,19,513,79000,64632
1796,1215,581,787,117100,64633
173,139,34,845,126100,64635
100,87,13,-,87000,64636
206,163,43,548,115200,64637
154,108,46,533,175000,64638
77,69,8,-,77900,64639
1241,896,345,796,177400,64640
250,168,82,-,121900,64641
275,219,56,763,87900,64642
461,376,85,653,112900,64643
1220,938,282,650,171600,64644
81,69,12,296,47000,64645
99,83,16,450,87500,64646
173,113,60,588,56500,64647
667,556,111,525,106700,64648
313,265,48,975,197000,64649
275,230,45,769,201600,64650
182,143,39,575,-,64651
156,139,17,495,165600,64652
213,193,20,292,119300,64653
18,14,4,-,154200,64654
57,57,0,-,-,64655
86,56,30,643,103800,64656
133,108,25,863,125000,64657
1122,914,208,600,114100,64658
334,256,78,622,131300,64659
167,157,10,588,206600,64660
316,226,90,550,80000,64661
105,91,14,575,121900,64664
96,90,6,-,48600,64667
642,461,181,830,104400,64668
388,295,93,613,187200,64670
780,696,84,495,166800,64671
75,70,5,-,-,64672
876,699,177,550,91400,64673
142,122,20,293,103100,64674
58,49,9,-,82600,64676
326,240,86,-,108300,64679
73,63,10,-,86100,64681
136,117,19,-,115500,64682
3042,2053,989,711,107200,64683
102,96,6,-,98600,64686
230,198,32,-,123200,64688
176,154,22,725,125000,64689
5493,3748,1745,886,234200,64701
1526,1125,401,754,163100,64720
103,80,23,665,115600,64722
239,186,53,625,175000,64723
802,532,270,503,108300,64724
761,613,148,1086,221300,64725
136,123,13,-,192800,64726
139,128,11,-,153600,64728
2500,1629,871,772,170400,64730
420,331,89,728,197300,64733
745,592,153,1127,313600,64734
5891,4166,1725,727,165000,64735
540,489,51,988,181300,64738
391,354,37,731,281100,64739
717,642,75,622,123200,64740
111,106,5,-,84600,64741
914,719,195,851,226300,64742
89,61,28,900,165200,64743
3221,2168,1053,856,164100,64744
27,16,11,-,72000,64745
609,501,108,1043,197600,64746
1609,1355,254,882,223500,64747
528,348,180,627,103000,64748
104,94,10,-,200000,64750
225,199,26,1000,116800,64752
912,750,162,673,159600,64755
215,188,27,513,90000,64756
2892,1879,1013,805,153700,64759
594,482,112,847,123900,64761
595,474,121,725,108000,64762
668,463,205,388,141600,64763
5,3,2,-,-,64765
267,255,12,-,139900,64767
232,206,26,386,49700,64769
528,388,140,711,126700,64770
175,149,26,608,176300,64771
5435,3796,1639,725,137800,64772
1535,1129,406,636,140700,64776
153,136,17,680,-,64778
971,791,180,719,88900,64779
142,120,22,794,66300,64780
40,30,10,-,71100,64781
259,218,41,529,102800,64783
549,393,156,541,146600,64784
593,451,142,933,160500,64788
354,243,111,746,114800,64790
15494,8553,6941,884,176100,64801
14898,10505,4393,886,171500,64804
286,170,116,843,87000,64830
2285,1560,725,777,147700,64831
492,397,95,1117,174700,64832
24,19,5,-,-,64833
3654,2838,816,1203,200300,64834
689,524,165,823,95400,64835
9235,6042,3193,883,157700,64836
1313,1006,307,715,215200,64840
472,296,176,828,116500,64841
294,230,64,802,165600,64842
1117,858,259,780,112900,64843
1574,1289,285,750,115600,64844
144,65,79,463,55000,64847
188,184,4,-,-,64848
79,76,3,-,93800,64849
9112,6138,2974,762,161700,64850
1570,729,841,752,92400,64854
1005,842,163,796,176600,64855
1570,1118,452,757,173600,64856
143,122,21,938,82100,64857
249,249,0,-,266400,64858
483,388,95,738,83600,64859
455,348,107,561,158300,64861
1235,924,311,858,117800,64862
569,372,197,622,150000,64863
1814,1468,346,879,188500,64865
411,376,35,794,122600,64866
331,299,32,844,154300,64867
55,55,0,-,94800,64868
6297,4146,2151,942,166000,64870
348,343,5,-,105900,64873
174,108,66,466,99100,64874
99,92,7,-,187500,65001
2988,2225,763,1180,274100,65010
793,552,241,444,140800,65011
1178,850,328,589,196400,65013
914,759,155,761,134200,65014
502,435,67,539,231400,65016
433,369,64,737,144500,65017
3347,2638,709,782,162800,65018
5360,4249,1111,836,243900,65020
736,659,77,937,210600,65023
466,408,58,720,120900,65024
308,210,98,725,167500,65025
4835,3592,1243,760,159000,65026
544,474,70,840,162000,65032
255,218,37,-,-,65034
606,551,55,-,213400,65035
2480,2140,340,791,250300,65037
1156,1116,40,591,408600,65039
479,439,40,-,191300,65040
2309,1784,525,805,206400,65041
3800,2912,888,954,209600,65043
520,480,40,463,204600,65046
572,315,257,339,233700,65047
88,80,8,-,341900,65048
2879,2245,634,895,354200,65049
193,174,19,630,223700,65050
1845,1241,604,659,178100,65051
1376,1236,140,746,298400,65052
582,514,68,775,328600,65053
367,338,29,-,214400,65054
494,460,34,532,191800,65058
450,376,74,917,233000,65059
245,233,12,-,92800,65061
6,6,0,-,-,65062
1489,1238,251,820,228300,65063
316,310,6,-,117900,65064
2829,2018,811,796,298700,65065
2471,1933,538,667,160900,65066
167,167,0,-,126200,65067
325,275,50,780,193100,65068
227,191,36,883,173600,65069
822,708,114,1265,230100,65072
1211,1056,155,652,167400,65074
389,357,32,-,264200,65075
265,210,55,950,185000,65076
184,167,17,-,202500,65077
1521,1240,281,754,115900,65078
2088,1954,134,1250,349100,65079
505,464,41,-,309800,65080
1017,707,310,774,148200,65081
372,323,49,1083,163800,65082
94,70,24,-,-,65083
2521,1862,659,568,153000,65084
413,369,44,606,257200,65085
10703,7054,3649,770,234600,65101
17169,11133,6036,828,204700,65109
19196,6233,12963,1078,229300,65201
18937,12078,6859,1091,202300,65202
25588,16254,9334,1035,319100,65203
0,0,0,-,-,65215
7,0,7,-,-,65216
204,183,21,-,61700,65230
1120,921,199,590,148500,65231
132,128,4,-,151700,65232
3830,2882,948,807,206000,65233
470,317,153,450,98600,65236
363,303,60,725,122400,65237
705,682,23,908,176200,65239
3571,2753,818,712,181300,65240
891,762,129,837,205700,65243
168,154,14,-,162500,65244
21,20,1,-,58000,65246
237,196,41,811,96000,65247
1361,983,378,838,141600,65248
151,143,8,-,188700,65250
7338,5135,2203,830,172200,65251
748,648,100,661,139500,65254
1906,1534,372,1034,225400,65255
786,685,101,648,241600,65256
571,485,86,723,117200,65257
188,162,26,635,168800,65258
1022,752,270,717,129800,65259
193,165,28,711,95000,65260
445,339,106,395,111600,65261
338,277,61,982,184400,65262
524,421,103,688,124000,65263
361,327,34,432,87800,65264
5753,3984,1769,715,127500,65265
6259,3981,2278,753,143300,65270
683,512,171,673,152700,65274
1021,830,191,702,143300,65275
651,509,142,702,182900,65276
31,24,7,-,82000,65278
696,605,91,1161,282500,65279
73,52,21,620,-,65280
1084,894,190,632,141300,65281
109,109,0,-,-,65282
250,247,3,-,230900,65283
830,620,210,886,184000,65284
186,177,9,-,160800,65285
33,27,6,-,-,65286
127,99,28,-,-,65287
13759,9237,4522,865,159700,65301
975,7,968,1217,-,65305
20,20,0,-,250000,65320
135,106,29,750,93300,65321
246,215,31,830,162500,65322
334,290,44,529,169600,65323
568,508,60,889,262100,65324
1117,841,276,858,184300,65325
832,782,50,907,182600,65326
93,81,12,775,130400,65327
103,85,18,-,336100,65329
177,132,45,571,109300,65330
800,727,73,1006,219800,65332
357,334,23,682,116000,65333
460,330,130,1116,173100,65334
96,86,10,-,-,65335
2794,1839,955,912,195400,65336
666,483,183,681,166200,65337
1147,907,240,851,134500,65338
222,135,87,-,82900,65339
5345,3747,1598,765,151700,65340
62,50,12,-,225000,65344
306,258,48,708,-,65345
354,338,16,700,156600,65347
554,480,74,713,192400,65348
968,620,348,559,93800,65349
527,439,88,810,124200,65350
751,552,199,730,118100,65351
258,151,107,1289,167500,65354
4729,3987,742,805,173400,65355
1639,1310,329,798,123400,65360
12798,7176,5622,796,206500,65401
4,4,0,-,-,65409
0,0,0,-,-,65436
1076,968,108,463,105800,65438
24,18,6,-,-,65439
98,92,6,-,-,65440
2137,1592,545,842,184700,65441
39,39,0,-,-,65443
393,291,102,639,140700,65444
134,39,95,-,106700,65446
74,52,22,-,-,65449
986,786,200,664,132000,65452
3407,2451,956,806,184100,65453
174,159,15,-,207000,65456
100,87,13,-,219400,65457
2868,2421,447,767,166200,65459
69,69,0,-,191100,65461
558,528,30,664,117700,65462
570,331,239,-,141400,65463
230,212,18,-,159900,65464
534,342,192,705,209500,65466
23,23,0,-,-,65468
338,277,61,-,186300,65470
1819,5,1814,1169,-,65473
109,109,0,-,231300,65479
1753,1260,493,727,116500,65483
18,18,0,-,-,65484
1228,1090,138,525,142300,65486
72,68,4,-,-,65501
77,77,0,-,-,65529
214,203,11,-,-,65534
560,493,67,491,129600,65535
11917,8339,3578,805,159400,65536
53,48,5,-,325000,65541
2242,1727,515,706,114200,65542
255,216,39,642,200900,65543
2434,1739,695,508,134900,65548
1208,905,303,530,155000,65550
688,604,84,903,182300,65552
525,421,104,492,112300,65555
2071,1559,512,493,116700,65556
121,108,13,-,215500,65557
3643,2710,933,834,194600,65559
5304,3998,1306,625,141700,65560
29,0,29,-,-,65564
2060,1387,673,724,122700,65565
327,255,72,323,97600,65566
617,521,96,661,163800,65567
330,315,15,868,79300,65570
749,562,187,425,116600,65571
329,239,90,641,198800,65580
789,585,204,680,160100,65582
5306,3379,1927,1107,209400,65583
4427,2444,1983,1067,207900,65584
16,16,0,-,-,65586
850,716,134,543,155500,65588
24,24,0,-,115800,65589
834,629,205,851,187600,65590
521,419,102,1082,141900,65591
266,209,57,740,133600,65601
48,44,4,-,280000,65603
1584,1325,259,757,192700,65604
4704,3389,1315,754,135800,65605
1008,769,239,845,130400,65606
3349,2515,834,692,152000,65608
289,250,39,736,102700,65609
2159,1941,218,809,250700,65610
1004,847,157,835,255900,65611
825,602,223,486,249300,65612
6726,4487,2239,828,197200,65613
178,148,30,840,115300,65614
11379,6536,4843,975,243000,65616
643,585,58,1117,205600,65617
50,50,0,-,122300,65618
3926,2984,942,945,212400,65619
90,39,51,-,-,65620
3106,2108,998,659,143200,65622
7,4,3,-,-,65623
670,622,48,686,232800,65624
2870,2056,814,711,161100,65625
761,611,150,667,190800,65626
377,255,122,-,127900,65627
209,181,28,589,257500,65629
215,197,18,-,456900,65630
2348,1894,454,1058,220600,65631
969,726,243,809,202200,65632
1412,1057,355,848,173200,65633
158,152,6,-,188200,65634
245,216,29,717,194100,65635
348,240,108,596,220500,65637
247,197,50,-,209400,65638
344,340,4,-,171500,65640
411,382,29,-,202400,65641
687,590,97,812,185500,65644
748,676,72,650,173600,65646
1192,1014,178,633,150900,65647
2222,1890,332,895,199300,65648
861,682,179,937,285700,65649
535,452,83,724,97000,65650
1500,1311,189,760,227300,65652
2621,1996,625,719,181400,65653
110,77,33,-,113200,65654
1013,742,271,623,162000,65655
1863,1566,297,839,229000,65656
89,55,34,-,190600,65657
696,527,169,539,267900,65658
100,96,4,-,116400,65660
927,645,282,583,126100,65661
399,328,71,-,157800,65662
988,780,208,-,209900,65663
21,12,9,1313,-,65664
0,0,0,-,-,65666
1110,857,253,478,209800,65667
776,607,169,1022,109200,65668
970,843,127,1120,215800,65669
3355,2483,872,878,172600,65672
932,592,340,683,116400,65674
12,9,3,-,85000,65675
194,143,51,-,121200,65676
1268,843,425,849,191800,65679
485,448,37,738,141600,65680
925,859,66,-,209800,65681
840,605,235,783,148000,65682
342,280,62,-,78000,65685
2199,1825,374,967,247300,65686
29,20,9,718,602900,65688
1972,1402,570,651,128900,65689
71,53,18,-,-,65690
361,258,103,913,175000,65692
112,96,16,-,258300,65702
1853,1367,486,461,197000,65704
1759,1173,586,822,159200,65705
6233,5069,1164,780,234400,65706
926,694,232,918,163500,65707
4769,2926,1843,853,170600,65708
510,360,150,756,206200,65710
3308,2616,692,686,120600,65711
3203,2375,828,687,208000,65712
835,581,254,655,190100,65713
12988,9381,3607,985,261300,65714
23,23,0,-,-,65715
863,663,200,584,162800,65717
165,147,18,-,184700,65720
12800,9562,3238,991,253700,65721
491,406,85,684,158600,65722
1109,790,319,818,150600,65723
679,627,52,597,153300,65724
926,746,180,845,185100,65725
0,0,0,-,-,65726
56,56,0,-,-,65727
13,13,0,-,-,65728
51,51,0,-,-,65729
8,8,0,-,-,65730
75,69,6,-,212500,65731
434,384,50,586,258300,65732
194,168,26,-,108300,65733
1261,994,267,644,170700,65734
34,23,11,-,122900,65735
3359,2696,663,919,242100,65737
8706,5878,2828,1069,195400,65738
407,356,51,690,285400,65739
1158,890,268,944,114400,65740
0,0,0,-,-,65741
5049,3659,1390,829,276800,65742
120,114,6,-,224300,65744
1082,710,372,814,112500,65745
2613,2097,516,698,190500,65746
1769,1573,196,773,252600,65747
156,97,59,924,98000,65752
2046,1659,387,791,215300,65753
244,244,0,-,171000,65754
262,246,16,-,119200,65755
309,281,28,-,221200,65756
3020,2633,387,1007,231200,65757
373,343,30,675,155100,65759
296,262,34,-,160100,65760
655,586,69,579,185600,65761
162,148,14,-,207900,65762
528,442,86,-,102800,65764
21,17,4,-,-,65766
712,572,140,538,165300,65767
84,61,23,-,238200,65768
996,885,111,725,168000,65769
1131,970,161,747,181200,65770
477,439,38,-,313200,65771
978,846,132,625,172400,65772
133,123,10,-,375000,65773
438,323,115,547,100900,65774
10118,6709,3409,776,177700,65775
45,18,27,-,-,65777
203,99,104,643,143400,65778
594,491,103,492,101300,65779
3246,2348,898,1153,210500,65781
80,80,0,-,83300,65783
9,9,0,-,-,65784
2154,1698,456,774,161600,65785
664,590,74,733,178400,65786
500,463,37,967,266800,65787
110,100,10,-,86800,65788
618,474,144,672,154700,65789
349,279,70,-,88100,65790
1517,1187,330,660,110200,65791
2331,1700,631,673,131500,65793
0,0,0,-,-,65801
18955,10781,8174,900,162400,65802
18434,9852,8582,890,158200,65803
19401,10356,9045,898,227000,65804
7396,915,6481,840,85700,65806
27561,12551,15010,994,174000,65807
4801,3924,877,933,355800,65809
9722,7241,2481,1109,282900,65810
24,0,24,-,-,65897
4572,3162,1410,754,145100,66002
2878,2118,760,1165,330300,66006
3692,2920,772,1173,353000,66007
72,68,4,-,190500,66008
275,253,22,582,120800,66010
3529,2819,710,1069,248000,66012
839,839,0,-,715300,66013
273,198,75,-,333300,66014
342,255,87,443,127800,66015
203,190,13,-,300000,66016
115,108,7,-,111000,66017
2395,1772,623,1097,379900,66018
560,492,68,1014,291900,66020
864,745,119,1213,232000,66021
475,385,90,846,108400,66023
221,144,77,918,93800,66024
2810,2133,677,1222,259200,66025
244,200,44,1652,221700,66026
1594,9,1585,1889,-,66027
8947,6240,2707,1306,281700,66030
0,0,0,-,-,66031
2012,1563,449,878,168900,66032
285,254,31,787,179500,66033
272,231,41,578,154700,66035
327,300,27,1331,160000,66039
1601,1319,282,897,164800,66040
369,346,23,846,163000,66041
362,211,151,1090,182800,66042
3471,2844,627,1122,246500,66043
11687,4270,7417,999,228100,66044
27,0,27,-,-,66045
8839,4005,4834,937,217100,66046
9122,4143,4979,1107,303100,66047
14034,8861,5173,954,203700,66048
14155,7683,6472,1145,362600,66049
702,634,68,945,250000,66050
765,587,178,986,338500,66052
3124,2376,748,1399,300000,66053
1066,947,119,1071,240500,66054
692,562,130,738,139500,66056
130,110,20,733,127100,66058
490,413,77,869,130100,66060
23843,18153,5690,1228,337400,66061
28606,20870,7736,1349,342700,66062
2186,1666,520,953,162200,66064
1123,989,134,852,215100,66066
6495,4341,2154,957,175600,66067
855,838,17,986,208000,66070
5189,4080,1109,1068,261400,66071
453,442,11,850,240400,66072
944,779,165,789,189300,66073
991,611,380,650,137800,66075
811,665,146,816,187200,66076
279,255,24,867,212900,66078
301,270,31,-,201700,66079
358,313,45,825,162500,66080
4564,3706,858,1118,340300,66083
4149,3509,640,1454,522300,66085
4173,3342,831,1165,288800,66086
819,665,154,809,120500,66087
1089,769,320,738,186700,66088
986,831,155,817,130800,66090
157,127,30,917,-,66091
1672,1406,266,1265,227700,66092
266,262,4,-,113100,66093
161,105,56,675,154700,66094
341,293,48,800,210800,66095
411,386,25,1067,219500,66097
5034,2132,2902,789,77300,66101
9988,5533,4455,1020,105000,66102
6238,2530,3708,1166,119400,66103
9475,6385,3090,996,117900,66104
965,483,482,905,62200,66105
8684,5807,2877,944,154500,66106
9512,7476,2036,1626,255500,66109
3750,2880,870,989,131800,66111
4870,2332,2538,1132,186300,66112
0,0,0,-,-,66115
0,0,0,-,-,66118
0,0,0,-,-,66160
8834,4403,4431,1228,264400,66202
8087,5307,2780,1183,235900,66203
8705,4125,4580,1319,254400,66204
6170,4667,1503,1639,341500,66205
4691,4029,662,2131,633700,66206
6059,4790,1269,1880,400600,66207
9283,7494,1789,1651,419300,66208
8174,6013,2161,1465,554300,66209
9310,5075,4235,1407,345200,66210
2660,1760,900,1494,589400,66211
14545,8447,6098,1244,283900,66212
13066,7284,5782,1554,445100,66213
5278,2458,2820,1122,321700,66214
11408,6697,4711,1420,311600,66215
9709,8259,1450,1298,324900,66216
2648,1387,1261,1300,404400,66217
2735,2317,418,1697,408500,66218
6675,2248,4427,1458,370500,66219
2911,2729,182,1230,554200,66220
8422,7060,1362,1685,670500,66221
10169,5661,4508,1697,402500,66223
4862,4389,473,1554,626300,66224
5131,4428,703,1261,386600,66226
3326,2821,505,1989,423000,66227
6,0,6,-,-,66251
821,622,199,-,191000,66401
1152,924,228,884,239400,66402
244,206,38,833,257700,66403
174,174,0,-,226100,66404
207,150,57,289,136400,66406
154,112,42,1375,196300,66407
109,100,9,-,151000,66408
1522,1505,17,-,281700,66409
513,409,104,833,75900,66411
166,145,21,-,331100,66412
774,555,219,696,124200,66413
1029,829,200,606,146400,66414
319,262,57,833,80000,66415
178,155,23,569,151000,66416
188,168,20,-,-,66417
163,158,5,1375,157800,66418
152,130,22,-,89000,66419
321,292,29,1531,-,66422
259,209,50,647,96200,66423
211,169,42,679,-,66424
236,198,38,769,104400,66425
543,492,51,677,101000,66427
75,47,28,-,-,66428
193,193,0,-,165300,66429
232,202,30,1266,162500,66431
245,165,80,794,260900,66432
1821,1402,419,676,132000,66434
2146,1528,618,837,211300,66436
88,65,23,-,295800,66438
1004,644,360,625,81800,66439
836,732,104,944,207000,66440
10783,5433,5350,1001,161100,66441
3996,39,3957,1376,222100,66442
318,275,43,900,158700,66449
644,551,93,686,155700,66451
99,79,20,-,90500,66501
18378,8262,10116,953,217500,66502
7136,4075,3061,1215,325400,66503
3,0,3,-,-,66506
401,333,68,1069,208600,66507
1632,1287,345,667,128700,66508
947,708,239,996,182200,66509
275,217,58,944,178800,66510
1331,1085,246,975,183400,66512
540,444,96,1074,234200,66514
108,104,4,-,92300,66515
131,108,23,906,111500,66516
695,370,325,1164,149700,66517
143,129,14,-,127600,66518
258,222,36,689,216700,66520
531,347,184,882,181800,66521
25,18,7,-,47500,66522
1555,1145,410,845,148100,66523
943,856,87,775,151500,66524
312,280,32,342,180100,66526
71,49,22,800,64200,66527
297,272,25,815,198100,66528
527,496,31,1301,195900,66531
212,188,24,700,158300,66532
628,438,190,970,209000,66533
1556,1122,434,696,182500,66534
1457,1182,275,1160,211500,66535
1093,790,303,854,211400,66536
528,439,89,1013,91900,66537
1371,1091,280,696,252900,66538
1184,985,199,861,212200,66539
254,235,19,1156,170300,66540
108,106,2,-,84500,66541
1203,1047,156,1109,211700,66542
421,346,75,1118,167000,66543
133,124,9,725,75900,66544
490,455,35,1031,230000,66546
2998,2565,433,1059,196000,66547
394,338,56,917,101100,66548
541,459,82,917,199600,66549
226,203,23,1036,136800,66550
263,200,63,550,145700,66552
235,212,23,960,240500,66554
661,166,495,593,91500,66603
9845,5628,4217,1032,126600,66604
8108,5597,2511,856,157200,66605
4729,2668,2061,1052,115100,66606
3470,1642,1828,804,45600,66607
2165,1322,843,843,77500,66608
3435,2400,1035,1050,108200,66609
3939,3817,122,1180,322900,66610
4367,2114,2253,963,139100,66611
1312,233,1079,706,-,66612
14418,9954,4464,995,181500,66614
1402,947,455,1294,272300,66615
2503,1669,834,1023,79200,66616
3257,2738,519,1124,204000,66617
3912,3514,398,966,241800,66618
953,300,653,1310,81000,66619
0,0,0,-,-,66621
0,0,0,-,-,66622
4655,3268,1387,789,107800,66701
304,264,40,732,75000,66710
223,170,53,975,-,66711
720,465,255,831,89000,66712
1976,1410,566,838,94100,66713
50,45,5,-,59400,66714
281,223,58,780,57800,66716
216,205,11,725,51700,66717
4397,3250,1147,648,91900,66720
408,345,63,754,95000,66724
2161,1534,627,796,106800,66725
89,85,4,-,79400,66732
885,700,185,548,115000,66733
195,164,31,-,-,66734
235,187,48,983,117700,66735
1495,1031,464,710,94700,66736
129,115,14,813,-,66738
2266,1572,694,757,83300,66739
99,90,9,-,214300,66740
83,70,13,-,220800,66741
15,11,4,-,-,66742
1673,1113,560,779,106200,66743
63,61,2,-,-,66746
1098,928,170,513,107100,66748
2969,2008,961,715,101000,66749
274,219,55,685,57000,66751
545,481,64,744,125700,66753
116,93,23,1081,113300,66754
359,286,73,447,132700,66755
454,397,57,659,119100,66756
1300,962,338,749,114200,66757
80,66,14,850,-,66758
12,12,0,-,-,66760
87,87,0,-,152500,66761
10091,5301,4790,845,129900,66762
1400,966,434,847,165400,66763
163,117,46,844,-,66767
219,215,4,-,124500,66769
279,242,37,668,131500,66770
373,289,84,681,104100,66771
120,96,24,723,162500,66772
306,252,54,585,74100,66773
80,67,13,-,168800,66775
561,474,87,1047,122600,66776
261,241,20,669,57000,66777
0,0,0,-,-,66778
278,224,54,755,78900,66779
261,252,9,438,154500,66780
366,262,104,1044,104500,66781
68,52,16,1300,38000,66782
855,693,162,590,90200,66783
11531,6242,5289,799,144200,66801
107,93,14,940,103100,66830
255,187,68,492,79800,66833
456,331,125,929,121800,66834
449,356,93,1021,119700,66835
73,71,2,-,107600,66838
1638,1100,538,864,161900,66839
209,174,35,763,88400,66840
161,130,31,1063,120700,66842
60,45,15,-,87500,66843
507,379,128,685,88300,66845
1479,1110,369,678,143800,66846
215,177,38,798,107000,66849
81,55,26,-,114400,66850
329,230,99,827,55000,66851
259,159,100,735,94600,66852
156,133,23,631,46900,66853
341,276,65,754,84700,66854
678,623,55,864,175700,66856
426,340,86,781,98600,66857
169,147,22,575,79600,66858
68,61,7,-,101000,66859
587,461,126,628,81200,66860
1356,1119,237,685,127500,66861
46,35,11,596,99200,66862
29,29,0,-,-,66863
128,121,7,-,61000,66864
410,346,64,663,195100,66865
626,477,149,830,96500,66866
267,239,28,850,-,66868
298,203,95,456,107500,66869
69,52,17,-,105000,66870
508,428,80,906,123800,66871
436,336,100,745,87400,66872
126,123,3,-,79300,66873
2444,1710,734,698,105700,66901
65,40,25,-,26300,66930
45,31,14,-,93000,66932
158,122,36,775,72200,66933
1016,754,262,613,84000,66935
128,119,9,-,85000,66936
337,275,62,575,103600,66937
513,434,79,674,79500,66938
155,114,41,736,125000,66939
186,136,50,625,51800,66940
66,58,8,-,112500,66941
115,105,10,-,-,66942
222,167,55,613,105600,66943
113,110,3,-,223700,66944
429,381,48,600,113700,66945
79,58,21,-,-,66946
246,237,9,-,89800,66948
229,175,54,559,73200,66949
354,294,60,910,83300,66951
199,167,32,334,66500,66952
243,152,91,489,97300,66953
22,22,0,-,-,66955
515,423,92,533,58700,66956
137,86,51,-,43300,66958
103,94,9,-,91300,66959
44,42,2,-,36300,66960
3,3,0,-,-,66961
98,76,22,563,150000,66962
105,57,48,-,29500,66963
96,90,6,-,22300,66964
246,163,83,670,97200,66966
833,666,167,646,107200,66967
690,550,140,517,111600,66968
25,18,7,-,-,66970
801,756,45,906,333000,67001
5561,4495,1066,1492,272400,67002
971,738,233,668,71200,67003
347,287,60,693,117200,67004
6057,4136,1921,769,85800,67005
254,185,69,675,134400,67008
304,210,94,661,58500,67009
5449,4262,1187,976,178600,67010
15,15,0,-,-,67012
1155,865,290,776,156800,67013
157,138,19,975,123000,67016
773,699,74,1049,235400,67017
26,26,0,-,65000,67018
342,274,68,838,92900,67019
619,472,147,819,116500,67020
14,14,0,-,103100,67021
718,567,151,478,79000,67022
57,46,11,588,-,67023
416,335,81,525,72700,67024
1305,1038,267,945,178600,67025
1724,1443,281,1057,231700,67026
77,75,2,-,-,67028
493,340,153,733,72200,67029
952,772,180,1345,263000,67030
905,730,175,977,157400,67031
338,268,70,625,128300,67035
71,51,20,-,47600,67036
11884,8479,3405,1085,227200,67037
218,197,21,513,106800,67038
1056,905,151,921,192400,67039
92,88,4,-,136500,67041
6491,4421,2070,868,133400,67042
1297,984,313,719,101700,67045
237,194,43,468,80000,67047
6,6,0,-,-,67049
690,597,93,957,279800,67050
158,148,10,458,86700,67051
2854,2383,471,1372,253800,67052
207,146,61,805,96700,67053
524,378,146,742,204200,67054
40,26,14,-,155900,67055
1071,773,298,927,171400,67056
136,102,34,880,48600,67057
792,552,240,811,97000,67058
290,241,49,775,110600,67059
5140,4112,1028,965,165800,67060
101,70,31,-,-,67061
1635,885,750,693,190300,67062
1277,1060,217,773,144900,67063
109,102,7,-,-,67065
143,69,74,1078,110200,67066
862,660,202,1610,239600,67067
1818,1163,655,835,85700,67068
396,334,62,743,79300,67070
17,17,0,-,-,67071
144,54,90,580,-,67072
128,86,42,1009,121400,67073
592,515,77,808,118600,67074
2737,1364,1373,1343,280100,67101
24,18,6,-,103100,67102
67,50,17,-,88600,67103
864,658,206,711,102100,67104
61,58,3,-,75000,67105
129,123,6,-,208300,67106
1075,795,280,795,185200,67107
595,525,70,994,159600,67108
168,121,47,716,103100,67109
3194,2650,544,1190,179800,67110
99,79,20,1104,304500,67111
111,91,20,486,243200,67112
8556,5983,2573,909,164900,67114
875,591,284,798,203000,67117
332,254,78,894,107300,67118
492,381,111,663,119000,67119
380,364,16,-,222500,67120
108,76,32,-,-,67122
352,323,29,856,112500,67123
2942,2048,894,809,118600,67124
284,226,58,475,54300,67127
122,104,18,-,194200,67131
132,95,37,890,211800,67132
2441,2133,308,1060,228400,67133
137,115,22,821,106300,67134
1192,995,197,1025,212900,67135
227,189,38,716,47500,67137
197,177,20,-,245200,67138
368,313,55,561,93500,67140
120,102,18,825,65000,67142
21,20,1,-,120000,67143
1070,910,160,1068,166700,67144
723,586,137,848,164600,67146
3989,2978,1011,996,227900,67147
411,400,11,-,232000,67149
8,7,1,-,-,67150
196,165,31,1326,302600,67151
3579,2420,1159,814,105100,67152
613,533,80,850,136000,67154
48,39,9,-,71700,67155
5496,3782,1714,789,137700,67156
88,71,17,-,103100,67159
1314,67,1247,1039,-,67202
13423,6201,7222,921,126800,67203
8819,6631,2188,976,148900,67204
7091,5854,1237,1237,314200,67205
7745,4745,3000,1186,318100,67206
11493,5054,6439,961,204600,67207
7222,3689,3533,1008,179100,67208
5199,3997,1202,942,209900,67209
3120,1177,1943,905,180700,67210
8026,3521,4505,841,99100,67211
18202,11693,6509,1021,189000,67212
8140,3717,4423,920,80500,67213
6055,2553,3502,752,72600,67214
2214,1900,314,1336,222500,67215
8631,4563,4068,876,92000,67216
12168,8077,4091,1006,115100,67217
9836,5064,4772,905,117700,67218
4131,2776,1355,1049,156000,67219
5808,3443,2365,889,193900,67220
0,0,0,-,-,67221
221,221,0,-,245500,67223
8914,5113,3801,1164,274700,67226
98,98,0,-,-,67227
725,689,36,-,388200,67228
3975,3697,278,2026,388400,67230
265,265,0,-,584400,67232
5262,4831,431,1541,298100,67235
0,0,0,-,-,67260
5354,3862,1492,798,109500,67301
619,496,123,940,98900,67330
75,67,8,-,-,67332
1041,823,218,778,127300,67333
36,29,7,-,46300,67334
1311,904,407,716,96900,67335
529,371,158,530,68800,67336
4569,3246,1323,725,69000,67337
113,97,16,550,75700,67340
235,235,0,-,156000,67341
317,266,51,856,128300,67342
257,201,56,900,103900,67344
78,64,14,-,70000,67345
119,83,36,793,50700,67346
136,130,6,-,155700,67347
395,307,88,500,83900,67349
164,113,51,733,107200,67351
205,173,32,-,51700,67352
223,193,30,625,57000,67353
254,219,35,571,74100,67354
74,69,5,-,125900,67355
980,702,278,695,86400,67356
4931,3509,1422,743,101700,67357
149,139,10,-,49800,67360
699,580,119,728,65800,67361
13,13,0,-,-,67363
99,97,2,-,133800,67364
20831,13626,7205,913,172700,67401
4477,3563,914,797,156600,67410
372,305,67,928,182400,67416
58,35,23,-,-,67417
112,99,13,-,-,67418
1665,1118,547,739,107400,67420
529,436,93,950,222800,67422
111,90,21,1071,93300,67423
198,176,22,975,142500,67425
189,173,16,814,49600,67427
459,395,64,911,155100,67428
233,167,66,855,90400,67430
849,673,176,810,207400,67431
2538,1746,792,949,146900,67432
216,171,45,636,71900,67436
442,365,77,594,108700,67437
103,95,8,-,51300,67438
1105,851,254,703,143500,67439
411,329,82,917,114600,67441
81,81,0,-,-,67442
816,708,108,685,194900,67443
273,205,68,1080,55400,67444
212,199,13,-,48900,67445
320,234,86,397,216700,67446
125,124,1,-,160700,67447
468,406,62,856,128600,67448
1272,979,293,916,92100,67449
236,205,31,655,76800,67450
335,261,74,546,120200,67451
119,119,0,-,105400,67452
292,266,26,708,87200,67454
661,501,160,550,66300,67455
1886,1492,394,949,193000,67456
236,191,45,750,143100,67457
134,121,13,-,188200,67458
99,93,6,-,50400,67459
6664,4759,1905,912,211900,67460
477,417,60,733,119300,67464
295,192,103,678,78300,67466
1185,848,337,592,155600,67467
110,96,14,-,60000,67468
201,146,55,1086,177000,67470
820,582,238,580,87800,67473
69,68,1,-,46700,67474
55,46,9,-,104500,67475
8,8,0,-,-,67476
65,45,20,-,25800,67478
616,503,113,967,163900,67480
298,237,61,635,115500,67481
54,54,0,-,173200,67482
144,101,43,714,95000,67483
398,385,13,669,171300,67484
197,132,65,435,122100,67485
627,507,120,837,174800,67487
406,318,88,709,90700,67490
166,121,45,791,107800,67491
82,57,25,734,130500,67492
9371,5504,3867,865,86300,67501
10261,7634,2627,919,178400,67502
1274,717,557,555,149000,67505
95,81,14,1025,149200,67510
79,75,4,-,91300,67511
88,81,7,-,56600,67512
43,39,4,-,-,67513
330,256,74,783,84500,67514
18,18,0,-,65000,67515
236,167,69,663,75800,67516
6,2,4,-,-,67518
94,82,12,1083,404700,67519
139,137,2,-,53800,67520
73,60,13,-,77600,67521
704,586,118,798,142500,67522
187,125,62,1285,72200,67523
259,171,88,688,80300,67524
318,258,60,566,151300,67525
941,719,222,702,103900,67526
95,77,18,435,57500,67529
7271,4514,2757,748,123400,67530
843,719,124,781,102500,67543
1286,924,362,848,79000,67544
63,61,2,-,115600,67545
1005,837,168,930,192300,67546
685,533,152,721,67200,67547
657,473,184,683,86300,67548
1984,1214,770,811,111000,67550
276,238,38,608,58700,67552
32,24,8,-,70000,67553
1661,1233,428,738,108500,67554
105,99,6,-,44600,67556
284,209,75,542,97500,67557
31,31,0,-,261300,67559
577,461,116,708,107300,67560
600,426,174,822,77800,67561
138,126,12,950,90000,67563
125,116,9,-,122500,67564
152,140,12,950,63800,67565
490,440,50,480,95300,67566
293,257,36,833,84200,67567
114,102,12,638,115000,67568
556,463,93,784,164900,67570
196,166,30,625,64500,67572
58,53,5,-,-,67573
80,69,11,575,77500,67574
255,183,72,903,89000,67575
707,619,88,859,118800,67576
486,367,119,503,77500,67578
1032,829,203,618,149400,67579
155,152,3,-,64500,67581
359,298,61,628,69200,67583
94,64,30,-,33900,67584
10251,6191,4060,902,221400,67601
141,122,19,247,81300,67621
268,172,96,594,84400,67622
98,73,25,672,-,67623
110,103,7,-,-,67625
159,127,32,-,113700,67626
82,37,45,-,254700,67627
64,64,0,-,-,67628
25,18,7,-,-,67629
56,53,3,-,84700,67631
126,83,43,645,126100,67632
106,102,4,-,111100,67634
48,47,1,-,102100,67635
1158,894,264,-,160800,67637
81,63,18,242,51200,67638
57,55,2,-,178400,67639
195,155,40,750,133900,67640
815,606,209,729,102600,67642
105,97,8,-,37500,67643
73,55,18,-,75000,67644
235,211,24,-,77000,67645
299,216,83,572,79800,67646
90,67,23,1096,109600,67647
294,243,51,652,43200,67648
105,96,9,244,-,67649
158,150,8,-,75600,67650
237,178,59,623,31000,67651
125,85,40,778,85000,67653
1393,1167,226,824,124800,67654
94,68,26,-,204300,67656
129,111,18,625,100700,67657
48,44,4,-,-,67658
32,32,0,-,-,67659
28,26,2,-,168200,67660
1379,1018,361,654,94900,67661
1032,739,293,768,89100,67663
116,95,21,653,150500,67664
2204,1621,583,747,119400,67665
99,93,6,875,150800,67667
800,631,169,713,100900,67669
622,418,204,863,173900,67671
1043,825,218,745,113300,67672
27,15,12,-,-,67673
24,8,16,-,166700,67674
68,53,15,-,37800,67675
2458,1805,653,751,166600,67701
810,540,270,831,114000,67730
314,210,104,769,110700,67731
227,178,49,788,153200,67732
24,24,0,-,152300,67733
57,52,5,-,70000,67734
2191,1426,765,851,128700,67735
68,64,4,-,53300,67736
238,152,86,691,120400,67737
216,194,22,723,130400,67738
128,109,19,375,48500,67739
694,512,182,687,167300,67740
125,105,20,890,107600,67741
84,84,0,-,160400,67743
38,24,14,-,106300,67744
168,110,58,807,-,67745
51,33,18,-,162500,67747
1174,753,421,794,152300,67748
1071,828,243,681,77500,67749
81,74,7,-,110000,67751
628,491,137,741,138800,67752
195,160,35,-,124000,67753
861,729,132,698,123100,67756
203,163,40,583,86900,67757
479,359,120,512,93600,67758
99,86,13,-,75000,67761
106,53,53,641,154200,67762
144,117,27,807,81300,67764
10412,6565,3847,979,129000,67801
444,302,142,738,70000,67831
380,285,95,748,95800,67834
920,639,281,812,179100,67835
33,31,2,-,62500,67836
392,317,75,550,245700,67837
333,228,105,717,112500,67838
489,425,64,477,144400,67839
42,39,3,-,72900,67840
166,146,20,-,137500,67841
178,131,47,766,165800,67842
66,0,66,908,-,67843
289,184,105,912,128100,67844
12138,7575,4563,994,188200,67846
112,100,12,700,83600,67849
235,148,87,557,74100,67850
920,798,122,1011,223400,67851
282,238,44,1000,140500,67853
462,361,101,923,87700,67854
721,571,150,701,64900,67855
46,8,38,-,84000,67857
260,212,48,915,143100,67859
943,752,191,1150,177900,67860
806,632,174,743,96900,67861
97,90,7,-,-,67862
123,90,33,-,136400,67863
740,547,193,742,106800,67864
355,299,56,955,112500,67865
559,478,81,798,171900,67867
85,66,19,-,-,67868
489,362,127,808,139400,67869
535,362,173,756,115900,67870
2184,1169,1015,840,170000,67871
608,499,109,813,172300,67876
820,713,107,850,185000,67877
731,597,134,773,124400,67878
522,409,113,915,107800,67879
2429,1780,649,704,145600,67880
75,73,2,-,220500,67882
6828,4100,2728,926,130600,67901
600,452,148,637,99800,67950
1602,1148,454,938,122900,67951
161,125,36,857,157100,67952
59,56,3,-,59000,67953
310,256,54,706,77700,67954
29,21,8,-,67000,68001
959,768,191,1030,274100,68002
2088,1631,457,904,281700,68003
463,355,108,838,115300,68004
8974,5152,3822,1033,193600,68005
6022,5543,479,1581,369900,68007
5136,4229,907,933,254900,68008
12,0,12,1094,-,68010
133,102,31,771,125000,68014
453,406,47,1073,177300,68015
162,155,7,-,375000,68016
840,761,79,980,205700,68017
198,180,18,588,190000,68018
206,185,21,1083,135200,68019
310,244,66,525,86400,68020
11928,8726,3202,1404,452800,68022
1091,859,232,1019,347700,68023
12535,8130,4405,1005,201900,68025
5546,4710,836,1434,370500,68028
372,264,108,-,147000,68029
271,223,48,829,183600,68030
581,449,132,853,186000,68031
144,128,16,1075,187500,68033
247,205,42,1198,217700,68034
232,203,29,1115,145800,68036
961,805,156,1079,254000,68037
591,450,141,720,114800,68038
235,70,165,694,-,68039
167,166,1,-,265400,68040
420,369,51,883,223500,68041
37,22,15,-,183300,68042
259,226,33,985,78000,68044
798,584,214,693,171300,68045
12417,9324,3093,1252,331800,68046
688,555,133,867,183700,68047
5309,4328,981,959,256200,68048
230,206,24,825,150000,68050
109,80,29,850,51100,68055
0,0,0,-,-,68056
563,446,117,887,145200,68057
167,156,11,925,473300,68058
1321,1137,184,1198,351900,68059
925,711,214,683,123500,68061
135,120,15,625,158300,68062
112,84,28,1167,97500,68063
1779,1306,473,945,476400,68064
556,521,35,735,281300,68065
2112,1523,589,908,246100,68066
315,188,127,718,55100,68067
76,74,2,-,184700,68068
1326,1150,176,1142,351700,68069
340,318,22,1042,227800,68070
526,223,303,662,84200,68071
66,66,0,-,187700,68072
891,763,128,1487,240400,68073
4951,739,4212,1242,350500,68102
15383,8920,6463,1049,157700,68104
9728,4079,5649,1010,187600,68105
10454,5732,4722,1234,202900,68106
9872,6252,3620,1015,142900,68107
5609,2874,2735,1128,124500,68108
3175,1598,1577,920,113800,68110
8697,3402,5295,1109,101800,68111
4446,3204,1242,1123,139000,68112
240,10,230,1425,-,68113
8292,3929,4363,1220,273100,68114
12664,9904,2760,1440,319900,68116
3037,2357,680,1328,157500,68117
3578,2894,684,1820,364500,68118
4400,3663,737,1241,231200,68122
12459,7246,5213,1395,273100,68123
6741,4193,2548,1223,277200,68124
9962,4600,5362,1040,230500,68127
8000,4630,3370,1255,275600,68128
8304,6495,1809,1532,384700,68130
6807,1655,5152,1081,224500,68131
6408,3729,2679,979,324600,68132
5108,4048,1060,1360,357400,68133
12931,7258,5673,1044,204000,68134
10521,9344,1177,1757,323300,68135
7452,6621,831,1671,339300,68136
10499,6801,3698,1337,232800,68137
4831,3456,1375,1149,222700,68138
1925,1879,46,1667,315700,68142
10795,7226,3569,1138,248900,68144
4561,3700,861,1296,202400,68147
2911,2252,659,1092,300900,68152
10339,6104,4235,1185,297800,68154
2045,1465,580,1400,223100,68157
11899,7763,4136,1278,241200,68164
112,0,112,980,-,68178
0,0,0,-,-,68182
0,0,0,-,-,68183
548,463,85,833,320200,68301
94,88,6,525,66400,68303
167,129,38,-,307100,68304
1771,1104,667,755,127100,68305
174,162,12,900,170600,68307
47,41,6,-,29600,68309
6275,4228,2047,755,162500,68310
304,274,30,1670,181000,68313
211,199,12,875,181300,68314
26,22,4,-,-,68315
195,159,36,714,121000,68316
778,721,57,1277,274800,68317
173,132,41,1118,56000,68318
213,149,64,956,146700,68319
141,111,30,544,94200,68320
186,166,20,-,293800,68321
173,146,27,669,134100,68322
91,69,22,-,137500,68323
42,39,3,-,-,68324
55,42,13,670,54200,68325
114,93,21,-,116300,68326
172,143,29,871,105400,68327
178,140,38,933,128300,68328
230,170,60,600,126900,68329
29,20,9,-,85000,68330
398,366,32,950,247700,68331
36,33,3,-,258300,68332
3092,2207,885,857,218400,68333
212,160,52,678,87400,68335
251,204,47,-,350000,68336
168,148,20,940,77500,68337
85,81,4,1000,110600,68338
433,376,57,1078,409800,68339
381,294,87,485,105000,68340
357,314,43,608,153800,68341
223,175,48,-,126000,68342
422,339,83,588,159100,68343
183,169,14,1047,167900,68344
102,85,17,907,88300,68345
206,172,34,781,115600,68346
908,883,25,733,221400,68347
143,127,16,280,-,68348
521,441,80,805,222000,68349
110,93,17,-,77300,68350
344,283,61,935,124000,68351
2103,1404,699,662,122600,68352
379,302,77,583,103100,68354
2222,1591,631,718,97700,68355
143,133,10,-,168800,68357
505,437,68,1036,415100,68358
620,498,122,812,179900,68359
202,184,18,-,231700,68360
964,733,231,704,161900,68361
13,9,4,-,55000,68362
114,110,4,-,159200,68364
150,143,7,-,121900,68365
298,261,37,1152,206800,68366
156,121,35,533,75200,68367
146,127,19,983,277900,68368
847,566,281,749,116200,68370
504,444,60,-,155000,68371
1351,1245,106,1309,336300,68372
57,48,9,-,39400,68375
517,355,162,497,93000,68376
168,144,24,-,85000,68377
282,264,18,625,169000,68378
29,24,5,-,55000,68379
28,27,1,-,46500,68380
55,37,18,-,81300,68381
34,25,9,-,57200,68382
421,355,66,903,176100,68401
467,396,71,927,430800,68402
103,91,12,950,205400,68403
429,408,21,-,293800,68404
1289,864,425,929,245800,68405
221,198,23,688,121700,68406
334,290,44,1031,309100,68407
280,238,42,1125,222700,68409
3431,2639,792,911,167100,68410
192,182,10,1375,292900,68413
90,68,22,883,71400,68414
234,209,25,665,138500,68415
111,83,28,313,108800,68416
113,86,27,1297,-,68417
500,454,46,1275,198500,68418
96,85,11,1250,196000,68419
515,419,96,608,59000,68420
298,233,65,504,97500,68421
292,233,59,1103,294600,68422
343,291,52,775,300700,68423
326,270,56,788,144300,68424
494,419,75,891,398400,68428
30,24,6,675,102800,68429
602,577,25,861,443000,68430
121,106,15,-,112500,68431
96,72,24,-,101900,68433
3253,2113,1140,998,259900,68434
216,190,26,857,159400,68436
125,108,17,850,61400,68437
57,48,9,1563,189300,68438
269,246,23,637,127000,68439
62,46,16,410,-,68440
72,59,13,-,-,68441
118,100,18,-,145000,68442
431,343,88,779,181500,68443
14,11,3,-,275000,68444
67,49,18,-,83500,68445
1268,995,273,675,228400,68446
224,179,45,592,142500,68447
99,82,17,1264,106300,68448
939,555,384,800,118000,68450
46,40,6,-,150000,68452
114,96,18,-,113500,68453
282,227,55,1054,179000,68454
353,260,93,1638,308500,68455
511,387,124,910,190900,68456
220,199,21,782,87900,68457
94,86,8,825,119600,68458
289,280,9,-,215400,68460
276,246,30,-,486100,68461
1707,1465,242,1065,295800,68462
604,464,140,886,207700,68463
214,195,19,675,181300,68464
899,658,241,845,180300,68465
680,521,159,636,78400,68466
3763,2625,1138,888,180800,68467
11155,5902,5253,812,220500,68502
6387,2437,3950,974,158900,68503
8278,2385,5893,1014,169000,68504
7708,4346,3362,1095,216600,68505
12466,7948,4518,1147,245200,68506
6890,4632,2258,884,215000,68507
6388,524,5864,760,121400,68508
9355,5471,3884,857,221200,68510
5858,3814,2044,1242,295900,68512
123,102,21,-,387900,68514
18998,13270,5728,1213,331600,68516
170,170,0,-,495700,68517
1107,846,261,1584,456400,68520
15049,8464,6585,1196,235600,68521
4523,3300,1223,1204,225400,68522
685,659,26,-,502000,68523
1999,1197,802,971,214500,68524
2954,2253,701,1288,424900,68526
828,808,20,-,482600,68527
2738,1624,1114,1227,243700,68528
61,54,7,-,460900,68531
218,218,0,-,553700,68532
0,0,0,-,-,68588
12025,8485,3540,872,204700,68601
1191,877,314,713,214000,68620
92,76,16,-,187100,68621
164,122,42,525,160700,68622
175,137,38,539,-,68623
407,375,32,735,150800,68624
227,203,24,700,183600,68626
269,244,25,757,105300,68627
350,310,40,871,155200,68628
489,421,68,533,103500,68629
146,121,25,625,213100,68631
1584,1123,461,735,177400,68632
459,365,94,720,198600,68633
202,195,7,850,144700,68634
238,175,63,789,204800,68635
567,450,117,682,104900,68636
118,102,16,490,96400,68637
734,561,173,782,134100,68638
410,345,65,850,127600,68640
435,369,66,583,121100,68641
653,575,78,671,255400,68642
403,355,48,871,140000,68643
314,219,95,759,232000,68644
259,239,20,892,205800,68647
155,115,40,-,218800,68648
690,546,144,791,197700,68649
499,378,121,611,183200,68651
300,261,39,863,123100,68652
216,192,24,1000,185000,68653
231,197,34,-,95600,68654
47,43,4,-,116100,68655
249,231,18,567,176000,68658
95,85,10,-,232100,68659
413,338,75,743,131000,68660
2327,1620,707,932,133500,68661
420,361,59,930,161200,68662
370,325,45,816,200400,68663
127,107,20,857,90500,68664
300,275,25,629,108700,68665
588,468,120,883,182800,68666
50,50,0,-,300000,68667
195,175,20,1375,123300,68669
12795,8501,4294,855,200400,68701
336,256,80,621,143500,68710
67,20,47,-,-,68711
904,684,220,728,174600,68713
506,368,138,608,122200,68714
637,557,80,1038,197200,68715
406,259,147,708,106000,68716
113,69,44,678,111600,68717
726,547,179,775,114000,68718
75,74,1,-,182400,68719
105,76,29,738,130600,68720
194,164,30,608,70000,68722
248,230,18,875,187500,68723
64,53,11,820,109400,68724
266,225,41,760,125700,68725
285,168,117,849,109800,68726
309,193,116,583,95000,68727
69,66,3,-,160000,68728
695,522,173,744,131100,68729
802,699,103,718,182600,68730
1017,862,155,890,196000,68731
72,70,2,-,137500,68732
483,352,131,682,125700,68733
50,31,19,-,228800,68734
353,278,75,706,109500,68735
225,208,17,1021,231300,68736
1085,885,200,650,201400,68739
338,294,44,1358,283900,68740
273,228,45,794,209100,68741
72,62,10,692,-,68742
263,220,43,1346,200000,68743
671,506,165,713,188500,68745
169,155,14,573,65700,68746
59,50,9,540,-,68747
913,720,193,836,140400,68748
27,21,6,-,42500,68749
25,21,4,-,51700,68751
256,223,33,1163,124300,68752
29,24,5,-,212500,68753
138,119,19,-,106800,68755
809,597,212,831,150200,68756
316,273,43,605,114900,68757
463,346,117,688,112800,68758
102,93,9,-,-,68759
436,283,153,550,89800,68760
184,159,25,933,53000,68761
1869,1277,592,720,151200,68763
278,240,38,850,108900,68764
435,375,60,688,168800,68765
131,105,26,712,113000,68766
1325,1054,271,869,214600,68767
285,187,98,672,186700,68768
708,500,208,825,112800,68769
646,461,185,684,205600,68770
575,431,144,747,167400,68771
100,77,23,-,-,68773
130,115,15,-,208200,68774
5279,3070,2209,1069,161100,68776
263,191,72,708,119900,68777
246,204,42,807,108900,68778
889,638,251,774,197800,68779
368,284,84,780,188500,68780
591,480,111,626,153400,68781
338,270,68,567,105700,68783
616,424,192,719,123000,68784
102,101,1,-,202300,68785
366,320,46,763,104900,68786
2533,1525,1008,705,206900,68787
1860,1321,539,827,217400,68788
42,42,0,-,-,68789
402,313,89,844,189100,68790
882,633,249,814,166500,68791
181,169,12,-,124000,68792
11252,6709,4543,931,186600,68801
10831,6929,3902,888,224100,68803
364,269,95,955,127500,68810
244,197,47,673,207300,68812
232,173,59,629,261400,68813
393,295,98,931,98500,68814
289,220,69,575,179500,68815
63,47,16,-,173100,68816
187,140,47,821,91500,68817
2028,1618,410,719,243800,68818
122,99,23,550,110800,68820
50,42,8,-,181600,68821
1924,1237,687,833,151400,68822
891,650,241,527,147600,68823
633,469,164,809,194700,68824
413,303,110,589,189400,68825
1554,1122,432,727,169600,68826
265,218,47,875,-,68827
130,100,30,-,115900,68828
324,226,98,865,171600,68831
823,689,134,945,257200,68832
85,56,29,825,85000,68833
92,76,16,714,107700,68834
218,155,63,771,120100,68835
670,494,176,838,215500,68836
35,30,5,-,250000,68837
110,88,22,580,275000,68838
1043,755,288,883,188100,68840
248,217,31,813,218800,68841
232,173,59,725,74600,68842
333,278,55,888,225000,68843
90,85,5,-,258700,68844
8494,4894,3600,896,274200,68845
124,106,18,756,86800,68846
7295,5016,2279,951,229200,68847
0,0,0,-,-,68849
4072,2343,1729,911,156700,68850
238,187,51,656,147500,68852
580,418,162,875,127100,68853
265,241,24,842,272800,68854
156,133,23,778,212500,68855
248,208,40,1000,194600,68856
125,103,22,850,179200,68858
193,155,38,550,77200,68859
138,119,19,-,58600,68860
51,42,9,-,126400,68861
1317,917,400,623,125200,68862
506,340,166,580,120700,68863
439,380,59,963,134800,68864
440,390,50,788,281900,68865
411,345,66,725,238200,68866
951,648,303,882,156700,68869
173,153,20,1125,217000,68870
121,111,10,-,118100,68871
383,329,54,1417,220600,68872
1333,950,383,739,208900,68873
335,261,74,563,95500,68874
244,196,48,575,96700,68875
673,548,125,1014,155600,68876
185,125,60,895,104200,68878
146,107,39,783,105500,68879
12,12,0,-,-,68881
196,158,38,725,60000,68882
878,740,138,900,186200,68883
10985,7155,3830,858,181800,68901
578,481,97,845,166900,68920
505,386,119,-,104000,68922
49,47,2,-,118800,68923
563,482,81,1138,240400,68924
153,136,17,825,172700,68925
283,187,96,655,65900,68926
454,378,76,658,178500,68927
147,143,4,950,97500,68928
66,58,8,-,112500,68929
564,424,140,744,194700,68930
144,122,22,825,72200,68932
345,289,56,620,154700,68933
49,47,2,-,-,68934
307,213,94,571,95000,68935
106,83,23,725,37600,68936
772,651,121,756,275300,68937
227,177,50,645,183400,68938
526,428,98,500,101000,68939
158,135,23,795,195800,68940
346,285,61,908,221200,68941
195,187,8,-,72500,68942
85,74,11,725,-,68943
520,409,111,737,123900,68944
75,43,32,825,312500,68945
23,23,0,-,23800,68946
281,226,55,645,134400,68947
173,137,36,1556,85200,68948
2947,1956,991,715,171600,68949
137,125,12,500,108200,68950
52,52,0,-,106300,68952
22,15,7,-,430000,68954
798,722,76,758,255200,68955
422,366,56,748,184100,68956
235,222,13,569,116100,68957
212,160,52,767,191700,68958
1631,1263,368,769,211000,68959
87,67,20,-,39800,68960
328,275,53,492,78900,68961
22,22,0,-,-,68964
192,163,29,506,75000,68966
407,303,104,930,114200,68967
555,426,129,548,72400,68970
163,151,12,-,168100,68971
80,48,32,-,-,68972
181,153,28,750,164700,68973
125,123,2,-,85000,68974
28,28,0,-,115900,68975
80,53,27,942,115600,68976
108,93,15,625,71700,68977
1065,814,251,665,77200,68978
694,583,111,843,156300,68979
148,121,27,1325,189400,68980
88,69,19,-,89300,68981
257,163,94,672,142400,68982
3820,2700,1120,778,147300,69001
230,186,44,924,88900,69020
594,465,129,585,123800,69021
695,597,98,746,123100,69022
94,70,24,-,271700,69023
467,342,125,835,103700,69024
409,245,164,488,159900,69025
80,75,5,-,154200,69026
13,13,0,-,-,69027
308,249,59,783,138700,69028
140,93,47,450,85800,69029
91,65,26,842,94200,69030
203,140,63,-,118100,69032
1050,819,231,950,204400,69033
308,271,37,639,110200,69034
26,21,5,-,55000,69036
29,29,0,-,-,69037
164,119,45,713,99600,69038
39,27,12,-,212500,69039
237,206,31,725,85400,69040
63,45,18,-,100700,69041
7,7,0,-,-,69042
232,203,29,638,76500,69043
266,202,64,633,86700,69044
354,241,113,450,99400,69045
117,108,9,-,214400,69046
12052,7420,4632,878,183100,69101
440,312,128,765,134900,69120
143,108,35,850,194400,69121
297,240,57,844,100000,69122
360,311,49,950,172600,69123
150,110,40,825,81600,69125
363,264,99,827,185400,69127
156,89,67,1076,90600,69128
558,472,86,748,99300,69129
2208,1501,707,836,143900,69130
357,303,54,775,105900,69131
41,26,15,-,160000,69132
175,139,36,781,124600,69133
131,109,22,575,139400,69134
9,9,0,-,-,69135
1720,1217,503,834,179600,69138
732,560,172,900,162300,69140
202,189,13,638,107400,69141
44,26,18,-,475000,69142
661,561,100,768,185700,69143
74,40,34,-,285300,69144
1210,887,323,832,111200,69145
165,144,21,-,189400,69146
301,235,66,717,107300,69147
44,12,32,-,-,69148
328,267,61,713,113000,69149
129,117,12,850,177000,69150
298,246,52,842,212300,69151
350,204,146,583,86000,69152
2870,2008,862,738,149600,69153
540,434,106,689,97900,69154
416,285,131,850,148300,69155
281,226,55,1117,115600,69156
37,25,12,-,58300,69157
39,25,14,-,-,69161
3286,1996,1290,914,140400,69162
335,272,63,758,122000,69163
737,531,206,824,204000,69165
307,195,112,850,107000,69166
155,107,48,653,110600,69167
95,77,18,1250,83800,69168
237,140,97,532,111100,69169
116,88,28,888,154500,69170
0,0,0,-,-,69171
1621,995,626,859,141200,69201
939,681,258,913,103300,69210
124,75,49,615,122900,69211
162,74,88,-,-,69212
88,54,34,-,180800,69214
83,45,38,-,-,69216
191,165,26,742,54200,69217
174,122,52,-,107700,69218
30,29,1,-,-,69219
41,9,32,-,243800,69220
29,13,16,-,-,69221
4047,3023,1024,769,165200,69301
4,4,0,-,-,69331
95,68,27,1636,-,69333
907,795,112,589,124900,69334
14,14,0,-,58000,69335
854,634,220,746,105200,69336
2608,1589,1019,1038,160800,69337
651,511,140,743,86600,69339
50,21,29,-,114100,69340
4289,3129,1160,815,169600,69341
1013,693,320,754,99900,69343
171,118,53,1075,136100,69345
196,141,55,967,95000,69346
560,454,106,770,118400,69347
534,406,128,907,116000,69348
168,109,59,720,112500,69350
79,54,25,-,102400,69351
320,254,66,797,96400,69352
33,30,3,-,68600,69353
70,43,27,-,173800,69354
66,54,12,738,70000,69355
914,794,120,-,180400,69356
1470,1070,400,1055,179200,69357
889,647,242,761,139300,69358
469,295,174,758,88400,69360
7252,4371,2881,949,154400,69361
11,11,0,-,-,69365
113,81,32,1071,195300,69366
65,57,8,450,-,69367
17695,9026,8669,1145,313300,70001
8773,4456,4317,1128,379400,70002
16429,12602,3827,1191,255300,70003
11462,7456,4006,1160,381000,70005
6017,3695,2322,1206,333000,70006
1359,1258,101,1765,205700,70030
536,466,70,1151,213300,70031
1858,1325,533,998,212400,70032
287,276,11,-,187500,70036
5987,4108,1879,1650,350000,70037
29,29,0,-,-,70038
803,569,234,1232,243100,70039
463,432,31,-,111600,70040
934,829,105,928,74300,70041
7914,4734,3180,1091,203800,70043
4848,3718,1130,1143,294200,70047
611,603,8,-,173000,70049
0,0,0,-,-,70050
638,569,69,-,141000,70051
980,795,185,1293,211400,70052
7042,3228,3814,1017,225700,70053
14847,8551,6296,1163,223000,70056
1337,1207,130,676,217500,70057
14751,9310,5441,1217,195100,70058
6251,3394,2857,1150,197500,70062
19979,12671,7308,1123,255800,70065
912,743,169,1326,205400,70067
11822,9393,2429,1117,191400,70068
5190,4549,641,1570,268400,70070
1168,1049,119,-,193600,70071
21088,15888,5200,1091,190700,70072
1788,1564,224,-,225800,70075
44,44,0,-,-,70076
1231,927,304,1089,232300,70079
348,284,64,-,187200,70080
95,68,27,-,38200,70082
753,663,90,-,89100,70083
2033,1583,450,1158,162400,70084
1697,1316,381,1100,150300,70085
608,446,162,646,106000,70086
2373,1838,535,835,211200,70087
2858,2304,554,673,190200,70090
82,71,11,-,-,70091
2403,2002,401,1147,166600,70092
12475,7990,4485,1172,154600,70094
2395,233,2162,1063,398400,70112
3994,940,3054,960,258500,70113
9358,4100,5258,1113,194100,70114
13817,7583,6234,1442,616600,70115
5622,2441,3181,1190,385100,70116
11882,5643,6239,1191,247600,70117
12674,6390,6284,1257,451600,70118
17429,6680,10749,1298,359300,70119
5450,3237,2213,1113,237200,70121
15040,8826,6214,1196,274700,70122
13174,7494,5680,1310,318000,70123
7977,6085,1892,1752,577800,70124
6489,2962,3527,1292,428600,70125
10549,5297,5252,1118,187300,70126
9646,4809,4837,1060,191200,70127
7703,4986,2717,1210,220200,70128
3075,2155,920,890,170800,70129
7144,2648,4496,1410,529300,70130
10223,6598,3625,1057,236200,70131
0,0,0,-,-,70139
43,0,43,925,-,70148
0,0,0,-,-,70163
19385,14470,4915,1008,217500,70301
0,0,0,-,-,70310
1993,1850,143,706,162600,70339
62,62,0,-,-,70340
1495,1245,250,-,105200,70341
1689,1297,392,492,190600,70342
1918,1683,235,1328,196800,70343
2002,1624,378,855,115500,70344
3460,2759,701,732,165600,70345
3643,2381,1262,854,186800,70346
145,74,71,-,-,70352
275,228,47,827,89200,70353
1549,1136,413,797,102000,70354
379,334,45,-,106900,70355
640,482,158,623,117900,70356
938,726,212,771,141400,70357
354,268,86,1118,266100,70358
3503,3141,362,1119,161300,70359
11206,7875,3331,1085,297100,70360
9357,6730,2627,1054,143800,70363
11039,7990,3049,1004,195600,70364
905,800,105,1263,143800,70372
2361,1951,410,739,178900,70373
2411,1903,508,984,190000,70374
51,51,0,-,244000,70375
1188,1000,188,694,119000,70377
8070,5749,2321,876,138300,70380
2837,2183,654,823,152000,70390
49,0,49,-,-,70391
2980,2029,951,760,141600,70392
84,84,0,-,209600,70393
5523,4476,1047,825,183700,70394
1711,1266,445,895,201200,70395
271,271,0,-,161100,70397
8454,3922,4532,977,226800,70401
0,0,0,-,-,70402
12006,8541,3465,992,207600,70403
2899,2449,450,1141,278300,70420
5052,3385,1667,844,169900,70422
1977,1341,636,621,124500,70426
6875,4240,2635,777,124000,70427
2013,1864,149,1327,241600,70431
17186,11832,5354,1373,316200,70433
8209,7398,811,1231,271600,70435
135,49,86,-,-,70436
3216,2920,296,563,303700,70437
8047,6159,1888,921,157000,70438
2169,1559,610,-,99100,70441
93,93,0,-,196000,70442
2780,2153,627,953,145700,70443
3610,2849,761,805,173300,70444
3706,3186,520,1089,220400,70445
2382,2210,172,-,205100,70446
5764,5451,313,2182,390600,70447
9744,7780,1964,1415,324100,70448
1325,1223,102,1037,250100,70449
1210,951,259,737,-,70450
73,0,73,-,-,70451
4905,4143,762,858,219900,70452
468,417,51,-,94800,70453
12614,10441,2173,1124,219500,70454
1101,1034,67,-,189600,70455
869,737,132,873,115500,70456
0,0,0,-,-,70457
15697,11394,4303,1400,227200,70458
8221,6399,1822,1208,184400,70460
11988,9387,2601,1201,267100,70461
2113,1926,187,1393,238000,70462
39,26,13,-,-,70463
96,11,85,-,-,70464
173,103,70,732,-,70465
3245,2224,1021,820,174300,70466
9460,7031,2429,1282,370100,70471
10686,4517,6169,867,117200,70501
11918,8068,3850,1087,326800,70503
18721,9663,9058,1024,215700,70506
7316,5239,2077,937,206700,70507
16749,10616,6133,1244,299200,70508
9757,6685,3072,789,150400,70510
3992,3236,756,539,135200,70512
12,0,12,-,-,70513
790,397,393,935,127500,70514
1131,900,231,830,126400,70515
445,397,48,1036,121200,70516
9875,7650,2225,938,151600,70517
6167,5080,1087,997,287300,70518
66,66,0,-,-,70519
7918,6390,1528,953,199600,70520
107,28,79,-,-,70522
183,101,82,1109,115100,70523
104,44,60,1269,92900,70524
5076,3432,1644,806,123000,70525
7184,4125,3059,603,152000,70526
974,728,246,814,118900,70528
5774,4304,1470,795,189600,70529
574,530,44,593,226500,70531
1088,877,211,474,102000,70532
2653,2076,577,828,151200,70533
223,157,66,725,92300,70534
6792,4299,2493,789,161200,70535
132,132,0,-,127000,70537
5046,3655,1391,860,109100,70538
429,143,286,679,86600,70541
1259,1066,193,668,113200,70542
1477,1155,322,674,168700,70543
3876,3234,642,758,110000,70544
6038,4204,1834,887,152400,70546
3606,2631,975,786,119200,70548
1292,1033,259,670,106000,70549
38,38,0,-,-,70550
296,280,16,-,113700,70551
438,269,169,859,144900,70552
2277,1325,952,528,93000,70554
3037,2567,470,1241,228500,70555
316,257,59,490,55900,70556
24,0,24,-,-,70558
894,669,225,485,87400,70559
14279,8148,6131,886,126500,70560
7944,6406,1538,975,190700,70563
14788,10491,4297,764,151300,70570
18,18,0,-,-,70575
360,217,143,724,153700,70576
1510,1044,466,693,98100,70577
5877,4387,1490,845,153800,70578
134,48,86,-,-,70580
354,263,91,-,200800,70581
7822,6157,1665,787,149100,70582
3987,2837,1150,877,130400,70583
2329,1819,510,1037,184000,70584
89,68,21,-,-,70585
7161,4657,2504,705,131800,70586
1224,919,305,653,105600,70589
1986,1725,261,817,152300,70591
10785,9279,1506,1106,239000,70592
12732,7690,5042,938,164300,70601
15699,11346,4353,1348,293800,70605
10256,6499,3757,1053,171700,70607
0,0,0,-,-,70609
7796,6551,1245,1241,249400,70611
4296,2617,1679,1095,128500,70615
0,0,0,-,-,70629
690,690,0,-,188800,70630
154,154,0,-,134400,70631
79,71,8,-,221400,70632
2633,2231,402,753,195300,70633
9779,7658,2121,902,165500,70634
399,352,47,-,219100,70637
261,179,82,797,-,70638
205,197,8,-,102800,70639
129,90,39,569,99100,70640
104,87,17,-,-,70643
214,197,17,-,56900,70644
289,269,20,-,225000,70645
104,104,0,-,189600,70646
4049,3474,575,1134,251400,70647
2387,1766,621,837,142600,70648
114,54,60,-,-,70650
160,160,0,-,61300,70651
746,650,96,837,189500,70652
1359,1132,227,562,112100,70653
60,60,0,-,-,70654
991,727,264,430,79000,70655
1462,1323,139,1269,65400,70656
1713,1637,76,-,177700,70657
232,215,17,678,109100,70658
552,371,181,741,200700,70659
472,454,18,-,324700,70660
628,518,110,-,84400,70661
218,218,0,-,150000,70662
10634,8466,2168,914,174300,70663
4711,3807,904,1212,229800,70665
2101,1492,609,957,141800,70668
3646,2953,693,1026,160800,70669
7635,6990,645,979,237900,70706
2784,2082,702,1451,242300,70710
1950,1557,393,860,221700,70711
142,33,109,-,-,70712
6112,4666,1446,1026,158800,70714
274,251,23,618,116600,70715
1476,1195,281,990,235700,70719
132,122,10,-,216100,70721
2171,1780,391,907,229700,70722
378,329,49,1179,-,70723
515,466,49,-,-,70725
22211,16491,5720,1180,215100,70726
368,356,12,-,402000,70729
1358,1212,146,729,212900,70730
443,369,74,677,193500,70732
588,512,76,1250,220000,70733
2988,2378,610,978,306200,70734
165,113,52,-,97300,70736
19116,15229,3887,1533,252600,70737
4962,4758,204,1403,295700,70739
369,333,36,-,126400,70740
249,230,19,-,189100,70743
1802,1633,169,892,130800,70744
224,131,93,-,-,70747
1522,1128,394,728,228000,70748
700,479,221,771,246600,70749
488,393,95,-,113200,70750
243,243,0,-,197700,70752
281,249,32,-,67800,70753
4316,3456,860,1113,181200,70754
595,484,111,641,197000,70755
270,216,54,-,112500,70756
1095,793,302,762,132500,70757
495,380,115,917,122500,70759
2608,1796,812,807,137200,70760
304,285,19,1098,136800,70761
268,255,13,-,284900,70762
1721,1621,100,759,264900,70763
6002,4831,1171,848,174700,70764
5785,4269,1516,934,197100,70767
16440,14705,1735,1245,295200,70769
1211,1176,35,-,173500,70770
418,400,18,-,116000,70772
14,14,0,-,-,70773
3454,3048,406,1073,243600,70774
3634,2952,682,1011,269200,70775
1598,1051,547,871,279800,70776
1527,1307,220,975,225000,70777
1061,992,69,1260,247700,70778
399,322,77,-,-,70780
55,45,10,-,286100,70782
1154,1027,127,-,313100,70783
7941,6653,1288,1059,235100,70785
0,0,0,-,-,70786
80,51,29,-,-,70787
1474,836,638,695,146300,70788
311,246,65,375,112900,70789
11224,9443,1781,1389,269800,70791
214,0,214,1679,-,70801
9816,3062,6754,935,105100,70802
0,0,0,-,-,70803
9167,3707,5460,833,103100,70805
12260,5263,6997,1014,321400,70806
5499,2438,3061,917,113800,70807
16055,8537,7518,1283,392600,70808
11762,6353,5409,1336,305900,70809
16236,11420,4816,1406,353100,70810
4605,2825,1780,876,161900,70811
3552,2609,943,1180,124300,70812
0,0,0,-,-,70813
4490,2867,1623,1064,181600,70814
10933,6855,4078,984,213100,70815
18285,9096,9189,1155,232300,70816
13627,10923,2704,1363,288400,70817
3928,2967,961,1353,255800,70818
1573,1404,169,1228,167900,70819
8919,2741,6178,1057,293900,70820
0,0,0,-,-,70825
321,9,312,1416,-,70836
1867,1215,652,715,95500,71001
75,49,26,-,131300,71002
323,205,118,883,91300,71003
169,132,37,1078,203600,71004
5592,4827,765,1096,304300,71006
641,582,59,-,182500,71007
176,84,92,715,-,71008
36,36,0,-,326700,71009
659,543,116,390,88400,71016
497,383,114,623,58000,71018
2879,2243,636,717,107700,71019
237,148,89,435,70800,71021
1191,1056,135,725,83500,71023
455,390,65,-,132400,71024
465,327,138,1063,185800,71027
623,425,198,550,92100,71028
70,63,7,-,131300,71029
547,427,120,522,183500,71030
320,281,39,1344,77200,71031
948,792,156,-,178200,71032
1650,1399,251,576,212300,71033
109,67,42,1063,82700,71034
7744,6723,1021,1304,205200,71037
1579,1097,482,424,85400,71038
752,580,172,942,112000,71039
2375,1655,720,680,76900,71040
189,169,20,-,84600,71043
330,287,43,725,101000,71044
270,183,87,389,85600,71045
294,260,34,780,76700,71046
4054,3600,454,1019,141000,71047
80,66,14,-,55200,71048
1345,997,348,498,78100,71049
1097,779,318,-,-,71051
3393,2050,1343,694,92500,71052
7270,4647,2623,811,117800,71055
1064,861,203,950,131200,71060
784,428,356,525,114400,71061
291,264,27,-,73200,71063
1444,1192,252,512,80400,71064
414,301,113,579,55700,71065
3,3,0,-,-,71066
968,670,298,766,97700,71067
1370,1047,323,329,86400,71068
271,180,91,714,-,71069
485,433,52,613,103100,71070
1001,767,234,440,103900,71071
563,488,75,-,68800,71072
928,711,217,672,137500,71073
2323,1171,1152,779,109600,71075
2911,2543,368,912,259500,71078
109,101,8,-,84800,71079
1701,1283,418,715,59800,71082
3306,1038,2268,714,86500,71101
2342,1012,1330,827,74200,71103
5552,2674,2878,1071,163300,71104
9471,5256,4215,1247,216000,71105
12707,8446,4261,890,310300,71106
11622,7510,4112,909,157000,71107
7265,2843,4422,1075,81300,71108
7357,3284,4073,896,91800,71109
945,0,945,1588,-,71110
17444,10212,7232,1065,268600,71111
12727,8183,4544,1181,183600,71112
6726,4400,2326,1110,239100,71115
9111,5532,3579,1009,168600,71118
4678,3539,1139,1103,184800,71119
5492,3201,2291,918,182000,71129
9429,5124,4305,882,247100,71201
8852,3884,4968,827,77400,71202
14899,8065,6834,987,181200,71203
0,0,0,-,-,71209
0,0,0,-,-,71212
0,0,0,-,-,71218
419,317,102,-,94400,71219
7857,5079,2778,819,100400,71220
1131,849,282,645,102700,71222
190,84,106,656,61900,71223
3060,2612,448,965,215800,71225
734,520,214,721,76200,71226
1487,1115,372,935,209900,71227
637,550,87,509,152400,71229
0,0,0,-,-,71230
2192,1521,671,907,118800,71232
63,35,28,729,-,71233
1655,1440,215,1090,148200,71234
1850,1261,589,855,155900,71235
403,238,165,913,101200,71237
1089,897,192,856,148200,71238
3057,2270,787,739,130200,71241
18,8,10,-,-,71242
67,63,4,-,172300,71243
1356,463,893,540,145800,71245
483,253,230,650,76000,71247
28,28,0,-,110900,71250
2793,1800,993,712,97800,71251
178,146,32,-,-,71253
2154,1160,994,767,75600,71254
281,246,35,610,49600,71256
787,639,148,781,126300,71259
1284,1034,250,543,80900,71260
685,459,226,582,104500,71261
2740,2086,654,662,94000,71263
391,299,92,-,156300,71264
573,402,171,823,116700,71266
997,856,141,922,143900,71268
4291,2763,1528,774,136700,71269
12778,6339,6439,819,218600,71270
0,0,0,-,-,71272
1266,948,318,965,93700,71275
108,108,0,-,-,71276
703,411,292,1614,84500,71277
26,0,26,-,-,71279
1981,1422,559,1043,260000,71280
2758,1487,1271,618,91200,71282
226,226,0,-,91700,71286
13767,8916,4851,974,219700,71291
8510,5907,2603,885,119700,71292
5197,3819,1378,746,111000,71295
6819,3387,3432,919,156700,71301
5079,2824,2255,868,103300,71302
9282,5276,4006,1115,232900,71303
18,18,0,-,-,71316
77,58,19,-,277300,71320
2317,1333,984,738,88500,71322
325,263,62,-,178600,71323
441,338,103,729,172200,71325
381,300,81,454,-,71326
1482,1037,445,731,105900,71327
3022,2723,299,912,166700,71328
25,25,0,-,-,71330
354,346,8,-,101200,71331
211,181,30,325,-,71333
3000,1962,1038,666,80200,71334
592,464,128,617,137900,71336
0,0,0,-,-,71339
397,303,94,579,104000,71340
1049,719,330,1035,122600,71341
2894,2337,557,533,154000,71342
2435,1919,516,849,85700,71343
35,0,35,-,-,71345
1110,873,237,712,174000,71346
1774,1220,554,690,149500,71350
4400,2814,1586,774,155800,71351
642,554,88,-,121700,71353
423,386,37,-,103400,71354
937,669,268,674,139800,71355
198,198,0,-,76100,71356
668,445,223,540,57500,71357
411,271,140,851,114400,71358
0,0,0,-,-,71359
13767,9199,4568,924,196300,71360
806,603,203,500,112300,71362
633,451,182,725,103300,71366
785,583,202,669,119400,71367
539,386,153,619,90000,71368
892,668,224,566,88100,71369
518,509,9,-,171600,71371
2441,1673,768,924,119800,71373
328,238,90,478,62300,71375
849,528,321,719,124200,71378
20,20,0,-,-,71401
1445,1233,212,1420,119700,71403
365,295,70,-,-,71404
1952,1661,291,1146,176900,71405
33,12,21,-,-,71406
485,394,91,-,-,71407
2089,1458,631,907,176800,71409
27,27,0,-,-,71410
1211,783,428,600,114000,71411
53,34,19,961,51700,71414
133,90,43,782,-,71415
309,184,125,622,86100,71416
1800,1384,416,785,106600,71417
2032,1350,682,696,89700,71418
695,632,63,767,109100,71419
687,548,139,839,111500,71422
1824,1624,200,944,123700,71423
516,480,36,-,124300,71424
10,10,0,-,-,71425
40,33,7,-,71000,71426
55,46,9,-,129000,71427
0,0,0,-,-,71428
1326,1107,219,877,117000,71429
934,612,322,1085,174700,71430
338,285,53,910,57300,71432
1536,1226,310,731,150500,71433
31,31,0,-,134800,71434
1476,1062,414,899,137300,71435
385,333,52,-,157500,71438
527,417,110,761,119900,71439
277,253,24,-,22900,71441
8630,5461,3169,892,157000,71446
397,359,38,638,87500,71447
3347,2687,660,652,190000,71449
364,341,23,-,-,71450
29,28,1,-,-,71452
1135,987,148,825,75600,71454
65,14,51,-,-,71455
480,408,72,338,260600,71456
9726,5554,4172,801,194200,71457
3247,15,3232,1140,-,71459
1025,475,550,767,123200,71461
592,485,107,731,74900,71462
2792,2031,761,733,111800,71463
1103,883,220,489,104100,71465
183,183,0,-,145900,71466
1964,1619,345,704,195300,71467
243,225,18,-,211000,71468
966,732,234,1051,91900,71469
1,1,0,-,-,71472
164,147,17,-,64700,71473
150,142,8,-,150000,71474
0,0,0,-,-,71475
194,128,66,664,101600,71479
188,164,24,1042,104000,71480
3183,2076,1107,607,119600,71483
1040,772,268,841,291300,71485
1820,1439,381,565,111000,71486
193,7,186,-,-,71497
4884,2620,2264,802,67800,71601
5993,3743,2250,900,135800,71602
11487,7499,3988,859,116000,71603
208,161,47,619,89600,71630
196,162,34,-,54100,71631
4127,2794,1333,647,93500,71635
1107,706,401,645,70800,71638
2368,1415,953,712,97700,71639
1079,772,307,558,57200,71640
244,232,12,-,175800,71642
507,389,118,387,58000,71643
229,176,53,658,128900,71644
2408,1836,572,638,91700,71646
534,387,147,488,76900,71647
15,15,0,-,-,71651
319,257,62,804,56100,71652
1814,1242,572,944,148500,71653
1737,942,795,704,95500,71654
5710,3461,2249,703,132500,71655
181,151,30,-,52800,71658
16,16,0,-,-,71659
386,281,105,-,145100,71660
30,28,2,-,60000,71661
12,0,12,-,-,71662
214,184,30,620,64900,71663
1825,1398,427,614,127100,71665
8,8,0,-,-,71666
2636,2072,564,770,111300,71667
532,408,124,678,109700,71670
2962,1941,1021,658,111900,71671
239,226,13,689,46400,71674
843,627,216,779,136600,71675
214,176,38,-,42100,71676
70,58,12,-,38000,71677
12,12,0,-,-,71678
6608,4548,2060,728,106500,71701
806,603,203,728,95000,71720
0,0,0,-,-,71721
36,27,9,-,12300,71722
114,97,17,-,47500,71724
130,101,29,405,89200,71725
511,440,71,553,76300,71726
20,20,0,-,-,71728
11449,7919,3530,833,123200,71730
571,451,120,591,142000,71740
1687,1153,534,644,101600,71742
1350,924,426,693,122200,71743
1078,893,185,852,103900,71744
36,36,0,-,153100,71745
296,277,19,756,79000,71747
33,33,0,-,258800,71748
1149,972,177,759,120500,71749
252,223,29,775,106300,71751
324,243,81,513,57600,71752
5748,3600,2148,625,166900,71753
66,46,20,-,75200,71758
158,148,10,-,167200,71759
1159,833,326,845,100400,71762
568,433,135,538,79100,71763
547,454,93,416,63000,71764
1003,905,98,672,46900,71765
192,175,17,625,58900,71766
1412,1228,184,768,91600,71770
9,9,0,-,98800,71772
5484,3506,1978,775,98200,71801
24,24,0,-,162500,71820
3179,2482,697,837,120300,71822
35,34,1,-,98300,71823
128,109,19,813,134700,71825
379,286,93,525,71600,71826
320,265,55,-,49400,71827
51,51,0,-,-,71831
3667,2064,1603,715,106700,71832
880,749,131,612,105600,71833
590,584,6,-,56000,71834
459,417,42,575,111900,71835
1215,1073,142,588,101900,71836
1561,1292,269,1071,102300,71837
595,540,55,790,102100,71838
195,78,117,476,-,71839
272,245,27,971,53800,71841
724,581,143,911,159600,71842
673,517,156,744,73400,71845
1015,805,210,770,113800,71846
124,110,14,-,114700,71847
707,529,178,810,115200,71851
3840,2677,1163,703,157200,71852
131,96,35,800,46300,71853
13965,8703,5262,883,157400,71854
164,127,37,-,-,71855
2050,1072,978,853,92200,71857
793,654,139,647,38100,71858
109,98,11,-,187900,71859
869,637,232,716,72500,71860
898,747,151,955,114700,71861
313,227,86,849,-,71862
38,37,1,-,"10,000-",71864
90,64,26,967,84800,71865
151,93,58,-,128100,71866
12495,7775,4720,797,173400,71901
9343,8097,1246,1143,255600,71909
20876,13773,7103,970,179200,71913
1243,1034,209,795,96700,71921
68,33,35,714,43200,71922
5842,3320,2522,735,164800,71923
1836,1590,246,857,196100,71929
496,392,104,647,122900,71933
349,268,81,-,151000,71935
734,530,204,738,109600,71937
588,515,73,606,98700,71940
814,681,133,912,157600,71941
49,43,6,-,119300,71942
1556,1014,542,676,123700,71943
314,268,46,779,83700,71944
690,519,171,669,105800,71945
509,406,103,-,131300,71949
305,225,80,-,116300,71950
18,18,0,-,137500,71952
5652,4795,857,743,144200,71953
615,556,59,609,60000,71956
1385,1057,328,695,167700,71957
1007,789,218,540,107800,71958
276,231,45,-,120800,71959
461,337,124,931,121500,71960
514,405,109,718,95600,71961
321,317,4,-,109500,71962
2016,1849,167,1421,165900,71964
102,68,34,-,127900,71965
1639,1353,286,1049,174700,71968
118,102,16,-,-,71969
282,272,10,-,221000,71970
236,166,70,-,185100,71971
150,119,31,-,81500,71972
423,311,112,596,86300,71973
0,0,0,-,-,71998
0,0,0,-,-,71999
257,192,65,620,114200,72001
7631,6334,1297,1028,202900,72002
319,272,47,798,112500,72003
282,201,81,-,75200,72004
24,24,0,-,-,72005
979,647,332,619,112900,72006
3501,2837,664,1193,220000,72007
2111,1431,680,729,124100,72010
1680,1420,260,904,185800,72011
5204,3708,1496,789,169700,72012
762,520,242,-,137100,72013
16,14,2,-,71400,72014
11222,7858,3364,1013,169200,72015
1137,884,253,844,161400,72016
121,53,68,-,67000,72017
11523,8518,3005,985,248700,72019
1167,937,230,597,89400,72020
1552,1003,549,590,83800,72021
7236,4769,2467,987,221200,72022
13854,10203,3651,978,202400,72023
1564,1329,235,673,132300,72024
314,259,55,622,105400,72025
100,99,1,-,117200,72026
508,398,110,-,70600,72027
6,6,0,-,-,72028
648,420,228,493,72800,72029
205,111,94,-,150700,72030
2822,2056,766,714,120900,72031
13378,8208,5170,976,183200,72032
20944,9784,11160,993,250000,72034
0,0,0,-,-,72035
282,150,132,537,44800,72036
44,44,0,-,178800,72038
793,656,137,974,147200,72039
1026,658,368,607,74000,72040
520,405,115,606,63000,72041
1967,1433,534,719,120100,72042
486,423,63,-,225400,72044
434,392,42,1125,139300,72045
1694,1096,598,784,99000,72046
338,303,35,596,170000,72047
28,28,0,-,268200,72048
174,134,40,-,73200,72051
43,34,9,-,88300,72052
0,0,0,-,-,72053
245,196,49,738,96200,72055
495,484,11,-,97000,72057
6488,5213,1275,1027,203400,72058
11,11,0,-,-,72059
274,229,45,850,132600,72060
79,79,0,-,-,72061
621,563,58,-,108600,72063
1031,817,214,861,107600,72064
2064,1576,488,955,191600,72065
81,72,9,-,-,72066
1216,997,219,654,201200,72067
249,141,108,717,62500,72068
438,332,106,431,83300,72069
671,497,174,542,140300,72070
149,124,25,-,103700,72072
313,234,79,938,80500,72073
42,32,10,-,92300,72074
9,0,9,-,-,72075
15592,8393,7199,917,155600,72076
134,122,12,-,165200,72079
239,234,5,-,-,72080
2633,1877,756,754,141500,72081
741,292,449,683,91900,72082
119,56,63,905,-,72083
338,270,68,900,84200,72084
88,58,30,827,111100,72085
4563,3559,1004,945,151700,72086
704,667,37,921,161400,72087
1413,1231,182,888,157500,72088
0,0,0,-,-,72099
1335,899,436,577,99100,72101
1158,972,186,724,96300,72102
5618,4503,1115,912,140600,72103
8211,5911,2300,768,117300,72104
2201,1807,394,855,173200,72106
44,44,0,-,152600,72107
0,0,0,-,-,72108
4303,2636,1667,704,146400,72110
495,407,88,942,156300,72111
3854,2283,1571,663,97200,72112
11583,6501,5082,1084,275800,72113
5322,1500,3822,781,87900,72114
10031,6469,3562,1058,218700,72116
5753,3854,1899,1125,125400,72117
9680,5112,4568,978,115900,72118
0,0,0,-,-,72119
14157,10095,4062,1026,189400,72120
1097,860,237,752,169000,72121
523,418,105,-,202900,72122
119,83,36,583,47900,72123
336,268,68,696,94700,72125
1307,1012,295,589,130900,72126
1172,937,235,747,143600,72127
267,199,68,833,108000,72128
539,485,54,663,100900,72129
108,108,0,-,112300,72130
1745,1438,307,846,162800,72131
1273,1081,192,952,116400,72132
0,0,0,-,-,72133
202,133,69,-,208800,72134
1394,1286,108,-,248900,72135
768,613,155,941,153400,72136
826,642,184,822,166200,72137
111,47,64,310,77500,72139
104,83,21,905,116100,72140
221,146,75,-,95900,72141
922,883,39,758,187700,72142
13053,8351,4702,851,176900,72143
4800,3654,1146,781,176900,72150
166,95,71,-,-,72152
1510,1337,173,-,124000,72153
348,324,24,-,234100,72156
559,489,70,758,-,72157
3521,2089,1432,809,152400,72160
22,22,0,-,-,72165
81,77,4,-,-,72166
507,477,30,682,139600,72167
112,87,25,-,55600,72168
34,27,7,-,82800,72169
92,85,7,-,81900,72170
3730,3258,472,769,202400,72173
115,59,56,1049,70800,72175
3099,2152,947,995,165000,72176
19,19,0,-,73100,72178
146,115,31,-,90600,72179
19,19,0,-,-,72180
29,29,0,-,275000,72181
36,18,18,-,-,72182
0,0,0,-,-,72183
16,16,0,-,-,72199
464,141,323,1344,262300,72201
5662,1569,4093,1040,246900,72202
12423,6711,5712,1016,117600,72204
10473,5390,5083,1110,204400,72205
8197,5692,2505,910,132100,72206
5022,3635,1387,942,384800,72207
12180,5232,6948,982,99100,72209
6350,3888,2462,954,227800,72210
10841,5657,5184,1142,257800,72211
5344,4656,688,1089,341400,72212
11104,6702,4402,1242,435100,72223
4939,3137,1802,1035,260900,72227
9579,4345,5234,848,119100,72301
28,18,10,975,85000,72311
0,0,0,-,-,72313
7977,4847,3130,802,117700,72315
30,30,0,-,-,72320
32,24,8,-,68000,72322
837,511,326,874,85300,72324
1,1,0,-,-,72325
845,580,265,751,100800,72326
481,375,106,706,145100,72327
26,26,0,-,-,72328
0,0,0,-,-,72329
151,112,39,708,60000,72330
792,391,401,605,72500,72331
37,4,33,755,100000,72332
145,97,48,398,56100,72333
5360,2563,2797,814,92700,72335
2,0,2,-,-,72338
74,68,6,-,-,72339
21,21,0,-,85900,72340
94,45,49,-,47900,72341
1633,607,1026,655,99000,72342
192,167,25,-,55100,72346
324,198,126,768,59000,72347
987,683,304,563,128200,72348
430,275,155,596,85000,72350
329,210,119,772,129500,72351
7,7,0,-,-,72352
30,30,0,-,-,72353
910,609,301,599,81800,72354
771,516,255,922,85300,72355
377,242,135,767,45700,72358
103,75,28,-,56500,72359
1919,1054,865,632,75600,72360
6022,4084,1938,1025,206400,72364
997,586,411,552,76700,72365
655,421,234,691,66400,72366
0,0,0,-,-,72367
435,342,93,725,102600,72368
0,0,0,-,-,72369
2825,1229,1596,831,110100,72370
606,488,118,679,78100,72372
401,241,160,580,37800,72373
239,167,72,-,114900,72374
628,562,66,563,105800,72376
33,11,22,-,-,72377
25,25,0,-,-,72379
17,17,0,-,-,72383
221,137,84,-,103900,72384
543,398,145,627,77100,72386
0,0,0,-,-,72387
164,65,99,295,88800,72389
2596,1471,1125,778,66000,72390
23,23,0,-,-,72391
148,97,51,839,171300,72392
128,105,23,567,58300,72394
504,353,151,825,140700,72395
4913,3313,1600,797,131100,72396
17070,7966,9104,897,185400,72401
11732,7527,4205,938,236300,72404
6438,4609,1829,1009,240300,72405
186,122,64,583,62800,72410
1076,611,465,1013,101300,72411
173,166,7,-,118900,72412
215,162,53,819,58600,72413
130,92,38,529,94300,72414
417,336,81,760,91800,72415
2154,1660,494,891,157700,72416
2175,1435,740,989,168800,72417
561,417,144,550,76500,72419
225,128,97,871,76700,72421
1783,1289,494,707,87600,72422
45,33,12,-,53000,72424
165,164,1,-,101900,72425
83,62,21,516,161100,72426
20,15,5,-,68800,72427
45,14,31,-,85700,72428
116,92,24,500,58200,72429
215,167,48,-,-,72430
141,112,29,-,-,72431
2401,1691,710,811,112700,72432
1126,706,420,723,83800,72433
850,719,131,514,100700,72434
137,127,10,-,-,72435
352,308,44,630,124600,72436
1403,1026,377,827,141400,72437
957,642,315,583,128300,72438
86,75,11,963,90800,72440
21,21,0,-,73800,72441
1549,1029,520,825,139700,72442
1108,730,378,705,111900,72443
670,555,115,633,131600,72444
22,18,4,-,241700,72445
752,536,216,569,114800,72447
56,44,12,-,55600,72449
15631,9883,5748,865,169100,72450
110,110,0,-,117500,72453
1916,1221,695,760,95600,72454
5007,3522,1485,690,128800,72455
232,200,32,-,121400,72456
87,74,13,565,101500,72457
221,207,14,900,86200,72458
558,419,139,548,55900,72459
339,272,67,529,-,72460
1612,1182,430,624,98400,72461
161,69,92,659,76400,72462
5,2,3,-,-,72464
543,444,99,619,122600,72466
17,0,17,-,-,72467
486,379,107,756,138500,72469
138,113,25,625,67500,72470
436,271,165,531,69600,72471
3806,2202,1604,632,110900,72472
878,644,234,753,84100,72473
2848,1694,1154,734,92000,72476
68,57,11,-,93200,72478
398,313,85,803,84800,72479
587,508,79,911,68700,72482
9785,6167,3618,818,129900,72501
965,741,224,691,117500,72512
998,774,224,802,103900,72513
0,0,0,-,-,72515
34,34,0,-,-,72517
956,755,201,350,146400,72519
217,201,16,-,-,72520
1850,1250,600,767,120600,72521
86,62,24,-,27800,72522
339,330,9,-,111000,72523
146,84,62,-,314300,72524
52,45,7,-,127600,72526
335,292,43,613,118000,72527
196,146,50,-,185800,72528
2132,1813,319,930,86900,72529
721,604,117,-,173400,72530
288,264,24,-,140700,72531
445,405,40,624,107600,72532
131,93,38,925,186800,72533
664,650,14,-,57200,72534
196,181,15,-,102200,72536
320,269,51,856,118800,72537
274,274,0,-,270000,72538
93,93,0,-,60400,72539
34,7,27,-,110400,72540
1491,1267,224,519,90500,72542
5398,3963,1435,836,180300,72543
469,418,51,-,198500,72544
9,9,0,-,-,72546
259,255,4,-,107600,72550
33,18,15,-,-,72553
1045,918,127,329,125900,72554
115,91,24,-,203800,72555
1328,835,493,627,173600,72556
3234,2323,911,716,159400,72560
283,250,33,375,124500,72561
1007,651,356,578,102400,72562
198,177,21,-,99800,72564
379,275,104,638,83500,72565
170,157,13,-,58100,72566
88,70,18,620,65200,72567
611,440,171,832,115300,72568
242,242,0,-,113600,72569
179,179,0,-,-,72571
136,92,44,-,157700,72572
157,157,0,-,-,72573
1553,1091,462,611,108100,72576
341,204,137,567,131400,72577
59,59,0,-,-,72578
600,398,202,780,-,72579
424,393,31,-,118900,72581
572,516,56,632,129600,72583
112,112,0,-,73600,72584
123,123,0,-,78800,72585
5,5,0,-,-,72587
12446,8423,4023,719,176500,72601
634,528,106,790,106900,72611
10,10,0,-,-,72615
4002,2969,1033,804,167200,72616
96,93,3,-,-,72617
781,601,180,663,158800,72619
208,196,12,-,165000,72623
152,152,0,-,214100,72624
661,533,128,657,170800,72626
368,317,51,-,154900,72628
162,152,10,-,-,72629
40,29,11,1097,128400,72630
2001,1655,346,812,241800,72631
2063,1619,444,838,228600,72632
679,648,31,676,154300,72633
2087,1663,424,752,149900,72634
1446,997,449,878,135600,72635
2,2,0,-,-,72636
2348,1764,584,798,159400,72638
231,191,40,-,127200,72639
193,181,12,-,158800,72640
888,508,380,667,201400,72641
941,758,183,830,188600,72642
938,856,82,819,99800,72644
584,406,178,494,107300,72645
172,157,15,-,199700,72648
1748,1299,449,604,87200,72650
642,445,197,1062,184900,72651
13418,9839,3579,865,167100,72653
154,135,19,-,107000,72655
773,597,176,727,102900,72658
258,233,25,850,143200,72660
393,393,0,-,150900,72661
1146,781,365,580,204700,72662
154,154,0,-,176700,72663
82,69,13,-,114900,72666
205,205,0,-,-,72668
55,52,3,-,-,72669
58,36,22,-,-,72670
107,94,13,-,-,72672
487,391,96,650,157700,72675
293,207,86,683,157600,72677
60,24,36,-,-,72679
464,344,120,1095,135200,72680
128,108,20,-,93400,72682
161,49,112,-,152300,72683
563,452,111,802,185200,72685
49,49,0,-,-,72686
2795,2335,460,853,164300,72687
17853,7899,9954,973,323900,72701
16251,6377,9874,958,341700,72703
12898,8325,4573,1163,301600,72704
14485,8461,6024,1197,401300,72712
10086,5171,4915,1302,355000,72713
5430,4763,667,1337,254800,72714
7553,6672,881,1261,263700,72715
428,307,121,847,165600,72717
1709,1595,114,2099,407200,72718
6610,4138,2472,1432,283300,72719
349,345,4,-,164200,72721
1072,652,420,788,178200,72722
2490,2051,439,1063,191900,72727
69,69,0,-,367900,72729
3924,3081,843,1225,244900,72730
2094,1848,246,955,236600,72732
3089,2423,666,1079,198000,72734
2410,2009,401,1012,277500,72736
781,614,167,705,231600,72738
222,162,60,987,-,72739
3614,2897,717,614,165600,72740
248,248,0,-,-,72742
1994,1367,627,1093,168100,72744
4926,3471,1455,1119,255700,72745
10,10,0,-,-,72747
51,25,26,-,-,72749
3414,2727,687,1395,258200,72751
131,109,22,-,120600,72752
3832,2739,1093,911,227900,72753
15366,9717,5649,914,243000,72756
16662,9945,6717,1300,358200,72758
84,79,5,-,175400,72760
8390,5355,3035,936,218700,72761
16303,11509,4794,1118,278600,72762
19436,9073,10363,984,226100,72764
492,333,159,731,147400,72768
369,270,99,836,209200,72769
555,446,109,736,140400,72773
2582,2088,494,1118,205600,72774
252,164,88,-,-,72776
6579,3145,3434,837,153900,72801
8943,6994,1949,887,196100,72802
742,520,222,674,85000,72821
2330,1737,593,894,140900,72823
765,456,309,726,113100,72824
2,2,0,-,-,72826
63,21,42,-,"10,000-",72827
58,0,58,-,-,72828
0,0,0,-,-,72829
6052,3876,2176,736,150000,72830
281,170,111,490,83800,72832
1152,670,482,578,113300,72833
4053,2862,1191,836,148300,72834
335,327,8,-,148100,72835
3469,2883,586,847,124500,72837
92,92,0,-,108900,72838
181,129,52,-,53700,72839
849,652,197,660,92900,72840
90,54,36,-,126600,72841
356,280,76,745,110600,72842
798,709,89,958,114900,72843
401,378,23,683,100400,72845
1624,1364,260,663,135500,72846
1161,1030,131,833,128800,72847
258,252,6,-,187400,72851
64,55,9,-,118600,72852
1024,751,273,509,99500,72853
279,251,28,-,98900,72854
2565,1982,583,691,119300,72855
189,153,36,-,218900,72856
560,379,181,397,112500,72857
1099,952,147,884,176700,72858
107,73,34,-,109400,72860
639,569,70,675,145500,72863
449,386,63,-,151100,72865
8778,3926,4852,837,113200,72901
11253,6034,5219,804,216200,72903
7720,3809,3911,817,108200,72904
0,0,0,-,-,72905
5949,3943,2006,886,181600,72908
4403,3132,1271,1212,257100,72916
4694,3340,1354,963,185800,72921
2273,1672,601,893,125600,72923
283,214,69,888,167400,72926
3270,2246,1024,733,112000,72927
314,266,48,729,112200,72928
103,77,26,-,116600,72930
745,698,47,980,158900,72932
2259,1747,512,720,134900,72933
361,343,18,636,-,72934
208,157,51,543,161900,72935
5674,4490,1184,824,197600,72936
1475,1140,335,789,142300,72937
453,373,80,883,134000,72938
674,538,136,698,159400,72940
1809,1529,280,889,159600,72941
962,794,168,793,153900,72943
1041,809,232,798,113600,72944
216,121,95,947,103400,72945
1459,1337,122,917,128800,72946
1559,1265,294,667,151800,72947
179,179,0,-,212000,72948
3696,2652,1044,725,119300,72949
233,164,69,-,127800,72950
292,236,56,706,133800,72951
946,923,23,-,141600,72952
252,209,43,-,-,72955
12971,9006,3965,825,177100,72956
2575,1865,710,727,95600,72958
1293,1145,148,728,189300,72959
19,11,8,-,41700,73001
359,313,46,700,101800,73002
9270,5389,3881,1338,230000,73003
318,256,62,1080,160400,73004
2666,1624,1042,713,94700,73005
1023,789,234,673,100500,73006
1150,1052,98,938,541500,73007
7912,4201,3711,1072,163500,73008
328,265,63,689,123600,73009
7397,6180,1217,1070,241600,73010
206,197,9,-,78300,73011
15708,12715,2993,1779,295500,73012
21621,16641,4980,1465,292500,73013
420,337,83,969,173300,73014
907,643,264,638,95800,73015
755,651,104,1356,240800,73016
468,372,96,669,86800,73017
7986,4743,3243,877,126600,73018
0,0,0,-,-,73019
9315,8207,1108,1363,248700,73020
151,101,50,727,184200,73021
0,0,0,-,-,73022
230,197,33,900,96100,73024
5448,5350,98,2656,441000,73025
4116,3942,174,982,266000,73026
591,493,98,862,-,73027
1381,1041,340,859,145200,73028
497,390,107,729,129700,73029
1570,1047,523,828,154400,73030
18,11,7,-,-,73031
82,57,25,1057,95500,73032
133,94,39,758,79300,73033
17473,12948,4525,1203,368000,73034
7038,4235,2803,912,162900,73036
584,483,101,700,116200,73038
576,442,134,970,96700,73040
128,96,32,644,158300,73041
360,264,96,678,109900,73042
67,58,9,-,88800,73043
9058,7379,1679,890,200100,73044
4045,3333,712,962,212800,73045
1866,1256,610,893,160500,73047
880,685,195,780,156400,73048
2451,2063,388,854,236100,73049
86,23,63,502,-,73050
2781,2232,549,934,152900,73051
2357,1669,688,850,161200,73052
207,149,58,650,134600,73053
1790,1613,177,788,206900,73054
3883,3099,784,828,154300,73055
227,195,32,-,50500,73056
961,769,192,798,133600,73057
82,77,5,-,172500,73058
1124,787,337,558,161000,73059
643,509,134,1082,230300,73061
480,401,79,472,93700,73062
358,331,27,-,179000,73063
9728,7874,1854,1280,236700,73064
4269,3491,778,990,240400,73065
78,46,32,-,-,73066
677,596,81,793,123100,73067
4649,3524,1125,958,188800,73068
11631,5321,6310,1031,212400,73069
0,0,0,-,-,73070
17765,8334,9431,1059,206600,73071
19399,10633,8766,1102,291400,73072
340,317,23,575,306200,73073
416,312,104,867,117900,73074
3628,2219,1409,840,125900,73075
2403,1845,558,761,129000,73077
4601,4241,360,1657,288800,73078
215,177,38,925,168800,73079
3731,2570,1161,881,206700,73080
1053,788,265,733,115700,73082
2595,1817,778,873,115600,73084
3082,2296,786,885,153500,73086
4827,4307,520,912,264200,73089
222,184,38,1056,192500,73090
283,197,86,731,127000,73092
1407,1156,251,2011,279600,73093
722,569,153,927,154400,73095
5488,2896,2592,764,243100,73096
45,45,0,-,-,73097
1292,884,408,842,153500,73098
31223,23122,8101,1255,229400,73099
1351,99,1252,1253,212500,73102
3111,1063,2048,954,400400,73103
2206,338,1868,1536,341300,73104
3018,1050,1968,1091,162800,73105
5190,1847,3343,1050,262500,73106
11118,6345,4773,1014,143000,73107
5596,2092,3504,799,75000,73108
7324,3352,3972,851,89300,73109
14348,6344,8004,1007,119900,73110
4743,2554,2189,941,109500,73111
14886,7853,7033,1030,173100,73112
8146,3058,5088,1135,134100,73114
8457,4735,3722,1024,111000,73115
4535,3218,1317,1136,285200,73116
2844,1139,1705,951,116300,73117
6829,3986,2843,1064,252500,73118
10554,5011,5543,923,93600,73119
17856,9407,8449,1045,227600,73120
1232,973,259,944,274700,73121
5328,2965,2363,923,158500,73122
9594,4239,5355,926,139200,73127
2724,1587,1137,1369,192200,73128
6609,3241,3368,914,76400,73129
8555,6384,2171,1143,195100,73130
1464,1400,64,2060,299500,73131
11607,6127,5480,1058,200500,73132
3915,685,3230,1211,242300,73134
8906,4954,3952,1212,164200,73135
7741,3454,4287,946,164100,73139
1054,776,278,859,129100,73141
7401,4178,3223,1211,344600,73142
670,13,657,1593,-,73145
1977,954,1023,1023,125700,73149
2035,1671,364,859,287500,73150
646,646,0,-,648100,73151
12730,6743,5987,1119,144200,73159
23883,15682,8201,1245,189000,73160
11641,8822,2819,1147,234800,73162
2673,2529,144,1099,319600,73165
1004,770,234,1231,255600,73169
16127,13428,2699,1525,249800,73170
1400,1326,74,-,355000,73173
2975,2418,557,1699,235400,73179
14240,9094,5146,960,174700,73401
56,48,8,-,338500,73425
546,487,59,1094,153300,73430
390,280,110,740,114200,73432
993,797,196,874,133400,73433
189,160,29,484,155600,73434
18,11,7,-,110400,73435
44,25,19,725,76300,73436
16,16,0,-,-,73437
1337,1053,284,845,70900,73438
2792,2365,427,855,146200,73439
88,85,3,-,171600,73440
54,49,5,525,106300,73441
128,110,18,692,134400,73442
1183,856,327,949,181300,73443
62,62,0,-,125000,73444
2894,2144,750,804,123000,73446
427,335,92,923,95700,73447
2107,1456,651,837,165000,73448
1363,1048,315,811,137800,73449
541,465,76,1159,124200,73450
242,206,36,784,257500,73453
219,163,56,785,68600,73455
669,562,107,510,102300,73456
309,233,76,1054,174000,73458
603,355,248,1055,202600,73459
1592,923,669,685,142400,73460
264,190,74,788,98800,73461
1481,1248,233,783,107800,73463
341,321,20,592,70400,73481
61,45,16,742,72800,73487
8,7,1,-,-,73488
312,241,71,940,110000,73491
7315,3262,4053,831,119400,73501
1746,0,1746,1271,-,73503
19090,9945,9145,915,147200,73505
8599,4885,3714,916,155400,73507
43,33,10,575,78800,73520
8190,4810,3380,896,150900,73521
0,0,0,-,-,73523
693,526,167,703,194400,73526
1948,1567,381,821,187200,73527
207,159,48,738,154900,73528
1748,1393,355,758,110700,73529
153,119,34,575,69200,73530
131,112,19,683,162500,73531
159,116,43,1011,110000,73532
11116,7910,3206,877,137300,73533
181,163,18,482,50500,73537
2301,1874,427,1143,268900,73538
81,72,9,-,98900,73539
126,107,19,521,196500,73540
1506,1247,259,1016,163300,73541
1558,1131,427,728,72100,73542
785,635,150,1115,105600,73543
71,63,8,-,66200,73544
505,336,169,741,56500,73546
498,391,107,681,119200,73547
197,191,6,-,79200,73548
130,119,11,-,228900,73549
837,598,239,662,75800,73550
8,8,0,-,76000,73551
535,495,40,944,125400,73552
6,5,1,-,-,73553
1333,1034,299,606,97300,73554
70,59,11,-,42700,73555
44,35,9,850,107800,73556
120,104,16,1556,322400,73557
171,102,69,485,47300,73559
315,166,149,578,97800,73560
196,163,33,775,150700,73562
143,130,13,633,84100,73564
357,263,94,542,61700,73565
605,418,187,640,116600,73566
307,226,81,775,116900,73567
418,350,68,703,61700,73568
178,117,61,435,59500,73569
329,267,62,600,77300,73570
30,11,19,-,-,73571
1158,907,251,716,123100,73572
948,620,328,631,78800,73573
3776,2908,868,863,118000,73601
508,346,162,-,161100,73620
120,96,24,958,81300,73622
700,318,382,817,105600,73624
158,128,30,681,99400,73625
374,307,67,960,150700,73626
192,162,30,817,119600,73627
677,512,165,825,152500,73628
1137,886,251,748,109200,73632
58,58,0,-,208300,73638
258,188,70,1050,107700,73639
194,148,46,579,43300,73641
54,46,8,-,62000,73642
6039,4007,2032,844,167300,73644
391,263,128,768,84400,73645
109,101,8,-,132700,73646
253,210,43,595,173800,73647
359,300,59,590,116700,73650
1550,1045,505,817,85900,73651
333,285,48,757,121900,73654
366,283,83,494,76600,73655
118,96,22,1042,90000,73658
58,44,14,-,-,73659
147,111,36,625,126300,73660
186,170,16,1125,119000,73661
1622,1112,510,772,113300,73662
386,309,77,1056,162500,73663
504,399,105,700,109200,73664
157,101,56,-,162500,73666
179,131,48,765,112500,73667
10,9,1,-,-,73668
531,427,104,696,147300,73669
216,151,65,-,-,73673
8997,4912,4085,788,99500,73701
12074,8151,3923,1039,191000,73703
0,0,0,-,-,73705
249,227,22,-,114100,73716
2649,1516,1133,808,142500,73717
205,193,12,-,147900,73718
45,33,12,-,214500,73719
102,102,0,-,-,73720
146,110,36,805,168800,73722
308,240,68,750,98600,73724
165,117,48,645,52600,73726
34,34,0,-,-,73727
745,559,186,788,124700,73728
253,224,29,696,102500,73729
285,253,32,943,203800,73730
70,52,18,-,85000,73731
64,49,15,-,103100,73733
327,251,76,860,164800,73734
307,286,21,1011,-,73735
250,224,26,-,272700,73736
1538,1149,389,615,138900,73737
349,289,60,1063,136300,73738
201,184,17,725,110400,73739
173,134,39,568,88000,73741
1398,1031,367,913,179400,73742
35,22,13,-,-,73743
91,69,22,681,111300,73744
12,6,6,-,-,73746
115,66,49,595,-,73747
205,169,36,486,82000,73749
2648,1782,866,911,219600,73750
194,175,19,1338,142100,73753
395,302,93,886,153500,73754
336,312,24,-,140600,73755
136,109,27,800,156700,73756
48,48,0,-,-,73757
120,115,5,-,67700,73758
513,364,149,819,65500,73759
156,134,22,546,139700,73760
154,117,37,-,126600,73761
709,592,117,783,244700,73762
667,372,295,861,123000,73763
104,86,18,688,187500,73764
387,294,93,983,116000,73766
579,499,80,817,126000,73768
9,9,0,-,-,73770
135,102,33,625,-,73771
1156,769,387,821,138100,73772
701,510,191,1099,131300,73773
6190,4248,1942,842,178700,73801
466,409,57,586,123300,73832
585,513,72,751,94300,73834
121,91,30,692,130400,73835
247,232,15,475,176600,73838
178,135,43,645,108100,73840
220,148,72,728,115500,73841
220,194,26,983,208300,73842
346,286,60,848,116400,73843
118,112,6,-,87500,73844
654,479,175,803,122800,73848
46,37,9,-,-,73851
954,769,185,1016,167400,73852
164,136,28,-,200000,73853
74,52,22,-,175000,73855
436,389,47,1025,206300,73857
512,417,95,711,141700,73858
548,375,173,936,121100,73859
508,428,80,752,134500,73860
38,34,4,-,43100,73901
234,181,53,784,87200,73931
652,475,177,783,128800,73932
445,310,135,698,73700,73933
69,60,9,-,107500,73937
199,176,23,1052,87600,73938
381,245,136,809,125800,73939
4622,3041,1581,975,172400,73942
133,104,29,533,48000,73944
856,643,213,941,136800,73945
6,2,4,-,-,73946
172,159,13,550,98100,73947
466,371,95,485,156700,73949
391,337,54,925,137500,73950
351,309,42,833,57600,73951
4,4,0,-,-,73960
107,103,4,-,68300,74001
652,506,146,712,111800,74002
5471,3290,2181,873,107400,74003
10838,8181,2657,960,184800,74006
11725,8850,2875,1302,303200,74008
4008,2712,1296,690,172600,74010
12473,9846,2627,1303,244900,74011
24777,16598,8179,1211,223100,74012
14836,13036,1800,1433,240200,74014
3312,2268,1044,1052,211300,74015
2198,1544,654,779,114700,74016
10966,7455,3511,1015,184400,74017
7783,6537,1246,963,225700,74019
2889,2202,687,886,137600,74020
8049,6735,1314,1197,224700,74021
783,706,77,575,116200,74022
4671,2870,1801,759,134700,74023
292,214,78,873,92400,74026
342,254,88,697,126600,74027
641,515,126,800,171800,74028
2023,1417,606,925,139200,74029
1355,971,384,523,90100,74030
738,590,148,773,132100,74032
4761,3385,1376,1292,194400,74033
48,41,7,-,-,74034
1264,918,346,677,99700,74035
2560,2178,382,938,200000,74036
8227,6378,1849,1565,267400,74037
807,684,123,950,154500,74038
1467,1112,355,917,152400,74039
972,792,180,1100,209900,74041
143,107,36,763,-,74042
3017,2444,573,926,176000,74044
116,94,22,-,214300,74045
36,22,14,-,-,74046
2501,2117,384,744,206200,74047
2200,1521,679,753,119300,74048
131,85,46,735,51000,74050
700,582,118,894,151700,74051
414,268,146,758,75200,74052
1900,1518,382,951,213700,74053
305,243,62,450,72500,74054
18686,13280,5406,1218,261400,74055
2011,1404,607,571,126800,74056
1402,1015,387,781,111800,74058
2432,1760,672,888,195500,74059
125,93,32,650,93900,74060
812,712,100,979,225400,74061
337,252,85,654,146600,74062
11945,9533,2412,989,187500,74063
12518,9255,3263,1000,168300,74066
23,23,0,-,-,74068
5682,4275,1407,951,208400,74070
89,29,60,682,98800,74071
657,546,111,891,142000,74072
1948,1659,289,1004,241400,74073
12785,6239,6546,965,247300,74074
10818,4372,6446,933,220900,74075
0,0,0,-,-,74077
0,0,0,-,-,74078
1770,1353,417,732,162300,74079
1002,825,177,907,261600,74080
657,593,64,-,116200,74081
118,26,92,1092,85000,74082
359,309,50,1125,179900,74083
197,162,35,790,45000,74084
982,750,232,819,172600,74085
581,5,576,1395,-,74103
5412,2604,2808,1109,224500,74104
13080,7094,5986,989,318500,74105
6875,3197,3678,816,98900,74106
7750,4150,3600,938,124100,74107
2867,1959,908,1077,122700,74108
5104,2651,2453,909,67700,74110
9383,5230,4153,1024,149800,74112
7350,5844,1506,1296,270900,74114
8355,4586,3769,987,74900,74115
1390,635,755,783,137500,74116
11,11,0,-,-,74117
2416,617,1799,1161,207500,74119
2818,944,1874,1071,415300,74120
3691,2174,1517,1043,61000,74126
6525,3779,2746,955,120600,74127
4501,2753,1748,1031,109100,74128
7150,3544,3606,929,141900,74129
780,563,217,1103,82800,74130
928,764,164,1048,188500,74131
4349,2406,1943,1134,271400,74132
21200,10805,10395,1129,254700,74133
8354,5316,3038,979,216900,74134
9524,4901,4623,900,230700,74135
14764,5234,9530,926,292200,74136
11592,7911,3681,1133,384500,74137
7405,4160,3245,1039,160700,74145
5726,2013,3713,831,134300,74146
0,0,0,-,-,74171
4000,2818,1182,830,127700,74301
1027,860,167,910,177500,74330
3340,2640,700,884,180200,74331
688,576,112,983,166200,74332
395,349,46,850,152300,74333
1787,1427,360,774,161000,74337
1898,1392,506,749,117400,74338
835,541,294,681,72000,74339
78,60,18,733,165000,74340
835,694,141,758,127700,74342
1336,958,378,783,136400,74343
6597,4811,1786,902,207200,74344
2845,2002,843,792,124700,74346
1057,939,118,825,93600,74347
365,281,84,856,250500,74349
303,223,80,750,121400,74350
2307,1680,627,644,132700,74352
6542,4106,2436,802,120200,74354
89,73,16,1100,57300,74358
70,51,19,625,68300,74359
9,9,0,-,-,74360
6678,4576,2102,930,187900,74361
1020,785,235,739,112700,74363
602,539,63,983,152300,74364
1609,1276,333,672,135600,74365
559,478,81,832,105600,74366
223,218,5,-,72200,74367
25,13,12,-,-,74368
661,491,170,675,137000,74369
1446,1122,324,589,134100,74370
6711,3694,3017,827,122300,74401
11338,7295,4043,841,145400,74403
1545,1295,250,934,171400,74421
391,353,38,1152,102500,74422
333,267,66,833,96300,74423
415,335,80,719,122900,74425
3699,2851,848,710,118800,74426
610,553,57,797,118800,74427
305,259,46,900,102100,74428
5942,4597,1345,968,215000,74429
270,239,31,691,116500,74430
328,259,69,788,85200,74431
4026,3144,882,817,175000,74432
3685,2974,711,787,181200,74434
1160,897,263,812,134100,74435
1938,1609,329,860,151800,74436
3694,2578,1116,767,91800,74437
158,128,30,683,97500,74438
2085,1751,334,862,151900,74441
272,247,25,1018,177600,74442
1104,771,333,866,184200,74445
169,136,33,975,73300,74446
6042,3689,2353,801,101900,74447
677,601,76,857,116400,74450
1812,1453,359,956,151500,74451
144,112,32,-,213300,74452
1228,943,285,630,194500,74454
1122,943,179,713,110200,74455
36,31,5,-,102100,74456
140,118,22,-,169400,74457
36,31,5,-,79400,74458
29,28,1,-,70000,74459
195,176,19,575,-,74460
2905,2202,703,787,149200,74462
47,26,21,817,-,74463
11846,6619,5227,793,169700,74464
5624,3887,1737,852,149500,74467
101,92,9,850,80000,74468
703,438,265,686,110300,74469
655,491,164,-,156000,74470
559,468,91,680,119800,74471
247,199,48,850,110100,74472
8,0,8,-,-,74477
11361,7743,3618,907,156500,74501
20,16,4,800,46300,74521
90,88,2,-,206000,74522
2308,1699,609,624,111600,74523
3372,2412,960,692,153000,74525
49,45,4,-,-,74528
81,67,14,-,57200,74530
317,238,79,695,89200,74531
329,274,55,819,120400,74533
60,43,17,-,86300,74534
43,43,0,-,91500,74535
644,451,193,429,114400,74536
1510,988,522,670,93800,74538
62,51,11,-,109400,74540
196,150,46,-,155200,74543
240,148,92,738,87700,74546
1202,868,334,662,110800,74547
40,31,9,-,139800,74549
373,296,77,595,135900,74552
535,421,114,700,131600,74553
844,480,364,832,96400,74554
207,171,36,773,137500,74555
124,101,23,750,140600,74556
238,222,16,758,119200,74557
152,120,32,517,101900,74558
170,142,28,811,112500,74560
754,598,156,628,85800,74561
258,207,51,533,135900,74562
774,629,145,778,109400,74563
158,120,38,475,137500,74565
33,29,4,-,71000,74567
199,176,23,756,93600,74569
454,396,58,638,155000,74570
1395,949,446,498,104100,74571
279,239,40,875,83900,74572
465,404,61,-,123500,74574
99,92,7,-,268800,74576
127,96,31,577,38300,74577
2270,1529,741,748,94200,74578
7059,4182,2877,860,94700,74601
4857,3856,1001,770,198100,74604
227,186,41,642,102300,74630
2639,1722,917,868,77100,74631
212,188,24,-,-,74632
149,126,23,783,105000,74633
74,51,23,917,123800,74636
612,508,104,609,57600,74637
101,94,7,-,90000,74640
259,240,19,833,131800,74641
173,126,47,923,65000,74643
186,159,27,583,83100,74644
91,91,0,-,-,74646
1208,921,287,675,109800,74647
199,172,27,475,58800,74650
341,277,64,529,258700,74651
391,340,51,730,76700,74652
1422,1031,391,753,86200,74653
10117,5650,4467,916,188100,74701
139,108,31,931,79200,74720
0,0,0,-,-,74721
60,38,22,483,225000,74722
518,427,91,789,101300,74723
44,37,7,-,110200,74724
795,626,169,871,150000,74726
888,572,316,660,97200,74727
3985,2929,1056,709,150200,74728
1037,816,221,900,138400,74729
2198,1406,792,948,168500,74730
632,492,140,1008,139900,74731
1161,808,353,898,122900,74733
349,289,60,608,131900,74734
661,499,162,873,153700,74735
309,247,62,633,139500,74736
12,12,0,-,-,74737
161,138,23,538,76700,74738
760,559,201,603,85800,74740
366,288,78,-,152100,74741
3447,2022,1425,651,123700,74743
3647,2278,1369,723,130600,74745
117,107,10,-,87800,74747
222,187,35,612,73900,74748
60,50,10,875,59100,74750
0,0,0,-,-,74753
171,141,30,-,-,74754
50,41,9,-,101000,74755
288,245,43,833,124500,74756
473,404,69,668,120500,74759
41,21,20,658,-,74760
14,11,3,-,107500,74761
1201,969,232,743,123300,74764
384,307,77,730,95600,74766
8329,5070,3259,868,122900,74801
7977,5531,2446,946,198500,74804
12398,7849,4549,882,177600,74820
455,378,77,879,162100,74824
725,558,167,905,106600,74825
516,416,100,775,136200,74826
119,92,27,713,195800,74827
234,201,33,563,93000,74829
76,63,13,800,38400,74830
254,198,56,781,120500,74831
322,256,66,859,101000,74832
189,148,41,727,119600,74833
2979,2395,584,798,180200,74834
103,102,1,-,210400,74836
66,58,8,850,74800,74837
208,157,51,713,70700,74839
687,582,105,914,155200,74840
91,82,9,-,141700,74842
81,73,8,-,288200,74843
99,67,32,833,78600,74844
133,115,18,-,-,74845
2133,1486,647,623,102100,74848
1168,807,361,708,95000,74849
96,83,13,733,119600,74850
3600,2988,612,624,159600,74851
606,483,123,780,134100,74852
649,514,135,536,84400,74854
1575,1140,435,896,151200,74855
261,224,37,875,121900,74856
3915,3596,319,1238,174600,74857
2303,1485,818,686,116200,74859
582,500,82,783,120200,74860
1808,1424,384,819,165600,74864
700,596,104,1016,125000,74865
27,24,3,-,66700,74866
229,181,48,642,72100,74867
4580,3123,1457,732,102600,74868
272,233,39,675,88400,74869
1000,843,157,685,166100,74871
1230,867,363,660,168000,74872
3993,2792,1201,823,130100,74873
343,287,56,548,183000,74875
704,636,68,729,156300,74878
736,578,158,626,78300,74880
2051,1722,329,716,127100,74881
812,581,231,555,84900,74883
2010,1342,668,820,85900,74884
719,431,288,677,67300,74901
1796,1243,553,747,134200,74902
683,554,129,681,108700,74930
421,348,73,775,116400,74931
898,734,164,805,165700,74932
63,48,15,850,106300,74935
480,353,127,774,136000,74936
1832,1339,493,812,89500,74937
196,164,32,713,90000,74939
790,598,192,690,119400,74940
855,651,204,663,95800,74941
56,39,17,463,66900,74942
33,28,5,-,94300,74943
437,368,69,596,75900,74944
56,51,5,925,77500,74945
14,9,5,850,106300,74946
38,25,13,717,-,74947
4606,3504,1102,747,120200,74948
141,118,23,-,96300,74949
629,395,234,816,124800,74951
4254,2884,1370,796,174400,74953
1778,1117,661,850,142900,74954
5565,3707,1858,854,124800,74955
751,547,204,824,124800,74956
387,333,54,607,113000,74957
2338,1657,681,809,99700,74959
4175,2799,1376,656,112300,74960
1705,1312,393,690,133400,74962
217,188,29,-,91700,74963
802,655,147,856,113500,74964
1791,1112,679,608,107300,74965
1263,1016,247,834,128100,74966
9869,1628,8241,1717,455800,75001
23334,18226,5108,1967,403800,75002
18731,9742,8989,1528,296500,75006
20479,13815,6664,1656,360100,75007
9377,8719,658,2134,471300,75009
12733,6322,6411,1797,434700,75010
17334,11162,6172,1810,561000,75013
16999,10816,6183,1817,525700,75019
9681,5709,3972,1136,187200,75020
3434,2870,564,900,188600,75021
9207,7807,1400,2183,617900,75022
18859,11876,6983,1897,385800,75023
18778,7162,11616,1820,566200,75024
18703,12537,6166,1942,466700,75025
17821,14289,3532,2233,458100,75028
12950,10460,2490,1918,462000,75032
15828,11378,4450,2055,606500,75033
22216,8921,13295,1730,679500,75034
28083,21312,6771,2171,562300,75035
11653,10132,1521,2238,500000,75036
14161,2853,11308,1467,391900,75038
11800,1903,9897,1812,567500,75039
20524,14036,6488,1670,245400,75040
9781,5757,4024,1368,214600,75041
11359,6659,4700,1336,221300,75042
21955,13262,8693,1467,253300,75043
16966,10095,6871,1714,305700,75044
10352,8807,1545,1775,366000,75048
16538,7110,9428,1412,224400,75050
13237,6280,6957,1183,196700,75051
31641,20277,11364,1680,282100,75052
5145,4727,418,2204,445500,75054
26768,16283,10485,1808,414600,75056
6649,2570,4079,1589,208500,75057
1133,934,199,1398,467400,75058
14669,9553,5116,1367,224100,75060
18819,7602,11217,1292,228400,75061
17678,7799,9879,1419,254500,75062
17674,6916,10758,1687,509500,75063
4792,3557,1235,1659,302100,75065
27359,10788,16571,1506,321100,75067
22711,18275,4436,2161,386300,75068
15581,8314,7267,1530,413700,75069
23036,12083,10953,1799,429300,75070
22801,17086,5715,2105,448500,75071
18067,14316,3751,2317,472700,75072
18653,9806,8847,1678,347300,75074
15237,8975,6262,1653,390400,75075
3220,2511,709,1337,241700,75076
14342,11323,3019,1886,418800,75077
13644,12136,1508,2284,650600,75078
18725,10022,8703,1817,420000,75080
14021,7076,6945,1765,340600,75081
12698,6006,6692,1883,473600,75082
14297,11618,2679,1727,399500,75087
9910,7506,2404,1899,326200,75088
11375,8591,2784,2029,359300,75089
8721,5331,3390,1111,163500,75090
12059,6880,5179,1205,260100,75092
19651,11732,7919,1773,622600,75093
6649,5934,715,2680,495500,75094
20876,16403,4473,1979,362900,75098
247,128,119,1269,108300,75101
529,433,96,1110,115400,75102
6245,4977,1268,1069,228100,75103
16724,11604,5120,1886,274900,75104
50,29,21,-,-,75105
1857,1640,217,1233,216200,75109
10528,6311,4217,1043,169200,75110
2308,1957,351,1652,275100,75114
21008,14820,6188,1478,282900,75115
6559,3898,2661,1400,220100,75116
1650,1340,310,1074,187300,75117
10846,7709,3137,1230,238400,75119
1935,1649,286,932,195300,75124
2234,1796,438,1089,198000,75125
23433,19249,4184,1930,337200,75126
762,631,131,810,198500,75127
0,0,0,-,-,75132
6885,5470,1415,1762,216600,75134
3265,2839,426,1393,289700,75135
6793,4811,1982,1756,260800,75137
2955,2417,538,957,131300,75140
1398,691,707,1370,99300,75141
7070,5352,1718,1301,208900,75142
5447,4433,1014,1163,173200,75143
1365,1021,344,847,156400,75144
8935,5059,3876,1560,249000,75146
2865,1794,1071,899,238700,75147
2598,1974,624,838,159100,75148
20054,13388,6666,1408,207500,75149
22675,11852,10823,1387,221000,75150
1824,1585,239,1663,240900,75152
146,78,68,1660,156000,75153
16619,13903,2716,1446,296000,75154
1019,855,164,1015,113400,75155
6705,5046,1659,932,209100,75156
72,57,15,-,251100,75157
1785,1558,227,1149,290300,75158
6667,5669,998,1176,224600,75159
8439,5901,2538,1177,221900,75160
2444,2157,287,775,223100,75161
1108,907,201,950,192600,75163
206,195,11,-,229000,75164
17870,12016,5854,1473,308100,75165
2186,1933,253,1780,385000,75166
4236,3792,444,1934,369600,75167
5869,4713,1156,953,183100,75169
2033,1242,791,1349,104300,75172
2737,2554,183,1396,322000,75173
8373,5367,3006,1249,208100,75180
7947,6799,1148,1968,273700,75181
2654,2205,449,1216,540500,75182
14660,13056,1604,2133,336000,75189
12039,1201,10838,1971,649700,75201
1798,511,1287,1975,325100,75202
6091,2276,3815,1110,125000,75203
20712,4019,16693,1822,451900,75204
9410,5482,3928,2348,1518600,75205
22556,5997,16559,1715,557500,75206
2342,23,2319,1789,-,75207
12557,6994,5563,1589,415200,75208
6828,4352,2476,1797,837700,75209
2717,1023,1694,952,110800,75210
22520,12189,10331,1251,198500,75211
8724,5118,3606,1085,204200,75212
15637,9439,6198,1536,707400,75214
7461,2586,4875,1209,137700,75215
18811,10217,8594,1169,138900,75216
23923,14078,9845,1189,164800,75217
9790,6263,3527,1651,476000,75218
16540,5160,11380,1751,377900,75219
13794,4367,9427,1164,449500,75220
4364,2254,2110,1363,244000,75223
11675,6375,5300,1177,213100,75224
9057,6880,2177,2406,1489200,75225
2860,123,2737,1731,-,75226
18282,10256,8026,1277,203000,75227
24299,11858,12441,1196,259500,75228
11698,8102,3596,1522,598500,75229
13370,8197,5173,1365,870000,75230
17605,3291,14314,1220,466200,75231
11186,7869,3317,1265,207000,75232
4734,2608,2126,1292,249500,75233
12417,6805,5612,1730,314300,75234
9218,2104,7114,1631,283000,75235
6983,2061,4922,1312,237900,75236
7856,975,6881,1193,231600,75237
13265,6558,6707,1269,526100,75238
10649,2356,8293,1333,326600,75240
10212,6886,3326,1208,162900,75241
27388,7301,20087,1226,359100,75243
5664,3033,2631,1918,578200,75244
1273,256,1017,1045,449600,75246
288,0,288,1218,-,75247
16917,9109,7808,1602,543000,75248
5067,3825,1242,1972,258800,75249
2204,23,2181,1736,-,75251
13219,6033,7186,1332,530100,75252
6973,4941,2032,1338,121400,75253
12001,2681,9320,1450,303200,75254
0,0,0,-,-,75261
0,0,0,-,-,75270
27632,6393,21239,1391,389400,75287
0,0,0,-,-,75390
8160,4560,3600,1157,163100,75401
7282,4746,2536,1414,252500,75402
9586,7513,2073,1867,307500,75407
8061,6259,1802,1947,316500,75409
1748,1552,196,908,189100,75410
396,234,162,774,-,75411
179,105,74,756,97900,75412
55,38,17,1438,-,75413
1343,1079,264,883,223100,75414
134,124,10,-,153600,75415
1165,915,250,940,169800,75416
1015,705,310,1143,114500,75417
4966,3412,1554,1040,207600,75418
577,509,68,981,134200,75420
282,236,46,788,152400,75421
1079,845,234,1148,205600,75422
1072,903,169,957,187500,75423
1291,1143,148,1563,302600,75424
2060,1305,755,906,105900,75426
3862,1975,1887,910,145600,75428
0,0,0,-,-,75429
644,403,241,880,192600,75431
1197,920,277,863,137200,75432
1204,963,241,925,174000,75433
0,0,0,-,-,75434
430,314,116,633,110900,75435
839,658,181,697,215300,75436
411,386,25,1075,222400,75437
467,333,134,1227,210200,75438
395,251,144,1094,158500,75439
2828,2328,500,1033,270400,75440
79,72,7,-,-,75441
3788,3136,652,1501,330000,75442
1427,1099,328,712,199000,75446
386,366,20,-,227600,75447
239,220,19,-,153800,75448
373,268,105,443,122000,75449
221,192,29,-,215900,75450
549,526,23,-,166900,75451
1564,1234,330,1067,242600,75452
1102,951,151,1096,204500,75453
6084,5356,728,2262,421700,75454
9430,6166,3264,821,168800,75455
2010,1426,584,940,242000,75457
2076,1462,614,1264,248500,75459
9811,4865,4946,895,123300,75460
4388,3444,944,961,226800,75462
389,307,82,-,241100,75468
181,169,12,-,253900,75469
86,55,31,-,-,75470
554,376,178,1079,130300,75471
1577,1317,260,783,150700,75472
1462,1304,158,-,218600,75473
6181,5015,1166,1101,169800,75474
66,66,0,-,214900,75475
538,493,45,983,216800,75476
346,273,73,861,200400,75477
336,277,59,970,117300,75478
683,539,144,969,175600,75479
773,731,42,-,270300,75480
158,138,20,-,-,75481
9703,6368,3335,1047,202600,75482
1126,1088,38,1587,203300,75486
450,392,58,488,112300,75487
368,357,11,-,261400,75488
303,200,103,1161,228400,75489
1023,855,168,1526,300400,75490
2066,1710,356,881,239700,75491
140,106,34,-,160200,75492
178,120,58,775,55500,75493
4107,3331,776,888,175300,75494
3569,2996,573,1239,353500,75495
1109,864,245,900,172100,75496
1634,1402,232,1038,185400,75497
13179,7586,5593,904,125700,75501
10605,6448,4157,1185,214400,75503
188,157,31,508,111900,75550
4428,3428,1000,865,165200,75551
863,719,144,791,181100,75554
688,575,113,718,102100,75555
424,343,81,970,84100,75556
865,836,29,-,101500,75558
2294,1656,638,690,128700,75559
392,332,60,-,66900,75560
1859,1340,519,977,128700,75561
10,10,0,-,-,75562
1760,1286,474,596,119300,75563
14,14,0,-,-,75564
48,13,35,-,177500,75565
232,229,3,-,86600,75566
1524,1114,410,751,139900,75567
997,771,226,812,108600,75568
1331,715,616,926,148400,75569
3268,2336,932,779,130700,75570
1027,897,130,569,134400,75571
1260,936,324,765,107000,75572
94,26,68,959,-,75573
537,496,41,-,112500,75574
5785,3533,2252,910,193800,75601
6853,4426,2427,970,122700,75602
2631,2129,502,687,175200,75603
12279,6923,5356,1058,189900,75604
15005,8511,6494,1186,238800,75605
1126,978,148,863,133200,75630
888,705,183,864,137800,75631
5070,3865,1205,774,150400,75633
2241,1717,524,814,102900,75638
991,848,143,-,140200,75639
2224,1840,384,1167,263000,75640
35,16,19,-,214300,75641
25,25,0,-,-,75642
835,697,138,814,132200,75643
4499,3124,1375,1024,164600,75644
4145,3484,661,1060,178700,75645
5073,3750,1323,1030,164300,75647
3669,2606,1063,1160,191800,75650
850,686,164,1176,188800,75651
4161,3119,1042,918,202400,75652
4579,3712,867,1033,176400,75654
1859,1376,483,834,123000,75656
3111,2345,766,856,119400,75657
16,10,6,-,-,75658
24,24,0,-,-,75659
1073,876,197,848,110400,75661
8225,6437,1788,1051,165700,75662
503,421,82,965,109100,75667
955,589,366,906,98900,75668
289,289,0,-,130700,75669
6223,3654,2569,891,100300,75670
0,0,0,-,-,75671
6228,4852,1376,980,166500,75672
0,0,0,-,-,75680
1075,931,144,971,138300,75681
303,299,4,-,185800,75682
1466,1306,160,694,106800,75683
2285,1899,386,901,145500,75684
4885,3748,1137,753,158900,75686
0,0,0,-,-,75687
30,28,2,-,-,75689
1724,1308,416,958,195200,75691
2018,1801,217,1115,142500,75692
2009,1477,532,1131,208600,75693
0,0,0,-,-,75694
12300,7197,5103,1250,190500,75701
8165,4483,3682,906,99700,75702
17235,9709,7526,1262,310500,75703
3216,2565,651,1185,136400,75704
475,216,259,1429,160800,75705
3316,2634,682,941,125400,75706
5881,4550,1331,1415,256300,75707
2704,2162,542,865,131100,75708
2218,1573,645,1230,188700,75709
0,0,0,-,-,75711
1146,900,246,879,141500,75750
6312,3976,2336,1063,205200,75751
2711,2346,365,1023,197900,75752
2595,2211,384,1063,249500,75754
1832,1321,511,896,108800,75755
1683,1285,398,1074,220000,75756
5077,4038,1039,1151,277600,75757
4208,3456,752,982,159400,75758
76,71,5,-,-,75759
985,864,121,1025,138900,75760
5112,4345,767,1201,283100,75762
2457,2109,348,1043,152700,75763
59,40,19,-,98800,75764
3250,2712,538,918,187200,75765
9482,6649,2833,858,144400,75766
1081,955,126,877,248800,75770
7620,6275,1345,1318,266000,75771
5706,3979,1727,746,221100,75773
1262,900,362,1100,141900,75778
19,19,0,-,-,75779
104,80,24,1028,-,75780
34,31,3,-,-,75782
3271,2833,438,993,176300,75783
197,181,16,1025,135900,75784
3186,2463,723,911,158800,75785
52,52,0,-,-,75788
3026,2511,515,983,192200,75789
1291,970,321,1029,172800,75790
5130,3857,1273,1420,231900,75791
1192,1000,192,1112,140900,75792
6316,3730,2586,1003,163100,75801
5900,4340,1560,1106,197800,75803
1950,1325,625,861,99200,75831
1296,1024,272,726,164200,75833
4668,2989,1679,871,144100,75835
124,78,46,-,162500,75838
2184,1781,403,995,156500,75839
2607,1784,823,878,192500,75840
2033,1477,556,835,159400,75844
995,856,139,678,97200,75845
1046,865,181,905,208500,75846
592,469,123,1074,136800,75847
30,20,10,686,-,75848
30,23,7,-,86300,75849
442,381,61,-,208000,75850
772,683,89,1009,165500,75851
446,400,46,1138,222800,75852
431,345,86,748,220700,75853
1228,990,238,781,164300,75855
67,29,38,-,-,75856
44,44,0,-,-,75858
1062,814,248,1406,227600,75859
1759,1402,357,852,124100,75860
532,391,141,917,208500,75861
4400,3330,1070,833,113000,75862
0,0,0,-,-,75865
0,0,0,-,-,75884
0,0,0,-,-,75886
10315,6565,3750,1085,163600,75901
71,0,71,-,-,75903
13106,7558,5548,1086,173000,75904
1334,911,423,620,113400,75925
544,443,101,732,115500,75926
446,361,85,-,67700,75928
520,445,75,542,149000,75929
893,818,75,1098,104200,75930
993,804,189,698,206200,75931
570,519,51,1086,71000,75932
529,462,67,-,-,75933
31,31,0,-,-,75934
4835,3708,1127,935,118100,75935
289,244,45,725,165300,75936
398,319,79,660,79000,75937
1047,883,164,734,117300,75938
1722,1174,548,707,121400,75939
2702,2119,583,722,93800,75941
0,0,0,-,-,75942
461,408,53,1121,213400,75943
437,417,20,-,71700,75944
1471,1006,465,915,146700,75946
2485,2118,367,860,170200,75948
3485,2399,1086,927,105900,75949
6386,4513,1873,867,125500,75951
1239,911,328,786,87300,75954
2976,2486,490,736,140300,75956
330,290,40,-,116500,75959
385,385,0,-,117600,75960
6314,2959,3355,974,133100,75961
0,0,0,-,-,75962
7558,4748,2810,916,114500,75964
7938,4127,3811,899,224700,75965
1817,1284,533,1019,100200,75966
802,626,176,539,121400,75968
1575,1232,343,1068,155300,75969
2343,1691,652,743,76700,75972
1007,823,184,934,135700,75973
999,681,318,630,94100,75974
1316,925,391,892,107600,75975
359,251,108,772,73100,75976
213,181,32,-,104400,75977
3667,2629,1038,952,122600,75979
1006,896,110,669,94300,75980
11677,9140,2537,1893,318300,76001
9718,8115,1603,2154,307100,76002
2150,1753,397,3216,482100,76005
12332,3269,9063,1344,286900,76006
7864,7186,678,2577,456700,76008
6515,5007,1508,1202,211000,76009
18727,6086,12641,1223,199200,76010
10438,2075,8363,1266,218400,76011
10732,6935,3797,1307,292200,76012
13368,6747,6621,1267,287000,76013
10743,4854,5889,1516,217600,76014
6499,3004,3495,1608,236200,76015
11063,9252,1811,1854,311200,76016
16361,10631,5730,1533,286300,76017
8538,6355,2183,1855,245600,76018
12032,9506,2526,1246,272800,76020
14952,7800,7152,1432,349800,76021
5651,2812,2839,1417,255300,76022
2453,2014,439,1091,281800,76023
26804,20468,6336,1691,294500,76028
5937,4609,1328,1274,203500,76031
10281,6333,3948,1287,230600,76033
9282,8877,405,3194,717600,76034
1026,720,306,1469,387400,76035
11234,8477,2757,1579,288700,76036
17057,6043,11014,1690,315300,76039
11737,5018,6719,1245,281300,76040
239,239,0,-,174100,76041
2706,2094,612,896,247700,76043
2965,2659,306,1227,370100,76044
10571,7825,2746,1288,230000,76048
12334,10838,1496,1545,329200,76049
2475,2070,405,1147,255400,76050
21350,11015,10335,1806,467800,76051
9837,8497,1340,2124,421200,76052
11906,6347,5559,1322,254800,76053
4519,3797,722,1464,356000,76054
1210,1022,188,836,204900,76055
7267,5322,1945,1347,224500,76058
1834,817,1017,939,223400,76059
2951,2292,659,1300,354100,76060
0,0,0,-,-,76061
26730,19273,7457,1762,378600,76063
990,621,369,1398,317400,76064
14577,11779,2798,1873,378600,76065
1656,1417,239,834,246100,76066
7640,4767,2873,1050,156000,76067
388,388,0,-,102500,76070
1428,1178,250,1253,286500,76071
2433,2114,319,1165,317200,76073
188,168,20,-,576500,76077
3242,2624,618,1574,278800,76078
7744,6629,1115,1275,277900,76082
3827,3501,326,1982,248800,76084
3727,3322,405,1699,357900,76085
8704,4665,4039,1389,235100,76086
12317,10790,1527,1775,352000,76087
5373,4558,815,1443,374900,76088
9458,9041,417,"3,500+",956200,76092
1408,1097,311,1246,123100,76093
4686,935,3751,1661,338700,76102
5422,3194,2228,1119,186300,76103
7845,3008,4837,1385,145000,76104
6752,3482,3270,1172,117600,76105
10714,5156,5558,1179,167600,76106
15703,6934,8769,1501,431300,76107
16201,11522,4679,1418,238800,76108
10076,5240,4836,1700,599400,76109
10883,6785,4098,1255,239200,76110
7643,4335,3308,1272,199100,76111
17041,8437,8604,1215,207100,76112
9708,5292,4416,1231,195400,76114
6063,2944,3119,1177,132100,76115
22341,8009,14332,1205,286500,76116
12012,6038,5974,1205,185300,76117
6043,4257,1786,1400,290900,76118
15204,8283,6921,1234,146100,76119
7788,3949,3839,1353,279700,76120
13595,10417,3178,2138,278600,76123
9690,7978,1712,1677,357000,76126
14,0,14,-,-,76127
0,0,0,-,-,76129
17869,13216,4653,1780,316000,76131
12524,3851,8673,1354,401200,76132
18820,11790,7030,1399,223200,76133
9949,6038,3911,1335,209100,76134
7615,4756,2859,1210,250600,76135
22519,13191,9328,1632,283100,76137
10049,6741,3308,1590,207800,76140
8168,6793,1375,1824,227600,76148
3625,10,3615,1398,-,76155
4445,2511,1934,1117,140200,76164
9303,4609,4694,1726,349400,76177
25205,19766,5439,1840,299300,76179
15236,7469,7767,1553,286700,76180
11496,9604,1892,1821,364100,76182
11635,2079,9556,1128,250200,76201
0,0,0,-,-,76203
7384,2828,4556,1368,307900,76205
7392,4891,2501,1654,361400,76207
8778,5983,2795,1591,358000,76208
10671,4690,5981,1367,248900,76209
16520,12165,4355,1774,348400,76210
1359,1095,264,951,281700,76225
13433,12596,837,3088,554900,76226
20242,15598,4644,1950,376200,76227
505,414,91,1065,150000,76228
3959,3046,913,1063,202000,76230
1399,1004,395,1070,228400,76233
7261,5852,1409,1358,304300,76234
154,97,57,1292,-,76238
484,355,129,839,200400,76239
11377,7713,3664,1105,207600,76240
0,0,0,-,-,76241
24608,17244,7364,1954,363200,76244
753,685,68,840,196000,76245
6264,5218,1046,2070,372700,76247
14432,11570,2862,1979,545100,76248
3277,2714,563,1703,304300,76249
363,306,57,1176,272900,76250
268,247,21,1328,237200,76251
1101,830,271,1317,283500,76252
64,57,7,-,99800,76253
2256,1705,551,740,158400,76255
2925,2492,433,1224,320200,76258
2032,1584,448,1387,356600,76259
85,69,16,-,78300,76261
15601,11495,4106,1752,527400,76262
14,14,0,-,-,76263
435,398,37,953,309600,76264
656,505,151,468,211900,76265
6890,5612,1278,1345,315900,76266
23,13,10,-,-,76267
91,91,0,-,142700,76268
873,862,11,-,242700,76270
694,534,160,1607,323800,76271
1798,1634,164,964,329500,76272
4024,2897,1127,1171,234400,76273
6364,3446,2918,790,71900,76301
5047,3040,2007,902,142500,76302
2000,1573,427,903,176700,76305
5487,3089,2398,884,105500,76306
8593,4623,3970,1083,198800,76308
5510,3270,2240,1023,138600,76309
7833,5726,2107,1005,201300,76310
716,12,704,1413,-,76311
657,494,163,496,125600,76351
4711,3118,1593,954,148700,76354
197,188,9,-,117300,76357
1101,736,365,761,64100,76360
63,59,4,-,25300,76363
94,67,27,1750,80800,76364
1965,1480,485,707,143200,76365
841,704,137,771,145700,76366
3998,3558,440,965,136600,76367
176,145,31,768,80400,76370
633,558,75,663,73000,76371
459,354,105,540,84000,76372
74,66,8,-,-,76373
1803,1203,600,475,98100,76374
197,160,37,768,89700,76377
208,162,46,935,138000,76379
1556,1034,522,685,93300,76380
4517,2814,1703,859,101600,76384
85,70,15,-,70000,76388
519,475,44,892,199600,76389
12311,7006,5305,1136,252000,76401
0,0,0,-,-,76402
3262,2513,749,801,102200,76424
3798,2939,859,1172,257500,76426
380,216,164,1092,131700,76427
70,70,0,-,-,76429
1016,851,165,478,197300,76430
1549,1380,169,1094,186700,76431
491,462,29,578,204000,76432
837,725,112,1200,404000,76433
240,214,26,1528,129500,76435
45,45,0,-,-,76436
2306,1722,584,951,119200,76437
0,0,0,-,-,76439
2762,2157,605,854,140700,76442
743,535,208,800,112400,76443
1529,1190,339,574,112500,76444
119,110,9,-,-,76445
2883,2470,413,1039,169000,76446
2054,1509,545,803,186900,76448
1013,839,174,943,268000,76449
5513,4114,1399,957,187700,76450
68,68,0,-,-,76452
651,584,67,992,322700,76453
600,400,200,490,82700,76454
336,283,53,792,136300,76455
1700,1339,361,972,217500,76457
1993,1442,551,836,171500,76458
57,57,0,-,58400,76459
135,101,34,-,115500,76460
1465,1303,162,1344,302400,76462
180,150,30,1188,122700,76463
207,173,34,933,-,76464
148,101,47,-,81300,76466
20,20,0,-,-,76469
1344,851,493,735,64000,76470
674,467,207,656,122400,76471
451,392,59,-,160600,76472
124,118,6,-,403600,76474
406,280,126,646,114500,76475
1141,969,172,1438,219500,76476
141,141,0,-,-,76481
373,272,101,-,73600,76483
332,316,16,-,158700,76484
509,386,123,1040,325000,76486
1194,1036,158,-,220800,76487
17,12,5,-,-,76490
270,195,75,779,112500,76491
6480,4201,2279,879,151000,76501
18252,11774,6478,1411,252100,76502
10183,3344,6839,1106,162600,76504
869,720,149,768,180200,76511
15021,10459,4562,1216,260200,76513
496,363,133,717,211700,76518
242,206,36,-,156600,76519
2858,2028,830,940,157700,76520
16428,10107,6321,1029,174000,76522
143,135,8,-,169500,76523
1341,1132,209,1138,200000,76524
522,405,117,781,117600,76525
1583,1173,410,913,370400,76527
6567,4701,1866,848,189900,76528
970,875,95,-,277200,76530
1629,1223,406,851,128000,76531
1074,852,222,1039,208000,76534
4352,3516,836,1729,272200,76537
453,401,52,715,125700,76538
3189,2997,192,1354,255800,76539
8453,1989,6464,858,97500,76541
19913,12858,7055,1237,228500,76542
13530,5388,8142,1099,140700,76543
4699,11,4688,1367,-,76544
11816,7354,4462,1113,268000,76548
20055,10814,9241,1363,202100,76549
5137,3862,1275,902,237600,76550
735,589,146,1190,162400,76554
741,660,81,-,140400,76556
1775,1380,395,1099,197000,76557
2631,1824,807,1159,184600,76559
415,327,88,924,141900,76561
0,0,0,-,-,76565
146,137,9,-,239800,76566
3685,2840,845,978,169900,76567
968,787,181,912,118500,76569
914,753,161,717,86600,76570
3586,3150,436,1172,395800,76571
5,5,0,-,-,76573
7797,5848,1949,1167,252000,76574
1411,1105,306,983,185400,76577
548,432,116,1176,315800,76578
1950,1219,731,1185,225500,76579
0,0,0,-,-,76596
0,0,0,-,-,76597
0,0,0,-,-,76598
0,0,0,-,-,76599
388,366,22,1350,227000,76621
486,384,102,794,197300,76622
39,32,7,-,113800,76623
941,860,81,877,147400,76624
479,335,144,1075,147300,76626
590,544,46,1219,143300,76627
28,28,0,-,-,76628
803,637,166,952,187300,76629
740,610,130,985,208500,76630
140,95,45,970,116900,76631
514,399,115,1260,95400,76632
1930,1790,140,1685,348100,76633
2990,2253,737,920,190600,76634
474,308,166,776,145600,76635
597,539,58,715,200300,76636
208,143,65,842,248300,76637
1091,1037,54,900,376300,76638
751,477,274,711,125100,76639
1034,820,214,965,178300,76640
663,548,115,1090,143200,76641
2292,1660,632,828,188800,76642
6011,4053,1958,1389,252200,76643
3987,2580,1407,941,154800,76645
1027,774,253,889,121300,76648
378,315,63,1368,174500,76649
23,21,2,-,116100,76650
1369,977,392,1152,213900,76651
466,435,31,-,188700,76652
539,495,44,1071,156600,76653
75,61,14,-,159400,76654
3314,2899,415,967,294600,76655
952,733,219,825,118300,76656
4251,3379,872,1228,367700,76657
168,147,21,950,119600,76660
2397,1698,699,716,52100,76661
1136,861,275,919,133800,76664
1157,715,442,624,124100,76665
82,41,41,-,91500,76666
3854,2663,1191,832,119700,76667
631,431,200,953,194000,76670
800,672,128,1000,203400,76671
381,311,70,1164,113700,76673
132,126,6,900,133300,76676
66,57,9,-,171600,76678
379,322,57,-,121700,76679
46,46,0,-,-,76680
231,209,22,-,104600,76681
1154,990,164,1163,157100,76682
28,28,0,-,118400,76685
114,84,30,900,125000,76686
798,708,90,992,256300,76687
1528,1308,220,1135,228800,76689
494,352,142,1158,151700,76690
2404,1904,500,931,229900,76691
4042,3134,908,898,159500,76692
745,522,223,907,203800,76693
868,115,753,1008,-,76701
3057,1022,2035,788,112800,76704
10785,6635,4150,941,167000,76705
14489,5641,8848,1063,180600,76706
5525,3162,2363,1055,113600,76707
10139,7009,3130,1087,204600,76708
10839,5039,5800,1098,229000,76710
3762,1917,1845,1314,112600,76711
10908,7636,3272,1333,302100,76712
0,0,0,-,-,76798
9728,6123,3605,854,138200,76801
2006,1574,432,1187,201100,76802
79,44,35,-,213900,76820
1726,1275,451,940,104200,76821
1099,844,255,742,136600,76823
0,0,0,-,-,76824
2599,1715,884,837,99900,76825
273,251,22,757,185900,76827
109,107,2,-,-,76828
0,0,0,-,-,76831
190,121,69,1336,147900,76832
2074,1594,480,746,87600,76834
1,1,0,-,-,76836
420,288,132,833,89100,76837
26,0,26,-,-,76841
134,106,28,-,-,76842
1324,1100,224,714,184000,76844
86,83,3,-,217000,76845
23,23,0,-,-,76848
1471,1164,307,766,162700,76849
141,127,14,-,179200,76852
519,419,100,663,247200,76853
178,107,71,-,564900,76854
1303,1007,296,751,271500,76856
999,667,332,1508,130900,76857
108,101,7,-,83500,76858
855,699,156,688,106100,76859
733,565,168,825,186100,76861
89,85,4,-,-,76862
329,279,50,730,259700,76864
105,77,28,-,107000,76865
256,212,44,968,119200,76866
11,11,0,-,-,76869
25,25,0,-,193800,76870
175,146,29,858,165600,76871
276,256,20,867,192700,76872
33,33,0,-,-,76873
0,0,0,-,-,76874
228,204,24,536,150000,76875
1624,1073,551,889,157800,76877
647,439,208,792,66900,76878
0,0,0,-,-,76880
107,78,29,-,175000,76882
40,38,2,-,-,76884
29,16,13,-,-,76885
57,45,12,-,233000,76887
70,49,21,-,-,76888
356,292,64,850,123100,76890
12333,9006,3327,1188,169500,76901
0,0,0,-,-,76902
12127,7609,4518,1051,115900,76903
15346,9515,5831,1119,266800,76904
4746,3281,1465,1499,146100,76905
0,0,0,-,-,76908
0,0,0,-,-,76909
37,37,0,-,-,76930
1026,775,251,806,164200,76932
599,430,169,889,152700,76933
334,315,19,-,244300,76934
681,670,11,-,356100,76935
907,793,114,627,116000,76936
98,79,19,-,1088100,76937
0,0,0,-,-,76939
16,16,0,-,-,76940
513,444,69,1028,136200,76941
1133,897,236,585,140100,76943
828,571,257,600,63000,76945
1243,835,408,770,141700,76950
402,335,67,968,143200,76951
17,17,0,-,-,76953
64,49,15,-,225000,76955
48,11,37,-,-,76957
100,100,0,-,269200,76958
7022,656,6366,1860,286100,77002
5376,2430,2946,1562,363000,77003
16208,6107,10101,1320,384100,77004
9935,7196,2739,2058,1354300,77005
14329,4994,9335,1761,599500,77006
24081,11079,13002,1951,501300,77007
19513,11512,8001,1567,609300,77008
15241,8946,6295,1229,403600,77009
420,0,420,3269,-,77010
6139,3142,2997,1063,187100,77011
6005,2494,3511,944,127400,77012
5709,2323,3386,1136,162600,77013
12059,6016,6043,1220,213300,77014
18253,9569,8684,1169,164700,77015
9806,6085,3721,1163,111900,77016
10332,5244,5088,1049,146600,77017
12128,8627,3501,1256,543800,77018
12838,5293,7545,1886,724900,77019
9065,4710,4355,942,133600,77020
10998,4380,6618,1193,203900,77021
9131,4370,4761,1047,197200,77022
10224,4537,5687,1079,279300,77023
16124,10017,6107,1796,1164400,77024
14330,5846,8484,1484,521300,77025
8053,3237,4816,962,104800,77026
11379,3327,8052,1840,881700,77027
6178,3457,2721,1115,108200,77028
5473,3766,1707,1129,115400,77029
6489,2311,4178,1684,614100,77030
6071,2698,3373,1083,227100,77031
4397,1536,2861,1148,122900,77032
9411,5559,3852,1204,98300,77033
12405,6209,6196,1178,178100,77034
13986,5680,8306,1124,259800,77035
26367,4629,21738,995,217400,77036
5089,3619,1470,1056,160500,77037
8786,5038,3748,1248,173500,77038
8047,4818,3229,1169,148600,77039
18315,9485,8830,1343,224200,77040
11191,8150,3041,1638,269000,77041
19095,4898,14197,1287,371300,77042
10254,5633,4621,1417,382800,77043
17275,12980,4295,1595,274500,77044
10405,6154,4251,1260,163600,77045
1135,576,559,1733,276400,77046
12802,9042,3760,1719,224200,77047
7439,4332,3107,1317,190900,77048
11945,8121,3824,1491,207900,77049
1779,969,810,1195,119700,77050
6568,2547,4021,1332,171900,77051
9443,6166,3277,1579,166200,77053
16434,1842,14592,1413,173000,77054
16217,7511,8706,1239,577800,77055
12805,4536,8269,1855,807300,77056
22244,6908,15336,1354,318700,77057
10130,3127,7003,1362,244800,77058
6502,6110,392,1819,395800,77059
15135,3474,11661,1024,144900,77060
8793,3461,5332,973,215200,77061
9677,7256,2421,1376,280400,77062
20044,4721,15323,1334,281300,77063
15989,10098,5891,1477,234600,77064
15866,7158,8708,1371,257800,77065
11715,8706,3009,1396,217500,77066
10035,4437,5598,1138,174600,77067
4127,2897,1230,1345,312400,77068
8841,5541,3300,1487,320200,77069
21657,10400,11257,1571,264300,77070
10442,5408,5034,1059,228000,77071
18687,8422,10265,1248,175100,77072
14052,8856,5196,1330,206700,77073
12829,4183,8646,1066,201600,77074
12389,7613,4776,1225,219900,77075
9794,5020,4774,1151,147700,77076
29208,10404,18804,1418,356300,77077
5024,2947,2077,1336,151500,77078
14689,7467,7222,1620,636100,77079
15666,7288,8378,1253,311600,77080
19419,1256,18163,990,245200,77081
23088,8505,14583,1361,225600,77082
22633,14815,7818,1375,223100,77083
36216,21733,14483,1522,232600,77084
5613,3573,2040,1431,174000,77085
8717,4992,3725,1199,196300,77086
11139,6174,4965,1015,148400,77087
17432,11437,5995,1177,173900,77088
18786,12409,6377,1411,237400,77089
16682,4667,12015,1228,235500,77090
11017,3882,7135,1061,223700,77091
14591,6128,8463,1228,222800,77092
13348,7584,5764,1102,122400,77093
4204,3343,861,1690,469300,77094
25458,17998,7460,1638,288500,77095
13514,6406,7108,1293,410200,77096
9063,3030,6033,1854,777700,77098
16432,6112,10320,1218,176800,77099
0,0,0,-,-,77204
12068,6793,5275,1229,193500,77301
6739,5619,1120,1315,247000,77302
8808,6436,2372,1157,232200,77303
17724,10226,7498,1397,324800,77304
5463,4402,1061,933,156600,77306
11117,9881,1236,1419,396500,77316
7551,6169,1382,1209,288900,77318
10004,6601,3403,975,174400,77320
102,102,0,-,-,77326
11010,8986,2024,1001,144100,77327
6069,4723,1346,1127,169200,77328
3288,2801,487,922,226400,77331
58,43,15,-,-,77334
1053,839,214,1144,140000,77335
4345,3411,934,1508,265800,77336
16739,8565,8174,1354,222900,77338
17618,10201,7417,1605,274900,77339
13064,6209,6855,992,229000,77340
0,0,0,-,-,77341
0,0,0,-,-,77342
9459,8111,1348,2172,370000,77345
25754,21307,4447,1770,291200,77346
91,84,7,-,84400,77350
12819,10015,2804,1057,163500,77351
13973,11109,2864,1850,379700,77354
10842,8944,1898,1472,329700,77355
12885,10621,2264,1608,369200,77356
11126,8415,2711,1366,218800,77357
2149,1630,519,987,219000,77358
300,196,104,-,190000,77359
2305,1701,604,1049,141300,77360
2535,2228,307,1058,271700,77362
1226,1061,165,1257,345300,77363
929,812,117,862,184700,77364
14537,11755,2782,1381,261200,77365
258,147,111,961,199600,77367
0,0,0,-,-,77368
243,230,13,-,73300,77369
2339,1820,519,1008,155300,77371
4369,3660,709,1226,217600,77372
22617,16527,6090,1649,221400,77373
139,139,0,-,156900,77374
24414,17236,7178,1495,287100,77375
277,272,5,-,-,77376
12833,10603,2230,1676,352000,77377
6249,4471,1778,1408,177900,77378
28721,21654,7067,1618,335900,77379
14971,5014,9957,1607,343900,77380
13165,10287,2878,1699,445400,77381
13277,10831,2446,1867,545400,77382
10523,5614,4909,1473,420400,77384
9174,7027,2147,1727,294900,77385
21767,17668,4099,1878,346300,77386
18110,12372,5738,1809,264600,77388
14601,11457,3144,1795,387100,77389
19533,13127,6406,1459,234100,77396
6192,5444,748,2705,977600,77401
21125,18447,2678,1986,383400,77406
24707,19218,5489,1993,353800,77407
5,5,0,-,-,77412
9908,6104,3804,991,166100,77414
74,58,16,-,-,77415
872,591,281,1096,155600,77417
3934,2894,1040,893,322200,77418
374,311,63,-,146700,77419
818,724,94,841,194600,77420
4950,4117,833,1068,205000,77422
5073,4048,1025,1340,266100,77423
984,705,279,-,368700,77426
35,0,35,-,-,77428
32248,26477,5771,1684,342300,77429
685,623,62,1803,329700,77430
204,192,12,-,-,77431
0,0,0,-,-,77432
33441,26802,6639,1904,384400,77433
1341,1171,170,1106,106600,77434
1921,1638,283,1226,281100,77435
0,0,0,-,-,77436
6625,4560,2065,961,175400,77437
64,64,0,-,-,77440
10110,9369,741,1923,557300,77441
360,273,87,612,229800,77442
45,0,45,-,-,77443
329,307,22,-,205800,77444
5084,3076,2008,1251,270900,77445
753,122,631,883,284000,77446
7328,6274,1054,1594,296200,77447
23,23,0,-,-,77448
39327,27716,11611,1755,236400,77449
25316,17615,7701,1730,342000,77450
181,135,46,1167,115100,77451
59,59,0,-,-,77453
93,93,0,-,-,77454
721,606,115,1104,159600,77455
384,348,36,-,119100,77456
278,211,67,-,271600,77457
13,13,0,-,-,77458
27055,22743,4312,2031,367700,77459
18,18,0,-,-,77460
4106,3146,960,1071,262600,77461
202,81,121,1906,230200,77464
2858,2295,563,748,170600,77465
147,121,26,-,295800,77466
22,0,22,-,-,77467
0,0,0,-,-,77468
22112,17947,4165,1675,315000,77469
165,132,33,-,-,77470
16443,9197,7246,1320,235000,77471
11,0,11,-,-,77473
6065,4818,1247,1261,253200,77474
225,200,25,-,214500,77475
136,121,15,-,394300,77476
12919,5179,7740,1436,241200,77477
8885,6759,2126,1751,378700,77478
29611,24564,5047,1997,462200,77479
3125,2359,766,1262,189000,77480
110,26,84,-,-,77481
846,724,122,-,147900,77482
132,132,0,-,206000,77483
4699,3158,1541,1075,243400,77484
1552,1128,424,896,198000,77485
2760,2183,577,1075,221600,77486
5246,3270,1976,989,173100,77488
13372,10376,2996,1797,209900,77489
19062,14899,4163,1806,321900,77493
42600,30247,12353,2044,450100,77494
17010,12013,4997,1831,281600,77498
11017,7021,3996,1185,164500,77502
8153,4425,3728,1211,165300,77503
9064,3794,5270,1196,207600,77504
8340,5718,2622,1522,276100,77505
10500,3993,6507,1049,131800,77506
328,0,328,1693,-,77507
5414,4613,801,1067,281200,77510
17987,12521,5466,1213,218100,77511
1960,1687,273,1607,200300,77514
11880,8715,3165,1024,210800,77515
1935,1682,253,830,266300,77517
3701,2275,1426,1169,168000,77518
235,219,16,-,-,77519
12863,6847,6016,1142,144200,77520
23795,14067,9728,1312,220100,77521
9836,8063,1773,1537,340600,77523
9532,6915,2617,1131,170600,77530
6552,3599,2953,1217,236800,77531
10818,9130,1688,1190,243700,77532
408,305,103,955,106500,77533
980,849,131,1435,255900,77534
10831,9190,1641,1075,217200,77535
11449,9241,2208,1344,238300,77536
295,275,20,-,151500,77538
17331,12969,4362,1370,246400,77539
6365,4452,1913,1102,162800,77541
8371,7097,1274,2102,240100,77545
18763,14266,4497,1689,354300,77546
2736,1912,824,1099,109100,77547
11604,4678,6926,1182,283800,77550
9228,4497,4731,1342,278100,77551
4964,3477,1487,1449,430500,77554
0,0,0,-,-,77555
371,353,18,-,266400,77560
8,8,0,-,-,77561
3602,2768,834,1190,195300,77562
4208,3246,962,1405,198700,77563
729,629,100,-,120300,77564
3010,1725,1285,1667,376600,77565
11447,7410,4037,1417,256900,77566
8054,5932,2122,1395,209300,77568
13825,10109,3716,1328,220300,77571
36043,27212,8831,1647,342000,77573
6019,4444,1575,953,161300,77575
498,441,57,938,258000,77577
9254,7431,1823,1936,359500,77578
0,0,0,-,-,77580
17739,13610,4129,1591,309100,77581
116,116,0,-,-,77582
13299,12253,1046,1501,298000,77583
30559,22936,7623,1818,339100,77584
430,358,72,-,203600,77585
9643,7140,2503,1421,325700,77586
5040,2738,2302,1174,177000,77587
13419,6740,6679,1179,168400,77590
6828,3653,3175,1226,204900,77591
214,142,72,-,371000,77597
12442,2683,9759,1279,228700,77598
3394,2630,764,1540,199200,77611
3689,3187,502,808,109200,77612
312,257,55,1074,200600,77613
209,178,31,-,131500,77614
126,106,20,-,75000,77615
243,202,41,-,97100,77616
22,13,9,-,-,77617
6132,4796,1336,1247,153800,77619
624,580,44,-,223400,77622
277,255,22,550,-,77623
268,253,15,1063,202400,77624
3516,2812,704,1060,115100,77625
8998,6712,2286,1364,201200,77627
230,200,30,-,170500,77629
10892,7228,3664,1033,163700,77630
8351,6620,1731,1037,184700,77632
6995,4678,2317,1163,97200,77640
13976,7271,6705,944,96100,77642
1222,1126,96,-,363900,77650
5188,3743,1445,1116,231000,77651
134,134,0,-,135000,77655
6678,5293,1385,974,114100,77656
8415,7067,1348,1039,243900,77657
1841,1579,262,1184,233800,77659
346,315,31,-,185800,77660
95,28,67,-,-,77661
9957,8060,1897,868,124800,77662
174,144,30,-,237500,77663
1116,978,138,1136,153700,77664
2416,1800,616,1109,203600,77665
4481,2427,2054,952,79000,77701
1445,906,539,1141,141700,77702
4390,1963,2427,929,97100,77703
9993,5572,4421,858,121900,77705
13317,7616,5701,1176,238800,77706
6376,4410,1966,1244,162600,77707
4952,2813,2139,1056,167100,77708
5727,3480,2247,1385,210300,77713
6051,986,5065,998,172200,77801
11246,5627,5619,1272,237600,77802
9799,6006,3793,1106,141000,77803
5157,2970,2187,1227,251900,77807
5351,4966,385,1103,352200,77808
1179,1010,169,1166,302000,77830
1324,1258,66,850,182100,77831
11948,8396,3552,1077,261900,77833
1218,1114,104,-,290300,77835
5103,4233,870,869,199000,77836
586,381,205,913,113100,77837
21769,2421,19348,1085,241000,77840
0,0,0,-,-,77843
28825,18404,10421,1384,349900,77845
18,18,0,-,-,77852
437,385,52,826,142000,77853
58,58,0,-,314700,77855
1633,1220,413,919,245900,77856
497,432,65,690,311400,77857
2963,2051,912,651,160900,77859
1210,1026,184,1146,260400,77861
52,19,33,-,-,77863
2799,1854,945,765,131800,77864
655,556,99,1197,183800,77865
0,0,0,-,-,77866
66,61,5,-,"10,000-",77867
5667,3844,1823,934,200400,77868
1126,918,208,748,245100,77871
737,545,192,1260,193500,77872
484,470,14,-,208400,77873
0,0,0,-,-,77875
60,60,0,-,-,77876
374,218,156,910,134000,77878
2190,1767,423,1039,142200,77879
1172,962,210,1350,272700,77880
15,15,0,-,-,77882
14532,8308,6224,1105,133900,77901
11747,8185,3562,1272,237900,77904
6082,5127,955,1094,208100,77905
91,75,16,-,96100,77950
477,338,139,761,132300,77951
3386,2207,1179,932,185500,77954
3285,2272,1013,1072,128400,77957
0,0,0,-,-,77960
40,40,0,-,-,77961
1297,775,522,937,228300,77962
2028,1634,394,730,177600,77963
3322,2530,792,928,232100,77964
1171,1001,170,778,225700,77968
55,55,0,-,785200,77969
83,68,15,867,-,77970
186,186,0,-,225400,77971
11,0,11,-,-,77973
242,187,55,1108,186500,77974
749,550,199,1055,197000,77975
5,5,0,-,-,77976
212,212,0,-,46200,77977
183,113,70,1125,116300,77978
6710,5101,1609,1065,137700,77979
339,339,0,-,248800,77982
1195,908,287,1357,173200,77983
1794,1605,189,1164,195500,77984
0,0,0,-,-,77986
69,44,25,-,305300,77987
103,68,35,-,-,77988
289,246,43,943,58800,77990
95,80,15,-,-,77991
92,82,10,-,221100,77993
163,130,33,1331,-,77994
3968,2791,1177,877,168400,77995
0,0,0,-,-,78001
2322,1810,512,1246,171200,78002
4126,3470,656,1096,233100,78003
194,178,16,-,691800,78004
537,340,197,-,403000,78005
15631,11777,3854,1612,502700,78006
48,22,26,-,-,78007
90,39,51,-,-,78008
3097,2631,466,1212,335200,78009
1376,1020,356,681,273700,78010
563,523,40,-,70600,78011
126,89,37,-,90800,78012
2125,1786,339,960,396700,78013
1353,1034,319,-,77100,78014
8027,7554,473,1498,482800,78015
3864,3020,844,739,173600,78016
1274,790,484,925,99800,78017
424,387,37,842,105900,78019
11,11,0,-,-,78021
1683,1220,463,897,140000,78022
9735,8602,1133,1570,393800,78023
501,421,80,992,635100,78024
1985,1545,440,972,256900,78025
2528,1884,644,959,151700,78026
214,214,0,-,279700,78027
17474,11811,5663,1097,281300,78028
0,0,0,-,-,78029
819,719,100,1068,122600,78039
11438,4331,7107,881,116500,78040
15761,8565,7196,956,216700,78041
12783,6885,5898,954,151400,78043
136,114,22,-,221100,78044
20713,16031,4682,1404,227300,78045
18350,14558,3792,1038,142000,78046
208,195,13,-,103800,78050
2042,1799,243,1076,178900,78052
795,620,175,-,245200,78055
889,828,61,-,502800,78056
146,146,0,-,138700,78057
481,439,42,-,253800,78058
1938,1779,159,1156,146600,78059
3199,1979,1220,1013,103200,78061
0,0,0,-,-,78062
4086,3764,322,964,265400,78063
5607,3919,1688,1109,216300,78064
3647,2812,835,959,136400,78065
189,189,0,-,233800,78066
225,225,0,-,86600,78067
2076,1815,261,1096,106700,78069
7574,6868,706,1274,469500,78070
1114,717,397,943,160900,78071
90,77,13,-,98100,78072
2703,2314,389,1031,139600,78073
37,37,0,-,-,78074
107,107,0,-,119500,78075
4364,3217,1147,566,89600,78076
2918,2676,242,887,273200,78101
7173,5115,2058,1049,106600,78102
29,0,29,-,-,78104
151,114,37,-,47900,78107
15390,13055,2335,2052,307300,78108
18933,14183,4750,1645,241100,78109
0,0,0,-,-,78111
3527,3146,381,1271,120400,78112
1163,854,309,1261,228800,78113
8529,7173,1356,1079,273900,78114
129,129,0,-,272800,78116
323,293,30,-,271700,78117
1302,947,355,668,115100,78118
1811,1033,778,1043,128500,78119
5077,4535,542,1086,359900,78121
212,212,0,-,-,78122
890,788,102,-,238900,78123
2475,2108,367,1326,282000,78124
16,16,0,-,333300,78125
37144,24486,12658,1525,296300,78130
14458,12537,1921,1531,570900,78132
9285,7891,1394,1236,300100,78133
1089,728,361,1011,84200,78140
398,353,45,769,59000,78141
20,13,7,-,-,78142
50,50,0,-,-,78143
0,0,0,-,-,78144
21,21,0,-,23800,78145
209,142,67,-,128100,78146
571,349,222,1120,194700,78147
8325,4403,3922,1252,249400,78148
0,0,0,-,-,78150
693,395,298,322,103400,78151
1428,1277,151,1785,292800,78152
14997,10491,4506,1664,296400,78154
20078,14674,5404,1149,246000,78155
232,159,73,873,73900,78159
1605,1345,260,1064,180900,78160
163,152,11,-,-,78161
91,70,21,-,188900,78162
6173,5895,278,1406,431100,78163
1271,1046,225,910,165000,78164
16534,7838,8696,1033,187400,78201
4288,2294,1994,1218,223900,78202
1798,856,942,989,139900,78203
5052,2409,2643,1516,142200,78204
1247,112,1135,1265,470200,78205
16704,7169,9535,857,93200,78207
1861,586,1275,894,125000,78208
19662,9576,10086,1371,497500,78209
11909,7111,4798,1119,172700,78210
9643,6029,3614,1047,110200,78211
11364,5373,5991,1084,299400,78212
16752,8051,8701,1161,199500,78213
7743,4455,3288,934,121600,78214
2483,69,2414,1754,486100,78215
19635,6705,12930,1211,281700,78216
14703,6708,7995,1186,216100,78217
14746,7292,7454,1168,183900,78218
5655,3202,2453,1128,155200,78219
6363,3516,2847,1153,125000,78220
13134,9167,3967,1147,157500,78221
8695,6085,2610,1151,188100,78222
20112,11567,8545,1054,156700,78223
6435,3476,2959,1132,138800,78224
5014,3410,1604,1082,110600,78225
2127,804,1323,1014,109300,78226
14599,8303,6296,1112,151300,78227
19284,11125,8159,1004,164700,78228
16398,2199,14199,1234,206400,78229
19137,9465,9672,1289,355400,78230
4052,2646,1406,1289,382000,78231
15525,8787,6738,1404,345300,78232
18459,11343,7116,1456,203300,78233
991,4,987,2196,-,78234
1116,0,1116,1479,-,78235
463,12,451,2099,-,78236
11838,7194,4644,987,103000,78237
10559,4801,5758,1183,191300,78238
9850,7300,2550,1401,215600,78239
24767,8745,16022,1283,245100,78240
10666,5630,5036,1230,128500,78242
0,0,0,-,-,78243
12444,8832,3612,1552,195400,78244
30429,22029,8400,1563,241500,78245
19337,14487,4850,1508,256400,78247
5707,4086,1621,1346,460400,78248
22633,11636,10997,1475,284200,78249
19614,14387,5227,1470,221900,78250
21963,11333,10630,1371,243900,78251
5681,5227,454,1825,242000,78252
22264,17216,5048,1557,334900,78253
24599,20514,4085,1670,298800,78254
6258,5297,961,1772,490600,78255
5498,1646,3852,1545,494400,78256
5477,2133,3344,1678,542300,78257
19271,11190,8081,1720,446700,78258
10568,6865,3703,1554,370800,78259
11981,10362,1619,1996,471200,78260
9231,7506,1725,1873,409400,78261
1602,1267,335,1142,312600,78263
3900,3350,550,1381,134300,78264
2652,2405,247,2282,553200,78266
150,131,19,-,87100,78330
8952,5683,3269,897,97900,78332
4697,3063,1634,1182,204200,78336
0,0,0,-,-,78338
132,66,66,-,70800,78339
214,187,27,1488,161200,78340
405,218,187,917,86700,78341
125,73,52,-,-,78342
1665,1451,214,781,108500,78343
156,142,14,-,87800,78344
44,44,0,-,-,78347
99,96,3,-,148100,78349
160,51,109,1073,98800,78351
25,25,0,-,-,78352
210,112,98,-,-,78353
2784,1527,1257,487,84200,78355
974,672,302,733,115400,78357
372,327,45,1175,-,78358
608,361,247,868,97200,78359
18,18,0,-,-,78360
1203,733,470,820,128900,78361
4038,2737,1301,1226,182600,78362
11003,5679,5324,1020,155900,78363
3767,2850,917,806,87300,78368
77,57,20,-,-,78369
1619,1251,368,1132,190800,78370
53,53,0,-,-,78371
1871,1420,451,799,144400,78372
1596,1195,401,2226,518500,78373
7277,4610,2667,1492,225800,78374
1116,694,422,733,81100,78375
50,38,12,-,-,78376
1145,781,364,759,92000,78377
790,680,110,1101,109200,78379
8426,6578,1848,1001,141900,78380
9733,7605,2128,1147,238200,78382
1686,1410,276,1011,228300,78383
1679,1279,400,993,59400,78384
17,6,11,-,-,78385
3138,1931,1207,918,122400,78387
703,604,99,953,56700,78389
1777,1230,547,1034,134200,78390
53,0,53,1200,-,78391
633,561,72,957,93900,78393
1503,190,1313,930,76100,78401
167,121,46,-,195800,78402
5651,3000,2651,1172,180500,78404
5002,2691,2311,1030,75300,78405
353,152,201,1715,-,78406
599,410,189,1054,131100,78407
3748,1902,1846,979,82300,78408
901,471,430,986,133100,78409
10014,6539,3475,1158,220400,78410
9263,5694,3569,1199,178800,78411
15510,7173,8337,1242,188500,78412
13958,7973,5985,1321,230900,78413
18756,12170,6586,1549,271300,78414
14197,8148,6049,1166,135600,78415
4705,2899,1806,1066,93100,78416
1468,935,533,1186,133300,78417
12424,8184,4240,1301,274800,78418
202,0,202,1851,-,78419
21539,10802,10737,943,149000,78501
7027,4107,2920,1087,130100,78503
19571,13405,6166,1178,203900,78504
10227,7874,2353,743,102900,78516
20034,11713,8321,842,129200,78520
27475,16312,11163,864,90500,78521
17085,11508,5577,1080,158300,78526
211,134,77,767,67900,78535
113,93,20,-,86800,78536
14028,10286,3742,744,74700,78537
3298,2370,928,586,87300,78538
14255,7872,6383,1034,198300,78539
0,0,0,-,-,78540
15773,8075,7698,945,142600,78541
22928,17136,5792,876,123500,78542
2772,2179,593,759,85900,78543
203,199,4,-,-,78545
132,83,49,-,-,78547
475,382,93,803,52300,78548
283,234,49,-,62700,78549
19639,10348,9291,863,120500,78550
13616,10173,3443,1054,154500,78552
3886,3067,819,849,156400,78557
202,162,40,-,54900,78558
4067,3043,1024,985,99900,78559
1440,771,669,776,114400,78560
241,228,13,-,55100,78561
589,463,126,-,117800,78562
34,28,6,-,-,78563
23,0,23,-,-,78564
63,63,0,-,-,78565
7214,5362,1852,863,138100,78566
109,87,22,-,61000,78567
1250,1033,217,682,103200,78569
8973,6619,2354,686,83400,78570
26575,19167,7408,900,121900,78572
12068,8405,3663,909,154800,78573
16933,13565,3368,807,119000,78574
1693,1124,569,1138,220400,78575
3116,2528,588,629,116600,78576
23284,13644,9640,988,111500,78577
4295,3297,998,763,193700,78578
720,536,184,871,-,78579
3597,2401,1196,906,56200,78580
12380,9165,3215,738,102000,78582
1997,1616,381,771,147500,78583
5242,3340,1902,647,83800,78584
0,0,0,-,-,78585
14602,11203,3399,839,83200,78586
63,47,16,530,-,78588
11404,9096,2308,926,112400,78589
109,109,0,-,54500,78590
79,69,10,-,-,78591
174,174,0,-,-,78592
1581,1128,453,876,66900,78593
499,366,133,369,37900,78594
1763,1543,220,615,86400,78595
12143,7827,4316,917,92800,78596
1540,1029,511,1421,508800,78597
92,84,8,-,-,78598
9225,6642,2583,954,113300,78599
12488,8684,3804,1331,310300,78602
2725,2423,302,1181,270800,78605
2853,2115,738,865,361100,78606
89,65,24,-,352800,78607
163,144,19,-,344400,78608
922,742,180,938,276100,78609
16828,13537,3291,1736,379300,78610
5583,4550,1033,1111,291400,78611
5724,4646,1078,1642,239100,78612
33646,21791,11855,1733,461900,78613
164,142,22,-,300000,78614
468,394,74,817,348900,78615
2878,2422,456,1300,174800,78616
8702,7065,1637,1449,247800,78617
138,120,18,888,319400,78618
2420,2217,203,1245,709400,78619
7531,6496,1035,1674,624800,78620
9904,7987,1917,1317,262300,78621
140,100,40,1382,172900,78622
594,594,0,-,564200,78623
9875,6927,2948,1347,439600,78624
15850,9944,5906,1752,358500,78626
17054,12825,4229,1552,467700,78628
4671,3027,1644,812,193200,78629
1155,951,204,1188,339100,78631
570,539,31,-,184400,78632
14267,12991,1276,1836,443500,78633
14942,11661,3281,2024,334200,78634
27,10,17,-,-,78635
1639,1111,528,1037,458800,78636
751,629,122,1252,301500,78638
3813,2820,993,964,249100,78639
24360,17519,6841,1572,291100,78640
32254,25515,6739,1873,453100,78641
7980,6867,1113,1475,486800,78642
3042,2229,813,951,308800,78643
7062,5071,1991,1162,242900,78644
6532,5831,701,1455,387200,78645
3278,2361,917,1063,217400,78648
836,803,33,1144,247300,78650
1763,1559,204,2590,480600,78652
12038,10313,1725,1602,328400,78653
7904,5331,2573,1404,315200,78654
1464,937,527,1012,223000,78655
1061,674,387,1510,194900,78656
3152,2624,528,1406,470100,78657
30,30,0,-,446200,78658
1113,1013,100,-,332800,78659
42673,29818,12855,1769,369300,78660
209,175,34,-,190200,78661
1238,938,300,962,243800,78662
315,267,48,-,-,78663
23299,12608,10691,1645,317400,78664
23318,14875,8443,1945,438700,78665
33836,12980,20856,1294,271900,78666
4672,4193,479,1940,576200,78669
68,44,24,1375,233300,78670
253,130,123,-,-,78671
402,369,33,-,190800,78672
53,36,17,-,43000,78674
64,64,0,-,433300,78675
6667,5265,1402,1432,476100,78676
18,18,0,-,-,78677
20220,15181,5039,1848,460000,78681
7319,3585,3734,2732,653600,78701
13308,5469,7839,1966,644200,78702
11497,6040,5457,2217,1353500,78703
27766,9214,18552,1755,862000,78704
11094,1290,9804,1520,627900,78705
0,0,0,-,-,78712
14149,7580,6569,1833,599200,78717
536,521,15,-,120800,78719
4451,2618,1833,1616,503400,78721
3189,1619,1570,1837,661600,78722
16084,8013,8071,1478,513500,78723
9491,6096,3395,1454,295400,78724
4236,3239,997,2253,306800,78725
6178,2588,3590,1690,648500,78726
14124,6000,8124,1818,483200,78727
12949,3717,9232,1523,392600,78728
14783,5752,9031,1613,434500,78729
4192,2658,1534,1734,1019100,78730
14158,7562,6596,1673,839500,78731
7447,5516,1931,1884,728500,78732
3125,2886,239,3060,964100,78733
9787,8005,1782,1930,626100,78734
9403,4459,4944,1930,791900,78735
4302,2956,1346,1849,556400,78736
8587,7563,1024,2176,689200,78737
11320,8633,2687,1915,754600,78738
7047,6474,573,3387,699400,78739
22918,4148,18770,1477,376500,78741
269,180,89,1094,-,78742
19313,9544,9769,1516,307000,78744
29860,14533,15327,1655,459100,78745
10997,7337,3660,2097,1352500,78746
8600,5996,2604,1776,395500,78747
24500,14124,10376,1711,434100,78748
15726,9628,6098,1843,530900,78749
11852,7599,4253,1743,552800,78750
9302,2018,7284,1627,700500,78751
10450,2234,8216,1445,361200,78752
23992,8217,15775,1447,344100,78753
12629,7571,5058,1704,318900,78754
4664,2095,2569,1383,788600,78756
11318,7044,4274,1661,629500,78757
24285,6184,18101,1549,419300,78758
22350,10369,11981,1680,634400,78759
7254,4742,2512,997,144100,78801
0,0,0,-,-,78802
371,244,127,440,92500,78827
21,21,0,-,-,78828
332,257,75,-,52000,78829
175,134,41,760,80000,78830
1180,904,276,771,88500,78832
316,180,136,945,81000,78833
2438,1437,1001,833,70300,78834
26,15,11,-,-,78836
69,55,14,-,209700,78837
71,71,0,-,-,78838
2668,1856,812,448,91900,78839
16576,11081,5495,957,151500,78840
0,0,0,-,-,78841
0,0,0,-,-,78842
29,0,29,-,-,78843
263,204,59,1197,307500,78850
47,47,0,-,-,78851
17992,12335,5657,789,150200,78852
0,0,0,-,-,78860
4590,3391,1199,1131,210100,78861
372,300,72,833,177700,78870
14,14,0,-,-,78871
411,308,103,2056,96900,78872
621,508,113,840,-,78873
328,253,75,-,-,78877
64,45,19,-,1086500,78879
443,417,26,714,78100,78880
524,388,136,628,81700,78881
125,83,42,-,450000,78883
353,240,113,819,345900,78884
28,22,6,-,361500,78885
163,163,0,-,156300,78886
68,68,0,-,-,78931
246,231,15,1679,355300,78932
444,420,24,-,375000,78933
2387,1770,617,1052,215400,78934
367,367,0,-,-,78935
108,90,18,775,217900,78938
934,875,59,910,256900,78940
1294,1019,275,882,171900,78941
3655,2731,924,1091,235600,78942
116,10,106,-,-,78943
269,254,15,1313,374200,78944
4268,3328,940,747,299500,78945
330,295,35,-,279800,78946
1958,1554,404,1037,276900,78947
247,177,70,857,-,78948
237,223,14,-,-,78949
880,823,57,-,304500,78950
0,0,0,-,-,78951
468,376,92,-,267400,78953
608,550,58,1155,453500,78954
2029,1437,592,1064,231200,78956
4053,3013,1040,1169,246500,78957
688,512,176,832,214800,78959
2090,1693,397,546,222500,78962
232,232,0,-,231000,78963
69,39,30,1188,143800,79001
8,8,0,-,-,79002
43,27,16,-,74100,79003
548,433,115,860,144000,79005
4685,3638,1047,846,94700,79007
0,0,0,-,-,79008
550,346,204,853,113500,79009
109,79,30,-,-,79010
80,54,26,954,240000,79011
0,0,0,-,-,79012
873,380,493,725,58100,79013
1339,1021,318,950,213700,79014
8406,5643,2763,976,267900,79015
0,0,0,-,-,79016
163,95,68,781,91300,79018
706,593,113,983,185700,79019
18,4,14,-,-,79021
3243,2338,905,1050,166900,79022
144,99,45,589,111200,79024
0,0,0,-,-,79025
1560,1050,510,910,101400,79027
5308,3235,2073,1002,152800,79029
475,382,93,803,93300,79031
64,51,13,-,92800,79032
8,8,0,-,-,79033
187,155,32,638,121900,79034
1840,1319,521,1014,137700,79035
1656,1526,130,1094,116500,79036
302,251,51,875,119000,79039
711,537,174,792,173600,79040
1045,867,178,625,101300,79041
401,328,73,988,119100,79042
482,266,216,1036,62700,79043
330,226,104,1538,193600,79044
5946,3918,2028,921,111800,79045
195,170,25,725,108800,79046
3,3,0,-,-,79051
408,293,115,821,98200,79052
28,18,10,-,-,79053
192,157,35,970,43400,79054
41,41,0,-,87200,79056
409,311,98,925,90400,79057
0,0,0,-,-,79058
258,217,41,769,126800,79059
100,90,10,-,96900,79061
94,77,17,585,78500,79062
241,224,17,-,196300,79063
755,529,226,843,81300,79064
7344,5383,1961,897,105400,79065
6,6,0,-,-,79066
1267,949,318,981,158100,79068
3672,2512,1160,905,135300,79070
8351,4595,3756,813,106400,79072
0,0,0,-,-,79073
49,48,1,-,-,79078
945,760,185,1060,84800,79079
174,139,35,847,39400,79080
1173,870,303,763,135900,79081
118,73,45,-,53600,79082
719,581,138,875,98200,79083
534,436,98,826,121100,79084
0,0,0,-,-,79085
1191,938,253,976,130200,79086
306,215,91,807,101800,79087
1858,1132,726,711,88700,79088
0,0,0,-,-,79091
442,357,85,1109,157900,79092
40,40,0,-,223900,79093
6,6,0,-,-,79094
883,650,233,623,109000,79095
725,553,172,945,144700,79096
488,382,106,884,182400,79097
207,169,38,1092,140900,79098
1132,142,990,898,152300,79101
4150,2232,1918,891,146500,79102
3609,2386,1223,1197,123900,79103
2513,1348,1165,905,94500,79104
11616,5839,5777,995,163100,79106
10152,5552,4600,1016,88400,79107
4353,3336,1017,1035,150600,79108
18097,10867,7230,945,217600,79109
6930,4837,2093,1173,153400,79110
417,5,412,1222,-,79111
10239,8012,2227,1328,224000,79118
9229,5974,3255,1217,335700,79119
2647,1970,677,976,254100,79121
4389,3880,509,1158,325900,79124
2205,1413,792,934,112500,79201
67,42,25,-,118800,79220
21,21,0,-,-,79223
300,224,76,823,75000,79225
1030,729,301,727,92900,79226
466,310,156,577,69400,79227
142,130,12,-,47500,79229
13,10,3,-,-,79230
14,14,0,-,-,79231
25,24,1,-,63300,79233
43,24,19,-,213300,79234
1124,774,350,498,105000,79235
85,33,52,-,-,79236
211,186,25,634,72900,79237
47,41,6,-,95000,79239
10,10,0,-,-,79240
791,674,117,750,98800,79241
9,7,2,-,112500,79243
295,240,55,581,85200,79244
932,699,233,608,79100,79245
14,14,0,-,-,79247
513,391,122,323,49700,79248
469,321,148,637,72600,79250
13,13,0,-,137500,79251
1025,707,318,637,80300,79252
199,157,42,760,65000,79255
117,77,40,900,49400,79256
351,295,56,-,82100,79257
4,4,0,-,-,79258
5,5,0,-,-,79259
142,93,49,605,87500,79261
1388,1090,298,758,150400,79311
305,221,84,969,50500,79312
589,428,161,928,69700,79313
34,19,15,-,29700,79314
3810,2457,1353,814,110700,79316
727,441,286,512,67300,79322
2389,1709,680,699,190800,79323
9,6,3,-,-,79324
691,462,229,1133,137500,79325
18,18,0,-,-,79326
1251,960,291,682,194500,79329
51,23,28,-,-,79330
3997,2776,1221,890,90300,79331
5800,4138,1662,803,124900,79336
2481,1727,754,1019,76500,79339
116,116,0,-,160200,79342
500,408,92,928,123200,79343
0,0,0,-,-,79344
311,197,114,811,69300,79345
749,468,281,723,57500,79346
2308,1777,531,748,104900,79347
131,128,3,-,45000,79350
397,293,104,786,96100,79351
11,11,0,-,-,79353
609,410,199,868,118400,79355
1415,988,427,784,83100,79356
756,575,181,773,69500,79357
470,355,115,1008,200400,79358
1245,847,398,676,92700,79359
5340,4350,990,854,199100,79360
2071,1728,343,1138,201200,79363
2577,1807,770,1018,89200,79364
462,455,7,-,311600,79366
226,141,85,869,66600,79367
12,12,0,-,-,79369
527,438,89,761,67200,79370
567,451,116,875,103800,79371
580,423,157,628,96600,79372
1107,839,268,963,121300,79373
4,4,0,-,-,79376
88,50,38,-,128800,79377
93,68,25,518,143500,79378
184,151,33,771,75500,79379
29,21,8,-,-,79380
510,429,81,689,168000,79381
3434,2692,742,1349,245100,79382
20,9,11,-,-,79383
3822,439,3383,1048,101500,79401
0,0,0,-,-,79402
5770,3516,2254,946,83100,79403
3333,2152,1181,958,86300,79404
0,0,0,-,-,79406
10673,4771,5902,1131,200700,79407
4425,1523,2902,1315,211300,79410
2894,906,1988,942,85000,79411
5855,2780,3075,964,117200,79412
8892,5157,3735,1325,195900,79413
8436,2860,5576,1100,150500,79414
6525,2551,3974,956,94000,79415
14528,7010,7518,1269,196900,79416
17326,12206,5120,1284,222500,79423
21586,14920,6666,1151,279600,79424
1135,938,197,921,88400,79501
432,368,64,620,54100,79502
123,103,20,-,117300,79503
1044,812,232,739,112500,79504
61,40,21,520,61300,79505
239,186,53,746,113100,79506
466,402,64,1055,150000,79508
2935,2455,480,913,154200,79510
475,424,51,1173,265700,79511
2095,1674,421,702,84700,79512
47,38,9,-,-,79517
51,23,28,-,67500,79518
57,50,7,-,228800,79519
1075,764,311,847,72700,79520
1328,909,419,792,108900,79521
1155,1119,36,593,123800,79525
382,327,55,747,145500,79526
85,81,4,-,121900,79527
201,163,38,869,101600,79528
446,295,151,772,66000,79529
185,163,22,950,74200,79530
395,302,93,367,102000,79532
233,192,41,-,52700,79533
127,118,9,-,216700,79534
57,51,6,-,91900,79535
1980,1586,394,1187,133300,79536
24,15,9,-,-,79537
71,66,5,-,326700,79538
72,56,16,738,75000,79539
29,29,0,-,-,79540
597,494,103,-,-,79541
477,400,77,665,73000,79543
145,138,7,725,-,79544
674,568,106,1014,100600,79545
739,561,178,618,67700,79546
395,324,71,1037,75000,79547
67,56,11,-,100000,79548
5500,4202,1298,918,108500,79549
1332,836,496,1033,66800,79553
5057,3233,1824,855,97800,79556
6,4,2,-,-,79560
232,192,40,677,82700,79561
1368,1220,148,2000,239100,79562
374,328,46,950,59100,79563
85,75,10,-,107500,79565
100,100,0,-,-,79566
1155,821,334,743,73700,79567
7817,3579,4238,988,182900,79601
9665,7423,2242,1123,233000,79602
8826,5072,3754,1022,114000,79603
11448,6577,4871,1077,159800,79605
12152,6880,5272,1165,248500,79606
928,86,842,1355,490000,79607
0,0,0,-,-,79699
10413,6733,3680,1336,204000,79701
7858,5168,2690,1466,220600,79703
18548,13288,5260,1431,329300,79705
11436,9467,1969,897,280500,79706
16126,9632,6494,1383,382400,79707
279,222,57,-,142000,79713
6780,5173,1607,1364,188200,79714
201,156,45,1088,59500,79718
98,83,15,-,99300,79719
11328,7731,3597,994,146500,79720
0,0,0,-,-,79721
38,38,0,-,-,79730
1584,1274,310,883,120600,79731
144,60,84,382,-,79733
776,690,86,1314,251300,79734
4352,3081,1271,978,151600,79735
129,77,52,-,85800,79738
358,218,140,-,237800,79739
83,57,26,1433,110900,79741
243,202,41,633,91400,79742
94,77,17,-,91100,79743
605,437,168,965,128200,79744
2280,1939,341,907,118200,79745
81,39,42,-,-,79748
229,98,131,944,173500,79749
815,583,232,1025,96200,79752
36,4,32,-,-,79754
5,5,0,-,-,79755
3657,2802,855,960,153200,79756
950,825,125,1609,360400,79758
0,0,0,-,-,79759
12429,7098,5331,1246,158400,79761
15739,9020,6719,1338,218900,79762
13644,9724,3920,1097,127300,79763
9628,6596,3032,944,150400,79764
9306,5686,3620,1535,299800,79765
3379,2718,661,1100,151200,79766
0,0,0,-,-,79769
0,0,0,-,-,79770
3939,3115,824,986,116000,79772
0,0,0,-,-,79776
43,34,9,-,191700,79777
497,401,96,664,116400,79778
10,10,0,-,-,79780
65,65,0,-,208800,79781
1594,1138,456,1232,162800,79782
15,11,4,-,162500,79783
16,16,0,-,51400,79785
283,266,17,-,83100,79788
501,467,34,696,141400,79789
1839,1428,411,973,135700,79821
4037,2575,1462,811,218700,79830
0,0,0,-,-,79832
285,5,280,774,-,79834
3884,2840,1044,921,103200,79835
2287,1929,358,971,107500,79836
96,34,62,-,36700,79837
1834,1430,404,645,89700,79838
286,205,81,-,50800,79839
198,104,94,-,143500,79842
1220,931,289,460,228300,79843
1102,793,309,-,82700,79845
18,18,0,-,-,79846
88,54,34,-,66000,79847
406,355,51,-,137800,79848
3774,2711,1063,878,104200,79849
185,121,64,1016,71500,79851
330,135,195,-,117300,79852
911,854,57,-,84900,79853
71,71,0,-,84500,79854
690,520,170,971,84500,79855
3743,289,3454,517,93100,79901
8656,3578,5078,777,223300,79902
5828,3414,2414,883,118300,79903
12328,5224,7104,1017,117400,79904
7931,3847,4084,646,103900,79905
1485,0,1485,1510,-,79906
16276,9607,6669,910,110600,79907
1121,19,1102,1753,-,79908
3360,2609,751,1421,293500,79911
30487,16851,13636,1191,248400,79912
12910,7799,5111,808,117600,79915
0,0,0,-,-,79916
0,0,0,-,-,79918
0,0,0,-,-,79920
2600,2297,303,1193,297300,79922
21616,13299,8317,1062,131200,79924
15128,7668,7460,1039,176300,79925
13566,10694,2872,1070,125300,79927
23700,20962,2738,1145,188600,79928
9878,4437,5441,909,124000,79930
10509,7577,2932,1042,253300,79932
9843,6769,3074,1387,197300,79934
6682,3411,3271,1070,194700,79935
35726,24113,11613,1214,169500,79936
28641,23251,5390,1433,199700,79938
9451,4700,4751,1733,538900,80002
13871,9662,4209,1729,486600,80003
14548,10703,3845,1771,590600,80004
11276,9903,1373,2058,620100,80005
6482,6174,308,2730,818400,80007
14267,5850,8417,1400,385700,80010
18449,9987,8462,1607,367200,80011
19275,9807,9468,1697,398300,80012
25688,19706,5982,1978,453700,80013
18945,11325,7620,1800,386500,80014
24818,20410,4408,2190,558900,80015
23283,18745,4538,2140,707700,80016
13992,8645,5347,1755,383700,80017
5631,5006,625,2542,558800,80018
1843,1585,258,1242,529300,80019
21077,13901,7176,2024,570100,80020
16402,8498,7904,2054,530300,80021
19026,14331,4695,1507,448400,80022
10080,7665,2415,2073,820900,80023
36,36,0,-,-,80024
46,46,0,-,643800,80025
13942,9417,4525,2054,664000,80026
12692,8565,4127,2234,822700,80027
6493,3722,2771,1296,422300,80030
14628,10456,4172,1911,499200,80031
12650,6203,6447,1536,568900,80033
770,7,763,2011,-,80045
214,160,54,2258,411100,80101
2023,1790,233,1358,491200,80102
1018,818,200,1336,503300,80103
13486,10810,2676,1816,586800,80104
778,704,74,943,374400,80105
1825,1724,101,1255,666800,80106
5143,4976,167,1779,663900,80107
12178,10278,1900,1995,813500,80108
9449,7497,1952,2245,648900,80109
10159,5770,4389,1582,455600,80110
13035,8271,4764,2063,890500,80111
16399,8582,7817,1948,627500,80112
10754,5459,5295,1588,699600,80113
1869,1814,55,2058,904600,80116
904,820,84,1292,623600,80117
2201,2082,119,2457,826900,80118
13578,8346,5232,1607,596400,80120
7293,6284,1009,1945,684900,80121
12741,10665,2076,2094,599400,80122
19148,14085,5063,1958,581800,80123
9841,5309,4532,2055,726600,80124
5253,4942,311,2882,708200,80125
15913,13351,2562,2379,713500,80126
17026,14578,2448,2102,663900,80127
14241,11981,2260,1934,554100,80128
12211,8735,3476,2283,643400,80129
9337,7270,2067,2564,652700,80130
112,92,20,-,395800,80131
10103,8869,1234,2134,700900,80132
1004,879,125,1913,452500,80133
28030,22566,5464,2027,643200,80134
1588,1410,178,1907,895300,80135
1986,1760,226,1234,495700,80136
607,595,12,-,698400,80137
12264,9671,2593,1919,679800,80138
11749,2612,9137,2246,677100,80202
15882,3347,12535,1569,462500,80203
16993,6614,10379,1724,579900,80204
17614,6686,10928,1816,627600,80205
14033,6259,7774,1694,892200,80206
9071,6717,2354,1819,661900,80207
14907,7152,7755,1981,971500,80209
17401,9685,7716,1963,870500,80210
19736,9708,10028,1931,747800,80211
10173,6644,3529,1714,705300,80212
12336,4946,7390,1516,519900,80214
8687,5029,3658,1728,615500,80215
6485,1807,4678,1934,392500,80216
12290,4333,7957,1475,653900,80218
20933,12075,8858,1464,426200,80219
16820,9714,7106,1621,739600,80220
14654,10017,4637,1642,449700,80221
11185,5051,6134,1715,596300,80222
8692,4116,4576,1650,497900,80223
8474,4887,3587,1636,565400,80224
13825,7138,6687,1738,547000,80226
15527,10333,5194,1786,535000,80227
15212,10337,4875,1819,607300,80228
19498,13200,6298,1719,382900,80229
5420,2712,2708,2025,798800,80230
16148,6221,9927,1727,489900,80231
9334,6694,2640,1715,487100,80232
17820,10928,6892,1863,441300,80233
12302,7320,4982,1772,493900,80234
4049,2146,1903,1768,544000,80235
6329,3791,2538,1636,495800,80236
11734,5141,6593,1845,587400,80237
11261,8022,3239,2071,806400,80238
13438,7915,5523,1903,394500,80239
12237,9580,2657,2036,502300,80241
7457,1589,5868,1661,659700,80246
14713,5929,8784,1754,295400,80247
12975,9836,3139,2083,457500,80249
12388,7663,4725,1532,188200,80260
0,0,0,-,-,80264
0,0,0,-,-,80266
357,0,357,2265,-,80290
0,0,0,-,-,80293
0,0,0,-,-,80294
12198,6603,5595,1999,761500,80301
12443,4984,7459,1850,1123800,80302
11496,5228,6268,1833,941600,80303
11179,7773,3406,1956,1166100,80304
6923,4317,2606,2198,985700,80305
2,0,2,-,-,80310
17024,11235,5789,1868,748800,80401
8493,7384,1109,2210,797100,80403
0,0,0,-,-,80419
594,340,254,1865,572500,80420
3925,3560,365,2235,552400,80421
2352,1925,427,1184,505800,80422
59,59,0,-,541700,80423
3927,2912,1015,2029,970000,80424
131,131,0,-,509200,80425
24,24,0,-,-,80426
349,175,174,1622,380100,80427
238,200,38,-,723500,80428
55,44,11,-,363200,80430
189,189,0,-,340900,80432
3429,3192,237,2651,697700,80433
16,4,12,-,-,80434
2933,1729,1204,1539,882100,80435
171,171,0,-,370900,80436
419,263,156,1216,299300,80438
10240,9143,1097,1870,838000,80439
1351,1074,277,1884,448700,80440
960,574,386,1575,596700,80442
1874,1226,648,2542,844400,80443
589,388,201,1361,440000,80444
1613,1185,428,1393,506400,80446
1100,816,284,-,575600,80447
0,0,0,-,-,80448
527,527,0,-,411900,80449
338,279,59,1183,386700,80451
1451,1159,292,1197,420500,80452
138,111,27,-,450000,80453
549,487,62,-,757400,80454
169,140,29,1208,535700,80455
222,209,13,-,492600,80456
172,153,19,-,385600,80457
832,685,147,1598,353500,80459
2747,2050,697,1612,395100,80461
48,48,0,-,-,80463
6156,5577,579,2270,628800,80465
1632,1049,583,1707,659900,80466
1058,884,174,1413,644400,80467
113,61,52,810,617200,80468
175,127,48,-,322500,80469
1631,1557,74,1800,630900,80470
0,0,0,-,-,80471
45,9,36,-,-,80473
136,136,0,-,602200,80474
9,9,0,-,-,80475
132,103,29,966,555300,80476
605,576,29,-,993100,80478
21,21,0,-,-,80479
518,407,111,-,219200,80480
224,194,30,1917,551500,80481
699,566,133,1654,562500,80482
208,175,33,-,346400,80483
7818,5760,2058,1927,915900,80487
3792,2850,942,1738,721700,80498
18318,10619,7699,1586,461400,80501
15011,10276,4735,1843,704800,80503
22824,18037,4787,1895,556500,80504
306,221,85,1318,772100,80510
801,694,107,-,618300,80512
6362,5609,753,1709,558100,80513
2212,1810,402,1823,448200,80514
320,296,24,-,539800,80515
12960,11534,1426,2718,683600,80516
4857,3847,1010,1451,670200,80517
694,579,115,1611,449000,80520
14343,5293,9050,1412,541300,80521
16619,11085,5534,1623,527700,80524
24412,14363,10049,1744,563100,80525
18912,10863,8049,1641,520500,80526
8728,5759,2969,1906,654200,80528
2210,2064,146,2182,449200,80530
67,67,0,-,313000,80532
7084,5552,1532,1778,509500,80534
1054,809,245,1099,391500,80535
959,933,26,-,580600,80536
19684,12581,7103,1630,460100,80537
21349,14724,6625,1730,472200,80538
1993,1707,286,2016,787800,80540
1778,1729,49,2694,590500,80542
3202,2865,337,-,403600,80543
0,0,0,-,-,80544
496,489,7,-,399100,80545
46,25,21,-,-,80546
2674,2257,417,2040,719400,80547
5008,4182,826,2290,452800,80549
16698,13448,3250,1791,538900,80550
13405,9506,3899,1729,471900,80601
13702,12630,1072,2574,639300,80602
5686,5109,577,1841,448700,80603
1541,1186,355,973,403300,80610
219,196,23,950,418900,80611
148,148,0,-,608000,80612
3533,3306,227,1661,489400,80615
6427,4414,2013,1463,315400,80620
4929,3521,1408,1389,425900,80621
92,74,18,-,-,80622
281,243,38,1900,287000,80623
265,233,32,-,482100,80624
17685,8245,9440,1209,300400,80631
24460,17754,6706,1567,405300,80634
4844,4036,808,2138,464400,80640
1474,1249,225,1160,568400,80642
1599,1225,374,1686,455200,80643
884,689,195,717,387400,80644
1713,1467,246,1248,404300,80645
0,0,0,-,-,80646
548,532,16,2192,393600,80648
148,130,18,1094,541700,80649
666,590,76,1125,310800,80650
1635,1413,222,1602,438000,80651
150,127,23,-,473000,80652
366,263,103,1030,343700,80653
1099,799,300,1096,396500,80654
6378,3940,2438,1096,318100,80701
402,294,108,906,148100,80705
1026,729,297,1102,209100,80720
79,57,22,-,337100,80721
188,155,33,-,235200,80722
2528,1683,845,1076,276000,80723
225,140,85,893,228800,80726
220,184,36,742,115500,80727
427,337,90,943,179200,80728
180,133,47,638,253600,80729
674,511,163,848,230900,80731
15,15,0,-,114400,80732
208,152,56,1089,222600,80733
1194,875,319,1000,263800,80734
148,68,80,896,223100,80735
248,198,50,1167,186900,80736
680,465,215,700,147000,80737
57,29,28,-,245000,80740
381,300,81,1208,304900,80741
116,94,22,785,237500,80742
530,386,144,856,227000,80743
203,161,42,781,120800,80744
33,23,10,-,193800,80745
29,10,19,-,183300,80746
208,186,22,875,210000,80747
114,94,20,875,165000,80749
83,83,0,-,248400,80750
6436,4237,2199,1033,232200,80751
56,48,8,-,234600,80754
37,37,0,-,-,80755
110,63,47,-,251500,80757
1430,1063,367,922,242700,80758
1842,1262,580,745,204200,80759
60,51,9,-,193800,80801
54,27,27,1167,154200,80802
181,131,50,550,146500,80804
131,101,30,825,203600,80805
1718,1177,541,1002,226300,80807
2497,2011,486,970,328300,80808
442,385,57,1969,496000,80809
527,387,140,874,181900,80810
107,76,31,950,165600,80812
843,510,333,1171,302600,80813
2102,1703,399,1423,432500,80814
431,238,193,820,207100,80815
3046,2895,151,1816,382300,80816
11091,8095,2996,1758,377300,80817
177,151,26,882,214100,80818
379,316,63,1618,429700,80819
303,264,39,-,392300,80820
555,391,164,892,250700,80821
102,73,29,1138,162500,80822
94,68,26,617,179400,80823
138,91,47,-,279200,80824
138,109,29,621,252500,80825
0,0,0,-,-,80826
447,402,45,-,447500,80827
962,673,289,1167,232500,80828
2587,1592,995,1175,567000,80829
73,67,6,-,437500,80830
10640,9922,718,2388,495800,80831
368,331,37,1313,391000,80832
464,411,53,900,194000,80833
145,116,29,825,208300,80834
335,239,96,1141,242700,80835
434,299,135,1463,200800,80836
672,0,672,2223,-,80840
300,178,122,615,184000,80860
103,87,16,875,246400,80861
30,21,9,-,279200,80862
5261,4226,1035,1960,503400,80863
609,520,89,1389,300000,80864
3401,0,3401,2052,-,80902
7576,3144,4432,1221,420000,80903
10924,6178,4746,1417,413400,80904
8363,4036,4327,1449,349500,80905
15387,9767,5620,1634,543400,80906
12599,7165,5434,1392,371200,80907
8260,7536,724,1460,673900,80908
15941,8593,7348,1227,352400,80909
13306,6220,7086,1299,276900,80910
12207,9972,2235,1643,348900,80911
0,0,0,-,-,80913
14,0,14,-,-,80914
9035,6526,2509,1424,328200,80915
14734,8100,6634,1505,289500,80916
13493,7972,5521,1435,353100,80917
19509,12524,6985,1572,414400,80918
11564,8680,2884,1800,570200,80919
14337,9659,4678,1955,484900,80920
9864,7617,2247,2212,647600,80921
11215,8069,3146,1952,407000,80922
12424,8776,3648,1997,448800,80923
6022,3975,2047,2131,621700,80924
5462,4584,878,2260,441100,80925
703,620,83,780,579100,80926
2334,2176,158,3109,530300,80927
282,256,26,2295,355000,80928
23,23,0,-,-,80929
608,203,405,2013,325800,80930
382,351,31,-,487900,80938
0,0,0,-,-,80939
1549,1122,427,2108,384200,80951
12621,6877,5744,1027,208400,81001
5657,2667,2990,847,178600,81003
11385,6441,4944,1002,181200,81004
12990,10026,2964,990,282100,81005
4461,3570,891,1176,317200,81006
12335,10725,1610,1319,371600,81007
5159,3432,1727,1396,280400,81008
704,501,203,1270,229000,81019
510,408,102,-,109600,81020
11,7,4,-,-,81021
538,421,117,1358,215000,81022
670,562,108,1338,352700,81023
108,108,0,-,291300,81024
365,319,46,1458,134700,81025
60,51,9,-,55800,81027
126,101,25,950,-,81029
98,71,27,1081,97200,81030
55,44,11,-,77000,81033
439,323,116,903,157500,81036
825,532,293,871,175900,81039
171,158,13,-,-,81040
294,193,101,666,106500,81041
29,25,4,-,-,81043
63,49,14,825,95500,81044
26,17,9,780,78800,81045
2,2,0,-,-,81046
660,459,201,293,157700,81047
93,59,34,-,134400,81049
4219,2917,1302,764,181500,81050
3361,2379,982,841,150400,81052
1533,951,582,860,124200,81054
763,652,111,1043,375600,81055
157,135,22,875,212500,81057
396,326,70,728,123000,81058
30,26,4,-,180600,81059
365,234,131,1034,133000,81062
744,451,293,1009,108600,81063
130,98,32,480,58600,81064
1956,1256,700,927,139100,81067
900,778,122,2517,347300,81069
107,57,50,850,-,81071
813,554,259,568,137500,81073
180,136,44,811,55600,81076
284,263,21,-,143700,81077
69,28,41,-,-,81081
5296,3619,1677,915,219400,81082
24,24,0,-,60000,81084
97,64,33,457,71400,81087
1802,1280,522,728,180800,81089
410,304,106,283,151100,81090
516,389,127,670,301900,81091
315,243,72,775,247700,81092
6185,3447,2738,908,216900,81101
930,677,253,803,134800,81120
136,127,9,-,268800,81121
3525,2976,549,1536,445900,81122
351,287,64,-,123800,81123
67,67,0,-,74900,81124
1558,975,583,519,138300,81125
130,110,20,-,167600,81126
10,10,0,-,-,81128
65,0,65,-,-,81129
428,313,115,903,404800,81130
666,558,108,1259,345500,81131
1540,1185,355,947,192100,81132
487,432,55,881,258500,81133
117,78,39,644,194400,81136
2221,1646,575,1073,309500,81137
27,14,13,-,-,81138
774,586,188,719,233100,81140
433,357,76,693,176200,81141
402,319,83,910,159400,81143
2840,1905,935,752,217500,81144
276,203,73,784,225900,81146
5578,4300,1278,1428,458100,81147
188,154,34,680,112500,81148
525,368,157,782,119000,81149
655,478,177,764,156900,81151
533,347,186,719,135900,81152
559,439,120,919,409000,81154
135,90,45,1008,466700,81155
4644,3187,1457,1614,631700,81201
251,163,88,-,628900,81210
3459,2500,959,1413,566200,81211
11703,8632,3071,1063,286300,81212
100,90,10,-,637100,81220
132,112,20,1125,205300,81221
116,116,0,-,335700,81222
1025,950,75,-,322800,81223
1725,1270,455,1408,862100,81224
440,313,127,1717,594600,81225
2383,1703,680,726,240700,81226
0,0,0,-,-,81227
0,0,0,-,-,81228
4809,2945,1864,1114,495200,81230
0,0,0,-,-,81232
542,431,111,488,386500,81233
428,336,92,1099,456500,81235
623,604,19,-,655900,81236
65,65,0,-,481300,81237
67,67,0,-,-,81239
1603,1319,284,1364,282300,81240
81,78,3,-,418600,81241
490,437,53,1569,479000,81242
70,47,23,-,454200,81243
223,200,23,797,191400,81244
90,55,35,-,-,81248
212,200,12,-,482600,81251
2150,1878,272,933,362200,81252
225,201,24,-,288600,81253
12966,8473,4493,1433,634900,81301
3696,2659,1037,1424,535800,81303
230,230,0,-,250000,81320
5693,4065,1628,1010,259500,81321
2316,1738,578,1041,338900,81323
825,673,152,-,204300,81324
62,62,0,-,457100,81325
1095,967,128,1254,515200,81326
210,204,6,-,366100,81327
2011,1779,232,1068,409700,81328
78,0,78,-,-,81330
168,168,0,-,346800,81331
246,201,45,1711,568900,81332
402,177,225,349,-,81334
50,50,0,-,437500,81335
9807,6921,2886,1090,343000,81401
4938,3992,946,1335,481900,81403
778,680,98,998,325700,81410
7,5,2,-,-,81411
2286,1794,492,1148,329300,81413
797,700,97,1116,398900,81415
5283,3601,1682,1043,282500,81416
650,497,153,1846,236300,81418
1378,1223,155,1049,352700,81419
243,194,49,836,169000,81422
728,568,160,1265,412000,81423
530,401,129,904,172900,81424
1774,1364,410,995,293500,81425
59,41,18,1188,875000,81426
572,423,149,954,562200,81427
1749,1389,360,1007,371400,81428
36,36,0,-,-,81429
362,299,63,1819,1004000,81430
224,207,17,-,270500,81431
1592,1235,357,1469,771400,81432
333,172,161,1076,402900,81433
31,31,0,-,638200,81434
2834,1684,1150,1137,706100,81435
10874,5126,5748,974,283300,81501
6197,4838,1359,1015,307600,81503
12611,9922,2689,1414,290300,81504
5241,3647,1594,1424,436800,81505
5328,3278,2050,1211,428000,81506
6742,6113,629,1580,491300,81507
5207,3418,1789,1013,228000,81520
6346,5281,1065,1249,385300,81521
12,12,0,-,-,81522
496,422,74,-,786100,81523
862,738,124,1702,718800,81524
472,244,228,1604,442200,81525
2323,1766,557,1219,449300,81526
572,490,82,1279,431300,81527
5972,3722,2250,1812,726000,81601
188,155,33,872,-,81610
5088,3198,1890,1822,1243500,81611
35,0,35,-,-,81612
1611,1143,468,1951,1748000,81615
4405,2384,2021,2199,951800,81620
2704,1826,878,2220,1138500,81621
6555,4465,2090,2094,835000,81623
504,442,62,1563,467300,81624
5001,3610,1391,1059,266900,81625
363,304,59,1275,276100,81630
2931,2107,824,1685,717600,81631
3932,2611,1321,1885,734300,81632
0,0,0,-,-,81633
2920,1982,938,998,251900,81635
3138,2391,747,2162,549800,81637
44,38,6,-,-,81638
1048,844,204,1680,415500,81639
63,20,43,-,-,81640
1514,1099,415,983,313500,81641
12,0,12,-,-,81642
369,338,31,-,581900,81643
419,290,129,2167,1072300,81645
86,73,13,-,470700,81646
2659,2026,633,1581,470000,81647
1052,869,183,774,199300,81648
122,90,32,1450,742600,81649
4830,3664,1166,1236,397100,81650
2223,1833,390,2030,505200,81652
0,0,0,-,-,81653
786,636,150,-,865400,81654
106,106,0,-,"2,000,000+",81655
273,273,0,-,"2,000,000+",81656
2520,1717,803,1696,1048600,81657
16771,10458,6313,1044,291400,82001
0,0,0,-,-,82005
9055,5696,3359,1120,218400,82007
14599,12145,2454,1106,415000,82009
122,111,11,-,141300,82050
28,28,0,-,-,82051
44,44,0,-,605300,82052
695,592,103,1739,246700,82053
313,287,26,-,555000,82054
193,184,9,-,495500,82055
18,18,0,-,-,82058
113,113,0,-,460900,82059
122,122,0,-,372500,82060
0,0,0,-,-,82061
33,33,0,-,295000,82063
8951,4529,4422,960,325500,82070
7104,3195,3909,901,313300,82072
15,15,0,-,-,82073
7,0,7,-,-,82081
719,578,141,725,316300,82082
141,64,77,1558,127300,82083
79,79,0,-,479200,82084
75,0,75,-,-,82190
2974,2083,891,728,250200,82201
137,124,13,682,216700,82210
307,247,60,1037,232100,82212
302,229,73,1607,245300,82213
440,352,88,963,215900,82214
83,60,23,-,-,82215
23,23,0,-,-,82217
5,5,0,-,-,82218
29,29,0,-,342300,82219
263,190,73,581,229400,82221
56,50,6,-,230900,82222
356,246,110,742,231600,82223
1,1,0,-,-,82224
862,515,347,783,200500,82225
139,121,18,763,75000,82227
17,17,0,-,-,82229
3744,2723,1021,788,233900,82240
74,62,12,-,320500,82242
93,93,0,-,-,82243
184,144,40,732,191700,82244
3229,2372,857,833,208000,82301
0,0,0,-,-,82310
283,208,75,908,224000,82321
69,60,9,718,-,82322
64,59,5,-,118100,82323
58,40,18,-,218200,82324
428,371,57,1100,212900,82325
353,252,101,1317,121100,82327
183,156,27,850,75300,82329
1026,851,175,971,299600,82331
19,10,9,-,-,82332
193,170,23,1172,201400,82334
0,0,0,-,-,82335
62,28,34,-,-,82336
3112,2357,755,728,186600,82401
748,624,124,914,185100,82410
157,124,33,-,172500,82411
193,137,56,-,163600,82412
7252,5320,1932,1036,421100,82414
276,232,44,-,229400,82420
176,170,6,875,156000,82421
28,0,28,-,-,82422
83,48,35,669,114100,82423
1154,905,249,893,189900,82426
61,26,35,-,92900,82428
40,37,3,-,84400,82430
1168,895,273,843,216500,82431
141,91,50,-,-,82432
525,326,199,732,251600,82433
37,23,14,-,-,82434
5161,4082,1079,847,318200,82435
72,20,52,-,-,82440
116,70,46,-,381400,82441
372,245,127,715,334200,82442
2028,1462,566,972,217500,82443
50,50,0,-,-,82450
7057,4696,2361,870,226400,82501
232,136,96,492,178100,82510
167,115,52,-,-,82512
898,675,223,844,362200,82513
353,218,135,575,94500,82514
158,131,27,792,188200,82515
127,115,12,725,135800,82516
5002,3690,1312,882,318300,82520
360,328,32,1078,225900,82523
11080,7943,3137,856,244200,82601
10995,9180,1815,1090,270800,82604
8471,5383,3088,1043,280800,82609
109,58,51,959,425600,82620
0,0,0,-,-,82630
4031,3143,888,874,274200,82633
39,18,21,531,26300,82635
1511,1095,416,924,266000,82636
1664,1314,350,1072,255000,82637
18,18,0,-,-,82638
313,288,25,1114,251900,82639
80,80,0,-,602900,82640
33,30,3,-,416700,82642
127,114,13,525,70300,82643
910,653,257,976,167900,82644
0,0,0,-,-,82646
8,8,0,-,-,82648
419,335,84,800,154200,82649
2024,1804,220,711,218400,82701
116,116,0,-,286400,82710
11,11,0,-,-,82711
147,104,43,-,-,82712
46,0,46,-,-,82714
6911,5072,1839,890,234700,82716
9389,7588,1801,1042,289900,82718
361,302,59,637,268400,82720
1099,880,219,878,272900,82721
70,70,0,-,-,82723
9,9,0,-,-,82725
805,729,76,-,346000,82727
1058,730,328,962,282900,82729
664,566,98,-,200000,82730
80,31,49,-,-,82731
654,559,95,1037,226300,82732
11128,7438,3690,942,339500,82801
87,84,3,-,-,82831
549,459,90,-,908500,82832
163,163,0,-,678700,82833
3489,2714,775,1080,297000,82834
129,70,59,1167,350000,82835
411,365,46,791,287000,82836
16,7,9,-,-,82837
191,171,20,-,553900,82838
565,471,94,765,374200,82839
296,245,51,-,359800,82842
11,0,11,-,-,82844
48,48,0,-,264700,82845
11237,8203,3034,918,238800,82901
141,141,0,-,855200,82922
294,294,0,-,554600,82923
189,189,0,-,416300,82925
6,0,6,-,-,82929
5431,4070,1361,865,257800,82930
367,245,122,1162,157800,82932
200,158,42,-,347900,82933
100,79,21,-,112500,82934
4715,3632,1083,912,254800,82935
17,17,0,-,-,82936
1168,991,177,1074,245700,82937
128,128,0,-,371100,82938
576,405,171,792,214000,82939
1901,1480,421,1296,323300,82941
9,9,0,-,-,82942
80,14,66,-,-,82943
93,72,21,-,-,82944
90,78,12,-,-,82945
6890,4141,2749,1986,1369000,83001
125,90,35,-,1766700,83011
46,0,46,-,-,83012
167,69,98,-,-,83013
1359,1013,346,1404,1579700,83014
508,199,309,-,"2,000,000+",83025
1534,1199,335,720,188400,83101
1881,1364,517,631,348000,83110
155,155,0,-,-,83111
287,287,0,-,513600,83112
1040,757,283,747,248700,83113
280,229,51,1102,203800,83114
154,154,0,-,619800,83115
288,229,59,643,101000,83116
245,223,22,-,353700,83118
34,0,34,-,-,83119
82,48,34,-,377300,83120
0,0,0,-,-,83121
248,248,0,-,-,83122
288,263,25,1198,301600,83123
62,55,7,-,239300,83124
157,117,40,-,425900,83126
1550,1399,151,1439,431200,83127
806,505,301,1309,581600,83128
14890,9917,4973,905,256100,83201
8405,6090,2315,941,300600,83202
20,6,14,-,-,83203
7763,5034,2729,748,233000,83204
222,0,222,638,-,83209
1180,922,258,675,181500,83210
2147,1484,663,725,195600,83211
154,138,16,-,125900,83212
548,397,151,488,113800,83213
226,193,33,-,250700,83214
9,8,1,-,-,83215
285,260,25,1050,225500,83217
184,165,19,1025,267900,83218
47,47,0,-,-,83220
9283,7501,1782,848,250200,83221
80,67,13,-,361700,83223
953,677,276,708,270700,83226
55,55,0,-,-,83227
339,298,41,829,276500,83228
190,142,48,-,290900,83232
105,105,0,-,-,83233
524,441,83,927,216000,83234
35,35,0,-,-,83235
822,721,101,639,277700,83236
447,353,94,1205,361800,83237
70,64,6,-,314300,83238
204,193,11,1025,194200,83239
720,609,111,710,206000,83241
19,19,0,-,-,83243
181,125,56,-,238700,83244
835,739,96,1061,300800,83245
365,299,66,843,359000,83246
691,648,43,875,296100,83250
569,461,108,628,327200,83251
1906,1659,247,1009,226600,83252
36,28,8,-,-,83253
1374,1094,280,633,200000,83254
405,336,69,835,250000,83255
184,168,16,862,235700,83261
355,305,50,1271,193600,83262
3402,2452,950,785,294600,83263
141,118,23,939,283300,83271
79,78,1,-,237500,83272
3718,2961,757,1097,328000,83274
1450,1139,311,839,224700,83276
59,38,21,-,194400,83277
210,208,2,-,618100,83278
79,79,0,-,303700,83281
45,45,0,-,-,83283
19,19,0,-,450000,83285
447,372,75,1323,322100,83286
121,112,9,-,653800,83287
23325,15457,7868,1011,290600,83301
49,30,19,-,139800,83302
201,176,25,958,280800,83311
77,67,10,-,363800,83312
1282,905,377,1496,512700,83313
315,228,87,860,303500,83314
3878,2980,898,825,248100,83316
6343,4278,2065,924,248700,83318
396,232,164,964,241700,83320
191,124,67,1008,200000,83321
24,5,19,-,-,83322
679,448,231,886,320500,83323
204,153,51,781,241700,83324
239,187,52,825,201500,83325
286,232,54,992,247200,83327
2422,1841,581,1131,293500,83328
2419,1612,807,900,230100,83330
1180,984,196,945,225700,83332
4707,3576,1131,1375,688400,83333
838,484,354,899,228400,83334
761,444,317,608,229800,83335
2140,1479,661,1057,275400,83336
13,4,9,-,-,83337
7164,5476,1688,883,253300,83338
2799,2110,689,1174,860400,83340
2945,2572,373,1019,411600,83341
480,416,64,723,291000,83342
376,260,116,1043,323400,83344
411,366,45,642,221600,83346
1176,902,274,745,274600,83347
33,23,10,-,281900,83348
483,387,96,765,203400,83349
4503,3296,1207,798,218400,83350
1174,916,258,928,202000,83352
565,531,34,2114,829000,83353
9,9,0,-,-,83354
1632,1118,514,770,236600,83355
15369,11465,3904,1132,307700,83401
11036,7073,3963,904,301400,83402
9108,6703,2405,1013,355200,83404
6495,4612,1883,1182,350500,83406
288,261,27,-,1040400,83414
967,832,135,925,320000,83420
158,158,0,-,264200,83421
1334,904,430,1200,472200,83422
215,132,83,770,200000,83423
15,15,0,-,-,83424
184,135,49,1083,222400,83425
807,743,64,1284,368400,83427
246,233,13,-,540400,83428
381,375,6,-,473300,83429
328,265,63,800,238600,83431
17,17,0,-,278100,83433
578,473,105,1134,240400,83434
183,97,86,1643,211200,83435
241,201,40,1131,287500,83436
75,53,22,-,230600,83438
11929,4531,7398,959,372800,83440
7496,6406,1090,1098,376800,83442
444,342,102,1107,154200,83443
416,277,139,1125,180500,83444
2300,1817,483,778,233700,83445
22,20,2,-,-,83446
846,616,230,1356,331100,83448
111,99,12,-,550600,83449
401,253,148,1003,183700,83450
308,272,36,869,288800,83451
825,744,81,991,435500,83452
118,91,27,921,306900,83454
2399,1986,413,1210,708900,83455
0,0,0,-,-,83460
204,204,0,-,366700,83462
55,55,0,-,262500,83463
103,88,15,772,165000,83464
34,27,7,-,237500,83465
57,52,5,-,384000,83466
2766,2200,566,722,277800,83467
75,51,24,850,348800,83468
14,14,0,-,-,83469
15286,10905,4381,948,297300,83501
86,76,10,-,159400,83520
645,498,147,850,237900,83522
342,298,44,940,193900,83523
395,318,77,888,226700,83524
147,121,26,-,286300,83525
101,86,15,613,247900,83526
2488,1812,676,1009,296900,83530
62,48,14,550,325000,83533
511,379,132,712,273400,83535
1730,1415,315,666,233000,83536
405,350,55,957,239800,83537
947,822,125,862,285700,83539
727,488,239,846,189900,83540
501,438,63,832,309500,83541
55,53,2,-,237500,83542
256,210,46,600,186400,83543
2373,1847,526,879,259600,83544
219,198,21,881,250000,83545
255,245,10,850,179200,83546
148,135,13,-,289100,83547
57,47,10,-,152500,83548
320,249,71,673,344000,83549
367,288,79,1271,232700,83552
538,463,75,592,226100,83553
183,175,8,-,350000,83554
184,136,48,775,231000,83555
0,0,0,-,-,83602
263,183,80,524,249700,83604
13528,9086,4442,973,300900,83605
11555,9462,2093,1404,385100,83607
373,281,92,718,261700,83610
943,831,112,1063,405100,83611
863,701,162,811,259700,83612
424,371,53,-,688800,83615
13178,11343,1835,1752,720300,83616
6672,5022,1650,873,364200,83617
3281,2559,722,917,305800,83619
979,855,124,959,503800,83622
612,426,186,725,191900,83623
549,252,297,900,269200,83624
593,434,159,1425,312500,83626
222,165,57,1065,165400,83627
1665,1180,485,943,233300,83628
810,673,137,950,348500,83629
714,585,129,776,373500,83631
148,116,32,781,309100,83632
229,180,49,842,422600,83633
10195,8486,1709,1557,414900,83634
86,29,57,-,-,83636
140,136,4,-,180000,83637
2374,2011,363,1013,685300,83638
1128,845,283,656,397400,83639
1280,1043,237,1079,414700,83641
22100,15905,6195,1629,492300,83642
65,50,15,-,472700,83643
5205,4672,533,1085,392000,83644
330,291,39,800,296500,83645
25954,21137,4817,1814,488000,83646
8760,6193,2567,1041,283600,83647
801,3,798,1821,-,83648
202,166,36,-,308300,83650
13679,10091,3588,1334,312500,83651
672,580,92,888,464600,83654
2023,1731,292,941,345700,83655
218,172,46,1170,238600,83656
69,58,11,-,482900,83657
2169,1509,660,982,363600,83660
3829,2465,1364,852,273400,83661
23,18,5,-,-,83666
5396,4380,1016,1633,535500,83669
296,280,16,-,309700,83670
3386,2424,962,924,244300,83672
1750,1370,380,850,311200,83676
65,55,10,-,-,83677
19756,15149,4607,1310,381800,83686
14003,10020,3983,1416,369700,83687
11768,6050,5718,1175,708000,83702
7826,5003,2823,1336,477000,83703
16905,10808,6097,1363,354400,83704
12406,6799,5607,1166,378800,83705
14841,7182,7659,1378,488900,83706
21567,17839,3728,1743,440700,83709
4401,2558,1843,1368,757700,83712
11712,9101,2611,1716,421600,83713
11263,8279,2984,1384,468100,83714
8354,6572,1782,1949,573300,83716
0,0,0,-,-,83720
0,0,0,-,-,83725
2549,2095,454,1238,495500,83801
23,16,7,-,-,83802
346,310,36,-,661200,83803
835,746,89,1022,281600,83804
3154,2509,645,872,345200,83805
77,74,3,-,120500,83806
46,44,2,-,-,83808
236,236,0,-,-,83809
622,580,42,-,517300,83810
752,420,332,1073,235300,83811
8,8,0,-,137500,83812
465,448,17,-,559900,83813
11915,7015,4900,1223,518800,83814
16101,10956,5145,1445,472300,83815
137,137,0,-,573600,83821
1020,841,179,903,374300,83822
680,606,74,1172,414000,83823
133,103,30,920,334000,83824
79,69,10,-,593800,83825
34,34,0,-,-,83826
80,76,4,-,225000,83827
143,143,0,-,227700,83830
790,687,103,1097,316300,83832
708,653,55,1038,530200,83833
74,74,0,-,407500,83834
9030,7657,1373,1688,502400,83835
499,456,43,988,534000,83836
1364,778,586,909,214600,83837
553,458,95,969,335600,83839
248,203,45,1548,286700,83840
220,200,20,-,336700,83841
45,37,8,-,635400,83842
11317,5542,5775,903,354100,83843
19,0,19,-,-,83844
950,735,215,732,357600,83845
371,286,85,879,171000,83846
675,470,205,-,257900,83847
145,132,13,-,811500,83848
908,756,152,794,192200,83849
968,806,162,878,261900,83850
672,462,210,865,219200,83851
581,172,409,988,381000,83852
19423,13445,5978,1311,433700,83854
771,665,106,708,294000,83855
2731,2327,404,820,373800,83856
467,462,5,-,325700,83857
6718,5601,1117,1244,452700,83858
2851,2455,396,1095,508400,83860
2988,2302,686,873,273100,83861
7902,5599,2303,1136,474100,83864
134,105,29,-,-,83866
185,170,15,-,281900,83867
433,314,119,922,114800,83868
1795,1668,127,737,425300,83869
129,98,31,465,428600,83870
933,830,103,814,333300,83871
347,347,0,-,480400,83872
712,477,235,660,249800,83873
60,60,0,-,-,83874
615,518,97,975,427900,83876
203,187,16,-,219000,84001
119,80,39,-,327600,84002
15678,11775,3903,1692,580600,84003
2988,2617,371,2786,893400,84004
11769,10006,1763,1995,469900,84005
284,155,129,1358,375000,84006
189,115,74,945,324400,84007
0,0,0,-,-,84008
12522,11645,877,1857,570400,84009
15225,10954,4271,1458,486000,84010
198,178,20,-,448000,84013
5689,4896,793,1548,491600,84014
22317,16822,5495,1385,377200,84015
1423,1123,300,1256,547300,84017
79,79,0,-,428200,84018
16325,11702,4623,1812,726000,84020
1101,909,192,1014,235400,84021
228,30,198,1053,356500,84022
40,20,20,240,260000,84023
54,26,28,-,428600,84024
7166,5917,1249,1644,618500,84025
223,137,86,-,165100,84026
227,213,14,-,181300,84027
207,154,53,813,527300,84028
3841,3356,485,1062,435400,84029
93,93,0,-,356300,84031
8145,6227,1918,1830,647900,84032
329,270,59,852,445300,84033
41,24,17,-,-,84034
285,267,18,-,181400,84035
2846,2391,455,1430,705400,84036
11193,9928,1265,1482,603500,84037
214,211,3,-,351400,84038
199,177,22,-,279300,84039
9226,7831,1395,1796,486300,84040
18455,12013,6442,1404,395800,84041
3271,2567,704,1502,639200,84042
22835,17621,5214,1802,567500,84043
8878,7079,1799,1623,341400,84044
10686,8979,1707,2201,566200,84045
222,197,25,1013,238800,84046
16216,7225,8991,1482,404200,84047
2386,1997,389,3013,857400,84049
3526,3172,354,1493,609500,84050
133,116,17,-,237700,84051
392,301,91,883,197900,84052
241,233,8,-,230300,84053
7442,5060,2382,1648,472300,84054
479,435,44,2425,642400,84055
1018,23,995,1717,404200,84056
11779,7470,4309,1408,398400,84057
11132,4690,6442,1395,441900,84058
5253,2677,2576,1799,509900,84059
3426,2438,988,1900,1753100,84060
117,96,21,-,704500,84061
14102,9874,4228,1617,479800,84062
99,85,14,-,258900,84063
243,175,68,618,242600,84064
15522,13314,2208,1783,595000,84065
4766,3686,1080,932,259200,84066
12980,11198,1782,1557,350400,84067
163,131,32,1103,360700,84069
11391,6667,4724,1578,429400,84070
625,609,16,758,453200,84071
157,132,25,1050,270300,84072
93,93,0,-,238400,84073
17627,14688,2939,1197,383300,84074
9251,8475,776,2006,532800,84075
121,107,14,-,328800,84076
9917,6929,2988,907,279000,84078
129,119,10,917,275000,84080
15015,12556,2459,1787,487100,84081
282,278,4,-,577900,84082
423,102,321,688,166700,84083
10245,7476,2769,1658,432100,84084
88,58,30,-,-,84085
153,117,36,-,168400,84086
5169,4432,737,1520,489100,84087
12793,9741,3052,1554,443400,84088
9198,8316,882,2146,706400,84092
7752,7042,710,2090,643800,84093
9545,7335,2210,1851,474700,84094
13279,10056,3223,1794,669600,84095
20599,16774,3825,1888,540500,84096
6906,4910,1996,1414,506900,84097
6926,5787,1139,2729,1117700,84098
4850,1118,3732,1336,541100,84101
10239,2495,7744,1305,487200,84102
12433,5023,7410,1374,710700,84103
7991,4825,3166,1235,318100,84104
10147,6205,3942,1482,632200,84105
15485,9330,6155,1576,529100,84106
16363,7725,8638,1387,426000,84107
7705,5944,1761,1562,759800,84108
8914,7080,1834,1584,679000,84109
7421,1770,5651,1294,423000,84111
182,0,182,1080,-,84112
0,0,0,-,-,84113
0,0,0,-,-,84114
12724,4903,7821,1263,396200,84115
13394,7082,6312,1280,334900,84116
10447,7219,3228,1687,581100,84117
12026,9990,2036,1670,348500,84118
15754,8617,7137,1418,341800,84119
13522,10223,3299,1434,370800,84120
15333,11387,3946,1732,614500,84121
14007,8192,5815,1416,436600,84123
8506,6688,1818,1460,704400,84124
8250,7293,957,1838,404600,84128
12175,9711,2464,1546,399200,84129
0,0,0,-,-,84138
7,7,0,-,-,84150
0,0,0,-,-,84180
283,241,42,1579,381500,84301
8932,6411,2521,957,343100,84302
33,33,0,-,-,84304
273,260,13,921,300000,84305
109,109,0,-,519100,84306
417,351,66,949,365500,84307
72,64,8,1000,278600,84308
178,170,8,-,459400,84309
1605,1463,142,1684,738500,84310
260,201,59,979,369500,84311
1537,1214,323,912,336200,84312
7,0,7,-,-,84313
333,264,69,1036,365900,84314
2688,2672,16,-,532500,84315
88,85,3,-,187500,84316
1063,971,92,1750,646100,84317
1561,1442,119,1269,501200,84318
3051,2623,428,971,375600,84319
791,653,138,848,333700,84320
16019,7875,8144,1037,360300,84321
0,0,0,-,-,84322
422,400,22,1200,570000,84324
684,642,42,753,549400,84325
678,635,43,1188,478900,84326
282,254,28,-,342600,84327
530,500,30,1333,518400,84328
58,42,16,-,335000,84329
142,134,8,588,357100,84330
87,72,15,1313,283300,84331
2651,2233,418,1414,478300,84332
947,830,117,930,351300,84333
73,73,0,-,274500,84334
4686,3756,930,1222,403800,84335
134,106,28,-,278300,84336
4901,3597,1304,1116,357300,84337
186,142,44,650,316700,84338
1630,1464,166,1083,400400,84339
1131,971,160,1563,453000,84340
9044,4025,5019,1248,403800,84341
17203,10192,7011,1179,410700,84401
13793,9480,4313,1172,392700,84403
22909,16979,5930,1304,352700,84404
12214,9289,2925,1266,386500,84405
0,0,0,-,-,84408
10421,9017,1404,1448,454100,84414
4989,3408,1581,840,212900,84501
1468,1010,458,833,245600,84511
239,203,36,-,118800,84512
509,425,84,719,174700,84513
0,0,0,-,-,84515
53,40,13,-,222200,84516
222,172,50,744,142100,84518
395,270,125,1053,84100,84520
227,175,52,712,189500,84521
136,122,14,-,128100,84522
518,405,113,679,231400,84523
348,249,99,560,170700,84525
1832,1265,567,781,209700,84526
973,763,210,684,199600,84528
44,9,35,-,-,84529
135,135,0,-,85000,84530
176,157,19,-,70500,84531
4730,3375,1355,1030,491100,84532
10,0,10,-,-,84533
726,606,120,733,60000,84534
886,743,143,1065,300200,84535
386,352,34,-,49500,84536
442,376,66,777,204300,84537
186,170,16,-,95000,84539
0,0,0,-,-,84540
577,343,234,868,173100,84542
11209,5139,6070,1173,370300,84601
37,0,37,-,-,84602
12190,6181,6009,1128,520500,84604
10810,2398,8412,1149,407600,84606
364,343,21,850,263400,84620
14,14,0,-,-,84621
390,346,44,1042,296700,84622
107,53,54,-,-,84623
1972,1539,433,1007,259600,84624
134,51,83,-,468800,84626
1790,975,815,903,417500,84627
368,356,12,1036,244300,84628
1131,1039,92,991,299800,84629
143,72,71,823,234400,84630
959,713,246,795,260400,84631
488,447,41,1089,326500,84632
286,214,72,1274,246100,84633
591,412,179,1030,248700,84634
281,168,113,950,163500,84635
152,127,25,1163,213800,84636
175,155,20,320,331700,84637
108,106,2,-,254300,84638
279,252,27,-,338900,84639
77,57,20,-,258900,84640
1113,883,230,1076,279600,84642
221,186,35,926,325000,84643
120,108,12,930,245800,84644
783,695,88,770,421000,84645
546,495,51,834,240800,84646
1440,1089,351,1049,280100,84647
2289,1716,573,930,386300,84648
257,233,24,-,203700,84649
8647,7391,1256,1398,423200,84651
266,232,34,-,268500,84652
3188,2966,222,1581,569300,84653
942,704,238,702,258400,84654
4665,4075,590,1165,443300,84655
141,132,9,850,250000,84656
167,141,26,-,274200,84657
12829,10137,2692,1393,452100,84660
566,511,55,842,367300,84662
10705,7526,3179,1475,430600,84663
3395,2955,440,1392,734100,84664
180,164,16,950,418400,84665
108,85,23,853,340600,84667
2880,2020,860,855,296500,84701
54,40,14,950,340000,84710
306,304,2,-,285700,84711
60,48,12,-,500000,84712
1472,1204,268,1101,332900,84713
386,345,41,-,199200,84714
208,159,49,850,333000,84715
191,108,83,-,304300,84716
112,86,26,-,233300,84718
26,26,0,-,309100,84719
8307,5397,2910,932,357400,84720
8965,6070,2895,1076,345000,84721
288,277,11,-,350000,84722
119,107,12,850,255000,84723
487,441,46,933,208700,84724
555,484,71,1283,350000,84725
430,302,128,770,390500,84726
25,8,17,-,-,84728
142,140,2,-,210700,84729
256,225,31,688,330500,84730
25,25,0,-,234400,84731
17,17,0,-,221900,84732
114,89,25,-,-,84733
113,67,46,1045,96100,84734
66,60,6,-,450000,84735
117,93,24,444,177700,84736
8511,6246,2265,1239,420900,84737
3948,3064,884,1717,540900,84738
150,117,33,850,237100,84739
103,95,8,-,173800,84740
2667,2113,554,1127,358500,84741
179,157,22,605,494200,84742
78,78,0,-,225600,84743
69,51,18,671,254200,84744
1360,1051,309,1316,366500,84745
493,436,57,1600,401000,84746
290,226,64,1068,229500,84747
101,69,32,-,365900,84749
239,225,14,-,258300,84750
588,459,129,872,237400,84751
301,277,24,1107,233900,84752
0,0,0,-,-,84753
1466,1314,152,1042,272400,84754
17,17,0,-,687500,84755
83,83,0,-,218800,84756
646,526,120,1375,595800,84757
225,210,15,-,305300,84758
726,614,112,799,301600,84759
387,315,72,1089,267600,84760
1210,781,429,962,312600,84761
87,87,0,-,419600,84762
111,79,32,1500,658300,84763
130,9,121,705,-,84764
2423,1918,505,1912,509600,84765
40,14,26,-,-,84766
200,135,65,-,832400,84767
17224,10813,6411,1344,407100,84770
77,43,34,-,241100,84772
127,92,35,-,614700,84773
608,567,41,1375,463200,84774
234,197,37,-,594700,84775
206,173,33,-,223000,84776
232,219,13,-,466300,84779
10678,8044,2634,1581,511700,84780
167,167,0,-,570900,84781
219,208,11,-,465900,84782
478,431,47,-,645600,84783
220,123,97,1372,385900,84784
18477,13735,4742,1598,500900,84790
5440,1625,3815,1258,577700,85003
5433,1280,4153,1759,365500,85004
9038,3571,5467,1168,376600,85006
5350,2364,2986,1079,447000,85007
22802,7017,15785,1300,323600,85008
14046,7121,6925,1128,215300,85009
4808,1877,2931,1693,701200,85012
10652,4525,6127,1435,476200,85013
13239,5380,7859,1339,447500,85014
16296,5388,10908,1227,312600,85015
18723,9551,9172,1575,508400,85016
11920,5300,6620,1197,242900,85017
17434,9543,7891,1411,805800,85018
7697,4010,3687,1342,255700,85019
16457,8903,7554,1389,400800,85020
16971,6502,10469,1221,433000,85021
23720,12108,11612,1517,385900,85022
14004,8021,5983,1429,359200,85023
10533,6849,3684,1813,430400,85024
0,0,0,-,-,85026
16632,9140,7492,1488,316100,85027
7943,6717,1226,1832,583000,85028
18811,10259,8552,1319,307800,85029
8443,5468,2975,1503,240300,85031
29044,16830,12214,1492,387900,85032
16055,9100,6955,1338,245900,85033
2425,548,1877,1205,397400,85034
15279,7085,8194,1390,244300,85035
15451,9329,6122,1649,290600,85037
11259,5355,5904,1193,294800,85040
18737,13753,4984,1612,310100,85041
15368,10245,5123,1495,353400,85042
11141,7248,3893,1496,288900,85043
17771,11078,6693,1798,437400,85044
2894,2604,290,2441,590600,85045
13421,9970,3451,1995,538500,85048
12465,9907,2558,2200,564200,85050
15948,8709,7239,1256,288300,85051
11579,7109,4470,1385,329500,85053
5259,1857,3402,2146,618100,85054
6854,6367,487,2115,572600,85083
11736,7081,4655,1818,589000,85085
15931,13507,2424,2177,554100,85086
3658,3447,211,1809,510800,85087
6982,6453,529,1244,447000,85118
10808,8488,2320,1365,259100,85119
14054,11522,2532,958,162900,85120
624,307,317,460,92700,85121
20856,14429,6427,1289,242500,85122
3641,2875,766,975,226000,85123
5938,4028,1910,1132,208400,85128
4684,3226,1458,940,243700,85131
10129,8606,1523,1268,314600,85132
174,132,42,-,37400,85135
977,792,185,870,131700,85137
16280,13272,3008,1919,342900,85138
6365,5147,1218,1481,293400,85139
16340,13742,2598,1883,411800,85140
154,130,24,-,-,85141
26680,23654,3026,2092,521300,85142
13845,11131,2714,1823,350800,85143
1128,1059,69,1534,252500,85145
1179,882,297,249,106600,85147
518,271,247,-,163200,85172
1183,853,330,792,141400,85173
19,19,0,-,-,85191
876,712,164,-,156500,85192
1417,1128,289,846,118900,85193
3185,2918,267,1172,318800,85194
21119,8229,12890,1349,292600,85201
16665,8386,8279,1431,334200,85202
13125,7431,5694,1388,388300,85203
23056,13348,9708,1426,296000,85204
19625,14150,5475,1363,301200,85205
16240,10378,5862,1717,322600,85206
19490,16037,3453,1595,460800,85207
15277,12174,3103,1438,261200,85208
17823,13163,4660,1798,363800,85209
15215,7092,8123,1383,301600,85210
15798,13378,2420,2024,530700,85212
13244,10256,2988,1640,407600,85213
7570,6063,1507,1755,398400,85215
20111,10825,9286,1785,391000,85224
27468,16764,10704,1662,386800,85225
16566,10230,6336,1785,452400,85226
14719,10528,4191,1895,468600,85233
16810,12624,4186,1971,488600,85234
0,0,0,-,-,85236
17727,14097,3630,1822,489100,85248
16789,15010,1779,2318,610800,85249
8235,6537,1698,1762,507500,85250
21742,10701,11041,1771,500700,85251
7365,6215,1150,1935,"2,000,000+",85253
19276,14056,5220,1954,701900,85254
19597,14320,5277,2401,975300,85255
1001,847,154,561,132400,85256
14671,9263,5408,1812,453200,85257
12798,9439,3359,1945,744600,85258
9577,7419,2158,1769,956300,85259
19064,11431,7633,1969,637000,85260
6401,6228,173,-,1178600,85262
1802,1746,56,-,775800,85263
332,303,29,575,389600,85264
5608,5426,182,3050,1026900,85266
11151,9302,1849,1781,576700,85268
28444,6774,21670,1531,364200,85281
23631,10822,12809,1627,370000,85282
19144,9315,9829,1669,409800,85283
7365,6013,1352,2162,646300,85284
17794,11891,5903,2031,548900,85286
18960,12145,6815,1965,527400,85295
17238,12182,5056,2141,496200,85296
10750,8401,2349,2083,559200,85297
13734,12577,1157,2525,598300,85298
22614,8910,13704,1189,218100,85301
14927,7703,7224,1241,326600,85302
10036,6247,3789,1476,286800,85303
10079,8116,1963,1401,345400,85304
5495,3235,2260,1867,410100,85305
8882,5936,2946,1666,342000,85306
4744,2196,2548,1745,368700,85307
25693,18461,7232,1777,420100,85308
0,0,0,-,-,85309
7060,6352,708,2087,489400,85310
122,115,7,-,397500,85320
1810,1321,489,920,120800,85321
191,183,8,-,237200,85322
14171,8650,5521,1625,335000,85323
1107,1000,107,-,286900,85324
595,595,0,-,123500,85325
20715,16656,4059,1635,342400,85326
173,173,0,-,37600,85328
819,541,278,1213,243600,85329
12731,11758,973,2535,674400,85331
852,785,67,-,236800,85332
190,123,67,-,-,85333
461,281,180,719,-,85334
11136,7758,3378,1682,282000,85335
2588,1450,1138,837,198000,85336
849,549,300,1089,120800,85337
22268,16935,5333,1822,396100,85338
15250,12305,2945,2008,398100,85339
12760,10412,2348,1924,499700,85340
15,0,15,-,-,85341
723,618,105,925,268200,85342
24,24,0,-,550000,85343
4408,2804,1604,781,173200,85344
22904,14948,7956,1563,278300,85345
1513,1015,498,682,78800,85346
157,33,124,1079,-,85347
1338,1152,186,906,98600,85348
6702,4814,1888,698,196800,85349
6037,4528,1509,864,211200,85350
17458,14824,2634,1477,250300,85351
122,32,90,548,-,85352
11977,8353,3624,1626,344600,85353
2837,2404,433,1343,277600,85354
4375,4044,331,2586,443700,85355
1842,1530,312,731,116900,85356
251,219,32,-,-,85357
57,57,0,-,143800,85360
2670,2380,290,1260,388800,85361
363,280,83,-,230300,85362
2460,1503,957,1130,282900,85363
27669,16356,11313,963,204300,85364
20893,16230,4663,1259,189900,85365
10705,8756,1949,1205,184500,85367
148,20,128,310,-,85371
9565,8275,1290,1950,317100,85373
18405,14438,3967,1897,355800,85374
16115,14209,1906,1658,350700,85375
1736,1571,165,1685,1058600,85377
3849,2396,1453,1369,235200,85378
15606,11694,3912,1944,413500,85379
10553,6957,3596,1726,407900,85381
17655,12209,5446,1875,408000,85382
24404,22371,2033,2371,607700,85383
8047,7551,496,2405,453800,85387
10446,8586,1860,2094,420000,85388
4841,3828,1013,1234,465800,85390
13823,8447,5376,1829,364700,85392
13602,10957,2645,1912,524600,85395
13148,12292,856,2047,451000,85396
5182,3783,1399,934,166400,85501
565,475,90,320,36700,85530
150,83,67,-,422900,85531
157,122,35,-,125000,85532
980,938,42,-,86200,85533
1112,888,224,576,158300,85534
0,0,0,-,-,85535
129,89,40,-,152500,85536
1263,959,304,976,107200,85539
1280,28,1252,568,-,85540
11349,9081,2268,1290,317700,85541
727,362,365,610,52000,85542
1592,1175,417,1118,247200,85543
1493,1287,206,-,372700,85544
361,268,93,-,192200,85545
6845,5180,1665,930,192700,85546
1444,889,555,392,66900,85550
112,68,44,656,-,85551
2222,1650,572,959,280200,85552
902,773,129,436,253400,85553
232,197,35,-,279900,85554
291,247,44,-,78700,85601
4301,3334,967,760,195500,85602
3402,2432,970,835,204900,85603
231,151,80,638,67700,85605
403,343,60,1255,233600,85606
5615,3568,2047,750,134000,85607
0,0,0,-,-,85608
257,257,0,-,-,85609
319,272,47,488,206500,85610
566,539,27,-,327300,85611
994,0,994,1498,-,85613
13861,11522,2339,1198,272900,85614
4056,3688,368,888,247400,85615
2268,1633,635,937,157600,85616
537,445,92,567,121900,85617
559,448,111,980,99700,85618
11,11,0,-,-,85619
321,284,37,694,74000,85620
7364,3737,3627,700,173600,85621
3726,3284,442,1307,324800,85622
2669,2426,243,2620,384700,85623
689,391,298,807,378300,85624
996,853,143,800,158500,85625
295,248,47,-,91100,85626
177,177,0,-,161400,85627
9584,7827,1757,1770,313600,85629
800,677,123,-,148500,85630
1547,1267,280,740,112900,85631
410,360,50,1023,119800,85632
14,0,14,-,-,85633
1429,905,524,524,93500,85634
15558,9458,6100,985,218100,85635
486,429,57,-,434300,85637
807,605,202,779,170800,85638
104,36,68,-,106300,85639
73,45,28,-,-,85640
10723,10000,723,1829,372500,85641
3058,2081,977,700,161500,85643
568,521,47,-,220000,85645
703,639,64,-,473400,85646
7079,5840,1239,1049,213100,85648
6198,5155,1043,1309,306400,85650
7667,6426,1241,991,298200,85653
0,0,0,-,-,85654
6818,5787,1031,1794,441600,85658
3195,801,2394,1183,451500,85701
16015,9302,6713,1424,389000,85704
25358,11663,13695,924,113700,85705
17961,10407,7554,981,169600,85706
20,0,20,-,-,85707
1379,7,1372,1584,-,85708
0,0,0,-,-,85709
26065,14483,11582,1169,245900,85710
18022,8663,9359,1001,248600,85711
16577,6764,9813,947,250400,85712
16778,10401,6377,1017,171700,85713
5203,2666,2537,879,177100,85714
9058,6421,2637,1368,330900,85715
17021,6501,10520,1021,300900,85716
12971,8949,4022,1224,677400,85718
19592,5817,13775,1051,266900,85719
0,0,0,-,-,85721
28,0,28,-,-,85723
0,0,0,-,-,85724
0,0,0,-,-,85726
15884,10675,5209,1206,218500,85730
0,0,0,-,-,85734
4071,3596,475,1191,190600,85735
1595,1394,201,999,140000,85736
9890,7589,2301,1710,433600,85737
9023,8412,611,1648,394000,85739
14173,8795,5378,1474,268600,85741
12390,9934,2456,1636,339100,85742
12149,10447,1702,1661,329200,85743
16371,10492,5879,1128,324100,85745
15145,11139,4006,1280,225200,85746
9411,7588,1823,1776,345900,85747
8453,6345,2108,1457,321700,85748
7834,6729,1105,1456,553800,85749
12078,8961,3117,1413,518000,85750
8205,7291,914,1896,452600,85755
11588,9230,2358,1256,210800,85756
6662,5596,1066,1040,266100,85757
8137,6098,2039,1009,256300,85901
0,0,0,-,-,85902
512,243,269,659,53400,85911
50,50,0,-,154400,85912
342,284,58,983,292900,85920
72,68,4,-,-,85922
185,185,0,-,177600,85923
901,769,132,-,104200,85924
1615,1396,219,897,232400,85925
266,99,167,430,62400,85926
63,63,0,-,557900,85927
194,115,79,1239,384000,85928
3103,2437,666,1117,250100,85929
304,224,80,813,-,85930
114,104,10,-,412500,85931
290,290,0,-,241100,85932
1818,1598,220,715,308100,85933
275,227,48,-,316500,85934
2191,1895,296,905,381000,85935
916,824,92,881,178600,85936
2823,2285,538,1182,259000,85937
874,639,235,991,191700,85938
1598,1360,238,-,291400,85939
537,454,83,-,236200,85940
2907,1670,1237,604,84200,85941
0,0,0,-,-,85942
13563,4753,8810,1505,570900,86001
43,35,8,-,162500,86003
14345,9060,5285,1611,464100,86004
7078,4087,2991,1531,556400,86005
51,2,49,1167,-,86011
576,540,36,-,456800,86015
21,21,0,-,30800,86016
455,398,57,-,397100,86017
429,390,39,-,559400,86018
606,539,67,-,59900,86020
783,529,254,1397,239400,86021
588,491,97,805,223600,86022
760,84,676,673,18400,86023
599,576,23,-,427000,86024
1732,1097,635,940,144600,86025
15,15,0,-,-,86028
12,12,0,-,-,86029
267,228,39,-,126200,86030
723,499,224,867,71800,86031
567,403,164,983,173300,86032
2808,1831,977,738,38300,86033
675,388,287,663,74300,86034
556,432,124,488,59700,86035
64,55,9,-,57900,86036
68,68,0,-,267900,86038
564,543,21,-,113900,86039
3994,2758,1236,1009,124600,86040
654,360,294,1088,61000,86042
563,412,151,-,76900,86043
1134,835,299,715,63000,86044
3158,1962,1196,825,67700,86045
2666,2146,520,1186,367800,86046
4306,2638,1668,875,113700,86047
0,0,0,-,-,86052
724,574,150,677,48500,86053
589,413,176,692,73500,86054
12158,8435,3723,1580,495100,86301
9855,6772,3083,1309,502400,86303
9409,7625,1784,1132,627100,86305
0,0,0,-,-,86313
16160,10720,5440,1432,363700,86314
3707,3224,483,2179,504500,86315
1108,978,130,1063,186600,86320
990,134,856,608,50300,86321
4773,3639,1134,1036,293700,86322
8137,6835,1302,1167,349900,86323
2489,1928,561,897,345000,86324
2389,1914,475,1540,409300,86325
11615,7434,4181,1102,312400,86326
5848,5248,600,1462,359700,86327
328,231,97,1161,268300,86329
209,119,90,1078,312100,86331
1145,1007,138,647,189900,86332
2696,2161,535,1008,173000,86333
1722,1426,296,1077,317700,86334
2579,1760,819,1475,291900,86335
5944,4327,1617,1456,705300,86336
872,651,221,654,133200,86337
252,202,50,889,633300,86338
71,48,23,-,438500,86343
3559,2223,1336,1640,658300,86351
12486,8923,3563,1045,247300,86401
8671,5522,3149,1152,313300,86403
8891,7329,1562,1352,421300,86404
11972,9083,2889,1311,434700,86406
13569,9534,4035,884,171900,86409
204,189,15,-,146200,86411
4772,4231,541,1056,157700,86413
6631,5692,939,968,274100,86426
4125,2584,1541,1076,319900,86429
127,99,28,-,130200,86431
1607,1278,329,821,215600,86432
79,79,0,-,-,86433
394,157,237,657,116800,86434
0,0,0,-,-,86435
951,483,468,929,206800,86436
33,27,6,-,242500,86437
386,375,11,-,278200,86438
3348,2729,619,1066,231700,86440
775,642,133,1115,92700,86441
15901,10742,5159,1000,174400,86442
0,0,0,-,-,86443
866,817,49,-,151000,86444
137,137,0,-,170800,86445
348,309,39,769,43400,86502
3150,2299,851,523,39500,86503
1628,1080,548,725,45600,86504
1984,1656,328,526,35700,86505
419,400,19,-,46600,86506
588,519,69,907,48800,86507
178,166,12,-,32900,86508
1600,1261,339,660,103800,86510
996,920,76,788,48000,86511
763,513,250,614,74800,86512
792,537,255,635,70700,86514
1102,572,530,661,57100,86515
769,695,74,715,60900,86520
329,317,12,-,44000,86535
553,419,134,600,54600,86538
308,233,75,481,25400,86540
463,390,73,608,49500,86544
302,257,45,479,36300,86545
240,212,28,625,48700,86547
628,430,198,550,35000,86556
974,859,115,-,224800,87001
7734,6348,1386,859,183700,87002
4583,3728,855,1066,235200,87004
30,30,0,-,-,87005
230,204,26,-,196700,87006
524,345,179,-,35600,87007
1087,1032,55,907,352900,87008
676,354,322,1375,450000,87010
2,2,0,-,-,87011
160,132,28,-,306300,87012
1516,1298,218,1038,77900,87013
160,160,0,-,22800,87014
6066,5461,605,891,263200,87015
1125,914,211,823,117400,87016
124,124,0,-,245500,87017
144,144,0,-,32500,87018
3893,2489,1404,741,154900,87020
1044,672,372,832,131500,87021
308,279,29,-,-,87022
147,121,26,-,153300,87023
679,509,170,993,185600,87024
692,666,26,746,436100,87025
915,643,272,383,-,87026
118,71,47,-,-,87027
36,36,0,-,-,87028
195,171,24,-,-,87029
15188,12300,2888,1083,206600,87031
119,119,0,-,-,87032
761,725,36,-,78100,87034
2354,1849,505,797,147600,87035
661,603,58,906,147700,87036
468,405,63,692,52600,87037
98,98,0,-,-,87038
75,75,0,-,-,87040
317,291,26,875,164100,87041
1373,1152,221,1346,275000,87042
2181,1998,183,1869,520200,87043
144,144,0,-,-,87044
686,654,32,708,56700,87045
71,71,0,-,328900,87046
2173,1974,199,1130,399400,87047
3685,3375,310,1184,552000,87048
0,0,0,-,-,87049
135,135,0,-,-,87051
607,443,164,831,144700,87052
293,242,51,1518,234900,87053
472,472,0,-,197300,87056
4109,3913,196,1218,322100,87059
11,0,11,-,-,87060
174,174,0,-,161900,87061
573,557,16,-,82200,87062
88,77,11,-,96300,87063
95,95,0,-,78700,87064
2109,1914,195,865,246300,87068
11,0,11,-,-,87070
168,156,12,-,205700,87072
281,258,23,1482,208100,87083
0,0,0,-,-,87101
10136,3600,6536,868,174400,87102
5940,3917,2023,1022,300000,87104
18824,14127,4697,972,200300,87105
12384,4795,7589,904,332100,87106
12440,7844,4596,901,282000,87107
17332,6545,10787,828,227600,87108
19258,9939,9319,1112,298300,87109
18292,11143,7149,1096,251400,87110
27168,16784,10384,1310,349200,87111
19170,11980,7190,1056,254400,87112
6915,4818,2097,1581,362100,87113
27445,18755,8690,1321,296200,87114
1427,27,1400,1744,-,87116
0,0,0,-,-,87117
26196,20823,5373,1404,276900,87120
25267,19295,5972,1277,192500,87121
6961,6360,601,1900,614200,87122
19374,12995,6379,995,236400,87123
22132,17530,4602,1380,262800,87124
17663,15223,2440,1670,280600,87144
0,0,0,-,-,87151
7177,3612,3565,858,134700,87301
542,525,17,-,49700,87305
287,280,7,-,66700,87310
1319,1075,244,833,39100,87311
211,205,6,-,-,87312
1592,1108,484,479,63900,87313
70,70,0,-,-,87315
498,293,205,1072,77200,87316
559,274,285,825,-,87317
750,590,160,-,29600,87319
212,186,26,775,39300,87320
812,576,236,1348,160200,87321
164,153,11,-,55300,87322
1362,1291,71,620,102700,87323
655,572,83,638,63700,87325
637,601,36,-,50500,87326
1843,1504,339,649,79300,87327
860,279,581,636,60500,87328
75,48,27,-,117300,87347
392,178,214,589,77600,87357
476,423,53,704,81000,87364
6,6,0,-,-,87365
1190,1142,48,475,37200,87375
15641,9741,5900,983,202400,87401
3811,2949,862,1042,269100,87402
5505,4226,1279,802,192600,87410
434,396,38,-,119900,87412
5015,3706,1309,898,176800,87413
906,700,206,1555,197800,87415
1354,1088,266,888,91300,87416
1726,1197,529,799,180400,87417
391,339,52,-,199400,87418
237,237,0,-,-,87419
3195,1754,1441,693,101600,87420
479,360,119,1647,125500,87421
503,420,83,625,25600,87455
461,435,26,-,29400,87461
251,220,31,950,77300,87499
8586,5703,2883,1516,649100,87501
16352,9650,6702,1348,484100,87505
7333,6071,1262,1142,523600,87506
20268,13518,6750,1276,333300,87507
7456,6750,706,1502,529000,87508
460,396,64,-,336300,87510
885,775,110,442,228800,87511
97,97,0,-,-,87512
676,653,23,-,403400,87513
696,614,82,-,521300,87514
123,123,0,-,352200,87515
57,57,0,-,525000,87516
90,90,0,-,-,87517
0,0,0,-,-,87518
170,170,0,-,415800,87519
516,415,101,529,207200,87520
346,303,43,948,188500,87521
1269,1040,229,834,219400,87522
162,162,0,-,150000,87523
144,144,0,-,-,87524
17,17,0,-,-,87525
578,417,161,-,399100,87527
1126,696,430,557,65300,87528
2104,1680,424,1444,393600,87529
469,469,0,-,273700,87530
51,51,0,-,-,87531
7444,5314,2130,887,225000,87532
848,670,178,1283,428100,87535
835,587,248,636,228800,87537
164,164,0,-,251300,87538
41,41,0,-,-,87539
558,321,237,980,685900,87540
124,124,0,-,-,87543
6171,4089,2082,1305,444700,87544
2040,2032,8,-,460100,87547
324,220,104,-,-,87548
569,478,91,-,257000,87549
166,166,0,-,-,87551
937,704,233,788,240900,87552
475,371,104,956,200300,87553
0,0,0,-,-,87554
1077,835,242,-,226900,87556
1766,1475,291,1268,373400,87557
523,318,205,935,429500,87558
719,572,147,943,98500,87560
113,113,0,-,-,87562
63,63,0,-,-,87564
198,198,0,-,"10,000-",87565
717,626,91,715,500000,87566
395,296,99,960,284200,87567
163,163,0,-,187300,87569
5168,3640,1528,1006,416800,87571
7,0,7,-,-,87573
323,222,101,-,-,87575
258,228,30,-,328600,87577
136,72,64,1140,-,87578
495,407,88,-,125100,87579
229,229,0,-,-,87580
0,0,0,-,-,87581
393,241,152,-,328200,87582
160,130,30,-,-,87583
8074,5364,2710,756,169000,87701
633,505,128,1120,436200,87710
258,258,0,-,-,87711
158,158,0,-,"10,000-",87712
111,111,0,-,-,87713
466,269,197,659,143500,87714
114,101,13,-,-,87715
161,118,43,950,170700,87718
433,424,9,-,119700,87722
142,142,0,-,177800,87723
10,0,10,-,-,87724
186,134,52,575,85000,87728
48,45,3,-,586500,87729
9,9,0,-,112500,87730
119,101,18,-,173400,87731
498,410,88,-,118600,87732
44,40,4,-,100000,87733
135,125,10,-,420700,87734
0,0,0,-,-,87735
37,37,0,-,-,87736
3213,2332,881,734,157000,87740
188,188,0,-,235300,87742
171,129,42,1039,55900,87743
541,541,0,-,198900,87745
52,43,9,-,212500,87746
667,471,196,552,116700,87747
0,0,0,-,-,87749
0,0,0,-,-,87750
338,242,96,675,-,87752
0,0,0,-,-,87753
3042,1945,1097,676,165700,87801
98,98,0,-,93000,87820
339,325,14,-,233800,87821
234,234,0,-,135500,87823
60,60,0,-,-,87824
868,607,261,-,110800,87825
178,129,49,-,245100,87827
153,152,1,-,179600,87828
443,408,35,-,259500,87829
214,164,50,729,118500,87830
113,89,24,-,156700,87831
96,96,0,-,214800,87832
2791,1584,1207,674,114800,87901
257,257,0,-,228000,87930
326,231,95,-,-,87931
0,0,0,-,-,87933
1074,907,167,1152,180800,87935
128,128,0,-,130800,87936
1008,733,275,474,102000,87937
108,108,0,-,517200,87939
141,92,49,-,-,87940
267,216,51,-,55900,87941
490,387,103,756,105900,87942
123,123,0,-,-,87943
15658,6410,9248,797,158300,88001
390,0,390,1288,-,88002
0,0,0,-,-,88003
0,0,0,-,-,88004
11178,6833,4345,899,207100,88005
9526,7687,1839,794,232200,88007
4175,3466,709,1191,228800,88008
0,0,0,-,-,88009
13949,8478,5471,1053,315100,88011
11660,8868,2792,1210,222300,88012
315,279,36,760,158000,88020
5367,3975,1392,605,151400,88021
319,287,32,-,169200,88022
798,510,288,653,118100,88023
153,131,22,-,-,88024
44,44,0,-,271200,88025
636,447,189,710,120900,88026
217,172,45,836,183300,88027
124,111,13,-,198400,88028
427,246,181,394,91400,88029
8655,6036,2619,712,113700,88030
30,30,0,-,-,88034
212,198,14,-,222700,88038
313,259,54,663,161600,88039
7,7,0,-,-,88040
417,406,11,-,145800,88041
230,189,41,-,193300,88042
587,466,121,807,86800,88043
945,785,160,540,194000,88044
1104,759,345,731,98800,88045
330,232,98,-,253000,88046
557,498,59,522,109600,88047
1209,1055,154,762,98200,88048
324,324,0,-,177700,88049
79,52,27,-,168600,88051
90,62,28,-,121500,88052
84,19,65,679,-,88053
0,0,0,-,-,88055
104,93,11,-,128900,88056
7138,5039,2099,841,185000,88061
3734,2724,1010,763,121900,88063
248,167,81,-,176100,88065
761,564,197,708,99200,88072
4758,3157,1601,874,101900,88081
17228,10381,6847,991,162400,88101
0,0,0,-,-,88103
151,132,19,-,361700,88112
28,16,12,-,-,88113
12,12,0,-,-,88114
8,8,0,-,-,88115
171,128,43,-,55600,88116
104,95,9,675,221700,88118
666,445,221,727,165400,88119
178,87,91,625,182500,88120
81,51,30,-,147500,88121
421,353,68,716,123800,88124
2,2,0,-,-,88125
8,8,0,-,-,88126
6790,4157,2633,865,136600,88130
116,52,64,732,138300,88132
26,20,6,-,-,88134
570,432,138,942,112900,88135
51,37,14,-,-,88136
10425,7649,2776,957,202600,88201
10633,6616,4017,776,115600,88203
6853,4935,1918,925,213900,88210
15542,11731,3811,1218,192600,88220
1675,1266,409,763,96500,88230
1191,939,252,749,151800,88231
620,513,107,731,115600,88232
14637,9453,5184,1124,177200,88240
2544,2164,380,1290,218700,88242
0,0,0,-,-,88244
56,56,0,-,-,88250
789,556,233,1155,105400,88252
307,235,72,1049,217300,88253
10,0,10,-,-,88254
33,33,0,-,-,88255
616,481,135,1201,182200,88256
4657,3459,1198,1081,174200,88260
2,2,0,-,-,88262
20,20,0,-,-,88263
10,10,0,-,-,88264
124,60,64,-,265900,88265
602,417,185,936,104300,88267
0,0,0,-,-,88268
637,550,87,618,85000,88301
15302,9770,5532,877,164300,88310
317,281,36,-,101800,88311
1488,1451,37,-,339200,88312
4,4,0,-,-,88314
1111,1007,104,963,164800,88316
919,735,184,922,206000,88317
191,145,46,-,-,88318
130,113,17,-,1096500,88321
0,0,0,-,-,88323
52,52,0,-,-,88324
419,400,19,-,246000,88325
1067,0,1067,1236,-,88330
208,197,11,-,-,88336
902,702,200,774,143900,88337
113,46,67,-,-,88338
291,281,10,-,244300,88339
915,612,303,365,53500,88340
339,300,39,-,239600,88341
5,5,0,-,-,88342
35,13,22,-,-,88343
34,34,0,-,127500,88344
3681,2585,1096,916,232400,88345
1210,865,345,826,-,88346
0,0,0,-,-,88347
127,127,0,-,-,88348
0,0,0,-,-,88349
75,75,0,-,-,88350
81,55,26,-,-,88351
1334,1141,193,908,122000,88352
180,111,69,438,45800,88353
76,76,0,-,-,88354
104,73,31,-,-,88355
3130,2204,926,753,65800,88401
35,34,1,-,-,88410
34,34,0,-,319000,88411
55,22,33,-,-,88414
1167,820,347,655,129600,88415
137,137,0,-,-,88416
32,6,26,-,-,88417
133,89,44,713,160900,88418
38,33,5,-,263200,88419
22,0,22,-,-,88421
62,24,38,-,-,88422
32,17,15,-,-,88424
478,405,73,1085,112600,88426
59,50,9,-,95000,88427
143,99,44,-,-,88430
27,27,0,-,-,88431
126,93,33,631,111600,88434
1108,889,219,525,113600,88435
32,18,14,-,-,88436
0,0,0,-,-,88439
460,284,176,738,194700,89001
13226,10910,2316,1844,427500,89002
397,251,146,842,154100,89003
128,97,31,-,633100,89004
6455,4825,1630,1376,424200,89005
230,230,0,-,320000,89007
366,262,104,630,190400,89008
165,125,40,577,110500,89010
13995,9539,4456,1725,458700,89011
15885,9866,6019,1915,472100,89012
112,75,37,-,86300,89013
16770,8457,8313,1629,415300,89014
15666,9883,5783,1324,373700,89015
9,9,0,-,-,89017
327,228,99,943,325500,89018
1198,749,449,916,221700,89019
715,355,360,642,93200,89020
885,793,92,946,438100,89021
0,0,0,-,-,89022
415,339,76,815,308100,89025
0,0,0,-,-,89026
7918,6090,1828,1106,343300,89027
4530,2282,2248,992,258800,89029
15335,5209,10126,1139,237300,89030
23895,17901,5994,1831,373500,89031
15496,9325,6171,1646,346500,89032
1587,1530,57,1831,478900,89034
174,125,49,835,127800,89039
1482,1040,442,1076,282400,89040
411,264,147,902,280600,89042
380,380,0,-,205600,89043
11710,9707,2003,2098,536800,89044
739,417,322,1013,104800,89045
269,188,81,488,129600,89046
69,35,34,-,-,89047
10225,7410,2815,1162,292400,89048
1308,807,501,875,182300,89049
24699,15384,9315,1938,595500,89052
105,102,3,-,-,89054
5163,4143,1020,919,232700,89060
3400,2985,415,1710,328400,89061
0,0,0,-,-,89070
20614,11859,8755,1782,436400,89074
13186,8810,4376,1830,385400,89081
12508,9082,3426,1841,434800,89084
1534,1342,192,2286,459500,89085
3165,1613,1552,1684,407800,89086
16002,3074,12928,1008,258100,89101
15230,4664,10566,1206,363200,89102
21831,6939,14892,1300,273800,89103
14951,6479,8472,1138,298700,89104
9787,3185,6602,1169,263100,89106
12735,7000,5735,1320,289100,89107
26628,12479,14149,1431,304400,89108
3425,1228,2197,1208,494800,89109
21272,11508,9764,1292,304300,89110
14942,8891,6051,1759,463900,89113
19635,6978,12657,1294,258900,89115
22999,10619,12380,1691,481900,89117
9337,4000,5337,1501,391800,89118
21860,4761,17099,1184,301000,89119
9176,5453,3723,1467,364800,89120
24029,12380,11649,1306,288400,89121
19467,11064,8403,1379,285600,89122
23012,13658,9354,1641,424900,89123
276,250,26,3153,504200,89124
15728,8026,7702,1621,378600,89128
21022,14761,6261,1767,420400,89129
13139,9482,3657,1620,391300,89130
17714,14165,3549,1920,498600,89131
11718,9499,2219,2014,450000,89134
13507,9888,3619,2400,657300,89135
8591,6998,1593,2485,708500,89138
14255,8938,5317,1848,449400,89139
14214,10830,3384,2097,494400,89141
10531,6622,3909,1448,323200,89142
4264,3178,1086,1799,437500,89143
8219,5539,2680,1907,486600,89144
9996,6403,3593,1569,348800,89145
7749,3281,4468,1407,432700,89146
21476,11043,10433,1732,376900,89147
23811,14115,9696,1920,443600,89148
16454,11374,5080,1792,494900,89149
9610,5544,4066,1354,288800,89156
454,194,260,2664,1191200,89158
139,101,38,-,456300,89161
10363,7407,2956,1757,475900,89166
10233,2053,8180,1159,299900,89169
15216,10630,4586,2030,451800,89178
3941,3063,878,2070,416000,89179
15057,8169,6888,1750,415400,89183
4,0,4,-,-,89191
2446,1823,623,854,199100,89301
115,74,41,-,117400,89310
80,49,31,-,90500,89311
55,28,27,758,108300,89314
40,40,0,-,-,89315
301,218,83,985,263600,89316
178,178,0,-,239000,89317
472,372,100,1661,96300,89318
169,169,0,-,71000,89319
67,61,6,-,"2,000,000+",89402
6591,5449,1142,1275,391500,89403
19,19,0,-,-,89404
0,0,0,-,-,89405
9728,6620,3108,1203,298000,89406
8686,6113,2573,1504,352600,89408
82,54,28,-,-,89409
4989,3482,1507,1516,588400,89410
535,500,35,-,1067400,89411
53,35,18,-,-,89412
373,345,28,-,"2,000,000+",89413
84,60,24,-,-,89414
1295,959,336,1289,184700,89415
69,69,0,-,-,89418
1310,860,450,673,179500,89419
18,7,11,-,-,89420
210,170,40,-,80400,89421
78,73,5,-,106900,89422
4467,3843,624,1953,646500,89423
154,119,35,550,53800,89424
155,137,18,-,300900,89425
107,95,12,-,116900,89426
341,242,99,575,86500,89427
44,33,11,-,354300,89428
3373,2798,575,1237,264700,89429
54,41,13,-,670800,89430
15404,7184,8220,1276,332000,89431
7205,5010,2195,1197,321000,89433
10832,6915,3917,1857,439000,89434
17917,13259,4658,2011,546600,89436
0,0,0,-,-,89437
0,0,0,-,-,89438
1036,820,216,950,762800,89439
448,448,0,-,456900,89440
5124,4673,451,2078,624000,89441
327,215,112,908,117100,89442
1584,1343,241,1211,444500,89444
6871,5079,1792,1005,258200,89445
0,0,0,-,-,89446
3466,2511,955,803,243600,89447
863,714,149,2034,1336500,89448
1390,836,554,1600,791200,89449
0,0,0,-,-,89450
3938,2696,1242,1963,1324900,89451
5551,4413,1138,1472,485700,89460
0,0,0,-,-,89496
2501,590,1911,1089,379800,89501
19195,6662,12533,1243,389200,89502
13006,5843,7163,1336,441800,89503
15870,11313,4557,1733,377500,89506
5042,4707,335,1865,429900,89508
16806,8935,7871,1443,670700,89509
638,580,58,613,569800,89510
12771,8681,4090,1860,903300,89511
11275,3293,7982,1113,318400,89512
3713,2941,772,1964,869600,89519
16018,11465,4553,2178,629900,89521
16000,9722,6278,1759,569300,89523
105,9,96,1390,-,89557
10944,6662,4282,1195,415800,89701
4973,3690,1283,1038,595400,89703
1883,1777,106,-,608500,89704
2194,1774,420,1364,456300,89705
8420,5191,3229,1174,344600,89706
10074,6624,3450,1185,278700,89801
5153,4581,572,1393,310100,89815
2188,1470,718,1062,214500,89820
321,312,9,-,-,89821
785,506,279,1211,197500,89822
230,222,8,-,455000,89823
325,143,182,712,-,89825
0,0,0,-,-,89826
140,125,15,-,-,89828
71,71,0,-,156900,89830
26,26,0,-,-,89831
321,166,155,529,81400,89832
82,58,24,-,345000,89833
23,23,0,-,-,89834
453,320,133,977,234600,89835
1943,968,975,845,126500,89883
13416,4775,8641,1471,513300,90001
13319,5423,7896,1509,502600,90002
17634,4692,12942,1515,547600,90003
23735,4011,19724,1752,1457200,90004
17477,1572,15905,1648,1084400,90005
19268,1951,17317,1396,841900,90006
12451,1297,11154,1480,852900,90007
14740,4475,10265,1589,1003000,90008
2488,444,2044,2621,863500,90010
24156,6346,17810,1497,575200,90011
15236,1249,13987,2116,686400,90012
8399,686,7713,1161,786600,90013
6450,236,6214,1604,644700,90014
13180,1618,11562,2385,1000800,90015
17844,6320,11524,1729,919800,90016
14148,842,13306,1669,675500,90017
16646,5340,11306,1512,886800,90018
23724,5673,18051,1782,1178100,90019
17563,1581,15982,1734,826500,90020
1541,107,1434,984,1075800,90021
17007,5636,11371,1407,603500,90022
11842,3057,8785,1414,617600,90023
16847,5417,11430,2666,1434000,90024
22875,5437,17438,2465,1081400,90025
26461,6635,19826,1822,1143400,90026
21736,4413,17323,1904,1747200,90027
17643,667,16976,1839,970800,90028
13089,1460,11629,1644,1066200,90029
12166,3823,8343,1487,758500,90031
13372,6932,6440,1571,780100,90032
13149,2382,10767,1391,669500,90033
25628,5291,20337,2180,1395000,90034
11997,3673,8324,2486,1844000,90035
19985,2675,17310,2730,1958600,90036
17709,4071,13638,1438,632600,90037
13344,1129,12215,1764,1089200,90038
12351,5564,6787,2149,1202000,90039
3344,1810,1534,1390,576900,90040
9790,5220,4570,1797,1135200,90041
21490,9985,11505,1853,940600,90042
16883,9007,7876,1424,867800,90043
27423,8579,18844,1427,588200,90044
16311,7678,8633,2909,1322700,90045
28716,6694,22022,2204,1411500,90046
17198,9361,7837,1492,648200,90047
11838,3312,8526,2359,1847500,90048
16605,8751,7854,2913,"2,000,000+",90049
0,0,0,-,-,90052
3531,1985,1546,2303,1510300,90056
16688,703,15985,1395,694500,90057
1105,173,932,1030,456500,90058
10245,4543,5702,1317,566200,90059
7729,2855,4874,1498,576400,90061
9626,4435,5191,1473,672700,90062
13229,5041,8188,1489,619100,90063
11807,5957,5850,2710,1746800,90064
16441,7716,8725,1774,1043900,90065
24867,9595,15272,2211,1636600,90066
1918,1188,730,"3,500+",1585900,90067
12103,5464,6639,2105,1840200,90068
13068,5078,7990,2230,1085900,90069
0,0,0,-,-,90071
0,0,0,-,-,90073
3225,2700,525,2680,"2,000,000+",90077
0,0,0,-,-,90079
6,0,6,-,-,90089
6075,1746,4329,"3,500+",1234400,90094
0,0,0,-,-,90095
24358,5111,19247,1623,542800,90201
8025,5748,2277,3045,"2,000,000+",90210
3693,1469,2224,2815,"2,000,000+",90211
5439,1168,4271,2764,"2,000,000+",90212
13595,8380,5215,1557,514600,90220
12397,6620,5777,1600,541800,90221
8519,4505,4014,1485,552000,90222
13243,7579,5664,2423,1025200,90230
7337,3087,4250,2659,1491800,90232
7675,5035,2640,1966,764200,90240
14481,5978,8503,1884,770100,90241
12571,6584,5987,1874,676100,90242
7125,3033,4092,2547,1521600,90245
16158,6579,9579,1751,640500,90247
4068,2585,1483,1602,646900,90248
8880,5188,3692,1705,709900,90249
32712,10407,22305,1723,827600,90250
8922,4527,4395,2812,"2,000,000+",90254
18714,5624,13090,1443,562600,90255
10330,4511,5819,1877,745700,90260
15130,7456,7674,1625,569400,90262
0,0,0,-,-,90263
6219,4881,1338,"3,500+","2,000,000+",90265
13323,8810,4513,3492,"2,000,000+",90266
6341,1900,4441,1469,595000,90270
8282,6413,1869,3133,"2,000,000+",90272
9182,8128,1054,"3,500+","2,000,000+",90274
15335,12363,2972,"3,500+",1543300,90275
16393,8008,8385,2621,1403800,90277
15863,9150,6713,2417,1195700,90278
24791,11011,13780,1471,608500,90280
2236,1665,571,"3,500+",1414900,90290
14247,4914,9333,2630,"2,000,000+",90291
13198,3986,9212,"3,500+",1233700,90292
6573,3029,3544,2734,971800,90293
12165,3193,8972,1658,698300,90301
10464,3085,7379,1784,731300,90302
6932,2764,4168,1709,764200,90303
7253,2108,5145,1499,696200,90304
5897,3533,2364,1868,785000,90305
4942,236,4706,2549,1129700,90401
4742,3499,1243,2698,"2,000,000+",90402
13372,3840,9532,2443,1553500,90403
10512,2314,8198,2095,1159500,90404
13972,4351,9621,2311,1940700,90405
14512,6614,7898,1868,887300,90501
6533,4570,1963,1903,655200,90502
17091,8973,8118,2249,1058100,90503
11664,7011,4653,2225,897100,90504
13925,7530,6395,2338,1144000,90505
0,0,0,-,-,90506
10789,6698,4091,1862,729000,90601
7950,3125,4825,1719,729300,90602
6425,5072,1353,2324,781000,90603
11630,7422,4208,1809,684400,90604
10816,7359,3457,1861,662000,90605
8705,6157,2548,1913,623500,90606
13111,9532,3579,2263,782000,90620
10950,4056,6894,2061,734400,90621
5093,3478,1615,2224,920200,90623
16018,10787,5231,2452,866400,90630
22673,13939,8734,2029,757900,90631
15120,11564,3556,2052,765100,90638
0,0,0,-,-,90639
19722,9125,10597,1771,660600,90640
26801,18256,8545,2014,616600,90650
16804,11788,5016,1775,621400,90660
5614,3533,2081,1908,624000,90670
10350,5324,5026,1953,571300,90680
4379,2348,2031,2276,763700,90701
15869,11829,4040,2910,906500,90703
1231,410,821,2076,902800,90704
23669,9023,14646,1771,661100,90706
9388,5154,4234,1547,648600,90710
9997,7573,2424,2302,779600,90712
9361,7945,1416,2699,808600,90713
6372,3244,3128,2196,660900,90715
3807,1712,2095,1696,525100,90716
7845,3560,4285,1874,793600,90717
8383,5441,2942,2370,1166200,90720
14348,6225,8123,1772,500400,90723
23131,7570,15561,1645,808800,90731
9178,6632,2546,2523,785000,90732
12752,9725,3027,2421,488400,90740
251,102,149,3004,1625000,90742
192,102,90,2364,"2,000,000+",90743
14959,5362,9597,1426,596100,90744
15606,10696,4910,1838,628400,90745
8599,7262,1337,2713,682000,90746
0,0,0,-,-,90747
4710,2453,2257,1817,730200,90755
22334,4576,17758,1855,546700,90802
17038,7384,9654,2073,1138300,90803
15041,3258,11783,1801,673600,90804
28256,12029,16227,1664,588500,90805
12347,4479,7868,1672,699800,90806
12808,7278,5530,1892,832200,90807
14217,11808,2409,2271,900100,90808
9970,5682,4288,1554,594200,90810
17336,2609,14727,1578,543700,90813
9521,2950,6571,1987,898700,90814
15457,10009,5448,2263,890500,90815
0,0,0,-,-,90822
0,0,0,-,-,90831
0,0,0,-,-,90840
12724,10248,2476,2298,1085000,91001
10623,7337,3286,2141,1187600,91006
11705,6095,5610,2129,1231100,91007
314,291,23,-,1704200,91008
8579,5384,3195,2035,691600,91010
6403,5667,736,2842,"2,000,000+",91011
15312,7604,7708,2008,874100,91016
3212,726,2486,2258,880700,91020
4711,2683,2028,2086,1172200,91024
10413,4586,5827,2218,1545100,91030
7513,5013,2500,1820,787000,91040
10190,5426,4764,1782,801800,91042
88,13,75,-,-,91046
11332,1746,9586,2282,687300,91101
8496,3955,4541,1925,960000,91103
13490,7642,5848,2040,1022600,91104
5771,3071,2700,2988,1615700,91105
10546,3671,6875,2096,966700,91106
13048,7860,5188,2311,1106600,91107
3934,3224,710,"3,500+","2,000,000+",91108
85,0,85,-,-,91125
8031,2627,5404,2034,1060500,91201
8779,3776,5003,2185,1094500,91202
6938,1435,5503,2348,661300,91203
6805,585,6220,1924,747400,91204
13572,2267,11305,1890,763100,91205
12449,4804,7645,2159,1094100,91206
3995,2239,1756,2192,1246300,91207
6029,3918,2111,2361,1276300,91208
167,42,125,"3,500+",902800,91210
10638,7794,2844,2475,1088200,91214
8730,7051,1679,3163,1096600,91301
9711,7061,2650,3011,1674900,91302
10484,2171,8313,1983,645300,91303
18369,9411,8958,1927,847600,91304
14697,8319,6378,1909,719900,91306
8735,7038,1697,"3,500+",907000,91307
14391,9613,4778,2199,837300,91311
12874,6461,6413,2104,909700,91316
15043,11617,3426,2617,917700,91320
10764,6611,4153,2135,654300,91321
10445,5065,5380,2286,869200,91324
12795,5859,6936,1924,900200,91325
12948,9861,3087,2995,1011100,91326
4,0,4,-,-,91330
23036,14475,8561,1818,609300,91331
24234,12287,11947,1811,700400,91335
8542,5530,3012,1740,624900,91340
25205,17073,8132,1965,641100,91342
18175,8964,9211,1796,751000,91343
17774,12812,4962,2276,872000,91344
5489,3979,1510,1846,654100,91345
13734,11310,2424,2485,733000,91350
10420,7739,2681,2272,589400,91351
12402,6515,5887,1761,700100,91352
10967,8518,2449,2923,803000,91354
11788,7648,4140,2704,744300,91355
12155,6994,5161,2027,1177200,91356
15161,10477,4684,2412,887000,91360
7773,5344,2429,2752,1328900,91361
13823,9758,4065,2735,1078100,91362
10219,7054,3165,2847,1162000,91364
18919,9038,9881,2674,1005900,91367
0,0,0,-,-,91371
5006,3595,1411,3150,1017100,91377
7267,4396,2871,2797,1029300,91381
7136,6018,1118,1730,693600,91384
14233,9318,4915,2499,695000,91387
6326,5525,801,2282,843200,91390
15053,5099,9954,1800,988500,91401
20147,6924,13223,1607,586500,91402
11892,5170,6722,2437,1467900,91403
18722,5017,13705,1736,698100,91405
19154,7550,11604,1859,765000,91406
9346,2547,6799,1850,973300,91411
15475,5797,9678,2239,1323500,91423
6012,4710,1302,2813,1894600,91436
8029,3202,4827,2070,1011600,91501
5322,479,4843,1899,946600,91502
10067,5254,4813,2147,1046200,91504
12975,5733,7242,2284,992300,91505
7908,4628,3280,1913,1055600,91506
18732,3004,15728,2115,961700,91601
10064,3216,6848,2186,1104400,91602
14848,6638,8210,2471,1698900,91604
16139,6048,10091,1736,729900,91605
15589,5210,10379,1744,801300,91606
13929,4259,9670,1998,1019300,91607
29,0,29,-,-,91608
12947,10256,2691,2232,718800,91701
17555,10395,7160,1847,604600,91702
18485,10899,7586,1816,589900,91706
5272,2412,2860,2712,642500,91708
25548,18059,7489,2750,829900,91709
22987,15489,7498,2002,645200,91710
12589,8311,4278,2135,870300,91711
9960,6900,3060,2039,626100,91722
6256,2685,3571,1711,663800,91723
9018,6169,2849,2056,722600,91724
25333,12262,13071,2240,595400,91730
8361,2988,5373,1583,614000,91731
15616,6810,8806,1752,628400,91732
10816,4654,6162,1658,601600,91733
7880,5534,2346,2263,843500,91737
11823,8649,3174,2508,860200,91739
8144,5246,2898,2226,702000,91740
8777,6322,2455,2212,923700,91741
18227,12610,5617,1873,585900,91744
16499,12213,4286,2246,778700,91745
7096,5321,1775,1804,603400,91746
13793,8910,4883,1922,781500,91748
12368,8347,4021,2217,789100,91750
10142,6398,3744,2022,647600,91752
12041,6757,5284,1884,845000,91754
8685,4005,4680,1811,761900,91755
162,139,23,-,339700,91759
17807,12023,5784,2015,590000,91761
19133,11171,7962,1752,568700,91762
10267,5633,4634,1767,550000,91763
16595,7398,9197,2039,524100,91764
15420,11905,3515,2395,878900,91765
19399,10367,9032,1776,568300,91766
14874,8102,6772,1749,585100,91767
8524,4912,3612,1606,536500,91768
16728,8542,8186,1740,712700,91770
12178,8678,3500,2232,754700,91773
8317,5425,2892,2068,1042600,91775
11769,4805,6964,1825,816400,91776
11336,7144,4192,2046,922900,91780
8962,7754,1208,2790,853900,91784
19408,8723,10685,1923,607100,91786
12716,10483,2233,2868,936800,91789
12711,7754,4957,2253,695700,91790
10896,7153,3743,1875,782500,91791
9475,5347,4128,2199,653800,91792
20219,7622,12597,1879,797000,91801
9884,5030,4854,1790,831800,91803
6386,4769,1617,2064,804000,91901
6106,4848,1258,2252,916100,91902
487,429,58,1077,387800,91905
1238,961,277,1863,327900,91906
26383,13337,13046,1930,676700,91910
25375,13146,12229,1931,602000,91911
17086,12401,4685,2863,750000,91913
4869,3795,1074,3076,960000,91914
10494,7513,2981,2915,719600,91915
618,451,167,"3,500+",615700,91916
236,183,53,1543,756500,91917
280,219,61,-,-,91931
9308,2854,6454,1914,811000,91932
436,195,241,2202,353000,91934
2953,2700,253,2196,845400,91935
12689,8314,4375,2067,884800,91941
17575,7736,9839,1934,689300,91942
9420,5030,4390,1769,640500,91945
49,49,0,-,273400,91948
17951,6322,11629,1600,580700,91950
1056,978,78,2222,496800,91962
140,85,55,-,-,91963
19420,12213,7207,1897,623500,91977
3268,2149,1119,2226,597300,91978
22,22,0,-,-,91980
1704,1149,555,2099,910600,92003
1649,1205,444,-,380900,92004
4392,2675,1717,2955,1808200,92007
11814,5933,5881,2343,1142300,92008
16223,11790,4433,2955,1219600,92009
6795,4267,2528,2764,1016400,92010
9149,5864,3285,3138,1188400,92011
5753,4033,1720,3172,"2,000,000+",92014
14988,10090,4898,2141,727400,92019
19507,8413,11094,1793,741600,92020
22573,11907,10666,1818,572000,92021
19740,13356,6384,2643,1409700,92024
16612,6994,9618,1823,767400,92025
19153,12051,7102,2066,664300,92026
17038,10351,6687,1884,665900,92027
16836,12009,4827,1743,781200,92028
7704,5649,2055,2232,911600,92029
1472,1276,196,1938,544700,92036
16519,10236,6283,2632,1857800,92037
15438,10235,5203,1908,648800,92040
15064,5917,9147,1847,851100,92054
0,0,0,-,-,92055
19512,13107,6405,2536,696400,92056
18762,12890,5872,2457,691900,92057
14274,4041,10233,2583,609000,92058
426,273,153,1552,506600,92059
157,157,0,-,625000,92060
742,640,102,-,785100,92061
16421,12430,3991,2261,971600,92064
12371,9459,2912,1889,731500,92065
157,108,49,-,364000,92066
2971,2805,166,"3,500+","2,000,000+",92067
15042,8392,6650,2078,714700,92069
296,140,156,1586,482900,92070
21036,15137,5899,2202,654800,92071
5100,3442,1658,2996,1937900,92075
18327,13072,5255,2468,874000,92078
10645,5665,4980,2393,774800,92081
6388,5618,770,1473,779500,92082
11486,5387,6099,2104,607400,92083
15025,8656,6369,1936,745800,92084
593,507,86,1486,430100,92086
663,517,146,"3,500+",1695100,92091
0,0,0,-,-,92092
0,0,0,-,-,92093
0,0,0,-,-,92096
28670,7190,21480,2351,740500,92101
14608,4528,10080,1855,646600,92102
19557,6898,12659,2020,986800,92103
23142,6703,16439,1925,861600,92104
22657,7322,15335,1687,593800,92105
7552,4501,3051,2231,1359000,92106
13688,5086,8602,2208,1218200,92107
13119,3781,9338,2731,606600,92108
22218,6966,15252,2362,1136000,92109
12377,4470,7907,2298,885200,92110
17041,9053,7988,2049,754300,92111
13575,3902,9673,1608,559100,92113
18210,12783,5427,1741,604300,92114
21728,8723,13005,1875,722500,92115
16583,5330,11253,1903,898500,92116
20773,11888,8885,2115,914400,92117
6989,3814,3175,3250,1998900,92118
9464,6816,2648,2314,833100,92119
12357,7950,4407,2416,870200,92120
1647,805,842,2537,1091600,92121
19706,6617,13089,2601,1005000,92122
12364,5425,6939,2798,799600,92123
11475,5178,6297,3080,868900,92124
25230,13300,11930,2630,802000,92126
16026,11598,4428,2642,1165100,92127
20306,13297,7009,2760,875400,92128
18425,13360,5065,2671,1018100,92129
21546,13354,8192,3289,1602800,92130
12873,10444,2429,3143,1107900,92131
0,0,0,-,-,92132
16,0,16,-,-,92134
0,0,0,-,-,92135
16,0,16,-,-,92136
10031,6034,3997,2107,598500,92139
0,0,0,-,-,92140
0,0,0,-,-,92145
0,0,0,-,-,92147
22987,13803,9184,2143,606400,92154
0,0,0,-,-,92155
0,0,0,-,-,92161
7735,2733,5002,1588,521800,92173
0,0,0,-,-,92179
0,0,0,-,-,92182
22617,13454,9163,1349,372800,92201
11740,9429,2311,1990,496600,92203
2457,1899,558,1029,1002200,92210
13473,9640,3833,1903,535700,92211
12194,8798,3396,1499,324800,92220
0,0,0,-,-,92222
20011,16107,3904,1496,458300,92223
5492,3321,2171,902,197000,92225
8109,4339,3770,955,272200,92227
702,521,181,1524,260100,92230
9933,5113,4820,1049,281600,92231
1178,761,417,933,177200,92233
19157,12501,6656,1554,420700,92234
12438,8214,4224,1113,342500,92236
64,43,21,1192,221200,92239
14104,7860,6244,1367,294200,92240
3846,3119,727,961,93400,92241
675,548,127,818,134400,92242
13981,7204,6777,992,286100,92243
1667,1173,494,1015,284300,92249
2141,1128,1013,826,278600,92250
6797,4543,2254,1378,350100,92251
3350,2314,1036,1172,290800,92252
15735,11764,3971,1741,612800,92253
3219,2008,1211,961,206900,92254
1695,1142,553,1362,265100,92256
698,357,341,765,113100,92257
177,84,93,1170,-,92258
157,105,52,-,159200,92259
14525,9137,5388,1654,463500,92260
13213,8330,4883,1420,600600,92262
11480,7858,3622,1581,498200,92264
102,31,71,946,-,92266
0,0,0,-,-,92267
167,129,38,-,526000,92268
8686,7130,1556,1575,747800,92270
428,194,234,1066,190700,92273
5796,4351,1445,903,139900,92274
536,393,143,1201,139600,92275
2700,2120,580,1432,260500,92276
10893,4618,6275,1267,224300,92277
0,0,0,-,-,92278
0,0,0,-,-,92280
498,237,261,800,222100,92281
515,429,86,1197,272600,92282
589,339,250,698,91100,92283
10579,6915,3664,1346,314500,92284
1126,1031,95,976,221500,92285
9413,5739,3674,1385,316300,92301
0,0,0,-,-,92304
129,107,22,-,417900,92305
13313,9349,3964,1379,396900,92307
14028,9972,4056,1390,360800,92308
202,59,143,883,115100,92309
2828,39,2789,1601,-,92310
12279,6063,6216,1081,217500,92311
4543,2769,1774,1782,465800,92313
4365,3218,1147,1428,412800,92314
2321,1589,732,1278,538200,92315
8011,5538,2473,1450,448200,92316
348,280,68,1518,548700,92317
3877,3575,302,1852,423300,92320
371,312,59,948,480000,92321
266,244,22,-,615000,92322
18210,9806,8404,1600,413100,92324
3732,2712,1020,1514,358300,92325
378,133,245,753,-,92327
405,89,316,831,78400,92328
26,26,0,-,375000,92332
206,128,78,1775,400000,92333
25070,11948,13122,1636,433600,92335
28225,22981,5244,2064,604600,92336
9494,7129,2365,2120,519400,92337
0,0,0,-,-,92338
536,407,129,1757,503200,92339
133,116,17,-,368300,92341
2545,2218,327,1575,339700,92342
5942,4680,1262,2117,454100,92344
26086,16940,9146,1499,359700,92345
17510,11808,5702,1654,461500,92346
257,162,95,632,-,92347
13,0,13,-,-,92350
2517,2174,343,2132,627400,92352
8199,3490,4709,1711,539100,92354
2404,1617,787,1138,239100,92356
301,274,27,1841,513800,92358
3330,2207,1123,1270,411100,92359
2319,1303,1016,738,138900,92363
15,0,15,-,-,92364
936,739,197,947,161200,92365
284,165,119,1212,313700,92368
0,0,0,-,-,92369
6278,4948,1330,1701,351700,92371
1729,1387,342,1074,418700,92372
13384,6966,6418,1886,713200,92373
14443,8373,6070,1972,494000,92374
21819,13084,8735,1613,433100,92376
5497,4758,739,2395,553800,92377
197,158,39,1278,350000,92378
2159,1576,583,1731,373700,92382
10,0,10,-,-,92384
114,99,15,-,388300,92385
906,548,358,1946,447200,92386
98,86,12,-,-,92389
955,682,273,1473,313100,92391
17104,11380,5724,1790,365800,92392
9856,6265,3591,1564,340200,92394
15583,8231,7352,1478,335900,92395
2619,2083,536,1668,457400,92397
655,340,315,626,185500,92398
18274,13255,5019,1658,472400,92399
734,109,625,1155,348400,92401
18702,9205,9497,1386,383700,92404
9382,4651,4731,1424,376800,92405
18346,10612,7734,1771,473200,92407
4093,1583,2510,1314,407300,92408
13379,5593,7786,1303,273700,92410
6650,3793,2857,1355,318500,92411
0,0,0,-,-,92415
6912,3113,3799,1615,466400,92501
24727,16302,8425,1801,556300,92503
16108,10210,5898,1758,501800,92504
14538,7449,7089,1936,520800,92505
14891,11613,3278,1814,634900,92506
18314,6459,11855,1780,503000,92507
10251,8211,2040,2560,656800,92508
20138,14406,5732,1698,501200,92509
552,31,521,1845,-,92518
0,0,0,-,-,92521
17430,11857,5573,1705,467400,92530
7933,6026,1907,2584,553100,92532
1085,958,127,1120,399300,92536
1258,1018,240,1254,298000,92539
13939,7807,6132,1306,250800,92543
16300,10744,5556,1530,356200,92544
16457,12262,4195,1778,334900,92545
2100,1590,510,1632,217300,92548
1648,1192,456,1415,486300,92549
8348,5693,2655,2046,435700,92551
19504,9813,9691,1892,413000,92553
11864,9046,2818,2376,543300,92555
15272,10043,5229,2081,471700,92557
803,668,135,1383,560100,92561
21365,15054,6311,2262,629000,92562
22989,17155,5834,2588,615700,92563
2825,2259,566,1678,496600,92567
14289,9328,4961,1461,419800,92570
14286,10247,4039,2005,430800,92571
5555,4761,794,2328,439000,92582
9682,6420,3262,1501,339500,92583
17356,14648,2708,2301,562100,92584
8190,6781,1409,2200,499800,92585
9177,6740,2437,1660,338200,92586
6119,4668,1451,2149,593800,92587
1949,660,1289,1289,1201400,92590
13891,8279,5612,2196,649900,92591
24914,19580,5334,2580,664000,92592
9891,7563,2328,2042,523500,92595
9646,8001,1645,2573,615500,92596
9495,4287,5208,2895,1323200,92602
7379,4113,3266,3435,1718800,92603
10037,6208,3829,2728,993900,92604
8925,3357,5568,2845,1046700,92606
4605,3749,856,3120,939000,92610
14328,3861,10467,2803,938900,92612
12018,4306,7712,2773,983100,92614
4296,1370,2926,1505,666500,92617
24179,9555,14624,3053,1153400,92618
21322,12016,9306,3125,1204100,92620
2736,1653,1083,2786,1142400,92624
5604,3513,2091,"3,500+","2,000,000+",92625
19484,8188,11296,2520,1037700,92626
22389,8301,14088,2299,1074900,92627
11216,7089,4127,2925,1212400,92629
23242,15833,7409,2614,858900,92630
11797,8423,3374,2232,364900,92637
21419,16066,5353,2570,1031700,92646
21315,9285,12030,2400,963900,92647
20023,9363,10660,2324,1176000,92648
14545,8445,6100,2554,1070800,92649
11141,7261,3880,2812,"2,000,000+",92651
10685,7537,3148,2637,978400,92653
2557,695,1862,1443,723700,92655
20226,11650,8576,2764,849900,92656
3810,2726,1084,"3,500+","2,000,000+",92657
15496,7696,7800,3349,"2,000,000+",92660
1645,635,1010,2836,"2,000,000+",92661
1196,610,586,2736,"2,000,000+",92662
10352,5043,5309,2717,"2,000,000+",92663
15293,7865,7428,2370,1240000,92672
9569,7630,1939,3412,1207600,92673
12095,9498,2597,2500,929700,92675
732,657,75,2131,797000,92676
25486,16949,8537,2819,1123000,92677
235,235,0,-,988600,92678
10521,9426,1095,3276,1242900,92679
27858,14541,13317,2101,820000,92683
15958,11099,4859,2508,857100,92688
16172,12457,3715,2517,916800,92691
17063,13055,4008,2812,983800,92692
11805,8779,3026,3318,1042600,92694
0,0,0,-,-,92697
12908,3770,9138,1650,608300,92701
14355,6985,7370,1922,585900,92703
20281,10185,10096,2147,641600,92704
15997,9838,6159,2250,1135600,92705
10195,5220,4975,1890,839100,92706
14198,6902,7296,2141,635600,92707
18840,12462,6378,2507,1018600,92708
17397,7962,9435,2211,832200,92780
11227,6945,4282,2778,1028900,92782
18783,6841,11942,1977,632600,92801
12156,4377,7779,1985,721700,92802
24644,10156,14488,1990,729700,92804
21718,8764,12954,2045,667400,92805
12545,5252,7293,2234,791200,92806
12640,10092,2548,2959,918000,92807
7628,5536,2092,2801,1036800,92808
14784,8571,6213,2254,851800,92821
1782,1421,361,"3,500+",1061200,92823
12823,5179,7644,2093,821300,92831
8546,3108,5438,2027,773100,92832
16568,9311,7257,2155,844000,92833
9387,6700,2687,2410,981700,92835
15891,8486,7405,1955,746900,92840
9619,5301,4318,1983,766400,92841
11630,5698,5932,1878,665900,92843
6910,2835,4075,1989,706900,92844
5481,4365,1116,2531,882600,92845
6803,5569,1234,1893,732600,92860
1895,1672,223,-,1686200,92861
6999,4679,2320,2343,842700,92865
5591,1893,3698,1955,892200,92866
13317,9052,4265,2209,951000,92867
8585,2723,5862,2356,714300,92868
11647,8473,3174,2335,935200,92869
16979,10752,6227,2267,871000,92870
14427,8339,6088,1968,592000,92879
20092,15444,4648,2596,724200,92880
9043,7431,1612,2150,723800,92881
20168,12685,7483,2093,653600,92882
12405,10066,2339,2855,671700,92883
16688,13740,2948,3001,1062200,92886
6967,5846,1121,2606,1130900,92887
12932,5776,7156,1881,760700,93001
19917,11535,8382,2173,781600,93003
11281,7516,3765,2380,750700,93004
16273,10566,5707,2455,809900,93010
13658,9368,4290,2790,794400,93012
6392,3811,2581,2331,1074600,93013
5813,3694,2119,1781,590300,93015
11716,9274,2442,2651,862600,93021
2136,1734,402,2489,704500,93022
8490,6237,2253,1831,888700,93023
15190,6905,8285,1853,639800,93030
16903,9699,7204,1810,549400,93033
9398,5854,3544,2478,747300,93035
14167,7357,6810,2199,648800,93036
469,349,120,1689,580800,93040
7889,3439,4450,2159,555600,93041
0,0,0,-,-,93042
0,0,0,-,-,93043
10358,5614,4744,1678,582900,93060
19770,14581,5189,2385,746000,93063
0,0,0,-,-,93064
25632,18687,6945,2612,759700,93065
1065,789,276,2287,1366100,93066
398,291,107,-,1597400,93067
12758,2786,9972,2109,1122200,93101
7621,3505,4116,2407,1555600,93103
10588,5678,4910,2572,1496500,93105
38,0,38,2725,-,93106
4724,3562,1162,"3,500+","2,000,000+",93108
4567,2498,2069,2870,1836300,93109
6515,3894,2621,2358,1101100,93110
6346,4276,2070,2838,1171400,93111
16964,6496,10468,1980,1021700,93117
271,86,185,1045,92600,93201
946,582,364,1282,263000,93202
4768,2498,2270,1086,247800,93203
2949,1322,1627,1060,224800,93204
839,472,367,1057,104700,93205
551,193,358,1086,229900,93206
81,63,18,-,259400,93207
148,148,0,-,306300,93208
4656,2459,2197,1034,258300,93210
4607,2300,2307,1030,220500,93212
12681,7587,5094,1085,271700,93215
155,106,49,1234,174400,93218
2298,1261,1037,945,266000,93219
0,0,0,-,-,93220
4719,2979,1740,1267,324000,93221
1211,991,220,1846,363800,93222
2644,1739,905,1034,237700,93223
144,119,25,1125,180800,93224
2007,1295,712,1433,334100,93225
33,20,13,-,420000,93226
59,26,33,-,-,93227
21947,13489,8458,1208,321900,93230
1637,446,1191,1051,236500,93234
1207,702,505,916,234200,93235
68,25,43,-,406300,93237
447,438,9,-,365400,93238
511,84,427,1063,133900,93239
2606,1822,784,1129,203500,93240
4401,1820,2581,946,199400,93241
912,570,342,1130,347400,93242
456,315,141,-,348800,93243
60,60,0,-,-,93244
12037,5817,6220,1470,324100,93245
0,0,0,-,-,93246
5347,2959,2388,957,271700,93247
541,174,367,844,165900,93249
3798,2013,1785,1063,244700,93250
73,35,38,867,243800,93251
559,325,234,963,165400,93252
335,280,55,-,216400,93254
383,326,57,-,188200,93255
1350,604,746,1207,240000,93256
23743,13165,10578,1086,276400,93257
338,144,194,1043,187500,93258
60,55,5,-,360500,93260
522,226,296,900,201200,93261
0,0,0,-,-,93262
6195,3931,2264,1182,301900,93263
1287,1213,74,-,440800,93265
358,195,163,989,271500,93266
1506,954,552,875,245600,93267
5724,2808,2916,998,225000,93268
1604,1078,526,1082,291800,93270
1106,759,347,1626,457500,93271
1073,353,720,1149,257500,93272
23127,13323,9804,1334,300900,93274
60,39,21,917,192500,93276
18347,11107,7240,1406,320500,93277
6299,3696,2603,996,255300,93280
992,814,178,1007,143900,93283
1357,993,364,921,202800,93285
2987,1589,1398,983,288300,93286
60,59,1,-,266100,93287
19017,11332,7685,1331,381600,93291
14331,8920,5411,1418,330600,93292
5730,2216,3514,1129,264300,93301
15599,6778,8821,1141,228800,93304
11224,3830,7394,1065,245000,93305
22238,14081,8157,1219,290700,93306
23128,10842,12286,1195,238400,93307
20073,9868,10205,1260,298000,93308
22286,10769,11517,1268,286600,93309
16778,11877,4901,1884,425500,93311
18382,14378,4004,1958,420500,93312
16615,12913,3702,1857,349800,93313
10980,9267,1713,1909,506800,93314
13460,6380,7080,1859,943500,93401
6232,4346,1886,1909,729200,93402
8558,2799,5759,1936,897800,93405
16,0,16,-,-,93407
0,0,0,-,-,93408
0,0,0,-,-,93409
0,0,0,-,-,93410
12642,8367,4275,2025,872200,93420
13106,8499,4607,1841,692100,93422
514,418,96,2063,1179600,93424
547,375,172,876,472000,93426
2267,1418,849,2088,762500,93427
2912,2259,653,1909,869600,93428
87,27,60,-,-,93429
1590,953,637,1571,965100,93430
464,388,76,1776,899500,93432
4973,2755,2218,1921,691900,93433
2153,1224,929,1674,454200,93434
18135,10131,8004,1578,460100,93436
1179,0,1179,2462,-,93437
491,390,101,-,672100,93440
405,348,57,-,1343800,93441
5227,3191,2036,1815,870600,93442
7671,5674,1997,2034,746400,93444
2912,1764,1148,1450,538200,93445
17423,11910,5513,1946,661400,93446
4112,2757,1355,2298,992900,93449
171,100,71,1148,427300,93450
1554,1012,542,1956,582200,93451
173,70,103,1343,276600,93452
1027,576,451,638,720100,93453
11928,6339,5589,1750,477600,93454
15469,12039,3430,2267,572700,93455
13961,6075,7886,1825,460300,93458
2397,1649,748,2604,1187700,93460
443,367,76,1599,454700,93461
3376,2113,1263,1895,1044100,93463
3891,2999,892,2417,875200,93465
2153,975,1178,1175,183400,93501
4647,2666,1981,1016,239600,93505
2524,2338,186,1755,713000,93510
175,150,25,-,278600,93512
681,520,161,1000,288700,93513
6022,4359,1663,1340,434900,93514
1022,601,421,981,102500,93516
164,152,12,225,321100,93517
458,398,60,1384,268400,93518
0,0,0,-,-,93519
29,29,0,-,-,93522
1296,311,985,2194,149400,93523
0,0,0,-,-,93524
361,265,96,1000,268400,93526
808,665,143,922,328000,93527
26,26,0,-,-,93528
103,51,52,-,705600,93529
21,0,21,-,-,93530
215,215,0,-,291300,93531
1019,794,225,1700,410000,93532
14997,5472,9525,1513,339900,93534
22708,14753,7955,1650,336200,93535
22930,15898,7032,1946,484900,93536
313,273,40,-,333600,93541
3551,2473,1078,1658,354100,93543
452,374,78,-,340000,93544
671,387,284,777,192800,93545
3838,2482,1356,1619,618800,93546
137,84,53,1571,325000,93549
22832,12064,10768,1573,378700,93550
16997,13115,3882,2263,548800,93551
11009,8477,2532,1851,414600,93552
601,507,94,-,368600,93553
52,52,0,-,"10,000-",93554
13073,8201,4872,1180,235400,93555
0,0,0,-,-,93558
6825,5337,1488,1229,324700,93560
12284,9701,2583,1299,377400,93561
683,448,235,809,60200,93562
41,31,10,-,-,93563
0,0,0,-,-,93581
1954,1490,464,1463,299200,93591
568,552,16,-,393100,93601
1110,938,172,1361,351000,93602
106,47,59,-,330000,93603
171,171,0,-,1043300,93604
31,15,16,1075,-,93605
261,135,126,952,237100,93606
253,87,166,691,144800,93608
1328,646,682,1227,263100,93609
5639,3073,2566,1239,342000,93610
15534,11417,4117,2101,457500,93611
13948,5706,8242,1410,311700,93612
4197,3641,556,1859,355100,93614
1429,660,769,1297,218200,93615
598,331,267,877,220100,93616
8604,5168,3436,1125,272600,93618
16353,14287,2066,2404,579400,93619
3376,1685,1691,1081,295100,93620
140,140,0,-,-,93621
2839,1302,1537,924,236100,93622
0,0,0,-,-,93623
186,32,154,695,-,93624
2841,1553,1288,1232,368700,93625
1132,1070,62,1176,594800,93626
70,0,70,-,-,93627
218,39,179,-,-,93628
6044,3130,2914,1187,343400,93630
5804,4072,1732,1117,379600,93631
32,32,0,-,-,93633
0,0,0,-,-,93634
14164,8162,6002,1505,423900,93635
4404,3890,514,1788,483300,93636
12047,6962,5085,1345,369200,93637
12116,6497,5619,1218,291500,93638
3416,1554,1862,841,255000,93640
116,66,50,-,-,93641
1213,972,241,1293,339300,93643
2773,2192,581,1301,378000,93644
293,172,121,-,366700,93645
2594,1135,1459,993,240500,93646
2842,1544,1298,927,232500,93647
3781,1708,2073,1067,239600,93648
1022,367,655,1178,306000,93650
545,335,210,1213,424400,93651
107,81,26,1000,194400,93652
516,439,77,1463,517700,93653
9097,5114,3983,1198,334500,93654
1592,745,847,965,272200,93656
10693,7238,3455,1123,382700,93657
978,364,614,1070,270800,93660
9187,5344,3843,1220,297800,93662
179,154,25,-,618200,93664
128,55,73,-,-,93665
172,36,136,869,333300,93666
840,715,125,1567,354900,93667
275,183,92,1233,332500,93668
60,60,0,-,289500,93669
35,0,35,-,-,93670
105,70,35,1038,179200,93673
1207,981,226,1042,284100,93675
3525,384,3141,926,207600,93701
12789,4369,8420,1110,211900,93702
10504,4160,6344,1204,250200,93703
11632,6315,5317,1392,366000,93704
12795,6202,6593,1254,281300,93705
11624,4349,7275,1129,227600,93706
12111,5226,6885,1337,348600,93710
16133,10283,5850,1561,469800,93711
18758,10730,8028,1990,457800,93720
2410,198,2212,915,219000,93721
26717,16187,10530,1529,350700,93722
3693,2986,707,1598,460400,93723
6672,4286,2386,1222,262400,93725
15054,5747,9307,1254,271800,93726
24660,15529,9131,1277,370300,93727
6462,2631,3831,1243,239700,93728
4852,3928,924,2397,707700,93730
2011,1885,126,-,470800,93737
0,0,0,-,-,93740
67,67,0,-,-,93741
10756,4919,5837,1792,721100,93901
14056,5866,8190,1799,570000,93905
17964,9770,8194,2127,595200,93906
7234,4940,2294,2122,676700,93907
4365,3625,740,1650,1071000,93908
517,194,323,1085,1803800,93920
1455,766,689,2980,"2,000,000+",93921
5478,4139,1339,2214,1570800,93923
2627,2111,516,2093,1133000,93924
342,150,192,1234,655600,93925
2399,1336,1063,1515,597600,93926
4737,2428,2309,1658,463600,93927
0,0,0,-,-,93928
4383,2334,2049,1537,404000,93930
189,166,23,-,550000,93932
9772,3888,5884,2015,776900,93933
13948,6000,7948,2305,1039700,93940
5,0,5,-,-,93943
6,0,6,-,-,93944
6988,3409,3579,2384,1129400,93950
1674,1426,248,"3,500+",1796900,93953
75,33,42,1643,302900,93954
10482,3865,6617,2312,693800,93955
4849,2871,1978,1492,567500,93960
110,73,37,-,829500,93962
10608,5957,4651,2889,"2,000,000+",94002
1867,1129,738,2634,1127200,94005
16252,9854,6398,2655,"2,000,000+",94010
14107,8375,5732,2089,979500,94014
20514,12400,8114,2760,1152900,94015
1390,1124,266,2034,1405400,94018
5299,4028,1271,1977,1509300,94019
762,605,157,-,1158100,94020
148,110,38,-,1020800,94021
7268,5862,1406,"3,500+","2,000,000+",94022
8016,7063,953,"3,500+","2,000,000+",94024
14318,8503,5815,3169,"2,000,000+",94025
2275,1989,286,"3,500+","2,000,000+",94027
2625,2220,405,"3,500+","2,000,000+",94028
7998,5055,2943,3401,1929700,94030
1061,950,111,-,1467400,94037
988,954,34,-,1112900,94038
15347,5561,9786,3017,"2,000,000+",94040
6652,2016,4636,2927,"2,000,000+",94041
13257,5973,7284,2965,1647500,94043
13982,9570,4412,3075,1211700,94044
358,216,142,854,1338200,94060
13144,6958,6186,2818,1938300,94061
9740,6947,2793,2885,"2,000,000+",94062
11291,3556,7735,2802,1077100,94063
4617,3036,1581,"3,500+",1847000,94065
15463,9556,5907,2696,1199400,94066
11331,7820,3511,2802,"2,000,000+",94070
39,25,14,-,-,94074
22033,13391,8642,2840,1159500,94080
9112,3597,5515,3187,1534500,94085
20166,6218,13948,2923,1784200,94086
20384,11293,9091,3222,"2,000,000+",94087
9129,4659,4470,3351,392000,94089
19543,1687,17856,1517,996300,94102
17352,3337,14015,2146,1057600,94103
263,81,182,783,1992600,94104
8316,3121,5195,"3,500+",1461700,94105
15761,5746,10015,3378,1227000,94107
6326,578,5748,1562,1207500,94108
31899,5775,26124,2172,1390000,94109
26984,11231,15753,2404,1500200,94110
2471,486,1985,2334,1217300,94111
23274,15681,7593,2326,1159600,94112
16804,7478,9326,2898,1771700,94114
16725,4146,12579,2380,1684100,94115
15355,11361,3994,2938,1450000,94116
17558,4969,12589,2786,1641400,94117
16995,6162,10833,2695,1817200,94118
18175,7824,10351,2327,1634600,94121
22375,10891,11484,2720,1507100,94122
12510,3596,8914,3248,"2,000,000+",94123
10982,5536,5446,1368,1043200,94124
7466,6106,1360,"3,500+",1897700,94127
0,0,0,-,-,94128
1338,0,1338,"3,500+",-,94129
617,0,617,2538,-,94130
12469,6737,5732,2971,1749500,94131
10686,4955,5731,2503,1458700,94132
12954,2264,10690,1985,1519100,94133
12545,8090,4455,1674,1064100,94134
4907,1772,3135,3316,1501100,94158
0,0,0,-,-,94188
7080,3653,3427,3290,"2,000,000+",94301
14485,8259,6226,2710,1825000,94303
2117,512,1605,3496,"2,000,000+",94304
3689,980,2709,1937,"2,000,000+",94305
10794,5637,5157,2927,"2,000,000+",94306
13086,5807,7279,2713,1123300,94401
9944,5897,4047,3476,"2,000,000+",94402
16372,8836,7536,3273,1725900,94403
14583,7446,7137,"3,500+",1682700,94404
25028,10462,14566,2362,1213100,94501
4782,4154,628,"3,500+",1182600,94502
5971,4648,1323,2370,663900,94503
5522,4900,622,2894,787500,94505
9294,8256,1038,"3,500+",1789600,94506
5181,4789,392,"3,500+","2,000,000+",94507
967,636,331,1651,774600,94508
23431,13666,9765,2052,565300,94509
10925,7776,3149,2234,778900,94510
900,646,254,1390,549500,94511
89,0,89,-,-,94512
21933,17964,3969,2449,793900,94513
581,368,213,2496,852900,94514
2671,1680,991,1830,830700,94515
73,53,20,1250,786800,94516
4425,3985,440,"3,500+",995600,94517
10217,7066,3151,2290,826500,94518
7098,5030,2068,2340,727600,94519
13287,4968,8319,2118,572400,94520
15607,11440,4167,2388,823100,94521
13817,8772,5045,2479,1038400,94523
1703,919,784,2186,709000,94525
11942,10006,1936,"3,500+",1588000,94526
371,371,0,-,"2,000,000+",94528
10923,6313,4610,2434,1097300,94530
13611,9846,3765,3063,660200,94531
24645,13519,11126,1980,497300,94533
13738,10466,3272,2699,700900,94534
1000,8,992,3024,-,94535
25211,14418,10793,2835,1210200,94536
23149,10365,12784,2860,1104800,94538
16876,13436,3440,3183,1878400,94539
21801,10286,11515,2229,781900,94541
4866,3489,1377,2605,1085900,94542
22920,12253,10667,2339,801900,94544
10097,7051,3046,2426,838800,94545
15918,10469,5449,2506,976300,94546
9319,7560,1759,3003,741200,94547
196,196,0,-,918100,94548
10291,8104,2187,2902,1968500,94549
17524,13035,4489,2681,1146700,94550
14199,9945,4254,2589,931000,94551
5016,4687,329,2925,1286300,94552
19134,13730,5404,2247,781400,94553
11784,8166,3618,3207,1295000,94555
5682,4800,882,3119,1594100,94556
24501,16477,8024,2248,855600,94558
10560,5271,5289,2044,877100,94559
15184,10582,4602,2730,1094200,94560
13903,10584,3319,1982,632100,94561
0,0,0,-,-,94562
7349,6770,579,2407,1810100,94563
6882,5222,1660,2738,697100,94564
30268,18214,12054,2145,563300,94565
15923,11334,4589,2639,1592200,94566
231,159,72,2205,386300,94567
23811,15504,8307,3174,1224100,94568
144,51,93,-,586500,94569
5440,4207,1233,1444,479900,94571
2958,1723,1235,2143,653500,94572
43,13,30,-,-,94573
3293,2189,1104,2065,1876500,94574
0,0,0,-,-,94575
64,49,15,-,1058600,94576
16870,9435,7435,2199,824900,94577
14060,5798,8262,2077,793500,94578
6692,5057,1635,1972,815900,94579
8782,6466,2316,2164,820100,94580
16166,11285,4881,2880,1543800,94582
13776,9883,3893,2973,1234400,94583
9585,5793,3792,2156,551400,94585
337,271,66,"3,500+",1557900,94586
21202,14215,6987,2713,1058200,94587
12182,7612,4570,3287,1277200,94588
9451,5976,3475,2127,478800,94589
15210,6689,8521,1768,510700,94590
19711,13227,6484,2218,602200,94591
441,387,54,2708,681300,94592
9341,7626,1715,2677,816600,94595
10801,4848,5953,2471,1245000,94596
10731,4983,5748,2557,986700,94597
10493,7987,2506,2989,1307100,94598
1507,993,514,2115,757300,94599
16447,5670,10777,1651,703100,94601
12287,7285,5002,1924,1111800,94602
10598,4901,5697,1838,596100,94603
16739,10465,6274,1867,840700,94605
15883,3173,12710,1775,747600,94606
12697,3869,8828,1875,744600,94607
16211,5344,10867,2561,826900,94608
10998,3566,7432,2116,1147900,94609
16115,5949,10166,2184,1324500,94610
17840,10734,7106,2274,1485000,94611
10164,1032,9132,1936,814000,94612
0,0,0,-,-,94613
7341,4845,2496,2742,1789100,94618
9875,6609,3266,2131,997300,94619
10494,3676,6818,1527,537600,94621
7419,3629,3790,1974,1168200,94702
8732,3441,5291,2257,1273000,94703
8262,964,7298,1987,918500,94704
5823,3434,2389,2330,1892300,94705
8031,4328,3703,2394,1188100,94706
5188,4511,677,2406,1626500,94707
4754,3975,779,2926,1517100,94708
5310,1334,3976,1988,1240500,94709
3744,1345,2399,2546,1084500,94710
195,46,149,"3,500+",-,94720
10421,4845,5576,1608,593500,94801
9500,6840,2660,2295,729000,94803
16080,7821,8259,1825,618000,94804
5727,3872,1855,2272,738800,94805
20304,10281,10023,2013,582000,94806
15663,7816,7847,2229,1369500,94901
12226,8013,4213,3026,1149400,94903
5651,3600,2051,2538,"2,000,000+",94904
4942,3607,1335,"3,500+","2,000,000+",94920
55,55,0,-,-,94922
684,546,138,1540,1177900,94923
551,417,134,1750,"2,000,000+",94924
4037,2802,1235,3468,1702000,94925
16841,8521,8320,2211,634700,94928
129,105,24,-,1564200,94929
3544,2323,1221,2314,1152100,94930
4119,2481,1638,1780,788200,94931
585,422,163,3172,886100,94933
565,433,132,1698,1536500,94937
246,174,72,"3,500+",1005100,94938
3431,1691,1740,3104,"2,000,000+",94939
123,67,56,-,-,94940
12534,8348,4186,2949,1990100,94941
7093,5075,2018,2168,1094300,94945
288,238,50,2000,"2,000,000+",94946
8938,6220,2718,2526,995000,94947
7226,4507,2719,2596,1075600,94949
18,18,0,-,-,94950
1472,979,493,2178,1213100,94951
13990,8387,5603,2272,1016800,94952
14886,9928,4958,2405,790100,94954
678,425,253,2089,"2,000,000+",94956
709,591,118,3482,"2,000,000+",94957
6192,4362,1830,2838,1589200,94960
195,173,22,-,1220800,94963
110,0,110,-,-,94964
6253,3525,2728,2952,1492600,94965
187,144,43,2291,1458300,94970
92,70,22,-,880000,94971
41,5,36,-,-,94972
652,578,74,2280,1111100,94973
545,379,166,2366,1023400,95002
9846,7112,2734,2548,1154000,95003
1291,971,320,1953,914000,95004
2774,1973,801,2358,959100,95005
3323,2546,777,1985,779300,95006
170,136,34,1407,789500,95007
18700,9135,9565,2694,1578800,95008
4161,1934,2227,2370,781900,95010
2480,1130,1350,1499,629600,95012
13,13,0,-,-,95013
21960,13051,8909,"3,500+","2,000,000+",95014
231,105,126,1500,993100,95017
2784,2291,493,2259,778100,95018
1873,591,1282,1468,678200,95019
19621,12587,7034,2256,1005600,95020
17523,11798,5725,1908,740500,95023
5201,4045,1156,2858,"2,000,000+",95030
10508,6601,3907,3123,"2,000,000+",95032
3869,3069,800,2849,1284500,95033
24801,14714,10087,3110,1180700,95035
16512,11890,4622,2242,1152400,95037
374,228,146,1371,440700,95039
337,188,149,1360,1060200,95041
230,143,87,1316,1095600,95043
1599,1068,531,2149,835500,95045
1947,1420,527,2312,1396600,95046
15552,6422,9130,2522,1420500,95050
23571,10260,13311,3054,1623600,95051
45,0,45,-,-,95053
9419,3330,6089,3413,1475400,95054
18280,9484,8796,2356,1189300,95060
15478,8290,7188,2291,1064600,95062
495,174,321,1572,437500,95064
2952,2063,889,2618,1192200,95065
6159,4655,1504,2384,1113000,95066
11124,9636,1488,"3,500+","2,000,000+",95070
4448,3258,1190,2093,1012000,95073
174,151,23,-,853600,95075
24799,13940,10859,1851,767200,95076
6740,2711,4029,2629,947900,95110
15833,9547,6286,1954,826200,95111
21264,5935,15329,2095,956300,95112
1501,224,1277,2914,953100,95113
13455,5313,8142,2049,842700,95116
10144,3611,6533,2367,1425200,95117
11329,7142,4187,2488,1377000,95118
3503,2577,926,2978,1176100,95119
12583,11158,1425,"3,500+",1924500,95120
9783,7541,2242,2912,1024700,95121
12017,6340,5677,2424,838900,95122
24251,14617,9634,2953,1108100,95123
17523,12637,4886,2936,1596700,95124
20927,12577,8350,2394,1646000,95125
15920,5441,10479,2544,1195700,95126
15804,10386,5418,2549,995100,95127
14070,6229,7841,2505,1214500,95128
14177,8235,5942,2746,"2,000,000+",95129
4745,3025,1720,2273,1774900,95130
9954,6297,3657,3182,1134200,95131
11913,8883,3030,3092,1263600,95132
8992,5213,3779,2275,1074300,95133
13761,1845,11916,3272,371200,95134
7583,6562,1021,"3,500+",1458800,95135
16058,9430,6628,2750,1104300,95136
5638,4636,1002,2728,1355000,95138
2172,1706,466,"3,500+",1125200,95139
32,32,0,-,"2,000,000+",95140
12111,9682,2429,3217,1211400,95148
3209,177,3032,864,322300,95202
5395,2200,3195,1248,349800,95203
11303,6634,4669,1381,358300,95204
10636,5295,5341,1264,288600,95205
17500,10604,6896,1546,388500,95206
18952,7782,11170,1549,409000,95207
13468,9997,3471,1813,464900,95209
12129,6288,5841,1450,336900,95210
0,0,0,-,-,95211
7993,5916,2077,2252,499200,95212
6741,4114,2627,1254,378900,95215
11244,6595,4649,1855,539900,95219
2676,1927,749,1358,718500,95220
85,58,27,-,-,95221
2187,1893,294,1769,488000,95222
1437,1289,148,1527,475800,95223
124,114,10,-,-,95224
376,207,169,730,571900,95225
0,0,0,-,-,95226
363,349,14,-,730200,95227
1810,1485,325,1931,453400,95228
182,84,98,2160,611100,95230
619,368,251,2005,477600,95231
51,51,0,-,385000,95232
134,134,0,-,298200,95233
1690,1086,604,1326,648300,95236
1443,1150,293,1214,423000,95237
16145,8025,8120,1439,443700,95240
10478,7216,3262,1925,549700,95242
1314,1102,212,1394,424700,95245
544,481,63,1375,409400,95246
1752,1353,399,1950,513700,95247
15,15,0,-,-,95248
1758,1280,478,1390,409000,95249
372,327,45,-,389900,95251
4808,4420,388,1778,444200,95252
136,36,100,1281,-,95253
167,90,77,-,456300,95254
756,646,110,1143,271700,95255
164,98,66,-,335500,95257
1526,1265,261,1457,553700,95258
12961,7354,5607,1215,367800,95301
302,184,118,1011,602100,95303
4668,2962,1706,2299,869300,95304
56,31,25,-,-,95305
387,351,36,-,-,95306
12847,8367,4480,1455,402300,95307
0,0,0,-,-,95309
767,547,220,1015,448800,95310
1086,917,169,1904,295700,95311
64,39,25,675,-,95312
405,141,264,1155,596400,95313
3482,2432,1050,1186,338300,95315
2508,1652,856,1387,453600,95316
269,75,194,1056,395500,95317
322,198,124,712,298100,95318
495,221,274,1101,328800,95319
4647,3435,1212,1624,490100,95320
1623,1413,210,1463,377100,95321
3212,1720,1492,1270,433400,95322
423,289,134,1075,523100,95323
2475,1247,1228,1555,441500,95324
0,0,0,-,-,95325
4014,2473,1541,1543,498900,95326
2985,1946,1039,1136,366700,95327
1162,560,602,1373,435100,95328
1040,922,118,1431,386800,95329
8567,7165,1402,2341,605100,95330
786,521,265,1003,309600,95333
4164,2290,1874,1340,346300,95334
82,82,0,-,247500,95335
15938,11112,4826,1774,522800,95336
13639,9965,3674,2049,611200,95337
4750,3551,1199,1281,367000,95338
12614,7095,5519,1204,383200,95340
9090,3568,5522,1172,295300,95341
216,177,39,-,415700,95345
398,304,94,1353,516100,95346
11213,5300,5913,1498,352700,95348
19476,11138,8338,1483,397100,95350
13040,6348,6692,1376,315700,95351
9100,4362,4738,1463,360300,95354
21368,13020,8348,1719,447600,95355
11482,7657,3825,1794,495800,95356
4297,3028,1269,2001,417800,95357
8263,5037,3226,1553,401100,95358
4132,2932,1200,1244,385500,95360
12292,8426,3866,1496,479900,95361
8127,5849,2278,1464,448000,95363
0,0,0,-,-,95364
1205,595,610,893,237200,95365
6473,4345,2128,1809,672900,95366
7435,5133,2302,1526,444700,95367
4337,3455,882,2004,448700,95368
336,203,133,946,350600,95369
12326,8722,3604,1313,416200,95370
664,554,110,1720,354400,95372
569,295,274,1061,435700,95374
63,22,41,-,-,95375
16628,10072,6556,2023,588200,95376
9612,7094,2518,2837,773500,95377
1503,1252,251,-,404500,95379
14875,7487,7388,1348,410300,95380
13800,8718,5082,1790,483100,95382
1655,1386,269,1850,453700,95383
228,122,106,965,-,95385
2908,1613,1295,1543,391100,95386
268,87,181,1289,348900,95387
3720,2022,1698,1108,307900,95388
347,91,256,2037,912500,95389
6630,4851,1779,3232,859600,95391
13831,7821,6010,1978,628900,95401
16567,9097,7470,2215,651900,95403
15642,9269,6373,1890,865900,95404
9419,5713,3706,2315,749700,95405
13098,6699,6399,1822,603300,95407
11693,7975,3718,2346,807800,95409
352,269,83,-,706300,95410
110,73,37,-,746300,95412
374,225,149,1330,638200,95415
53,53,0,-,-,95417
113,70,43,-,-,95419
183,118,65,-,1103300,95420
636,507,129,1595,642700,95421
5845,3495,2350,1162,206300,95422
1599,1107,492,1350,285300,95423
4515,3204,1311,1307,647000,95425
610,545,65,-,348000,95426
209,151,58,-,867900,95427
972,562,410,913,376400,95428
78,78,0,-,376500,95429
0,0,0,-,-,95430
0,0,0,-,-,95431
331,228,103,-,728100,95432
81,0,81,-,-,95435
2382,1677,705,1947,704100,95436
6337,3677,2660,1367,541400,95437
276,243,33,-,817800,95439
745,486,259,1570,1277800,95441
1421,1030,391,1720,1360500,95442
18,11,7,-,-,95443
240,217,23,-,865500,95444
861,576,285,2208,664700,95445
2452,1696,756,1546,585900,95446
6495,4056,2439,2129,1030100,95448
593,247,346,1673,597200,95449
99,74,25,2161,797600,95450
4982,3609,1373,1302,340700,95451
559,404,155,2969,969200,95452
4657,3471,1186,1091,371100,95453
728,563,165,750,385000,95454
437,288,149,859,489900,95456
1419,1083,336,1078,414100,95457
1457,1058,399,1368,237100,95458
328,199,129,-,643100,95459
1062,816,246,1908,666200,95460
1319,941,378,2192,385000,95461
612,492,120,1375,713800,95462
7,7,0,-,-,95463
997,636,361,1425,154100,95464
525,335,190,1820,1122500,95465
229,157,72,-,698900,95466
2143,1832,311,2276,394000,95467
689,419,270,1792,451400,95468
618,417,201,1406,593800,95469
2182,1460,722,1285,533000,95470
351,252,99,1886,617500,95471
11608,8360,3248,1918,995200,95472
14996,10083,4913,2127,882300,95476
1,0,1,-,-,95480
11734,6595,5139,1335,473000,95482
1203,879,324,1013,364600,95485
15,6,9,-,-,95486
220,220,0,-,-,95488
5578,3502,2076,1243,383900,95490
9643,7234,2409,2149,777700,95492
34,34,0,-,750000,95493
80,30,50,-,-,95494
654,622,32,1350,1198200,95497
9502,4012,5490,1151,389900,95501
9976,6956,3020,1485,411500,95503
47,47,0,-,-,95511
16,16,0,-,-,95514
7550,4627,2923,1442,432600,95519
8860,3251,5609,1300,478600,95521
709,567,142,1755,585100,95524
733,395,338,1221,489600,95525
283,179,104,815,338000,95526
271,185,86,-,426100,95527
562,455,107,1075,514800,95528
7691,5212,2479,1202,323600,95531
1299,819,480,1239,570800,95536
105,35,70,-,360300,95537
414,414,0,-,285900,95538
5696,3335,2361,1135,362400,95540
1227,715,512,1442,413800,95542
241,195,46,882,365300,95543
75,61,14,-,479500,95545
755,568,187,839,252800,95546
457,408,49,850,489100,95547
369,281,88,995,224200,95548
362,276,86,1917,661200,95549
90,26,64,-,857100,95550
657,304,353,1338,469800,95551
225,133,92,420,196700,95552
355,301,54,-,437900,95553
148,78,70,-,431300,95554
137,72,65,732,400000,95555
293,245,48,820,323600,95556
132,97,35,-,-,95558
0,0,0,-,-,95559
643,334,309,631,363700,95560
1383,823,560,1057,310600,95562
169,69,100,-,580900,95563
197,71,126,1241,421900,95564
315,157,158,1208,350000,95565
876,719,157,670,326800,95567
34,25,9,-,280600,95568
120,84,36,-,433300,95569
1092,760,332,1840,599300,95570
48,0,48,-,-,95571
563,408,155,1773,337400,95573
245,132,113,915,373500,95585
0,0,0,-,-,95587
646,511,135,1164,439000,95589
92,55,37,-,365900,95595
180,120,60,1625,350600,95601
7543,6114,1429,1730,646900,95602
11871,7963,3908,1451,613900,95603
12,0,12,-,-,95604
4846,2289,2557,1615,375500,95605
111,101,10,-,-,95606
104,79,25,-,478800,95607
25856,13422,12434,1549,565600,95608
17625,9221,8404,1764,466500,95610
451,222,229,2449,950000,95612
0,0,0,-,-,95613
1701,1580,121,2665,489800,95614
390,213,177,957,650500,95615
18356,6708,11648,1911,856900,95616
10282,5581,4701,2237,839900,95618
2557,1547,1010,1678,348800,95619
7805,4854,2951,1716,594900,95620
16631,11411,5220,1776,401900,95621
1659,1394,265,1387,570800,95623
20257,15580,4677,1960,603700,95624
120,44,76,-,-,95625
1728,1393,335,1428,467900,95626
1140,784,356,1402,477900,95627
16896,11893,5003,1857,615400,95628
491,452,39,-,472900,95629
29215,20183,9032,2280,702200,95630
2728,2258,470,1734,507400,95631
10081,7678,2403,1490,487500,95632
1160,1055,105,2174,432700,95633
1716,1324,392,1527,332100,95634
558,519,39,-,475600,95635
480,441,39,-,369100,95636
177,132,45,-,1011900,95637
843,731,112,1438,641300,95638
67,62,5,-,-,95639
3934,3190,744,1516,432100,95640
890,731,159,1094,293300,95641
3050,2095,955,1384,470700,95642
498,391,107,1409,387400,95645
115,94,21,-,568200,95646
21316,17861,3455,2054,635200,95648
5085,4573,512,1826,783300,95650
218,132,86,1960,697400,95651
412,0,412,1283,-,95652
229,191,38,-,320800,95653
1634,1240,394,917,573800,95655
2332,2146,186,1529,814300,95658
257,188,69,1586,500000,95659
10840,6532,4308,1650,330600,95660
13212,8211,5001,1930,667500,95661
12339,9428,2911,1841,500000,95662
1175,1062,113,1413,963000,95663
615,551,64,1487,387700,95664
2098,1809,289,1164,371300,95665
2604,2356,248,1324,347900,95666
14489,10900,3589,1408,527900,95667
212,156,56,2240,618200,95668
972,884,88,1250,537700,95669
21936,12200,9736,1693,463100,95670
19,0,19,-,-,95671
1996,1864,132,2160,707600,95672
5255,3838,1417,1788,438200,95673
293,221,72,1131,593300,95674
84,84,0,-,-,95675
23,2,21,1096,-,95676
10838,7361,3477,2081,630300,95677
17954,9862,8092,2118,534700,95678
52,42,10,-,-,95679
10,10,0,-,-,95680
390,318,72,-,463000,95681
11544,8644,2900,1771,682100,95682
2661,2478,183,2472,666200,95683
1356,1078,278,1215,517800,95684
2126,1428,698,1323,546800,95685
379,197,182,864,429800,95686
22991,15249,7742,2250,583800,95687
14120,10034,4086,2063,657400,95688
500,424,76,-,405700,95689
612,323,289,1329,710600,95690
14284,9070,5214,1543,532400,95691
1776,1169,607,1350,445100,95692
2356,2076,280,1743,875700,95693
3484,2205,1279,1435,633600,95694
14439,7654,6785,1456,493800,95695
82,0,82,1634,-,95697
154,102,52,-,960900,95698
23,17,6,-,-,95699
402,371,31,-,512000,95701
725,567,158,1327,644300,95703
2435,1768,667,1491,584600,95709
3895,3099,796,1520,480200,95713
164,126,38,1125,472000,95714
31,31,0,-,373800,95715
51,21,30,1125,490000,95717
25,25,0,-,601200,95720
0,0,0,-,-,95721
1804,1595,209,1500,671800,95722
3446,2829,617,1099,401200,95726
255,214,41,-,977700,95728
23,23,0,-,537500,95735
77,0,77,2150,-,95736
4788,4183,605,2481,616100,95742
7777,6922,855,2830,1057600,95746
28590,23263,5327,2184,653400,95747
15459,11223,4236,2470,648100,95757
21995,15565,6430,2178,558800,95758
16685,14548,2137,2479,881500,95762
14604,10031,4573,2270,699800,95765
8223,5607,2616,1677,554900,95776
4831,814,4017,1564,707900,95811
6987,724,6263,1226,621400,95814
9737,3638,6099,1448,298400,95815
11085,3314,7771,1647,789700,95816
6666,2623,4043,1511,500700,95817
10647,6097,4550,1650,768700,95818
8332,5830,2502,2007,716000,95819
13686,7847,5839,1646,394300,95820
15662,7560,8102,1342,470900,95821
16689,10447,6242,1537,438400,95822
24569,11309,13260,1533,372100,95823
9359,3980,5379,1392,322400,95824
15833,3932,11901,1582,433500,95825
15908,8724,7184,1691,441300,95826
7588,4683,2905,1790,419500,95827
18000,11757,6243,1709,377300,95828
9296,7027,2269,2021,589700,95829
169,157,12,-,925800,95830
19344,11013,8331,1864,619800,95831
3217,2139,1078,1938,363600,95832
15544,7969,7575,1835,439700,95833
12598,6705,5893,1734,518300,95834
14912,10266,4646,2177,588300,95835
111,73,38,2550,1274000,95837
11951,6629,5322,1605,369000,95838
8335,3199,5136,1577,414200,95841
11902,5865,6037,1545,367500,95842
15105,10041,5064,2057,467900,95843
9875,7450,2425,1863,770200,95864
13060,7192,5868,1151,351300,95901
591,23,568,2498,392900,95903
18,18,0,-,-,95910
1543,1054,489,1034,424700,95912
95,76,19,-,-,95913
185,158,27,1400,424200,95914
0,0,0,-,-,95915
320,261,59,989,257000,95916
1176,864,312,1159,380700,95917
926,834,92,-,572600,95918
517,407,110,-,346400,95919
77,46,31,636,288900,95920
286,172,114,795,270000,95922
38,38,0,-,729200,95923
72,21,51,-,-,95925
17035,7156,9879,1418,462900,95926
15807,6685,9122,1419,476600,95928
0,0,0,-,-,95929
109,63,46,-,-,95930
2909,1836,1073,1112,367300,95932
49,49,0,-,-,95934
252,227,25,-,404300,95935
66,66,0,-,-,95936
447,276,171,683,-,95937
1484,1013,471,1228,532000,95938
156,67,89,1139,262500,95939
105,103,2,-,195800,95941
869,812,57,-,508300,95942
254,144,110,883,945700,95943
91,0,91,-,-,95944
12008,6767,5241,1420,496600,95945
3738,3072,666,2049,534400,95946
469,397,72,358,343800,95947
3721,2087,1634,1162,343500,95948
8166,7043,1123,1827,551700,95949
175,97,78,795,-,95950
772,498,274,865,313800,95951
3401,2314,1087,793,335900,95953
3460,2902,558,1293,268200,95954
472,334,138,1326,288500,95955
192,155,37,-,280200,95956
281,170,111,-,296300,95957
0,0,0,-,-,95958
7256,5619,1637,1715,603200,95959
251,142,109,930,283300,95960
9906,7132,2774,1279,400900,95961
450,353,97,-,371700,95962
5642,3826,1816,1117,353000,95963
7218,4402,2816,1112,295500,95965
11593,8657,2936,1124,309300,95966
563,288,275,1132,122400,95968
3447,2790,657,1244,419900,95969
172,106,66,1208,435000,95970
2138,1412,726,1323,308400,95971
0,0,0,-,-,95972
15024,9547,5477,1546,484600,95973
59,59,0,-,-,95974
649,544,105,1315,582100,95975
660,646,14,-,441300,95977
65,39,26,-,-,95978
209,132,77,645,247100,95979
28,28,0,-,-,95981
1120,884,236,1362,376100,95982
154,90,64,950,-,95983
100,75,25,-,427500,95984
42,26,16,-,-,95986
2010,1105,905,1317,372100,95987
3082,1746,1336,1171,299300,95988
14638,7066,7572,1318,366200,95991
12792,8547,4245,1552,441600,95993
13008,7861,5147,1238,385900,96001
12929,7952,4977,1281,347500,96002
18125,10635,7490,1402,370500,96003
164,145,19,-,280600,96006
9824,6892,2932,1037,284800,96007
427,365,62,-,343300,96008
135,109,26,686,142900,96009
11,11,0,-,-,96010
62,42,20,850,-,96011
1648,1042,606,936,227600,96013
110,78,32,-,139100,96014
136,113,23,-,-,96015
139,111,28,-,243400,96016
68,48,20,593,-,96017
3970,2488,1482,1264,271600,96019
1084,901,183,1063,277700,96020
5219,3422,1797,1144,287400,96021
6019,4676,1343,1409,355300,96022
500,351,149,822,139000,96023
392,274,118,1017,369700,96024
1031,685,346,930,271900,96025
794,628,166,1017,315400,96027
605,433,172,1042,399400,96028
35,29,6,-,512500,96029
43,34,9,-,188600,96031
1088,777,311,1168,292800,96032
101,83,18,1300,-,96033
144,117,27,877,292200,96034
1535,967,568,1168,225400,96035
63,63,0,-,-,96037
209,151,58,941,329300,96038
306,175,131,685,161700,96039
39,39,0,-,-,96040
1124,727,397,808,272800,96041
499,378,121,941,210700,96044
39,33,6,-,-,96046
381,324,57,1533,364800,96047
327,237,90,697,400800,96048
217,193,24,595,237500,96050
476,419,57,980,311700,96051
675,547,128,1056,321200,96052
119,113,6,-,144000,96054
1447,974,473,1101,261000,96055
627,597,30,-,411200,96056
528,409,119,983,317600,96057
202,130,72,-,142500,96058
239,143,96,-,423100,96059
38,0,38,-,-,96061
393,339,54,1656,441100,96062
60,11,49,1052,-,96063
1819,1394,425,907,247400,96064
148,130,18,-,315800,96065
3715,2565,1150,1504,377500,96067
12,5,7,-,-,96068
551,490,61,-,343100,96069
17,17,0,-,-,96071
1929,1803,126,1609,539800,96073
46,45,1,-,-,96074
144,33,111,-,49400,96075
63,39,24,-,-,96076
24,24,0,-,-,96078
12047,7700,4347,1140,314600,96080
297,221,76,1354,277100,96084
32,32,0,-,-,96085
139,107,32,1025,260300,96086
298,285,13,-,359400,96087
2199,1961,238,1120,286100,96088
181,128,53,877,265800,96090
329,320,9,1109,341400,96091
160,138,22,-,-,96092
1555,1211,344,1050,335800,96093
2760,1924,836,951,298600,96094
323,278,45,1302,375400,96096
4378,2797,1581,984,256400,96097
1870,1342,528,830,192200,96101
631,594,37,1563,429700,96103
364,263,101,-,248200,96104
207,184,23,-,446400,96105
134,70,64,-,519700,96106
293,179,114,2061,370800,96107
39,26,13,-,-,96108
414,381,33,-,231500,96109
63,54,9,-,218200,96110
13,13,0,-,-,96111
59,35,24,565,193800,96112
350,165,185,1082,72200,96113
1182,891,291,1336,297900,96114
65,63,2,-,289300,96115
0,0,0,-,-,96116
81,54,27,-,315600,96117
645,528,117,-,262800,96118
16,16,0,-,-,96119
358,302,56,-,481300,96120
58,9,49,1064,-,96121
1913,1222,691,876,239000,96122
26,19,7,-,-,96123
39,17,22,-,687500,96124
146,146,0,-,377000,96125
102,85,17,-,795700,96126
259,248,11,-,391500,96128
146,98,48,-,312500,96129
5658,3694,1964,982,258400,96130
8,4,4,-,-,96132
56,14,42,-,-,96133
780,621,159,718,162800,96134
59,59,0,-,-,96135
16,16,0,-,-,96136
1268,978,290,971,403100,96137
467,416,51,2250,870500,96140
260,224,36,2278,1060300,96141
392,237,155,1698,798700,96142
1297,788,509,1232,714500,96143
1372,1053,319,1768,980500,96145
517,297,220,2612,1546600,96146
222,199,23,-,712700,96148
12678,7363,5315,1497,649100,96150
0,0,0,-,-,96155
7655,6014,1641,2104,922000,96161
14546,10067,4479,1930,913300,96701
830,722,108,1479,527800,96703
2579,1862,717,1705,586200,96704
652,447,205,1503,684900,96705
23441,16185,7256,2785,796600,96706
15054,11061,3993,2551,772400,96707
4076,2728,1348,2284,1032800,96708
115,108,7,-,721400,96710
2775,1453,1322,2033,1264300,96712
462,239,223,2423,606900,96713
438,268,170,1375,1169000,96714
723,521,202,2016,738100,96716
1206,636,570,2224,874000,96717
512,376,136,1898,632900,96719
17912,11816,6096,1346,458100,96720
952,715,237,-,1213800,96722
1524,915,609,1528,840400,96725
10,10,0,-,-,96726
1420,1187,233,1218,559900,96727
158,121,37,1450,433800,96728
436,352,84,878,199200,96729
544,356,188,1952,982100,96730
803,508,295,1450,812500,96731
8127,5154,2973,1479,832700,96732
16854,10846,6008,3297,1246300,96734
1801,1346,455,829,232000,96737
2695,2114,581,2251,686700,96738
14149,10025,4124,1692,730600,96740
2203,1712,491,1706,915700,96741
22,0,22,1300,-,96742
5021,3900,1121,2023,724700,96743
17867,13697,4170,2410,1001400,96744
6792,4640,2152,2053,830500,96746
307,0,307,1022,-,96747
1576,963,613,941,355500,96748
6792,5188,1604,1268,396400,96749
1088,735,353,1076,613800,96750
35,0,35,-,-,96751
1041,667,374,2228,516800,96752
11187,6926,4261,2076,958400,96753
1377,1065,312,1891,1144100,96754
1193,989,204,1381,693200,96755
2110,1263,847,1593,909700,96756
220,166,54,1621,419200,96757
50,0,50,-,-,96759
1397,1201,196,1208,371500,96760
7061,4241,2820,2099,905800,96761
1023,437,586,2382,962400,96762
1228,608,620,1087,558800,96763
219,131,88,1324,598800,96764
197,126,71,1993,725000,96765
4982,3310,1672,1904,751800,96766
6543,4104,2439,1794,905400,96768
86,0,86,836,-,96769
254,129,125,1125,362300,96770
2777,2109,668,1161,291400,96771
1026,835,191,1509,396300,96772
86,59,27,-,824200,96773
124,101,23,-,295300,96774
553,401,152,-,409500,96776
494,416,78,650,227200,96777
5854,4681,1173,1321,241200,96778
962,614,348,2486,946000,96779
175,141,34,-,539800,96780
679,566,113,1495,787700,96781
12227,8280,3947,2287,846200,96782
552,314,238,805,485400,96783
2053,1686,367,1292,330500,96785
13159,3926,9233,2784,724400,96786
19126,15296,3830,2298,871000,96789
3155,2240,915,2147,1039900,96790
2291,1431,860,2096,932000,96791
13262,8133,5129,1820,551400,96792
10198,7598,2600,1797,776100,96793
2508,1974,534,1710,746700,96795
740,332,408,1664,573900,96796
20259,13756,6503,1981,798600,96797
12401,6792,5609,1821,804100,96813
12682,6263,6419,1770,706500,96814
15000,6691,8309,1903,627600,96815
17982,11309,6673,1879,1121400,96816
19690,8487,11203,1419,930000,96817
18488,6887,11601,3185,653400,96818
12512,6420,6092,1789,963900,96819
0,0,0,-,-,96820
6794,5824,970,2946,1457700,96821
18735,10032,8703,1736,985100,96822
11188,9162,2026,3416,1067900,96825
14590,4777,9813,1604,485200,96826
4,0,4,-,-,96848
0,0,0,-,-,96850
0,0,0,-,-,96853
0,0,0,-,-,96857
0,0,0,-,-,96858
0,0,0,-,-,96859
0,0,0,-,-,96860
0,0,0,-,-,96863
55,47,8,717,-,97001
2285,1872,413,1522,443000,97002
10564,5950,4614,1925,458200,97003
1644,1529,115,1482,691400,97004
11668,4614,7054,1551,476000,97005
18839,8600,10239,1844,535800,97006
18932,14157,4775,1792,582700,97007
12450,6746,5704,1664,555300,97008
2910,2564,346,1209,615500,97009
354,336,18,-,585700,97011
8956,6448,2508,1439,509100,97013
711,558,153,1159,337700,97014
9204,5783,3421,1778,491300,97015
2760,2223,537,887,296700,97016
1119,1031,88,-,590600,97017
723,651,72,1467,441700,97018
1133,927,206,1809,665600,97019
462,407,55,-,336500,97020
589,418,171,1286,393000,97021
1272,1030,242,1597,588200,97022
4454,3647,807,1079,530800,97023
4931,2341,2590,1503,404000,97024
1168,1019,149,1689,354700,97026
5307,3411,1896,1721,464700,97027
100,86,14,-,-,97028
146,87,59,-,-,97029
15592,6910,8682,1604,418100,97030
7127,4752,2375,1411,608100,97031
1741,1330,411,1492,444200,97032
58,38,20,-,-,97033
8501,6473,2028,2030,995900,97034
10961,6979,3982,1951,790900,97035
381,257,124,1268,290900,97037
6120,4365,1755,1497,452200,97038
180,105,75,971,245600,97039
598,437,161,1287,413900,97040
1220,865,355,1244,606500,97041
1125,1035,90,1660,657000,97042
20899,15632,5267,1600,563600,97045
2823,2066,757,882,364300,97048
944,871,73,1977,471500,97049
114,91,23,756,173400,97050
6547,4287,2260,1258,369300,97051
1426,1324,102,-,532200,97053
623,609,14,-,426400,97054
7333,6076,1257,1573,472900,97055
4888,3775,1113,1612,437500,97056
10,7,3,-,-,97057
8104,5179,2925,950,332500,97058
7519,5027,2492,1560,425700,97060
11051,6471,4580,1721,607800,97062
569,466,103,1146,274100,97063
1464,1210,254,1213,360100,97064
286,205,81,1133,203400,97065
1034,801,233,1617,361800,97067
11033,9370,1663,1994,760900,97068
10808,5626,5182,1842,601200,97070
10279,6912,3367,1382,316500,97071
9103,5784,3319,1824,462700,97078
16657,12099,4558,1596,485000,97080
12626,8086,4540,1598,655700,97086
4899,4551,348,2642,616800,97089
1324,892,432,1413,484200,97101
201,183,18,-,545600,97102
7220,4481,2739,1156,437900,97103
1891,1671,220,1589,512900,97106
871,661,210,1112,342000,97107
222,188,34,637,466700,97108
155,136,19,-,576500,97109
597,329,268,1121,740100,97110
1533,1190,343,1744,472900,97111
846,618,228,1415,429300,97112
5312,3934,1378,1457,434100,97113
1677,1430,247,1514,455000,97114
1353,1171,182,1133,498400,97115
9918,6428,3490,1397,479800,97116
269,234,35,1925,603200,97117
375,274,101,1094,307600,97118
1734,1557,177,1227,590600,97119
738,533,205,1225,384900,97121
129,129,0,-,323000,97122
17107,11931,5176,1814,489100,97123
21473,10050,11423,1918,518500,97124
30,30,0,-,-,97125
1432,1276,156,1144,383000,97127
14602,9449,5153,1295,419200,97128
475,432,43,1693,704900,97130
1252,1084,168,1453,427700,97131
11702,7779,3923,1567,498500,97132
2185,1768,417,1455,644300,97133
101,90,11,-,488600,97134
658,428,230,1226,500000,97135
1110,885,225,1195,354100,97136
418,269,149,1302,584900,97137
5712,3257,2455,1004,433200,97138
9278,7155,2123,1934,618000,97140
5183,3494,1689,1127,376200,97141
50,50,0,-,526800,97144
172,110,62,1025,693500,97145
3083,1933,1150,1265,440200,97146
238,110,128,933,412200,97147
1037,860,177,1729,532200,97148
296,192,104,-,655500,97149
9594,2798,6796,1565,648400,97201
19233,9737,9496,1674,684800,97202
12941,7625,5316,1551,468600,97203
441,25,416,783,-,97204
6222,1231,4991,1381,693600,97205
21479,13916,7563,1693,480500,97206
0,0,0,-,-,97208
14698,3195,11503,1669,573700,97209
7077,2275,4802,1577,991500,97210
14222,9143,5079,1818,616800,97211
11459,7485,3974,1790,824800,97212
14278,9198,5080,1490,609100,97213
14936,5007,9929,1628,733200,97214
7669,5070,2599,1587,658500,97215
6963,3767,3196,1390,439000,97216
16196,9313,6883,1789,569500,97217
6244,3657,2587,1440,493300,97218
18133,12972,5161,1603,651600,97219
11561,6768,4793,1412,427700,97220
5313,3864,1449,1658,789700,97221
16127,8909,7218,1592,465100,97222
20835,12686,8149,1726,577600,97223
15347,10585,4762,1693,579400,97224
11618,6202,5416,1703,709500,97225
3531,873,2658,1609,595900,97227
27532,19314,8218,1948,728800,97229
16142,10107,6035,1511,435800,97230
1861,1625,236,1824,795100,97231
8762,2220,6542,1584,801300,97232
13816,6784,7032,1352,385100,97233
13115,7721,5394,1436,414400,97236
9416,4228,5188,1749,713100,97239
0,0,0,-,-,97258
13233,7543,5690,1532,420800,97266
12453,9058,3395,1607,489100,97267
20415,8815,11600,1197,310800,97301
17152,10494,6658,1230,415200,97302
15235,9522,5713,1361,396700,97303
13784,8922,4862,1441,469500,97304
14751,7732,7019,1386,339100,97305
13635,9292,4343,1455,438900,97306
0,0,0,-,-,97310
8809,6205,2604,1370,382500,97317
11406,8403,3003,1264,442400,97321
14436,7963,6473,1335,321200,97322
474,304,170,1127,324600,97324
2578,2177,401,1700,364000,97325
354,336,18,-,334000,97326
1284,1076,208,1015,376500,97327
22,11,11,-,-,97329
18889,9464,9425,1339,495700,97330
0,0,0,-,-,97331
9970,4539,5431,1360,482200,97333
102,102,0,-,362200,97335
32,32,0,-,-,97336
8762,6289,2473,1197,388100,97338
1636,1296,340,1316,344700,97341
61,53,8,733,307100,97342
209,138,71,1109,374100,97343
503,385,118,1073,295500,97344
158,134,24,-,569000,97345
399,362,37,1278,378900,97346
594,227,367,754,249500,97347
640,502,138,1694,321700,97348
88,63,25,684,215000,97350
3618,2259,1359,1592,357700,97351
2033,1664,369,1121,404300,97352
13048,8946,4102,1267,332700,97355
107,107,0,-,445300,97357
1029,932,97,979,451700,97358
799,591,208,1168,281100,97360
4402,2387,2015,1128,407100,97361
1358,733,625,1199,420400,97362
197,115,82,958,482100,97364
5033,3031,2002,1155,418500,97365
857,751,106,-,474400,97366
5109,3325,1784,1333,388800,97367
1114,979,135,1123,302200,97368
134,113,21,-,586000,97369
4103,3134,969,1353,424600,97370
286,139,147,963,323300,97371
0,0,0,-,-,97373
1920,1593,327,992,534500,97374
420,379,41,1301,485900,97375
611,453,158,948,411900,97376
317,243,74,-,610500,97377
2851,2063,788,1078,341200,97378
772,560,212,531,247700,97380
5683,3839,1844,1491,497700,97381
3862,2510,1352,1090,408300,97383
9,9,0,-,-,97384
1467,1133,334,1497,482400,97385
6165,4445,1720,1141,302200,97386
486,403,83,-,444400,97388
629,422,207,1875,365400,97389
490,434,56,756,413200,97390
2355,1554,801,1046,355100,97391
2328,2005,323,1125,546600,97392
2543,2039,504,1104,354400,97394
1378,985,393,1104,324500,97396
22990,6952,16038,1318,472200,97401
23077,11394,11683,1287,330000,97402
4714,1797,2917,1211,550900,97403
13164,9203,3961,1408,397700,97404
19588,13683,5905,1417,494000,97405
221,166,55,-,264800,97406
6341,3984,2357,1731,535300,97408
187,165,22,-,535000,97410
3811,2787,1024,920,425800,97411
233,200,33,1097,285500,97412
388,283,105,907,388200,97413
164,151,13,-,234000,97414
6745,4976,1769,1221,385100,97415
402,302,100,1036,264400,97416
1062,693,369,998,218100,97417
375,333,42,-,528400,97419
11899,8021,3878,982,282300,97420
2650,2022,628,1150,266200,97423
7428,5139,2289,1012,349700,97424
3934,3058,876,1293,435100,97426
374,244,130,832,311800,97429
194,172,22,1069,355700,97430
729,611,118,2130,327000,97431
95,51,44,-,-,97432
321,201,120,1069,285900,97434
1023,735,288,978,270800,97435
319,226,93,1017,330800,97436
927,764,163,1629,446700,97437
436,401,35,2083,450000,97438
7895,5614,2281,1164,364600,97439
116,24,92,-,-,97441
920,692,228,931,291100,97442
943,733,210,816,331600,97443
2774,2117,657,1086,396000,97444
1848,1478,370,1172,318200,97446
300,204,96,989,376900,97447
5915,4076,1839,1079,410500,97448
1015,823,192,1317,293100,97449
306,280,26,-,334400,97450
193,161,32,-,359500,97451
664,557,107,1121,345900,97452
404,296,108,1099,336800,97453
443,388,55,994,422200,97454
943,848,95,-,620700,97455
1187,864,323,1189,372100,97456
4317,3034,1283,917,242300,97457
2161,1543,618,800,251400,97458
6276,4396,1880,1066,349700,97459
306,281,25,-,449200,97461
1655,1364,291,1205,377700,97462
1557,978,579,918,241000,97463
1129,799,330,848,292100,97465
443,352,91,870,221300,97466
2608,1913,695,750,224100,97467
1076,858,218,852,237900,97469
8360,4850,3510,1037,246500,97470
12664,9762,2902,1099,326400,97471
159,143,16,-,371700,97473
115,115,0,-,267600,97476
16178,8454,7724,1176,345800,97477
14593,10196,4397,1314,361200,97478
4595,3097,1498,1207,281500,97479
134,95,39,792,278100,97480
316,272,44,-,202500,97481
115,68,47,679,302900,97484
256,242,14,-,-,97486
3922,3245,677,1412,334300,97487
363,317,46,-,411200,97488
409,347,62,-,429600,97489
133,109,24,1404,385000,97490
483,468,15,1325,222000,97492
213,169,44,-,464300,97493
42,42,0,-,-,97494
782,705,77,1144,440000,97495
3146,2369,777,1029,236700,97496
620,448,172,535,302800,97497
1021,827,194,893,483900,97498
710,596,114,1000,288300,97499
18233,9964,8269,1238,325200,97501
11436,8149,3287,1245,374000,97502
4494,3782,712,1082,299500,97503
20271,12469,7802,1387,447800,97504
12456,7076,5380,1360,568700,97520
228,178,50,817,229200,97522
3090,2499,591,1239,301000,97523
5858,4625,1233,1340,421400,97524
2154,1652,502,1142,426700,97525
15092,10007,5085,1076,379700,97526
14573,10701,3872,1350,408200,97527
3754,2941,813,1657,541400,97530
98,98,0,-,-,97531
910,767,143,894,417700,97532
475,383,92,-,257500,97534
2020,1422,598,1284,374600,97535
523,428,95,792,292700,97536
2813,2103,710,1161,362300,97537
765,634,131,785,289800,97538
1521,1021,500,1055,295700,97539
3935,2272,1663,1428,427900,97540
557,493,64,1078,-,97541
297,188,109,1050,550500,97543
842,671,171,1519,525300,97544
9622,5941,3681,972,266500,97601
12929,8742,4187,987,251100,97603
0,0,0,-,-,97604
29,22,7,-,-,97620
169,144,25,-,-,97621
155,129,26,-,-,97622
1314,1048,266,879,280600,97623
1720,1393,327,896,242300,97624
46,46,0,-,408000,97625
103,96,7,-,210000,97626
137,112,25,-,329100,97627
2156,1394,762,941,223600,97630
480,348,132,1288,293800,97632
493,302,191,829,211400,97633
143,139,4,-,259800,97634
107,37,70,-,202800,97635
128,50,78,464,205000,97636
54,42,12,-,-,97637
215,115,100,-,-,97638
9,9,0,-,-,97639
54,29,25,-,225000,97640
645,424,221,829,-,97641
17947,9666,8281,1700,567800,97701
21679,15620,6059,1825,620600,97702
14296,10956,3340,1831,915900,97703
2984,2693,291,2298,559300,97707
0,0,0,-,-,97709
28,25,3,-,240600,97710
18,16,2,-,-,97711
34,0,34,-,-,97712
1932,1202,730,702,170600,97720
89,66,23,1069,-,97721
21,12,9,-,262500,97722
132,100,32,1958,625000,97730
80,56,24,-,312500,97731
74,40,34,531,-,97732
277,248,29,-,223200,97733
1257,940,317,1084,307700,97734
71,30,41,-,-,97735
23,4,19,-,1083300,97736
263,199,64,-,269400,97737
839,645,194,432,199500,97738
5685,4822,863,1144,327500,97739
4535,2970,1565,993,308900,97741
193,109,84,925,271200,97750
13,13,0,-,-,97751
0,0,0,-,-,97752
1323,1113,210,-,699400,97753
9267,6882,2385,1224,397700,97754
17059,12047,5012,1473,469000,97756
18,9,9,-,-,97758
3142,2718,424,1402,695400,97759
3320,3017,303,-,465400,97760
826,449,377,556,151200,97761
7951,4881,3070,924,277600,97801
293,216,77,963,261900,97810
338,233,105,1173,198400,97812
553,442,111,868,217200,97813
5664,4193,1471,825,254400,97814
7,2,5,-,-,97817
1699,1017,682,986,248700,97818
7,7,0,-,115600,97819
576,514,62,832,217800,97820
521,414,107,885,144800,97823
781,646,135,1142,363100,97824
173,149,24,950,234800,97825
378,265,113,946,410300,97826
1039,789,250,939,233000,97827
1440,1045,395,821,369600,97828
316,243,73,684,189200,97830
267,193,74,1549,415600,97833
505,319,186,797,249500,97834
252,224,28,644,236100,97835
879,584,295,743,283000,97836
50,38,12,-,-,97837
9562,6855,2707,1046,274400,97838
97,80,17,656,233300,97839
50,12,38,421,-,97840
168,149,19,-,274000,97841
63,56,7,-,291700,97842
321,244,77,1063,208100,97843
1320,1134,186,825,211600,97844
995,712,283,936,272200,97845
1106,839,267,1011,373300,97846
95,58,37,-,400000,97848
6955,4028,2927,973,264700,97850
211,163,48,708,254200,97856
248,205,43,1273,536000,97857
60,44,16,-,250000,97859
4611,2590,2021,858,225400,97862
216,179,37,588,507800,97864
487,416,71,693,191200,97865
423,319,104,865,148800,97867
627,546,81,979,190300,97868
467,403,64,858,190700,97869
241,152,89,625,201900,97870
68,50,18,-,157100,97873
152,105,47,843,299100,97874
1018,759,259,894,204300,97875
399,354,45,1560,434400,97876
170,162,8,-,135900,97877
150,135,15,675,-,97880
2327,1615,712,1072,192100,97882
1099,742,357,1049,225100,97883
51,42,9,-,277800,97884
499,419,80,839,359000,97885
415,361,54,1142,235600,97886
256,212,44,758,442900,97901
8,6,2,-,-,97902
14,14,0,-,150000,97903
117,107,10,-,595800,97904
21,21,0,-,-,97905
107,86,21,1018,287500,97906
299,199,100,661,114600,97907
8,5,3,-,-,97908
10,0,10,-,-,97909
221,100,121,686,190000,97910
31,20,11,275,-,97911
1775,1089,686,793,196800,97913
5961,3685,2276,813,220600,97914
16,9,7,-,-,97917
1612,1109,503,864,240900,97918
16,11,5,-,-,97920
12037,9169,2868,1927,538800,98001
14343,7138,7205,1613,397700,98002
19451,9268,10183,1650,428500,98003
19275,6980,12295,2706,"2,000,000+",98004
8997,4593,4404,2380,1373000,98005
14075,11203,2872,2869,1233500,98006
11543,4002,7541,2276,934600,98007
9407,6869,2538,2480,1130000,98008
2425,2124,301,2304,793300,98010
11543,6598,4945,2223,888000,98011
27229,18111,9118,2279,811500,98012
2789,2525,264,1740,849500,98014
3995,3588,407,2652,746500,98019
8833,6664,2169,1894,959200,98020
12113,9607,2506,2537,902800,98021
8647,6982,1665,1626,577200,98022
17802,11825,5977,1875,545600,98023
1907,1673,234,1405,1005100,98024
51,51,0,-,-,98025
15344,11091,4253,1894,758900,98026
11468,7977,3491,2343,976400,98027
9004,6273,2731,1944,869800,98028
12193,7665,4528,2625,964400,98029
12946,6860,6086,1797,540100,98030
13900,9322,4578,1956,552300,98031
14691,6076,8615,1782,473000,98032
17182,10967,6215,2386,1259900,98033
21277,12893,8384,2324,875200,98034
16450,9933,6517,1686,693300,98036
11660,7175,4485,1864,683600,98037
12837,11047,1790,2152,714100,98038
1011,795,216,"3,500+","2,000,000+",98039
9893,6529,3364,2464,1884200,98040
16874,13908,2966,2121,613000,98042
9106,5107,3999,1966,605800,98043
5696,4831,865,2153,845700,98045
2345,1356,989,1728,431300,98047
75,75,0,-,-,98050
1292,1098,194,2157,702500,98051
33055,15455,17600,2339,1107900,98052
8419,7296,1123,2737,1155500,98053
9731,5468,4263,2098,561600,98055
14713,8091,6622,1992,726300,98056
6221,1507,4714,1767,606500,98057
15615,11429,4186,2015,627200,98058
14642,11361,3281,2230,809800,98059
5310,4495,815,3052,890300,98065
229,195,34,1152,760800,98068
4423,3590,833,1444,717700,98070
9593,7054,2539,2334,1067000,98072
10128,8535,1593,2685,1211700,98074
8047,7127,920,3072,1457900,98075
4776,4364,412,2457,1131500,98077
15800,8373,7427,2010,633200,98087
16994,12644,4350,1870,594800,98092
11237,1767,9470,2476,741400,98101
16858,4303,12555,1920,988700,98102
26105,11791,14314,2006,1012900,98103
9035,723,8312,1511,663000,98104
18106,5993,12113,1803,1261100,98105
11496,6690,4806,1824,666800,98106
15434,6079,9355,2194,924900,98107
8526,4850,3676,1463,693500,98108
20583,4410,16173,2329,986000,98109
9827,7978,1849,2081,1076200,98110
10918,6642,4276,2062,1407400,98112
23403,13883,9520,2118,1041500,98115
13386,7182,6204,2033,917000,98116
14588,10310,4278,2197,1028100,98117
18593,10682,7911,1831,746400,98118
13861,5443,8418,1963,1032500,98119
13832,3490,10342,2329,796600,98121
23153,6471,16682,1991,929400,98122
20148,9203,10945,1856,844500,98125
10053,6072,3981,1708,751900,98126
23191,11401,11790,1794,719100,98133
210,72,138,1551,385300,98134
7872,5031,2841,1917,900000,98136
15696,7231,8465,1805,890400,98144
10507,7011,3496,1721,642300,98146
4050,2038,2012,1837,576400,98148
0,0,0,-,-,98154
13959,10015,3944,2016,758000,98155
0,0,0,-,-,98158
137,115,22,-,714600,98164
9068,6038,3030,1739,785700,98166
12503,6650,5853,1724,500600,98168
0,0,0,-,-,98174
7990,6923,1067,2123,995700,98177
9462,6134,3328,1836,628200,98178
11208,4663,6545,1641,452900,98188
0,0,0,-,-,98195
14494,7874,6620,1770,527100,98198
10065,6278,3787,2461,1160000,98199
13651,6397,7254,1443,476900,98201
13791,9260,4531,1761,575300,98203
17770,6247,11523,1732,386300,98204
0,0,0,-,-,98207
22025,15069,6956,1859,641300,98208
207,181,26,-,460900,98220
10382,7566,2816,1596,659800,98221
64,49,15,-,741100,98222
16964,13262,3702,1780,556900,98223
95,91,4,-,604700,98224
22496,9220,13276,1430,588800,98225
19558,12157,7401,1557,568400,98226
13569,9493,4076,1533,564700,98229
7907,6201,1706,1255,467900,98230
1551,1379,172,1588,714000,98232
6687,4156,2531,1567,466300,98233
193,107,86,740,502900,98235
2774,2336,438,1542,611000,98236
1872,1555,317,1199,340500,98237
44,0,44,-,-,98238
3359,2799,560,1177,577700,98239
1145,1090,55,-,566400,98240
951,715,236,899,391000,98241
169,116,53,1212,1043500,98243
1246,1092,154,1081,431900,98244
2068,1624,444,1341,694100,98245
3092,2312,780,1148,514400,98247
9783,7494,2289,1455,550300,98248
2225,1881,344,1648,585700,98249
4373,3382,991,1498,745700,98250
1868,1584,284,1833,414900,98251
4006,3356,650,1412,492500,98252
1151,1049,102,1464,710100,98253
99,83,16,-,206000,98255
163,137,26,1283,379500,98256
2047,1625,422,1317,481300,98257
17655,13802,3853,2187,606600,98258
2602,2159,443,1455,646100,98260
1464,1158,306,1147,700900,98261
489,443,46,-,529000,98262
77,70,7,-,385700,98263
8039,5483,2556,1611,538100,98264
1626,1208,418,1217,358300,98266
170,113,57,-,298700,98267
19331,13563,5768,1845,540000,98270
11114,8242,2872,1851,483100,98271
10054,8026,2028,1902,638300,98272
11497,7224,4273,1171,448300,98273
7192,5554,1638,1716,492400,98274
8303,5885,2418,2127,830000,98275
518,444,74,1750,484500,98276
15992,9512,6480,1651,455300,98277
0,0,0,-,-,98278
331,220,111,2109,820700,98279
245,208,37,1719,926800,98280
677,554,123,1055,460500,98281
7426,6785,641,1710,600300,98282
92,81,11,-,309400,98283
10462,7465,2997,1476,427900,98284
84,60,24,-,621000,98286
99,69,30,-,442300,98288
14525,11837,2688,1591,717600,98290
9485,7632,1853,1691,610700,98292
2981,2602,379,1533,462500,98294
1136,685,451,1341,408000,98295
9381,8458,923,2325,867700,98296
36,34,2,-,409100,98297
749,739,10,-,477600,98303
372,310,62,-,241300,98304
104,93,11,-,266400,98305
9076,4658,4418,1559,421600,98310
10471,7870,2601,1792,448100,98311
13611,8779,4832,1601,430700,98312
32,0,32,2681,-,98314
1085,11,1074,2314,-,98315
610,511,99,1222,265500,98320
6046,5351,695,1805,524300,98321
245,221,24,1438,435500,98323
699,564,135,686,468000,98325
363,187,176,925,284400,98326
3870,2350,1520,2230,550200,98327
3813,3159,654,1211,538700,98328
4347,3825,522,1666,476400,98329
12,12,0,-,-,98330
2310,1376,934,850,194700,98331
7621,6270,1351,2373,686900,98332
1382,1266,116,-,952500,98333
10879,8513,2366,1971,736400,98335
369,291,78,-,244600,98336
3313,1644,1669,1395,386700,98337
10754,9002,1752,1889,471800,98338
1524,1106,418,1179,385500,98339
1386,1250,136,-,460700,98340
634,520,114,1438,644000,98342
125,53,72,2211,621300,98345
3907,3255,652,1550,561300,98346
2229,1956,273,1551,363400,98349
92,57,35,642,57500,98350
656,578,78,-,694400,98351
0,0,0,-,-,98353
3121,1821,1300,2010,510900,98354
200,131,69,-,412500,98355
974,785,189,1047,281000,98356
514,387,127,613,160800,98357
452,349,103,1382,561400,98358
1751,1486,265,1361,584200,98359
5091,4414,677,2293,466200,98360
241,241,0,-,265600,98361
10778,7185,3593,1094,368000,98362
6174,4516,1658,1188,338500,98363
0,0,0,-,-,98364
2621,2395,226,1811,603500,98365
14534,9597,4937,1704,449700,98366
12224,10420,1804,1809,507600,98367
8794,6651,2143,1349,511900,98368
13109,10044,3065,1757,587000,98370
9422,6508,2914,1654,515500,98371
10305,5299,5006,1745,570100,98372
10817,6090,4727,1823,517600,98373
15954,11615,4339,1925,491200,98374
10399,7727,2672,2140,471900,98375
954,859,95,1172,376400,98376
1158,856,302,914,425100,98377
1773,1525,248,2584,567300,98380
92,79,13,1232,203600,98381
14452,11573,2879,1210,463800,98382
8920,5039,3881,2076,565100,98383
201,194,7,-,490000,98385
16412,12642,3770,1837,424100,98387
2764,1792,972,1721,594600,98388
4670,2396,2274,1886,471500,98390
19833,17110,2723,2178,578300,98391
1396,1063,333,1364,433400,98392
422,351,71,869,471500,98394
321,258,63,1211,489200,98396
4395,878,3517,1478,558100,98402
4699,1878,2821,1414,737100,98403
12630,8638,3992,1440,387300,98404
10873,5618,5255,1480,443800,98405
10150,6467,3683,1677,594100,98406
9987,6533,3454,1847,613000,98407
8078,5444,2634,1610,379400,98408
11704,5091,6613,1579,363000,98409
0,0,0,-,-,98416
4349,2908,1441,1512,385300,98418
56,4,52,1273,-,98421
8041,6238,1803,2104,614300,98422
4341,2163,2178,1836,497400,98424
0,0,0,-,-,98430
4351,57,4294,2268,-,98433
25,0,25,-,-,98438
2079,170,1909,1644,-,98439
2207,1847,360,1768,478300,98443
12979,5948,7031,1581,369500,98444
12088,8425,3663,1721,413200,98445
5085,3544,1541,1944,459500,98446
0,0,0,-,-,98447
3743,1948,1795,1453,544500,98465
12374,6553,5821,1724,564400,98466
6283,3852,2431,1566,580100,98467
11854,7278,4576,1604,458200,98498
13880,4875,9005,1445,370000,98499
19082,11581,7501,1600,485200,98501
14651,8295,6356,1569,496500,98502
17602,10338,7264,1673,407700,98503
0,0,0,-,-,98505
8529,5713,2816,1431,469700,98506
12782,9060,3722,1655,438800,98512
13654,10767,2887,1897,443300,98513
11104,7516,3588,1948,528000,98516
8481,5487,2994,1034,237000,98520
1786,1750,36,2667,513400,98524
84,56,28,1098,65700,98526
142,131,11,-,433900,98527
4410,3584,826,1123,367400,98528
178,132,46,1242,219000,98530
10580,6865,3715,1068,285700,98531
9721,7526,2195,1070,381700,98532
326,201,125,842,352100,98533
259,250,9,-,262300,98535
28,12,16,-,-,98536
1031,843,188,947,301400,98537
146,107,39,1196,398300,98538
71,58,13,950,-,98539
3746,2884,862,928,338000,98541
224,152,72,583,415700,98542
8,8,0,-,-,98544
1096,1021,75,1157,482200,98546
764,648,116,591,192800,98547
1157,1066,91,-,255000,98548
5007,3239,1768,1003,212400,98550
59,38,21,1048,-,98552
152,122,30,-,-,98555
0,0,0,-,-,98556
1495,1282,213,900,351000,98557
0,0,0,-,-,98558
0,0,0,-,-,98559
51,41,10,-,506000,98560
91,8,83,-,-,98562
3316,2533,783,1118,315200,98563
1308,970,338,882,213500,98564
166,137,29,1125,276000,98565
101,96,5,-,128300,98566
1113,916,197,925,409800,98568
3735,3098,637,1177,373900,98569
1770,1278,492,1016,352000,98570
23,0,23,-,-,98571
305,224,81,748,217600,98572
57,54,3,-,255000,98575
1725,1550,175,1193,400000,98576
3009,2546,463,965,231000,98577
4841,3974,867,1222,405500,98579
4483,3897,586,1789,485400,98580
225,212,13,-,200000,98581
205,205,0,-,-,98582
38,17,21,-,-,98583
14513,11185,3328,1250,365200,98584
341,278,63,-,376000,98585
771,445,326,942,231900,98586
304,243,61,702,107600,98587
877,821,56,-,325000,98588
2955,2392,563,1284,408600,98589
192,166,26,860,556100,98590
1528,1372,156,719,405300,98591
748,609,139,"3,500+",520900,98592
669,556,113,1161,338100,98593
1242,820,422,752,254800,98595
2555,2139,416,1184,364900,98596
9484,7625,1859,1441,423200,98597
983,843,140,1129,517300,98601
90,90,0,-,360000,98602
396,265,131,585,368800,98603
13210,10735,2475,1492,543500,98604
550,381,169,1477,319200,98605
3434,2996,438,1585,676600,98606
12219,9527,2692,1854,648700,98607
0,0,0,-,-,98609
1251,1001,250,955,390700,98610
3476,2856,620,1348,382000,98611
1445,1217,228,1060,373300,98612
206,186,20,1375,325600,98613
247,247,0,-,310400,98614
63,63,0,-,-,98616
532,400,132,1419,363100,98617
279,214,65,781,271400,98619
3397,2370,1027,881,252200,98620
87,87,0,-,-,98621
25,25,0,-,-,98623
569,374,195,1219,332300,98624
2823,2224,599,-,442000,98625
10190,6944,3246,1169,339800,98626
190,131,59,931,184700,98628
3145,2877,268,1978,568900,98629
1691,1240,451,838,338300,98631
20692,12165,8527,1142,355200,98632
859,646,213,1357,486000,98635
597,525,72,1233,323600,98638
493,329,164,1021,378900,98639
2807,2442,365,976,297900,98640
75,75,0,-,362500,98641
9234,7845,1389,1938,622800,98642
204,168,36,1571,232400,98643
432,346,86,627,246700,98644
851,798,53,782,467000,98645
147,136,11,-,290000,98647
1292,1006,286,986,477400,98648
370,293,77,885,286600,98649
489,411,78,1333,669500,98650
420,354,66,1089,571000,98651
6658,2625,4033,1408,444300,98660
21424,8772,12652,1440,424700,98661
14011,8959,5052,1685,424200,98662
6444,3822,2622,1538,430900,98663
9298,5836,3462,1670,442300,98664
11602,7029,4573,1678,447700,98665
26,25,1,-,288600,98670
8675,6832,1843,1566,532100,98671
2915,2358,557,1329,623100,98672
164,116,48,870,161200,98673
5611,3993,1618,1283,481100,98674
2128,1876,252,1642,522500,98675
23628,16411,7217,1766,442100,98682
13587,7637,5950,1783,501500,98683
13862,7485,6377,1847,442100,98684
11838,9855,1983,1701,572500,98685
7964,6066,1898,1836,546100,98686
17316,9919,7397,1200,429700,98801
11577,8072,3505,1361,431900,98802
10,0,10,-,-,98811
1637,867,770,906,301400,98812
838,481,357,891,165000,98813
213,213,0,-,511700,98814
2770,2089,681,1034,492900,98815
3121,1993,1128,1332,450500,98816
60,45,15,-,-,98817
109,85,24,850,216100,98819
193,11,182,-,-,98821
840,689,151,1234,348300,98822
4417,2942,1475,956,256400,98823
65,38,27,-,180200,98824
3377,2436,941,1122,639700,98826
169,65,104,1513,-,98827
810,694,116,1560,382300,98828
208,167,41,-,308600,98829
253,197,56,394,216100,98830
1357,906,451,1397,652300,98831
80,68,12,-,259400,98832
103,103,0,-,604200,98833
100,97,3,-,539300,98834
267,267,0,-,407900,98836
17504,11597,5907,1128,290000,98837
1987,1215,772,967,251700,98840
3480,2590,890,830,288400,98841
875,527,348,826,646100,98843
2307,1776,531,757,251100,98844
72,43,29,917,245800,98845
449,398,51,1094,314900,98846
751,521,230,846,391300,98847
3962,2437,1525,1035,308800,98848
518,361,157,996,241600,98849
655,528,127,1183,331100,98850
1613,1029,584,902,240500,98851
19,17,2,-,608300,98852
0,0,0,-,-,98853
2376,1690,686,848,230100,98855
1176,866,310,865,398400,98856
1331,945,386,820,194400,98857
756,547,209,981,241100,98858
165,133,32,-,-,98859
116,97,19,917,184200,98860
1387,1043,344,1005,694800,98862
11355,5713,5642,996,268100,98901
17025,8822,8203,1045,237700,98902
6270,4673,1597,1232,265900,98903
14681,10217,4464,1302,356900,98908
0,0,0,-,-,98921
3581,2913,668,1030,624800,98922
580,285,295,892,228300,98923
398,365,33,1917,782500,98925
13744,7603,6141,1261,425600,98926
4598,2691,1907,980,277600,98930
1502,803,699,1076,230300,98932
396,250,146,1050,225400,98933
489,345,144,1048,283000,98934
1109,670,439,1060,196100,98935
2638,2240,398,1288,325400,98936
1885,1371,514,888,343300,98937
554,372,182,-,174100,98938
29,18,11,-,-,98939
274,191,83,-,491000,98940
421,295,126,1639,464100,98941
7202,5373,1829,1354,352100,98942
319,199,120,1193,375000,98943
6508,4106,2402,959,230100,98944
123,92,31,1544,445500,98946
1000,770,230,799,240200,98947
3502,2049,1453,978,217800,98948
0,0,0,-,-,98950
3503,1906,1597,871,214000,98951
474,307,167,585,111000,98952
2253,1757,496,1160,362800,98953
2562,984,1578,1271,281100,99001
1791,1527,264,850,410800,99003
8436,4719,3717,1081,368500,99004
3620,3302,318,1185,488100,99005
5083,4253,830,970,366600,99006
144,100,44,-,453300,99008
1664,1521,143,1090,402300,99009
758,5,753,1681,-,99011
326,220,106,1039,288600,99012
546,344,202,877,231100,99013
15,15,0,-,-,99014
7735,5836,1899,1715,450000,99016
99,91,8,-,106300,99017
132,96,36,-,309500,99018
4632,3177,1455,1790,558100,99019
7,7,0,-,-,99020
3366,3053,313,1209,418200,99021
3466,2790,676,838,345600,99022
256,256,0,-,700000,99023
1957,1851,106,1362,458100,99025
3508,3367,141,1110,477300,99026
2583,2400,183,1097,368400,99027
609,466,143,809,378700,99029
257,242,15,867,283700,99030
500,443,57,688,330100,99031
381,311,70,779,141400,99032
362,243,119,805,271900,99033
91,14,77,-,-,99034
649,560,89,-,580800,99036
6061,3961,2100,1303,446700,99037
61,50,11,925,191700,99039
262,185,77,421,180800,99040
600,543,57,696,347900,99101
211,95,116,1024,170800,99102
208,154,54,892,225000,99103
14,13,1,-,-,99105
2277,1830,447,890,274900,99109
655,506,149,902,444700,99110
1697,1237,460,983,264300,99111
234,197,37,1031,355700,99113
5194,3668,1526,916,268300,99114
536,384,152,726,207600,99115
726,487,239,961,212800,99116
250,216,34,543,253500,99117
383,281,102,856,306700,99118
674,587,87,766,302100,99119
112,91,21,-,420800,99121
1656,1295,361,918,315600,99122
435,374,61,1043,247700,99123
127,103,24,788,185200,99124
242,148,94,975,171900,99125
284,255,29,-,234700,99126
117,90,27,925,300000,99128
289,194,95,432,169700,99129
295,235,60,989,210700,99130
97,62,35,-,255000,99131
671,433,238,703,221100,99133
258,197,61,998,266400,99134
184,168,16,456,198000,99135
13,13,0,-,118800,99136
186,118,68,606,278100,99137
443,282,161,556,206800,99138
417,314,103,775,241200,99139
236,188,48,559,138900,99140
2706,1991,715,918,283000,99141
294,250,44,666,120300,99143
4,4,0,-,-,99144
20,20,0,-,666700,99146
102,98,4,-,416700,99147
1067,981,86,900,415600,99148
43,43,0,-,73600,99149
127,127,0,-,380300,99150
84,73,11,925,159500,99151
69,55,14,-,255000,99152
233,136,97,673,267200,99153
8,8,0,-,158300,99154
386,257,129,390,136500,99155
3937,3053,884,788,303200,99156
339,240,99,714,190300,99157
211,174,37,1036,241700,99158
558,409,149,909,202100,99159
43,27,16,-,"10,000-",99160
591,491,100,933,285800,99161
12462,4195,8267,1011,412700,99163
1245,920,325,789,273100,99166
391,361,30,1113,303900,99167
1048,812,236,859,210700,99169
411,349,62,722,216100,99170
432,331,101,893,210200,99171
624,561,63,850,267400,99173
28,20,8,-,225000,99174
71,63,8,-,258300,99176
199,145,54,-,323900,99179
228,176,52,-,360000,99180
922,778,144,873,254600,99181
592,431,161,817,248900,99185
7788,2361,5427,883,259800,99201
7736,3747,3989,1070,268700,99202
9320,7126,2194,1243,449100,99203
4018,1237,2781,1103,355700,99204
17747,12729,5018,1250,286300,99205
16698,10294,6404,1174,362100,99206
13183,7200,5983,1127,246800,99207
23404,15213,8191,1226,414000,99208
8866,5988,2878,1184,314300,99212
11641,5307,6334,1307,336700,99216
7969,5410,2559,1267,329300,99217
6191,3351,2840,1147,404500,99218
14799,9874,4925,1221,457200,99223
10047,6272,3775,1290,439700,99224
0,0,0,-,-,99251
4,0,4,-,-,99258
26437,18482,7955,1195,353300,99301
3423,2905,518,1090,300300,99320
161,97,64,-,-,99321
243,210,33,688,-,99322
1334,1158,176,1088,358600,99323
3347,2211,1136,1121,338600,99324
1330,899,431,1033,262800,99326
1692,1331,361,937,252200,99328
56,51,5,-,277500,99329
266,249,17,-,292100,99330
30,25,5,-,556800,99333
82,63,19,-,184400,99335
19378,9563,9815,1155,292300,99336
11200,9816,1384,1347,356700,99337
6637,5557,1080,1474,526700,99338
268,224,44,780,245300,99341
778,557,221,1090,244500,99343
5493,3657,1836,948,256700,99344
68,42,26,441,422200,99345
88,60,28,-,214700,99346
1121,840,281,768,220800,99347
603,183,420,924,204300,99348
2314,1307,1007,1181,409000,99349
4576,2891,1685,899,289100,99350
14482,9796,4686,1457,442100,99352
6238,5284,954,1534,407600,99353
10274,6373,3901,1299,355400,99354
72,31,41,963,370000,99356
909,589,320,759,307400,99357
62,49,13,1583,132500,99359
480,368,112,1068,492300,99360
790,511,279,1038,290500,99361
16802,10957,5845,1148,398000,99362
40,40,0,-,207100,99363
136,101,35,-,187500,99371
134,134,0,-,322100,99401
681,605,76,1008,295700,99402
8643,6227,2416,994,283800,99403
7671,2774,4897,1181,378700,99501
9144,6710,2434,1661,408000,99502
6071,1923,4148,1185,316700,99503
16022,10726,5296,1529,309200,99504
816,0,816,2504,-,99505
2251,6,2245,1964,-,99506
13389,9680,3709,1546,371200,99507
12623,6519,6104,1353,309400,99508
0,0,0,-,-,99513
7762,6002,1760,1716,400500,99515
7235,6469,766,1284,576600,99516
6659,4025,2634,1364,365300,99517
4168,2615,1553,1661,297900,99518
0,0,0,-,-,99519
0,0,0,-,-,99530
221,146,75,-,360000,99540
94,14,80,-,78000,99546
5,5,0,-,112500,99547
12,9,3,-,187500,99548
19,11,8,-,137500,99549
80,71,9,-,189100,99550
138,86,52,817,-,99551
60,49,11,425,22500,99552
64,34,30,642,91400,99553
222,151,71,828,-,99554
44,37,7,-,84200,99555
1289,1086,203,1167,226500,99556
213,128,85,1592,231500,99557
44,17,27,-,-,99558
2190,1028,1162,1637,328300,99559
108,86,22,792,-,99561
104,65,39,763,-,99563
12,10,2,-,116700,99564
12,9,3,-,177500,99565
58,33,25,810,-,99566
2617,2324,293,1193,437100,99567
207,198,9,-,260900,99568
8,7,1,-,-,99569
116,40,76,1141,162500,99571
114,84,30,-,404500,99572
336,278,58,946,259200,99573
888,597,291,1346,382300,99574
9,1,8,-,-,99575
803,453,350,1233,283500,99576
10420,8226,2194,1709,413400,99577
72,54,18,1021,-,99578
9,6,3,-,-,99579
14,14,0,-,-,99580
250,182,68,1006,116500,99581
34,12,22,-,-,99583
79,69,10,-,23900,99585
212,122,90,625,285700,99586
799,606,193,-,672100,99587
498,328,170,1356,236700,99588
36,36,0,-,125000,99589
69,54,15,775,110300,99590
10,9,1,-,85000,99591
87,72,15,733,55600,99602
4599,3550,1049,1236,345600,99603
196,127,69,725,-,99604
29,22,7,-,-,99605
90,69,21,-,171900,99606
56,39,17,1025,219400,99607
9,9,0,-,-,99608
128,109,19,683,61500,99609
963,768,195,1630,246200,99610
5808,4252,1556,1108,279800,99611
404,203,201,909,110900,99612
146,69,77,1313,318400,99613
115,83,32,556,33100,99614
4333,2579,1754,1699,400700,99615
231,157,74,-,75000,99620
178,129,49,825,63700,99621
103,68,35,568,170800,99622
7715,6236,1479,1558,294800,99623
33,27,6,-,114100,99624
13,3,10,-,-,99625
61,49,12,-,207500,99626
98,73,25,855,102200,99627
150,109,41,713,85900,99628
124,98,26,605,92700,99630
42,15,27,-,-,99631
200,142,58,1100,21500,99632
125,73,52,1361,279700,99633
182,97,85,-,31900,99634
0,0,0,-,-,99635
96,59,37,930,108000,99636
211,157,54,740,91600,99637
1,0,1,-,-,99638
569,489,80,961,244600,99639
34,7,27,-,137500,99640
153,118,35,-,86700,99641
91,60,31,863,95000,99643
62,51,11,-,112500,99644
11067,8698,2369,1309,338400,99645
10,10,0,-,275000,99647
28,14,14,1063,93300,99648
23,17,6,1000,154200,99649
121,106,15,-,24000,99650
7,7,0,-,-,99651
1698,1277,421,1066,280200,99652
32,14,18,-,450000,99653
15794,11328,4466,1233,342200,99654
287,238,49,788,35000,99655
5,5,0,-,-,99656
73,55,18,-,104200,99657
294,197,97,1150,109600,99658
39,24,15,-,-,99659
61,40,21,967,107100,99660
380,280,100,1149,196400,99661
109,62,47,-,-,99662
176,151,25,1042,196500,99663
1633,1107,526,1158,335500,99664
7,3,4,-,-,99665
0,0,0,-,-,99666
69,69,0,-,205700,99667
17,13,4,-,115600,99668
6604,5018,1586,1205,304000,99669
40,21,19,1083,104200,99670
174,121,53,863,116100,99671
1771,1549,222,1079,313300,99672
631,523,108,882,222600,99674
25,5,20,697,131300,99675
686,523,163,862,247000,99676
9,4,5,-,-,99677
268,194,74,725,102500,99678
12,4,8,-,-,99679
105,73,32,525,-,99680
75,51,24,-,-,99681
98,62,36,558,46000,99682
293,274,19,-,204900,99683
196,113,83,1180,171300,99684
692,220,472,2051,448700,99685
1614,1020,594,1463,310900,99686
1166,1053,113,1331,266700,99688
207,126,81,1276,185000,99689
14,14,0,-,"10,000-",99690
59,44,15,-,105000,99691
114,0,114,1850,-,99692
168,59,109,965,83500,99693
563,430,133,1216,234500,99694
0,0,0,-,-,99695
7480,3446,4034,1233,235300,99701
832,0,832,2000,-,99702
1903,0,1903,2132,-,99703
0,0,0,-,-,99704
7836,6134,1702,1496,290100,99705
16,9,7,-,335700,99706
0,0,0,-,-,99707
12543,8091,4452,1288,296000,99709
4643,3960,683,987,292800,99712
541,503,38,-,251300,99714
72,42,30,-,77800,99720
79,38,41,1143,137500,99721
59,40,19,-,38400,99722
1512,670,842,1190,282400,99723
39,27,12,-,35500,99724
270,192,78,-,209300,99725
11,8,3,-,-,99726
146,114,32,1054,72000,99727
80,70,10,900,221400,99729
56,51,5,-,80800,99730
1,1,0,-,-,99732
30,19,11,-,-,99733
0,0,0,-,-,99734
51,40,11,625,106300,99736
1459,1066,393,1423,286000,99737
74,55,19,725,-,99738
66,54,12,-,117300,99739
321,259,62,1038,110800,99740
282,206,76,1250,96300,99741
148,126,22,900,77300,99742
268,251,17,825,308800,99743
52,45,7,-,176100,99744
19,14,5,-,-,99745
38,25,13,1021,-,99746
47,40,7,-,102100,99747
62,43,19,813,92700,99748
107,79,28,925,121900,99749
154,122,32,1028,119600,99750
38,20,18,1304,-,99751
845,368,477,1610,264500,99752
97,61,36,931,97200,99753
35,28,7,-,110000,99754
100,26,74,919,458300,99755
13,13,0,-,121900,99756
11,11,0,-,-,99757
92,63,29,875,32600,99758
68,31,37,825,117000,99759
394,244,150,1288,142900,99760
138,112,26,850,156300,99761
1336,703,633,1567,324000,99762
122,84,38,-,137500,99763
50,45,5,-,179200,99764
104,84,20,-,65000,99765
166,113,53,1288,184700,99766
0,0,0,-,-,99767
85,72,13,-,72900,99768
147,141,6,-,105300,99769
96,52,44,488,72500,99770
68,63,5,-,93000,99771
122,82,40,950,116700,99772
44,42,2,-,85000,99773
3,0,3,-,-,99774
136,0,136,1452,-,99775
37,17,20,525,-,99776
134,73,61,747,63800,99777
96,56,40,1008,56700,99778
716,576,140,639,218600,99780
48,24,24,-,-,99781
171,113,58,765,109100,99782
79,53,26,-,96900,99783
61,46,15,1025,104700,99784
150,115,35,813,80900,99785
76,66,10,475,86700,99786
38,34,4,-,32500,99788
119,71,48,1271,131700,99789
7,7,0,-,-,99790
43,16,27,807,137500,99791
12106,7977,4129,1468,433000,99801
177,108,69,581,191700,99820
1032,485,547,1426,421800,99824
7,7,0,-,-,99825
262,217,45,1106,276500,99826
943,711,232,881,316000,99827
284,180,104,1078,340800,99829
224,164,60,958,158300,99830
37,27,10,-,166100,99832
1319,936,383,1208,301300,99833
3503,2160,1343,1350,442100,99835
13,10,3,-,112500,99836
451,296,155,1228,430000,99840
111,103,8,-,307100,99841
0,0,0,-,-,99850
5621,3785,1836,1388,379000,99901
1,1,0,-,-,99903
136,128,8,-,375000,99918
244,145,99,938,244200,99919
762,528,234,1009,262500,99921
107,72,35,600,120000,99922
17,17,0,-,-,99923
386,278,108,957,270500,99925
441,321,120,742,160500,99926
18,18,0,-,-,99927
911,515,396,1047,290100,99929
