housing_units_occ,homeowner_units_occ,renters_units_occ,med_rent,med_household_price,zip
5959,3157,2802,375,92000,601
12785,9577,3208,385,90000,602
18828,11315,7513,391,126000,603
1975,1474,501,278,93200,606
9210,7153,2057,424,99300,610
22931,14897,8034,394,99100,612
3499,2594,905,459,97500,616
8334,6564,1770,451,108200,617
2503,1450,1053,547,140700,622
14627,8562,6065,402,110300,623
7922,6034,1888,418,78500,624
11816,8327,3489,399,105300,627
648,250,398,252,80000,631
7413,5624,1789,428,98100,637
6000,3950,2050,381,106200,638
9440,6090,3350,386,93900,641
12079,9244,2835,658,148200,646
1818,1425,393,602,88800,647
4994,3736,1258,448,93500,650
1367,1196,171,456,92300,652
3717,2667,1050,386,90400,653
6651,4799,1852,343,82700,656
14339,10736,3603,428,112800,659
6233,4718,1515,405,109200,660
14321,9199,5122,485,109700,662
4749,3157,1592,373,90000,664
8457,4616,3841,433,94400,667
9771,5506,4265,393,87800,669
3109,2037,1072,292,75700,670
15958,11492,4466,471,108900,674
12550,8559,3991,410,96400,676
5236,4099,1137,423,126900,677
9360,5566,3794,442,108900,678
18926,11243,7683,392,95800,680
11733,6779,4954,380,113500,682
11752,8480,3272,371,101000,683
14046,8889,5157,379,102700,685
9827,7148,2679,493,99400,687
4256,3163,1093,431,97000,688
2171,1656,515,550,117800,690
11904,8416,3488,523,120600,692
17873,14878,2995,548,111800,693
39,39,0,-,-,694
10643,8271,2372,381,92500,698
8790,5909,2881,425,106200,703
2938,2314,624,353,87100,704
8526,6818,1708,451,119400,705
4035,2845,1190,361,93900,707
6168,4745,1423,459,92200,714
1268,815,453,315,90700,715
11483,6776,4707,402,112600,716
6943,2952,3991,320,105700,717
8513,6752,1761,408,94800,718
8820,6875,1945,477,100800,719
6735,4688,2047,358,98600,720
6458,4617,1841,351,94000,723
31237,20365,10872,472,130500,725
20567,15183,5384,673,147600,727
13654,10064,3590,465,99000,728
16532,12783,3749,518,115600,729
12463,8010,4453,372,93700,730
4814,3459,1355,386,93700,731
4658,3561,1097,462,95800,735
17705,11879,5826,458,120000,736
12099,8276,3823,468,106600,738
12279,9097,3182,505,121000,739
592,250,342,501,84600,740
1554,1185,369,638,88500,741
16545,12840,3705,559,117800,745
8247,6756,1491,365,86700,751
13676,9870,3806,465,116900,754
7757,5677,2080,408,93100,757
2585,2173,412,614,108100,765
8030,6055,1975,345,92900,766
12045,8676,3369,412,90700,767
13482,10356,3126,464,90900,769
12774,9124,3650,470,113600,771
6659,4570,2089,364,94700,772
6691,4645,2046,469,111900,773
499,321,178,621,107000,775
12878,9366,3512,415,116500,777
15473,13079,2394,610,156700,778
4162,3426,736,347,116300,780
5813,3674,2139,366,89500,782
10842,8504,2338,463,92700,783
14441,10660,3781,424,94800,784
117,117,0,-,96700,786
17175,12717,4458,431,100200,791
9404,7114,2290,392,102500,794
15379,11638,3741,431,97700,795
2782,1090,1692,499,247100,901
55,35,20,-,260700,906
8943,5217,3726,715,236400,907
2520,968,1552,454,144900,909
3868,2000,1868,672,278200,911
2438,1354,1084,550,143800,912
3420,514,2906,172,391100,913
11411,4922,6489,406,95400,915
8193,3790,4403,446,114700,917
8030,3635,4395,241,186600,918
7131,4023,3108,632,152500,920
13945,6244,7701,543,147900,921
10379,4367,6012,394,115800,923
20004,10712,9292,384,134600,924
3135,616,2519,452,122600,925
37771,26282,11489,610,180500,926
6049,3291,2758,532,217200,927
47,0,47,-,-,934
0,0,0,-,-,936
26248,19533,6715,558,138800,949
0,0,0,-,-,950
8,8,0,-,-,951
3073,1892,1181,556,115100,952
21935,18714,3221,609,147800,953
26169,18930,7239,552,134000,956
15220,10669,4551,511,136800,957
18795,12182,6613,555,148500,959
0,0,0,-,-,960
11402,7863,3539,479,153400,961
7182,4082,3100,266,112000,962
2821,1651,1170,425,105200,965
6367,4934,1433,694,248400,966
1854,1314,540,851,226300,968
15818,12204,3614,809,238800,969
10160,7056,3104,536,151600,971
21694,14717,6977,522,155100,976
7732,5006,2726,773,181600,979
5893,3871,2022,627,139600,982
14554,9516,5038,571,149500,983
12754,8772,3982,478,142100,985
21578,16013,5565,666,152000,987
7190,5074,2116,975,202800,1001
9561,4466,5095,1206,344000,1002
26,0,26,1150,-,1003
1840,1448,392,926,213700,1005
5611,4434,1177,921,258000,1007
530,501,29,831,235000,1008
106,94,12,-,218800,1009
1494,1213,281,773,267400,1010
552,460,92,881,188900,1011
243,208,35,1106,228400,1012
9302,4296,5006,840,173400,1013
12482,8098,4384,839,179300,1020
1204,979,225,1268,121100,1022
455,376,79,786,259100,1026
7883,4660,3223,912,247900,1027
6063,5095,968,851,259800,1028
325,261,64,633,289500,1029
4431,3498,933,780,241800,1030
533,290,243,696,183300,1031
273,241,32,1352,253300,1032
2476,2105,371,786,262100,1033
862,749,113,-,262400,1034
2291,1697,594,1072,325900,1035
1907,1758,149,913,271200,1036
252,246,6,-,313200,1037
1270,972,298,1035,282700,1038
547,441,106,1004,271900,1039
15005,6243,8762,742,188600,1040
925,793,132,988,220000,1050
557,426,131,-,278600,1053
809,717,92,1029,344200,1054
8000,5977,2023,884,228300,1056
3476,2897,579,844,226800,1057
6433,2730,3703,1042,319200,1060
4374,3194,1180,879,314300,1062
0,0,0,-,-,1063
12,0,12,-,-,1066
647,611,36,1175,271600,1068
3471,2632,839,669,189600,1069
259,230,29,633,239300,1070
511,486,25,882,225500,1071
650,574,76,1321,267200,1072
2490,2238,252,979,322000,1073
78,0,78,-,-,1074
6803,5006,1797,927,227300,1075
3634,2956,678,929,283300,1077
354,229,125,1323,177300,1079
901,576,325,840,159600,1080
709,569,140,861,195000,1081
4377,3183,1194,752,185800,1082
1136,690,446,878,200000,1083
71,68,3,-,315000,1084
15389,10569,4820,913,223700,1085
0,0,0,-,-,1086
245,176,69,980,245900,1088
11630,6978,4652,840,202400,1089
486,352,134,-,251800,1092
130,119,11,-,341800,1093
193,67,126,484,179900,1094
5257,4663,594,718,287800,1095
1047,885,162,883,269800,1096
25,3,22,-,-,1097
537,453,84,775,266400,1098
1406,144,1262,813,119000,1103
8866,4031,4835,797,132400,1104
4822,516,4306,720,141000,1105
5832,5256,576,1261,327700,1106
3873,994,2879,658,161400,1107
9776,3727,6049,918,152200,1108
9571,4456,5115,907,129300,1109
5531,4306,1225,910,157300,1118
4722,3570,1152,934,149700,1119
1071,1043,28,-,168200,1128
2872,2277,595,1018,164000,1129
3289,1284,2005,891,133500,1151
0,0,0,-,-,1199
19765,12212,7553,803,172400,1201
3773,2540,1233,642,149700,1220
370,328,42,790,254800,1222
999,927,72,1115,259900,1223
108,54,54,720,192300,1224
1445,1123,322,822,198800,1225
2871,2193,678,872,187500,1226
52,44,8,-,246700,1229
3263,2293,970,928,344300,1230
1165,976,189,727,193200,1235
474,395,79,-,330500,1236
958,796,162,1217,242100,1237
2434,1774,660,761,250800,1238
2326,1399,927,781,369400,1240
156,87,69,-,251700,1242
183,172,11,-,221700,1243
56,44,12,-,427300,1244
412,329,83,977,427600,1245
6874,4059,2815,686,154100,1247
319,307,12,625,239500,1253
469,431,38,1170,447500,1254
338,312,26,706,288600,1255
326,291,35,792,188400,1256
953,767,186,1013,314500,1257
189,179,10,-,417900,1258
279,248,31,1107,386200,1259
151,81,70,-,384400,1260
564,322,242,958,366200,1262
65,52,13,1250,355600,1264
633,556,77,1621,380800,1266
2376,1760,616,895,299300,1267
342,340,2,-,279300,1270
7838,4357,3481,837,185300,1301
634,525,109,900,276200,1330
5331,3849,1482,760,148500,1331
1130,956,174,1172,236700,1337
57,51,6,-,287500,1338
624,495,129,787,228400,1339
733,590,143,1006,185300,1340
684,629,55,1196,300400,1341
555,297,258,1135,334300,1342
24,24,0,-,287500,1343
638,523,115,725,199800,1344
194,175,19,967,213800,1346
64,46,18,-,103800,1347
425,352,73,763,192300,1349
43,33,10,900,104700,1350
1008,779,229,852,268100,1351
582,488,94,829,240600,1354
397,351,46,1047,254900,1355
1256,966,290,782,234500,1360
3326,2299,1027,733,159500,1364
481,404,77,734,279900,1366
250,220,30,1300,190000,1367
512,428,84,1164,213000,1368
1789,1242,547,822,242000,1370
1867,1524,343,1027,277500,1373
1547,671,876,1222,278200,1375
2283,1085,1198,787,184400,1376
351,325,26,1088,206800,1378
353,305,48,917,205700,1379
14714,7716,6998,912,180200,1420
2195,2028,167,961,239900,1430
1051,928,123,1243,247000,1431
3324,2182,1142,887,292800,1432
206,119,87,938,243300,1434
1299,1010,289,549,171800,1436
245,227,18,-,211400,1438
8215,4212,4003,767,173200,1440
4042,3485,557,1157,427800,1450
1666,1537,129,1375,565100,1451
1626,1464,162,1263,239300,1452
16730,9236,7494,877,227000,1453
3554,2968,586,1257,392300,1460
4262,3428,834,1577,273600,1462
4301,3375,926,1177,315500,1463
2408,1685,723,971,310600,1464
144,144,0,-,513400,1467
1707,1566,141,-,209000,1468
2652,2108,544,847,258100,1469
2864,2478,386,1113,270400,1473
745,621,124,1125,277900,1474
3855,2993,862,879,186400,1475
6452,5311,1141,986,240700,1501
1129,963,166,1067,376100,1503
3343,2342,1001,853,261400,1504
1723,1478,245,1065,347900,1505
1419,1135,284,930,217200,1506
4834,3904,930,902,280100,1507
5602,3011,2591,1045,242800,1510
826,711,115,867,236100,1515
3164,2580,584,1068,274000,1516
1252,881,371,685,334700,1518
2376,1881,495,997,378000,1519
5238,4726,512,1161,290400,1520
952,815,137,1214,203200,1521
1231,1037,194,1000,283900,1522
2277,1884,393,1123,304300,1523
2656,1892,764,856,220800,1524
56,38,18,-,208700,1525
5267,3857,1410,982,261200,1527
1073,831,242,985,291800,1529
386,344,42,1025,272400,1531
5117,4245,872,1328,379900,1532
2228,1692,536,749,327100,1534
1824,1277,547,803,233100,1535
2764,2146,618,1065,322300,1536
929,752,177,866,194700,1537
4338,3099,1239,801,236900,1540
1226,1090,136,1114,368500,1541
868,658,210,1063,239300,1542
2873,2489,384,907,279600,1543
12860,9523,3337,1227,384400,1545
6835,2954,3881,872,185400,1550
1667,896,771,1085,354600,1560
84,35,49,-,-,1561
4735,3119,1616,782,248000,1562
2762,2421,341,1181,340600,1564
2350,2065,285,1276,266500,1566
2659,2183,476,978,399800,1568
4754,3771,983,1191,271600,1569
6520,3537,2983,830,209500,1570
3945,2989,956,859,250300,1571
6757,4146,2611,1362,432000,1581
2031,1718,313,853,268700,1583
1843,1395,448,1291,219800,1585
3715,2154,1561,911,250800,1588
3201,2897,304,789,356500,1590
9444,5495,3949,1129,218600,1602
7254,3324,3930,959,179300,1603
14189,6575,7614,1050,209800,1604
10391,3100,7291,891,195100,1605
7865,5357,2508,996,210600,1606
3584,1613,1971,1015,175600,1607
1587,92,1495,746,-,1608
7133,2685,4448,931,291700,1609
7912,1198,6714,976,169000,1610
925,574,351,971,227600,1611
1512,1372,140,1044,281800,1612
12543,9978,2565,1340,377300,1701
15207,5046,10161,1195,312600,1702
199,158,41,-,261000,1718
2157,1581,576,958,500200,1719
8409,6488,1921,1303,540400,1720
6726,5362,1364,1300,372400,1721
5133,3666,1467,1703,595600,1730
520,6,514,2522,-,1731
1703,1602,101,972,476600,1740
1762,1694,68,2085,757900,1741
6773,5186,1587,1825,729200,1742
149,141,8,-,391000,1745
5119,4342,777,964,399900,1746
2280,1799,481,1140,311800,1747
5620,4767,853,1567,536100,1748
7605,5699,1906,1159,310100,1749
15442,8500,6942,1245,316500,1752
4375,3140,1235,1110,327600,1754
2012,1776,236,1422,403500,1756
11116,7532,3584,1022,285900,1757
13943,10160,3783,1304,474500,1760
1449,1345,104,1097,716800,1770
3181,2832,349,1328,582900,1772
1955,1583,372,1626,870500,1773
2519,2272,247,1589,452600,1775
6133,5609,524,788,650200,1776
5129,4525,604,1133,638300,1778
15266,9218,6048,1405,374300,1801
9271,6458,2813,1693,439400,1803
12179,9727,2452,1325,580000,1810
10911,8829,2082,1310,358300,1821
9812,8364,1448,1272,373200,1824
10957,8470,2487,1236,291300,1826
1165,1133,32,1375,436600,1827
10010,5444,4566,1095,271100,1830
8616,5245,3371,1054,253900,1832
3153,2633,520,1295,409200,1833
2274,1861,413,1259,372600,1834
5155,3483,1672,1126,267300,1835
2259,141,2118,839,108600,1840
14715,4027,10688,1028,236700,1841
8778,3160,5618,1077,227600,1843
17401,12329,5072,1103,293600,1844
10900,7981,2919,1392,448300,1845
5447,2462,2985,1131,206700,1850
10114,4097,6017,1070,243900,1851
13675,6224,7451,1037,244100,1852
9530,3533,5997,952,224900,1854
2641,2291,350,1332,322100,1860
3412,2902,510,1180,355500,1862
3879,2978,901,1095,303300,1863
5391,4669,722,1406,452300,1864
9037,7429,1608,1217,473300,1867
11108,9606,1502,1582,346300,1876
4332,3735,597,1018,344000,1879
9964,7479,2485,1237,433000,1880
8140,7251,889,1727,468500,1886
7867,6701,1166,1696,390800,1887
7741,6606,1135,1571,796500,1890
852,73,779,701,231700,1901
16740,5578,11162,1041,243500,1902
6197,4758,1439,1266,294000,1904
8437,3808,4629,1072,250600,1905
10039,7927,2112,1155,352700,1906
5428,4155,1273,1328,447400,1907
1600,1094,506,1272,519100,1908
6970,4831,2139,1053,308600,1913
16229,9748,6481,1113,378100,1915
2703,2651,52,779,607000,1921
1068,910,158,-,449100,1922
10543,7313,3230,1254,369900,1923
1453,1136,317,1134,516800,1929
12619,8127,4492,1009,370900,1930
0,0,0,-,-,1937
5589,4078,1511,1042,430400,1938
4796,3933,863,1389,580900,1940
2115,1455,660,1262,737100,1944
8261,6511,1750,1353,593100,1945
2853,2430,423,1805,441900,1949
7742,5734,2008,1143,461900,1950
1729,1464,265,1279,466300,1951
3649,2749,900,1157,319600,1952
21304,13794,7510,1238,346300,1960
3233,2228,1005,986,460800,1966
2209,1823,386,1174,420600,1969
18052,8616,9436,1105,317400,1970
2754,2274,480,1121,516100,1982
2233,2061,172,-,552900,1983
1389,1221,168,978,534100,1984
1590,1512,78,1250,489300,1985
6342,5097,1245,1366,283000,2019
8918,6963,1955,1473,444700,2021
2949,2363,586,1470,847100,2025
9606,6516,3090,1460,394200,2026
1966,1846,120,2371,987300,2030
1588,1323,265,1458,428900,2032
6352,4211,2141,1375,380400,2035
11191,9038,2153,1131,387900,2038
8556,7070,1486,2073,683700,2043
4919,3346,1573,1199,365800,2045
33,18,15,-,-,2047
8280,5997,2283,1170,378500,2048
9623,7496,2127,1321,413600,2050
4115,3641,474,1174,617000,2052
4602,3922,680,1132,379200,2053
3075,2500,575,1544,368900,2054
3160,3005,155,1169,455100,2056
3635,3363,272,873,559300,2061
11752,6760,4992,1350,391600,2062
6518,5613,905,1008,507200,2066
6123,5257,866,1738,482900,2067
315,282,33,-,452600,2071
10578,7598,2980,1217,321500,2072
7144,5862,1282,1299,437200,2081
5609,4856,753,1418,656200,2090
3950,3317,633,1096,406400,2093
2006,952,1054,1995,924000,2108
2043,601,1442,2382,779800,2109
1296,701,595,2569,794700,2110
3217,811,2406,1319,667600,2111
4342,1030,3312,1777,518300,2113
7109,1696,5413,2015,630700,2114
9425,1304,8121,1480,648300,2115
11834,4621,7213,1677,875700,2116
12558,4330,8228,1081,681400,2118
11028,2428,8600,909,346300,2119
4755,435,4320,978,353100,2120
10245,2045,8200,801,369600,2121
8280,3141,5139,1334,359500,2122
18667,7082,11585,1220,338000,2124
12774,4199,8575,1216,357800,2125
9846,4224,5622,1236,306200,2126
16569,6446,10123,1360,469800,2127
16145,4515,11630,1195,332200,2128
8649,3688,4961,1130,570600,2129
16072,7304,8768,1465,457400,2130
12304,6774,5530,1301,389400,2131
11317,8172,3145,1523,444000,2132
7530,1046,6484,1600,438400,2134
18479,4364,14115,1601,435700,2135
11389,5996,5393,1076,340600,2136
13286,5340,7946,1858,718100,2138
14044,5042,9002,1747,597600,2139
8742,3256,5486,1443,627300,2140
6256,2197,4059,1538,548800,2141
1237,206,1031,3029,878700,2142
11291,3379,7912,1635,480500,2143
10662,3764,6898,1736,609300,2144
10178,4020,6158,1391,429600,2145
23117,9532,13585,1325,339000,2148
15220,6005,9215,1296,338200,2149
12396,3232,9164,1193,280900,2150
20239,9734,10505,1227,320400,2151
7699,4415,3284,1278,367700,2152
22251,12530,9721,1495,421300,2155
512,0,512,2242,-,2163
24600,10220,14380,1292,347800,2169
7672,4115,3557,1242,390300,2170
7551,4188,3363,1453,393300,2171
11385,7600,3785,1176,437100,2176
9007,5756,3251,1358,425500,2180
13767,9704,4063,1353,385400,2184
8980,7416,1564,1349,513900,2186
6351,3624,2727,1224,337800,2188
6146,3621,2525,1120,298200,2189
6853,4675,2178,1311,350000,2190
3541,2773,768,1305,324300,2191
812,25,787,3049,"2,000,000+",2199
0,0,0,-,-,2203
1471,521,950,2855,644500,2210
7566,805,6761,1690,443500,2215
20845,9717,11128,1030,243600,2301
11146,7594,3552,986,209200,2302
1658,1235,423,1076,295400,2322
7886,5948,1938,1315,329100,2324
4494,4165,329,1005,267600,2330
5355,4782,573,1578,567000,2332
5012,4173,839,1118,305500,2333
2923,2638,285,1720,281300,2338
5019,4311,708,1143,444500,2339
3596,3255,341,747,335300,2341
4106,3281,825,1055,280500,2343
8854,7231,1623,1111,287200,2346
3860,3339,521,1180,352400,2347
6203,4193,2010,1111,308300,2351
4220,3468,752,1219,403700,2356
13,13,0,-,-,2357
6282,5478,804,1613,358100,2359
21889,17076,4813,1302,333100,2360
4699,3728,971,1177,341300,2364
0,0,0,-,-,2366
1028,894,134,876,353800,2367
12322,8457,3865,1267,272600,2368
6768,4885,1883,1206,271700,2370
3523,2864,659,1410,321800,2375
2369,2048,321,1239,311800,2379
5359,3885,1474,983,282900,2382
4967,4406,561,1995,746100,2420
6635,4959,1676,1732,787800,2421
8432,4516,3916,2048,744000,2445
13235,5455,7780,1975,744400,2446
7341,4234,3107,1574,413700,2451
5017,3088,1929,1613,464400,2452
11270,4599,6671,1321,435100,2453
0,0,0,-,-,2457
4937,2998,1939,1647,693300,2458
6553,5275,1278,1757,923500,2459
3810,2507,1303,1701,710000,2460
2628,1977,651,1784,812600,2461
594,376,218,1705,761900,2462
1279,851,428,1617,552200,2464
4311,3334,977,1722,707600,2465
2838,1428,1410,1645,718000,2466
6198,4250,1948,2031,719400,2467
1908,1754,154,2250,1064500,2468
14747,7462,7285,1650,474100,2472
11512,6589,4923,1500,535900,2474
7140,4707,2433,1387,563200,2476
9633,6065,3568,1710,711000,2478
4747,4101,646,2228,1072700,2481
3862,3010,852,1495,906100,2482
6880,6142,738,782,746100,2492
3834,3270,564,1478,1173800,2493
3554,2562,992,1677,668200,2494
5354,4223,1131,1115,309000,2532
359,273,86,1129,402000,2534
538,392,146,1313,1007800,2535
7990,6522,1468,1351,328100,2536
2358,2116,242,1643,402500,2537
1275,1003,272,1270,240000,2538
1394,1091,303,1725,655100,2539
3988,2682,1306,863,490000,2540
230,11,219,1069,-,2542
412,283,129,1520,802500,2543
48,48,0,-,269200,2553
3734,2349,1385,1615,964300,2554
1187,1034,153,1368,495900,2556
1849,1446,403,1326,578800,2557
617,324,293,976,257000,2558
1838,1423,415,1111,333900,2559
247,209,38,-,292100,2561
1312,1075,237,1246,363700,2562
3704,3181,523,1173,345700,2563
92,92,0,-,-,2564
1371,930,441,1326,612200,2568
4429,2973,1456,1021,261900,2571
951,812,139,1194,747600,2575
1935,1865,70,1333,250100,2576
10,10,0,-,-,2584
6013,2975,3038,1058,244100,2601
892,773,119,1729,566100,2630
4226,3557,669,1099,420300,2631
4464,3826,638,1290,338000,2632
1809,1431,378,852,564700,2633
1569,1424,145,1972,382700,2635
48,34,14,-,473900,2637
1583,1408,175,1272,505500,2638
1330,894,436,982,323600,2639
124,124,0,-,562500,2641
2398,2029,369,1022,445600,2642
9,0,9,-,-,2643
1474,1145,329,1368,316000,2644
4099,3534,565,1134,370800,2645
911,788,123,1144,399500,2646
93,84,9,-,1822900,2647
2716,2544,172,1610,327800,2648
6212,5384,828,1343,332400,2649
479,363,116,1216,815000,2650
13,13,0,-,-,2651
409,373,36,-,531500,2652
2903,2245,658,935,587000,2653
1590,1283,307,1677,461300,2655
1802,1203,599,1064,490400,2657
409,360,49,1440,486500,2659
3165,2469,696,875,334400,2660
52,52,0,-,-,2663
4230,3103,1127,1101,297500,2664
411,307,104,1040,554400,2666
1510,1260,250,918,484100,2667
1273,930,343,1426,447300,2668
75,59,16,-,466000,2669
705,533,172,938,385500,2670
505,359,146,719,380900,2671
86,50,36,-,-,2672
3724,2858,866,1311,270400,2673
3075,2812,263,1158,355900,2675
1457,1276,181,1375,328500,2702
16801,10928,5873,991,271000,2703
21,21,0,-,680600,2713
1156,1108,48,1600,328000,2715
1551,1373,178,1136,311400,2717
2346,2020,326,767,253700,2718
6663,4905,1758,849,266200,2719
13143,5230,7913,791,236100,2720
11032,3842,7190,711,222000,2721
6438,1836,4602,697,223900,2723
7517,2324,5193,706,220400,2724
925,716,209,1090,249400,2725
6010,4892,1118,948,272400,2726
1904,1494,410,1228,493300,2738
2375,1919,456,1014,408700,2739
18334,7392,10942,770,198200,2740
3965,3477,488,766,271400,2743
4651,1762,2889,730,216200,2744
10021,5946,4075,831,209200,2745
6129,1167,4962,758,193800,2746
6748,5252,1496,941,304900,2747
4875,3811,1064,896,345200,2748
9766,6885,2881,969,321500,2760
3395,2505,890,1198,336600,2762
703,596,107,1120,345100,2763
1390,1193,197,499,309100,2764
6320,5173,1147,1148,319600,2766
4806,3705,1101,1342,321300,2767
3944,3602,342,1085,340600,2769
1794,1602,192,1453,376100,2770
5587,4866,721,1143,305500,2771
6117,5318,799,885,266600,2777
2318,2209,109,-,339800,2779
19904,11800,8104,937,233800,2780
6125,5154,971,947,360100,2790
155,118,37,-,521300,2791
428,166,262,790,196400,2802
829,750,79,590,199000,2804
6194,5457,737,1350,394800,2806
448,327,121,768,1078100,2807
851,740,111,-,223500,2808
8362,5565,2797,1001,307500,2809
441,409,32,-,303800,2812
3171,2656,515,1109,311600,2813
2735,2502,233,922,252900,2814
85,85,0,-,-,2815
12975,10177,2798,932,212200,2816
2181,1763,418,1474,301400,2817
7553,5686,1867,971,378300,2818
2384,1887,497,881,321800,2822
1964,1676,288,1163,280700,2825
291,251,40,931,203500,2826
759,698,61,1456,298400,2827
2929,2376,553,1049,264700,2828
2317,1680,637,855,230200,2830
1287,1157,130,1121,296800,2831
1960,1471,489,778,260100,2832
340,239,101,640,265100,2833
2327,1956,371,1708,563900,2835
83,83,0,-,227300,2836
1636,1257,379,1054,519300,2837
1383,628,755,956,222800,2838
678,496,182,1037,201400,2839
10699,4230,6469,1097,382200,2840
0,0,0,-,-,2841
6653,3388,3265,1210,337600,2842
8945,6383,2562,990,302100,2852
3557,3133,424,899,288500,2857
213,127,86,-,260900,2858
2438,1756,682,914,222200,2859
17806,6000,11806,819,168200,2860
9778,5892,3886,953,170100,2861
6327,1507,4820,809,153900,2863
13484,9884,3600,921,256600,2864
6224,4454,1770,1043,284900,2865
7042,5221,1821,1214,362300,2871
121,121,0,-,229700,2872
160,134,26,-,343500,2873
2193,2019,174,1284,398100,2874
187,110,77,-,278200,2875
133,45,88,1116,-,2876
6790,5300,1490,899,260100,2878
8564,6258,2306,1019,335200,2879
1086,635,451,1045,342300,2881
6036,3896,2140,1304,398600,2882
4743,2552,2191,923,249600,2885
12670,8355,4315,1077,204500,2886
8520,6369,2151,1040,190400,2888
11185,8472,2713,1078,185300,2889
9247,5653,3594,1078,291300,2891
1755,1561,194,1040,286900,2892
12771,6555,6216,936,182800,2893
333,253,80,1091,285200,2894
17248,6470,10778,827,156100,2895
4350,3425,925,1058,279800,2896
540,392,148,1063,227300,2898
4782,764,4018,1009,289500,2903
12641,6082,6559,820,191500,2904
8812,4036,4776,880,175600,2905
10785,5111,5674,1166,386100,2906
8605,2302,6303,878,143400,2907
11901,5017,6884,931,168800,2908
14976,4174,10802,883,146800,2909
7873,5493,2380,984,175000,2910
6690,3778,2912,941,196300,2911
0,0,0,-,-,2912
8644,4283,4361,876,194300,2914
7288,4480,2808,1020,204900,2915
3648,2547,1101,842,232200,2916
4476,3541,935,814,277600,2917
12051,8110,3941,915,209400,2919
14292,8652,5640,1007,209500,2920
4387,3690,697,1043,335800,2921
4053,3593,460,1636,337200,3031
1985,1843,142,915,295400,3032
1669,1555,114,1070,312400,3033
1479,1412,67,854,267700,3034
1659,1586,73,2135,315100,3036
1580,1430,150,1167,260100,3037
13069,8116,4953,1146,221400,3038
2584,2200,384,1078,230500,3042
609,578,31,1292,279300,3043
1658,1410,248,1650,243400,3044
5133,4098,1035,1136,234400,3045
1020,922,98,1042,287900,3046
602,483,119,1086,211400,3047
1388,1090,298,768,189900,3048
2989,2688,301,1516,431500,3049
8837,7076,1761,1274,263200,3051
3003,2504,499,1182,288500,3052
8796,7595,1201,1330,285900,3053
9688,8283,1405,1375,251100,3054
5958,3822,2136,1072,236000,3055
833,782,51,939,292300,3057
11757,4080,7677,1061,214800,3060
10892,7839,3053,1300,253100,3062
6599,3925,2674,1286,235400,3063
5641,3365,2276,1059,244000,3064
1894,1781,113,1172,306600,3070
1769,1548,221,1039,229700,3071
4506,3941,565,1182,324500,3076
3990,3093,897,1113,216700,3077
11263,8648,2615,1079,296900,3079
635,581,54,1098,257500,3082
523,483,40,1050,255800,3084
1501,1173,328,958,243500,3086
5101,4705,396,1907,368400,3087
1725,157,1568,839,216300,3101
13312,5358,7954,1058,200700,3102
13817,6643,7174,1016,188700,3103
13338,6412,6926,1043,241100,3104
5143,4146,997,1145,236600,3106
4126,3268,858,1093,210700,3109
7523,6619,904,1563,370000,3110
90,90,0,-,333300,3215
957,805,152,1086,196400,3216
918,486,432,834,155600,3217
306,288,18,-,221400,3218
2750,2379,371,892,186900,3220
847,759,88,1117,223900,3221
2212,1693,519,840,203300,3222
1583,1363,220,644,189000,3223
895,846,49,810,262100,3224
1357,1169,188,1055,168000,3225
412,363,49,1083,334000,3226
448,364,84,1292,291900,3227
2057,1822,235,848,263700,3229
601,520,81,941,168000,3230
114,109,5,-,272100,3231
39,39,0,-,335700,3233
1751,1419,332,1070,201000,3234
3525,2005,1520,787,160400,3235
806,786,20,1103,235300,3237
46,37,9,-,-,3238
534,451,83,877,164200,3240
392,306,86,873,300000,3241
1690,1168,522,933,231800,3242
400,366,34,1223,190700,3243
3212,2678,534,985,194000,3244
844,665,179,987,259300,3245
6758,3668,3090,888,178600,3246
3163,2737,426,1018,240600,3249
577,299,278,731,210300,3251
2660,1936,724,988,280400,3253
1807,1523,284,1156,331600,3254
826,777,49,1316,276100,3255
875,748,127,849,206100,3256
1738,1317,421,864,346900,3257
996,898,98,1076,253100,3258
143,120,23,-,286800,3259
289,251,38,1199,300700,3260
1629,1434,195,1090,230600,3261
405,311,94,682,187100,3262
1568,913,655,784,182700,3263
2176,1278,898,840,179300,3264
927,780,147,925,167200,3266
510,478,32,981,200600,3268
1197,1110,87,-,245400,3269
162,140,22,-,257000,3273
4298,3104,1194,888,204000,3275
3237,2230,1007,905,177400,3276
1065,791,274,915,239800,3278
294,227,67,744,145600,3279
455,424,31,889,216500,3280
3144,2833,311,1488,234900,3281
314,299,15,788,183200,3282
377,311,66,950,216500,3284
879,754,125,971,222900,3285
619,476,143,1347,278200,3287
1728,1659,69,1060,262100,3290
18,18,0,-,-,3291
35,24,11,-,210000,3293
12938,6534,6404,1005,216100,3301
6087,4068,2019,939,189800,3303
2854,2509,345,1153,299800,3304
2037,1758,279,997,232500,3307
10361,5639,4722,983,180700,3431
997,750,247,859,190200,3440
149,108,41,-,161700,3441
555,426,129,961,168800,3442
247,217,30,-,316000,3443
572,460,112,806,258800,3444
280,220,60,1117,181000,3445
2395,1886,509,877,175700,3446
1029,922,107,921,167100,3447
306,269,37,538,189900,3448
754,669,85,996,297500,3449
440,372,68,1013,257300,3450
1792,1315,477,743,133200,3451
2112,1475,637,686,187600,3452
876,610,266,841,203000,3455
281,260,21,1271,163900,3456
263,201,62,994,259200,3457
3136,2039,1097,867,242000,3458
1816,1460,356,1102,225900,3461
716,610,106,787,276400,3462
449,413,36,1125,217200,3464
893,618,275,927,157400,3465
505,424,81,727,278100,3466
632,574,58,1141,259100,3467
1966,1491,475,1056,144100,3470
2595,1450,1145,599,164500,3561
4015,2472,1543,720,88700,3570
1060,695,365,793,156100,3574
16,16,0,-,700000,3575
1449,1088,361,641,147800,3576
217,176,41,655,196400,3579
603,504,99,1289,307400,3580
1433,1086,347,708,129500,3581
1058,762,296,683,85200,3582
442,378,64,775,176500,3583
1554,1078,476,741,148900,3584
1057,849,208,855,151600,3585
315,283,32,813,303500,3586
704,603,101,644,150900,3588
396,318,78,525,94700,3590
561,493,68,538,151100,3592
208,181,27,788,238200,3593
300,239,61,844,187500,3595
142,96,46,-,-,3597
1451,941,510,763,142100,3598
188,171,17,1089,173200,3601
1098,850,248,808,196100,3602
2200,1772,428,763,141300,3603
147,98,49,-,220000,3604
422,384,38,856,170200,3605
168,151,17,917,155400,3607
1111,954,157,847,228000,3608
329,191,138,801,162500,3609
308,272,36,819,189700,3740
1612,1277,335,1063,178200,3741
5437,3455,1982,796,139200,3743
581,506,75,1236,248200,3745
94,83,11,-,267200,3746
2075,1560,515,928,265900,3748
310,289,21,-,506600,3750
217,154,63,912,255300,3751
288,216,72,1042,181000,3752
1136,1051,85,1644,239400,3753
104,0,104,-,-,3754
2692,1614,1078,1430,479800,3755
223,191,32,-,160300,3765
4340,2254,2086,994,234500,3766
674,599,75,1385,422300,3768
176,164,12,-,330000,3770
335,310,25,737,195600,3771
3129,2253,876,884,161100,3773
641,530,111,1125,144800,3774
547,424,123,1163,246600,3777
362,303,59,625,190500,3779
183,156,27,-,161100,3780
766,683,83,1388,269900,3781
1386,929,457,1153,293900,3782
1871,765,1106,960,262700,3784
932,577,355,762,124500,3785
10476,5484,4992,1160,365600,3801
1349,1158,191,767,275100,3809
742,636,106,2109,289500,3810
2663,2378,285,835,317400,3811
350,247,103,570,270700,3812
1355,1191,164,924,168100,3813
1027,809,218,926,153200,3814
515,424,91,972,232500,3816
354,258,96,1085,178600,3817
1513,1022,491,733,162700,3818
1524,1305,219,936,256900,3819
12800,6661,6139,1027,238200,3820
628,518,110,1095,333000,3823
3234,1834,1400,981,354900,3824
3347,3059,288,961,256400,3825
1050,769,281,781,275200,3826
1172,1054,118,1691,334800,3827
805,706,99,1099,219000,3830
168,139,29,863,289800,3832
8640,6441,2199,1128,282500,3833
2746,1797,949,939,170800,3835
555,467,88,1182,256000,3836
600,582,18,2050,259600,3837
586,494,92,1159,239300,3838
1493,930,563,971,169800,3839
1427,1271,156,1865,416100,3840
2510,2105,405,1131,297300,3841
6901,5088,1813,1156,342100,3842
904,806,98,1347,461600,3844
481,327,154,722,204200,3845
461,365,96,881,385000,3846
96,96,0,-,418600,3847
2446,2073,373,963,256600,3848
521,429,92,991,178400,3849
166,150,16,-,420000,3850
1525,1261,264,1007,194700,3851
190,183,7,-,230800,3852
248,216,32,-,277100,3853
473,395,78,1867,941600,3854
970,892,78,1033,227200,3855
535,479,56,1411,408300,3856
3941,2105,1836,1069,263400,3857
1796,1423,373,1093,291800,3858
1925,1271,654,968,223400,3860
1720,1406,314,976,311200,3861
1750,1559,191,1734,384800,3862
668,525,143,947,183600,3864
2873,2267,606,1215,254500,3865
9298,5842,3456,882,163700,3867
2162,1677,485,1138,136700,3868
1001,721,280,1000,228400,3869
2234,1851,383,1695,575000,3870
29,29,0,-,-,3871
1391,1217,174,655,198000,3872
2226,2001,225,1279,263700,3873
3880,2431,1449,939,275300,3874
545,464,81,1167,219500,3875
4671,2557,2114,988,176900,3878
597,511,86,811,175300,3882
57,57,0,-,-,3883
1396,1253,143,1034,266900,3884
2675,2378,297,1503,373500,3885
992,646,346,796,190200,3886
707,620,87,1225,180100,3887
142,131,11,-,188800,3890
2774,2261,513,892,283200,3894
2904,2563,341,972,215000,3901
1031,822,209,1067,352100,3902
2492,1982,510,1079,315700,3903
3445,2009,1436,1310,284400,3904
885,810,75,-,338000,3905
1771,1393,378,892,231000,3906
633,520,113,1139,504500,3907
2755,2116,639,865,259400,3908
4372,3568,804,1147,376300,3909
138,39,99,-,325000,3910
39,23,16,-,-,3911
1007,888,119,1043,194800,4001
2855,2568,287,915,213200,4002
157,140,17,-,594200,4003
9144,4566,4578,883,213700,4005
85,20,65,988,727300,4006
1323,1190,133,1309,200000,4008
2032,1438,594,847,166700,4009
518,475,43,1059,188500,4010
8311,5752,2559,796,217900,4011
1547,1124,423,1018,199300,4015
207,184,23,950,393800,4017
0,0,0,-,-,4019
587,399,188,802,184400,4020
2218,2000,218,-,321300,4021
382,362,20,-,207900,4022
234,211,23,675,189500,4024
2194,1945,249,629,181200,4027
719,583,136,932,176300,4029
1009,957,52,678,193600,4030
3198,2417,781,1076,277200,4032
1315,1043,272,766,171700,4037
6148,5064,1084,1012,249300,4038
2846,2175,671,1111,213000,4039
1388,1185,203,850,179600,4040
604,516,88,820,142100,4041
1868,1606,262,869,194800,4042
4954,3763,1191,967,277500,4043
3253,2676,577,1018,316300,4046
739,537,202,725,160000,4047
1074,902,172,988,170700,4048
1331,1202,129,695,172900,4049
112,96,16,950,364000,4050
439,393,46,663,177800,4051
1629,1503,126,904,179200,4055
132,95,37,675,194500,4056
0,0,0,-,-,4057
1025,871,154,691,174500,4061
6486,5548,938,945,228100,4062
298,156,142,248,285700,4063
4143,2706,1437,837,193600,4064
291,182,109,1150,540200,4066
539,408,131,903,138000,4068
626,585,41,914,248200,4069
2055,1748,307,826,262700,4071
7866,5107,2759,977,232200,4072
6744,4017,2727,792,162000,4073
7550,5915,1635,1191,324800,4074
1084,972,112,1156,185000,4076
1744,1379,365,858,359300,4079
1840,1280,560,787,171400,4083
2940,2606,334,844,228500,4084
672,672,0,-,196100,4085
3703,2858,845,876,219100,4086
676,604,72,-,200500,4087
551,469,82,735,159700,4088
4391,3635,756,901,285400,4090
348,314,34,985,162500,4091
7711,4688,3023,892,204300,4092
3265,2824,441,805,225000,4093
559,476,83,872,185800,4095
3502,2575,927,1018,346300,4096
1358,1254,104,1093,285500,4097
8802,1523,7279,921,289100,4101
7761,3485,4276,929,248100,4102
13168,7565,5603,1090,240700,4103
4551,3701,850,1680,392200,4105
10792,6318,4474,1086,228200,4106
3751,3361,390,989,386800,4107
439,391,48,602,336500,4108
41,28,13,-,-,4109
585,523,62,-,602300,4110
9774,5402,4372,739,152200,4210
176,166,10,575,137500,4216
1118,911,207,602,202700,4217
548,491,57,843,153600,4219
1105,933,172,754,135500,4220
328,262,66,665,125900,4221
1551,1394,157,730,211500,4222
982,755,227,632,103000,4224
72,72,0,-,132500,4226
27,9,18,-,-,4227
31,0,31,-,-,4228
112,99,13,558,152200,4231
70,58,12,-,49700,4234
1634,1325,309,1051,172500,4236
90,82,8,950,188900,4237
447,380,67,869,191800,4238
1808,1588,220,574,130100,4239
15772,7764,8008,681,143500,4240
1774,1326,448,694,129200,4250
1763,1291,472,728,141900,4252
896,702,194,736,142200,4253
1327,767,560,593,91800,4254
244,216,28,956,165300,4255
1081,831,250,665,129700,4256
959,807,152,588,75500,4257
958,867,91,732,174100,4258
1244,1078,166,913,172800,4259
2109,1759,350,998,218200,4260
151,134,17,910,190000,4261
851,710,141,788,147600,4263
446,361,85,1011,166200,4265
15,12,3,-,-,4267
1691,1300,391,699,117700,4268
2370,2098,272,623,122300,4270
0,0,0,-,-,4271
2285,1846,439,799,184000,4274
150,135,15,619,92100,4275
2330,1516,814,576,87400,4276
2719,2215,504,1060,153000,4280
1931,1229,702,632,121300,4281
2331,2002,329,930,168300,4282
454,433,21,963,210900,4284
179,167,12,833,136700,4285
62,52,10,-,-,4286
1435,1236,199,773,189300,4287
663,510,153,703,122700,4289
482,453,29,744,124700,4290
365,336,29,917,137000,4292
1518,1213,305,612,131700,4294
11007,6541,4466,691,147500,4330
763,670,93,790,167000,4342
29,29,0,-,-,4343
1456,970,486,683,136700,4344
4613,3486,1127,671,148000,4345
788,547,241,643,117200,4346
1137,625,512,836,201000,4347
1214,991,223,835,176800,4348
432,410,22,733,154600,4349
1469,1295,174,627,170000,4350
1097,866,231,801,207900,4351
695,604,91,965,179000,4352
897,752,145,975,153800,4353
634,557,77,817,152400,4354
1085,945,140,898,197800,4355
1497,1117,380,862,143800,4357
1671,1401,270,790,150700,4358
216,168,48,-,111000,4359
233,216,17,783,170500,4360
1029,857,172,888,126200,4363
2381,1660,721,797,195300,4364
18697,9896,8801,773,155200,4401
297,272,25,689,129000,4406
67,56,11,-,158300,4408
478,409,69,602,96900,4410
687,564,123,808,146500,4411
3829,2363,1466,847,160800,4412
102,84,18,-,112500,4413
521,434,87,529,77200,4414
114,94,20,664,59200,4415
2368,1802,566,664,124900,4416
130,117,13,-,65900,4417
673,541,132,720,84400,4418
1037,879,158,869,140700,4419
316,206,110,924,345200,4421
434,393,41,-,137200,4422
309,271,38,522,67600,4424
2046,1465,581,561,129100,4426
1020,860,160,672,127900,4427
1214,992,222,800,153500,4428
1876,1577,299,785,177800,4429
831,598,233,383,56100,4430
40,40,0,-,161700,4431
454,389,65,1257,127700,4434
430,397,33,375,128900,4435
462,370,92,634,99800,4438
875,642,233,667,160500,4441
3,3,0,-,-,4442
1049,742,307,543,105200,4443
3392,2905,487,940,193800,4444
551,411,140,588,91500,4448
595,498,97,742,152400,4449
492,376,116,775,122300,4450
123,111,12,-,56000,4451
332,243,89,744,86900,4453
8,8,0,-,-,4454
356,321,35,629,111800,4455
1110,901,209,894,153000,4456
2396,1671,725,593,98100,4457
410,323,87,464,69500,4459
499,450,49,619,72600,4460
1285,994,291,730,115200,4461
2235,1598,637,523,66300,4462
1331,865,466,716,77200,4463
283,241,42,344,97800,4464
3900,2470,1430,666,121800,4468
0,0,0,-,-,4469
306,271,35,650,84500,4471
927,775,152,748,179900,4472
2967,1393,1574,806,202300,4473
1639,1390,249,720,180700,4474
211,187,24,525,87500,4475
566,487,79,909,183900,4476
162,147,15,-,188400,4478
589,464,125,656,106100,4479
195,173,22,-,114900,4481
84,76,8,-,155700,4485
393,363,30,592,68300,4487
517,495,22,-,131400,4488
128,112,16,-,123300,4489
106,99,7,-,86800,4490
66,59,7,492,45800,4491
70,60,10,-,60000,4492
787,682,105,838,103600,4493
221,219,2,-,68500,4495
1695,1446,249,727,162500,4496
161,142,19,433,72200,4497
4973,3215,1758,772,174000,4530
277,251,26,1050,189100,4535
856,790,66,960,245200,4537
1009,726,283,719,240900,4538
475,432,43,1099,237300,4539
50,37,13,-,483300,4541
880,545,335,777,233100,4543
310,292,18,-,535700,4544
462,424,38,1089,169000,4547
437,347,90,1094,374500,4548
373,348,25,940,232800,4551
792,557,235,920,271000,4553
455,379,76,802,319200,4554
745,599,146,850,219200,4555
523,414,109,921,237700,4556
104,104,0,-,278800,4558
948,850,98,825,227800,4562
581,401,180,909,184600,4563
206,206,0,-,294400,4564
255,216,39,1025,369200,4568
0,0,0,-,-,4570
200,190,10,-,201700,4571
2071,1537,534,470,160700,4572
247,209,38,1125,268800,4573
586,530,56,903,143300,4574
20,20,0,-,863600,4575
319,253,66,857,409500,4576
1960,1162,798,738,187000,4578
1280,1090,190,894,205300,4579
5840,4218,1622,765,180100,4605
538,456,82,577,176000,4606
498,375,123,700,161700,4607
2413,1462,951,892,320300,4609
189,160,29,-,120000,4611
220,181,39,825,248700,4612
49,38,11,-,-,4613
1181,842,339,742,215800,4614
367,310,57,971,257500,4616
332,301,31,679,242900,4617
1390,804,586,578,88400,4619
630,471,159,616,98800,4622
431,349,82,683,112900,4623
89,80,9,-,297700,4624
25,25,0,-,245800,4625
197,161,36,795,174200,4626
712,502,210,540,194000,4627
286,231,55,479,112000,4628
75,75,0,-,-,4629
603,471,132,791,117900,4630
705,487,218,630,124300,4631
782,629,153,939,140900,4634
11,11,0,-,205000,4635
78,74,4,-,162500,4637
999,710,289,782,159500,4640
47,44,3,-,300000,4642
421,339,82,700,107700,4643
0,0,0,-,-,4644
26,18,8,-,366700,4645
29,22,7,-,342900,4646
230,175,55,843,109800,4648
562,431,131,719,95000,4649
96,96,0,-,-,4650
866,698,168,505,119100,4652
233,102,131,725,273100,4653
1360,911,449,625,114700,4654
388,313,75,699,152100,4655
136,125,11,675,120800,4657
666,536,130,635,118900,4658
551,458,93,883,445200,4660
244,174,70,930,411400,4662
449,367,82,938,153800,4664
532,480,52,621,111300,4666
638,475,163,483,97700,4667
663,417,246,306,69500,4668
101,96,5,-,366700,4669
240,231,9,-,151400,4671
67,64,3,-,233300,4673
177,151,26,806,256300,4674
117,89,28,1000,323600,4675
435,362,73,575,211400,4676
132,112,20,1188,171300,4677
851,518,333,726,284000,4679
512,398,114,755,120100,4680
519,332,187,675,241100,4681
45,20,25,-,-,4683
715,588,127,842,198100,4684
184,139,45,620,227400,4685
54,54,0,-,80000,4686
148,130,18,725,158300,4691
233,179,54,640,175700,4693
1012,803,209,629,85400,4694
4034,2661,1373,517,95800,4730
765,629,136,445,83100,4732
101,98,3,-,142900,4733
341,269,72,633,97900,4734
255,210,45,354,79300,4735
4198,2864,1334,626,90700,4736
369,312,57,519,123000,4739
510,376,134,393,86000,4740
0,0,0,-,-,4741
1553,1035,518,582,82200,4742
1962,1428,534,560,125000,4743
398,358,40,534,87100,4745
234,190,44,342,66400,4746
599,503,96,528,93900,4747
766,489,277,676,66200,4750
1625,1210,415,532,93100,4756
1193,1055,138,529,126800,4757
581,401,180,396,119400,4758
295,222,73,433,78900,4760
228,199,29,754,124500,4761
254,218,36,488,109100,4762
306,238,68,388,81800,4763
27,25,2,-,176300,4764
613,498,115,405,88800,4765
159,136,23,863,92400,4766
187,179,8,-,120800,4768
3963,2254,1709,646,102600,4769
372,289,83,439,117400,4772
311,254,57,606,143900,4773
317,247,70,266,85900,4774
411,358,53,492,90900,4776
174,160,14,850,70900,4777
132,116,16,-,120800,4779
284,240,44,520,84400,4780
239,210,29,975,99300,4781
204,179,25,588,96800,4783
1016,681,335,516,69900,4785
817,629,188,578,98500,4786
222,197,25,534,87300,4787
3550,2037,1513,706,158600,4841
2371,1651,720,773,338200,4843
617,520,97,675,237300,4847
382,320,62,836,295300,4848
1656,1367,289,914,234400,4849
29,29,0,-,212500,4851
20,19,1,-,293800,4852
211,165,46,900,239000,4853
722,620,102,940,230500,4854
130,123,7,-,353100,4855
1307,1102,205,1014,285200,4856
547,474,73,656,194600,4858
283,255,28,914,174800,4859
644,593,51,1087,256300,4860
1200,854,346,727,166600,4861
1496,1307,189,938,179700,4862
515,423,92,594,232400,4863
1536,1262,274,770,166000,4864
11251,6701,4550,630,129700,4901
776,626,150,809,140100,4910
875,715,160,597,84100,4911
384,321,63,517,102800,4912
3735,2441,1294,779,179000,4915
1040,924,116,939,184600,4917
187,140,47,-,176600,4918
744,664,80,429,77200,4920
635,476,159,680,144800,4921
511,423,88,617,92900,4922
207,181,26,706,85800,4923
911,718,193,783,106300,4924
65,58,7,-,120000,4925
22,22,0,-,-,4926
1335,1071,264,786,102700,4927
850,643,207,799,111800,4928
337,237,100,755,103700,4929
1862,1334,528,729,100300,4930
580,504,76,767,135500,4932
26,26,0,-,-,4933
85,73,12,-,180100,4936
2559,1731,828,716,116300,4937
3498,2496,1002,599,125500,4938
472,445,27,913,103000,4939
0,0,0,-,-,4940
604,503,101,547,149700,4941
582,519,63,796,85800,4942
688,519,169,639,82800,4943
51,0,51,-,-,4944
428,316,112,625,118300,4945
670,593,77,883,168100,4947
374,310,64,620,138000,4949
2068,1492,576,706,113500,4950
434,391,43,1052,150800,4951
821,675,146,831,157300,4952
1345,958,387,735,151600,4953
539,482,57,791,125000,4955
282,250,32,920,145300,4956
1658,1415,243,795,115300,4957
830,733,97,817,110000,4958
476,426,50,760,114500,4961
55,21,34,-,-,4962
3023,2362,661,733,160000,4963
69,52,17,-,383300,4964
848,780,68,831,97900,4965
726,592,134,543,107200,4966
1480,1092,388,884,98200,4967
517,422,95,716,126200,4969
729,604,125,538,223500,4970
790,647,143,807,98700,4971
645,554,91,883,157900,4973
1349,932,417,-,127200,4974
38,38,0,-,-,4975
4360,2911,1449,656,108600,4976
307,258,49,617,143200,4978
418,349,69,655,115200,4979
1020,859,161,740,159500,4981
175,112,63,450,138300,4982
664,543,121,648,100200,4983
270,224,46,705,125000,4984
37,34,3,-,-,4985
670,553,117,839,135800,4986
431,341,90,767,153400,4987
781,540,241,570,146800,4988
1656,1291,365,781,159800,4989
173,93,80,-,115500,4992
4091,2593,1498,960,219600,5001
59,47,12,-,396400,5031
1057,770,287,765,195700,5032
1201,833,368,750,176000,5033
135,96,39,775,500000,5034
280,194,86,1083,222900,5035
475,393,82,942,230600,5036
184,166,18,1075,286800,5037
550,417,133,757,168400,5038
469,421,48,888,159200,5039
198,168,30,598,160200,5040
151,145,6,-,171500,5041
198,189,9,769,150500,5042
370,313,57,549,221800,5043
894,695,199,1012,236000,5045
445,369,76,457,148300,5046
1209,944,265,926,230500,5048
62,21,41,681,164400,5050
728,630,98,864,189700,5051
72,15,57,-,-,5052
172,162,10,1643,369200,5053
1290,1013,277,1106,451700,5055
196,168,28,560,286000,5056
125,115,10,-,226600,5058
215,123,92,1596,314100,5059
1908,1360,548,753,187600,5060
579,525,54,785,199700,5061
282,239,43,871,279800,5062
458,357,101,1054,210800,5065
98,98,0,-,315000,5067
1412,758,654,966,201200,5068
222,193,29,975,147600,5069
234,208,26,1161,312700,5070
57,57,0,-,363000,5071
242,213,29,1625,229400,5072
464,415,49,781,260100,5075
149,119,30,848,165600,5076
505,421,84,983,208500,5077
297,263,34,840,169000,5079
243,148,95,604,120000,5081
116,71,45,569,143800,5083
101,101,0,-,231300,5084
289,261,28,846,154100,5086
2186,1448,738,742,179000,5089
1571,1185,386,1069,355800,5091
1989,1058,931,820,144200,5101
67,41,26,-,128100,5141
301,256,45,743,219600,5142
1840,1394,446,833,199300,5143
324,261,63,800,250600,5146
392,294,98,877,260800,5148
966,617,349,816,234600,5149
547,386,161,913,130400,5150
614,569,45,1079,184100,5151
182,152,30,975,330200,5152
293,226,67,882,165300,5153
203,131,72,864,207100,5154
370,247,123,904,283500,5155
3663,2487,1176,841,147200,5156
474,369,105,782,158900,5158
254,209,45,890,347700,5161
5977,3758,2219,798,162000,5201
1607,1275,332,920,258700,5250
648,541,107,1186,384200,5251
119,101,18,-,196300,5252
288,268,20,-,268900,5253
82,73,9,-,423300,5254
1881,1280,601,904,274900,5255
894,659,235,970,200200,5257
162,119,43,-,109300,5260
1079,885,194,933,173500,5261
1043,872,171,938,234100,5262
7302,4181,3121,853,218500,5301
324,279,45,746,322200,5340
217,168,49,817,203900,5341
275,241,34,1059,231900,5342
354,296,58,750,223100,5343
1029,882,147,973,223900,5345
1948,1549,399,864,209500,5346
393,323,70,575,151900,5350
343,319,24,875,206900,5352
370,273,97,858,214100,5353
840,657,183,750,226800,5354
318,272,46,818,173700,5355
483,279,204,742,245000,5356
88,71,17,-,187500,5358
243,228,15,900,209600,5359
115,101,14,781,352800,5360
427,350,77,785,196200,5361
33,33,0,-,229700,5362
962,724,238,1069,239000,5363
12278,3588,8690,1081,319000,5401
8361,5276,3085,1331,271600,5403
3177,1322,1855,1027,223700,5404
0,0,0,-,-,5405
3961,2897,1064,956,230400,5408
52,0,52,-,-,5439
692,552,140,872,189800,5440
359,333,26,1063,213800,5441
156,129,27,788,139900,5442
2695,2000,695,890,229600,5443
581,486,95,1051,231300,5444
1435,1301,134,1868,493900,5445
6536,4484,2052,1172,261500,5446
41,33,8,-,143800,5447
362,345,17,746,215800,5448
2007,1421,586,754,189600,5450
8508,6000,2508,1115,278500,5452
1732,1271,461,1150,238700,5454
416,345,71,1111,245600,5455
547,419,128,929,253900,5456
581,509,72,599,203600,5457
948,730,218,1086,260400,5458
854,651,203,1095,189000,5459
1763,1414,349,1030,284400,5461
751,647,104,1171,260000,5462
217,188,29,893,217900,5463
1370,897,473,938,237000,5464
2085,1849,236,1167,292200,5465
5052,4209,843,1069,240900,5468
356,250,106,975,150000,5471
665,511,154,1061,249400,5472
575,499,76,985,281100,5473
381,343,38,1072,287800,5474
1166,825,341,882,136200,5476
1756,1381,375,1072,295200,5477
5685,3743,1942,888,199200,5478
0,0,0,-,-,5481
3151,2284,867,2037,365800,5482
566,461,105,739,219300,5483
38,38,0,-,112500,5485
667,526,141,1375,352700,5486
531,463,68,988,225600,5487
2995,2095,900,767,205700,5488
1230,1125,105,977,321700,5489
2485,1856,629,878,223800,5491
292,253,39,900,176800,5492
630,588,42,979,280100,5494
4046,3143,903,1144,302600,5495
5252,3360,1892,917,243200,5602
67,64,3,-,290000,5640
7100,5009,2091,727,166200,5641
457,394,63,883,202200,5647
173,148,25,1198,250000,5648
236,205,31,-,159600,5649
467,383,84,1125,251300,5650
649,510,139,959,228500,5651
347,317,30,1009,118200,5652
178,133,45,960,189900,5653
341,248,93,916,123300,5654
1194,972,222,832,180600,5655
1165,637,528,841,172000,5656
40,40,0,-,275000,5657
559,456,103,779,170300,5658
793,689,104,894,275000,5660
2517,1824,693,760,213400,5661
2177,1619,558,951,196500,5663
69,69,0,-,-,5664
835,597,238,925,194000,5667
268,216,52,988,156800,5669
2059,1360,699,945,374400,5672
1137,915,222,1152,340000,5673
776,613,163,737,282800,5674
469,407,62,853,181800,5675
2075,1452,623,915,252800,5676
991,846,145,867,276800,5677
56,36,20,-,-,5678
1360,982,378,867,170300,5679
858,764,94,960,206400,5680
171,164,7,-,227800,5681
473,420,53,1232,225000,5682
9065,5202,3863,782,171300,5701
132,128,4,-,261100,5730
413,229,184,955,185800,5732
2484,1903,581,776,185800,5733
558,419,139,963,235300,5734
1302,961,341,634,176100,5735
299,187,112,834,188300,5736
328,242,86,800,222900,5737
457,404,53,963,222500,5738
586,461,125,1043,185100,5739
0,0,0,-,-,5740
244,218,26,-,219200,5742
1655,1177,478,845,164000,5743
254,171,83,1161,182600,5744
129,94,35,933,171900,5747
147,114,33,825,130600,5748
374,319,55,1073,307100,5751
3611,2127,1484,865,270500,5753
352,286,66,940,240700,5757
333,302,31,975,208600,5758
800,670,130,796,197000,5759
492,405,87,950,216400,5760
401,341,60,680,219300,5761
199,144,55,966,210000,5762
1117,936,181,853,185900,5763
1271,907,364,839,168400,5764
713,540,173,888,150300,5765
273,217,56,914,215600,5766
477,372,105,682,185400,5767
482,370,112,776,254000,5769
420,374,46,1106,207000,5770
303,273,30,1025,203200,5772
955,737,218,808,195800,5773
450,409,41,666,167400,5774
217,151,66,729,148500,5775
297,258,39,633,257100,5776
1388,1168,220,855,164000,5777
300,228,72,977,229200,5778
3797,2589,1208,736,171700,5819
259,231,28,658,158000,5820
442,407,35,1000,218100,5821
708,545,163,483,132600,5822
472,380,92,735,144400,5824
63,46,17,-,160000,5825
349,299,50,900,174000,5826
136,114,22,617,191100,5827
802,681,121,1076,202600,5828
820,617,203,790,173100,5829
706,529,177,688,137800,5830
319,266,53,886,228100,5832
112,90,22,908,87700,5833
469,382,87,834,152700,5836
166,155,11,792,123400,5837
319,277,42,240,155900,5839
189,160,29,-,273700,5841
171,143,28,792,110400,5842
980,661,319,742,144500,5843
478,422,56,433,146500,5845
444,287,157,643,137500,5846
358,264,94,925,146900,5847
55,46,9,-,-,5850
2528,1685,843,712,142000,5851
259,228,31,1066,173500,5853
2922,2004,918,715,156200,5855
804,698,106,856,170500,5857
184,173,11,-,116400,5858
728,574,154,835,158200,5859
1046,849,197,750,134500,5860
148,132,16,-,221700,5862
259,230,29,893,142400,5866
331,300,31,850,169600,5867
163,163,0,-,175800,5868
581,463,118,719,150200,5871
410,332,78,684,176500,5872
276,251,25,1063,179200,5873
181,160,21,684,186500,5874
234,197,37,639,209200,5875
9,9,0,-,375000,5901
101,71,30,653,106300,5902
398,322,76,641,116800,5903
107,64,43,760,66900,5904
351,312,39,919,166700,5905
518,425,93,817,116700,5906
74,61,13,575,177500,5907
7265,6237,1028,1341,370000,6001
8463,6070,2393,1234,211800,6002
24985,16351,8634,895,192500,6010
3366,3110,256,992,324100,6013
2675,1862,813,1257,234200,6016
1004,702,302,1257,201100,6018
4025,3246,779,1115,297300,6019
0,0,0,-,-,6020
126,114,12,-,297800,6021
15,15,0,-,-,6022
493,379,114,1284,286900,6023
283,242,41,1286,253300,6024
2090,1651,439,932,296000,6026
558,508,50,786,264600,6027
6678,4369,2309,1161,265700,6029
620,560,60,827,307100,6031
7153,5153,2000,1340,342100,6032
11182,8785,2397,1174,331700,6033
3158,2858,300,957,271200,6035
7541,6309,1232,1082,288100,6037
841,509,332,1061,404400,6039
13992,7824,6168,1089,192900,6040
9753,5522,4231,1315,172800,6042
1980,1761,219,992,292900,6043
11897,2960,8937,889,138800,6051
3137,1892,1245,1027,193400,6052
13095,6310,6785,952,157900,6053
2348,2180,168,950,296800,6057
689,534,155,806,311900,6058
0,0,0,-,-,6059
703,679,24,-,396800,6060
80,80,0,-,146700,6061
7455,5150,2305,967,204000,6062
1214,1086,128,1141,249600,6063
320,305,15,-,250700,6065
13157,7120,6037,996,205600,6066
8271,5428,2843,1304,254400,6067
728,518,210,1235,475500,6068
1110,918,192,876,380400,6069
5581,4714,867,1342,330100,6070
3431,2874,557,1118,306200,6071
2140,1948,192,1536,442100,6073
9739,8352,1387,1152,276200,6074
4903,3560,1343,962,198600,6076
3720,3062,658,1328,286300,6078
643,452,191,904,204300,6081
16268,12014,4254,1080,184000,6082
5202,4946,256,1203,277300,6084
2868,2119,749,735,316400,6085
1987,1414,573,1104,164100,6088
1277,936,341,1127,301300,6089
412,359,53,-,398300,6090
45,27,18,1375,287500,6091
1496,1342,154,-,377700,6092
1120,1029,91,1333,326000,6093
10786,8905,1881,1167,217500,6095
5084,3911,1173,1144,190700,6096
5298,3263,2035,967,178600,6098
1049,148,901,1499,155800,6103
9764,1610,8154,854,242000,6105
13835,3125,10710,917,155500,6106
7500,6407,1093,1398,369400,6107
9153,4123,5030,945,163500,6108
10820,8261,2559,1025,246200,6109
4848,3277,1571,1069,225600,6110
12617,9818,2799,1163,228000,6111
7436,2512,4924,961,147200,6112
9569,2818,6751,957,165100,6114
5494,4465,1029,1219,366900,6117
10375,6903,3472,1019,163300,6118
6611,3359,3252,1249,297700,6119
4396,777,3619,798,145500,6120
0,0,0,-,-,6160
6540,2211,4329,748,140700,6226
1305,1186,119,1511,324700,6231
1195,1107,88,804,281700,6232
2970,2264,706,913,224100,6234
827,748,79,930,200000,6235
2043,1727,316,1142,242300,6237
4707,4255,452,1141,252600,6238
4440,2867,1573,919,172300,6239
2691,2156,535,1067,220100,6241
511,423,88,868,245100,6242
0,0,0,-,-,6243
1067,889,178,1110,226400,6247
2030,1896,134,1254,284300,6248
2682,2339,343,956,255500,6249
1840,1400,440,1127,233900,6250
721,635,86,1188,239900,6254
1820,1199,621,1003,181000,6255
979,866,113,871,176900,6256
1720,1363,357,860,270900,6259
3851,2305,1546,860,182200,6260
337,261,76,1181,172500,6262
117,31,86,534,-,6263
35,35,0,-,196600,6264
178,135,43,-,144600,6266
3544,1892,1652,1143,238000,6268
0,0,0,-,-,6269
1529,1409,120,787,223100,6277
1718,1380,338,859,237000,6278
2430,1577,853,1019,228800,6279
1283,978,305,1081,194200,6280
2724,2344,380,1129,261700,6281
449,436,13,-,206500,6282
10612,3578,7034,915,183900,6320
1197,820,377,1126,227800,6330
1829,1620,209,940,224000,6331
126,103,23,-,160300,6332
2424,2099,325,1314,337400,6333
986,851,135,1116,232700,6334
2620,2154,466,1083,254400,6335
27,23,4,-,-,6336
3123,2483,640,1117,233800,6339
12429,4637,7792,1170,209400,6340
49,37,12,-,-,6350
6008,4489,1519,976,203400,6351
16,16,0,-,-,6353
2335,1567,768,804,174000,6354
5470,4250,1220,1210,310200,6355
4906,3679,1227,1148,285100,6357
2031,1723,308,1110,287200,6359
14975,7744,7231,976,169100,6360
1808,1527,281,1334,249500,6365
2678,2325,353,1183,213500,6370
4168,3432,736,1362,416300,6371
87,87,0,-,178000,6373
2899,2228,671,702,169300,6374
1490,1281,209,1081,235800,6375
89,89,0,-,513300,6376
1035,881,154,970,200200,6377
2394,1810,584,1339,404100,6378
3642,2474,1168,870,264700,6379
1021,360,661,877,183200,6380
4004,3209,795,977,180000,6382
1052,944,108,854,221700,6384
6363,5367,996,1148,258200,6385
102,0,102,968,-,6387
13,0,13,-,-,6389
118,75,43,1388,1507400,6390
6891,4000,2891,1031,214600,6401
2404,2054,350,1147,231800,6403
12200,8267,3933,1202,293800,6405
273,210,63,-,271200,6409
10029,8848,1181,1148,330500,6410
1853,1330,523,971,354300,6412
5286,4130,1156,1219,286000,6413
38,38,0,-,350000,6414
6100,4660,1440,1144,267800,6415
5631,4495,1136,1167,245100,6416
1902,1512,390,1044,275100,6417
4955,2733,2222,1069,199600,6418
2479,2376,103,1550,372800,6419
1570,1486,84,1323,269100,6420
2650,2442,208,1112,345400,6422
2068,1786,282,990,309700,6423
4941,4215,726,1152,258100,6424
1494,1104,390,1586,466400,6426
8553,7314,1239,1279,385500,6437
1014,822,192,819,321000,6438
2050,1810,240,1264,297100,6441
1194,915,279,1126,335100,6442
6791,5932,859,1161,440600,6443
69,44,25,-,-,6444
2296,2078,218,1138,303600,6447
14977,9257,5720,990,174600,6450
10260,6016,4244,924,176100,6451
1316,1253,63,-,305800,6455
131,108,23,-,282800,6456
19219,10297,8922,1062,228500,6457
15849,11343,4506,1468,300000,6460
5700,4971,729,1355,319100,6461
105,105,0,-,213800,6467
6844,6260,584,1525,374500,6468
1165,968,197,1033,259600,6469
5848,4914,934,1318,418100,6470
3052,2668,384,1111,262900,6471
2470,2214,256,1334,297200,6472
8457,7059,1398,1258,295300,6473
4201,3473,728,1556,373600,6475
4919,4267,652,1686,382300,6477
4390,3847,543,1295,346500,6478
3906,3184,722,1068,255100,6479
3948,3445,503,897,244500,6480
459,334,125,1074,299300,6481
3948,3492,456,1483,382700,6482
6063,4332,1731,996,255800,6483
15803,12846,2957,1195,338200,6484
7782,6772,1010,1499,318600,6488
12703,10518,2185,1022,273000,6489
17911,13264,4647,1093,265000,6492
2847,2257,590,1269,374900,6498
1538,130,1408,1394,282400,6510
20971,4875,16096,1164,211400,6511
11754,7513,4241,1196,206300,6512
14771,5428,9343,1002,171300,6513
10110,6276,3834,1249,192900,6514
6735,2701,4034,1092,210700,6515
19961,11083,8878,1085,193800,6516
6366,4296,2070,1086,251500,6517
6854,4763,2091,1521,257500,6518
5431,1274,4157,1069,151000,6519
1999,1807,192,1115,343500,6524
2934,2695,239,1106,484300,6525
10351,2818,7533,1069,176700,6604
8477,2488,5989,1160,206600,6605
16035,9690,6345,1173,173700,6606
2765,843,1922,1149,123200,6607
4388,910,3478,1052,160900,6608
8341,3908,4433,1053,142000,6610
12040,10574,1466,1813,392800,6611
2672,2528,144,1805,629200,6612
13265,11542,1723,1400,260300,6614
7275,4848,2427,1134,221200,6615
1587,40,1547,462,101400,6702
8926,3678,5248,904,120200,6704
10154,3924,6230,947,121900,6705
4886,2341,2545,886,123300,6706
10738,6293,4445,972,141900,6708
3448,1071,2377,847,138200,6710
3288,2908,380,1024,295300,6712
5844,5056,788,1086,243400,6716
569,356,213,696,252400,6750
1268,1046,222,945,349700,6751
763,692,71,1295,505200,6752
650,555,95,1386,382700,6754
318,280,38,-,311100,6755
987,915,72,-,364700,6756
887,580,307,974,338600,6757
156,143,13,1688,330500,6758
2414,2006,408,998,363100,6759
2686,2393,293,1339,354100,6762
775,648,127,791,346700,6763
11934,7922,4012,954,178600,6770
10033,7862,2171,1135,287500,6776
653,548,105,1237,377600,6777
586,586,0,-,257000,6778
3305,2438,867,945,194000,6779
882,765,117,958,213500,6782
951,795,156,1083,638400,6783
1452,1311,141,2531,467400,6784
254,209,45,-,479700,6785
3851,2993,858,1056,185600,6786
3062,2387,675,832,207500,6787
14843,9921,4922,885,162600,6790
2022,1948,74,636,282900,6791
523,385,138,1198,648400,6793
467,391,76,1115,454300,6794
5024,4253,771,867,278200,6795
496,433,63,945,398100,6796
4059,3011,1048,1115,331800,6798
7217,5619,1598,1344,335900,6801
6054,4963,1091,1485,357900,6804
2498,1695,803,1859,1002100,6807
18153,8353,9800,1319,264900,6810
11254,8972,2282,1345,310600,6811
4795,4458,337,1921,356300,6812
6618,5653,965,2803,1248200,6820
11309,9526,1783,2029,653000,6824
7223,5595,1628,1486,469600,6825
9617,4880,4737,1761,1479700,6830
4985,3809,1176,2120,1140700,6831
7018,5388,1630,1932,1373100,6840
7240,4631,2609,1513,406900,6850
10551,7406,3145,1588,422700,6851
1482,1211,271,2658,990700,6853
10596,5242,5354,1382,367600,6854
3188,1715,1473,1607,427200,6855
0,0,0,-,-,6856
2496,2111,385,2390,1413900,6870
8925,7569,1356,1527,673600,6877
2550,2117,433,1850,1381600,6878
9864,8263,1601,1813,1080800,6880
3440,3249,191,2579,857700,6883
1573,1368,205,2105,839700,6890
3480,2922,558,1475,603000,6896
5926,5059,867,2264,813000,6897
3903,555,3348,1436,301700,6901
24790,10786,14004,1668,400300,6902
4889,4592,297,2949,784600,6903
7337,5502,1835,1780,531100,6905
3322,2016,1306,1564,433500,6906
3434,2532,902,1636,460900,6907
5022,2530,2492,1220,269100,7001
25377,9426,15951,1158,312900,7002
17616,9649,7967,1260,316300,7003
2464,2205,259,1854,471200,7004
5636,4512,1124,1349,425100,7005
9291,6914,2377,1388,520900,7006
8048,4642,3406,1305,259900,7008
4395,3482,913,1397,444500,7009
10652,5323,5329,1253,415800,7010
12652,6047,6605,1329,293600,7011
4625,2617,2008,1352,338200,7012
9788,7253,2535,1243,350500,7013
1878,1407,471,1511,328800,7014
8480,6615,1865,1465,455200,7016
13898,4079,9819,975,215700,7017
10983,2443,8540,1034,197000,7018
5493,1718,3775,2174,533700,7020
747,706,41,2071,831000,7021
5349,1770,3579,1228,352800,7022
2519,2221,298,2689,422700,7023
16608,9800,6808,1633,326700,7024
11002,4001,7001,1222,329900,7026
1750,1088,662,1367,372500,7027
2490,2209,281,1544,593200,7028
6253,1760,4493,1280,307300,7029
25063,7792,17271,2001,621300,7030
6083,3198,2885,1261,348500,7031
13607,6325,7282,1191,314000,7032
2675,2136,539,1422,346100,7033
3455,2247,1208,1205,330100,7034
3886,2975,911,1560,338000,7035
14854,8260,6594,1161,263900,7036
9755,8811,944,2579,582800,7039
8170,6269,1901,1390,475300,7040
2551,1591,960,1599,703700,7041
10131,4613,5518,1403,497800,7042
4300,3489,811,1537,689600,7043
5276,4118,1158,1396,426300,7044
3839,3580,259,2305,541900,7045
1354,1270,84,1810,825100,7046
21644,8742,12902,1259,301300,7047
11427,2458,8969,1040,225800,7050
16375,10932,5443,1399,357500,7052
10945,5887,5058,1201,441400,7054
19362,4519,14843,1122,303100,7055
4515,1953,2562,1134,359700,7057
1921,1051,870,1552,593400,7058
5115,4654,461,1370,718700,7059
14460,5984,8476,1167,268100,7060
4037,2525,1512,1247,234300,7062
3675,2480,1195,1308,239200,7063
1269,987,282,1557,278900,7064
10508,6240,4268,1311,265300,7065
5661,4444,1217,1334,408600,7066
6031,5300,731,1282,344000,7067
2380,1902,478,2066,477200,7068
1954,1601,353,2031,760700,7069
7053,4344,2709,1347,435100,7070
8455,4630,3825,1244,362300,7071
2340,1494,846,1225,386200,7072
3709,1400,2309,1386,383300,7073
986,748,238,990,341700,7074
3000,2173,827,1620,383600,7075
8387,6694,1693,1398,465000,7076
900,732,168,1119,282300,7077
3983,3639,344,1797,1313500,7078
5249,3605,1644,1585,532300,7079
7859,6393,1466,1557,323100,7080
7148,4594,2554,1653,411800,7081
1585,1502,83,1966,538900,7082
19220,14116,5104,1364,315700,7083
5958,1986,3972,1382,529200,7086
23705,4580,19125,1129,288900,7087
1272,766,506,1388,214600,7088
10551,8622,1929,1532,688800,7090
2360,2169,191,2642,622000,7092
23599,5211,18388,1221,313300,7093
6905,3890,3015,1614,399300,7094
7348,3917,3431,1557,269600,7095
4691,374,4317,773,210900,7102
10522,2548,7974,920,176900,7103
18169,3727,14442,987,234400,7104
16869,3562,13307,1090,274500,7105
10921,3278,7643,991,201300,7106
12656,2651,10005,950,246700,7107
7634,1368,6266,873,187400,7108
12835,6527,6308,1206,271600,7109
10842,7136,3706,1301,363600,7110
20220,6144,14076,967,181100,7111
9089,2587,6502,1012,221400,7112
3710,407,3303,763,197400,7114
8076,2056,6020,1078,250600,7201
13385,3061,10324,1082,266200,7202
8028,4147,3881,1084,204800,7203
4946,2962,1984,1168,269300,7204
7252,4808,2444,1226,234200,7205
7673,1840,5833,1120,232700,7206
10853,3012,7841,1024,280900,7208
19664,5440,14224,1932,549100,7302
15630,4162,11468,1069,284700,7304
21918,8460,13458,1131,285700,7305
20313,4240,16073,1098,307600,7306
15945,4595,11350,1207,313000,7307
5907,850,5057,2642,645100,7310
205,0,205,3094,-,7311
2252,1939,313,1693,680000,7401
2741,1824,917,1437,306900,7403
6177,4860,1317,1436,434300,7405
6823,3908,2915,1560,346500,7407
11853,9395,2458,1463,396800,7410
2119,1434,685,1097,209500,7416
3700,3265,435,2263,944900,7417
691,644,47,-,278300,7418
3696,2988,708,1419,217400,7419
1552,1323,229,1334,258900,7420
2575,2178,397,1772,263500,7421
2452,2346,106,2027,212600,7422
1438,1318,120,2375,716800,7423
9598,5942,3656,1320,375500,7424
9350,7545,1805,1809,462200,7430
2798,1902,896,1514,456000,7432
986,813,173,1082,389900,7435
4354,3980,374,1457,438500,7436
4291,3952,339,1054,332200,7438
855,714,141,1354,234200,7439
1558,1318,240,734,380400,7440
3941,2995,946,1440,294800,7442
4761,3658,1103,2131,376700,7444
5486,4782,704,1314,558900,7446
8344,6457,1887,1960,723900,7450
3914,3679,235,1891,610600,7452
3797,3652,145,2000,348600,7456
1924,1399,525,1903,330400,7457
3722,3249,473,1936,990500,7458
1239,1183,56,2121,259000,7460
6884,5701,1183,1117,280600,7461
2523,1798,725,1241,226200,7462
3568,3049,519,1968,428600,7463
2600,2186,414,1573,330500,7465
18240,14533,3707,1461,445100,7470
5775,5206,569,1589,293500,7480
5859,5316,543,1594,711500,7481
0,0,0,-,-,7495
10222,1520,8702,1054,235700,7501
4382,2096,2286,1303,223600,7502
5329,1564,3765,1135,249800,7503
3233,1336,1897,1173,261100,7504
1064,59,1005,932,347100,7505
6748,4116,2632,1423,368300,7506
7375,4967,2408,1341,353500,7508
3413,2717,696,1501,369600,7512
3396,966,2430,1227,256400,7513
6511,1608,4903,1113,231900,7514
5760,1358,4402,1101,215600,7522
3872,978,2894,1097,228200,7524
18524,6541,11983,1318,291500,7601
2856,1947,909,1239,313400,7603
4412,2950,1462,1346,400700,7604
3351,2017,1334,1406,473200,7605
875,397,478,1398,379100,7606
3587,2321,1266,1386,373500,7607
44,2,42,1500,-,7608
567,471,96,1188,"2,000,000+",7620
9002,6014,2988,1252,332700,7621
2677,2201,476,1954,637200,7624
2995,2486,509,2054,540700,7626
1669,1540,129,3375,652800,7627
6253,4500,1753,1174,358300,7628
2455,2028,427,1707,465000,7630
10630,5439,5191,1444,378100,7631
1826,1605,221,3255,976300,7632
1584,1408,176,1697,600900,7640
1119,1066,53,3341,644700,7641
3497,3057,440,1415,515800,7642
4207,1815,2392,1291,325700,7643
9095,3712,5383,1173,353000,7644
2856,2373,483,1709,600500,7645
5771,3568,2203,1259,394200,7646
1745,1397,348,1517,453800,7647
2168,1757,411,1663,610000,7648
2626,2325,301,1323,560100,7649
7510,2442,5068,1401,507100,7650
8451,7477,974,1838,565300,7652
3234,2520,714,1465,533500,7656
3799,1934,1865,1432,457200,7657
4723,2687,2036,1291,324300,7660
3918,2893,1025,1404,470100,7661
1841,1239,602,1475,351300,7662
5206,3546,1660,1444,366600,7663
13569,9865,3704,1376,387100,7666
4675,3689,986,1599,750800,7670
9696,7611,2085,1646,565600,7675
3236,2973,263,2241,493300,7676
2114,1892,222,2411,756100,7677
9681,6293,3388,1348,378900,7701
1420,1309,111,2262,528500,7702
0,0,0,-,-,7703
1919,1768,151,2297,664500,7704
578,465,113,1250,701800,7711
15990,7011,8979,1106,380900,7712
3617,2668,949,1143,403300,7716
943,584,359,1437,899400,7717
2434,2030,404,1855,335700,7718
8468,6028,2440,1369,429300,7719
2200,859,1341,1237,458400,7720
1089,730,359,1208,274200,7721
3294,2999,295,1702,741100,7722
376,262,114,1311,1098700,7723
8826,5739,3087,1176,329000,7724
15430,13631,1799,1522,440300,7726
2769,1896,873,997,417200,7727
19942,15311,4631,1562,339400,7728
5950,5164,786,895,309300,7730
12516,11228,1288,1416,311200,7731
2479,1573,906,1149,244700,7732
5657,4925,732,1445,606100,7733
5134,3104,2030,1046,213200,7734
6890,4880,2010,1174,250600,7735
1388,1132,256,1323,344900,7737
2080,1785,295,371,499200,7738
2090,1945,145,2187,608300,7739
12051,5184,6867,1244,321200,7740
5986,5766,220,2049,515900,7746
11618,8767,2851,1419,337400,7747
9476,7952,1524,1313,416600,7748
1401,1166,235,1988,668100,7750
5985,5504,481,2205,520700,7751
15486,9723,5763,1339,279300,7753
2094,1811,283,1568,379200,7755
1818,820,998,1028,440600,7756
2103,1771,332,-,447700,7757
1555,1339,216,1857,310800,7758
3342,2847,495,1618,834500,7760
3743,2310,1433,1393,601500,7762
2421,1817,604,1417,393900,7764
8030,4057,3973,1362,278500,7801
1192,1038,154,1133,290500,7803
34,34,0,-,-,7820
3452,3160,292,1271,303500,7821
272,241,31,-,288400,7822
3351,2421,930,861,233000,7823
3390,2953,437,1225,319000,7825
2234,1848,386,1327,298100,7826
1685,1203,482,1128,208200,7827
5617,2737,2880,1077,296900,7828
2388,2228,160,1125,443500,7830
1419,1200,219,1271,292800,7832
44,14,30,-,220000,7833
6770,5904,866,1692,386400,7834
4364,2916,1448,1369,401000,7836
1304,1031,273,1346,312600,7838
11648,7450,4198,1105,285000,7840
44,44,0,-,315400,7842
4612,3900,712,1334,231700,7843
17,17,0,-,227500,7846
565,461,104,1230,287700,7847
1529,1289,240,1237,328600,7848
3498,3124,374,1547,307300,7849
2217,1937,280,1151,269600,7850
27,27,0,-,282100,7851
1520,1151,369,1622,344400,7852
4268,4020,248,1742,477700,7853
2096,1484,612,1590,292000,7856
1450,723,727,1165,264900,7857
9867,7397,2470,1116,267100,7860
1571,1331,240,847,251700,7863
713,613,100,1180,249400,7865
8218,6836,1382,1334,339600,7866
8964,6728,2236,1342,498700,7869
8,0,8,-,-,7870
7015,6310,705,1123,375600,7871
3066,2847,219,1655,255000,7874
3397,3242,155,1421,373100,7876
313,279,34,-,340900,7878
92,92,0,-,-,7880
6,6,0,-,-,7881
5473,4138,1335,1048,248700,7882
3674,2434,1240,1309,283900,7885
8333,5835,2498,1624,807600,7901
9685,8020,1665,1928,658100,7920
3900,2912,988,1871,357600,7921
4051,3764,287,1404,589000,7922
2747,2342,405,1742,667600,7924
36,36,0,-,-,7926
1490,1152,338,2073,468800,7927
6479,5406,1073,1772,780000,7928
2847,2694,153,1304,631600,7930
1212,959,253,1934,966200,7931
3999,2778,1221,2227,607600,7932
1195,1040,155,1668,453300,7933
582,479,103,1944,703500,7934
173,137,36,1725,454200,7935
3942,3600,342,1720,527500,7936
0,0,0,-,-,7939
5433,3850,1583,1559,681100,7940
3055,2837,218,1689,719400,7945
1081,1000,81,2618,563600,7946
7076,5878,1198,1831,457200,7950
17222,10949,6273,1558,554900,7960
0,0,0,-,-,7961
57,57,0,-,-,7970
4057,3415,642,1501,576300,7974
227,227,0,-,1402800,7976
210,115,95,1138,473100,7977
232,217,15,-,566700,7979
815,569,246,1467,468800,7980
3459,3042,417,1990,461700,7981
383,288,95,1652,168300,8001
8508,5658,2850,1327,228000,8002
10844,9424,1420,1516,300600,8003
3924,3345,579,1362,190900,8004
8966,7578,1388,1503,250400,8005
225,201,24,1308,713000,8006
2032,1293,739,786,191400,8007
3291,2940,351,1171,739400,8008
4627,3891,736,1068,214600,8009
4510,2787,1723,1080,165600,8010
39,39,0,-,-,8011
14884,10108,4776,1105,199900,8012
227,165,62,1235,178700,8014
7087,5516,1571,1092,168500,8015
11833,8652,3181,1004,238400,8016
391,328,63,-,253400,8019
921,816,105,1076,261800,8020
17592,9208,8384,977,147800,8021
3605,3535,70,1353,300900,8022
172,96,76,1417,95700,8023
780,725,55,1615,202100,8026
1985,1598,387,1026,181100,8027
6736,4587,2149,1034,192500,8028
1823,1316,507,742,168200,8029
4610,3144,1466,1083,124000,8030
4339,2677,1662,808,163700,8031
6242,4704,1538,1087,417100,8033
6923,5578,1345,1284,239500,8034
2918,2331,587,905,279000,8035
2185,2066,119,1169,287400,8036
8634,6698,1936,1167,229200,8037
28,26,2,-,159400,8038
28,28,0,-,-,8039
320,281,39,-,376700,8041
43,43,0,-,-,8042
10877,7354,3523,1183,303600,8043
1070,770,300,782,168300,8045
10334,8434,1900,1576,159900,8046
4585,3274,1311,1104,295400,8048
2166,1566,600,960,166600,8049
9339,7910,1429,1454,268000,8050
4412,3529,883,1257,174200,8051
8184,3899,4285,1099,180700,8052
17437,13159,4278,1355,278000,8053
17267,13893,3374,1463,252900,8054
9843,8510,1333,1363,345100,8055
1471,1406,65,1080,370300,8056
7213,6142,1071,1124,488000,8057
2142,1712,430,944,165900,8059
8706,6514,2192,1144,227600,8060
889,728,161,1603,271000,8061
5221,4670,551,1171,334500,8062
1034,828,206,1183,154400,8063
0,0,0,-,-,8064
3080,2203,877,1226,170000,8065
3523,1988,1535,886,128000,8066
614,532,82,1208,216700,8067
2748,1628,1120,971,205600,8068
4546,2426,2120,1024,151500,8069
5177,3804,1373,933,158800,8070
3640,2767,873,1011,189800,8071
109,105,4,-,199000,8072
111,111,0,-,328800,8073
0,0,0,-,-,8074
10527,7561,2966,1158,223400,8075
6765,5835,930,1463,270300,8077
3092,2111,981,894,169600,8078
4111,2451,1660,902,169400,8079
12622,11200,1422,1352,256300,8080
16546,13640,2906,1220,198800,8081
3678,2732,946,923,183200,8083
2624,1991,633,866,181200,8084
6651,5720,931,1459,280100,8085
3184,2353,831,1235,224100,8086
10031,8167,1864,1246,219700,8087
9363,8684,679,1325,260900,8088
1603,1274,329,1090,188300,8089
2927,2566,361,1155,187700,8090
1993,1299,694,865,174500,8091
1323,1116,207,1496,306100,8092
3759,2248,1511,934,162200,8093
14759,12329,2430,1077,195900,8094
112,112,0,-,-,8095
13755,9787,3968,1109,190000,8096
1087,999,88,1139,197100,8097
3363,2505,858,1013,250300,8098
2413,483,1930,643,84400,8102
4527,1998,2529,920,83200,8103
8913,2921,5992,888,69700,8104
8507,3886,4621,895,90800,8105
4066,2645,1421,854,208300,8106
5160,2936,2224,939,192800,8107
7514,5041,2473,1169,257800,8108
8318,6332,1986,929,181000,8109
5760,4464,1296,981,138900,8110
3843,2614,1229,1253,197200,8201
777,701,76,1168,1028800,8202
4372,3122,1250,1230,344000,8203
7569,6030,1539,946,288100,8204
10267,7601,2666,1207,212100,8205
6336,5250,1086,1294,268900,8210
117,107,10,1250,735500,8212
4983,3649,1334,1069,210900,8215
0,0,0,-,-,8217
2593,2144,449,1474,289500,8221
1718,1501,217,1306,284000,8223
203,157,46,675,244600,8224
3038,2676,362,1479,234200,8225
5466,3537,1929,1082,568700,8226
2059,1760,299,1112,322000,8230
6296,3814,2482,1123,159100,8232
14007,12195,1812,1004,222900,8234
0,0,0,-,-,8240
355,328,27,1538,286200,8241
1192,921,271,1061,250300,8242
1024,892,132,1200,640700,8243
4460,2455,2005,986,218000,8244
67,67,0,-,211000,8246
454,397,57,1316,1175000,8247
80,80,0,-,-,8248
4243,3243,1000,1173,178900,8251
6256,4076,2180,902,330000,8260
2939,2237,702,1056,262800,8270
13813,8502,5311,1030,162200,8302
692,609,83,971,156600,8310
709,496,213,1274,167800,8311
2928,2236,692,1104,180000,8312
137,121,16,-,130200,8314
108,85,23,-,228800,8316
467,451,16,-,219900,8317
4470,3968,502,945,216400,8318
425,417,8,-,224000,8319
0,0,0,-,-,8320
80,56,24,983,166700,8321
3561,3185,376,1244,207200,8322
269,218,51,1389,204300,8323
144,100,44,942,227400,8324
546,406,140,971,178400,8326
166,166,0,-,151400,8327
463,388,75,938,163800,8328
51,39,12,-,186200,8329
10701,7865,2836,1328,189600,8330
13719,8954,4765,1006,156000,8332
290,210,80,1083,265800,8340
1011,449,562,784,168200,8341
1738,1585,153,1486,251300,8343
1972,1531,441,1104,183100,8344
246,200,46,911,156900,8345
205,170,35,-,121300,8346
140,102,38,-,183300,8348
749,608,141,1415,153700,8349
348,292,56,-,237700,8350
186,147,39,971,160400,8352
139,97,42,844,156600,8353
15094,8721,6373,975,156200,8360
6225,5133,1092,998,200300,8361
15407,4141,11266,854,182900,8401
3238,2517,721,1124,469100,8402
556,484,72,1795,727800,8403
4351,2507,1844,1075,292300,8406
2348,2184,164,1138,395300,8501
3620,2783,837,1913,638000,8502
6936,5203,1733,1146,268900,8505
1823,1793,30,1938,545200,8510
346,302,44,888,232700,8511
3940,2310,1630,1223,467200,8512
1848,1646,202,1147,363600,8514
1813,1644,169,1329,423500,8515
2233,1664,569,991,197300,8518
9094,6434,2660,1289,280900,8520
1955,1609,346,1427,424100,8525
20229,17468,2761,1323,334300,8527
77,68,9,-,300000,8528
3147,2330,817,1223,377200,8530
2146,1851,295,1225,337700,8533
4864,4437,427,1289,471700,8534
1669,1606,63,1286,580100,8535
7911,3582,4329,1409,443000,8536
17441,11620,5821,1593,617000,8540
1704,541,1163,1636,534600,8542
6502,5550,952,1723,614600,8550
1870,1718,152,1665,463800,8551
232,188,44,1938,465000,8553
1464,1285,179,948,167500,8554
277,243,34,-,268400,8555
2428,2168,260,1510,691300,8558
1958,1714,244,1188,453900,8559
1347,1223,124,1787,374200,8560
48,48,0,-,-,8561
1709,995,714,915,236400,8562
465,16,449,696,-,8608
4546,1149,3397,961,86500,8609
11285,7431,3854,1049,194400,8610
7953,2576,5377,1065,94100,8611
13191,6052,7139,885,169200,8618
8674,6013,2661,1133,252600,8619
4256,3448,808,1040,267700,8620
4052,2674,1378,1241,259700,8628
3884,2743,1141,1123,121400,8629
8051,4779,3272,1084,187100,8638
955,13,942,1946,-,8640
1231,3,1228,1892,-,8641
11828,7990,3838,1498,284000,8648
7125,6171,954,1339,285100,8690
5805,4779,1026,1582,385200,8691
23738,11497,12241,1355,297000,8701
251,246,5,-,486600,8720
7613,6319,1294,1308,268700,8721
3726,3128,598,1614,237400,8722
12823,10020,2803,1221,271600,8723
16623,14414,2209,1329,274800,8724
1821,1646,175,1970,608000,8730
7681,6932,749,1473,258300,8731
638,508,130,1522,409900,8732
860,570,290,1735,193600,8733
3191,2851,340,872,315600,8734
1803,1613,190,1118,602600,8735
4723,3863,860,1363,561000,8736
473,445,28,1397,1091600,8738
818,594,224,1611,249100,8740
930,883,47,1618,296700,8741
9840,7800,2040,1460,395500,8742
1427,1312,115,1200,825000,8750
1849,815,1034,1321,447000,8751
1274,975,299,1214,573500,8752
23212,18111,5101,1371,282300,8753
10081,8688,1393,1209,269900,8755
16738,14947,1791,1289,152100,8757
3360,2931,429,1438,306300,8758
19117,16556,2561,1049,110500,8759
2646,2169,477,1583,395900,8801
1473,1330,143,1213,377500,8802
960,894,66,1018,292100,8804
4133,2442,1691,1217,288700,8805
13126,10720,2406,1640,458400,8807
27,21,6,-,-,8808
1974,1462,512,1401,332600,8809
2766,2292,474,1766,379700,8810
4593,3767,826,1268,349700,8812
16337,13261,3076,1383,379300,8816
15924,8877,7047,1448,297200,8817
13257,9696,3561,1417,466700,8820
112,101,11,-,344000,8821
11573,9197,2376,1339,388500,8822
3751,2495,1256,1803,271800,8823
4273,3836,437,1160,410700,8824
1688,1315,373,1115,361800,8825
2258,1733,525,1140,337700,8826
1632,1401,231,1016,362400,8827
842,661,181,1649,272200,8828
1539,1211,328,1341,241800,8829
6353,4385,1968,1618,288700,8830
20558,17910,2648,1313,327900,8831
899,198,701,1230,260600,8832
3056,2630,426,1840,483200,8833
3738,2369,1369,1317,248900,8835
1336,1292,44,-,582700,8836
6367,3353,3014,1217,311400,8837
5966,4776,1190,1516,372400,8840
13551,11585,1966,1438,401300,8844
4610,3482,1128,1295,302800,8846
3062,2745,317,1195,345700,8848
3061,2605,456,1224,355600,8850
6282,3953,2329,1469,376900,8852
1804,1321,483,1192,553000,8853
16253,10818,5435,1449,310900,8854
14755,9914,4841,1173,341300,8857
54,54,0,-,-,8858
7992,5183,2809,1161,293100,8859
16565,5423,11142,1196,248500,8861
4442,3180,1262,1229,290000,8863
11522,7385,4137,932,191900,8865
1792,1629,163,1345,516200,8867
2818,1798,1020,1410,334900,8869
7186,4447,2739,1180,288600,8872
19398,13533,5865,1448,326600,8873
8077,5765,2312,1266,354200,8876
9224,5454,3770,1172,276800,8879
1518,963,555,1285,246600,8880
5551,3676,1875,1146,276000,8882
3356,2704,652,921,286100,8884
2394,2029,365,1525,309800,8886
544,416,128,1426,188300,8887
3757,3439,318,1628,443800,8889
0,0,0,-,-,8890
14309,2685,11624,1381,253300,8901
14637,8480,6157,1474,302800,8902
5778,2409,3369,1315,353000,8904
11967,3232,8735,2114,460500,10001
33327,4601,28726,919,608900,10002
27258,8292,18966,2117,963100,10003
1592,430,1162,2911,1250000,10004
4295,749,3546,3005,1424900,10005
1776,233,1543,2847,939800,10006
2743,1009,1734,3339,1946100,10007
30062,2026,28036,1554,609700,10009
16070,4414,11656,2442,698800,10010
28738,10217,18521,2029,973200,10011
12240,1985,10255,2128,1322000,10012
11934,3304,8630,1663,"2,000,000+",10013
18671,5841,12830,2337,1039000,10014
28359,7856,20503,2440,723300,10016
10134,3958,6176,2214,590200,10017
4956,402,4554,2849,927100,10018
23465,4184,19281,2211,929700,10019
0,0,0,-,-,10020
24558,10159,14399,1961,1178900,10021
17619,8825,8794,2386,904000,10022
33144,13517,19627,2256,972600,10023
28809,10391,18418,1947,1272600,10024
42783,11059,31724,1450,963900,10025
14803,2700,12103,1045,695400,10026
22933,3115,19818,1063,672600,10027
25837,8260,17577,2187,1155200,10028
30640,1995,28645,911,792400,10029
11878,1089,10789,917,531300,10030
21881,2509,19372,1174,322500,10031
20140,1417,18723,1131,378100,10032
19426,2095,17331,1294,469700,10033
15841,1335,14506,1232,337100,10034
13480,1167,12313,758,472700,10035
15568,1614,13954,2053,825800,10036
9317,563,8754,1068,412000,10037
10048,2652,7396,2185,637000,10038
10856,1338,9518,882,390600,10039
16086,1660,14426,1235,356900,10040
4790,777,4013,2181,626900,10044
16468,5739,10729,2251,1370200,10065
2629,658,1971,3064,1539500,10069
12766,5111,7655,2037,835600,10075
0,0,0,-,-,10103
0,0,0,-,-,10110
0,0,0,-,-,10111
0,0,0,-,-,10112
0,0,0,-,-,10115
0,0,0,-,-,10119
32151,10252,21899,2056,926600,10128
0,0,0,-,-,10152
0,0,0,-,-,10153
0,0,0,-,-,10154
625,0,625,2735,-,10162
0,0,0,-,-,10165
0,0,0,-,-,10167
0,0,0,-,-,10168
0,0,0,-,-,10169
0,0,0,-,-,10170
0,0,0,-,-,10171
0,0,0,-,-,10172
0,0,0,-,-,10173
0,0,0,-,-,10174
0,0,0,-,-,10177
0,0,0,-,-,10199
0,0,0,-,-,10271
0,0,0,-,-,10278
0,0,0,-,-,10279
4800,1132,3668,2936,705400,10280
2434,210,2224,2974,1654400,10282
14361,6331,8030,1186,421000,10301
6072,3400,2672,1198,363400,10302
8124,4878,3246,972,314200,10303
14669,7660,7009,1072,452000,10304
14563,9599,4964,1195,417600,10305
20271,14367,5904,1232,453600,10306
5128,3883,1245,1175,614200,10307
10667,8969,1698,1365,458700,10308
11247,9328,1919,1339,554000,10309
8304,5111,3193,1086,399500,10310
0,0,0,-,-,10311
21311,17968,3343,1185,480200,10312
31297,23008,8289,1274,443200,10314
18489,2329,16160,965,122200,10451
25765,779,24986,1065,265800,10452
27240,899,26341,1057,380200,10453
12838,732,12106,705,392000,10454
14225,1073,13152,851,311600,10455
29771,1772,27999,948,360300,10456
24089,1583,22506,1083,377600,10457
27000,1182,25818,1143,350600,10458
15870,1456,14414,941,373800,10459
19974,2026,17948,964,414600,10460
18881,5817,13064,1301,441800,10461
29438,6597,22841,1226,239000,10462
27607,8641,18966,1236,272000,10463
1890,1202,688,1251,477700,10464
15647,8698,6949,1277,440900,10465
23056,8757,14299,1165,398000,10466
35860,4288,31572,1160,347000,10467
25485,1992,23493,1167,189100,10468
21821,10439,11382,1293,421600,10469
5800,2245,3555,1303,413100,10470
8614,4253,4361,1504,322600,10471
21756,3110,18646,1100,417700,10472
20906,6049,14857,893,365600,10473
3542,246,3296,1094,382700,10474
18664,7693,10971,954,28400,10475
385,379,6,-,653500,10501
1879,1579,300,1231,619100,10502
86,86,0,-,530600,10503
2569,2380,189,2516,1020500,10504
298,173,125,1256,760500,10505
1961,1800,161,-,978600,10506
2071,1035,1036,1436,581500,10507
6756,5082,1674,1250,347600,10509
3466,2903,563,1323,677400,10510
807,618,189,1418,377700,10511
9128,7458,1670,1270,306800,10512
3948,3725,223,2178,977100,10514
2170,1590,580,1456,443200,10516
150,120,30,1917,419000,10517
494,439,55,-,788300,10518
71,71,0,-,-,10519
5208,3099,2109,1330,507800,10520
3680,2202,1478,1815,618200,10522
2763,1515,1248,1938,425300,10523
1454,1303,151,1281,453700,10524
614,533,81,1330,559800,10526
276,276,0,-,620100,10527
4589,2721,1868,2018,724300,10528
5738,4512,1226,1817,380100,10530
1662,1419,243,1657,486800,10532
2591,2070,521,1756,671000,10533
266,101,165,1248,401000,10535
3459,3117,342,2212,709500,10536
576,547,29,-,247100,10537
5947,4724,1223,1781,929600,10538
8644,7362,1282,1355,376200,10541
7597,4368,3229,1714,597100,10543
0,0,0,-,-,10545
472,422,50,3224,679100,10546
2584,1914,670,1527,340300,10547
1295,950,345,1307,352000,10548
5834,3867,1967,1393,557300,10549
13208,3348,9860,1167,348700,10550
8127,4629,3498,1335,364800,10552
3282,1770,1512,1351,366300,10553
1734,1418,316,1697,595500,10560
10046,5762,4284,1453,411100,10562
9180,4464,4716,1324,289100,10566
6924,6095,829,1866,397000,10567
4114,3308,806,1528,645200,10570
12537,6611,5926,1476,494800,10573
1872,1595,277,2343,918400,10576
833,707,126,3459,1164800,10577
308,224,84,1615,479400,10578
3175,2876,299,1554,394900,10579
5797,4380,1417,2053,1170900,10580
13701,11654,2047,1903,859500,10583
1069,808,261,1471,342500,10588
3789,3416,373,2328,453800,10589
2478,2322,156,1764,585700,10590
8830,4622,4208,1450,560700,10591
1536,1263,273,1620,606000,10594
2277,1537,740,1628,591500,10595
546,303,243,1547,286500,10596
388,388,0,-,920500,10597
10340,9084,1256,1345,432400,10598
5195,1760,3435,1634,326000,10601
6753,4322,2431,1544,389900,10603
3847,2213,1634,1693,637600,10604
6616,5087,1529,1581,608300,10605
5723,2360,3363,1594,532300,10606
2212,1850,362,1456,500700,10607
21514,6812,14702,1222,345900,10701
7045,3686,3359,1288,333600,10703
12218,6860,5358,1363,392900,10704
13601,4277,9324,1148,388100,10705
3310,2448,862,1688,640600,10706
3994,2499,1495,1733,559300,10707
9224,7022,2202,1593,452900,10708
3558,2815,743,1597,617400,10709
10195,7012,3183,1373,432200,10710
14349,5311,9038,1333,462700,10801
3882,3046,836,1853,753300,10803
4992,4750,242,1894,676000,10804
7535,2702,4833,1455,311100,10805
8710,6445,2265,1233,402800,10901
27,0,27,-,-,10910
0,0,0,-,-,10911
1603,1581,22,1292,489700,10913
134,134,0,-,371800,10914
0,0,0,-,-,10915
1223,1130,93,2043,349200,10916
644,471,173,1582,345100,10917
3821,3167,654,1418,301200,10918
446,412,34,-,248900,10919
2948,2475,473,1550,426900,10920
1335,1041,294,1116,278500,10921
589,446,143,1660,253800,10922
2687,1591,1096,1373,337200,10923
4570,3071,1499,1183,314800,10924
1746,1352,394,1211,280800,10925
1226,637,589,1385,173900,10926
3621,1562,2059,1295,257900,10927
1835,905,930,1108,216600,10928
2645,2425,220,-,299100,10930
311,221,90,1353,299300,10931
24,24,0,-,-,10932
255,245,10,-,298600,10933
17668,10573,7095,1122,210400,10940
4728,3255,1473,1295,259700,10941
12655,8137,4518,1145,304700,10950
9059,4532,4527,1376,512800,10952
79,79,0,-,620200,10953
8212,5935,2277,1606,392800,10954
10129,9063,1066,1291,480000,10956
922,795,127,1029,279200,10958
6244,3132,3112,1511,480900,10960
1744,1478,266,965,481000,10962
830,658,172,1438,228200,10963
521,392,129,3004,584900,10964
5441,4267,1174,1337,434800,10965
1146,749,397,1566,645300,10968
500,384,116,2023,284900,10969
3631,2691,940,1762,291800,10970
768,604,164,1152,264600,10973
1101,862,239,1391,315800,10974
153,91,62,1592,185400,10975
785,471,314,530,451400,10976
15566,7698,7868,1263,374200,10977
81,81,0,-,231900,10979
4647,3890,757,1448,365100,10980
1890,1746,144,2228,450500,10983
965,878,87,1915,374900,10984
19,19,0,-,-,10985
561,490,71,1225,452400,10986
1343,1069,274,1322,465600,10987
278,229,49,995,193800,10988
3458,2982,476,1766,413300,10989
7273,5680,1593,1024,327700,10990
3152,2562,590,926,272600,10992
1438,738,700,1218,233400,10993
2620,2407,213,1331,484100,10994
825,14,811,3216,-,10996
871,748,123,1438,307000,10998
9129,7317,1812,1508,489800,11001
12064,9619,2445,1644,368600,11003
5103,3784,1319,1412,479700,11004
1405,1290,115,2298,436400,11005
7749,6378,1371,1344,444700,11010
1842,1573,269,-,894400,11020
7780,5407,2373,1756,611200,11021
2915,2429,486,3087,853000,11023
2065,1803,262,1448,1358000,11024
6145,5365,780,1422,1170000,11030
12736,11577,1159,1486,552100,11040
0,0,0,-,-,11042
10919,7229,3690,2039,765800,11050
2442,1110,1332,1270,353600,11096
12034,2039,9995,1322,775900,11101
13874,1746,12128,1529,566500,11102
16460,2496,13964,1531,700800,11103
11500,1986,9514,1447,440400,11104
15398,3938,11460,1574,704200,11105
17232,3062,14170,1462,453000,11106
2736,278,2458,3000,386400,11109
26303,9537,16766,2103,794500,11201
27479,10833,16646,1208,417400,11203
24307,8982,15325,1261,727400,11204
15604,3412,12192,1229,636000,11205
30107,3103,27004,942,560300,11206
32120,7877,24243,1079,412400,11207
30641,7794,22847,1171,422300,11208
29451,10539,18912,1402,696300,11209
22251,9892,12359,1223,512700,11210
38049,5989,32060,1520,843300,11211
31587,4727,26860,956,406000,11212
24471,3591,20880,1131,657600,11213
31716,10688,21028,1246,645000,11214
29007,10918,18089,2000,1000800,11215
23629,4979,18650,1220,802800,11216
16718,5192,11526,1791,991700,11217
24660,8493,16167,1438,624700,11218
26145,6640,19505,1295,787700,11219
28951,6867,22084,1262,720000,11220
29570,6319,23251,1254,610600,11221
17058,3457,13601,1781,713400,11222
27373,9525,17848,1211,656300,11223
18157,5077,13080,744,331000,11224
23481,3376,20105,1261,653600,11225
36399,4683,31716,1242,487800,11226
15265,8658,6607,1344,763100,11228
31024,14664,16360,1205,531300,11229
30668,8656,22012,1275,690900,11230
15468,4272,11196,1666,1053300,11231
8927,2190,6737,1357,580000,11232
27723,6189,21534,1114,609500,11233
32050,21400,10650,1336,501700,11234
32421,13353,19068,1207,515000,11235
32786,15845,16941,1305,480300,11236
16785,1543,15242,1357,551100,11237
23996,7037,16959,1560,761500,11238
6456,150,6306,645,511900,11239
0,0,0,-,-,11351
20414,7974,12440,1395,438100,11354
27144,8496,18648,1307,527900,11355
7549,3684,3865,1521,575300,11356
14614,10895,3719,1621,620700,11357
13006,7240,5766,1520,659900,11358
0,0,0,-,-,11359
8345,5583,2762,1949,516600,11360
10420,5875,4545,1662,605200,11361
7035,5681,1354,1716,509400,11362
2649,1919,730,1777,798900,11363
13226,9601,3625,1623,507600,11364
15436,7667,7769,1440,620800,11365
4386,3015,1371,1631,669000,11366
14761,6948,7813,1314,409200,11367
28773,6326,22447,1464,493200,11368
11025,5422,5603,1391,486300,11369
8670,4079,4591,1545,576200,11370
0,0,0,-,-,11371
24326,7438,16888,1347,282100,11372
30989,8455,22534,1386,512800,11373
19271,6921,12350,1389,298900,11374
32354,16119,16235,1600,371800,11375
31603,9493,22110,1412,442500,11377
12506,6332,6174,1447,552700,11378
13456,8180,5276,1400,588400,11379
34919,10922,23997,1337,509100,11385
6034,5117,917,1438,402500,11411
11019,8026,2993,1333,392100,11412
12367,8888,3479,1538,415900,11413
10477,7560,2917,1532,479900,11414
8324,3023,5301,1432,334600,11415
7173,3005,4168,1384,457700,11416
9264,5341,3923,1389,444600,11417
11062,4730,6332,1395,470400,11418
12673,7174,5499,1419,442100,11419
13321,8770,4551,1401,428800,11420
12120,6761,5359,1449,430000,11421
9602,6169,3433,1581,412600,11422
9633,5451,4182,1308,441900,11423
0,0,0,-,-,11424
0,0,0,-,-,11425
6240,4768,1472,1554,479300,11426
7448,4440,3008,1299,466900,11427
5566,3597,1969,1401,432400,11428
7405,5208,2197,1371,393700,11429
0,0,0,-,-,11430
18487,6768,11719,1356,541200,11432
10398,4378,6020,1134,375900,11433
20968,10288,10680,1138,380500,11434
18979,6683,12296,1353,340500,11435
5494,3834,1660,1450,369700,11436
0,0,0,-,-,11451
7180,4595,2585,1625,441800,11501
2360,2278,82,1750,606100,11507
906,814,92,2420,726900,11509
10765,9033,1732,1611,368500,11510
1636,1191,445,1583,479600,11514
2210,1507,703,1607,525300,11516
3912,3048,864,1986,421900,11518
13487,9094,4393,1385,311500,11520
9256,8483,773,2267,713900,11530
9741,5115,4626,1728,477200,11542
4246,3763,483,1886,821100,11545
274,233,41,-,497700,11547
481,346,135,1750,664400,11548
0,0,0,-,-,11549
16543,7154,9389,1316,313800,11550
7226,6269,957,1758,394500,11552
6182,4548,1634,1315,302700,11553
12171,10724,1447,1758,400700,11554
0,0,0,-,-,11556
2501,2215,286,1528,528500,11557
3022,2216,806,1640,408200,11558
2801,2257,544,1643,774900,11559
2297,1733,564,1714,712800,11560
15897,9482,6415,1743,470300,11561
8181,5823,2358,1679,424100,11563
3164,2981,183,1220,432900,11565
11186,10608,578,2194,490100,11566
1013,931,82,1603,1694800,11568
467,353,114,1865,830100,11569
9884,6927,2957,1514,592900,11570
10242,8932,1310,1370,437500,11572
4299,3124,1175,1652,286700,11575
4668,4172,496,2048,902300,11576
4227,3684,543,1800,727000,11577
1952,1426,526,1766,649300,11579
12929,10674,2255,1465,369100,11580
6859,5638,1221,1640,427100,11581
14037,10484,3553,1580,415100,11590
3526,2981,545,1718,552900,11596
3877,3437,440,1805,625300,11598
19869,4716,15153,1089,434800,11691
6298,2229,4069,867,356600,11692
4751,2362,2389,924,291500,11693
8150,4148,4002,1250,611300,11694
1496,1451,45,-,548100,11697
8552,5654,2898,1386,326900,11701
5065,3892,1173,1725,430300,11702
5488,4511,977,1753,336100,11703
12852,9316,3536,1577,334500,11704
2645,2121,524,1767,426700,11705
18860,13378,5482,1427,310900,11706
2423,1955,468,1392,506900,11709
11286,9958,1328,1725,449600,11710
3188,2058,1130,2059,314000,11713
7475,6818,657,1905,403500,11714
1556,1309,247,1600,382000,11715
3559,2662,897,1591,381400,11716
13446,9566,3880,1325,280900,11717
1104,1015,89,1138,503900,11718
1181,916,265,1376,393500,11719
8923,7333,1590,2019,331000,11720
2266,2091,175,1498,577000,11721
9638,6236,3402,1526,255100,11722
1034,884,150,2360,1114400,11724
9722,8749,973,1665,459000,11725
5977,3998,1979,1504,291000,11726
10971,6794,4177,1732,293300,11727
8969,7312,1657,1616,349500,11729
4446,3981,465,1697,404000,11730
10054,8711,1343,1724,460200,11731
1488,1092,396,2209,628900,11732
5651,5330,321,2280,478500,11733
11232,9086,2146,1617,377900,11735
5129,4373,756,1757,338200,11738
364,347,17,-,645100,11739
3229,2578,651,450,512300,11740
9079,7245,1834,1832,361400,11741
4566,3590,976,1690,336900,11742
15042,13110,1932,1809,566100,11743
20905,17303,3602,1640,467700,11746
6986,6139,847,2548,609200,11747
959,837,122,1897,310200,11749
5096,4259,837,1376,367400,11751
2957,2535,422,1734,351200,11752
4150,3720,430,1733,738900,11753
6535,5251,1284,1387,429800,11754
4139,3484,655,1784,383500,11755
13391,12138,1253,1765,354600,11756
14890,11285,3605,1495,343200,11757
18124,16389,1735,1429,442300,11758
7285,7066,219,2431,443200,11762
9295,7422,1873,1637,292200,11763
4274,4036,238,1388,426500,11764
261,231,30,2722,1875000,11765
4256,3968,288,1728,432900,11766
4874,4328,546,1547,441500,11767
7898,6817,1081,1616,614300,11768
3406,2983,423,1544,407100,11769
30,30,0,-,812500,11770
3479,2719,760,1654,759300,11771
16585,10339,6246,1416,298400,11772
8229,6686,1543,1666,346200,11776
3456,2441,1015,1685,521500,11777
4236,3525,711,1414,278900,11778
12740,9584,3156,1482,332400,11779
5276,4756,520,1659,484000,11780
5365,4281,1084,1749,436400,11782
7037,6357,680,1874,434700,11783
7980,6655,1325,1539,294700,11784
1790,1706,84,2359,404100,11786
11999,10489,1510,1400,463900,11787
5547,4414,1133,1889,453100,11788
2843,2496,347,1341,287700,11789
4550,4178,372,2351,442200,11790
8067,7392,675,2500,670400,11791
3017,2793,224,1156,445300,11792
10362,9742,620,1462,438100,11793
0,0,0,-,-,11794
7953,7548,405,1426,413300,11795
1254,954,300,1553,376700,11796
2969,2623,346,2313,856500,11797
3770,2642,1128,1636,297700,11798
12646,10696,1950,1729,405200,11801
9408,8761,647,1511,503500,11803
1623,1462,161,-,560000,11804
10009,7136,2873,1389,300100,11901
518,437,81,1986,1176700,11930
17,17,0,-,-,11931
409,381,28,1297,905800,11932
2734,2397,337,1514,357700,11933
2425,2065,360,1224,378000,11934
1247,1155,92,1671,516900,11935
6569,5528,1041,1469,775500,11937
456,393,63,1648,611200,11939
1892,1463,429,1779,408800,11940
784,580,204,1396,531300,11941
1687,1420,267,1839,504600,11942
1787,1171,616,1370,438100,11944
5447,3848,1599,1682,432100,11946
77,77,0,-,352000,11947
438,406,32,-,537500,11948
4952,4334,618,1470,407100,11949
4773,3732,1041,1557,233700,11950
4769,3239,1530,1791,189500,11951
1822,1518,304,1309,547000,11952
5259,3850,1409,1662,266500,11953
1522,1205,317,1461,844500,11954
1569,736,833,1662,343700,11955
147,115,32,1938,604700,11956
351,300,51,1367,680100,11957
250,219,31,-,604900,11958
360,276,84,1713,1070300,11959
248,229,19,-,721700,11960
5383,4555,828,1391,263800,11961
188,178,10,-,"2,000,000+",11962
2794,2312,482,1942,842700,11963
886,763,123,-,733200,11964
239,191,48,-,822900,11965
7710,6337,1373,1989,251900,11967
4411,3373,1038,1816,838300,11968
81,81,0,-,-,11970
2616,2303,313,1420,525500,11971
466,350,116,1508,557000,11972
0,0,0,-,-,11973
130,112,18,-,1656300,11975
938,840,98,2622,1960900,11976
814,683,131,1953,681500,11977
1259,922,337,1819,583000,11978
1761,1385,376,2004,303000,11980
0,0,0,-,-,12007
196,187,9,-,232900,12008
3011,2372,639,984,263400,12009
11695,7356,4339,744,109700,12010
1052,788,264,835,170200,12015
148,125,23,-,268800,12017
2866,2454,412,743,214800,12018
5705,4585,1120,988,272200,12019
12909,9716,3193,1069,218000,12020
397,313,84,683,135700,12022
808,771,37,-,189100,12023
12,12,0,-,-,12024
2253,1868,385,763,159800,12025
1459,1238,221,1188,253800,12027
332,303,29,876,187800,12028
409,328,81,1298,301200,12029
62,46,16,564,100000,12031
380,350,30,817,142900,12032
3058,2401,657,981,208800,12033
301,237,64,828,92200,12035
109,96,13,-,143200,12036
1799,1254,545,967,218600,12037
55,55,0,-,93800,12040
209,209,0,-,159600,12041
85,53,32,-,151100,12042
2965,1738,1227,738,147000,12043
169,126,43,669,156600,12045
392,355,37,-,204300,12046
8533,4262,4271,852,164900,12047
1432,979,453,712,169100,12051
659,514,145,775,165900,12052
1503,1230,273,1171,215800,12053
6822,5147,1675,1146,267500,12054
783,695,88,843,219200,12056
807,696,111,714,173400,12057
563,461,102,882,195600,12058
668,591,77,755,211700,12059
624,534,90,-,250000,12060
3801,2606,1195,1171,243500,12061
652,572,80,962,178300,12062
169,136,33,-,270600,12063
225,165,60,671,98700,12064
17571,12001,5570,1116,261400,12065
756,645,111,776,141300,12066
557,518,39,1034,227600,12067
1191,945,246,701,125300,12068
68,48,20,-,115300,12069
635,576,59,907,124300,12070
129,92,37,-,203300,12071
964,796,168,800,104900,12072
1141,1022,119,640,229500,12074
1038,829,209,977,243600,12075
599,525,74,864,129400,12076
2480,1900,580,977,286700,12077
9928,6160,3768,691,88700,12078
1488,1332,156,640,172300,12083
1999,455,1544,1171,255300,12084
142,27,115,1022,-,12085
726,638,88,795,157400,12086
339,300,39,-,124600,12087
64,55,9,-,-,12089
2339,1567,772,860,133900,12090
334,237,97,646,130200,12092
694,556,138,675,152800,12093
863,728,135,1036,180000,12094
4820,3248,1572,790,106700,12095
1093,880,213,1115,238600,12106
132,103,29,817,215900,12108
7534,5405,2129,1139,234800,12110
105,72,33,-,-,12115
852,655,197,951,117500,12116
1444,1140,304,775,133200,12117
5957,3910,2047,888,226600,12118
227,210,17,-,200000,12120
697,663,34,-,220200,12121
2027,1619,408,692,123800,12122
2101,1672,429,829,183500,12123
256,247,9,-,188200,12124
604,440,164,960,192600,12125
394,357,37,-,208800,12130
46,39,7,-,129200,12131
123,99,24,-,201000,12132
1461,1185,276,804,164100,12134
326,300,26,-,367400,12136
675,587,88,1030,183700,12137
1337,1113,224,735,157600,12138
71,63,8,-,162500,12139
645,559,86,915,227300,12140
2040,1214,826,883,167200,12143
8515,5180,3335,945,169400,12144
225,212,13,-,237000,12147
1753,1469,284,2689,295400,12148
934,691,243,752,159000,12149
282,244,38,924,150500,12150
316,264,52,1047,206600,12151
367,367,0,-,240300,12153
1022,849,173,710,174600,12154
731,538,193,713,120300,12155
375,300,75,679,320200,12156
1661,1321,340,754,160200,12157
2547,2117,430,1000,208100,12158
3291,2480,811,1034,338900,12159
344,288,56,-,145800,12160
28,14,14,-,-,12161
73,66,7,-,152800,12164
72,47,25,675,-,12165
527,449,78,672,111100,12166
1128,790,338,601,142800,12167
885,683,202,845,162900,12168
113,113,0,-,210800,12169
1833,1527,306,1154,211400,12170
116,69,47,1066,123300,12172
709,577,132,892,177700,12173
130,85,45,898,161900,12174
223,200,23,888,147900,12175
86,78,8,-,185000,12176
233,191,42,-,92800,12177
21139,9922,11217,885,170900,12180
6225,3430,2795,760,144100,12182
1117,332,785,837,118200,12183
2558,2084,474,869,222100,12184
849,745,104,833,196900,12185
2514,2178,336,940,249200,12186
187,187,0,-,166300,12187
4742,3045,1697,881,212100,12188
7860,3332,4528,835,160600,12189
223,199,24,888,154900,12190
684,629,55,641,182600,12192
790,755,35,1125,177100,12193
63,63,0,-,86600,12194
124,93,31,-,222500,12195
1236,1096,140,787,233600,12196
938,780,158,691,111000,12197
2996,2535,461,958,198700,12198
4047,963,3084,740,99500,12202
13517,6585,6932,998,198200,12203
3232,848,2384,984,167600,12204
11271,7604,3667,1065,193300,12205
6097,1745,4352,873,114000,12206
826,67,759,361,-,12207
9661,4560,5101,962,195500,12208
4425,2427,1998,933,158900,12209
5006,1032,3974,830,166700,12210
4356,3844,512,1557,280400,12211
0,0,0,-,-,12222
10132,7673,2459,975,179600,12302
10677,7799,2878,852,172700,12303
8558,5414,3144,863,125500,12304
2214,437,1777,708,129800,12305
9133,6780,2353,901,162900,12306
2053,582,1471,765,73600,12307
4968,2378,2590,823,132900,12308
10735,8766,1969,1020,238900,12309
14096,7789,6307,1010,180900,12401
1490,1215,275,1106,234900,12404
209,158,51,-,218300,12405
488,256,232,826,189300,12406
77,74,3,-,241700,12407
339,278,61,1075,351300,12409
248,226,22,-,214700,12410
124,124,0,-,247800,12411
270,183,87,974,169900,12412
1154,662,492,940,151700,12413
3780,2372,1408,846,176800,12414
89,64,25,-,241700,12416
182,138,44,1100,129500,12417
130,125,5,-,179300,12418
253,142,111,957,238900,12419
177,141,36,-,261200,12420
174,169,5,-,172200,12421
114,114,0,-,200000,12422
438,344,94,831,171100,12423
103,92,11,-,213500,12424
138,126,12,-,238000,12427
2490,1538,952,906,141800,12428
108,70,38,-,-,12429
493,423,70,655,221500,12430
484,292,192,1116,175000,12431
244,169,75,1261,202700,12432
239,201,38,-,343800,12433
296,198,98,521,154100,12434
128,81,47,997,244800,12435
155,113,42,-,178100,12436
26,26,0,-,186100,12438
132,106,26,857,178000,12439
875,671,204,1353,238500,12440
17,17,0,-,264600,12441
407,250,157,-,258900,12442
1567,1500,67,1384,231600,12443
200,183,17,900,222400,12444
1951,1502,449,944,170500,12446
218,210,8,-,400000,12448
1225,838,387,1082,176300,12449
59,59,0,-,-,12450
515,448,67,1285,138100,12451
94,89,5,-,156800,12452
135,69,66,-,360600,12453
124,114,10,-,236400,12454
884,608,276,758,181000,12455
203,183,20,-,134400,12456
406,256,150,1200,271600,12457
958,635,323,751,114500,12458
106,106,0,-,-,12459
114,75,39,696,171300,12460
800,606,194,848,274100,12461
554,452,102,778,180900,12463
454,340,114,693,229000,12464
118,113,5,-,235400,12465
985,804,181,923,204700,12466
467,422,45,692,159200,12468
318,298,20,-,150000,12469
164,99,65,-,157300,12470
162,33,129,1383,-,12471
659,384,275,1020,191500,12472
365,358,7,-,187300,12473
453,345,108,713,154000,12474
128,128,0,-,-,12475
7358,5140,2218,987,204000,12477
373,336,37,-,167100,12480
558,450,108,1208,237300,12481
219,149,70,837,26100,12482
152,89,63,-,99400,12483
1186,987,199,1190,253700,12484
480,361,119,881,226400,12485
557,478,79,1478,236600,12486
1224,841,383,1260,206800,12487
107,107,0,-,160200,12489
15,15,0,-,-,12490
668,637,31,1117,231400,12491
132,120,12,-,258900,12492
111,40,71,-,-,12493
325,290,35,-,270700,12494
153,153,0,-,398800,12495
640,530,110,-,224400,12496
2272,1855,417,1085,276200,12498
974,616,358,1114,283000,12501
445,365,80,1359,319600,12502
295,216,79,1364,264600,12503
30,11,19,-,-,12504
71,60,11,-,478900,12507
7128,3891,3237,1222,243600,12508
35,0,35,-,-,12512
228,180,48,-,210000,12513
1131,1025,106,1340,313700,12514
550,362,188,958,209600,12515
671,519,152,1140,241300,12516
242,152,90,942,283300,12517
2433,1534,899,1371,313100,12518
1099,767,332,1236,317700,12520
545,516,29,871,238900,12521
1950,1471,479,986,217100,12522
644,472,172,828,225400,12523
5936,4205,1731,1373,280000,12524
1042,750,292,1042,246200,12525
1509,1194,315,867,273700,12526
52,7,45,-,-,12527
5110,3565,1545,1106,237900,12528
1083,786,297,1006,243900,12529
84,41,43,-,-,12530
1278,1012,266,1338,279500,12531
8560,7717,843,1153,338800,12533
7629,4619,3010,821,185700,12534
4996,3558,1438,1003,227100,12538
2636,2369,267,1355,326500,12540
2307,1591,716,908,254200,12542
1285,822,463,1072,170000,12543
1987,1075,912,1102,395600,12545
1188,713,475,974,259600,12546
1068,796,272,1152,229100,12547
621,460,161,-,226000,12548
3860,3039,821,1142,269100,12549
18437,10412,8025,1131,227700,12550
9161,6528,2633,1221,241500,12553
6274,3952,2322,1133,301600,12561
2341,1915,426,1222,297000,12563
2596,1928,668,957,320300,12564
609,285,324,736,155400,12565
3791,2868,923,900,238000,12566
1234,894,340,1018,260900,12567
4112,2854,1258,1285,258000,12569
2625,2438,187,1223,343100,12570
3947,2933,1014,1152,284000,12571
3636,2571,1065,1101,352900,12572
53,47,6,-,-,12574
647,617,30,-,343200,12575
524,459,65,1388,299700,12577
806,623,183,1119,298300,12578
1550,1064,486,1049,280700,12580
877,648,229,872,285200,12581
1405,1206,199,1068,364100,12582
864,554,310,1258,250600,12583
346,293,53,931,332500,12585
4287,2924,1363,1159,221800,12586
4989,4149,840,978,253600,12589
12843,9277,3566,1338,278800,12590
414,273,141,840,261400,12592
1472,1088,384,913,247300,12594
15801,6337,9464,1055,207300,12601
15407,11617,3790,1175,245600,12603
7,7,0,-,-,12604
4216,1922,2294,851,114200,12701
545,408,137,830,191400,12719
108,49,59,-,-,12720
2116,1675,441,1096,225100,12721
49,49,0,-,-,12722
748,561,187,869,204900,12723
143,116,27,-,-,12724
81,75,6,-,231300,12725
550,476,74,943,181800,12726
785,520,265,1070,161100,12729
369,275,94,1118,170400,12732
309,128,181,746,157500,12733
387,287,100,883,181000,12734
50,50,0,-,213600,12736
736,601,135,885,203600,12737
153,105,48,-,185300,12738
629,500,129,1024,214900,12740
118,89,29,693,211700,12741
37,20,17,608,275000,12742
143,107,36,1617,193400,12743
75,41,34,-,118800,12745
384,321,63,1134,196900,12746
545,392,153,906,161200,12747
676,567,109,785,171400,12748
200,59,141,620,215400,12749
81,58,23,1240,253100,12750
306,165,141,1253,130600,12751
117,73,44,822,173300,12752
2454,1266,1188,780,119000,12754
1606,1193,413,1029,157000,12758
474,348,126,813,109200,12759
197,173,24,927,113800,12760
222,134,88,783,-,12762
223,185,38,768,133000,12763
747,582,165,619,186100,12764
389,306,83,841,205100,12765
153,134,19,-,-,12766
30,30,0,-,97500,12767
329,239,90,695,124800,12768
111,88,23,-,138100,12769
74,64,10,-,166400,12770
5430,3501,1929,920,184400,12771
829,684,145,1131,225700,12775
929,774,155,866,163100,12776
364,304,60,1361,193600,12777
255,169,86,-,116800,12778
703,262,441,786,199100,12779
927,881,46,1304,158800,12780
104,104,0,-,-,12781
548,432,116,858,175000,12783
31,31,0,-,-,12784
321,239,82,1193,181500,12785
268,156,112,850,169400,12786
88,75,13,-,138800,12787
821,647,174,846,167200,12788
883,402,481,797,131000,12789
1721,1267,454,1006,163400,12790
308,197,111,819,315800,12791
85,68,17,-,151300,12792
6349,3205,3144,821,150800,12801
3473,2275,1198,907,175400,12803
10686,7809,2877,1016,216500,12804
203,203,0,-,282300,12808
1368,1152,216,911,153700,12809
287,262,25,672,125800,12810
32,29,3,-,-,12811
39,37,2,-,124000,12812
593,428,165,908,311700,12814
447,401,46,812,234700,12815
1973,1474,499,776,165900,12816
973,854,119,713,211500,12817
131,108,23,-,113600,12819
197,140,57,1146,125900,12821
2401,1804,597,841,143400,12822
144,132,12,-,-,12823
492,406,86,1107,291100,12824
1394,1096,298,864,152800,12827
3520,2536,984,863,137900,12828
6463,5002,1461,1103,230600,12831
2735,1855,880,682,118700,12832
1666,1440,226,882,228900,12833
2497,1975,522,741,183400,12834
1026,876,150,843,177300,12835
273,238,35,881,242400,12836
343,290,53,921,122300,12837
233,198,35,767,150000,12838
5242,2944,2298,860,133800,12839
67,55,12,-,308300,12841
263,202,61,542,119400,12842
179,150,29,525,130400,12843
106,94,12,-,-,12844
2005,1557,448,908,260300,12845
1217,1001,216,789,166200,12846
109,104,5,688,268400,12847
98,98,0,-,186600,12849
1210,1015,195,1296,229700,12850
101,95,6,-,131300,12851
222,208,14,675,171100,12852
546,426,120,738,151500,12853
100,86,14,590,129200,12855
49,49,0,-,164800,12856
211,169,42,850,153600,12857
33,33,0,-,-,12858
893,751,142,1157,189000,12859
187,155,32,-,104700,12860
334,297,37,904,169400,12861
5,5,0,-,-,12862
223,182,41,882,254200,12863
18,18,0,-,-,12864
1567,1324,243,831,129800,12865
16302,9956,6346,1132,310100,12866
424,309,115,681,197400,12870
1602,1202,400,827,171200,12871
18,15,3,-,162500,12872
323,309,14,-,166700,12873
94,94,0,-,560000,12874
294,265,29,747,147500,12878
2050,1504,546,751,117200,12883
127,97,30,975,104800,12884
1905,1419,486,751,144000,12885
94,67,27,542,109600,12886
1989,1352,637,798,100300,12887
13114,7155,5959,746,139900,12901
573,364,209,1228,134900,12903
640,541,99,718,88700,12910
6,6,0,-,-,12911
874,624,250,677,125000,12912
522,423,99,616,159000,12913
413,326,87,762,70900,12914
851,662,189,634,94000,12916
536,445,91,678,103000,12917
913,841,72,849,132400,12918
1275,990,285,688,102700,12919
1056,758,298,711,88400,12920
983,807,176,866,130700,12921
23,22,1,-,-,12922
244,187,57,388,76100,12923
50,28,22,-,-,12924
862,681,181,573,89500,12926
112,100,12,-,117900,12927
751,635,116,798,117400,12928
316,212,104,702,108200,12929
299,251,48,765,83600,12930
539,413,126,627,160800,12932
6,6,0,-,-,12933
375,284,91,754,90800,12934
557,417,140,683,117600,12935
221,175,46,667,187500,12936
681,560,121,788,77500,12937
114,86,28,-,141700,12939
560,496,64,1125,163700,12941
391,315,76,-,241000,12942
118,51,67,1184,273200,12943
1721,1262,459,741,100300,12944
232,232,0,-,189700,12945
2244,1212,1032,809,236900,12946
287,227,60,733,103700,12950
233,142,91,788,49700,12952
4679,3176,1503,684,96100,12953
171,165,6,-,92900,12955
329,252,77,-,76100,12956
791,569,222,702,83300,12957
952,719,233,484,104700,12958
609,609,0,-,95700,12959
444,313,131,1114,139800,12960
158,109,49,-,89200,12961
2327,1892,435,913,150300,12962
79,32,47,766,167900,12964
197,169,28,614,86800,12965
1242,963,279,692,72700,12966
409,351,58,492,62400,12967
202,194,8,-,85200,12969
131,84,47,-,168800,12970
2170,1696,474,750,148200,12972
69,64,5,-,85800,12973
614,471,143,696,102300,12974
144,109,35,564,148000,12975
93,83,10,-,203100,12976
39,39,0,-,-,12977
142,78,64,-,128800,12978
1028,616,412,583,140500,12979
580,496,84,644,64100,12980
1023,874,149,714,111800,12981
3407,1914,1493,704,174100,12983
549,488,61,1103,89300,12985
2581,1810,771,621,122600,12986
147,127,20,-,147100,12987
430,382,48,706,162500,12989
2095,1633,462,767,120200,12992
655,561,94,773,139800,12993
943,781,162,808,120800,12996
532,419,113,850,213000,12997
200,137,63,-,73200,12998
27,24,3,-,-,13020
16634,10152,6482,688,122100,13021
0,0,0,-,-,13024
593,447,146,698,159500,13026
13314,9734,3580,821,154300,13027
588,393,195,939,190100,13028
2810,2107,703,985,148000,13029
1516,1198,318,747,157900,13030
6259,5012,1247,886,152100,13031
5034,3596,1438,764,110900,13032
1362,1184,178,709,126800,13033
794,667,127,706,123500,13034
3118,2514,604,850,226400,13035
3405,2594,811,789,118800,13036
3304,2668,636,691,131100,13037
6595,5575,1020,793,169600,13039
1029,809,220,779,90800,13040
4074,3677,397,1149,145600,13041
900,686,214,991,90400,13042
888,819,69,796,120400,13044
10660,6258,4402,701,114700,13045
62,0,62,738,-,13051
606,474,132,608,98000,13052
1822,1361,461,779,167000,13053
641,464,177,-,130000,13054
6261,4676,1585,796,116500,13057
1108,957,151,735,131900,13060
467,394,73,827,167200,13061
54,54,0,-,156800,13062
642,516,126,881,144200,13063
26,24,2,-,353300,13064
5136,3949,1187,961,213000,13066
2271,1595,676,854,144500,13068
9323,6306,3017,702,84500,13069
355,267,88,665,99900,13071
254,215,39,-,83800,13072
2536,1854,682,764,132400,13073
1688,1371,317,809,84000,13074
908,891,17,-,98000,13076
2520,1776,744,696,117600,13077
3643,2907,736,995,193100,13078
1387,1128,259,610,107700,13080
421,342,79,726,160300,13081
1790,1445,345,741,139700,13082
642,513,129,615,106900,13083
1662,1237,425,845,147500,13084
78,78,0,-,305300,13087
10294,6213,4081,853,124100,13088
12008,8720,3288,900,146700,13090
1021,876,145,701,118100,13092
870,673,197,632,108100,13101
18,8,10,-,-,13102
153,126,27,-,-,13103
5882,4689,1193,854,234600,13104
2456,2081,375,751,175600,13108
936,842,94,705,158300,13110
601,569,32,642,95900,13111
710,693,17,-,135000,13112
93,71,22,768,98300,13113
2418,1905,513,649,98900,13114
73,73,0,-,103700,13115
1441,1123,318,788,132000,13116
94,64,30,905,95600,13117
2129,1686,443,638,115400,13118
747,662,85,499,87000,13120
434,326,108,530,193400,13122
122,122,0,-,80500,13123
28,23,5,-,67500,13124
13366,8698,4668,725,101000,13126
1333,1121,212,774,109500,13131
1461,1162,299,834,105700,13132
63,41,22,663,86900,13134
2554,1774,780,674,112000,13135
186,152,34,396,66200,13136
0,0,0,-,-,13138
1722,1440,282,763,84300,13140
216,153,63,876,103700,13141
2458,1724,734,653,98900,13142
1078,862,216,645,86400,13143
599,465,134,735,68300,13144
810,641,169,700,91000,13145
818,696,122,770,80100,13146
495,382,113,844,107600,13147
4586,3087,1499,764,99900,13148
3459,2857,602,795,270700,13152
147,116,31,675,140000,13153
276,208,68,586,73800,13155
901,745,156,702,93400,13156
303,210,93,925,122200,13157
593,407,186,664,95700,13158
1955,1617,338,831,164000,13159
763,565,198,833,125600,13160
205,151,54,-,124800,13162
150,123,27,768,128100,13163
813,740,73,818,156000,13164
4372,3087,1285,694,90500,13165
2191,1738,453,771,118900,13166
1179,990,189,815,111200,13167
2314,117,2197,671,83900,13202
6932,2021,4911,719,108400,13203
8149,2606,5543,741,69900,13204
7345,2752,4593,729,77700,13205
7713,4064,3649,736,90600,13206
5195,3174,2021,850,86200,13207
8512,3688,4824,714,85500,13208
5693,3929,1764,754,114400,13209
7937,2476,5461,786,124400,13210
2618,1659,959,872,83800,13211
8579,6292,2287,838,116100,13212
3059,2246,813,784,160500,13214
5599,4543,1056,892,198100,13215
6338,5286,1052,826,128000,13219
3494,2198,1296,737,155700,13224
0,0,0,-,-,13290
40,40,0,-,221400,13301
649,550,99,740,76100,13302
459,404,55,918,161800,13303
690,575,115,749,172900,13304
151,124,27,-,139300,13305
1233,1000,233,812,108100,13308
2233,1669,564,575,96600,13309
208,190,18,-,103300,13310
179,158,21,906,240300,13312
180,119,61,718,71900,13313
175,166,9,-,79400,13314
540,498,42,950,120100,13315
2591,1902,689,634,111300,13316
1437,963,474,723,105700,13317
436,398,38,850,131400,13318
307,101,206,725,76700,13319
893,739,154,913,161000,13320
527,269,258,692,52500,13321
368,261,107,667,124700,13322
4022,2918,1104,965,155800,13323
889,779,110,638,93000,13324
396,350,46,1050,100800,13325
2357,1658,699,778,263000,13326
742,578,164,568,127100,13327
551,447,104,674,135900,13328
1639,1187,452,612,82000,13329
95,95,0,-,295000,13331
975,733,242,815,100900,13332
20,20,0,-,125000,13333
406,388,18,-,175000,13334
581,490,91,613,121400,13335
307,211,96,727,299400,13337
507,434,73,818,115600,13338
2450,1902,548,663,86400,13339
3223,2444,779,645,108500,13340
65,65,0,-,134200,13341
94,91,3,-,152900,13342
725,614,111,688,112700,13343
83,55,28,1075,101300,13345
1704,1224,480,841,181500,13346
591,479,112,590,163700,13348
4195,2085,2110,711,93000,13350
64,64,0,-,-,13352
16,11,5,-,162500,13353
1289,1167,122,651,123400,13354
326,222,104,788,100900,13355
4484,2958,1526,602,81900,13357
85,79,6,700,280600,13360
325,302,23,618,98100,13361
74,59,15,-,-,13362
847,713,134,1272,112000,13363
52,52,0,-,60600,13364
3353,2281,1072,607,90400,13365
3189,2271,918,665,138700,13367
496,380,116,654,105300,13368
670,555,115,-,111300,13402
1708,1451,257,792,173300,13403
79,72,7,-,93300,13404
297,258,39,783,104300,13406
2078,1503,575,566,92400,13407
930,811,119,706,124700,13408
869,710,159,729,91400,13409
83,68,15,489,80000,13410
1362,1117,245,541,84900,13411
6737,5150,1587,854,158300,13413
32,18,14,-,-,13415
895,720,175,574,108600,13416
1580,712,868,755,124200,13417
110,88,22,-,80600,13418
575,467,108,624,302900,13420
5320,3343,1977,678,109800,13421
891,629,262,738,126400,13424
880,708,172,630,90800,13425
636,404,232,445,101900,13428
695,606,89,839,139000,13431
737,540,197,695,86800,13433
105,93,12,513,92800,13435
29,23,6,-,212500,13436
178,156,22,492,106700,13437
1498,1261,237,765,121800,13438
1594,1171,423,738,120500,13439
16878,10422,6456,726,105100,13440
16,0,16,-,-,13441
37,31,6,-,156300,13450
1771,1297,474,618,83600,13452
281,216,65,677,98000,13454
1597,1360,237,744,145500,13456
877,610,267,750,147600,13459
1778,1141,637,599,111500,13460
1320,985,335,625,136300,13461
528,409,119,644,84300,13464
143,102,41,733,177800,13468
389,344,45,-,133500,13469
323,309,14,625,78400,13470
1267,1029,238,838,101100,13471
60,60,0,-,172200,13472
243,227,16,1036,106600,13473
21,11,10,-,137500,13475
1286,941,345,691,133300,13476
623,491,132,599,147200,13477
1078,864,214,624,112100,13478
1365,959,406,631,110000,13480
85,51,34,730,108000,13483
80,80,0,-,105800,13484
451,381,70,749,79600,13485
318,235,83,763,98000,13486
53,41,12,-,88300,13488
230,193,37,642,99100,13489
657,518,139,842,177100,13490
1346,1054,292,663,109100,13491
5011,3966,1045,671,138100,13492
677,577,100,674,85500,13493
110,98,12,-,152100,13494
922,643,279,697,98800,13495
14162,6632,7530,645,98000,13501
12812,7779,5033,691,95000,13502
15288,7644,7644,820,142200,13601
122,0,122,1428,-,13602
3230,32,3198,1378,156800,13603
1775,1284,491,732,143000,13605
1067,740,327,789,137200,13606
771,520,251,734,144300,13607
546,421,125,798,104500,13608
953,632,321,974,155700,13612
913,676,237,776,88300,13613
105,83,22,-,57200,13614
451,301,150,594,159900,13615
808,361,447,1215,98100,13616
3575,2434,1141,798,117900,13617
813,674,139,496,141400,13618
4128,2458,1670,908,133600,13619
747,554,193,646,128000,13620
200,166,34,1104,73600,13621
944,740,204,1172,123600,13622
10,6,4,-,-,13623
2027,1458,569,902,168000,13624
822,697,125,711,126000,13625
904,623,281,950,140300,13626
99,74,25,942,93000,13628
518,439,79,625,110200,13630
111,83,28,725,79500,13633
1593,1307,286,639,156700,13634
432,285,147,677,76000,13635
111,72,39,850,129700,13636
1863,439,1424,1183,154700,13637
123,92,31,1306,78600,13638
79,68,11,-,64000,13639
212,206,6,-,293800,13640
37,37,0,-,188300,13641
3557,2414,1143,682,90300,13642
0,0,0,-,-,13643
992,799,193,643,82400,13646
42,27,15,-,140300,13647
885,718,167,648,85100,13648
677,559,118,827,172600,13650
83,64,19,-,390000,13651
707,544,163,634,73900,13652
878,746,132,580,87900,13654
1407,1079,328,487,124700,13655
921,797,124,831,136100,13656
862,709,153,605,92700,13658
198,177,21,743,100600,13659
662,477,185,658,93900,13660
544,473,71,738,110800,13661
7186,4858,2328,696,80100,13662
144,116,28,960,97100,13664
308,270,38,-,137500,13665
91,70,21,1712,-,13666
1208,821,387,761,87200,13667
1529,1133,396,708,82200,13668
6082,4281,1801,607,78300,13669
201,173,28,647,66300,13670
335,223,112,815,79700,13672
871,540,331,669,143600,13673
28,5,23,-,-,13674
34,34,0,-,129800,13675
5225,3159,2066,760,113400,13676
22,12,10,-,-,13677
103,52,51,626,-,13678
758,642,116,1107,116300,13679
503,416,87,819,95000,13680
271,242,29,664,90700,13681
324,289,35,1632,181300,13682
458,414,44,608,80800,13684
1006,457,549,1047,224200,13685
201,149,52,-,119000,13687
330,233,97,509,65800,13690
1130,858,272,928,125700,13691
21,21,0,-,-,13692
198,145,53,-,166200,13693
639,481,158,777,121100,13694
43,43,0,-,231700,13695
14,14,0,-,-,13696
821,741,80,587,75000,13697
1205,1016,189,551,114000,13730
436,367,69,931,225000,13731
2941,2551,390,636,137300,13732
1977,1572,405,729,97700,13733
818,615,203,594,108700,13734
784,653,131,905,94600,13736
349,312,37,675,146000,13739
205,159,46,935,219000,13740
1436,1294,142,543,99300,13743
502,454,48,770,117000,13744
816,743,73,819,107200,13746
1351,1154,197,711,119200,13748
364,234,130,-,117600,13750
64,45,19,-,-,13751
335,284,51,871,172600,13752
1621,1126,495,762,169900,13753
1423,1009,414,668,116000,13754
551,442,109,604,109600,13755
194,148,46,714,-,13756
463,394,69,852,134400,13757
19016,12328,6688,723,123500,13760
70,65,5,-,-,13774
634,528,106,692,139100,13775
192,137,55,550,127700,13776
182,115,67,752,133500,13777
2331,1783,548,611,123400,13778
429,375,54,-,106400,13780
282,235,47,870,159100,13782
1015,782,233,561,112500,13783
41,27,14,1125,65900,13784
197,163,34,967,145100,13786
1428,1033,395,666,85600,13787
399,279,120,709,139800,13788
7784,4438,3346,746,88000,13790
14,14,0,-,-,13794
1433,965,468,792,95100,13795
592,508,84,688,137200,13796
829,715,114,740,89600,13797
584,509,75,657,81300,13801
181,176,5,-,83300,13802
1487,1208,279,693,98900,13803
193,148,45,664,111300,13804
116,101,15,-,163900,13806
522,422,100,713,160500,13807
622,488,134,655,136800,13808
773,576,197,793,70700,13809
467,390,77,655,130500,13810
1755,1421,334,635,98100,13811
923,775,148,624,94500,13812
249,232,17,-,113800,13813
5220,3512,1708,647,86300,13815
7421,4552,2869,842,144800,13820
1455,1208,247,709,126600,13825
13,13,0,-,-,13826
4819,3525,1294,654,112900,13827
2052,1699,353,663,93400,13830
232,210,22,625,80800,13832
1727,1489,238,685,96500,13833
44,10,34,-,-,13834
509,398,111,643,94000,13835
1942,1174,768,641,84400,13838
484,449,35,668,106900,13839
238,184,54,767,104100,13841
172,154,18,-,158800,13842
787,686,101,731,100000,13843
316,257,59,750,79400,13844
59,16,43,-,-,13845
112,106,6,-,148500,13846
18,14,4,-,-,13847
1656,1386,270,696,97100,13849
8836,6836,2000,908,148100,13850
2706,1766,940,659,116000,13856
127,90,37,1007,99700,13859
29,19,10,-,-,13860
130,115,15,-,147800,13861
1630,1330,300,688,101600,13862
243,200,43,683,75200,13863
481,346,135,757,97500,13864
2376,2085,291,588,111100,13865
8061,4693,3368,609,113600,13901
7,7,0,-,-,13902
7577,5095,2482,657,105600,13903
3782,2547,1235,706,91700,13904
11291,5592,5699,712,106700,13905
3879,3017,862,764,135400,14001
4175,3443,732,737,162000,14004
688,573,115,740,113600,14005
4180,3441,739,758,105100,14006
558,443,115,675,104800,14008
2293,1784,509,615,107100,14009
2522,1887,635,613,119200,14011
855,698,157,658,113600,14012
754,665,89,863,90300,14013
9538,6091,3447,722,98300,14020
669,604,65,708,95100,14024
1209,921,288,758,180000,14025
299,251,48,1083,164400,14026
637,575,62,874,104100,14028
645,539,106,834,129500,14030
3918,3014,904,703,218800,14031
2853,2551,302,993,275900,14032
846,728,118,625,221300,14033
807,708,99,597,109500,14034
33,17,16,-,-,14035
2009,1699,310,778,132000,14036
390,327,63,523,160700,14037
44,32,12,533,84200,14039
825,696,129,841,152200,14040
75,49,26,-,83100,14041
1589,1167,422,618,89300,14042
10783,7526,3257,761,120200,14043
2507,2114,393,759,121300,14047
6041,3791,2250,639,68900,14048
7568,6595,973,1475,253200,14051
6625,5580,1045,730,203200,14052
565,445,120,715,111900,14054
601,541,60,558,169000,14055
3205,2791,414,575,165600,14057
776,647,129,679,112200,14058
4052,3585,467,738,223800,14059
164,155,9,910,75800,14060
125,85,40,825,89300,14061
1232,1046,186,608,89400,14062
5015,3467,1548,694,127400,14063
683,612,71,625,108100,14065
470,419,51,694,80100,14066
2094,1624,470,639,117400,14067
2798,2067,731,1008,222200,14068
370,304,66,408,186200,14069
2050,1452,598,619,84900,14070
7877,6444,1433,919,189600,14072
17737,13398,4339,797,159100,14075
1781,1518,263,540,161300,14080
1274,954,320,698,113500,14081
195,158,37,689,159700,14082
2537,2471,66,777,173900,14085
12593,10517,2076,719,185600,14086
355,304,51,583,99400,14091
4785,3805,980,819,162200,14092
20281,14682,5599,632,113200,14094
1119,940,179,810,95100,14098
707,596,111,733,105600,14101
447,420,27,-,204100,14102
4392,3057,1335,653,84000,14103
1679,1318,361,663,99100,14105
2156,1860,296,640,108800,14108
0,0,0,-,-,14109
1368,1113,255,648,119500,14111
0,0,0,-,-,14112
262,205,57,593,140500,14113
18691,13722,4969,666,128000,14120
1457,1145,312,587,96200,14125
262,195,67,587,97800,14126
11932,9317,2615,920,220500,14127
584,445,139,708,105100,14129
63,55,8,-,55000,14130
2120,1876,244,1004,152600,14131
2394,2045,349,545,147900,14132
38,34,4,-,85000,14134
67,31,36,557,-,14135
2018,1571,447,711,92700,14136
786,639,147,646,79900,14138
973,824,149,715,189300,14139
3134,2259,875,583,126300,14141
505,417,88,643,111800,14143
705,570,135,791,140300,14145
18684,13369,5315,788,113600,14150
740,608,132,675,138100,14167
24,3,21,-,-,14168
106,80,26,-,91700,14169
1059,882,177,644,172700,14170
845,696,149,823,104600,14171
1273,1050,223,660,129500,14172
211,105,106,656,93100,14173
2245,1893,352,737,146800,14174
5700,1391,4309,649,157100,14201
1620,441,1179,533,363500,14202
1022,0,1022,741,-,14203
4091,1409,2682,481,71000,14204
8739,5423,3316,618,67100,14206
9420,3158,6262,648,56300,14207
4384,1808,2576,761,45800,14208
3902,1088,2814,730,184000,14209
5979,2806,3173,699,65700,14210
8969,3642,5327,699,40500,14211
4651,2207,2444,615,60500,14212
8827,3000,5827,723,81000,14213
7854,3489,4365,805,159700,14214
16284,7664,8620,725,55600,14215
10472,5153,5319,793,136000,14216
10575,6785,3790,691,115200,14217
8022,4198,3824,619,86800,14218
5143,3298,1845,737,114200,14219
9864,6572,3292,706,86300,14220
23088,17265,5823,1140,200500,14221
6528,2220,4308,831,241900,14222
9966,8054,1912,778,121100,14223
17587,13635,3952,760,140700,14224
15072,10847,4225,724,93900,14225
12409,9109,3300,860,142000,14226
10698,7105,3593,847,119100,14227
8925,4694,4231,898,164600,14228
4,0,4,-,-,14261
5540,2120,3420,593,55000,14301
0,0,0,-,-,14302
2591,1083,1508,680,51900,14303
12755,9421,3334,685,87400,14304
6636,3836,2800,661,73400,14305
4992,3474,1518,644,89200,14411
2943,2155,788,796,143700,14414
70,57,13,-,89500,14415
1459,1124,335,744,115500,14416
519,471,48,973,138600,14418
7105,4517,2588,789,136200,14420
913,791,122,739,104900,14422
1870,1479,391,739,128400,14423
11650,7937,3713,843,178500,14424
4690,3296,1394,1064,147900,14425
864,706,158,679,84900,14427
3198,2668,530,1019,157900,14428
2328,1835,493,704,108000,14432
1496,1193,303,815,83000,14433
1227,1107,120,873,143700,14435
4065,2972,1093,659,89400,14437
164,112,52,913,90000,14441
3530,1974,1556,851,101300,14445
16840,12986,3854,944,189100,14450
3245,1718,1527,792,162000,14454
7762,4582,3180,733,105600,14456
202,178,24,700,133100,14462
2822,2377,445,712,104200,14464
789,723,66,526,124900,14466
4052,2740,1312,947,142400,14467
6893,5734,1159,957,139800,14468
2537,2103,434,704,144700,14469
3250,2625,625,669,94500,14470
1031,916,115,933,137900,14471
3326,2578,748,844,225500,14472
111,97,14,-,271900,14475
840,630,210,777,122500,14476
656,630,26,-,121500,14477
311,280,31,-,200000,14478
109,68,41,626,87000,14479
236,147,89,811,169900,14480
799,578,221,766,99200,14481
3419,2387,1032,713,108600,14482
1722,1292,430,684,143100,14485
155,144,11,-,107300,14486
2321,1860,461,826,157500,14487
2882,2010,872,653,78200,14489
4074,3368,706,759,157700,14502
822,597,225,846,89700,14504
2036,1790,246,783,114100,14505
518,518,0,-,239500,14506
515,435,80,750,123000,14507
1812,1185,627,662,79000,14510
162,101,61,-,141900,14511
1933,1665,268,625,136700,14512
5736,3644,2092,696,96500,14513
2572,1763,809,879,157500,14514
946,827,119,804,98100,14516
1320,944,376,531,90200,14517
4936,4070,866,783,153000,14519
1040,763,277,663,96900,14521
3987,2788,1199,723,114100,14522
987,831,156,669,111900,14525
8087,6840,1247,859,175800,14526
5015,3656,1359,698,136200,14527
68,44,24,-,127100,14529
2257,1638,619,641,85100,14530
1768,1188,580,729,119900,14532
756,573,183,690,119100,14533
12172,10926,1246,1192,251100,14534
257,204,53,630,73100,14536
85,56,29,693,84400,14537
62,62,0,-,83100,14539
919,688,231,923,128200,14541
22,17,5,-,74200,14542
1282,1151,131,920,170200,14543
838,672,166,586,157900,14544
72,63,9,-,98600,14545
1999,1419,580,1015,133300,14546
1491,1257,234,750,108100,14548
29,15,14,511,137500,14549
696,538,158,621,78200,14550
2062,1589,473,687,81600,14551
493,425,68,791,129200,14555
6927,5463,1464,892,159800,14559
835,755,80,800,120400,14560
1062,929,133,726,129900,14561
5795,4654,1141,1289,247700,14564
2086,1942,144,696,141200,14568
2607,1614,993,578,106800,14569
506,486,20,-,97500,14571
2124,1644,480,701,93100,14572
20573,15634,4939,960,183500,14580
53,53,0,-,32500,14585
4137,2823,1314,1104,176700,14586
42,42,0,-,88300,14588
2957,2263,694,664,132400,14589
2089,1572,517,547,89900,14590
656,560,96,620,116300,14591
60,60,0,-,132500,14592
1284,0,1284,581,-,14604
4626,861,3765,672,54400,14605
11235,6336,4899,807,108500,14606
9399,1602,7797,781,164400,14607
5095,895,4200,734,86800,14608
17779,10925,6854,825,91600,14609
6787,3855,2932,874,150000,14610
6622,2182,4440,776,56600,14611
14766,10706,4060,824,137800,14612
4782,1716,3066,794,68500,14613
38,0,38,-,-,14614
7152,3633,3519,817,91900,14615
12303,8750,3553,843,99200,14616
9540,8214,1326,860,127200,14617
8234,6320,1914,981,193600,14618
5496,2794,2702,929,73800,14619
11178,3645,7533,841,135200,14620
12787,4119,8668,747,56300,14621
5437,4277,1160,865,110600,14622
8582,4775,3807,941,119400,14623
13848,11220,2628,903,127400,14624
4456,3894,562,985,171700,14625
12901,9006,3895,941,137500,14626
0,0,0,-,-,14627
16642,9867,6775,598,73300,14701
2560,2034,526,649,94400,14706
89,80,9,-,52200,14707
70,67,3,-,52500,14708
606,502,104,565,85000,14709
1283,1155,128,932,97000,14710
760,520,240,574,71900,14711
1447,1282,165,625,139900,14712
214,179,35,975,77800,14714
1113,839,274,582,60100,14715
896,555,341,566,70600,14716
251,200,51,548,83300,14717
883,724,159,703,98200,14718
1427,1133,294,557,82100,14719
399,160,239,600,43900,14720
65,44,21,475,46800,14721
145,129,16,-,617100,14722
421,360,61,711,80400,14723
879,735,144,765,109200,14724
609,452,157,632,72600,14726
2143,1787,356,704,76400,14727
418,379,39,-,96500,14728
383,318,65,669,100000,14729
603,483,120,625,208500,14731
47,47,0,-,71300,14732
1621,1086,535,596,74300,14733
1155,826,329,564,75400,14735
111,74,37,689,137500,14736
1728,1365,363,619,71200,14737
1557,1412,145,-,87800,14738
1188,875,313,602,52300,14739
526,432,94,725,86400,14740
886,768,118,743,121000,14741
104,84,20,-,98800,14742
717,583,134,666,74000,14743
440,299,141,768,108900,14744
916,770,146,496,79100,14747
294,203,91,538,66600,14748
1963,1439,524,663,115000,14750
116,116,0,-,82400,14752
463,374,89,575,61600,14753
265,214,51,580,56700,14754
1216,961,255,542,92200,14755
70,70,0,-,95700,14756
1382,1078,304,650,101800,14757
7904,4690,3214,608,80100,14760
673,549,124,603,86100,14767
411,372,39,535,87200,14769
1146,864,282,624,87100,14770
1409,1034,375,557,77500,14772
52,39,13,713,70800,14774
985,794,191,567,73300,14775
255,204,51,705,72500,14777
0,0,0,-,-,14778
2674,1516,1158,608,69200,14779
764,629,135,630,88500,14781
909,654,255,635,80400,14782
149,118,31,450,60700,14783
280,217,63,702,75000,14784
2076,1526,550,618,89200,14787
121,36,85,428,-,14788
2171,1619,552,616,85300,14801
364,94,270,788,115600,14802
409,282,127,801,115900,14803
579,482,97,598,80600,14804
390,326,64,857,115800,14805
868,692,176,657,65200,14806
1244,965,279,697,96700,14807
193,164,29,619,70700,14808
1024,761,263,698,82300,14809
5123,3181,1942,616,85300,14810
1195,1049,146,715,86900,14812
1030,756,274,574,67900,14813
683,586,97,-,149600,14814
401,348,53,741,120000,14815
172,165,7,-,-,14816
924,699,225,865,156200,14817
755,621,134,843,118800,14818
271,211,60,883,78100,14819
327,271,56,605,82200,14820
1314,1168,146,755,92300,14821
495,385,110,767,73200,14822
1456,1117,339,598,80900,14823
202,161,41,790,77700,14824
339,259,80,756,97900,14825
807,684,123,619,88600,14826
41,41,0,-,-,14827
8496,5412,3084,739,115900,14830
346,342,4,-,106000,14836
2121,1570,551,623,112400,14837
837,793,44,808,95000,14838
298,252,46,536,86400,14839
1372,1101,271,637,165000,14840
321,299,22,-,192500,14841
415,400,15,-,120500,14842
5397,3370,2027,614,76300,14843
8606,6460,2146,864,137300,14845
345,304,41,663,81700,14846
1055,840,215,645,101500,14847
24224,10778,13446,1064,221300,14850
0,0,0,-,-,14853
19,19,0,-,-,14854
317,274,43,460,97400,14855
96,38,58,-,-,14856
626,502,124,744,98800,14858
278,252,26,571,101000,14859
538,442,96,627,101400,14860
571,512,59,754,94400,14861
475,430,45,812,121400,14864
1193,778,415,604,90300,14865
2287,1700,587,854,134400,14867
521,402,119,565,111600,14869
4198,2777,1421,880,115100,14870
2059,1799,260,783,135000,14871
340,253,87,638,95000,14872
1029,898,131,553,93200,14873
124,113,11,856,112500,14874
170,127,43,622,97900,14877
243,209,34,730,116300,14878
852,696,156,680,87800,14879
598,491,107,664,63600,14880
125,50,75,-,-,14881
1589,1177,412,1253,184100,14882
1560,1089,471,713,120300,14883
123,110,13,-,76700,14884
254,229,25,-,89400,14885
2968,2368,600,852,180600,14886
636,534,102,819,101600,14889
1741,1254,487,677,120300,14891
3348,2310,1038,686,95200,14892
3,3,0,-,-,14893
519,456,63,710,84800,14894
4158,2706,1452,598,71900,14895
360,312,48,490,66000,14897
616,490,126,706,83500,14898
5538,2472,3066,659,72300,14901
3015,1973,1042,674,106500,14903
6533,3844,2689,714,70700,14904
3930,2732,1198,769,113600,14905
13132,10003,3129,655,121000,15001
5047,3184,1863,657,85800,15003
107,58,49,-,88400,15004
4047,3380,667,637,154400,15005
110,81,29,-,64300,15006
121,110,11,-,125000,15007
6379,4617,1762,566,167500,15009
11226,7570,3656,662,121300,15010
6552,5059,1493,699,119800,15012
1411,881,530,688,73000,15014
497,473,24,235,288300,15015
7392,5195,2197,810,154600,15017
318,308,10,-,81600,15018
719,568,151,676,98500,15019
132,69,63,-,72700,15020
3138,2513,625,753,124500,15021
4380,3053,1327,598,87800,15022
3661,2988,673,779,126500,15024
6733,4688,2045,810,120000,15025
1310,1168,142,754,161800,15026
939,770,169,542,130000,15027
69,57,12,575,56400,15028
511,282,229,775,56800,15030
264,158,106,1272,91000,15031
2020,1399,621,523,60600,15033
881,580,301,478,59800,15034
978,532,446,716,71700,15035
4580,3915,665,759,107900,15037
144,57,87,626,87000,15038
3631,2864,767,876,153800,15042
785,688,97,1257,156000,15043
10462,9621,841,1210,240800,15044
1925,1215,710,604,55300,15045
994,880,114,823,129000,15046
36,36,0,-,86000,15047
461,331,130,719,97800,15049
951,901,50,767,158900,15050
195,157,38,775,74100,15051
1399,1278,121,763,114100,15052
69,52,17,-,98200,15053
160,93,67,679,72600,15054
610,421,189,725,168200,15055
548,337,211,787,75500,15056
5763,4971,792,828,194000,15057
1592,916,676,517,83200,15059
285,189,96,690,113600,15060
5194,3831,1363,667,124000,15061
3624,2560,1064,604,73800,15062
4619,3563,1056,657,117300,15063
121,73,48,937,126800,15064
4888,3516,1372,656,97900,15065
5325,3392,1933,614,95200,15066
1013,664,349,704,85400,15067
16482,11244,5238,648,121700,15068
4516,3347,1169,953,149500,15071
87,44,43,-,68500,15072
3810,2469,1341,701,88100,15074
83,45,38,-,179200,15075
397,280,117,744,83500,15076
56,41,15,585,81700,15077
140,93,47,647,-,15078
189,146,43,722,85600,15081
66,66,0,-,117200,15082
380,321,59,625,103200,15083
4404,2828,1576,653,80200,15084
3312,2643,669,759,152000,15085
132,52,80,-,-,15086
86,86,0,-,116700,15087
198,130,68,694,55000,15088
2729,2167,562,525,115900,15089
8854,7053,1801,1237,306300,15090
9810,7868,1942,979,207100,15101
12326,9770,2556,880,167800,15102
3875,1727,2148,512,34000,15104
8966,5603,3363,783,111500,15106
17120,11813,5307,885,172000,15108
2263,927,1336,575,36000,15110
1494,704,790,607,65600,15112
6110,5364,746,817,167900,15116
8205,5073,3132,673,82400,15120
8689,6470,2219,654,92100,15122
3016,2333,683,790,153500,15126
4419,3330,1089,878,151600,15129
3815,2843,972,765,100000,15131
9796,5116,4680,602,47300,15132
2910,2345,565,715,70800,15133
2189,1585,604,729,120500,15135
9365,5958,3407,667,118400,15136
4516,3068,1448,643,77900,15137
3115,1925,1190,827,175000,15139
1500,641,859,561,59300,15140
544,446,98,-,655900,15142
7976,6365,1611,971,287100,15143
1943,1315,628,689,92300,15144
3290,1426,1864,531,71500,15145
12537,8130,4407,893,135000,15146
8104,5447,2657,759,87700,15147
1237,486,751,585,48700,15148
6121,3270,2851,913,120100,15201
9679,4904,4775,699,119600,15202
5024,2224,2800,1033,169300,15203
3569,2387,1182,831,67400,15204
10210,5713,4497,832,112200,15205
13489,5376,8113,824,146800,15206
5065,3250,1815,611,87800,15207
4520,2173,2347,695,150900,15208
5563,3997,1566,765,133400,15209
10982,6415,4567,739,56400,15210
5537,2571,2966,917,92300,15211
12776,6660,6116,725,91500,15212
9536,2469,7067,916,125000,15213
6071,3724,2347,754,95400,15214
5453,3595,1858,765,202800,15215
10405,6227,4178,790,112600,15216
11848,5919,5929,993,277900,15217
6769,3858,2911,742,113500,15218
5139,1399,3740,593,85000,15219
8027,4842,3185,912,151700,15220
15487,7806,7681,753,98000,15221
2066,381,1685,1637,311000,15222
3117,2036,1081,667,102500,15223
5367,1945,3422,810,104400,15224
595,282,313,743,85200,15225
6033,4317,1716,829,95200,15226
12113,8350,3763,692,108200,15227
7358,5393,1965,834,238700,15228
6178,4469,1709,831,137600,15229
6228,1532,4696,1053,326500,15232
1265,589,676,789,114400,15233
6244,4170,2074,758,120400,15234
14797,11577,3220,831,92000,15235
12467,9773,2694,820,141000,15236
18062,13911,4151,978,193300,15237
5391,4189,1202,899,300300,15238
8427,6812,1615,939,140300,15239
7563,6603,960,1212,265800,15241
5720,4977,743,1219,189500,15243
0,0,0,-,-,15260
0,0,0,-,-,15290
20278,13651,6627,690,153400,15301
141,110,31,238,152600,15310
601,453,148,677,187500,15311
1408,1195,213,666,149100,15312
154,140,14,675,96700,15313
1599,1135,464,392,118800,15314
298,263,35,744,51900,15315
43,31,12,-,48200,15316
14766,11953,2813,832,235500,15317
2238,1505,733,397,126100,15320
630,560,70,667,209400,15321
808,689,119,710,71600,15322
1730,1324,406,701,150500,15323
279,203,76,772,63900,15324
201,93,108,701,-,15325
601,510,91,773,69700,15327
516,375,141,780,161700,15329
2049,1890,159,645,201800,15330
285,183,102,789,70200,15331
3609,3048,561,650,138400,15332
966,748,218,481,90300,15333
56,46,10,763,85000,15334
222,151,71,575,113500,15337
677,555,122,582,90600,15338
533,431,102,850,199700,15340
335,261,74,473,138500,15341
2070,1558,512,838,163700,15342
635,540,95,631,103200,15344
596,446,150,660,75800,15345
260,233,27,669,57100,15346
232,217,15,-,158500,15347
157,118,39,715,82000,15348
797,601,196,759,131600,15349
184,110,74,757,56000,15350
376,184,192,665,29000,15351
361,281,80,552,115500,15352
28,20,8,-,-,15353
701,589,112,448,107200,15357
352,255,97,764,86600,15358
75,40,35,753,109100,15359
685,597,88,720,180400,15360
11,11,0,-,-,15361
312,244,68,606,116400,15362
311,173,138,774,139100,15363
291,244,47,740,116100,15364
101,77,24,-,73900,15366
2993,2740,253,1123,362300,15367
104,69,35,525,48500,15368
4770,3204,1566,662,120200,15370
614,483,131,710,162700,15376
266,221,45,475,151400,15377
35,11,24,-,-,15378
56,45,11,867,131300,15379
255,175,80,578,95600,15380
13481,8613,4868,613,104400,15401
434,385,49,-,53000,15410
308,236,72,638,130800,15411
180,147,33,654,89700,15412
204,171,33,-,60300,15413
3627,2563,1064,607,88800,15417
1615,795,820,468,112800,15419
74,35,39,-,37900,15420
11,11,0,-,-,15421
72,52,20,-,-,15422
895,743,152,651,113300,15423
900,664,236,546,89300,15424
7817,5533,2284,535,92800,15425
491,403,88,802,97300,15427
741,612,129,750,93100,15428
88,63,25,619,99400,15429
122,102,20,-,71100,15430
1662,1335,327,583,79100,15431
186,126,60,536,82100,15432
379,330,49,-,154300,15433
113,92,21,661,59300,15434
214,145,69,868,81700,15435
1061,773,288,503,95900,15436
908,698,210,837,163700,15437
717,621,96,734,94800,15438
102,94,8,-,127800,15440
717,636,81,723,81100,15442
85,85,0,-,37300,15443
222,131,91,-,71900,15444
1093,845,248,670,109900,15445
158,141,17,-,154000,15446
0,0,0,-,-,15447
102,70,32,-,109800,15448
145,124,21,-,36200,15449
62,47,15,-,72400,15450
384,320,64,733,93600,15451
38,25,13,-,-,15454
187,142,45,-,70400,15455
1171,864,307,592,93700,15456
1041,835,206,672,71400,15458
617,417,200,494,106300,15459
37,24,13,-,-,15460
1696,1138,558,640,69900,15461
148,148,0,-,31800,15462
0,0,0,-,-,15463
590,505,85,568,95300,15464
196,163,33,672,65400,15466
61,41,20,-,54100,15467
932,715,217,693,84100,15468
848,702,146,724,97900,15469
323,275,48,480,134400,15470
51,19,32,-,-,15472
1674,1315,359,565,126100,15473
735,546,189,710,73600,15474
430,319,111,536,75600,15475
51,51,0,-,11300,15476
351,269,82,600,80800,15477
2474,1909,565,586,94500,15478
827,631,196,596,126700,15479
744,583,161,600,80700,15480
180,150,30,661,50000,15482
195,156,39,542,89500,15483
65,62,3,-,65200,15484
905,766,139,518,110200,15486
130,90,40,-,71800,15489
341,272,69,-,89700,15490
68,62,6,-,62000,15492
6531,4636,1895,544,119600,15501
34,24,10,-,333300,15502
0,0,0,-,-,15510
119,119,0,-,58800,15520
660,566,94,625,115200,15521
4908,3678,1230,651,151600,15522
2041,1626,415,554,108500,15530
1626,1311,315,471,87900,15531
76,61,15,-,47400,15532
588,441,147,655,110700,15533
384,324,60,581,120400,15534
839,730,109,697,154700,15535
179,168,11,825,135900,15536
3301,2615,686,541,114500,15537
312,273,39,567,119100,15538
235,197,38,-,117800,15539
95,80,15,-,150000,15540
1386,1218,168,587,114000,15541
422,379,43,495,85000,15542
74,74,0,-,55300,15544
1131,900,231,597,103300,15545
128,103,25,-,-,15546
158,134,24,814,125900,15547
666,533,133,575,113300,15550
340,289,51,592,111400,15551
2212,1703,509,540,92500,15552
1015,852,163,761,108200,15554
50,44,6,-,43300,15555
1401,1115,286,590,108200,15557
871,624,247,586,107000,15558
818,704,114,650,142600,15559
67,60,7,750,79000,15560
79,60,19,636,122200,15561
55,43,12,663,135600,15562
1226,1020,206,710,97800,15563
37,29,8,440,95400,15564
24149,17674,6475,654,158300,15601
1521,1382,139,508,149600,15610
300,237,63,1250,13200,15611
165,165,0,-,-,15612
5910,4881,1029,618,126700,15613
104,98,6,-,140000,15615
23,23,0,-,-,15616
150,113,37,725,82300,15617
1068,842,226,597,80200,15618
391,260,131,799,79600,15620
42,0,42,-,-,15621
551,440,111,322,150000,15622
279,262,17,-,122800,15623
83,55,28,743,86300,15624
54,54,0,-,-,15625
2437,1914,523,686,154500,15626
2810,2204,606,679,99400,15627
241,186,55,580,85000,15628
372,250,122,561,55900,15629
438,313,125,680,84600,15631
3670,2895,775,677,199800,15632
124,108,16,-,104200,15633
199,178,21,-,62600,15634
89,76,13,-,155300,15635
1356,1231,125,814,227200,15636
758,570,188,978,98600,15637
170,84,86,1036,86300,15638
929,728,201,523,154400,15639
198,189,9,-,101600,15640
222,197,25,571,83000,15641
18227,15348,2879,745,164400,15642
8088,6059,2029,665,113600,15644
87,70,17,-,86400,15646
69,69,0,-,121700,15647
11213,8423,2790,647,139500,15650
142,110,32,658,114500,15655
4247,3333,914,596,124700,15656
3866,3131,735,696,170700,15658
154,137,17,-,122300,15660
254,137,117,634,81100,15661
43,43,0,-,-,15662
181,138,43,485,130900,15663
596,467,129,981,135500,15665
6756,5275,1481,635,115400,15666
5443,4960,483,957,223600,15668
1579,1364,215,669,154000,15670
302,302,0,-,141700,15671
1508,1042,466,662,175500,15672
523,427,96,561,92800,15673
370,287,83,962,80300,15675
221,118,103,596,135000,15676
181,166,15,-,135000,15677
183,136,47,521,96200,15678
1159,945,214,564,130900,15679
57,49,8,-,68100,15680
1895,1548,347,650,111700,15681
3528,2708,820,523,102400,15683
314,232,82,430,71100,15684
337,287,50,703,115500,15686
496,416,80,475,149300,15687
417,369,48,765,71900,15688
139,72,67,698,-,15689
3847,2707,1140,616,74600,15690
41,41,0,-,-,15691
470,446,24,-,130900,15692
55,15,40,-,-,15693
173,137,36,-,106100,15695
159,132,27,683,83600,15696
1397,906,491,618,103500,15697
311,280,31,-,69500,15698
13432,7581,5851,742,138800,15701
94,81,13,-,77000,15710
200,160,40,725,82200,15711
64,53,11,-,53500,15712
70,56,14,-,94700,15713
2099,1636,463,546,71300,15714
217,155,62,596,71900,15715
234,128,106,759,68800,15716
4243,3341,902,629,110100,15717
77,61,16,721,70600,15721
992,869,123,586,88900,15722
6,6,0,-,-,15723
913,776,137,654,75200,15724
625,542,83,529,111100,15725
73,46,27,869,65700,15727
1428,991,437,525,68800,15728
621,525,96,-,78000,15729
27,24,3,-,93300,15730
240,159,81,-,92900,15731
642,555,87,713,106500,15732
53,50,3,-,75600,15733
128,100,28,-,65800,15734
315,204,111,630,107600,15736
42,42,0,-,32500,15737
90,66,24,-,66900,15738
151,111,40,768,67100,15739
18,18,0,-,70000,15741
371,325,46,589,77800,15742
63,56,7,-,60800,15744
64,55,9,-,53000,15745
58,26,32,-,68800,15746
808,646,162,648,124000,15747
2795,2291,504,637,99600,15748
102,25,77,757,-,15750
11,0,11,-,-,15752
202,189,13,617,85900,15753
201,186,15,-,66000,15754
118,84,34,625,62000,15756
613,509,104,546,76700,15757
1119,935,184,638,105000,15759
44,40,4,-,59300,15760
40,27,13,-,125900,15761
372,341,31,713,126800,15762
78,69,9,-,152100,15764
706,601,105,704,132000,15765
5868,4273,1595,589,97300,15767
73,70,3,-,122200,15770
340,301,39,460,93800,15771
579,475,104,636,78800,15772
185,176,9,-,73900,15773
1222,1023,199,580,127200,15774
282,241,41,-,85400,15775
25,25,0,-,82500,15776
63,63,0,-,53100,15777
58,38,20,775,52000,15778
154,125,29,-,78300,15779
55,55,0,-,65000,15780
29,29,0,-,110400,15781
42,25,17,825,57000,15783
24,24,0,-,78600,15784
7884,5889,1995,600,108000,15801
63,60,3,-,112500,15821
626,515,111,535,86400,15823
2165,1563,602,562,103400,15824
3752,2791,961,590,104800,15825
85,73,12,-,37800,15827
141,133,8,-,112500,15828
572,447,125,616,104800,15829
139,128,11,530,57500,15832
1953,1291,662,589,68800,15834
877,630,247,704,86500,15840
101,92,9,-,47000,15841
1399,1060,339,556,55800,15845
1377,1224,153,510,122900,15846
106,86,20,664,73300,15847
388,316,72,641,98800,15848
462,395,67,793,80100,15849
2721,2085,636,542,86400,15851
2861,2133,728,469,81200,15853
374,346,28,708,114400,15856
5540,4235,1305,560,109500,15857
491,427,64,531,101600,15860
64,58,6,650,80000,15861
106,93,13,-,47300,15863
704,593,111,606,94800,15864
586,389,197,613,69100,15865
76,64,12,-,105000,15866
593,510,83,573,81400,15868
564,483,81,538,76600,15870
2068,647,1421,408,25800,15901
5302,3268,2034,565,52900,15902
6490,4685,1805,686,126000,15904
9140,7008,2132,645,97100,15905
5041,3395,1646,457,47800,15906
2155,1746,409,586,86400,15909
316,276,40,800,124400,15920
53,53,0,-,80200,15921
70,52,18,-,88800,15922
592,514,78,620,78300,15923
433,368,65,537,58500,15924
61,44,17,980,50000,15925
1069,925,144,516,86500,15926
453,403,50,-,75100,15927
933,730,203,865,151900,15928
54,11,43,-,85000,15929
78,78,0,-,-,15930
3637,2589,1048,662,154100,15931
87,87,0,-,105100,15934
1038,873,165,657,102300,15935
596,507,89,597,92000,15936
369,340,29,-,92400,15937
967,828,139,637,86300,15938
663,532,131,610,168000,15940
906,869,37,-,130800,15942
1535,1263,272,436,65000,15943
1322,1102,220,583,105800,15944
63,63,0,-,66900,15945
2785,2197,588,502,89100,15946
300,194,106,657,77100,15948
219,204,15,785,58800,15949
195,170,25,-,70700,15951
615,405,210,602,127800,15952
66,52,14,-,73500,15953
973,739,234,603,87300,15954
1048,960,88,517,79300,15955
1063,812,251,547,63200,15956
270,238,32,-,107700,15957
825,708,117,663,124200,15958
247,200,47,683,50000,15960
328,281,47,775,79800,15961
64,54,10,875,68900,15962
4578,3386,1192,629,93600,15963
17859,11832,6027,673,147100,16001
6004,5244,760,905,186800,16002
451,357,94,741,114600,16020
142,103,39,597,84200,16022
1938,1226,712,855,168500,16023
104,82,22,988,137500,16024
2098,1783,315,644,155300,16025
88,76,12,983,150000,16027
844,592,252,538,92800,16028
344,280,64,708,107300,16029
131,83,48,546,87200,16030
2446,1822,624,809,176700,16033
739,610,129,576,156000,16034
40,32,8,-,75000,16035
110,89,21,621,101000,16036
1742,1434,308,800,221400,16037
1364,1146,218,671,131300,16038
373,296,77,624,110000,16040
811,655,156,623,98400,16041
487,280,207,810,73500,16045
5924,4775,1149,1344,292600,16046
73,58,15,-,89300,16048
1258,1033,225,637,91300,16049
628,543,85,725,96000,16050
1260,1063,197,725,131100,16051
994,858,136,972,166800,16052
1793,1608,185,688,203800,16053
174,154,20,775,102400,16054
3397,2985,412,854,181100,16055
2034,1555,479,623,176400,16056
4617,2814,1803,694,162200,16057
3203,2721,482,1480,257400,16059
1039,932,107,657,142400,16061
3032,2027,1005,746,186700,16063
10898,9117,1781,1201,273800,16066
13776,9260,4516,574,79200,16101
2380,1881,499,672,81300,16102
6479,4937,1542,760,132800,16105
141,137,4,-,106000,16110
466,391,75,559,107700,16111
643,510,133,661,90800,16112
163,147,16,531,164000,16113
239,208,31,688,122500,16114
1244,1078,166,636,136500,16115
1180,1101,79,569,91200,16116
7104,5348,1756,727,97900,16117
800,646,154,499,117200,16120
1904,1226,678,695,61000,16121
826,700,126,539,195500,16123
770,628,142,544,124500,16124
7001,5135,1866,581,99300,16125
5375,3945,1430,685,139100,16127
812,690,122,586,108800,16130
307,261,46,686,110700,16131
79,66,13,-,-,16132
616,521,95,731,129400,16133
1663,1426,237,690,105100,16134
335,227,108,639,74500,16136
4438,3585,853,614,128800,16137
11,11,0,-,-,16140
757,680,77,498,84300,16141
2159,1607,552,596,168100,16142
1328,1197,131,646,120800,16143
1109,890,219,592,131600,16145
6055,3310,2745,614,61300,16146
7074,5231,1843,794,134300,16148
3015,2204,811,714,102500,16150
32,24,8,-,88000,16151
1074,813,261,648,112400,16153
1081,1011,70,705,124900,16154
44,9,35,741,-,16155
1125,983,142,682,152600,16156
1323,1077,246,538,99900,16157
1903,1422,481,596,135600,16159
398,293,105,729,81300,16160
423,281,142,606,52800,16161
7813,5555,2258,620,108000,16201
360,322,38,714,84200,16210
61,48,13,-,57500,16211
144,125,19,729,62200,16212
60,35,25,715,69600,16213
3878,1606,2272,617,133300,16214
45,36,9,-,129200,16217
419,344,75,936,122000,16218
862,755,107,550,88100,16222
80,67,13,-,81400,16223
475,401,74,575,87300,16224
3442,2425,1017,605,87600,16226
186,167,19,588,83400,16228
2111,1581,530,663,143600,16229
157,111,46,625,78500,16230
1733,1413,320,501,104200,16232
503,442,61,663,152900,16233
523,458,65,655,123500,16235
67,67,0,-,78500,16236
185,121,64,600,94600,16238
595,481,114,648,82900,16239
564,425,139,508,97400,16240
1987,1385,602,534,84000,16242
98,85,13,-,55000,16244
107,86,21,-,58200,16245
96,79,17,750,66200,16246
1252,877,375,571,85200,16248
793,632,161,494,117000,16249
142,115,27,1058,56500,16250
43,40,3,-,62300,16253
1300,1077,223,646,111600,16254
665,536,129,692,96200,16255
516,430,86,531,96000,16256
843,499,344,688,83900,16258
758,644,114,546,90400,16259
117,90,27,-,169700,16260
1071,854,217,631,115200,16262
137,127,10,-,52400,16263
6493,4684,1809,564,65600,16301
218,185,33,759,118100,16311
3,3,0,-,-,16312
707,573,134,582,71500,16313
2148,1814,334,650,117400,16314
2501,1827,674,645,132900,16316
575,502,73,625,86200,16317
516,461,55,-,123900,16319
33,31,2,-,48300,16321
54,49,5,592,66300,16322
6670,4753,1917,581,82700,16323
177,163,14,638,143800,16326
1201,1028,173,863,102900,16327
35,23,12,850,66400,16328
214,187,27,-,81700,16329
29,29,0,-,122900,16331
19,7,12,-,-,16332
124,108,16,-,50000,16333
127,119,8,950,113000,16334
11460,7314,4146,637,109800,16335
799,710,89,450,96600,16340
786,694,92,575,80300,16341
847,709,138,718,86100,16342
220,131,89,735,63800,16343
209,144,65,614,50000,16344
1478,1283,195,533,132200,16345
1437,1017,420,592,88400,16346
935,731,204,426,68800,16347
990,835,155,554,103800,16350
652,499,153,465,86900,16351
109,94,15,757,64400,16352
1255,1082,173,483,91300,16353
4437,2912,1525,571,85100,16354
532,438,94,600,103900,16360
37,37,0,-,-,16361
491,419,72,568,98800,16362
448,374,74,644,120500,16364
7941,5564,2377,584,94200,16365
93,84,9,-,66200,16370
1307,958,349,567,84000,16371
204,149,55,489,59500,16372
1286,1023,263,639,108600,16373
841,734,107,594,104200,16374
1720,1291,429,543,103000,16401
293,273,20,818,80500,16402
2259,1743,516,609,103100,16403
1214,997,217,638,91000,16404
293,253,40,728,90200,16405
1215,974,241,612,115300,16406
4218,2930,1288,681,92200,16407
633,567,66,773,110000,16410
602,474,128,849,105400,16411
4263,2705,1558,792,166300,16412
3315,2852,463,630,190300,16415
71,62,9,-,33300,16416
3031,2323,708,626,119500,16417
234,206,28,593,71700,16420
978,804,174,429,141000,16421
126,104,22,-,80400,16422
1752,1363,389,663,104300,16423
1955,1667,288,703,97600,16424
1483,1308,175,780,148500,16426
84,69,15,925,86100,16427
4965,3554,1411,682,149900,16428
2076,1760,316,664,113000,16433
917,753,164,635,97400,16434
722,576,146,690,108700,16435
214,178,36,575,113500,16436
3141,2467,674,635,92000,16438
403,342,61,643,125000,16440
3896,3287,609,706,162900,16441
1050,928,122,615,135200,16442
531,425,106,677,102500,16443
0,0,0,-,-,16444
1456,11,1445,388,-,16501
7139,2584,4555,653,71700,16502
5780,1967,3813,660,47100,16503
6408,4345,2063,791,86500,16504
7519,5396,2123,740,141200,16505
9900,6754,3146,877,162900,16506
3834,1091,2743,683,57700,16507
6972,4832,2140,692,93000,16508
12129,8569,3560,792,147100,16509
9944,7627,2317,684,110000,16510
4698,3112,1586,696,118500,16511
0,0,0,-,-,16546
0,0,0,-,-,16563
13419,9339,4080,590,97500,16601
12305,8200,4105,644,91400,16602
1026,856,170,574,127000,16611
561,496,65,675,114600,16613
41,31,10,-,89000,16616
1134,854,280,645,103600,16617
140,121,19,525,59300,16619
121,109,12,725,92500,16620
289,221,68,603,127900,16621
75,75,0,-,103400,16622
181,145,36,438,151600,16623
83,60,23,525,116700,16624
1603,1074,529,654,98500,16625
881,715,166,603,73500,16627
1771,1283,488,588,102400,16630
23,23,0,-,146900,16631
73,54,19,-,80000,16633
132,104,28,575,93800,16634
5024,3797,1227,791,156900,16635
299,292,7,642,111100,16636
950,749,201,689,107100,16637
17,12,5,675,112500,16638
589,529,60,667,86900,16639
322,286,36,614,101200,16640
1057,857,200,629,76200,16641
62,57,5,663,89200,16645
978,794,184,554,84200,16646
331,285,46,658,167600,16647
5990,4351,1639,775,183400,16648
761,608,153,600,118100,16650
1448,1078,370,500,83700,16651
5824,3949,1875,559,128400,16652
650,556,94,681,130700,16655
485,422,63,779,65700,16656
544,469,75,688,154900,16657
132,79,53,677,89000,16659
325,273,52,652,58800,16661
2322,1647,675,699,148000,16662
674,598,76,640,144000,16664
124,87,37,685,152900,16665
1243,1073,170,535,82000,16666
539,435,104,611,115700,16667
1500,1162,338,443,83800,16668
880,633,247,630,139300,16669
28,23,5,-,108800,16670
209,181,28,663,96100,16671
105,59,46,688,58800,16672
2143,1513,630,717,120300,16673
251,221,30,771,87900,16674
89,89,0,-,105100,16677
1118,838,280,644,93700,16678
344,276,68,625,77100,16679
174,151,23,850,105700,16680
24,14,10,-,-,16682
177,145,32,575,161600,16683
71,53,18,-,158800,16685
5181,3873,1308,638,122100,16686
175,166,9,-,160700,16689
139,123,16,825,147300,16691
280,226,54,650,66700,16692
1536,1147,389,559,111100,16693
79,69,10,-,81000,16694
390,329,61,618,139800,16695
0,0,0,-,-,16699
7397,5072,2325,617,76200,16701
491,410,81,673,72600,16720
55,41,14,-,70800,16724
85,68,17,-,-,16725
232,225,7,-,70300,16726
70,57,13,-,-,16727
15,15,0,-,38800,16728
350,279,71,598,67500,16729
51,51,0,-,73900,16730
1099,849,250,563,65200,16731
180,164,16,-,75100,16732
107,96,11,-,74700,16733
99,93,6,-,61000,16734
2598,1930,668,621,70800,16735
538,465,73,625,77900,16738
455,337,118,572,62500,16740
1651,1203,448,714,82800,16743
141,122,19,-,76700,16744
219,193,26,467,78800,16745
513,384,129,622,85900,16746
1037,839,198,557,84800,16748
1588,1316,272,666,88800,16749
187,127,60,582,83800,16750
17384,6892,10492,971,262500,16801
9,0,9,-,-,16802
10144,4482,5662,1053,266600,16803
383,330,53,681,167300,16820
67,67,0,-,-,16821
758,610,148,579,116500,16822
10874,8112,2762,771,172900,16823
90,55,35,-,93400,16825
246,212,34,679,169600,16826
1785,1469,316,1047,246000,16827
1908,1658,250,1041,215500,16828
244,222,22,616,108800,16829
5872,3865,2007,565,86200,16830
185,146,39,713,186700,16832
2230,1690,540,583,85500,16833
52,52,0,-,86900,16834
68,55,13,828,116100,16835
456,414,42,777,101100,16836
60,60,0,-,52500,16837
727,643,84,690,86300,16838
208,204,4,-,65300,16839
220,195,25,-,63500,16840
2166,1688,478,735,144800,16841
261,219,42,-,38000,16843
1085,966,119,799,162900,16844
284,245,39,537,84800,16845
144,123,21,-,85800,16847
152,113,39,754,127000,16848
154,143,11,-,136800,16849
250,230,20,-,199400,16851
117,93,24,-,150600,16852
115,36,79,701,161300,16853
316,251,65,806,142500,16854
183,183,0,-,52400,16855
1500,1296,204,862,98600,16858
227,184,43,720,111000,16859
138,100,38,-,139300,16860
109,99,10,-,72100,16861
265,213,52,767,91200,16863
766,726,40,977,182900,16865
3762,2592,1170,539,100700,16866
114,99,15,-,197100,16868
2555,2262,293,761,268000,16870
20,17,3,-,61700,16871
450,312,138,754,151300,16872
542,490,52,700,122800,16874
1624,1257,367,811,221100,16875
114,97,17,760,87000,16876
702,613,89,972,181000,16877
727,657,70,635,92800,16878
127,91,36,860,76000,16879
836,747,89,816,94500,16881
131,107,24,594,158500,16882
4073,3149,924,730,144900,16901
162,148,14,775,107100,16911
705,498,207,613,112400,16912
797,650,147,719,144500,16914
2228,1677,551,730,120100,16915
495,408,87,627,141700,16917
850,563,287,665,86300,16920
209,156,53,683,112500,16921
815,611,204,635,89600,16922
610,468,142,608,121900,16923
1265,1069,196,826,121700,16925
338,271,67,738,169600,16926
244,195,49,661,94500,16927
526,402,124,638,92400,16928
945,721,224,716,123400,16929
484,374,110,779,135900,16930
261,213,48,994,179900,16932
2820,1795,1025,667,152100,16933
522,459,63,642,168200,16935
739,593,146,847,119100,16936
105,85,20,-,69000,16937
277,227,50,871,156300,16938
120,98,22,1000,93600,16939
109,58,51,459,99200,16940
41,38,3,-,73300,16941
292,223,69,833,93900,16942
202,172,30,550,132700,16943
1006,733,273,774,112500,16946
1852,1387,465,633,137800,16947
607,443,164,446,107900,16948
1368,1020,348,554,98200,16950
239,185,54,408,146400,17002
4152,3135,1017,787,173900,17003
1670,1153,517,558,147500,17004
145,106,39,718,108300,17005
358,274,84,689,144600,17006
2131,1877,254,824,240500,17007
807,535,272,645,85200,17009
35,0,35,-,-,17010
13527,9545,3982,940,188800,17011
13914,8319,5595,848,169800,17013
8032,7048,984,894,209200,17015
355,139,216,2190,120200,17016
686,555,131,695,147300,17017
1734,1409,325,821,183500,17018
7029,5696,1333,783,210700,17019
3630,2789,841,766,164900,17020
396,278,118,571,158900,17021
10870,7377,3493,933,181500,17022
1349,940,409,635,133800,17023
713,587,126,734,177700,17024
6938,5126,1812,852,181700,17025
1297,1094,203,521,183500,17026
211,147,64,1159,182800,17027
1519,1338,181,815,178000,17028
134,108,26,-,65900,17029
342,261,81,686,112500,17030
3295,2713,582,628,163000,17032
6442,3610,2832,912,243200,17033
1062,533,529,763,90800,17034
369,265,104,483,123800,17035
9242,6524,2718,996,215700,17036
324,275,49,1156,147700,17037
3126,2386,740,909,171200,17038
26,26,0,-,-,17039
906,788,118,798,162000,17040
51,51,0,-,223000,17041
14363,9783,4580,816,163800,17042
2828,1396,1432,885,142500,17043
8931,5726,3205,625,90100,17044
1253,974,279,625,157600,17045
11802,7241,4561,666,134900,17046
904,674,230,648,153300,17047
1466,1069,397,689,100800,17048
1111,926,185,664,137900,17049
14517,11270,3247,1092,252600,17050
1863,1454,409,565,119000,17051
642,555,87,597,89900,17052
2128,1631,497,861,162200,17053
15459,10818,4641,954,194800,17055
23,23,0,-,51900,17056
9062,6171,2891,825,137700,17057
653,445,208,601,117400,17058
3057,2246,811,586,152700,17059
487,404,83,638,87600,17060
3021,2196,825,659,119800,17061
1527,1344,183,619,165400,17062
1237,954,283,717,96600,17063
345,278,67,947,273900,17064
1699,1227,472,772,161400,17065
2297,1546,751,499,81100,17066
5387,4170,1217,828,166400,17067
1563,1248,315,849,162000,17068
53,26,27,754,125000,17069
6773,4929,1844,799,170900,17070
73,62,11,810,66000,17071
66,0,66,-,-,17072
1903,1485,418,783,169400,17073
2864,2116,748,653,159200,17074
37,35,2,-,49600,17075
27,27,0,-,-,17076
41,17,24,-,-,17077
8781,6125,2656,861,186500,17078
100,91,9,719,109700,17080
163,128,35,-,154700,17081
1361,1004,357,621,142100,17082
6,0,6,-,-,17083
1745,1347,398,747,154500,17084
822,615,207,610,157500,17086
990,815,175,783,171900,17087
323,242,81,942,170700,17088
2306,2080,226,667,162800,17090
447,208,239,1119,139400,17093
1051,796,255,525,140000,17094
359,293,66,675,73800,17097
976,752,224,662,84600,17098
534,388,146,701,80800,17099
1525,64,1461,744,202900,17101
4035,1240,2795,738,138200,17102
4444,1911,2533,770,81300,17103
7360,3025,4335,744,77800,17104
10410,5241,5169,911,152600,17109
10317,6461,3856,960,160200,17110
12238,8408,3830,953,167200,17111
14180,11556,2624,1018,197500,17112
3995,2401,1594,829,108900,17113
0,0,0,-,-,17120
10407,5301,5106,808,162100,17201
11606,9169,2437,905,193500,17202
57,48,9,-,140800,17210
156,136,20,-,141700,17211
296,255,41,567,163400,17212
234,180,54,621,133900,17213
410,253,157,640,172700,17214
88,67,21,-,176300,17215
53,32,21,1031,162500,17217
146,123,23,-,127700,17219
147,83,64,-,131900,17220
220,161,59,834,114100,17221
4461,3742,719,750,183200,17222
140,87,53,596,136800,17223
744,640,104,544,160000,17224
7221,5474,1747,890,205300,17225
431,361,70,663,149600,17228
525,434,91,713,119800,17229
2209,1562,647,609,144200,17233
150,74,76,1048,195000,17235
3158,2357,801,804,169800,17236
594,463,131,1000,144400,17237
637,540,97,623,162300,17238
102,97,5,-,126100,17239
1209,982,227,867,190000,17240
4557,3583,974,818,163800,17241
666,528,138,450,104100,17243
950,759,191,957,168300,17244
78,55,23,-,151300,17246
182,16,166,1190,-,17247
166,150,16,788,82400,17249
32,32,0,-,-,17250
65,45,20,-,168800,17251
1547,1241,306,665,152400,17252
114,89,25,695,91400,17253
0,0,0,-,-,17254
418,364,54,688,120800,17255
34,34,0,-,-,17256
10612,6450,4162,894,173500,17257
435,364,71,650,122900,17260
0,0,0,-,-,17261
530,418,112,736,161700,17262
257,229,28,-,176100,17263
911,740,171,559,122300,17264
218,180,38,936,125700,17265
188,141,47,742,177200,17266
1122,888,234,786,172800,17267
11931,8201,3730,777,163100,17268
24,24,0,-,-,17270
108,95,13,-,164500,17271
201,201,0,-,-,17272
1559,1400,159,946,170800,17301
981,750,231,988,177700,17302
992,810,182,827,174500,17304
124,79,45,1139,147100,17306
2217,1607,610,842,193600,17307
812,667,145,580,166500,17309
101,62,39,817,135700,17311
4407,3097,1310,842,153400,17313
2107,1679,428,858,170300,17314
10148,8379,1769,862,152700,17315
3088,2659,429,836,190300,17316
269,224,45,1042,132600,17317
168,90,78,948,122700,17318
4179,3355,824,1070,168300,17319
2945,2637,308,850,216700,17320
871,753,118,894,225800,17321
2264,1921,343,1236,173900,17322
1559,1297,262,597,172700,17324
10345,7462,2883,800,218200,17325
2882,2262,620,896,220800,17327
907,811,96,919,240600,17329
20285,14487,5798,843,175100,17331
2734,2120,614,907,229100,17339
4216,3293,923,811,205800,17340
0,0,0,-,-,17343
1479,943,536,841,157000,17344
3180,2307,873,796,143000,17345
2251,1965,286,880,166800,17347
2669,2374,295,920,248800,17349
4876,3790,1086,1016,164900,17350
465,377,88,861,219800,17352
1375,1206,169,840,177200,17353
95,59,36,930,181900,17355
8045,6060,1985,846,169400,17356
2447,2107,340,1042,193900,17360
2388,1982,406,848,221000,17361
5047,4307,740,746,184900,17362
3497,3097,400,881,218100,17363
1383,1292,91,626,160000,17364
945,793,152,631,169200,17365
2151,1758,393,746,139800,17366
3081,2395,686,897,145800,17368
1863,1630,233,903,158600,17370
132,105,27,1109,148400,17371
1538,1193,345,745,207500,17372
6489,1854,4635,761,64700,17401
13880,9569,4311,956,173500,17402
14560,9469,5091,822,153000,17403
13756,9759,3997,832,132900,17404
8727,6738,1989,1001,160000,17406
824,759,65,1034,174100,17407
9055,7105,1950,973,167600,17408
1764,1063,701,853,162600,17501
1028,855,173,921,175200,17502
596,388,208,717,301100,17505
36,16,20,-,-,17507
202,186,16,-,239400,17508
1302,923,379,880,228100,17509
7037,4723,2314,762,139100,17512
1774,1496,278,815,210600,17516
5820,4562,1258,878,196100,17517
428,329,99,1145,209000,17518
2131,1532,599,910,228000,17519
1857,1629,228,1079,166900,17520
12673,8935,3738,854,176800,17522
1938,1391,547,909,223900,17527
1504,1000,504,838,255700,17529
1116,976,140,695,182400,17532
746,382,364,1083,277300,17535
879,773,106,729,250200,17536
2375,2061,314,743,232200,17538
3427,2189,1238,997,213200,17540
16270,11760,4510,1034,218900,17543
8358,6696,1662,945,193900,17545
2636,1933,703,880,162400,17547
317,141,176,994,163600,17550
3737,2417,1320,1066,167900,17551
8013,5737,2276,950,177000,17552
3300,1866,1434,898,184500,17554
2080,1714,366,841,245200,17555
5129,3152,1977,950,225800,17557
2179,1922,257,995,155000,17560
1298,917,381,882,229500,17562
1189,925,264,1047,208100,17563
1049,887,162,1048,219600,17565
4012,3056,956,993,215600,17566
1937,1747,190,949,204600,17569
129,52,77,-,333300,17570
1217,824,393,788,227500,17572
75,75,0,-,218800,17576
2622,2093,529,825,192600,17578
2080,1688,392,969,214900,17579
313,242,71,696,200600,17581
812,727,85,719,215500,17582
3754,2672,1082,1440,194700,17584
20126,14522,5604,1056,220800,17601
19093,9715,9378,905,165000,17602
24588,13925,10663,890,151700,17603
265,32,233,1621,-,17606
17669,10218,7451,752,122700,17701
4539,3287,1252,782,131000,17702
697,456,241,648,95800,17721
23,22,1,-,158300,17723
1886,1192,694,611,124800,17724
42,36,6,-,215000,17727
2004,1753,251,758,153200,17728
29,29,0,-,73800,17729
66,0,66,-,-,17730
111,104,7,-,435700,17731
2490,1956,534,675,155100,17737
16,16,0,-,121900,17739
4833,3513,1320,708,130400,17740
15,6,9,-,-,17742
1269,1007,262,675,125200,17744
7016,4278,2738,699,125000,17745
1019,848,171,721,144700,17747
140,131,9,925,52500,17748
152,118,34,775,112500,17749
57,53,4,-,129800,17750
2741,2282,459,754,132800,17751
1736,1257,479,790,133000,17752
4931,4067,864,792,174100,17754
4264,3360,904,669,147600,17756
371,331,40,945,156900,17758
274,236,38,716,95900,17760
213,180,33,861,135200,17762
90,85,5,-,72500,17763
960,680,280,510,52300,17764
412,340,72,641,155500,17765
80,67,13,-,89700,17767
138,121,17,758,147300,17768
1273,1124,149,809,154300,17771
908,749,159,596,153200,17772
521,410,111,705,157700,17774
136,110,26,438,154700,17776
2987,2153,834,643,151100,17777
41,38,3,-,75000,17778
55,13,42,-,-,17779
7050,4527,2523,607,113900,17801
765,639,126,675,157100,17810
500,358,142,699,121800,17812
764,599,165,852,126200,17813
1883,1530,353,714,151300,17814
11390,7184,4206,732,153400,17815
2322,1845,477,723,148600,17820
7497,5473,2024,717,173900,17821
0,0,0,-,-,17822
479,367,112,693,161700,17823
1721,1471,250,796,188000,17824
301,220,81,663,142000,17827
90,69,21,830,103500,17829
798,677,121,674,120000,17830
305,289,16,-,77100,17832
1637,1044,593,632,80000,17834
103,76,27,725,108300,17835
92,79,13,830,145800,17836
6398,3947,2451,696,191400,17837
157,141,16,-,47500,17840
1760,1415,345,636,109500,17841
3214,2484,730,616,146200,17842
3931,3007,924,651,159600,17844
758,572,186,691,139500,17845
1514,1215,299,718,167300,17846
4971,3422,1549,664,125600,17847
308,212,96,589,38600,17850
3526,2399,1127,608,45900,17851
1172,905,267,631,161000,17853
389,320,69,681,137900,17855
1272,1039,233,681,151200,17856
3186,2360,826,756,132000,17857
1149,997,152,756,146400,17859
1003,876,127,780,173000,17860
44,40,4,-,139300,17861
188,96,92,687,140200,17862
710,552,158,665,153700,17864
43,33,10,-,79700,17865
3348,2444,904,575,64500,17866
74,60,14,1100,173100,17867
429,345,84,775,160700,17868
5484,3853,1631,699,161700,17870
4336,2768,1568,574,57200,17872
814,461,353,485,153300,17876
536,448,88,687,169300,17878
43,33,10,767,-,17880
620,513,107,535,74500,17881
108,60,48,658,80000,17884
66,54,12,-,146400,17885
424,248,176,729,116200,17886
182,182,0,-,-,17887
116,100,16,633,75000,17888
965,833,132,769,193800,17889
9841,6816,3025,635,88700,17901
169,151,18,-,82500,17920
2815,2149,666,499,88800,17921
1997,1813,184,918,162500,17922
184,141,43,-,71100,17923
194,133,61,688,85600,17925
696,489,207,709,103200,17929
202,129,73,739,66100,17930
2196,1679,517,747,80700,17931
38,24,14,-,-,17933
192,163,29,492,30800,17934
598,467,131,716,29600,17935
290,242,48,703,95900,17936
946,796,150,595,121200,17938
318,254,64,558,158200,17941
51,51,0,-,124000,17943
67,61,6,-,65000,17944
75,74,1,-,54800,17945
29,29,0,-,33100,17946
1983,1439,544,598,31500,17948
100,98,2,-,32300,17949
98,92,6,-,90000,17951
100,90,10,-,68500,17952
226,169,57,642,64300,17953
1944,1283,661,596,59300,17954
164,152,12,-,83900,17957
608,479,129,540,49600,17959
1560,1385,175,710,172500,17960
2904,2180,724,667,164700,17961
3573,2819,754,663,149700,17963
302,246,56,442,145000,17964
871,646,225,660,73700,17965
1059,924,135,610,122200,17967
109,85,24,650,86100,17968
1347,868,479,609,64200,17970
4509,3406,1103,732,119900,17972
149,104,45,-,140400,17974
2871,1837,1034,603,36900,17976
98,49,49,710,143800,17978
96,96,0,-,143800,17979
1240,1038,202,601,86000,17980
1039,811,228,564,71100,17981
184,144,40,962,80000,17982
629,428,201,603,112100,17983
506,456,50,1078,153300,17985
2089,1736,353,1391,195600,18011
6489,4749,1740,990,187100,18013
4346,3553,793,925,187700,18014
11054,5983,5071,921,154400,18015
0,0,0,-,-,18016
15015,10173,4842,1049,226100,18017
13541,7147,6394,952,163300,18018
7495,6466,1029,1184,241300,18020
327,227,100,557,129600,18030
3631,2608,1023,1508,256300,18031
3739,2467,1272,758,156700,18032
2811,2343,468,1144,285300,18034
63,63,0,-,189100,18035
4733,4111,622,817,274200,18036
3017,2416,601,939,182400,18037
1133,967,166,908,196300,18038
6116,5440,676,919,246100,18040
2076,1635,441,923,233200,18041
15388,8262,7126,922,143800,18042
10148,8414,1734,1156,230100,18045
15,15,0,-,-,18046
7431,5238,2193,971,201800,18049
1321,1185,136,-,298700,18051
10935,6650,4285,1011,178400,18052
840,677,163,967,218400,18053
1649,1407,242,937,274000,18054
4817,3588,1229,1013,205400,18055
330,321,9,-,28000,18056
3818,3324,494,931,169000,18058
427,417,10,-,259600,18059
9922,8286,1636,1213,240000,18062
264,212,52,-,198700,18063
9293,7149,2144,916,242200,18064
2154,1915,239,1051,259600,18066
7380,5743,1637,973,194800,18067
0,0,0,-,-,18068
2895,2577,318,969,270700,18069
408,271,137,1153,173400,18070
4078,3286,792,775,152800,18071
2432,1675,757,872,163900,18072
3358,3004,354,948,252900,18073
2256,2022,234,1210,262100,18074
1172,802,370,811,190600,18076
938,793,145,1032,322000,18077
2796,2245,551,1042,276900,18078
164,146,18,-,120000,18079
4753,3645,1108,845,171900,18080
128,96,32,-,-,18081
178,116,62,1000,187500,18083
367,325,42,820,200600,18085
181,147,34,-,190200,18086
281,103,178,991,171700,18087
3223,2881,342,831,191000,18088
2399,1689,710,879,191500,18091
1185,1031,154,1027,307800,18092
1515,185,1330,671,81800,18101
15577,5172,10405,859,89700,18102
17770,11698,6072,961,161800,18103
16390,11809,4581,1198,212700,18104
0,0,0,-,-,18105
3080,2305,775,1342,221700,18106
6499,3136,3363,946,128800,18109
0,0,0,-,-,18195
9861,5412,4449,669,87100,18201
4556,2710,1846,776,119700,18202
2934,2368,566,1336,158300,18210
567,515,52,783,228200,18211
70,64,6,-,112900,18212
753,700,53,578,134700,18214
449,324,125,650,80400,18216
1034,690,344,607,47700,18218
639,479,160,833,161100,18219
150,143,7,-,53200,18220
202,202,0,-,86700,18221
3507,3220,287,1270,172800,18222
85,56,29,-,102500,18223
2361,1766,595,728,81000,18224
73,73,0,-,29100,18225
3346,2724,622,895,162900,18229
41,30,11,775,90000,18230
219,142,77,753,85700,18231
1666,1113,553,647,47600,18232
191,182,9,-,117100,18234
7681,6014,1667,794,164100,18235
1363,923,440,685,85000,18237
130,42,88,781,-,18239
1607,1146,461,722,94300,18240
297,157,140,760,69800,18241
89,86,3,-,-,18242
133,116,17,695,106300,18244
110,93,17,-,84700,18245
78,47,31,-,36800,18246
229,156,73,857,110200,18248
1536,1363,173,1030,213700,18249
1154,838,316,813,100000,18250
37,0,37,-,-,18251
4504,2953,1551,690,82900,18252
414,323,91,820,99200,18254
1832,1535,297,828,128400,18255
167,143,24,725,145800,18256
9690,6905,2785,1069,170700,18301
5966,5019,947,1212,149800,18302
509,387,122,847,118000,18321
878,684,194,867,186600,18322
67,67,0,-,351400,18323
3192,2611,581,1324,131600,18324
893,738,155,850,172600,18325
1701,1215,486,784,179800,18326
231,103,128,1098,186400,18327
2636,2367,269,1394,152900,18328
2638,2408,230,1332,180000,18330
227,140,87,738,205300,18331
1048,824,224,820,201800,18332
137,87,50,-,204700,18333
1675,1379,296,1178,150600,18334
318,251,67,-,169900,18335
1601,1133,468,869,190800,18336
5069,4282,787,1114,227500,18337
59,59,0,-,310600,18340
179,100,79,-,139600,18342
1570,1216,354,976,226200,18343
1267,751,516,866,157600,18344
866,714,152,954,156400,18346
1217,1008,209,906,167400,18347
117,117,0,-,217000,18349
737,567,170,804,174500,18350
199,137,62,1047,158500,18351
363,226,137,1442,198700,18352
4124,3763,361,840,195100,18353
283,259,24,-,216000,18354
470,372,98,1185,197800,18355
43,43,0,-,207000,18356
77,27,50,-,-,18357
9663,6519,3144,983,205800,18360
385,307,78,1485,170800,18370
319,280,39,-,181900,18371
789,634,155,897,187700,18372
2825,2252,573,713,147900,18403
1004,839,165,829,172100,18405
5801,3706,2095,618,100200,18407
8727,7103,1624,1016,214000,18411
109,29,80,757,219800,18413
2047,1845,202,797,195900,18414
456,368,88,768,257000,18415
421,361,60,833,202900,18417
1724,1453,271,744,169100,18419
22,14,8,-,-,18420
2006,1496,510,673,122000,18421
2050,1783,267,1056,157500,18424
513,465,48,1271,166000,18425
1855,1533,322,945,158400,18426
37,0,37,-,-,18427
4772,3926,846,987,196100,18428
9,6,3,-,-,18430
4887,3442,1445,730,169400,18431
2578,2062,516,684,151300,18433
1588,1090,498,715,138800,18434
332,299,33,-,238400,18435
5042,4290,752,1058,190300,18436
96,81,15,575,162500,18437
521,514,7,-,206400,18438
200,150,50,578,166300,18439
132,93,39,596,112500,18441
194,168,26,856,168600,18443
5299,4513,786,790,199200,18444
967,789,178,853,181600,18445
1399,1167,232,651,151000,18446
4594,3073,1521,690,160200,18447
249,215,34,-,258000,18451
2226,1574,652,608,151600,18452
420,359,61,747,178100,18453
4,0,4,-,-,18454
32,30,2,-,141700,18455
188,119,69,783,190400,18456
85,70,15,-,185300,18457
1167,967,200,1087,215500,18458
14,14,0,-,-,18459
83,62,21,-,129200,18460
170,157,13,700,123100,18461
173,146,27,800,165000,18462
87,76,11,950,168800,18463
578,519,59,1229,202700,18464
561,467,94,763,162000,18465
5357,4081,1276,1291,119800,18466
134,93,41,-,193900,18469
842,720,122,775,214400,18470
242,216,26,-,294000,18471
1588,1237,351,675,175100,18472
232,174,58,792,115300,18473
606,82,524,429,83900,18503
8322,4628,3694,727,108300,18504
8249,4364,3885,706,104500,18505
2085,1698,387,700,156900,18507
4978,2651,2327,748,96700,18508
4600,2489,2111,726,124600,18509
4596,1980,2616,735,118600,18510
5290,3523,1767,740,138900,18512
2097,1303,794,719,118100,18517
3779,2505,1274,693,143500,18518
2024,1074,950,642,124500,18519
110,98,12,1375,345500,18602
8189,5662,2527,702,117300,18603
1459,1318,141,1147,144500,18610
6173,4875,1298,734,182300,18612
1108,842,266,525,158300,18614
704,557,147,779,182400,18615
260,205,55,569,135900,18616
717,352,365,563,74700,18617
1524,1202,322,935,173100,18618
119,102,17,1031,121000,18619
1971,1789,182,769,138700,18621
85,71,14,-,91000,18622
1050,831,219,683,150500,18623
225,174,51,1615,300000,18624
203,162,41,575,172700,18625
200,185,15,588,187500,18626
107,96,11,-,94100,18628
643,535,108,715,161200,18629
1232,921,311,783,164200,18630
559,418,141,852,135000,18631
199,160,39,754,79600,18632
5755,3554,2201,627,86500,18634
1648,1242,406,685,131100,18635
536,478,58,720,119100,18636
7379,5024,2355,735,120700,18640
2664,2099,565,699,108400,18641
1842,1388,454,768,135000,18642
5346,3754,1592,691,139200,18643
3026,2279,747,694,143800,18644
3668,2206,1462,730,82300,18651
40,40,0,-,170800,18653
2385,1964,421,641,154900,18655
916,782,134,683,197300,18656
4778,3681,1097,717,165600,18657
1420,1208,212,699,154700,18660
2354,2001,353,834,145400,18661
950,87,863,571,161700,18701
15333,8183,7150,738,85900,18702
13583,8098,5485,748,123500,18704
6340,4000,2340,683,92000,18705
6856,4798,2058,634,86100,18706
6016,5403,613,602,190300,18707
3479,2808,671,771,174900,18708
1406,799,607,590,89300,18709
3448,2570,878,744,163900,18801
2392,1760,632,464,133800,18810
675,618,57,890,194300,18812
55,39,16,775,156300,18814
50,50,0,-,109800,18816
69,52,17,967,132100,18817
553,472,81,611,174100,18818
513,292,221,672,140600,18821
1503,1076,427,762,99100,18822
92,49,43,293,89700,18823
561,413,148,964,159900,18824
50,45,5,-,111300,18825
692,562,130,725,193400,18826
148,90,58,844,152200,18828
301,257,44,742,163900,18829
294,241,53,817,145200,18830
518,452,66,913,116600,18831
713,527,186,654,142100,18832
782,644,138,675,148500,18833
1430,1174,256,773,159300,18834
1145,928,217,840,138000,18837
4810,3351,1459,680,129400,18840
114,110,4,-,117100,18842
128,96,32,-,97200,18843
746,585,161,850,171600,18844
122,109,13,1125,151300,18845
332,289,43,955,180500,18846
2297,1735,562,684,112400,18847
3759,2631,1128,706,153100,18848
820,652,168,855,138100,18850
281,233,48,820,124700,18851
1642,1377,265,731,166300,18853
495,403,92,923,143800,18854
10394,7158,3236,1323,410100,18901
7467,6652,815,1556,464700,18902
47,47,0,-,354700,18912
61,23,38,-,-,18913
7442,6438,1004,1309,365100,18914
301,282,19,-,270000,18915
896,438,458,1008,296200,18917
177,171,6,-,303300,18920
306,303,3,-,351700,18923
2416,2255,161,1111,445800,18925
2939,2806,133,1730,406100,18929
1082,954,128,935,354900,18930
203,184,19,-,356600,18932
0,0,0,-,-,18935
0,0,0,-,-,18936
5893,4830,1063,1427,580800,18938
10683,8982,1701,1523,446100,18940
1300,1041,259,1066,378500,18942
9172,7134,2038,1134,299300,18944
2244,2090,154,950,412900,18947
90,90,0,-,643900,18950
13298,10598,2700,986,246000,18951
3173,3049,124,-,425400,18954
708,515,193,1040,228300,18955
5006,3897,1109,1163,271000,18960
218,182,36,1063,270000,18962
5013,3831,1182,929,268500,18964
13862,11858,2004,1456,347500,18966
5837,4019,1818,967,260000,18969
323,214,109,941,230500,18970
1581,1275,306,1167,380900,18972
16156,11943,4213,1307,296800,18974
7093,5727,1366,1295,371200,18976
1507,1449,58,2778,590700,18977
212,193,19,-,468500,18980
6388,5173,1215,1127,247600,19001
12357,9495,2862,1245,398800,19002
5385,3370,2015,1258,298000,19003
3836,3125,711,1333,481900,19004
7894,6259,1635,1120,380100,19006
7906,4296,3610,864,194300,19007
7221,6219,1002,1169,339300,19008
253,143,110,983,450800,19009
7263,4685,2578,1455,605200,19010
2251,2012,239,1047,229200,19012
12248,4553,7695,806,67800,19013
7601,6464,1137,957,230900,19014
6269,4720,1549,1020,167800,19015
72,72,0,-,400000,19017
9394,5821,3573,979,156900,19018
21762,12473,9289,1103,259000,19020
3661,2566,1095,977,199200,19021
1370,589,781,933,95900,19022
7260,4101,3159,964,95100,19023
2015,1690,325,2054,425200,19025
12017,7844,4173,1007,187500,19026
8391,5055,3336,994,271600,19027
1527,952,575,852,142000,19029
4625,3437,1188,979,242600,19030
1805,1349,456,1145,344400,19031
2278,1739,539,1176,112600,19032
3073,2365,708,1056,203700,19033
2051,1704,347,1205,475300,19034
1542,1344,198,1484,806000,19035
5224,3848,1376,997,135400,19036
11096,9316,1780,1108,274300,19038
7778,5713,2065,1119,270300,19040
2450,1490,960,1524,594800,19041
1124,762,362,1015,178400,19043
6518,4326,2192,1201,257000,19044
7125,5149,1976,1077,332400,19046
12618,9388,3230,1200,341100,19047
10535,6349,4186,886,147300,19050
9575,7628,1947,1096,287800,19053
6081,4448,1633,1119,230000,19054
4668,3965,703,1108,202900,19055
5291,3779,1512,1088,249400,19056
6299,4491,1808,1133,212900,19057
3701,3586,115,1010,418000,19060
7608,4938,2670,920,174200,19061
14346,10061,4285,1184,359800,19063
8464,7753,711,1192,291900,19064
1767,1595,172,2085,644800,19066
19718,15809,3909,1242,355500,19067
2722,2060,662,891,219000,19070
3940,2960,980,1404,492500,19072
7769,6197,1572,1562,407900,19073
2060,1628,432,909,165600,19074
2731,2398,333,982,303500,19075
2478,1596,882,945,181100,19076
4429,3092,1337,897,184400,19078
3440,2292,1148,975,107900,19079
3338,2756,582,1203,260700,19081
13696,6462,7234,898,112000,19082
13171,11481,1690,1016,297800,19083
1841,1683,158,1969,803600,19085
4287,3775,512,1142,322100,19086
11987,9195,2792,1467,501800,19087
7175,5080,2095,1180,247200,19090
1552,977,575,715,174200,19094
2962,1413,1549,1454,311300,19095
5400,4161,1239,1446,502100,19096
2935,715,2220,2014,385500,19102
14274,4625,9649,1549,469500,19103
15559,2963,12596,910,115500,19104
6260,2870,3390,1680,448500,19106
6869,1399,5470,1197,337100,19107
0,0,0,-,-,19109
23998,13673,10325,914,170000,19111
0,0,0,-,-,19112
58,38,20,-,165900,19113
12709,7780,4929,1033,189100,19114
13548,7738,5810,944,235700,19115
12714,7360,5354,901,233600,19116
4319,2000,2319,1420,485300,19118
11730,7677,4053,967,237400,19119
23069,13270,9799,936,96500,19120
12075,3665,8410,726,88300,19121
6087,2498,3589,751,153800,19122
6757,2061,4696,1171,317300,19123
22518,11489,11029,874,97400,19124
9368,5695,3673,989,195500,19125
5579,3352,2227,884,140500,19126
2378,991,1387,1360,229800,19127
15339,9076,6263,1204,234900,19128
4620,2401,2219,1168,194200,19129
12586,5154,7432,1285,343500,19130
17450,7865,9585,923,107900,19131
13439,6809,6630,788,48400,19132
8627,3650,4977,670,50700,19133
20307,10278,10029,847,81900,19134
11671,7608,4063,855,112700,19135
12262,7505,4757,871,148900,19136
3041,2212,829,996,130900,19137
11405,7987,3418,945,108300,19138
16121,7008,9113,827,77400,19139
18036,8221,9815,802,61800,19140
12218,5984,6234,792,96700,19141
9483,5030,4453,933,79300,19142
25465,12840,12625,826,83000,19143
16882,6114,10768,838,115900,19144
18142,10909,7233,923,156800,19145
16160,8332,7828,1005,262300,19146
16579,8748,7831,1214,322200,19147
19364,12858,6506,990,170800,19148
18710,11051,7659,1078,127800,19149
9566,6967,2599,994,159700,19150
12124,7941,4183,975,126200,19151
12838,7874,4964,946,186600,19152
5338,3146,2192,1043,137300,19153
12108,9858,2250,1088,196300,19154
2671,1967,704,1297,363600,19301
998,753,245,919,235100,19310
2992,2323,669,1275,337100,19311
4417,3792,625,1358,584200,19312
55,46,9,-,172100,19316
3646,3112,534,1600,457600,19317
61,49,12,-,-,19319
19179,13952,5227,1093,227600,19320
1951,1690,261,1093,286600,19330
2875,1818,1057,1374,548600,19333
17474,13975,3499,1193,326200,19335
6782,4202,2580,1347,350200,19341
7376,5199,2177,1835,418100,19342
2852,2451,401,1479,377900,19343
4199,3128,1071,1236,235400,19344
7,7,0,-,-,19345
8324,5870,2454,1066,382000,19348
4115,3560,555,1406,380600,19350
2762,2535,227,1063,328700,19352
9162,6899,2263,1533,435300,19355
212,92,120,1127,157800,19358
2000,1735,265,865,211600,19362
5808,4298,1510,895,251300,19363
2663,1996,667,969,203500,19365
27,5,22,-,-,19367
642,370,272,1541,221200,19372
1000,905,95,1280,529300,19373
272,109,163,989,325900,19374
28,0,28,-,-,19375
19760,14130,5630,1331,367900,19380
20201,14273,5928,1305,399900,19382
0,0,0,-,-,19383
4766,3692,1074,976,292900,19390
15842,6923,8919,1065,172100,19401
17823,12751,5072,1321,266500,19403
2407,1236,1171,928,198100,19405
9964,6172,3792,1266,291800,19406
7168,5548,1620,1678,415900,19422
5014,4709,305,1582,466300,19425
12050,10620,1430,1346,338600,19426
7652,4302,3350,1390,292200,19428
55,55,0,-,193600,19435
340,55,285,1424,-,19436
283,283,0,-,843000,19437
9219,7170,2049,1332,328400,19438
7041,4776,2265,971,280900,19440
0,0,0,-,-,19442
4258,3206,1052,1421,379200,19444
21903,14107,7796,1232,310300,19446
665,504,161,-,217000,19453
11054,8429,2625,1272,305400,19454
265,265,0,-,351700,19456
43,43,0,-,-,19457
16303,11837,4466,1139,285100,19460
5767,4340,1427,1306,322800,19462
18028,12158,5870,889,166400,19464
6592,5207,1385,1089,273900,19465
10094,7226,2868,1210,246500,19468
20,0,20,-,-,19472
5887,5069,818,1060,312800,19473
310,274,36,-,229000,19474
4115,3059,1056,834,270400,19475
0,0,0,-,-,19477
258,36,222,2321,270000,19492
442,232,210,806,190300,19501
497,384,113,893,172400,19503
1887,1684,203,846,262100,19504
1233,937,296,968,202700,19505
2739,2459,280,796,212000,19506
1066,967,99,817,199800,19507
5995,5097,898,911,176400,19508
2997,2551,446,1036,189600,19510
46,46,0,-,185300,19511
7044,5310,1734,823,192300,19512
5495,4569,926,1076,231000,19518
0,0,0,-,-,19519
2337,1797,540,859,286500,19520
5413,4647,766,879,174900,19522
147,147,0,-,146600,19523
5520,5013,507,1082,295500,19525
4511,3430,1081,765,149400,19526
1371,1125,246,981,234900,19529
4719,3157,1562,920,187600,19530
2430,1996,434,844,193400,19533
780,515,265,757,196700,19534
14,14,0,-,-,19535
226,134,92,815,135500,19536
8,8,0,-,-,19538
1805,1484,321,1099,197200,19539
4511,3824,687,861,225900,19540
1605,1352,253,896,224200,19541
0,0,0,-,-,19542
2113,1750,363,968,255100,19543
34,29,5,-,134400,19544
204,182,22,-,162500,19545
1635,1306,329,1240,236400,19547
115,70,45,775,90000,19549
162,69,93,698,122500,19550
1861,1576,285,754,185100,19551
168,110,58,628,162500,19554
1389,1075,314,810,158600,19555
130,90,40,933,141300,19559
3119,2562,557,1243,139900,19560
1170,681,489,707,147600,19562
61,30,31,-,171400,19564
3414,2642,772,890,178000,19565
1888,1442,446,904,147800,19567
11492,4030,7462,744,70700,19601
6312,2271,4041,685,46700,19602
7991,4058,3933,863,69700,19604
7490,6393,1097,928,147200,19605
13096,10427,2669,967,167400,19606
9559,6106,3453,947,150000,19607
8066,6604,1462,1166,217400,19608
3827,3031,796,1003,152500,19609
6351,4615,1736,1170,223900,19610
3826,1926,1900,712,109700,19611
14312,11136,3176,1338,262700,19701
19395,12507,6888,1214,229500,19702
5948,3247,2701,958,206300,19703
729,501,228,1025,186100,19706
5865,5298,567,1773,404300,19707
12241,10548,1693,1164,317400,19709
7,7,0,-,-,19710
18983,12409,6574,1116,289800,19711
12089,7655,4434,987,200400,19713
0,0,0,-,-,19716
0,0,0,-,-,19717
21657,14688,6969,1032,185900,19720
381,323,58,1232,325700,19730
117,117,0,-,163100,19731
36,17,19,-,-,19732
87,50,37,1257,-,19733
3783,3470,313,1475,303000,19734
16,0,16,-,-,19735
25,0,25,-,-,19736
5944,1544,4400,824,134900,19801
10111,5426,4685,916,145000,19802
8466,7269,1197,1313,341900,19803
7051,4970,2081,1014,191000,19804
15122,8083,7039,981,170600,19805
5110,2792,2318,1009,284700,19806
3032,2203,829,1277,785000,19807
15149,12165,2984,1094,248300,19808
6003,3922,2081,1078,228500,19809
9988,7918,2070,1058,316300,19810
13579,7269,6310,1072,175300,19901
0,0,0,-,-,19902
12145,8161,3984,1048,195400,19904
1193,1161,32,1375,555700,19930
106,91,15,-,190300,19931
3427,2720,707,664,202700,19933
4961,3936,1025,1406,223200,19934
96,81,15,-,-,19936
3081,2606,475,1090,220600,19938
2425,2224,201,1110,259200,19939
1985,1442,543,820,173500,19940
965,749,216,845,173100,19941
4653,3918,735,1089,195000,19943
343,289,54,1108,697900,19944
2534,1752,782,1033,233200,19945
1722,1293,429,1058,181100,19946
6181,4225,1956,830,210300,19947
2427,1900,527,949,199400,19950
681,594,87,1299,299200,19951
3788,2724,1064,854,202400,19952
1583,1298,285,803,195600,19953
605,500,105,648,198200,19954
15,11,4,-,212500,19955
5598,4144,1454,859,169300,19956
10530,8717,1813,1249,323600,19958
2237,1789,448,887,182000,19960
3926,3074,852,963,200200,19962
7953,5503,2450,872,196200,19963
385,315,70,819,214200,19964
11261,8746,2515,922,173600,19966
392,301,91,1194,279300,19967
4167,3298,869,1000,266800,19968
3452,2723,729,1185,326300,19970
6119,5008,1111,1163,387700,19971
9230,6692,2538,898,172300,19973
3872,2852,1020,1010,315600,19975
8581,6399,2182,940,223300,19977
206,170,36,965,168100,19979
18266,6257,12009,1684,585400,20001
25395,10355,15040,1375,539600,20002
12164,5700,6464,1788,695300,20003
1148,489,659,2509,535000,20004
8175,1813,6362,1801,506900,20005
668,22,646,1703,250000,20006
11870,6285,5585,1804,911500,20007
15357,5864,9493,1829,742500,20008
26999,9432,17567,1728,613400,20009
12762,4137,8625,1314,543800,20010
24372,12819,11553,1132,448500,20011
5898,3622,2276,1223,577700,20012
6468,4504,1964,1707,932700,20015
14069,9493,4576,1940,847600,20016
7794,4351,3443,1356,410300,20017
7861,4452,3409,898,410100,20018
23190,7584,15606,913,229900,20019
21310,5980,15330,998,268600,20020
7159,2869,4290,1461,353200,20024
14511,2798,11713,968,223900,20032
3969,1460,2509,1821,398200,20036
6828,2353,4475,2023,602500,20037
0,0,0,-,-,20045
0,0,0,-,-,20052
0,0,0,-,-,20053
0,0,0,-,-,20057
0,0,0,-,-,20064
5070,4602,468,2549,481400,20105
2059,1788,271,1175,348700,20106
12914,5579,7335,1466,238100,20109
14069,9097,4972,1369,300300,20110
9782,6845,2937,1487,298700,20111
8068,7641,427,2180,432000,20112
2282,1772,510,1139,390200,20115
1085,696,389,1042,548400,20117
2,0,2,-,-,20118
1545,1223,322,1241,348100,20119
13752,10373,3379,1788,448300,20120
9990,6063,3927,1709,359000,20121
4951,4516,435,2196,652200,20124
232,232,0,-,780300,20129
84,84,0,-,-,20130
5343,4354,989,1309,478800,20132
1199,1023,176,898,333100,20135
8785,7554,1231,2263,407700,20136
460,401,59,-,561300,20137
100,44,56,-,625000,20139
1972,1773,199,1839,422700,20141
375,342,33,-,671900,20143
405,331,74,935,629400,20144
21139,14991,6148,1735,471700,20147
13044,10535,2509,2016,564600,20148
6879,5589,1290,1623,487000,20151
9414,8130,1284,2162,507700,20152
11084,9435,1649,2004,443000,20155
1398,1283,115,1818,501400,20158
12436,9208,3228,1640,333300,20164
11470,9166,2304,1859,476300,20165
3452,2067,1385,1721,362200,20166
7185,6432,753,2500,497800,20169
13225,8856,4369,1808,452700,20170
16665,10310,6355,1837,575000,20171
10730,8214,2516,1459,450500,20175
16549,12198,4351,1542,464000,20176
2371,2064,307,1792,434900,20180
2654,2430,224,1537,428000,20181
341,186,155,-,668300,20184
5527,3742,1785,1193,360500,20186
5572,4907,665,1561,411800,20187
8702,4054,4648,1702,440800,20190
11567,7827,3740,1511,464800,20191
5601,3998,1603,1889,614000,20194
591,552,39,1341,669900,20197
1039,727,312,777,460400,20198
0,0,0,-,-,20202
0,0,0,-,-,20204
0,0,0,-,-,20228
0,0,0,-,-,20230
0,0,0,-,-,20240
0,0,0,-,-,20245
0,0,0,-,-,20260
0,0,0,-,-,20307
313,33,280,1755,-,20317
0,0,0,-,-,20319
0,0,0,-,-,20373
0,0,0,-,-,20390
0,0,0,-,-,20405
0,0,0,-,-,20418
0,0,0,-,-,20427
0,0,0,-,-,20506
0,0,0,-,-,20510
0,0,0,-,-,20520
0,0,0,-,-,20535
0,0,0,-,-,20540
0,0,0,-,-,20551
0,0,0,-,-,20553
0,0,0,-,-,20560
0,0,0,-,-,20565
0,0,0,-,-,20566
0,0,0,-,-,20593
8908,7072,1836,1756,271200,20601
9788,6076,3712,1385,232100,20602
10741,8082,2659,1800,296900,20603
232,185,47,-,279500,20606
3501,3292,209,1593,349300,20607
271,223,48,1048,307500,20608
450,326,124,932,283300,20609
492,393,99,1259,352500,20611
249,214,35,-,296400,20612
4744,4106,638,1536,331800,20613
161,161,0,-,358500,20615
2065,1825,240,1237,254700,20616
309,309,0,-,363600,20617
195,175,20,-,251400,20618
4504,2948,1556,1584,284500,20619
536,425,111,1694,243400,20620
366,303,63,-,334400,20621
1689,1466,223,881,335600,20622
908,829,79,2654,279400,20623
525,415,110,1294,271700,20624
309,267,42,1375,304400,20625
155,127,28,-,-,20626
98,84,14,-,597800,20628
131,95,36,-,558500,20629
111,111,0,-,387500,20630
119,101,18,-,268900,20632
2666,1646,1020,1174,257600,20634
3742,3243,499,1438,327100,20636
1766,1564,202,-,392800,20637
4843,4430,413,1810,417600,20639
3763,2874,889,1401,225800,20640
337,276,61,1858,308500,20645
6847,5472,1375,1200,341600,20646
5171,3874,1297,984,359900,20650
9079,4990,4089,1253,252200,20653
6649,5477,1172,1576,239500,20657
360,264,96,1389,238100,20658
7748,6834,914,1534,297800,20659
24,0,24,-,-,20660
1061,976,85,1120,291100,20662
1166,893,273,1463,271700,20664
214,131,83,-,274600,20667
404,15,389,1855,-,20670
287,210,77,1435,416700,20674
687,628,59,2316,305600,20675
1385,1074,311,1615,348600,20676
727,691,36,-,371800,20677
4408,3221,1187,1045,331000,20678
401,290,111,1134,335400,20680
433,309,124,1056,326600,20684
2220,1938,282,1647,340600,20685
43,43,0,-,-,20686
179,126,53,-,401600,20687
999,421,578,2085,458400,20688
654,648,6,-,381900,20689
318,281,37,-,423100,20690
520,458,62,-,382400,20692
408,351,57,-,357100,20693
2545,2273,272,1696,317600,20695
0,0,0,-,-,20701
8666,5499,3167,1463,286000,20705
12185,8121,4064,1425,260600,20706
12310,7131,5179,1431,274200,20707
9794,3534,6260,1349,307600,20708
3550,865,2685,1174,184800,20710
2413,2138,275,967,-,20711
3682,913,2769,1104,273300,20712
2012,1339,673,1598,273000,20714
8687,7904,783,2104,298000,20715
8377,5895,2482,1720,273500,20716
7390,6802,588,2302,365100,20720
9595,8424,1171,2032,367000,20721
1708,1217,491,1266,207000,20722
11233,7595,3638,1709,394100,20723
6651,4391,2260,1783,280200,20724
3419,2770,649,1532,314000,20732
1038,881,157,1844,315700,20733
12473,11083,1390,1987,273400,20735
2966,2735,231,1214,442100,20736
5798,2731,3067,1149,222900,20737
9481,4486,4995,1453,264400,20740
0,0,0,-,-,20742
14122,8747,5375,1196,195100,20743
18533,14558,3975,1461,276800,20744
10869,4574,6295,1211,210800,20745
11058,4514,6544,1287,198200,20746
14634,7851,6783,1192,194700,20747
14766,8165,6601,1237,229200,20748
873,795,78,1119,374600,20751
2426,2196,230,2500,428800,20754
2581,34,2547,2073,219600,20755
187,167,20,-,387800,20758
1365,1285,80,"3,500+",630700,20759
902,0,902,2213,-,20762
776,283,493,1551,306200,20763
1644,1412,232,1595,289000,20764
209,109,100,-,465000,20765
2175,2050,125,1223,408200,20769
10198,4269,5929,1424,184000,20770
15909,13067,2842,1810,282700,20772
16645,13035,3610,1725,281100,20774
1258,1117,141,1454,511600,20776
1089,1067,22,-,654600,20777
771,675,96,-,525000,20778
465,438,27,-,497100,20779
3853,2107,1746,1149,262400,20781
11434,4816,6618,1337,258800,20782
12761,5418,7343,1261,244100,20783
9710,5949,3761,1302,213400,20784
13757,6558,7199,1353,216800,20785
3510,2628,882,1487,286500,20794
101,90,11,3208,843800,20812
12818,6971,5847,1884,687000,20814
13014,8336,4678,1945,949800,20815
6163,5104,1059,2111,910500,20816
13162,10869,2293,1982,863100,20817
716,672,44,2115,857400,20818
8743,7683,1060,1589,459100,20832
2461,2342,119,2685,552600,20833
2020,1691,329,1803,485800,20837
105,100,5,-,690500,20838
32,12,20,-,-,20839
2956,2680,276,2703,576200,20841
678,582,96,895,587600,20842
18802,11053,7749,1876,578700,20850
4891,2864,2027,1631,341500,20851
20426,9281,11145,1832,490600,20852
9860,8281,1579,1218,445500,20853
16703,15348,1355,2696,902100,20854
4951,4271,680,1853,476600,20855
896,646,250,1417,640100,20860
563,563,0,-,688300,20861
116,107,9,-,667700,20862
4652,3578,1074,1878,310700,20866
233,233,0,-,755800,20868
5680,4893,787,2243,445800,20871
4332,3788,544,1461,375200,20872
21937,14136,7801,1585,299100,20874
8532,5769,2763,1705,353000,20876
12676,5456,7220,1469,333300,20877
22781,16101,6680,1692,543400,20878
8322,5594,2728,1625,292800,20879
202,186,16,1773,456900,20880
4449,4204,245,1756,552300,20882
11835,8120,3715,1459,280400,20886
6994,5572,1422,1707,588200,20895
326,314,12,-,761600,20896
120,10,110,647,-,20899
12514,8526,3988,1411,398000,20901
16672,10530,6142,1662,365700,20902
7178,2440,4738,1403,348400,20903
20908,11226,9682,1578,383500,20904
5872,5357,515,1740,466100,20905
25100,15964,9136,1619,315400,20906
19580,6432,13148,1616,536300,20910
9394,3926,5468,1199,467300,20912
9553,6201,3352,988,217900,21001
646,0,646,1771,-,21005
11214,9084,2130,1304,245500,21009
106,0,106,1702,-,21010
7446,6320,1126,1684,415800,21012
1701,1679,22,-,422400,21013
14098,10914,3184,1135,299300,21014
9864,8316,1548,1546,326500,21015
2668,1829,839,1376,206200,21017
1109,982,127,1150,374800,21028
3552,3258,294,2606,669100,21029
10022,4750,5272,1141,380000,21030
0,0,0,-,-,21031
3219,2832,387,1336,405500,21032
1297,1121,176,967,243500,21034
2767,2639,128,2939,621400,21035
778,725,53,-,732900,21036
7761,6785,976,2037,399900,21037
8802,5811,2991,1010,160000,21040
13496,11907,1589,1646,577200,21042
16569,11244,5325,1606,457000,21043
17558,10310,7248,1626,389700,21044
14712,10704,4008,1497,336300,21045
6318,4262,2056,1599,369100,21046
4187,3892,295,1067,370900,21047
3560,3353,207,969,360200,21048
6468,5678,790,1385,334200,21050
106,106,0,-,389500,21051
125,107,18,1400,281800,21052
1169,1101,68,1344,366800,21053
4003,3453,550,1745,372600,21054
82,82,0,-,1442300,21056
1581,1397,184,2150,432800,21057
12506,8964,3542,1188,246000,21060
21170,11152,10018,1220,239200,21061
220,220,0,-,327000,21071
5493,4576,917,906,278700,21074
10660,7465,3195,1644,326000,21075
6348,4500,1848,1996,366000,21076
195,195,0,-,300500,21077
7481,5346,2135,996,272100,21078
214,183,31,-,350000,21082
2652,2469,183,1005,372300,21084
6289,5223,1066,1133,257900,21085
1929,1886,43,-,395400,21087
3618,3138,480,1221,296600,21090
15467,12193,3274,1240,356500,21093
3922,3355,567,854,303100,21102
1511,1482,29,-,502900,21104
9,9,0,-,-,21105
6426,5246,1180,1616,412000,21108
1522,1355,167,1210,538500,21111
12876,8409,4467,1742,303900,21113
9769,7690,2079,1798,357000,21114
22422,12066,10356,1363,275500,21117
2489,2227,262,1200,438500,21120
21658,18536,3122,1556,303500,21122
4888,4253,635,1396,336800,21128
101,36,65,1261,-,21130
2581,2451,130,1010,527400,21131
849,799,50,1216,319300,21132
11413,7682,3731,1105,229500,21133
12577,9173,3404,1162,271900,21136
1254,1130,124,1806,465400,21140
11449,8632,2817,1408,348600,21144
9345,8523,822,1504,514800,21146
2207,1566,641,1212,390400,21152
104,98,6,-,1075000,21153
1968,1694,274,989,342100,21154
1022,786,236,1330,325600,21155
158,150,8,-,332100,21156
14068,10036,4032,985,301500,21157
7608,6014,1594,1325,308300,21158
986,788,198,965,320500,21160
1936,1764,172,1288,382100,21161
1321,1220,101,1283,353200,21162
2596,2329,267,1729,453200,21163
9281,1080,8201,1039,182000,21201
8302,1721,6581,924,214600,21202
7491,3665,3826,1519,436600,21204
5338,1797,3541,861,53500,21205
19215,11271,7944,910,152500,21206
18537,11294,7243,1049,179500,21207
14984,9402,5582,1330,252700,21208
11850,7001,4849,1203,286000,21209
5459,3181,2278,1244,422400,21210
7743,3894,3849,1124,201300,21211
13088,8733,4355,1004,278500,21212
11069,5740,5329,1017,96400,21213
7938,5868,2070,932,175200,21214
22069,10743,11326,934,122300,21215
10745,5077,5668,943,89700,21216
14759,4562,10197,820,117300,21217
18757,8893,9864,949,151800,21218
3455,2891,564,1025,266400,21219
15229,10190,5039,1129,192600,21220
16078,9034,7044,950,189300,21221
20758,13419,7339,1024,142200,21222
8917,2961,5956,896,69500,21223
19272,11160,8112,1246,192400,21224
12000,5632,6368,830,166200,21225
2702,1806,896,988,236900,21226
12167,7460,4707,1085,207400,21227
18386,13073,5313,1260,300500,21228
18079,9903,8176,947,126000,21229
14945,8069,6876,1372,231300,21230
7474,2905,4569,1170,273900,21231
29103,18064,11039,1189,211800,21234
15408,10497,4911,1204,237800,21236
11477,7215,4262,1142,215800,21237
11776,6353,5423,1056,146700,21239
0,0,0,-,-,21240
13744,6950,6794,1206,197800,21244
0,0,0,-,-,21250
0,0,0,-,-,21251
0,0,0,-,-,21252
7987,5093,2894,1194,303600,21286
16172,9972,6200,1581,438800,21401
247,23,224,2107,-,21402
12898,8032,4866,1531,404000,21403
161,161,0,-,885600,21405
7504,6540,964,1730,396300,21409
16328,10906,5422,627,119600,21502
774,606,168,939,206000,21520
577,467,110,605,93000,21521
79,70,9,-,144600,21522
93,93,0,-,89400,21523
246,169,77,889,160300,21524
225,194,31,-,110600,21529
650,555,95,790,159000,21530
850,643,207,552,166600,21531
5738,3475,2263,730,152100,21532
1528,1159,369,550,174000,21536
191,171,20,641,77000,21538
1007,726,281,526,88100,21539
42,25,17,703,34200,21540
590,482,108,685,252300,21541
304,195,109,550,74500,21542
42,42,0,-,152300,21543
783,666,117,710,101900,21545
5777,4301,1476,638,161500,21550
781,641,140,626,114500,21555
744,690,54,1017,134400,21557
999,897,102,1054,215200,21561
1196,924,272,646,88000,21562
10577,6805,3772,1019,299000,21601
210,174,36,1097,324400,21607
146,114,32,800,181300,21610
234,225,9,-,573400,21612
7426,3997,3429,826,190000,21613
3714,3062,652,1125,371200,21617
2450,1733,717,1563,324600,21619
4995,3238,1757,893,243600,21620
299,288,11,945,215800,21622
621,459,162,1121,293800,21623
55,40,15,-,291200,21624
952,812,140,1125,269400,21625
105,88,17,-,239300,21626
18,18,0,-,37500,21627
248,173,75,1210,-,21628
3540,2507,1033,1040,205300,21629
1001,881,120,1077,222300,21631
2359,1377,982,771,166500,21632
78,61,17,-,401600,21634
897,658,239,854,241300,21635
415,344,71,1232,200000,21636
1848,1507,341,1494,400900,21638
1574,1022,552,774,173300,21639
533,499,34,954,194400,21640
37,22,15,963,216700,21641
2064,1547,517,915,170000,21643
45,4,41,-,-,21644
398,346,52,731,287000,21645
70,61,9,-,438200,21647
88,69,19,-,196900,21648
572,440,132,1017,155600,21649
85,76,9,-,-,21650
1044,866,178,900,219000,21651
90,70,20,-,540300,21652
28,23,5,-,331800,21653
564,402,162,1000,555600,21654
1955,1601,354,1204,207900,21655
336,247,89,1507,316000,21657
1442,1238,204,1559,373900,21658
586,458,128,950,189800,21659
1385,946,439,888,212300,21660
1088,818,270,943,228400,21661
249,213,36,1229,625000,21662
1494,1131,363,987,478100,21663
229,177,52,956,136100,21664
148,129,19,-,512100,21665
4288,3689,599,1388,359700,21666
120,109,11,-,263500,21667
702,552,150,785,224100,21668
86,72,14,-,370600,21669
374,359,15,-,319800,21671
90,83,7,-,74200,21672
1275,861,414,1051,316700,21673
104,104,0,-,153400,21675
180,132,48,1210,291700,21676
190,177,13,-,282300,21677
699,584,115,1250,254100,21678
191,191,0,-,291000,21679
15288,9788,5500,1188,282700,21701
15324,9031,6293,1295,267600,21702
12588,8084,4504,1508,240900,21703
5116,4301,815,1582,413300,21704
0,0,0,-,-,21705
1733,1425,308,1779,398600,21710
326,215,111,761,201700,21711
3785,3075,710,778,256800,21713
64,35,29,-,332400,21714
1979,1371,608,932,180900,21716
11,11,0,-,-,21717
65,41,24,688,345000,21718
458,364,94,950,185600,21719
2052,1700,352,861,230600,21722
229,194,35,-,564500,21723
1723,1293,430,784,267900,21727
327,308,19,-,260000,21733
321,183,138,681,145200,21734
601,504,97,-,823000,21737
1100,1083,17,-,674500,21738
23074,12620,10454,790,167800,21740
13185,8120,5065,1051,217000,21742
0,0,0,-,-,21746
1542,1083,459,622,149300,21750
2139,1960,179,1388,443700,21754
2015,1825,190,1123,342200,21755
1368,1156,212,1042,288300,21756
1201,908,293,1170,269900,21757
1718,1459,259,1300,261200,21758
107,96,11,-,336200,21762
267,196,71,541,204900,21766
539,230,309,916,164800,21767
4042,3532,510,1181,381800,21769
1845,1772,73,1581,374200,21770
9803,8888,915,1622,397300,21771
1950,1823,127,956,340100,21773
4408,4061,347,1712,353000,21774
1963,1560,403,1046,297400,21776
556,516,40,-,344000,21777
406,348,58,1304,236800,21778
349,315,34,-,321900,21779
513,382,131,1137,245900,21780
15,15,0,-,-,21781
1551,1362,189,920,237900,21782
3301,2792,509,921,222600,21783
13596,11855,1741,1099,365500,21784
3899,3077,822,1062,269100,21787
4580,3482,1098,942,248700,21788
39,34,5,-,310000,21790
1958,1531,427,925,307300,21791
3554,2879,675,1302,285500,21793
912,848,64,3319,663700,21794
3756,2571,1185,919,198300,21795
2905,2581,324,1470,551100,21797
773,626,147,1339,307900,21798
10634,6230,4404,859,189700,21801
0,0,0,-,-,21802
14743,7793,6950,1073,165400,21804
208,164,44,-,246600,21810
9231,7483,1748,1195,253800,21811
978,910,68,-,317500,21813
165,73,92,-,230900,21814
2118,1366,752,561,112100,21817
443,379,64,797,106900,21821
846,655,191,958,152100,21822
62,54,8,-,-,21824
1923,1343,580,1210,165700,21826
221,179,42,-,196000,21829
1341,1160,181,892,154600,21830
211,122,89,911,303800,21835
1066,839,227,1144,173700,21837
627,540,87,836,134100,21838
213,116,97,-,290600,21840
348,240,108,957,204300,21841
5075,3751,1324,974,289200,21842
1402,1138,264,879,171000,21849
1013,793,220,1006,152100,21850
2848,1703,1145,818,159800,21851
3592,1860,1732,707,158000,21853
321,265,56,-,165400,21856
344,281,63,864,135600,21861
62,11,51,-,-,21862
1815,1274,541,687,176200,21863
273,180,93,-,158300,21864
240,226,14,-,431500,21865
24,24,0,-,100000,21866
15,15,0,-,-,21867
363,265,98,770,168800,21869
795,599,196,624,146900,21871
260,154,106,675,203400,21872
912,690,222,1112,161900,21874
2350,1542,808,1074,176000,21875
0,0,0,-,-,21890
6632,4877,1755,1117,252100,21901
0,0,0,-,-,21902
2367,1419,948,878,218400,21903
2404,2039,365,778,238000,21904
3588,2757,831,955,241100,21911
358,213,145,-,395800,21912
413,201,212,769,167200,21913
297,198,99,950,234800,21914
1202,923,279,1087,264500,21915
0,0,0,-,-,21916
914,780,134,1087,235000,21917
1428,1315,113,1151,237600,21918
1238,1094,144,1194,256200,21919
150,131,19,-,202700,21920
15919,10953,4966,1073,234600,21921
83,35,48,-,-,21930
19190,12838,6352,1639,508400,22003
14808,12006,2802,2042,471200,22015
6125,5261,864,2084,357800,22025
4656,2799,1857,1458,284500,22026
681,625,56,-,830300,22027
19367,11836,7531,1812,533800,22030
11945,5838,6107,1891,530400,22031
9713,8336,1377,2259,562800,22032
15232,9237,5995,1834,466500,22033
0,0,0,-,-,22035
5870,5552,318,3484,777900,22039
10627,4551,6076,1519,369500,22041
11998,7662,4336,1720,457400,22042
9281,5198,4083,1799,584500,22043
5489,2585,2904,1389,547700,22044
6588,4725,1863,1493,671700,22046
2791,305,2486,2632,549000,22060
5880,5612,268,3148,1070400,22066
11367,7687,3680,1850,452100,22079
10643,8842,1801,2928,974200,22101
10342,5643,4699,1841,834300,22102
6751,5671,1080,1857,742500,22124
343,228,115,1921,353300,22125
1545,39,1506,1659,181300,22134
8820,5409,3411,1808,421000,22150
5565,4659,906,1979,430600,22151
10398,8391,2007,2112,441200,22152
10207,8531,1676,2206,487800,22153
3344,1592,1752,1028,410300,22172
8462,6273,2189,1870,647300,22180
5233,4136,1097,1965,704400,22181
8881,6932,1949,2005,829200,22182
0,0,0,-,-,22185
21450,12154,9296,1543,273400,22191
19766,14315,5451,1676,313300,22192
23333,17572,5761,1611,289000,22193
18267,6428,11839,2065,618500,22201
12767,3156,9611,2038,623200,22202
11136,3872,7264,1970,576200,22203
21576,8595,12981,1473,466800,22204
6698,5122,1576,1700,758800,22205
10321,4816,5505,1876,424800,22206
11630,9406,2224,1870,875800,22207
7169,2411,4758,1827,567400,22209
89,0,89,1828,-,22211
1333,889,444,2613,666600,22213
0,0,0,-,-,22214
5221,3486,1735,1697,714400,22301
8349,4240,4109,1713,414300,22302
6829,3071,3758,1650,361500,22303
21248,8547,12701,1553,339400,22304
6529,2450,4079,1543,586400,22305
11551,5000,6551,1380,413800,22306
4517,3506,1011,1715,518600,22307
4564,4118,446,2909,651200,22308
11384,7181,4203,1409,391100,22309
11386,8821,2565,1990,436400,22310
7882,1291,6591,1488,480400,22311
11171,5459,5712,1623,429300,22312
16570,8013,8557,1893,637300,22314
10597,7536,3061,2098,445800,22315
10271,3575,6696,1096,321500,22401
10175,7872,2303,1441,271000,22405
8120,5898,2222,1237,340200,22406
19536,14321,5215,1359,248000,22407
9454,7031,2423,1378,261000,22408
1129,731,398,974,196500,22427
188,94,94,-,195800,22432
151,118,33,-,174400,22433
1202,1008,194,802,135300,22435
372,322,50,-,167400,22436
369,310,59,-,132800,22437
67,53,14,-,208000,22438
3484,2562,922,1022,225100,22443
150,0,150,1523,-,22448
738,515,223,811,158400,22454
663,503,160,836,138000,22460
528,468,60,713,100000,22469
2230,1932,298,546,246200,22473
260,213,47,789,172200,22476
432,245,187,924,335900,22480
1566,1105,461,549,258300,22482
8529,6359,2170,1039,287700,22485
503,419,84,-,169800,22488
1785,1459,326,887,198900,22503
97,91,6,-,324100,22504
5169,4764,405,1346,256500,22508
10,10,0,-,-,22509
529,446,83,1023,285400,22511
1044,745,299,870,201400,22514
2465,1937,528,1013,195700,22520
108,88,20,-,"10,000-",22529
18,10,8,-,-,22530
1004,855,149,1155,213400,22534
211,143,68,777,193100,22535
61,61,0,-,156000,22538
1116,1067,49,419,376300,22539
773,682,91,1109,209700,22542
6164,4946,1218,1216,188700,22546
99,64,35,-,-,22548
6729,5939,790,1194,240400,22551
4591,3557,1034,1474,282400,22553
16979,12524,4455,1565,330800,22554
9037,7036,2001,1569,311900,22556
2407,1592,815,831,172200,22560
1054,909,145,1138,220600,22567
2244,1614,630,804,163500,22572
735,602,133,794,225600,22576
1144,916,228,889,296900,22578
32,32,0,-,-,22579
1999,1541,458,987,182000,22580
11113,5214,5899,946,211800,22601
10260,7989,2271,1133,247000,22602
5446,4328,1118,1157,215100,22603
701,644,57,-,250800,22610
3295,2320,975,1018,328200,22611
998,732,266,1267,339200,22620
243,233,10,-,198200,22623
962,701,261,1144,258300,22624
1463,1247,216,1164,225300,22625
305,224,81,966,452900,22627
11662,8377,3285,930,223700,22630
803,704,99,444,235800,22637
226,156,70,1449,733300,22639
246,211,35,-,569400,22640
179,173,6,-,206400,22641
1584,1454,130,1033,213200,22642
54,54,0,-,-,22643
867,729,138,740,191300,22644
1540,1248,292,725,251600,22645
97,97,0,-,474000,22646
308,234,74,546,202800,22650
513,459,54,1063,269900,22652
524,454,70,-,278700,22654
7374,5613,1761,1098,213100,22655
1049,863,186,1162,251100,22656
4155,2842,1313,934,191700,22657
878,628,250,734,187700,22660
567,356,211,629,329800,22663
3494,2240,1254,746,224200,22664
11946,7784,4162,1051,231300,22701
383,294,89,723,229600,22709
18,18,0,-,-,22711
2746,2068,678,1165,252400,22712
531,436,95,1164,247700,22713
304,271,33,872,314400,22714
509,380,129,-,254800,22715
466,361,105,744,446600,22716
245,220,25,-,246700,22718
135,97,38,723,320600,22719
334,328,6,-,373100,22720
134,122,12,-,298600,22722
20,20,0,-,-,22723
755,700,55,1825,326000,22724
234,195,39,1153,194000,22726
1984,1303,681,808,229200,22727
1139,943,196,1060,342100,22728
30,30,0,-,-,22729
51,17,34,-,-,22730
27,14,13,-,-,22731
84,84,0,-,224200,22732
568,483,85,1080,334600,22733
1154,806,348,1069,240700,22734
930,859,71,1330,291000,22735
251,239,12,-,219400,22736
1071,736,335,1155,269100,22737
431,299,132,631,380200,22738
553,346,207,1096,289600,22740
40,28,12,-,330000,22741
626,558,68,1306,276600,22742
103,90,13,-,269700,22743
535,370,165,790,400000,22747
129,83,46,1069,474000,22749
12862,5963,6899,909,246000,22801
11103,5602,5501,770,183500,22802
3,3,0,-,-,22807
368,266,102,639,204500,22810
210,185,25,-,156300,22811
3165,2190,975,823,206900,22812
3395,2528,867,654,189500,22815
117,106,11,-,-,22820
1999,1538,461,645,197700,22821
2503,1911,592,601,198100,22824
4146,3247,899,789,165600,22827
681,551,130,844,140000,22830
372,270,102,718,169200,22831
518,411,107,1101,218800,22832
397,361,36,-,206300,22834
4567,3220,1347,695,189300,22835
1726,1295,431,1050,234300,22840
1176,929,247,833,248000,22841
2085,1476,609,799,166200,22842
884,745,139,779,229900,22843
1968,1280,688,729,201700,22844
10,10,0,-,-,22845
781,619,162,1103,302500,22846
359,304,55,770,251600,22847
2016,1506,510,759,151700,22849
331,261,70,825,211800,22850
2422,1577,845,659,152000,22851
1711,1008,703,728,159200,22853
14097,8029,6068,1144,317900,22901
9693,4890,4803,1043,258700,22902
14519,6266,8253,1082,347200,22903
31,14,17,1163,-,22904
7057,4576,2481,1218,297000,22911
1604,1264,340,568,265800,22920
789,614,175,906,171900,22922
2027,1466,561,1274,285600,22923
131,107,24,950,261700,22931
3185,2342,843,1163,321300,22932
356,224,132,1610,-,22935
1932,1724,208,1003,363600,22936
632,492,140,1091,168300,22937
610,362,248,917,230000,22938
1968,1269,699,1255,246000,22939
498,330,168,1227,290300,22940
3463,2606,857,876,220600,22942
150,94,56,-,253600,22943
104,83,21,-,-,22946
1722,1299,423,994,554700,22947
79,79,0,-,477600,22948
552,344,208,285,161900,22949
938,735,203,942,212200,22952
1146,965,181,-,425000,22958
587,489,98,969,282800,22959
4116,2647,1469,818,198500,22960
6171,4860,1311,1336,223400,22963
57,46,11,-,-,22964
720,537,183,927,214800,22967
3674,3093,581,637,235900,22968
381,304,77,774,247100,22969
704,479,225,-,192400,22971
140,95,45,-,"2,000,000+",22972
2450,1773,677,907,219900,22973
1829,1511,318,1113,289400,22974
179,71,108,705,350000,22976
13199,8760,4439,815,173500,22980
0,0,0,-,-,22989
3647,3118,529,662,187900,23002
303,258,45,-,81300,23004
6032,4051,1981,972,243000,23005
2253,1946,307,1322,218000,23009
433,364,69,-,296900,23011
1480,1257,223,964,248800,23015
99,99,0,-,426000,23021
452,365,87,-,164100,23022
242,204,38,-,-,23023
3352,2879,473,1026,211500,23024
66,66,0,-,-,23025
558,444,114,-,145500,23027
1957,1610,347,816,162600,23030
125,87,38,-,289100,23032
510,366,144,1140,290000,23035
766,595,171,990,167900,23038
449,380,69,842,255300,23039
1708,1400,308,720,136600,23040
823,664,159,1059,320900,23043
48,48,0,-,-,23045
767,629,138,1053,282000,23047
264,259,5,-,-,23050
359,242,117,1161,213600,23055
190,160,30,-,450000,23056
11974,8876,3098,1395,375500,23059
13312,10066,3246,1201,250400,23060
7977,6483,1494,884,224100,23061
1155,580,575,891,216900,23062
1623,1300,323,1088,189400,23063
122,85,37,-,212700,23064
758,658,100,969,190600,23065
190,160,30,-,225000,23066
165,152,13,-,189000,23068
1029,875,154,952,248400,23069
178,178,0,-,334300,23070
717,639,78,790,296500,23071
4687,3631,1056,906,228400,23072
3902,2290,1612,944,131900,23075
329,269,60,965,244000,23076
161,117,44,739,225000,23079
704,544,160,711,132200,23083
654,555,99,1125,193800,23084
211,185,26,-,119600,23085
1242,1165,77,1139,190100,23086
2046,1696,350,1069,247400,23089
75,62,13,-,186100,23091
265,232,33,778,242900,23092
4813,3552,1261,866,181500,23093
1098,1013,85,1303,272700,23102
1998,1864,134,1174,482200,23103
340,242,98,-,186900,23106
117,95,22,-,199000,23108
1082,877,205,682,196500,23109
267,177,90,-,205800,23110
14220,11284,2936,1121,229100,23111
18231,14050,4181,1260,231800,23112
9378,7682,1696,1285,401200,23113
6769,5460,1309,1338,278200,23114
99,79,20,-,99800,23115
9903,8767,1136,1225,290200,23116
3528,2834,694,1002,242200,23117
213,194,19,-,402000,23119
2413,2271,142,925,366500,23120
782,647,135,721,120600,23123
1422,1178,244,797,240200,23124
81,72,9,-,187000,23125
91,43,48,871,318400,23126
399,287,112,861,276500,23128
169,111,58,-,463300,23129
57,33,24,-,-,23130
186,179,7,-,207600,23138
9107,7970,1137,935,247500,23139
2260,2018,242,768,213800,23140
2581,2149,432,1057,240600,23141
1267,1067,200,1042,322800,23146
788,585,203,853,138500,23148
1107,770,337,753,215000,23149
4896,3713,1183,952,158400,23150
448,362,86,861,273300,23153
635,532,103,1009,158800,23156
0,0,0,-,-,23160
83,74,9,-,176900,23161
46,38,8,-,-,23163
2440,1911,529,1511,285200,23168
489,414,75,739,231900,23169
0,0,0,-,-,23173
834,620,214,547,237400,23175
228,228,0,-,144300,23176
202,178,24,-,146900,23177
174,159,15,-,186600,23180
2267,1703,564,895,208300,23181
17562,12190,5372,1147,317100,23185
0,0,0,-,-,23187
16719,12251,4468,1262,306600,23188
2512,2256,256,969,269500,23192
2124,185,1939,891,285500,23219
13311,4130,9181,993,242600,23220
7412,3509,3903,1058,355500,23221
9698,5062,4636,904,122200,23222
20717,8907,11810,886,148400,23223
13624,4897,8727,861,109200,23224
18530,7705,10825,894,199700,23225
6898,4956,1942,1260,317300,23226
11806,6010,5796,820,224500,23227
15016,7363,7653,1017,163800,23228
12660,8844,3816,982,287600,23229
2714,1515,1199,977,181800,23230
14118,9360,4758,951,177200,23231
11876,7758,4118,1278,323300,23233
15493,8846,6647,956,157700,23234
12645,9033,3612,1200,215400,23235
9875,8448,1427,1212,204200,23236
8062,5824,2238,993,161400,23237
10888,6844,4044,1100,272400,23238
0,0,0,-,-,23250
7427,2372,5055,1093,194600,23294
555,347,208,632,141100,23301
62,14,48,-,-,23302
431,346,85,-,175200,23303
18,18,0,-,-,23304
369,262,107,1023,208800,23306
198,81,117,727,-,23307
806,645,161,871,86100,23308
1833,1285,548,837,164700,23310
43,7,36,-,-,23313
2934,2087,847,1243,267500,23314
580,498,82,-,211900,23315
183,117,66,927,180900,23316
22034,13240,8794,1312,243700,23320
12476,9139,3337,1141,249000,23321
19758,17060,2698,1567,327300,23322
12845,9996,2849,1130,238100,23323
8728,4099,4629,937,162700,23324
6769,4354,2415,1061,193100,23325
1382,1052,330,870,222500,23336
247,156,91,-,209400,23337
203,114,89,928,151500,23347
1543,941,602,684,136100,23350
97,63,34,-,378800,23354
509,342,167,1309,195800,23356
419,295,124,-,216400,23357
32,10,22,-,-,23358
353,192,161,705,130100,23359
50,50,0,-,-,23389
182,182,0,-,-,23395
21,21,0,-,-,23398
118,95,23,686,-,23401
456,434,22,"3,500+",231100,23405
175,120,55,-,75100,23407
25,8,17,-,-,23408
43,21,22,-,-,23409
970,771,199,717,139900,23410
422,290,132,688,187500,23413
39,39,0,-,134400,23414
716,441,275,766,115600,23415
202,94,108,-,38300,23416
1632,1183,449,721,237600,23417
337,213,124,673,158200,23418
1135,721,414,726,113900,23420
1634,949,685,724,113200,23421
54,34,20,-,242500,23422
188,172,16,-,185600,23423
65,58,7,-,79200,23426
108,88,20,675,111100,23427
6961,5564,1397,964,262100,23430
494,426,68,900,317800,23432
542,476,66,1144,327000,23433
17862,10930,6932,975,208700,23434
10191,7868,2323,1297,273100,23435
346,334,12,-,339000,23436
1629,1367,262,820,193100,23437
651,565,86,754,231700,23438
213,203,10,-,93100,23440
63,18,45,922,-,23441
498,298,200,569,89700,23442
20222,9831,10391,1194,418400,23451
22586,13925,8661,1213,238400,23452
12074,8129,3945,1202,227800,23453
22431,14135,8296,1249,286600,23454
19756,11858,7898,1312,276900,23455
17013,14657,2356,1801,321500,23456
1628,1352,276,1108,359200,23457
254,0,254,1658,-,23459
0,0,0,-,-,23460
0,0,0,-,-,23461
24608,13120,11488,1259,199000,23462
26926,18815,8111,1304,247200,23464
169,137,32,829,107700,23480
51,51,0,-,160100,23486
2229,1730,499,871,164500,23487
63,57,6,-,-,23488
7698,3843,3855,1089,193400,23502
13680,5457,8223,962,186700,23503
7554,2437,5117,757,173300,23504
12231,4178,8053,947,211100,23505
3505,1269,2236,1234,393300,23507
5942,2836,3106,1070,301100,23508
5045,2937,2108,1054,170900,23509
3265,748,2517,1124,375500,23510
161,8,153,1665,-,23511
11494,5663,5831,1014,152100,23513
2392,557,1835,965,234100,23517
11795,6427,5368,1024,211300,23518
2605,1036,1569,787,162300,23523
0,0,0,-,-,23551
10515,5367,5148,894,191600,23601
15628,8834,6794,1075,206600,23602
1351,505,846,1129,174100,23603
700,13,687,1598,-,23604
5723,2737,2986,918,141700,23605
11394,5406,5988,996,245200,23606
8524,3271,5253,788,115700,23607
16752,8564,8188,1030,186500,23608
198,0,198,2397,-,23651
5472,3430,2042,1019,157200,23661
4584,3804,780,1140,302200,23662
5045,2876,2169,1031,145300,23663
4040,2545,1495,1144,214600,23664
1305,12,1293,1626,-,23665
21403,11349,10054,1025,197200,23666
15949,9410,6539,997,194600,23669
1371,686,685,780,252300,23690
25,5,20,-,-,23691
7164,5731,1433,1333,317000,23692
8335,6168,2167,1413,343500,23693
1400,1213,187,1802,344300,23696
9038,6011,3027,1014,163400,23701
4422,1860,2562,925,135000,23702
10014,6547,3467,1093,204100,23703
7396,2785,4611,912,150900,23704
5970,2617,3353,857,165200,23707
0,0,0,-,-,23708
0,0,0,-,-,23709
1268,26,1242,1549,203600,23801
15120,7817,7303,870,134900,23803
7507,4543,2964,925,154700,23805
0,0,0,-,-,23806
650,545,105,656,109000,23821
2680,1630,1050,782,108700,23824
590,372,218,634,106300,23827
78,49,29,730,108800,23828
443,355,88,438,155600,23829
436,378,58,562,234400,23830
13533,9250,4283,1136,215900,23831
11418,9860,1558,1238,210300,23832
1045,855,190,835,179000,23833
9757,6314,3443,957,171800,23834
4624,3456,1168,1354,222900,23836
1881,1149,732,780,183800,23837
5467,5111,356,1164,315700,23838
292,249,43,800,175200,23839
857,714,143,536,129400,23840
1366,1064,302,777,160500,23841
2374,2020,354,785,207600,23842
293,236,57,-,153000,23843
254,142,112,924,104800,23844
225,209,16,-,278300,23845
369,328,41,-,143400,23846
5091,2970,2121,688,101600,23847
360,313,47,-,116500,23850
5470,3249,2221,833,161100,23851
356,271,85,-,93400,23856
190,142,48,-,-,23857
10575,5969,4606,827,137900,23860
792,648,144,933,199300,23866
934,763,171,900,98500,23867
2107,1332,775,583,105000,23868
1049,780,269,848,161800,23872
395,263,132,962,116600,23874
4040,2643,1397,1116,205200,23875
194,175,19,-,202900,23876
413,270,143,619,200000,23878
282,234,48,530,75600,23879
766,502,264,710,149700,23881
959,744,215,656,123000,23882
1055,921,134,868,184300,23883
26,26,0,-,165900,23884
1011,804,207,923,219300,23885
226,134,92,1033,241700,23887
1090,555,535,792,116700,23888
255,189,66,711,83100,23889
1519,999,520,855,140300,23890
2,2,0,-,-,23891
95,64,31,-,-,23893
164,132,32,-,179800,23894
325,220,105,875,180400,23897
766,704,62,-,219800,23898
135,100,35,827,154500,23899
5552,3107,2445,806,153500,23901
0,0,0,-,-,23909
215,174,41,617,98000,23915
1201,934,267,398,132800,23917
1033,901,132,950,200900,23919
1594,1220,374,821,109200,23920
861,590,271,626,118300,23921
1013,625,388,764,141500,23922
959,782,177,650,132000,23923
2284,1662,622,507,109200,23924
1803,1445,358,642,169400,23927
2240,1579,661,766,144600,23930
169,135,34,-,92200,23934
2291,1765,526,643,130500,23936
756,431,325,615,87000,23937
143,95,48,-,75800,23938
572,537,35,-,154500,23942
35,35,0,-,-,23943
1558,1051,507,709,110300,23944
1500,935,565,546,101800,23947
1328,879,449,814,102300,23950
92,83,9,-,163300,23952
617,476,141,723,110500,23954
1272,906,366,753,144200,23958
447,327,120,436,101600,23959
715,577,138,1014,130000,23960
193,147,46,-,125500,23962
45,37,8,-,-,23963
438,353,85,655,83400,23964
954,654,300,643,126300,23966
510,363,147,587,89000,23967
325,261,64,-,114600,23968
3064,1770,1294,757,119000,23970
1726,1189,537,636,108600,23974
44,15,29,-,-,23976
217,38,179,944,1000000,24011
12374,7323,5051,748,133300,24012
3018,1377,1641,722,82000,24013
7706,5072,2634,786,175400,24014
7135,4015,3120,730,171400,24015
4163,1033,3130,730,122700,24016
9649,5076,4573,763,108900,24017
16179,10957,5222,916,215900,24018
10938,8817,2121,972,178100,24019
8,0,8,-,-,24020
1323,1030,293,678,131000,24053
2664,2103,561,550,87500,24054
5386,3923,1463,533,88800,24055
67,52,15,-,-,24058
338,264,74,-,224600,24059
18357,7044,11313,935,283900,24060
1930,1552,378,737,180700,24064
2711,2220,491,804,188100,24065
2140,1716,424,690,150500,24066
995,758,237,732,143600,24067
811,692,119,699,109500,24069
481,371,110,743,204700,24070
516,391,125,559,179000,24072
12830,8505,4325,787,178100,24073
452,312,140,587,187500,24076
383,324,59,838,157100,24077
3096,1934,1162,652,117100,24078
835,627,208,563,122700,24079
133,106,27,-,164800,24082
1293,969,324,904,264000,24083
4446,3323,1123,637,134300,24084
837,751,86,565,127800,24085
112,72,40,-,68700,24086
1647,1347,300,618,109800,24087
1567,1244,323,677,121400,24088
1237,846,391,685,82400,24089
1978,1696,282,964,262600,24090
2843,2226,617,538,167800,24091
1324,935,389,647,131400,24092
67,49,18,542,184200,24093
1935,1635,300,930,165300,24095
2487,2148,339,901,239400,24101
735,619,116,343,137700,24102
1485,1200,285,731,255900,24104
201,93,108,-,-,24105
13430,8883,4547,597,93800,24112
705,545,160,728,109900,24120
4412,3827,585,844,255900,24121
718,693,25,-,134200,24122
1944,1448,496,755,92200,24124
1891,1317,574,519,154400,24127
841,740,101,764,162300,24128
10,10,0,-,-,24130
27,0,27,-,-,24131
246,85,161,-,126000,24132
1163,991,172,545,90500,24133
2199,1628,571,574,100500,24134
1415,1087,328,710,117200,24136
1167,1011,156,529,173000,24137
657,562,95,-,173700,24138
240,240,0,-,160300,24139
8803,5007,3796,764,163300,24141
0,0,0,-,-,24142
654,433,221,559,113800,24147
3298,2630,668,577,108700,24148
1406,1205,201,-,215300,24149
329,305,24,-,88700,24150
8024,5681,2343,638,140000,24151
14901,10725,4176,844,180500,24153
227,156,71,712,121600,24161
747,513,234,689,165700,24162
627,466,161,477,111800,24165
172,139,33,-,96800,24167
71,41,30,-,-,24168
3642,2683,959,534,112100,24171
1169,1019,150,729,115700,24174
3194,2854,340,911,235600,24175
650,616,34,-,374400,24176
7546,5382,2164,701,162800,24179
1918,1701,217,686,184100,24184
286,239,47,-,133200,24185
7360,4232,3128,661,108300,24201
4983,4239,744,649,135500,24202
7531,4898,2633,618,134100,24210
4195,3438,757,649,202400,24211
1088,706,382,605,52800,24216
153,94,59,-,53300,24217
4181,2857,1324,672,102500,24219
225,208,17,-,80000,24220
253,226,27,-,73700,24221
2398,1832,566,547,82400,24224
660,603,57,705,80600,24225
562,438,124,655,77100,24226
2746,2113,633,559,71600,24228
3426,2243,1183,594,78800,24230
1343,957,386,620,103000,24236
398,259,139,690,-,24237
67,67,0,-,-,24239
792,590,202,559,114300,24243
2255,1666,589,346,75400,24244
392,260,132,403,77500,24245
219,137,82,-,85900,24246
1003,766,237,427,77000,24248
634,582,52,821,78700,24250
3440,2770,670,531,100100,24251
1381,911,470,394,83500,24256
744,534,210,521,89600,24258
2219,1865,354,573,81100,24260
2486,1657,829,505,83800,24263
261,191,70,619,39800,24265
3657,2701,956,519,120900,24266
110,92,18,630,-,24269
254,150,104,-,79400,24270
1079,741,338,498,96300,24271
186,115,71,-,77300,24272
2882,1624,1258,571,84500,24273
2238,1522,716,509,77500,24277
1821,1398,423,617,85000,24279
355,344,11,-,156600,24280
1126,877,249,563,66700,24281
237,144,93,452,-,24282
925,689,236,437,89600,24283
841,588,253,582,110400,24290
181,148,33,-,101700,24292
3766,2670,1096,701,109800,24293
6071,3953,2118,561,107900,24301
835,610,225,695,84700,24311
904,692,212,696,107000,24312
311,222,89,-,51300,24313
669,507,162,750,88600,24314
1145,905,240,567,105700,24315
0,0,0,-,-,24316
1650,1363,287,573,100600,24317
388,361,27,-,119000,24318
2805,2113,692,598,102900,24319
80,63,17,-,77500,24322
310,259,51,-,119900,24323
813,647,166,710,141500,24324
408,294,114,-,131800,24325
573,514,59,-,88800,24326
847,702,145,503,110300,24328
1385,1034,351,503,85300,24330
7235,5033,2202,577,100800,24333
2184,1735,449,663,109100,24340
3792,2766,1026,509,119200,24343
664,554,110,662,177200,24347
1701,1249,452,432,93100,24348
446,397,49,561,70900,24350
279,178,101,460,58200,24351
403,375,28,-,114500,24352
6172,3941,2231,564,92700,24354
2287,1784,503,652,111700,24360
1829,1577,252,707,112700,24361
627,558,69,425,106700,24363
279,251,28,-,127800,24366
2102,1615,487,604,121900,24368
2509,1963,546,509,75000,24370
312,224,88,666,88600,24374
644,446,198,520,76700,24375
118,102,16,-,107500,24377
580,506,74,606,88300,24378
1100,907,193,431,120800,24380
1784,1449,335,523,117200,24381
6167,4101,2066,615,151500,24382
15113,9878,5235,782,179800,24401
27,27,0,-,-,24411
25,25,0,-,-,24412
76,65,11,-,-,24413
35,35,0,-,-,24415
3515,2328,1187,713,117200,24416
1686,1423,263,847,219800,24421
2679,1945,734,631,98800,24422
6032,4780,1252,634,96400,24426
692,431,261,533,122000,24430
908,748,160,-,142200,24431
137,103,34,-,-,24432
41,41,0,-,-,24433
844,697,147,632,254800,24435
486,435,51,-,272200,24437
501,390,111,479,162700,24439
1141,904,237,1086,165500,24440
2516,1852,664,716,166000,24441
61,52,9,-,128900,24442
1278,846,432,491,129500,24445
136,118,18,750,65400,24448
5892,4032,1860,789,237000,24450
85,70,15,-,-,24457
209,197,12,-,149600,24458
204,204,0,-,204300,24459
570,439,131,391,170000,24460
130,110,20,-,-,24464
704,572,132,706,207300,24465
720,689,31,525,231700,24467
580,467,113,825,200800,24471
852,642,210,548,241000,24472
373,305,68,674,221900,24473
191,145,46,558,73600,24474
81,81,0,-,205400,24476
4347,3236,1111,886,199000,24477
536,445,91,996,240300,24479
1729,1399,330,855,174000,24482
235,235,0,-,94000,24483
381,303,78,-,107600,24484
76,76,0,-,107500,24485
1416,996,420,1087,184400,24486
123,90,33,-,164300,24487
10164,4820,5344,692,102100,24501
16465,8908,7557,852,157300,24502
7633,5500,2133,823,238500,24503
3694,2088,1606,657,109200,24504
2215,1426,789,675,137300,24517
1016,800,216,555,94800,24520
4099,3257,842,658,168700,24521
3891,2988,903,689,147500,24522
8018,5653,2365,690,165900,24523
474,425,49,495,98900,24526
1195,897,298,569,117000,24527
1348,948,400,629,104100,24528
688,499,189,1050,138500,24529
546,356,190,568,100700,24530
3783,2865,918,593,116300,24531
592,409,183,461,113000,24534
114,114,0,-,163800,24536
1958,1789,169,549,155800,24538
90,56,34,-,-,24539
13798,8576,5222,618,99600,24540
12151,6921,5230,605,110300,24541
1688,1293,395,681,102800,24549
3129,2811,318,698,165800,24550
8863,7491,1372,780,235600,24551
746,581,165,933,99100,24553
1690,1276,414,548,119600,24554
827,583,244,638,119500,24555
1161,956,205,838,221200,24556
3396,2627,769,529,90400,24557
2667,2024,643,704,119700,24558
143,143,0,-,110900,24562
2382,1750,632,578,99100,24563
388,314,74,486,96300,24565
541,458,83,480,85500,24566
459,361,98,653,109300,24569
16,0,16,-,-,24570
825,656,169,643,159200,24571
6397,4693,1704,741,140200,24572
1543,1257,286,825,154300,24574
2060,1470,590,568,86100,24577
413,326,87,900,201800,24578
683,565,118,1091,99400,24579
168,118,50,-,89100,24580
33,33,0,-,-,24581
2169,1727,442,840,121200,24586
3429,2860,569,657,140400,24588
884,724,160,471,147600,24589
3121,2338,783,931,197600,24590
5505,3540,1965,587,115200,24592
592,429,163,673,159500,24593
662,443,219,679,103800,24594
28,12,16,-,-,24595
491,396,95,-,109800,24597
712,542,170,541,121700,24598
282,197,85,832,110600,24599
33,33,0,-,-,24601
494,442,52,-,79400,24602
398,371,27,-,60400,24603
201,115,86,526,43000,24604
3581,2766,815,607,99000,24605
66,58,8,-,-,24606
186,149,37,-,95000,24607
2920,2218,702,621,100100,24609
80,80,0,-,65800,24612
220,161,59,-,56900,24613
2901,2223,678,628,78900,24614
1290,1110,180,526,68200,24620
400,318,82,594,61500,24622
131,131,0,-,66600,24628
2800,2017,783,606,90400,24630
798,464,334,615,68300,24631
240,208,32,290,68700,24634
212,136,76,-,43800,24635
1572,1366,206,698,128900,24637
1235,906,329,657,66900,24639
2536,1662,874,604,86200,24641
273,212,61,330,38300,24646
1306,961,345,600,84900,24649
2467,1792,675,571,117500,24651
1274,1052,222,530,71400,24656
159,118,41,709,72900,24657
8357,5861,2496,588,69700,24701
565,438,127,638,122700,24712
103,78,25,-,82800,24714
207,162,45,569,63000,24715
221,210,11,-,-,24716
32,32,0,-,-,24719
20,12,8,-,-,24724
150,123,27,-,128000,24726
105,63,42,-,-,24729
106,91,15,-,-,24731
321,280,41,-,88000,24733
202,175,27,556,65000,24736
52,14,38,-,-,24737
99,85,14,-,106000,24738
13047,9484,3563,609,106600,24740
1013,792,221,485,70800,24747
1428,1029,399,428,48200,24801
277,219,58,519,37500,24808
253,188,65,-,34400,24811
154,140,14,-,-,24813
264,211,53,525,29200,24815
135,121,14,-,-,24816
311,237,74,574,53400,24817
376,351,25,-,47600,24818
255,201,54,633,55700,24822
145,137,8,-,68800,24823
44,44,0,-,-,24826
532,444,88,515,45900,24827
310,238,72,419,19100,24828
56,53,3,-,28800,24830
80,73,7,-,52200,24831
161,141,20,-,72300,24834
199,168,31,-,22600,24836
617,510,107,707,58600,24839
48,35,13,-,75400,24843
768,623,145,449,45300,24844
188,119,69,-,84700,24845
46,46,0,-,53300,24846
133,96,37,-,-,24847
65,51,14,-,20600,24848
155,146,9,-,81300,24849
393,308,85,535,50600,24850
167,167,0,-,52600,24851
235,166,69,502,51800,24853
108,44,64,690,32800,24854
437,343,94,613,76300,24857
157,157,0,-,79300,24860
71,37,34,-,-,24861
215,189,26,-,54700,24862
95,95,0,-,45900,24866
174,102,72,-,43600,24867
471,380,91,527,30000,24868
156,57,99,-,53400,24869
1266,952,314,565,61500,24870
120,99,21,-,24600,24871
314,283,31,-,27900,24872
167,96,71,-,-,24873
1159,924,235,714,84300,24874
193,150,43,585,-,24878
218,190,28,-,-,24879
121,103,18,-,-,24880
163,131,32,-,22600,24881
144,121,23,-,46100,24882
110,88,22,-,24100,24884
7,7,0,-,-,24887
48,48,0,-,43600,24888
664,471,193,552,28900,24892
142,115,27,-,39300,24894
60,60,0,-,-,24898
4156,2856,1300,835,168200,24901
1885,1339,546,622,89100,24910
287,244,43,705,89200,24915
260,214,46,-,91900,24916
618,462,156,616,142900,24918
139,89,50,-,54300,24920
144,110,34,-,138600,24924
291,213,78,700,161500,24925
119,93,26,-,85800,24927
502,400,102,-,143500,24931
195,167,28,-,146900,24934
302,282,20,-,110500,24935
680,622,58,-,155500,24938
489,431,58,-,91400,24941
160,134,26,-,178600,24944
178,160,18,-,-,24945
567,473,94,663,115600,24946
627,436,191,626,111600,24951
1662,1325,337,623,115200,24954
134,134,0,-,216700,24957
29,29,0,-,-,24962
1781,1361,420,573,108800,24963
671,580,91,519,73100,24966
1911,1328,583,594,100000,24970
109,79,30,-,107400,24974
430,393,37,-,121300,24976
244,201,43,-,97900,24977
327,192,135,-,84500,24981
1084,902,182,552,99500,24983
154,110,44,-,335000,24984
2277,1563,714,594,84900,24986
260,235,25,-,96600,24991
15,15,0,-,-,25002
1099,814,285,804,103700,25003
53,30,23,-,62500,25005
264,222,42,-,75900,25007
46,21,25,-,56400,25008
454,412,42,663,71600,25009
423,354,69,589,102200,25011
1920,1318,602,628,85000,25015
232,185,47,706,-,25019
131,59,72,605,69500,25021
87,64,23,-,-,25022
208,139,69,483,55900,25024
60,60,0,-,-,25025
174,144,30,-,85000,25028
132,132,0,-,57500,25030
367,274,93,684,55200,25031
758,665,93,554,82800,25033
470,388,82,100-,47200,25035
220,153,67,428,44600,25036
413,311,102,617,-,25039
184,153,31,-,100500,25040
596,468,128,431,78200,25043
89,83,6,-,89700,25044
2085,1665,420,626,88200,25045
138,73,65,594,-,25047
34,34,0,-,58200,25048
176,104,72,538,60900,25049
80,57,23,-,75600,25051
1708,1077,631,590,102600,25053
146,132,14,-,57100,25054
165,151,14,-,43700,25057
250,198,52,612,57300,25059
124,106,18,-,45300,25060
288,266,22,-,55800,25061
83,83,0,-,59400,25062
669,528,141,620,93200,25063
4392,2698,1694,731,89800,25064
354,299,55,822,87500,25067
703,547,156,586,118100,25070
5126,3899,1227,818,111900,25071
256,178,78,-,45000,25075
182,103,79,493,-,25076
402,390,12,-,105300,25081
607,405,202,607,160300,25082
300,277,23,-,70100,25083
395,247,148,598,63700,25085
266,218,48,738,79400,25086
76,65,11,-,28200,25088
84,45,39,-,153400,25090
85,85,0,-,-,25093
83,56,27,600,50000,25102
55,25,30,-,46800,25103
183,106,77,334,54000,25106
226,132,94,432,-,25107
238,200,38,-,92800,25108
182,154,28,-,91400,25109
209,141,68,688,78400,25110
222,197,25,-,56300,25111
0,0,0,-,-,25112
304,285,19,-,92300,25113
230,160,70,-,80000,25114
66,66,0,-,26300,25115
363,321,42,-,50100,25118
115,84,31,-,61600,25119
257,155,102,-,64400,25121
1409,1107,302,493,78300,25123
568,540,28,-,81400,25124
337,284,53,-,67200,25125
37,26,11,-,-,25126
1468,1060,408,660,97200,25130
55,38,17,-,-,25132
420,238,182,241,-,25133
205,169,36,-,64600,25134
731,320,411,442,82800,25136
169,169,0,-,118900,25139
510,390,120,579,48900,25140
91,67,24,-,70800,25141
159,135,24,-,76900,25142
3638,2538,1100,717,97800,25143
146,121,25,-,45300,25148
97,83,14,-,57300,25149
147,133,14,-,45800,25152
287,206,81,-,105800,25154
43,14,29,-,-,25156
2135,1738,397,844,121700,25159
34,34,0,-,-,25160
115,105,10,-,101500,25161
184,147,37,644,94400,25162
421,321,100,-,101600,25164
249,201,48,528,93500,25165
849,749,100,-,109400,25168
204,133,71,618,83300,25169
138,111,27,-,45300,25173
181,175,6,-,34200,25174
10027,7629,2398,685,95800,25177
7,7,0,-,-,25180
581,499,82,557,62000,25181
0,0,0,-,-,25183
0,0,0,-,-,25185
388,212,176,338,69100,25186
309,263,46,-,-,25187
184,121,63,540,-,25193
15,0,15,-,-,25201
483,416,67,631,111500,25202
42,0,42,-,-,25203
77,52,25,-,26700,25204
233,233,0,-,69700,25205
180,165,15,-,-,25206
379,338,41,518,52400,25208
615,364,251,487,48000,25209
73,73,0,-,11700,25211
2272,1940,332,701,155200,25213
173,144,29,-,48900,25214
442,387,55,578,81000,25234
345,315,30,-,58300,25235
653,526,127,521,93600,25239
646,595,51,1065,150600,25241
285,241,44,575,82000,25243
267,249,18,-,42900,25244
196,167,29,-,119000,25245
258,185,73,639,66800,25247
1082,962,120,-,171300,25248
194,169,25,-,78500,25251
574,511,63,-,122400,25252
885,773,112,382,82300,25253
213,183,30,-,109700,25259
663,480,183,568,65200,25260
145,115,30,-,76400,25261
409,409,0,-,111000,25262
127,88,39,-,81400,25264
615,505,110,550,80100,25265
328,206,122,-,75700,25266
262,234,28,-,72500,25267
313,270,43,-,-,25268
344,295,49,-,86600,25270
3880,2753,1127,584,122600,25271
696,682,14,-,101800,25275
3144,2328,816,475,86700,25276
190,184,6,-,142000,25285
571,501,70,-,92300,25286
318,305,13,-,58900,25287
1534,302,1232,582,133300,25301
6690,4161,2529,681,103400,25302
3394,2369,1025,728,129900,25303
3609,2172,1437,698,183800,25304
0,0,0,-,-,25305
2818,1893,925,742,82100,25306
5737,4304,1433,608,109600,25309
4930,2479,2451,694,100200,25311
6481,4618,1863,685,92400,25312
5073,3588,1485,769,140100,25313
6429,4960,1469,854,214500,25314
1349,872,477,596,74000,25315
2522,2041,481,692,94600,25320
5751,2579,3172,871,135000,25401
4962,4148,814,1106,209900,25403
8512,5737,2775,935,152300,25404
4773,3547,1226,1043,152300,25405
5161,3727,1434,764,173300,25411
3052,2470,582,1008,167800,25413
6736,4992,1744,913,233100,25414
3823,2955,868,940,192600,25419
1409,1213,196,922,142600,25420
901,682,219,813,167400,25422
4995,4063,932,981,203900,25425
5168,4464,704,1036,175500,25427
4414,3821,593,1123,158200,25428
2983,2225,758,793,198700,25430
127,80,47,-,83500,25431
76,54,22,-,74300,25432
1024,520,504,623,93300,25434
179,106,73,383,126400,25437
2613,1599,1014,932,160800,25438
675,526,149,841,182000,25442
2612,1866,746,851,270800,25443
121,42,79,-,234400,25444
571,461,110,1222,221700,25446
459,375,84,-,90400,25501
563,391,172,654,76500,25502
423,350,73,638,83900,25503
5296,3527,1769,788,136200,25504
188,145,43,-,122300,25505
2015,1351,664,440,71700,25506
342,226,116,591,100700,25507
4000,3193,807,634,102700,25508
1901,1582,319,819,119100,25510
397,340,57,681,-,25511
421,331,90,-,78200,25512
1459,1047,412,549,73100,25514
897,743,154,557,82300,25515
845,679,166,-,70200,25517
607,482,125,-,60600,25520
360,292,68,714,127600,25521
1085,738,347,438,93600,25523
1091,896,195,569,64600,25524
8574,6853,1721,800,184400,25526
395,360,35,618,56900,25529
2282,1784,498,511,84800,25530
139,96,43,-,-,25534
1119,898,221,-,119100,25535
767,647,120,729,107000,25537
80,37,43,-,32500,25540
3599,2760,839,678,132400,25541
1928,1641,287,732,141500,25545
431,315,116,-,102900,25547
3614,2755,859,495,78800,25550
621,493,128,733,45300,25555
599,482,117,-,32200,25557
697,635,62,-,114000,25559
3163,2633,530,967,184200,25560
488,368,120,-,85000,25564
285,238,47,-,56300,25565
362,350,12,-,73600,25567
2550,1796,754,537,71600,25570
812,620,192,742,91400,25571
480,416,64,-,117000,25573
2115,1440,675,540,87200,25601
434,343,91,550,84800,25606
374,291,83,241,67500,25607
515,452,63,524,52100,25608
353,212,141,782,88000,25611
251,237,14,-,111000,25617
888,646,242,588,51900,25621
84,84,0,-,113500,25624
506,341,165,561,100300,25625
222,173,49,100-,81200,25628
299,232,67,620,74300,25630
244,158,86,-,40900,25632
212,167,45,845,43500,25634
545,438,107,537,103200,25635
282,234,48,546,74600,25637
404,325,79,-,56900,25638
209,173,36,619,57600,25639
196,160,36,-,81300,25644
480,395,85,604,64300,25646
368,284,84,575,71600,25647
546,429,117,624,120700,25649
177,177,0,-,85900,25650
315,279,36,-,47100,25651
451,340,111,703,65100,25652
132,97,35,-,87600,25653
75,75,0,-,80800,25654
2717,1793,924,617,81700,25661
287,195,92,-,52000,25666
411,394,17,-,50300,25669
2299,1776,523,642,77800,25670
516,404,112,775,67600,25671
168,124,44,-,-,25672
1138,817,321,522,70700,25674
515,446,69,394,65000,25676
729,537,192,246,69200,25678
136,115,21,-,84800,25688
112,97,15,-,67900,25690
429,281,148,479,67000,25692
92,60,32,-,65000,25696
71,64,7,-,"10,000-",25699
10077,5332,4745,624,117800,25701
3126,1839,1287,581,83000,25702
2166,484,1682,694,61500,25703
6845,4637,2208,680,90200,25704
9263,5753,3510,732,114400,25705
14113,9630,4483,681,110800,25801
128,106,22,-,58700,25810
75,59,16,-,-,25811
660,536,124,547,82400,25812
2285,1656,629,676,122400,25813
312,228,84,-,59200,25817
131,20,111,587,-,25818
160,138,22,-,-,25820
989,797,192,601,83100,25823
976,841,135,716,119300,25825
107,107,0,-,57200,25826
1117,926,191,781,101000,25827
535,522,13,-,88200,25831
1719,1479,240,431,144700,25832
265,176,89,-,55100,25836
122,108,14,-,-,25837
204,122,82,-,137000,25839
3392,2780,612,600,98800,25840
217,208,9,-,110300,25841
412,302,110,-,-,25843
526,412,114,371,88700,25844
374,282,92,375,80300,25845
103,88,15,-,-,25846
147,106,41,-,-,25848
237,186,51,-,80600,25849
0,0,0,-,-,25853
363,355,8,-,99900,25854
35,9,26,-,-,25855
93,48,45,-,54300,25857
39,39,0,-,-,25862
113,103,10,-,114300,25864
469,384,85,888,107800,25865
113,113,0,-,-,25868
11,11,0,-,-,25870
256,199,57,617,135500,25871
261,172,89,818,102400,25873
201,190,11,-,-,25875
32,32,0,-,-,25876
373,360,13,-,105000,25878
241,134,107,-,-,25879
2613,1795,818,572,81300,25880
907,745,162,580,63500,25882
4650,3304,1346,595,87200,25901
44,36,8,-,25500,25902
133,124,9,-,156300,25904
128,128,0,-,89800,25906
37,26,11,-,-,25907
43,43,0,-,122100,25908
18,6,12,-,-,25911
111,111,0,-,134900,25913
126,46,80,476,50900,25915
61,37,24,-,-,25916
853,710,143,525,76400,25917
1692,1325,367,690,153300,25918
37,24,13,-,-,25920
837,484,353,742,53600,25921
97,74,23,-,123800,25922
170,138,32,-,78400,25928
56,56,0,-,86500,25932
19,12,7,-,"10,000-",25936
497,465,32,-,85400,25938
108,108,0,-,27900,25942
2656,2042,614,589,86600,25951
304,224,80,625,58100,25958
1502,1142,360,553,78300,25962
444,365,79,423,68300,25969
392,249,143,764,167300,25971
98,94,4,-,-,25972
1185,1015,170,605,71700,25976
48,48,0,-,-,25977
298,168,130,604,64400,25978
317,277,40,504,156600,25979
263,213,50,332,65900,25981
697,502,195,545,73900,25984
139,126,13,-,-,25985
174,119,55,582,-,25989
18192,12322,5870,593,111500,26003
233,188,45,715,49000,26030
770,465,305,475,63000,26031
170,112,58,475,96700,26032
1195,1042,153,712,106700,26033
1942,1300,642,622,84000,26034
1070,901,169,666,116900,26035
157,157,0,-,218800,26036
2746,2064,682,572,86400,26037
1228,961,267,656,140500,26038
323,244,79,532,154200,26039
808,513,295,651,66600,26040
6570,4846,1724,587,94700,26041
2504,2113,391,573,94900,26047
643,455,188,668,41300,26050
754,638,116,-,95300,26055
92,92,0,-,133300,26056
1073,870,203,948,110500,26059
791,678,113,697,108900,26060
9463,6318,3145,652,88000,26062
3661,2694,967,535,92200,26070
267,139,128,514,107700,26074
167,146,21,775,50300,26075
12544,7424,5120,627,85100,26101
7156,4997,2159,671,101300,26104
5357,4037,1320,616,126000,26105
580,502,78,541,114300,26133
398,286,112,505,92900,26134
289,256,33,-,152100,26136
254,225,29,-,70400,26137
49,49,0,-,53900,26138
114,91,23,-,106500,26141
998,724,274,607,57400,26142
1864,1553,311,587,80700,26143
435,327,108,411,87800,26146
883,640,243,710,88100,26147
115,96,19,-,83600,26148
941,734,207,503,89000,26149
2549,1971,578,789,138600,26150
242,192,50,-,76800,26151
47,7,40,-,-,26152
3356,2705,651,602,94400,26155
1153,840,313,652,83000,26159
440,401,39,485,76000,26160
128,98,30,-,59700,26161
3172,2354,818,651,88900,26164
325,303,22,-,81200,26167
220,183,37,560,110800,26169
2238,1861,377,648,107800,26170
1313,955,358,628,91900,26175
196,141,55,-,59100,26178
889,759,130,371,105600,26180
2525,2283,242,725,145500,26181
757,673,84,752,124600,26184
2670,2162,508,675,142200,26187
7494,5577,1917,646,117600,26201
224,212,12,-,78100,26202
18,18,0,-,-,26203
1265,961,304,570,85100,26205
1449,933,516,444,57300,26206
395,371,24,-,60200,26208
61,24,37,827,-,26209
62,62,0,-,-,26215
140,77,63,-,128800,26217
1121,955,166,682,108000,26218
204,184,20,-,75300,26222
118,105,13,-,80700,26224
18,18,0,-,-,26228
64,57,7,-,51200,26230
425,342,83,-,66500,26234
13,13,0,-,-,26236
153,104,49,-,62900,26237
339,255,84,-,77400,26238
6196,3732,2464,560,119900,26241
1796,1429,367,583,91600,26250
1433,1068,365,584,139200,26253
173,116,57,-,122300,26254
373,362,11,-,97200,26257
76,66,10,-,"10,000-",26259
534,436,98,675,168400,26260
1102,796,306,481,44300,26261
109,109,0,-,225000,26263
283,239,44,572,65800,26264
34,16,18,-,-,26266
123,93,30,-,-,26267
23,15,8,-,-,26268
417,317,100,545,104900,26269
314,264,50,483,101000,26270
131,119,12,475,102000,26271
301,250,51,553,102800,26273
247,136,111,473,57800,26275
98,98,0,-,-,26276
218,210,8,-,58600,26278
771,639,132,521,68700,26280
14,14,0,-,-,26282
611,557,54,339,114500,26283
195,195,0,-,63500,26285
1314,1036,278,482,84700,26287
1602,1155,447,520,72500,26288
29,29,0,-,385000,26291
316,255,61,511,95500,26292
253,210,43,-,65600,26293
398,353,45,-,79000,26294
55,55,0,-,104200,26296
42,42,0,-,85000,26298
12293,8018,4275,635,86200,26301
304,249,55,325,103000,26320
184,150,34,538,-,26321
191,118,73,740,63800,26323
130,95,35,475,57400,26325
19,19,0,-,-,26327
5948,4654,1294,875,187100,26330
488,347,141,445,74400,26335
506,423,83,435,75800,26337
338,251,87,373,84000,26338
44,35,9,-,302800,26339
127,113,14,-,112500,26342
83,77,6,-,116000,26343
391,351,40,-,65800,26346
856,666,190,824,103800,26347
36,36,0,-,-,26348
33,33,0,-,-,26349
1351,832,519,535,96700,26351
4390,3447,943,520,87300,26354
87,87,0,-,30500,26361
1276,900,376,549,91700,26362
18,6,12,-,-,26366
234,173,61,724,66100,26369
332,274,58,-,156500,26372
460,405,55,-,150900,26374
242,204,38,-,-,26376
233,208,25,-,72500,26377
1575,1188,387,788,147000,26378
279,260,19,-,45500,26384
1477,1225,252,580,108500,26385
839,666,173,803,84800,26386
213,163,50,-,94400,26404
404,316,88,-,82500,26405
1159,996,163,850,162300,26408
371,272,99,750,79200,26410
287,249,38,-,83000,26411
265,227,38,-,56600,26412
1327,1064,263,605,94300,26415
3041,1992,1049,515,110600,26416
415,322,93,608,78100,26419
88,59,29,-,-,26421
226,94,132,623,80000,26422
117,103,14,-,71400,26424
545,477,68,457,56600,26425
2627,2187,440,535,90200,26426
140,132,8,-,115500,26430
2373,1911,462,584,91100,26431
67,56,11,-,67700,26435
58,32,26,-,86700,26436
219,177,42,322,44400,26437
118,61,57,-,42300,26438
433,348,85,636,106900,26440
135,135,0,-,85500,26443
1392,1248,144,659,86200,26444
571,450,121,535,58400,26447
441,383,58,390,66200,26448
322,269,53,761,83100,26451
3579,2373,1206,531,85300,26452
1295,1118,177,514,95100,26456
7947,5081,2866,692,155300,26501
14115,4884,9231,784,181300,26505
12039,9007,3032,808,200800,26508
766,589,177,687,85600,26519
335,325,10,-,161200,26520
83,72,11,563,97700,26521
2184,1765,419,583,156000,26525
967,601,366,662,78100,26534
2179,1617,562,665,125900,26537
953,731,222,629,92600,26541
1065,899,166,469,86500,26542
63,39,24,-,75600,26543
910,724,186,547,116500,26547
16660,12206,4454,740,122700,26554
513,430,83,711,119700,26559
115,95,20,-,-,26560
207,150,57,-,73500,26562
206,171,35,-,53600,26563
279,206,73,925,75900,26568
1405,1200,205,536,88800,26570
884,754,130,631,69600,26571
121,121,0,-,44200,26572
250,211,39,567,56300,26574
322,213,109,636,113700,26575
115,101,14,-,70700,26576
293,208,85,472,53700,26581
1904,1549,355,675,78700,26582
205,202,3,-,134500,26585
76,76,0,-,-,26586
136,136,0,-,79000,26587
1018,856,162,627,122800,26588
271,220,51,822,110000,26590
475,441,34,-,87700,26591
1799,1382,417,528,90900,26601
427,365,62,806,63800,26610
73,49,24,-,153800,26611
115,101,14,-,77400,26615
70,70,0,-,85200,26617
128,68,60,-,-,26619
344,227,117,548,82100,26621
514,374,140,574,94400,26623
1128,871,257,464,85700,26624
76,51,25,-,170200,26627
117,90,27,-,125000,26629
134,101,33,-,59800,26631
179,135,44,-,95000,26636
69,61,8,-,54300,26638
4219,3198,1021,535,98400,26651
200,144,56,-,53000,26656
149,137,12,-,87600,26660
476,476,0,-,94400,26662
184,164,20,-,84600,26676
515,405,110,-,151900,26678
819,695,124,688,150800,26679
132,107,25,-,45800,26680
561,528,33,-,87300,26681
53,53,0,-,87400,26684
276,200,76,470,40700,26690
151,114,37,-,"10,000-",26691
2262,1648,614,493,116700,26704
338,291,47,-,116500,26705
127,113,14,533,78100,26707
909,627,282,588,119100,26710
961,626,335,637,168900,26711
190,81,109,-,26300,26714
286,240,46,-,102600,26716
471,207,264,436,87600,26717
1294,772,522,575,174100,26719
28,28,0,-,-,26720
460,192,268,510,156300,26722
5201,3220,1981,558,117300,26726
96,96,0,-,135700,26731
269,240,29,-,84600,26739
559,436,123,424,160000,26743
339,154,185,394,39300,26750
2520,1575,945,591,141900,26753
413,354,59,-,142200,26755
2540,1491,1049,520,132200,26757
250,187,63,-,161500,26761
782,409,373,615,114800,26763
1553,1178,375,473,85800,26764
234,144,90,557,76100,26767
414,364,50,-,110600,26801
543,336,207,696,78100,26802
305,281,24,350,70200,26804
1197,947,250,498,145700,26807
414,183,231,629,-,26808
151,127,24,-,260900,26810
545,486,59,475,127400,26812
163,104,59,511,85700,26814
322,276,46,-,114400,26815
158,111,47,-,257800,26817
356,296,60,665,165700,26818
228,82,146,-,-,26823
694,573,121,534,174100,26833
2692,1651,1041,596,104200,26836
249,200,49,-,159800,26845
2420,1764,656,556,132700,26847
784,651,133,713,125100,26851
293,192,101,523,98400,26852
250,218,32,561,118800,26855
100,46,54,-,-,26865
341,287,54,619,-,26866
254,212,42,475,111100,26884
5464,4787,677,858,237700,27006
856,740,116,628,113000,27007
957,878,79,-,162600,27009
2260,1761,499,576,121300,27011
10023,8362,1661,836,206700,27012
2433,1706,727,681,126200,27013
272,184,88,838,80700,27014
627,493,134,480,109600,27016
3487,2392,1095,580,125300,27017
3069,2419,650,627,141900,27018
1614,1332,282,535,116500,27019
2650,2082,568,583,125500,27020
7392,5639,1753,683,128000,27021
623,524,99,526,103300,27022
5092,4391,701,747,201700,27023
1032,773,259,629,132700,27024
4442,3525,917,555,125400,27025
1959,1090,869,552,87100,27027
9765,7068,2697,651,135400,27028
14980,10739,4241,616,111500,27030
4502,4028,474,1053,173400,27040
3097,2379,718,638,143000,27041
279,199,80,690,-,27042
2855,2233,622,561,135900,27043
3585,2647,938,674,130500,27045
897,745,152,514,84900,27046
427,382,45,945,125600,27047
3437,2837,600,601,100600,27048
1578,1232,346,724,130700,27050
3067,2273,794,763,122500,27051
4255,3161,1094,625,117000,27052
1221,1024,197,631,132200,27053
828,739,89,772,90500,27054
5523,4223,1300,637,134300,27055
8696,3161,5535,634,128600,27101
15966,8351,7615,755,150400,27103
13211,7646,5565,776,242900,27104
14577,7095,7482,673,95300,27105
19296,10510,8786,757,181900,27106
16925,11430,5495,737,125300,27107
0,0,0,-,-,27109
0,0,0,-,-,27110
14960,9908,5052,813,129800,27127
28,15,13,-,80800,27201
8720,4100,4620,599,103800,27203
12605,9932,2673,690,119700,27205
1308,1072,236,720,126400,27207
690,600,90,860,139900,27208
1480,1103,377,564,73200,27209
546,488,58,481,100000,27212
3822,3033,789,795,160300,27214
17467,10116,7351,783,158700,27215
13966,8443,5523,746,107100,27217
1207,727,480,600,71800,27229
681,560,121,785,177500,27231
1245,1098,147,834,142900,27233
1822,1428,394,1929,255800,27235
3468,2740,728,631,120800,27239
777,631,146,520,88300,27242
1754,1494,260,705,188900,27243
4553,3219,1334,905,166100,27244
1745,1144,601,687,100500,27248
5174,4121,1053,717,140100,27249
1002,837,165,562,138900,27252
12166,8464,3702,692,139000,27253
2456,2002,454,854,115400,27258
8946,3274,5672,644,78900,27260
8389,4419,3970,756,155500,27262
8695,5489,3206,670,115700,27263
19904,13108,6796,860,162200,27265
9383,7037,2346,878,237700,27278
1216,926,290,615,155000,27281
6512,4903,1609,956,180400,27282
1207,1054,153,710,163800,27283
21369,15235,6134,739,165800,27284
9777,6080,3697,610,87300,27288
664,568,96,-,117600,27291
15006,9947,5059,653,115300,27292
14765,11199,3566,666,142700,27295
3957,2954,1003,642,131300,27298
2073,1532,541,638,104200,27299
3405,2982,423,842,155200,27301
11738,8134,3604,803,169500,27302
645,530,115,635,88400,27305
2677,2113,564,655,94000,27306
2422,2183,239,737,321700,27310
1436,1065,371,527,84100,27311
8699,7148,1551,883,278900,27312
2446,2184,262,801,147600,27313
424,386,38,-,135900,27314
870,654,216,499,120800,27315
2502,1800,702,722,112500,27316
6405,4788,1617,591,121600,27317
15637,10276,5361,656,112700,27320
2329,1897,432,490,93700,27325
1447,938,509,530,106900,27326
14175,8822,5353,697,140900,27330
10841,7995,2846,825,140800,27332
69,0,69,-,-,27340
2250,1867,383,715,94500,27341
709,547,162,833,89600,27343
6681,4179,2502,685,130900,27344
2214,1929,285,594,140800,27349
2604,2044,560,727,125100,27350
1027,839,188,549,123000,27355
1483,909,574,528,83000,27356
2879,2436,443,636,158700,27357
5082,4484,598,774,292300,27358
18222,12192,6030,659,118900,27360
5383,4451,932,595,125000,27370
3294,2199,1095,507,116300,27371
3564,3001,563,847,236700,27376
3113,2341,772,898,162800,27377
2048,1308,740,464,98500,27379
7080,2658,4422,717,104500,27401
7921,4197,3724,789,165600,27403
18440,8632,9808,707,104000,27405
23369,12371,10998,742,123500,27406
19654,8986,10668,797,131600,27407
8270,5914,2356,809,217300,27408
7899,2887,5012,794,133100,27409
24155,14954,9201,881,205900,27410
12081,8329,3752,838,214000,27455
6984,5228,1756,729,151000,27501
12403,9497,2906,1161,281400,27502
1231,1072,159,935,288400,27503
5063,3312,1751,757,125500,27504
2172,1537,635,740,127400,27505
676,578,98,642,140000,27507
561,354,207,550,84500,27508
1479,838,641,787,132100,27509
7036,2156,4880,933,268000,27510
13492,8918,4574,959,218800,27511
17160,10535,6625,1021,278400,27513
10090,4722,5368,1043,413400,27514
14535,9555,4980,1049,353600,27516
10617,7190,3427,1082,374900,27517
8164,5524,2640,1111,372500,27518
17340,13162,4178,1249,365200,27519
13951,10183,3768,957,151100,27520
2198,1587,611,677,119500,27521
4486,3354,1132,930,140300,27522
3949,2608,1341,1077,338500,27523
4565,3113,1452,659,131300,27524
5471,4148,1323,741,137300,27525
14875,11761,3114,985,208200,27526
6751,5758,993,1136,204300,27527
17038,12055,4983,946,168400,27529
15659,8655,7004,624,131100,27530
0,0,0,-,-,27531
12997,6893,6104,856,133400,27534
6588,2689,3899,599,98300,27536
8714,6393,2321,713,95600,27537
7501,6401,1100,1158,269100,27539
11489,9975,1514,1217,247900,27540
1572,1219,353,920,159500,27541
3553,2281,1272,705,102000,27542
1795,1234,561,671,107200,27544
8975,6330,2645,944,158800,27545
6596,4064,2532,770,136800,27546
9362,6643,2719,694,119100,27549
785,593,192,879,146300,27551
736,522,214,801,78500,27553
264,125,139,685,81000,27555
92,63,29,548,-,27556
2654,1803,851,620,103300,27557
746,618,128,806,170400,27559
10917,5098,5819,1142,267900,27560
681,529,152,-,231300,27562
2045,1316,729,511,72800,27563
9622,6421,3201,646,123300,27565
253,116,137,644,135600,27568
2875,1920,955,828,99300,27569
1871,1612,259,703,255400,27571
2869,2590,279,950,175600,27572
4639,2004,2635,593,114400,27573
5410,4431,979,657,109400,27574
6156,3890,2266,789,112100,27576
8392,5044,3348,754,135100,27577
1336,1145,191,772,155700,27581
71,42,29,780,85800,27582
2613,2234,379,721,125600,27583
21335,16348,4987,981,272700,27587
3106,2097,1009,643,91800,27589
7118,5627,1491,789,139900,27591
5745,4777,968,847,162800,27592
6256,5177,1079,825,165700,27596
8309,5767,2542,839,147200,27597
3656,1068,2588,741,262100,27601
19185,11908,7277,953,189300,27603
17585,9758,7827,921,162400,27604
2831,940,1891,975,345100,27605
18007,6419,11588,922,237000,27606
8366,4281,4085,951,364700,27607
4929,3300,1629,980,493700,27608
15155,7806,7349,937,248400,27609
24167,13671,10496,911,146700,27610
17140,8983,8157,995,290900,27612
18158,12110,6048,969,297400,27613
12467,9061,3406,1132,367800,27614
18110,12389,5721,1004,280000,27615
18139,10930,7209,973,175300,27616
8407,4090,4317,1174,260100,27617
9408,2760,6648,710,196000,27701
17566,10854,6712,978,157500,27703
13948,7711,6237,857,142200,27704
20429,9231,11198,909,229000,27705
20287,8712,11575,914,213000,27707
398,338,60,-,195100,27709
8219,7403,816,1158,196600,27712
22212,12411,9801,976,209700,27713
8087,4183,3904,639,83200,27801
7648,4666,2982,659,147500,27803
11850,6890,4960,785,128700,27804
1534,1166,368,701,89100,27805
947,706,241,566,87500,27806
2530,1701,829,654,102100,27807
849,693,156,498,149800,27808
1700,1257,443,635,89200,27809
1749,1159,590,618,109300,27810
1113,765,348,475,89600,27812
264,155,109,773,82800,27813
814,758,56,-,91500,27814
772,533,239,610,116000,27816
2748,1949,799,665,112400,27817
549,415,134,635,121400,27818
112,94,18,581,66600,27819
1186,806,380,594,88300,27820
147,53,94,575,-,27821
3232,2679,553,610,115600,27822
3139,1930,1209,673,70600,27823
696,397,299,807,113500,27824
33,17,16,750,67900,27825
296,285,11,-,37600,27826
13,6,7,-,106300,27827
3359,2039,1320,717,134000,27828
738,516,222,638,99400,27829
1929,1378,551,756,87800,27830
1319,927,392,784,56800,27831
1248,774,474,675,67300,27832
22608,9311,13297,712,105300,27834
2413,1946,467,736,167100,27837
1244,909,335,870,81600,27839
211,146,65,608,52000,27840
15,13,2,-,34600,27841
664,514,150,831,313300,27842
543,393,150,750,80900,27843
1217,877,340,652,80000,27844
1014,795,219,608,97800,27845
1245,890,355,545,85000,27846
272,129,143,610,56800,27847
542,363,179,690,82400,27849
3065,2208,857,714,151100,27850
2047,1609,438,592,88800,27851
1141,896,245,644,90300,27852
133,108,25,-,104100,27853
2130,1316,814,641,89800,27855
6599,4918,1681,562,124400,27856
470,385,85,607,76600,27857
22671,10529,12142,776,161500,27858
731,492,239,1012,93800,27860
30,27,3,-,61900,27861
299,219,80,625,130100,27862
4442,3105,1337,841,113800,27863
1888,1143,745,636,74900,27864
827,773,54,-,99200,27865
305,103,202,947,67200,27866
952,705,247,754,57400,27869
10862,6653,4209,710,97600,27870
1780,1239,541,651,73800,27871
194,115,79,615,63800,27872
204,140,64,783,77200,27873
1678,1127,551,653,74300,27874
336,246,90,-,73100,27875
706,550,156,514,98600,27876
869,402,467,709,76600,27878
106,83,23,800,135900,27879
1264,1008,256,723,145700,27880
30,19,11,-,-,27881
2846,1884,962,717,91400,27882
1217,951,266,596,82600,27883
443,443,0,-,90400,27884
361,343,18,-,72000,27885
8275,5048,3227,665,83800,27886
924,667,257,695,81900,27888
10984,7143,3841,664,130000,27889
1018,529,489,650,98600,27890
1904,1437,467,691,87000,27891
5696,3942,1754,641,91100,27892
15261,6793,8468,679,96800,27893
8178,5882,2296,806,162700,27896
739,345,394,451,68000,27897
14605,8706,5899,859,156400,27909
4603,2850,1753,656,87100,27910
422,269,153,992,258400,27915
309,263,46,-,205800,27916
317,180,137,749,131800,27917
460,375,85,830,186700,27919
429,300,129,889,220000,27920
1885,1417,468,1167,212600,27921
404,370,34,733,82300,27922
233,140,93,651,238300,27923
1172,1074,98,832,78500,27924
1421,1061,360,759,113800,27925
647,555,92,1045,117700,27926
375,289,86,1042,450000,27927
863,605,258,947,82500,27928
606,580,26,-,287500,27929
5014,3303,1711,735,128500,27932
646,542,104,518,166100,27935
422,366,56,1173,227600,27936
1626,1325,301,743,151400,27937
574,409,165,823,111900,27938
871,639,232,946,173800,27939
229,220,9,-,262200,27941
385,341,44,943,69000,27942
224,196,28,-,398600,27943
5119,3927,1192,762,163300,27944
415,372,43,1169,124600,27946
574,453,121,1096,235900,27947
4622,2855,1767,1122,241700,27948
3118,2661,457,1266,387700,27949
848,744,104,869,186900,27950
463,216,247,815,126700,27953
2791,1851,940,927,249900,27954
154,131,23,-,297500,27956
653,550,103,-,77200,27957
3792,3351,441,1273,242700,27958
1226,793,433,1149,340000,27959
159,47,112,908,-,27960
2991,1850,1141,623,80600,27962
311,217,94,977,317200,27964
271,212,59,1254,139800,27965
340,300,40,788,193800,27966
105,86,19,539,60000,27967
117,36,81,624,-,27968
1320,890,430,763,86900,27970
79,56,23,-,342400,27972
512,370,142,871,215300,27973
484,352,132,1097,216200,27974
1260,1178,82,1472,218800,27976
108,67,41,694,217900,27978
687,484,203,685,118800,27979
839,717,122,-,127500,27980
632,351,281,940,184600,27981
53,45,8,-,-,27982
3487,2412,1075,642,82700,27983
138,74,64,844,147700,27985
521,305,216,620,85400,27986
10657,7230,3427,644,122200,28001
469,400,69,847,138300,28006
239,203,36,817,62400,28007
529,359,170,685,84800,28009
8312,5851,2461,734,159400,28012
4817,2979,1838,699,99600,28016
0,0,0,-,-,28017
2270,1846,424,683,112300,28018
0,0,0,-,-,28019
801,709,92,594,79700,28020
5287,3901,1386,635,119400,28021
5474,3901,1573,745,149400,28023
18867,12701,6166,795,147600,28025
21578,15362,6216,868,184500,28027
11437,7936,3501,1160,256200,28031
1192,725,467,880,141000,28032
1123,1012,111,730,110000,28033
6547,4547,2000,661,118600,28034
5500,4225,1275,978,375700,28036
7818,6341,1477,811,282500,28037
32,17,15,-,67900,28039
3159,2449,710,660,89600,28040
8212,4939,3273,590,101400,28043
12308,6760,5548,764,93000,28052
14780,7399,7381,768,122800,28054
12215,9630,2585,799,151300,28056
1171,898,273,742,121400,28071
413,321,92,-,141900,28072
1920,1221,699,646,79700,28073
5675,5115,560,1334,253600,28075
160,53,107,478,-,28076
185,102,83,657,87400,28077
20797,15490,5307,1126,256100,28078
11565,9831,1734,1163,191200,28079
2882,2428,454,738,136100,28080
9740,5975,3765,799,126400,28081
9191,5609,3582,825,117000,28083
9990,6829,3161,671,108700,28086
1064,797,267,743,130100,28088
20,19,1,-,172500,28089
3265,2513,752,588,101300,28090
1000,747,253,498,87200,28091
14606,10262,4344,655,128000,28092
2173,1694,479,649,156000,28097
1289,884,405,672,122600,28098
312,225,87,746,133100,28101
33,28,5,-,77100,28102
3904,2839,1065,783,151600,28103
10419,9482,937,1182,291600,28104
16626,12246,4380,1013,218500,28105
2776,2332,444,717,181700,28107
38,21,17,-,-,28108
96,34,62,550,106900,28109
18136,12338,5798,841,166100,28110
9234,6700,2534,842,147200,28112
2962,2221,741,666,92500,28114
12672,9038,3634,828,174300,28115
14226,10256,3970,1064,351700,28117
1181,824,357,610,53300,28119
7837,5754,2083,767,145300,28120
2186,1763,423,830,178700,28124
890,733,157,709,207700,28125
2694,2125,569,674,144300,28127
3029,2133,896,686,106100,28128
2304,1874,430,697,144700,28129
897,642,255,769,126000,28133
4363,2265,2098,988,173900,28134
1818,1140,678,636,67400,28135
1128,929,199,669,157000,28137
3551,2628,923,676,117700,28138
7795,6059,1736,590,120000,28139
9426,4823,4603,734,119200,28144
10513,7946,2567,725,149400,28146
8781,5855,2926,747,136300,28147
11040,7264,3776,645,112600,28150
9351,6171,3180,696,116400,28152
1169,698,471,705,97300,28159
1367,848,519,591,90000,28160
1957,1472,485,705,156800,28163
5659,4550,1109,668,161800,28164
3570,2725,845,747,159800,28166
1020,874,146,540,114000,28167
3959,3266,693,602,120300,28168
52,27,25,580,85000,28169
4388,2625,1763,721,90200,28170
15971,14167,1804,1069,343400,28173
2797,1846,951,780,136300,28174
6407,2076,4331,1319,237100,28202
7538,2698,4840,1143,419900,28203
2974,885,2089,1079,359300,28204
19167,7754,11413,811,166700,28205
4522,1512,3010,751,89500,28206
3785,2996,789,1024,816600,28207
13187,4300,8887,784,89300,28208
10206,5490,4716,901,282700,28209
20351,11172,9179,941,252400,28210
12490,7380,5110,1014,389700,28211
15404,5103,10301,833,118200,28212
14728,7259,7469,846,139400,28213
13433,10053,3380,1060,130800,28214
20094,11878,8216,890,133400,28215
18646,10605,8041,1015,124900,28216
10048,2996,7052,920,105700,28217
15945,10680,5265,1044,312500,28226
19611,13525,6086,945,153400,28227
0,0,0,-,-,28244
14761,5233,9528,1021,151800,28262
28834,17758,11076,1105,162500,28269
12930,9138,3792,1126,294800,28270
13517,6989,6528,1043,155900,28273
25094,17728,7366,1319,295500,28277
8487,6255,2232,1164,223600,28278
0,0,0,-,-,28280
0,0,0,-,-,28282
6908,2441,4467,652,91300,28301
12832,6302,6530,810,134900,28303
14550,8117,6433,919,114600,28304
2817,1477,1340,816,193300,28305
15173,9363,5810,844,152300,28306
4945,32,4913,1171,158300,28307
25,0,25,1156,-,28308
0,0,0,-,-,28310
14186,7071,7115,813,145800,28311
7200,4945,2255,687,120900,28312
22216,10056,12160,919,125300,28314
4941,2855,2086,777,140300,28315
1842,1494,348,499,124700,28318
3695,2393,1302,625,77900,28320
1274,979,295,783,172900,28323
178,123,55,711,63800,28325
6388,3561,2827,1217,147200,28326
5849,4799,1050,748,168800,28327
10202,6239,3963,620,99100,28328
184,94,90,-,-,28330
168,110,58,794,93900,28332
3979,2510,1469,696,70100,28333
9819,6311,3508,669,103300,28334
4163,2656,1507,683,92800,28337
1827,1251,576,665,72900,28338
2716,1906,810,713,91000,28339
4038,2681,1357,509,71300,28340
1496,1046,450,732,74400,28341
69,62,7,813,110900,28342
532,313,219,602,76500,28343
1191,911,280,658,77900,28344
4893,3030,1863,577,71000,28345
455,287,168,623,63800,28347
12093,8252,3841,850,141100,28348
1364,1099,265,644,101200,28349
88,88,0,-,256900,28350
1673,1307,366,668,69300,28351
9408,5436,3972,611,87400,28352
1839,1377,462,877,163200,28356
1135,819,316,610,95100,28357
13478,7592,5886,642,80000,28358
4887,3377,1510,628,77400,28360
497,351,146,757,56700,28363
4928,3615,1313,518,65000,28364
6141,4231,1910,627,86300,28365
1987,1621,366,585,90400,28366
22,6,16,560,-,28367
1057,821,236,571,60500,28369
2319,1564,755,835,95100,28371
4666,2764,1902,548,75800,28372
1033,735,298,818,121400,28373
7703,6546,1157,1553,296100,28374
40,28,12,-,104200,28375
14212,9106,5106,838,144300,28376
4173,2428,1745,553,63700,28377
10715,6939,3776,609,87200,28379
2553,1810,743,740,80700,28382
2879,2135,744,552,64000,28383
4197,3033,1164,543,63000,28384
1049,804,245,-,88900,28385
1907,1287,620,609,56900,28386
6766,4036,2730,780,247200,28387
8447,3815,4632,872,116000,28390
2012,1626,386,747,109100,28391
756,565,191,663,99700,28392
654,424,230,550,76700,28393
2179,1361,818,659,172700,28394
928,684,244,623,118300,28395
1100,826,274,647,81300,28396
2908,1662,1246,583,76500,28398
854,676,178,577,91100,28399
10121,3511,6610,820,139800,28401
17084,5360,11724,845,236500,28403
13279,7704,5575,1010,191500,28405
12314,10253,2061,1228,250800,28409
13580,10627,2953,1081,239600,28411
16246,9632,6614,911,194100,28412
1373,868,505,765,108000,28420
510,400,110,680,106700,28421
3049,2375,674,821,188500,28422
942,700,242,724,74800,28423
20,9,11,711,112500,28424
4041,2701,1340,731,130700,28425
2709,1513,1196,1195,295400,28428
2975,2306,669,780,159600,28429
704,534,170,475,60300,28430
2831,1942,889,513,75100,28431
749,484,265,578,102700,28432
1980,1424,556,576,78400,28433
666,395,271,540,95600,28434
912,774,138,591,89300,28435
767,625,142,738,97900,28436
717,516,201,531,72700,28438
703,462,241,386,69300,28439
1388,779,609,503,79500,28441
716,562,154,630,83600,28442
7354,6099,1255,965,220300,28443
826,746,80,498,84300,28444
2714,1869,845,1125,181700,28445
517,417,100,579,118000,28447
376,274,102,-,151200,28448
823,615,208,1371,387700,28449
987,740,247,800,159900,28450
12339,9005,3334,942,155800,28451
374,188,186,980,59800,28452
1181,805,376,692,66000,28453
779,571,208,1082,117800,28454
698,596,102,586,100200,28455
1525,1283,242,692,88200,28456
3687,2795,892,776,129900,28457
2667,1629,1038,618,82600,28458
3861,2246,1615,1135,206500,28460
7995,6208,1787,991,256300,28461
5236,4083,1153,773,159900,28462
3359,2091,1268,596,80200,28463
819,564,255,708,74100,28464
3347,2435,912,930,275200,28465
4427,3237,1190,622,112700,28466
4659,4132,527,990,185700,28467
2260,1808,452,799,253200,28468
2749,2270,479,916,310600,28469
4692,3290,1402,721,152400,28470
7387,4842,2545,598,90000,28472
1692,1457,235,663,100800,28478
2361,1610,751,742,164100,28479
1199,710,489,1403,742100,28480
7892,3844,4048,629,83700,28501
8453,5643,2810,775,109700,28504
723,578,145,759,66600,28508
641,521,120,746,183100,28510
296,219,77,777,172500,28511
1606,1120,486,880,359700,28512
4124,2535,1589,681,95700,28513
905,570,335,629,103600,28515
4984,3446,1538,814,189400,28516
3345,2321,1024,719,117600,28518
153,103,50,917,164900,28519
145,111,34,-,-,28520
891,730,161,813,96400,28521
964,647,317,629,86500,28523
148,117,31,-,116500,28524
1077,718,359,737,82300,28525
1134,801,333,586,78500,28526
476,448,28,425,115400,28527
241,188,53,787,159800,28528
892,597,295,706,115900,28529
2683,1671,1012,673,85700,28530
598,501,97,-,231200,28531
8582,4131,4451,1028,143100,28532
20,0,20,-,-,28533
49,21,28,-,-,28537
932,604,328,762,86200,28538
5830,3643,2187,946,140600,28539
17710,9321,8389,823,149000,28540
1858,10,1848,1152,-,28543
2034,459,1575,965,117200,28544
17000,8716,8284,881,153700,28546
2075,7,2068,1281,-,28547
5685,4204,1481,689,93800,28551
56,47,9,-,139700,28552
183,162,21,-,152600,28553
96,83,13,-,52600,28554
1798,1125,673,731,139800,28555
575,496,79,-,158900,28556
6689,4331,2358,847,226600,28557
11392,7710,3682,749,151100,28560
15918,10493,5425,904,181300,28562
8922,6856,2066,778,158200,28570
1146,934,212,990,268800,28571
2373,1789,584,595,90300,28572
971,731,240,662,108600,28573
5986,4151,1835,1025,142900,28574
258,205,53,950,276400,28575
168,142,26,531,155600,28577
1895,1335,560,562,81900,28578
228,218,10,-,169900,28579
3983,2662,1321,607,95700,28580
110,110,0,-,-,28581
699,639,60,-,208700,28582
77,52,25,677,86700,28583
4859,3425,1434,970,228000,28584
1608,1190,418,560,88600,28585
3059,2352,707,524,81100,28586
163,89,74,620,79000,28587
83,53,30,-,179200,28589
9370,6804,2566,861,165500,28590
1847,1321,526,1177,363700,28594
19527,12398,7129,672,154900,28601
11346,7094,4252,664,129600,28602
2982,2133,849,839,224900,28604
1505,1080,425,950,364100,28605
643,554,89,-,113900,28606
12712,6075,6637,838,248700,28607
2321,1970,351,678,138700,28609
3804,2933,871,778,108300,28610
487,300,187,641,87200,28611
4715,3468,1247,601,99800,28612
8634,5923,2711,668,130400,28613
851,731,120,525,92400,28615
140,87,53,-,153600,28616
1120,757,363,451,154300,28617
922,777,145,879,165200,28618
562,371,191,649,98000,28619
4071,2699,1372,635,118900,28621
764,636,128,584,103200,28622
728,564,164,705,124600,28623
645,494,151,508,101800,28624
14084,10626,3458,690,139200,28625
1178,1014,164,992,186800,28626
494,322,172,490,124400,28627
141,73,68,785,93600,28628
0,0,0,-,-,28629
7981,6021,1960,636,111800,28630
343,300,43,-,162800,28631
1882,1403,479,539,111700,28634
1605,1195,410,608,79700,28635
1956,1382,574,581,99300,28636
628,400,228,607,114500,28637
4477,3101,1376,629,111700,28638
1969,1300,669,573,163100,28640
2312,1597,715,485,108700,28642
1579,1251,328,682,105400,28643
428,364,64,-,147700,28644
18095,12316,5779,606,103800,28645
226,169,57,-,-,28646
51,44,7,-,180000,28647
497,463,34,-,-,28649
4308,3300,1008,727,119300,28650
2724,2082,642,535,116400,28651
30,30,0,-,-,28652
1575,1317,258,556,118200,28654
20806,14680,6126,621,115000,28655
4155,3226,929,673,129000,28657
9898,6738,3160,678,123700,28658
8329,5604,2725,593,114700,28659
869,724,145,678,155600,28660
25,25,0,-,-,28662
239,221,18,-,233700,28663
994,821,173,581,141500,28665
86,14,72,-,-,28666
202,130,72,733,71000,28667
177,168,9,-,390000,28668
1131,864,267,601,75000,28669
1238,1004,234,482,115400,28670
198,122,76,653,138500,28671
0,0,0,-,-,28672
2323,1971,352,839,272500,28673
2933,2146,787,597,129900,28675
1675,1207,468,691,122500,28676
12697,8052,4645,718,115200,28677
1972,1495,477,557,121900,28678
852,535,317,767,168400,28679
9697,7325,2372,595,129100,28681
541,394,147,631,548900,28682
616,503,113,613,91400,28683
979,669,310,970,162800,28684
708,610,98,727,112200,28685
542,461,81,580,160000,28689
3706,2751,955,467,125500,28690
1647,1392,255,771,202900,28692
630,490,140,794,135700,28693
3433,2387,1046,736,154000,28694
5197,3940,1257,616,149600,28697
810,687,123,750,170900,28698
1460,1248,212,554,222900,28701
197,158,39,737,165800,28702
8068,5261,2807,989,204600,28704
2888,2226,662,536,146400,28705
56,41,15,-,-,28707
240,188,52,-,259600,28708
926,688,238,651,179000,28709
5534,3593,1941,750,216200,28711
8161,5785,2376,654,206000,28712
3526,2502,1024,600,135100,28713
6951,5225,1726,619,139900,28714
9981,7241,2740,752,170000,28715
7215,5221,1994,675,149100,28716
736,547,189,826,248300,28717
172,157,15,-,177400,28718
2778,2000,778,612,100200,28719
59,30,29,665,235700,28720
4286,2986,1300,697,163300,28721
2836,1769,1067,774,191300,28722
3475,1582,1893,616,213600,28723
7,4,3,-,-,28725
1210,617,593,660,127200,28726
1519,1233,286,1071,171100,28729
3651,2811,840,955,220500,28730
3738,3020,718,863,188700,28731
7081,5385,1696,983,199600,28732
0,0,0,-,-,28733
11755,8541,3214,706,155000,28734
146,74,72,524,-,28735
372,258,114,841,222200,28736
9057,6749,2308,751,234400,28739
592,478,114,409,128100,28740
1928,1399,529,897,453100,28741
1101,958,143,770,219700,28742
929,570,359,609,105500,28743
325,287,38,-,291400,28745
1081,887,194,647,259800,28746
909,759,150,664,169700,28747
4551,3594,957,734,161500,28748
0,0,0,-,-,28749
1747,1467,280,785,184100,28751
11824,7912,3912,579,106300,28752
4520,3383,1137,649,153600,28753
3256,2483,773,644,172100,28754
1714,1323,391,681,200500,28756
87,82,5,-,390600,28757
2866,2356,510,744,228300,28759
3179,2478,701,637,102700,28761
2731,2085,646,612,100800,28762
1207,934,273,559,177500,28763
461,391,70,713,210600,28766
3011,2444,567,719,223600,28768
3094,2543,551,541,119700,28771
516,503,13,479,105800,28772
1268,1102,166,959,260900,28773
554,451,103,931,375900,28774
129,129,0,-,164700,28775
3600,2926,674,545,139800,28777
4226,2813,1413,743,144100,28778
7059,5007,2052,700,171200,28779
368,283,85,-,120700,28781
3030,2357,673,904,217200,28782
729,360,369,621,118400,28783
3137,2430,707,775,207200,28785
9599,6493,3106,711,162200,28786
8201,6718,1483,757,207800,28787
2177,1491,686,818,152000,28789
1322,1133,189,634,151700,28790
6587,5023,1564,815,195600,28791
13638,8458,5180,738,149100,28792
6235,2407,3828,725,265500,28801
14221,7602,6619,1014,219000,28803
8198,5396,2802,940,292000,28804
8465,4989,3476,793,208700,28805
16554,9787,6767,875,172800,28806
2132,1630,502,495,92400,28901
540,447,93,-,152000,28902
3777,2818,959,672,151700,28904
1193,1033,160,685,123300,28905
7389,5874,1515,736,156700,28906
479,469,10,-,130000,28909
792,561,231,466,66300,29001
2401,1825,576,696,73500,29003
3835,2808,1027,639,82900,29006
1058,850,208,682,76000,29009
4140,2985,1155,671,68900,29010
708,592,116,575,110500,29014
599,428,171,560,61500,29015
6815,5597,1218,1099,232900,29016
1222,914,308,592,86800,29018
8917,6757,2160,696,123300,29020
734,523,211,605,116400,29030
563,474,89,685,79200,29031
1853,1373,480,797,72300,29032
5257,3198,2059,875,117300,29033
7798,7129,669,1140,270100,29036
356,191,165,-,93400,29037
800,655,145,701,73900,29038
1332,1001,331,594,77400,29039
3435,2692,743,673,106800,29040
1999,1322,677,453,61800,29042
1940,1545,395,708,78200,29044
8866,6977,1889,968,152300,29045
101,94,7,-,-,29046
1477,1161,316,543,84900,29047
1936,1537,399,895,93000,29048
265,219,46,480,91400,29051
818,504,314,709,60500,29052
6431,4564,1867,787,72300,29053
3772,3217,555,693,167300,29054
1577,1231,346,688,61900,29055
748,532,216,578,69400,29056
1733,1395,338,736,102200,29058
2377,1652,725,523,75000,29059
5387,4152,1235,865,111700,29061
75,22,53,-,-,29062
13094,10982,2112,1149,161700,29063
296,264,32,-,83200,29065
3385,2510,875,597,86300,29067
1944,1490,454,613,71500,29069
5836,4813,1023,645,120400,29070
20714,16100,4614,978,208900,29072
16318,12711,3607,850,129000,29073
26,26,0,-,-,29074
1084,896,188,679,179200,29075
5653,4727,926,625,120100,29078
27,0,27,-,-,29079
1117,825,292,441,56800,29080
486,362,124,547,88200,29081
168,146,22,-,70000,29082
1127,958,169,627,85000,29101
6940,5125,1815,614,92300,29102
545,404,141,623,78800,29104
492,355,137,661,77200,29105
1202,940,262,706,58600,29107
7338,4771,2567,687,81300,29108
666,475,191,578,70200,29111
1771,1341,430,599,72600,29112
592,467,125,576,56400,29113
697,523,174,488,67700,29114
10567,5735,4832,656,84500,29115
0,0,0,-,-,29117
6388,4731,1657,639,140100,29118
16,11,5,-,-,29122
2792,2192,600,746,84800,29123
925,650,275,738,60000,29125
948,881,67,672,136800,29126
3637,2954,683,742,172900,29127
1832,1559,273,663,79100,29128
1039,728,311,759,93000,29129
2438,1874,564,781,180500,29130
423,349,74,1028,91300,29133
3363,2424,939,755,96000,29135
857,654,203,577,69100,29137
3795,2499,1296,655,86700,29138
1940,1408,532,698,111000,29142
279,205,74,939,69800,29145
677,586,91,665,68700,29146
0,0,0,-,-,29147
3109,2337,772,503,90500,29148
16196,8932,7264,713,116000,29150
480,0,480,1102,-,29152
5734,3960,1774,837,86800,29153
11052,8157,2895,851,129500,29154
3326,2595,731,734,92000,29160
3977,2830,1147,700,81900,29161
1058,773,285,682,85400,29162
718,511,207,650,73800,29163
1748,1416,332,603,69300,29164
318,257,61,492,85700,29166
1357,1042,315,772,64000,29168
10786,5472,5314,821,129700,29169
8090,6200,1890,850,130600,29170
3694,2667,1027,783,96900,29172
149,135,14,-,77900,29175
1325,1054,271,590,55500,29178
5373,3849,1524,677,99700,29180
7585,2187,5398,1000,153200,29201
155,105,50,1573,283700,29202
14767,7402,7365,794,87900,29203
7849,4124,3725,803,134300,29204
10986,5385,5601,765,254500,29205
8224,5278,2946,901,239400,29206
12,4,8,-,-,29207
0,0,0,-,-,29208
13215,7895,5320,910,138700,29209
16412,6139,10273,799,120900,29210
11636,8265,3371,967,164700,29212
20705,11330,9375,944,141700,29223
0,0,0,-,-,29225
16361,11926,4435,1131,164100,29229
13363,7373,5990,766,128100,29301
6654,5012,1642,745,143300,29302
8814,4300,4514,632,79700,29303
6621,2836,3785,675,93900,29306
8115,4960,3155,736,133900,29307
9142,6949,2193,824,135800,29316
159,147,12,-,31800,29320
1350,1021,329,731,65800,29321
3038,2446,592,702,146800,29322
5290,4074,1216,674,105500,29323
106,60,46,438,36000,29324
5473,3524,1949,714,89000,29325
87,26,61,-,-,29329
3055,1982,1073,645,80100,29330
65,65,0,-,45200,29331
1063,897,166,550,76400,29332
179,122,57,680,57900,29333
4948,3466,1482,865,143000,29334
1676,1374,302,623,78600,29335
0,0,0,-,-,29338
7794,5661,2133,627,78100,29340
7319,4910,2409,656,125500,29341
99,80,19,-,73600,29346
11100,9080,2020,742,131800,29349
510,387,123,528,53100,29351
1664,1273,391,548,80500,29353
369,334,35,680,87100,29355
3354,2686,668,680,149700,29356
8202,5272,2930,632,87300,29360
250,145,105,695,29800,29364
3763,3311,452,793,135200,29365
42,42,0,-,-,29368
4940,4276,664,875,164500,29369
331,291,40,850,91800,29370
1523,1155,368,564,78000,29372
96,89,7,-,28000,29373
1222,1034,188,854,147200,29374
25,16,9,-,76700,29375
2870,2299,571,754,143800,29376
429,269,160,588,59900,29377
52,8,44,-,-,29378
7432,4968,2464,577,74100,29379
1916,1505,411,698,84800,29384
3041,2143,898,689,101000,29385
5503,3927,1576,669,96600,29388
3964,1887,2077,1517,923800,29401
8714,3034,5680,954,332600,29403
326,0,326,1373,-,29404
9754,4295,5459,803,118500,29405
12029,4289,7740,874,115200,29406
15141,8180,6961,951,241800,29407
15,0,15,950,-,29409
7664,4644,3020,952,189800,29410
16601,11611,4990,1159,261000,29412
16114,10087,6027,1099,210100,29414
10007,4971,5036,875,134600,29418
8219,5314,2905,1004,169800,29420
0,0,0,-,-,29423
0,0,0,-,-,29424
590,500,90,775,122900,29426
1021,863,158,735,299100,29429
2416,1821,595,710,132300,29431
1251,1055,196,488,72200,29432
231,185,46,926,-,29434
1635,1377,258,802,79000,29435
1660,1349,311,679,89100,29436
1093,881,212,629,113000,29437
1105,995,110,846,313800,29438
1020,589,431,1048,573200,29439
10389,7443,2946,638,121100,29440
20490,12940,7550,1021,155700,29445
332,283,49,-,-,29446
748,540,208,694,88700,29448
3583,2963,620,917,189000,29449
1261,1084,177,968,95300,29450
1919,1580,339,1714,759200,29451
121,81,40,655,38500,29452
408,352,56,708,101300,29453
8777,6977,1800,1096,278700,29455
10384,6763,3621,1050,142100,29456
997,810,187,877,155600,29458
12436,9623,2813,839,167000,29461
20503,12968,7535,1355,383900,29464
12058,9778,2280,1593,386600,29466
762,525,237,561,83500,29468
532,471,61,609,246100,29469
1916,1462,454,899,147500,29470
624,561,63,-,85400,29471
2671,2104,567,790,119300,29472
990,887,103,564,81000,29474
1041,898,143,535,75400,29475
2558,2114,444,571,80200,29477
2500,1824,676,628,112900,29479
639,508,131,487,59800,29481
790,686,104,2114,1218400,29482
26616,18779,7837,962,163900,29483
18936,13157,5779,1076,181100,29485
1048,940,108,765,318800,29487
8497,5276,3221,718,93900,29488
4625,3248,1377,1426,473000,29492
45,37,8,-,137500,29493
17756,10678,7078,729,162900,29501
10049,7342,2707,808,149800,29505
7253,4344,2909,605,98900,29506
3843,2948,895,677,75200,29510
2034,1468,566,750,120400,29511
6035,3996,2039,563,68000,29512
341,235,106,693,62000,29516
529,364,165,-,94700,29518
133,121,12,-,57900,29519
5765,3718,2047,545,94200,29520
823,491,332,490,54300,29525
15680,10780,4900,804,153000,29526
9217,6425,2792,730,121500,29527
943,786,157,499,76400,29530
8086,5017,3069,608,82600,29532
5745,3435,2310,531,72500,29536
2026,1621,405,538,66700,29540
3361,2713,648,833,105300,29541
170,128,42,-,77600,29543
1953,1426,527,766,110000,29544
616,497,119,686,82100,29545
1022,702,320,545,66300,29546
1109,742,367,492,51400,29547
12363,8503,3860,622,93600,29550
3422,2830,592,634,71100,29554
2130,1599,531,527,81800,29555
4738,3336,1402,617,70700,29556
4914,3160,1754,646,69800,29560
1015,658,357,467,58800,29563
320,232,88,611,49800,29564
2516,1828,688,525,60700,29565
7543,5619,1924,809,164800,29566
215,151,64,624,41800,29567
5592,4416,1176,965,149700,29568
5926,4691,1235,705,96900,29569
1459,1010,449,348,49900,29570
5608,3783,1825,533,77200,29571
4353,2840,1513,848,264000,29572
4636,3319,1317,450,72900,29574
8056,5911,2145,821,192900,29575
12953,10710,2243,1032,186800,29576
12768,6411,6357,838,158500,29577
14161,9122,5039,992,183500,29579
442,373,69,706,54700,29580
1837,1336,501,609,80700,29581
7989,5577,2412,893,255000,29582
1951,1568,383,548,68200,29583
955,699,256,618,52600,29584
6464,5157,1307,1091,320100,29585
16274,11115,5159,885,161000,29588
877,681,196,1050,47800,29590
1922,1274,648,538,70800,29591
367,284,83,468,48900,29592
624,446,178,588,58800,29593
52,38,14,-,60000,29594
976,741,235,721,68600,29596
4931,1691,3240,681,268300,29601
13978,8736,5242,774,142700,29605
15833,7941,7892,887,178200,29607
12089,6961,5128,720,167700,29609
11037,5886,5151,689,81700,29611
0,0,0,-,-,29613
78,3,75,477,-,29614
16350,8737,7613,839,214200,29615
10206,5617,4589,693,112700,29617
5090,3926,1164,496,95900,29620
15900,10802,5098,786,162100,29621
5952,3044,2908,602,68400,29624
11947,7795,4152,735,128600,29625
5204,4064,1140,736,117000,29626
6650,4785,1865,602,93300,29627
914,631,283,596,49700,29628
6108,2945,3163,692,120000,29630
5360,2486,2874,868,201500,29631
86,0,86,850,-,29634
637,613,24,-,161500,29635
1201,965,236,717,79500,29638
385,272,113,730,117500,29639
11757,8366,3391,701,108600,29640
11969,9416,2553,791,164400,29642
924,876,48,747,185000,29643
7230,5439,1791,800,122400,29644
3607,2761,846,706,87000,29645
10391,5678,4713,639,98800,29646
10311,6626,3685,691,135500,29649
13114,9141,3973,916,211500,29650
17072,12416,4656,715,150000,29651
1853,1497,356,610,109300,29653
3819,2889,930,568,86700,29654
2751,2219,532,707,82100,29655
5704,4550,1154,714,97400,29657
158,158,0,-,87400,29658
41,19,22,563,73000,29659
2252,1506,746,603,92800,29661
6087,4032,2055,867,149600,29662
905,773,132,543,153000,29664
84,19,65,-,-,29665
2633,2070,563,634,86900,29666
95,84,11,-,105300,29667
4578,3490,1088,631,100500,29669
3568,2356,1212,581,133900,29670
6910,5551,1359,660,115300,29671
5186,4044,1142,811,249600,29672
10172,7346,2826,734,139700,29673
2620,2302,318,732,213400,29676
8962,5738,3224,703,132000,29678
10367,8115,2252,952,163800,29680
18641,16045,2596,993,207500,29681
1414,1158,256,589,106400,29682
82,82,0,-,76300,29683
1593,1282,311,620,81000,29684
601,545,56,-,166100,29685
315,236,79,339,136400,29686
15859,11225,4634,755,142000,29687
1710,1489,221,700,196200,29689
7593,5739,1854,710,138900,29690
4202,2879,1323,643,106500,29691
1835,1271,564,695,55500,29692
5585,4129,1456,615,118400,29693
1928,1399,529,842,162900,29696
5072,3784,1288,676,117100,29697
3489,2337,1152,646,81500,29702
1507,1179,328,519,164200,29704
7379,5177,2202,562,90400,29706
9697,8810,887,1237,263400,29707
10888,8994,1894,1152,284700,29708
2550,2034,516,538,73800,29709
12300,9511,2789,925,175400,29710
805,664,141,924,107900,29712
1137,791,346,668,87000,29714
10671,7920,2751,922,198400,29715
466,416,50,486,124300,29717
1559,1160,399,479,81800,29718
16555,12005,4550,645,114000,29720
16,0,16,531,-,29724
581,492,89,836,115100,29726
633,491,142,531,45100,29727
4001,2505,1496,634,83900,29728
779,669,110,692,87800,29729
21186,12004,9182,814,128400,29730
22450,15007,7443,862,162900,29732
0,0,0,-,-,29733
864,812,52,642,73000,29741
987,862,125,611,106300,29742
417,335,82,674,144100,29743
10893,8476,2417,783,144500,29745
10106,6358,3748,743,119300,29801
15538,12255,3283,878,187100,29803
2276,1926,350,597,122600,29805
1091,749,342,660,86300,29809
1880,1164,716,549,52600,29810
4258,3016,1242,649,85600,29812
470,280,190,708,57400,29816
1877,1448,429,538,62900,29817
598,442,156,527,61100,29819
523,417,106,575,117200,29821
2592,1822,770,574,119600,29824
52,42,10,369,56400,29826
1194,739,455,606,51900,29827
421,270,151,324,65700,29828
3963,3003,960,613,143700,29829
1581,1317,264,607,79400,29831
2067,1364,703,547,89600,29832
760,516,244,576,63000,29834
3070,2321,749,466,135500,29835
214,205,9,-,50300,29836
223,207,16,-,190200,29838
135,126,9,-,65700,29840
13010,8596,4414,722,134700,29841
3096,2133,963,643,85400,29842
508,413,95,672,62300,29843
58,58,0,-,134400,29844
409,306,103,506,60000,29845
1648,1341,307,831,83500,29847
256,234,22,523,95300,29848
87,81,6,575,96600,29849
181,100,81,-,39300,29850
2839,2072,767,663,83200,29851
2414,1724,690,553,68700,29853
1122,880,242,661,74600,29856
5671,4905,766,857,170800,29860
0,0,0,-,-,29899
5567,3232,2335,876,195800,29902
0,0,0,-,-,29904
10,0,10,-,-,29905
8082,3785,4297,971,126000,29906
4796,3753,1043,1207,233500,29907
9109,8200,909,1228,275600,29909
13770,9102,4668,1156,255700,29910
664,557,107,625,69000,29911
0,0,0,-,-,29912
233,227,6,-,444700,29915
567,483,84,-,78300,29916
1470,1073,397,570,73300,29918
4137,3440,697,932,185100,29920
86,66,20,470,47600,29921
305,266,39,471,39200,29922
236,209,27,628,49300,29923
1660,1187,473,604,89900,29924
10305,7954,2351,1083,419200,29926
2725,1482,1243,891,129400,29927
7885,5814,2071,1161,542400,29928
447,385,62,814,76400,29929
117,95,22,583,105500,29932
397,319,78,-,83800,29934
1698,646,1052,948,170900,29935
4934,3476,1458,777,98200,29936
142,126,16,-,38500,29939
1423,1181,242,844,97700,29940
277,190,87,-,-,29941
142,101,41,-,195400,29943
1814,1314,500,592,80500,29944
1894,1543,351,706,69400,29945
2709,1538,1171,725,273400,30002
21156,15469,5687,1251,358500,30004
12639,8823,3816,1280,371500,30005
10657,5696,4961,938,132300,30008
6248,3603,2645,1228,254700,30009
4669,3480,1189,1033,126000,30011
9040,4873,4167,854,103800,30012
9171,6217,2954,911,163500,30013
13256,7770,5486,832,132600,30014
16925,12268,4657,1087,106600,30016
7195,6150,1045,1279,225200,30017
13435,11603,1832,1563,203000,30019
7344,1650,5694,847,116500,30021
23435,16557,6878,1217,349200,30022
22398,19241,3157,1489,285800,30024
3371,2648,723,893,170000,30025
7647,6503,1144,1054,220100,30028
11210,6614,4596,952,345700,30030
17115,7964,9151,889,89200,30032
12663,6932,5731,1073,254500,30033
15550,9599,5951,951,96400,30034
7678,4017,3661,938,94300,30035
15043,8039,7004,975,118500,30038
14313,11114,3199,1290,141400,30039
21008,17435,3573,1180,261500,30040
20073,17006,3067,1146,303500,30041
27100,19331,7769,1158,173000,30043
27563,16823,10740,1142,146100,30044
10271,8910,1361,1441,166900,30045
12005,6527,5478,895,131300,30046
20081,15182,4899,1116,173300,30047
20204,16062,4142,1147,157600,30052
4029,3113,916,917,158200,30054
977,781,196,1037,147000,30055
825,653,172,719,143800,30056
19499,11321,8178,1049,99100,30058
12932,5246,7686,880,121800,30060
23572,18162,5410,1161,265900,30062
17629,14432,3197,1095,229000,30064
19760,15697,4063,1262,209700,30066
20273,8119,12154,988,282900,30067
12023,9884,2139,1139,356500,30068
181,33,148,664,35800,30070
7406,3363,4043,958,145500,30071
351,252,99,822,137500,30072
19795,15821,3974,1154,345200,30075
16114,9481,6633,1093,267700,30076
10711,8174,2537,1101,169200,30078
1044,522,522,697,135800,30079
25389,10879,14510,993,213000,30080
10870,6838,4032,1079,222100,30082
19600,9113,10487,885,97600,30083
13789,9479,4310,972,181400,30084
13681,11352,2329,1223,162300,30087
9358,5470,3888,998,95500,30088
13483,6684,6799,992,296700,30092
18210,5614,12596,920,113200,30093
11370,8675,2695,1019,143800,30094
25562,10797,14765,1082,173200,30096
15486,11344,4142,1354,367500,30097
19400,15235,4165,1144,199600,30101
13635,9813,3822,974,149200,30102
5694,3428,2266,742,114800,30103
1480,1168,312,778,87300,30104
826,669,157,857,151500,30105
7893,4301,3592,933,118800,30106
4900,4194,706,957,196500,30107
2878,1958,920,688,104900,30108
4821,3196,1625,684,119500,30110
2429,1887,542,746,105900,30113
18092,12518,5574,874,233700,30114
12981,10911,2070,1086,237600,30115
8204,5964,2240,886,116600,30116
13504,6355,7149,757,115200,30117
0,0,0,-,-,30118
14194,8806,5388,840,139900,30120
8362,4735,3627,879,121400,30121
9267,4564,4703,998,106200,30122
1126,831,295,558,128300,30124
8674,5595,3079,677,106000,30125
14606,10371,4235,964,181100,30126
20995,17468,3527,1144,167500,30127
12508,9301,3207,929,162700,30132
14536,9591,4945,939,111000,30134
21021,15803,5218,1066,148600,30135
613,412,201,836,108200,30137
1568,1055,513,661,101800,30139
7816,6015,1801,1072,134600,30141
8524,6479,2045,879,213700,30143
19744,10950,8794,1145,169300,30144
2552,2239,313,900,140100,30145
1716,1109,607,673,92200,30147
215,186,29,725,157500,30148
44,0,44,864,-,30149
15172,11090,4082,1107,221200,30152
6603,4296,2307,709,94100,30153
16104,12847,3257,1054,128300,30157
13322,7642,5680,649,122300,30161
0,0,0,-,-,30164
14886,8585,6301,713,119600,30165
9249,4209,5040,850,99500,30168
962,811,151,758,99000,30170
1272,1024,248,806,122400,30171
2024,1425,599,715,109200,30173
2140,1748,392,743,127300,30175
2709,1879,830,664,96800,30176
431,342,89,828,131700,30177
1042,888,154,850,122900,30178
5890,4509,1381,836,94400,30179
12966,9669,3297,936,130800,30180
937,712,225,614,96700,30182
1726,1363,363,987,213100,30183
2582,2103,479,1011,163600,30184
1439,1117,322,850,120700,30185
2741,2367,374,1120,141500,30187
21136,16407,4729,1282,186700,30188
13124,10567,2557,1183,209200,30189
4376,2882,1494,633,113100,30204
1054,895,159,692,222200,30205
990,865,125,1056,120800,30206
10813,6397,4416,947,136700,30213
10762,8740,2022,1050,184500,30214
12280,10581,1699,1114,227300,30215
772,545,227,1027,87800,30216
3636,2504,1132,738,98100,30217
660,549,111,-,79400,30218
1738,1175,563,966,117100,30220
1621,1034,587,581,88000,30222
12959,7374,5585,776,103300,30223
8917,5887,3030,847,124700,30224
12516,9339,3177,1049,120800,30228
3122,2138,984,849,103300,30230
7482,5626,1856,746,128700,30233
717,408,309,806,90000,30234
15617,8497,7120,914,111000,30236
11851,6693,5158,1000,82000,30238
10597,6473,4124,755,134500,30240
8605,4363,4242,846,111700,30241
7981,6504,1477,1069,153300,30248
32,0,32,-,-,30250
902,540,362,746,109800,30251
13597,11628,1969,1213,170800,30252
18198,10764,7434,1012,143200,30253
815,710,105,588,115900,30256
1672,1419,253,763,131600,30257
980,780,200,858,126400,30258
1050,839,211,1046,172800,30259
8803,4132,4671,878,83700,30260
20947,13353,7594,907,165900,30263
12568,9498,3070,1145,188800,30265
3108,2174,934,866,121800,30268
12859,9560,3299,1262,286700,30269
4836,3637,1199,1134,95500,30273
12309,5077,7232,863,72500,30274
0,0,0,-,-,30275
5263,4430,833,1049,196700,30276
7735,6666,1069,1039,208100,30277
23722,15335,8387,1045,128800,30281
23,17,6,-,-,30284
140,140,0,-,93100,30285
8885,5758,3127,641,82900,30286
3026,2392,634,854,87900,30288
28,14,14,800,264300,30289
2863,2360,503,898,240300,30290
7863,3052,4811,864,79000,30291
2030,1773,257,728,165000,30292
1145,932,213,722,62600,30293
13442,10411,3031,995,122200,30294
1554,1189,365,640,131400,30295
8935,5675,3260,1125,86600,30296
8433,3472,4961,818,58700,30297
1227,227,1000,748,150600,30303
11549,6684,4865,1197,495400,30305
10800,5909,4891,1155,542600,30306
9075,4753,4322,1086,413200,30307
10352,2966,7386,1124,234000,30308
13332,6149,7183,1202,279600,30309
10731,3883,6848,883,81400,30310
13575,5243,8332,793,91800,30311
11244,3484,7760,984,211200,30312
2011,653,1358,934,206400,30313
7184,2138,5046,828,73300,30314
11370,3901,7469,797,91400,30315
12659,7618,5041,1044,183100,30316
5386,3401,1985,919,245800,30317
20291,7833,12458,1019,176200,30318
18529,10083,8446,1334,412900,30319
0,0,0,-,-,30322
13805,5187,8618,1185,302300,30324
3261,1239,2022,1702,275000,30326
9383,7270,2113,1324,838700,30327
15605,8830,6775,1221,361800,30328
11824,2753,9071,1147,280300,30329
22948,10588,12360,896,137200,30331
0,0,0,-,-,30332
0,0,0,-,-,30334
177,9,168,974,-,30336
5366,1548,3818,769,159600,30337
13794,8625,5169,1242,409500,30338
11572,3632,7940,1159,310800,30339
9470,3858,5612,934,167700,30340
12426,5570,6856,1019,247400,30341
12405,6000,6405,1091,527200,30342
12810,5457,7353,935,88000,30344
9675,5066,4609,1094,355300,30345
3240,124,3116,1375,214000,30346
24177,13691,10486,855,116000,30349
16640,5879,10761,1024,419900,30350
6202,1926,4276,884,86600,30354
5268,2968,2300,927,264200,30360
1627,599,1028,1588,236900,30363
4774,3034,1740,614,74900,30401
595,419,176,708,111100,30410
792,600,192,489,54800,30411
36,32,4,-,160000,30412
716,525,191,598,63600,30413
2526,1919,607,737,115500,30415
3960,2582,1378,626,87300,30417
483,347,136,466,63900,30420
1566,1146,420,531,75200,30421
88,24,64,663,85000,30423
522,443,79,483,75900,30425
295,206,89,629,59500,30426
3861,2600,1261,613,109000,30427
1193,733,460,533,43600,30428
85,53,32,-,-,30429
1857,1126,731,593,77900,30434
4379,2904,1475,558,71100,30436
24,14,10,-,-,30438
4015,2476,1539,579,89700,30439
781,562,219,520,70400,30441
3116,2051,1065,503,57400,30442
1249,775,474,493,60800,30445
508,389,119,680,66500,30446
13,13,0,-,64400,30448
46,31,15,654,65000,30449
907,613,294,854,84500,30450
11,4,7,-,175000,30451
513,448,65,629,86700,30452
2472,1477,995,508,64800,30453
292,225,67,-,66900,30454
241,191,50,725,76400,30455
736,569,167,387,69900,30456
2417,1670,747,529,71400,30457
15642,5522,10120,761,138400,30458
0,0,0,-,-,30460
5068,3407,1661,749,149000,30461
25,14,11,555,-,30464
4477,3063,1414,577,82200,30467
158,131,27,436,104600,30470
1933,1249,684,484,59900,30471
931,749,182,463,86700,30473
6583,3960,2623,560,103100,30474
0,0,0,-,-,30475
1065,644,421,480,59000,30477
9276,3767,5509,769,133000,30501
8001,3645,4356,870,155300,30504
15346,11801,3545,973,196700,30506
8186,5678,2508,839,125700,30507
2290,1777,513,579,109300,30510
1319,983,336,620,120800,30511
8119,6328,1791,677,189800,30512
4636,3440,1196,734,171800,30513
577,480,97,738,70800,30516
4149,3471,678,1142,183400,30517
15576,11386,4190,1043,185000,30518
13302,10048,3254,1205,194600,30519
1751,1301,450,684,111000,30520
1790,1486,304,491,98900,30521
422,394,28,-,174100,30522
4957,3892,1065,796,142700,30523
2901,2055,846,663,146800,30525
1479,1192,287,941,186200,30527
8832,6271,2561,737,141400,30528
3599,2236,1363,732,106500,30529
2100,1686,414,738,135400,30530
3751,2393,1358,646,138500,30531
9247,5871,3376,872,176100,30533
10514,7957,2557,900,196900,30534
2475,1896,579,718,140000,30535
3312,2594,718,819,172500,30536
603,409,194,550,193800,30537
942,816,126,747,77700,30538
6892,4976,1916,686,133600,30540
632,531,101,875,130800,30541
12003,9043,2960,1028,178200,30542
1396,1085,311,861,109700,30543
363,237,126,930,163600,30545
3048,2474,574,618,193200,30546
1188,959,229,619,125800,30547
6083,5470,613,1063,240500,30548
8084,5942,2142,775,161500,30549
703,559,144,897,233900,30552
2902,1810,1092,700,141200,30553
2681,1963,718,852,130100,30554
942,584,358,432,116700,30555
1684,1380,304,625,93700,30557
2040,1470,570,778,111200,30558
1913,1493,420,955,172100,30559
1880,1663,217,826,169000,30560
440,327,113,672,63700,30562
2027,1660,367,755,118300,30563
1366,983,383,792,152500,30564
1552,1317,235,646,129800,30565
2695,1715,980,866,131600,30566
1225,927,298,849,181700,30567
809,453,356,685,152700,30568
1850,1492,358,873,203300,30571
445,401,44,609,155500,30572
73,66,7,-,297000,30573
322,195,127,584,153500,30575
979,834,145,672,153700,30576
7935,5467,2468,580,101200,30577
0,0,0,-,-,30581
1803,1382,421,715,169100,30582
8757,2903,5854,747,99000,30601
0,0,0,-,-,30602
15555,4876,10679,795,159000,30605
16634,7498,9136,815,188800,30606
3283,1958,1325,754,141000,30607
0,0,0,-,-,30609
481,339,142,800,148400,30619
4060,3424,636,1130,134400,30620
1658,1485,173,912,277400,30621
4212,2868,1344,955,193600,30622
115,115,0,-,103100,30623
1225,937,288,613,65800,30624
1023,718,305,858,197600,30625
961,766,195,506,83300,30627
2593,2076,517,721,132400,30628
1766,1282,484,772,100000,30629
857,576,281,541,101500,30630
738,525,213,604,59800,30631
3146,2244,902,689,120800,30633
785,621,164,691,96500,30634
5893,4010,1883,626,85900,30635
841,755,86,1219,165800,30641
4734,3430,1304,659,363000,30642
6533,4630,1903,571,119900,30643
2485,1698,787,753,128900,30646
1258,863,395,650,111600,30648
4216,3153,1063,850,194400,30650
8596,4878,3718,810,142500,30655
5388,4356,1032,871,167900,30656
456,341,115,678,82600,30660
3494,2129,1365,563,108700,30662
1153,891,262,666,183400,30663
19,17,2,-,36500,30664
27,11,16,715,-,30665
3126,2452,674,901,130800,30666
396,311,85,939,89800,30667
715,599,116,563,68700,30668
1180,798,382,727,77000,30669
3071,1999,1072,587,92200,30673
6505,5355,1150,896,224200,30677
622,487,135,397,117500,30678
13405,9024,4381,906,123800,30680
2486,1776,710,855,136300,30683
13710,8261,5449,655,118400,30701
12129,7742,4387,631,99000,30705
6073,4537,1536,669,110600,30707
83,71,12,-,84900,30708
2375,1849,526,534,143800,30710
1334,1028,306,662,84100,30711
9768,5226,4542,673,153500,30720
17276,10721,6555,660,100300,30721
1623,1246,377,704,143200,30725
0,0,0,-,-,30726
7635,5419,2216,620,98000,30728
718,529,189,696,60300,30730
1060,755,305,491,83700,30731
809,606,203,741,98000,30733
1258,996,262,790,78100,30734
2032,1467,565,640,98000,30735
15054,12142,2912,715,148900,30736
1557,1287,270,943,139400,30738
1733,1527,206,1123,167200,30739
3065,2385,680,737,148500,30740
11776,7605,4171,708,88100,30741
2864,1394,1470,758,112400,30742
584,382,202,796,121100,30746
5909,3993,1916,616,76800,30747
1343,1098,245,853,258800,30750
11,11,0,-,-,30751
3262,2461,801,617,115800,30752
2477,1667,810,637,52000,30753
3218,2367,851,757,116700,30755
62,19,43,-,89000,30756
937,620,317,846,84400,30757
2010,1712,298,642,164900,30802
292,237,55,554,69700,30803
927,659,268,710,80300,30805
34,31,3,-,58200,30807
1551,1153,398,628,74900,30808
13657,11098,2559,1400,228200,30809
727,540,187,488,66400,30810
0,0,0,-,-,30812
12064,8888,3176,1103,164800,30813
2768,2191,577,720,120900,30814
13422,9442,3980,936,100200,30815
691,527,164,624,86400,30816
3307,2390,917,640,122000,30817
261,205,56,-,66800,30818
450,325,125,494,59900,30820
345,273,72,632,53800,30821
228,177,51,-,-,30822
625,531,94,440,60700,30823
6490,3802,2688,614,113100,30824
1671,1050,621,563,63400,30828
5082,3493,1589,491,84800,30830
1338,719,619,524,66400,30833
6372,2009,4363,618,59300,30901
251,229,22,-,165600,30903
10129,4792,5337,689,103100,30904
1102,0,1102,1200,-,30905
20111,11368,8743,790,82000,30906
18574,13426,5148,944,147000,30907
17724,8586,9138,817,145600,30909
0,0,0,-,-,30912
1046,719,327,451,57800,31001
986,749,237,425,64500,31002
52,47,5,-,65000,31003
6209,4811,1398,989,153200,31005
1801,1163,638,621,55700,31006
410,340,70,538,61500,31007
7010,5182,1828,839,134300,31008
547,425,122,611,69100,31009
320,252,68,525,95900,31011
507,325,182,466,44800,31012
4420,3245,1175,572,88300,31014
7923,4438,3485,637,92400,31015
495,370,125,492,75000,31016
642,517,125,526,69200,31017
484,352,132,618,77300,31018
834,616,218,591,103500,31019
737,590,147,760,59800,31020
10377,5976,4401,552,108200,31021
532,435,97,541,109300,31022
5821,3575,2246,564,73500,31023
7813,5742,2071,674,151800,31024
504,469,35,715,151600,31025
3489,2138,1351,609,54800,31027
2043,1338,705,983,159200,31028
5775,4067,1708,676,137100,31029
6194,3990,2204,619,98700,31030
2197,1689,508,620,75400,31031
5003,4043,960,859,147600,31032
933,713,220,737,71900,31033
447,374,73,575,81500,31035
4231,2512,1719,655,125700,31036
1171,686,485,587,53600,31037
341,303,38,-,159900,31038
0,0,0,-,-,31039
325,204,121,552,54300,31041
577,482,95,817,71500,31042
1125,781,344,392,72800,31044
28,17,11,-,-,31045
1218,1127,91,466,159400,31046
4479,3607,872,957,188400,31047
642,526,116,615,80800,31049
382,282,100,761,-,31050
71,36,35,336,52500,31051
3074,2667,407,836,143300,31052
616,460,156,766,56200,31054
2378,1462,916,571,60600,31055
798,555,243,590,88600,31057
559,491,68,590,73400,31058
915,677,238,607,68500,31060
15447,8272,7175,687,110400,31061
14,0,14,-,-,31062
1931,1132,799,558,74200,31063
3583,2509,1074,780,115000,31064
328,223,105,471,94200,31065
525,446,79,546,123500,31066
89,84,5,-,33200,31067
1329,805,524,575,58900,31068
6801,4394,2407,760,142100,31069
387,291,96,475,84200,31070
420,342,78,489,63800,31071
618,461,157,413,68300,31072
1009,757,252,732,68400,31075
1392,1024,368,517,58800,31076
578,415,163,556,63400,31077
1158,765,393,622,68100,31078
823,619,204,596,86400,31079
69,35,34,-,-,31081
4037,2796,1241,577,83100,31082
122,90,32,606,46100,31083
8,8,0,-,-,31084
373,279,94,856,102400,31085
2874,2225,649,637,67700,31087
19802,13482,6320,901,134400,31088
1671,1071,600,650,73100,31089
284,204,80,430,75000,31090
1458,1003,455,341,66200,31091
2808,1642,1166,570,96200,31092
11388,5727,5661,745,94500,31093
451,330,121,574,93900,31094
2282,1561,721,486,62700,31096
546,415,131,919,105800,31097
958,0,958,1100,-,31098
3454,719,2735,553,74500,31201
11973,5653,6320,690,93500,31204
9257,3972,5285,658,59700,31206
4,4,0,-,-,31207
13337,7363,5974,871,196200,31210
6137,3682,2455,679,101500,31211
0,0,0,-,-,31213
5745,4557,1188,804,143300,31216
6116,3910,2206,627,70600,31217
5317,3339,1978,865,151000,31220
1683,725,958,745,121600,31301
2986,2283,703,978,135600,31302
710,566,144,749,153100,31303
0,0,0,-,-,31304
2362,1536,826,688,102300,31305
387,366,21,-,114600,31307
2616,2014,602,878,124200,31308
292,137,155,714,70600,31309
5731,4736,995,873,150900,31312
15482,7251,8231,935,122600,31313
0,0,0,-,-,31314
2517,14,2503,1178,-,31315
3546,2516,1030,626,124800,31316
120,112,8,-,230000,31318
3214,2331,883,951,130400,31320
2439,1852,587,643,126300,31321
9339,5874,3465,1176,174800,31322
531,395,136,721,80500,31323
8070,5446,2624,1272,237200,31324
6940,5055,1885,1012,166200,31326
202,202,0,-,-,31327
1406,944,462,1238,419300,31328
3125,2186,939,888,123800,31329
2619,2367,252,734,111300,31331
8223,2457,5766,889,247400,31401
11568,5191,6377,895,110600,31404
14178,7249,6929,947,175600,31405
13498,7568,5930,958,172600,31406
4228,2628,1600,1054,186600,31407
3334,1142,2192,808,100000,31408
0,0,0,-,-,31409
9770,7365,2405,1171,237900,31410
3735,3453,282,1169,472300,31411
4582,1825,2757,760,81900,31415
21509,10714,10795,987,158800,31419
5992,3147,2845,642,77800,31501
7856,5184,2672,631,78100,31503
3410,2284,1126,556,67200,31510
871,705,166,389,88900,31512
5939,4104,1835,504,72700,31513
5378,4075,1303,591,98100,31516
286,247,39,456,104600,31518
1263,942,321,533,69400,31519
8687,3875,4812,724,94300,31520
7273,5171,2102,1192,355800,31522
5232,4286,946,816,146600,31523
0,0,0,-,-,31524
10892,6062,4830,826,137100,31525
368,209,159,953,382400,31527
311,259,52,282,49800,31532
5811,3255,2556,526,97100,31533
4084,2906,1178,622,81400,31535
2878,2102,776,596,82800,31537
4984,3660,1324,514,74900,31539
981,669,312,538,66700,31542
1637,1395,242,367,66000,31543
269,178,91,496,66200,31544
5657,3435,2222,614,85400,31545
2319,1452,867,575,119900,31546
125,0,125,1130,-,31547
7550,4448,3102,902,141600,31548
967,561,406,575,37500,31549
357,172,185,-,71500,31550
408,256,152,488,56800,31551
320,320,0,-,37300,31552
1805,1511,294,604,72100,31553
1831,1490,341,574,54200,31554
959,830,129,613,103000,31555
19,16,3,-,-,31556
1046,825,221,584,89100,31557
7626,3698,3928,969,166800,31558
1005,756,249,567,101500,31560
120,106,14,-,-,31561
715,587,128,525,75400,31562
522,438,84,719,76100,31563
771,677,94,1017,167200,31565
1230,1149,81,632,62300,31566
244,183,61,-,123700,31567
399,336,63,-,107700,31568
2059,1586,473,779,134600,31569
11744,4803,6941,642,81800,31601
13353,5844,7509,807,131100,31602
7675,4727,2948,966,157800,31605
1249,970,279,615,79400,31606
3600,2396,1204,681,97400,31620
761,641,120,450,69900,31622
27,21,6,-,-,31623
441,373,68,480,71700,31624
543,440,103,546,104000,31625
1338,938,400,718,108000,31626
96,62,34,650,119400,31627
249,166,83,-,133700,31629
158,89,69,378,44500,31630
203,173,30,763,45700,31631
3989,2986,1003,832,126700,31632
2196,1572,624,498,68500,31634
2120,1046,1074,541,102300,31635
3532,2286,1246,663,139200,31636
1169,868,301,658,70400,31637
412,236,176,609,81300,31638
3930,2862,1068,536,83900,31639
657,461,196,713,125400,31641
1580,1047,533,520,65900,31642
3548,2547,1001,606,85800,31643
2155,1545,610,633,106700,31645
1327,851,476,736,48100,31647
444,226,218,701,41000,31648
461,417,44,908,133000,31649
1278,905,373,514,54300,31650
0,0,0,-,-,31698
0,0,0,-,-,31699
7660,2464,5196,607,76300,31701
11187,5582,5605,661,71900,31705
10842,4124,6718,740,114900,31707
6250,3195,3055,661,109000,31709
278,203,75,-,60800,31711
451,303,148,538,69500,31712
2357,1593,764,564,75100,31714
981,779,202,538,80800,31716
3335,1894,1441,579,69300,31719
151,71,80,626,85900,31720
7745,5814,1931,865,162700,31721
135,107,28,525,65000,31722
3356,2247,1109,579,77400,31730
612,495,117,664,138500,31733
443,275,168,627,124600,31735
846,613,233,612,91400,31738
175,72,103,830,83200,31743
1013,698,315,586,73700,31744
75,56,19,-,47800,31747
861,571,290,529,79800,31749
6919,4315,2604,605,83400,31750
246,232,14,-,92800,31756
3973,2601,1372,815,145900,31757
8321,5907,2414,864,150200,31763
508,397,111,619,79600,31764
1183,900,283,502,91400,31765
7786,4187,3599,622,80600,31768
1968,1324,644,535,75800,31771
195,183,12,-,130200,31772
1338,1018,320,756,129800,31773
2283,1536,747,458,69300,31774
1018,759,259,586,67100,31775
1029,787,242,524,91600,31778
3213,2056,1157,546,76700,31779
762,537,225,618,71600,31780
712,505,207,690,72000,31781
347,336,11,-,71800,31783
287,172,115,687,80000,31784
566,435,131,579,91200,31787
3570,2371,1199,544,99700,31788
460,339,121,680,58000,31789
607,452,155,613,68500,31790
4628,3017,1611,641,82700,31791
9451,5146,4305,744,130000,31792
3354,2353,1001,647,147500,31793
9469,4773,4696,582,102600,31794
835,648,187,675,80500,31795
482,359,123,613,84500,31796
232,200,32,-,57900,31798
942,831,111,773,111000,31801
2203,1476,727,502,100800,31803
2003,1866,137,985,214700,31804
1126,764,362,532,64900,31805
1873,1265,608,645,102700,31806
1085,886,199,984,193500,31807
2364,2062,302,1021,220700,31808
110,73,37,529,112500,31810
2024,1688,336,1043,214400,31811
221,182,39,304,-,31812
124,103,21,-,-,31814
725,427,298,524,55800,31815
2069,1111,958,775,77700,31816
3381,2960,421,1243,272700,31820
80,66,14,-,41600,31821
2164,1518,646,801,147700,31822
328,258,70,702,118000,31823
685,549,136,555,42700,31824
1042,729,313,437,54900,31825
947,776,171,772,93000,31826
928,706,222,511,56900,31827
354,325,29,-,263400,31829
868,564,304,649,104900,31830
1268,1072,196,493,171600,31831
55,33,22,-,46100,31832
2865,1653,1212,741,122800,31833
417,354,63,521,72400,31836
3274,603,2671,542,149700,31901
7503,2410,5093,642,62600,31903
13236,6659,6577,834,163500,31904
3466,16,3450,1454,104200,31905
8666,3702,4964,702,121100,31906
20160,11418,8742,879,110600,31907
15101,7776,7325,1017,158500,31909
10301,8226,2075,1399,233800,32003
2086,1714,372,639,84300,32008
1098,960,138,884,151500,32009
4863,3750,1113,852,151500,32011
6503,5479,1024,793,112600,32024
7553,4579,2974,819,107500,32025
0,0,0,-,-,32026
1767,1517,250,1240,120900,32033
14056,10345,3711,1172,269400,32034
3567,2927,640,771,95900,32038
2326,1942,384,630,130800,32040
8938,6987,1951,830,158700,32043
699,576,123,-,130500,32044
3307,2586,721,863,123000,32046
2740,1904,836,562,67600,32052
1293,1051,242,668,72800,32053
3410,2399,1011,528,92600,32054
5980,4044,1936,754,96900,32055
1247,1039,208,627,96900,32058
935,763,172,731,82700,32059
8275,6015,2260,687,98700,32060
76,55,21,-,229800,32061
877,736,141,429,109700,32062
4349,3385,964,717,115000,32063
2292,993,1299,601,76800,32064
12235,8807,3428,1134,165800,32065
1879,1481,398,675,117400,32066
17601,13903,3698,1092,137000,32068
1251,849,402,638,69700,32071
93,93,0,-,73400,32072
14811,9521,5290,941,149200,32073
193,19,174,1113,104200,32079
9975,7009,2966,1049,293900,32080
3048,2273,775,1637,351700,32081
12837,10099,2738,1214,453000,32082
492,273,219,605,85200,32083
12510,7582,4928,937,168000,32084
11121,8120,3001,1041,176900,32086
1455,1090,365,689,70700,32087
5430,3617,1813,723,86700,32091
10750,9091,1659,1729,259400,32092
966,798,168,-,76900,32094
3044,2410,634,1239,172200,32095
1002,740,262,590,95300,32096
5873,4580,1293,1063,167700,32097
989,847,142,757,84700,32102
2636,1869,767,664,100600,32110
2715,1903,812,522,77200,32112
2017,1714,303,690,83700,32113
13247,4386,8861,758,88300,32114
9624,4913,4711,796,77800,32117
8954,5136,3818,861,177900,32118
9973,6123,3850,865,117500,32119
1361,1145,216,1573,202900,32124
12633,9464,3169,1048,156700,32127
7503,6585,918,1161,220700,32128
9229,6106,3123,1048,105700,32129
1977,1552,425,885,129700,32130
1742,1242,500,769,137700,32131
3096,2379,717,847,113000,32132
47,47,0,-,-,32133
3114,2401,713,700,74700,32134
3559,2840,719,999,218200,32136
15245,12008,3237,1120,199200,32137
485,429,56,-,55100,32139
380,343,37,-,82400,32140
7239,5894,1345,1055,131500,32141
1853,1479,374,755,82800,32145
133,73,60,-,-,32147
3795,2623,1172,680,71100,32148
113,93,20,-,158000,32157
15229,12595,2634,935,165700,32159
29686,28359,1327,1529,246200,32162
15764,11742,4022,1115,162000,32164
10844,8127,2717,948,170900,32168
5533,4136,1397,1216,303600,32169
20413,15739,4674,984,172600,32174
6850,5237,1613,1028,184900,32176
9719,6498,3221,662,86300,32177
2885,2196,689,634,66700,32179
1236,921,315,624,108400,32180
721,605,116,578,87600,32181
676,506,170,577,110500,32187
2789,2538,251,919,81300,32189
339,268,71,510,-,32190
413,308,105,422,122400,32193
1367,1169,198,935,128200,32195
1686,165,1521,570,129600,32202
3702,919,2783,911,153300,32204
12652,6227,6425,837,118000,32205
6685,2753,3932,732,72700,32206
14426,7255,7171,827,139400,32207
11869,7061,4808,851,75500,32208
12642,6488,6154,743,61400,32209
23133,12828,10305,871,100100,32210
12716,5880,6836,787,103900,32211
260,0,260,1560,-,32212
15715,7953,7762,975,124900,32216
8054,4330,3724,824,166300,32217
20056,12810,7246,921,136100,32218
3965,3134,831,901,126900,32219
4644,3730,914,884,121600,32220
9837,7195,2642,1152,141800,32221
3202,2473,729,1302,151800,32222
9492,7627,1865,1119,234900,32223
14532,8692,5840,1180,240700,32224
19886,14067,5819,1143,179400,32225
5542,4408,1134,1605,177300,32226
337,8,329,1409,-,32227
0,0,0,-,-,32228
9018,4800,4218,1048,225300,32233
2127,1606,521,767,106700,32234
21117,12979,8138,970,106900,32244
18974,10846,8128,1120,140500,32246
12459,7921,4538,1092,281700,32250
4552,2489,2063,864,70000,32254
19049,7204,11845,1084,247500,32256
15352,9736,5616,958,168300,32257
11014,8172,2842,1298,198600,32258
14390,12273,2117,1656,299000,32259
2952,1973,979,1192,338800,32266
10946,6059,4887,903,139900,32277
12854,3790,9064,905,141100,32301
20008,10143,9865,995,143400,32303
16569,2275,14294,849,86300,32304
7750,4577,3173,795,96300,32305
10551,5273,5278,965,192700,32308
12128,9704,2424,1079,243500,32309
6190,2849,3341,765,99400,32310
7752,4832,2920,1162,185100,32311
12107,9880,2227,1179,274200,32312
5189,4691,498,1445,229800,32317
1388,1044,344,711,130400,32320
1529,1116,413,545,71100,32321
1248,852,396,710,113000,32322
141,85,56,-,45300,32323
1545,1033,512,621,86900,32324
9180,7004,2176,825,134000,32327
1255,947,308,802,140200,32328
231,152,79,723,74100,32330
1642,1382,260,615,58600,32331
697,511,186,633,54000,32332
4586,3561,1025,703,143100,32333
834,672,162,581,66100,32334
676,632,44,-,90300,32336
3783,2786,997,600,90300,32340
1167,862,305,1032,127800,32343
4829,3682,1147,807,133000,32344
766,468,298,858,129900,32346
3093,2618,475,603,79200,32347
3454,2478,976,549,77500,32348
566,517,49,592,91800,32350
6443,4133,2310,676,88600,32351
2216,1760,456,744,87500,32352
111,65,46,-,122100,32355
65,65,0,-,-,32356
900,734,166,684,114000,32358
848,557,291,956,151000,32359
69,64,5,-,83600,32361
0,0,0,-,-,32399
9228,4811,4417,813,106100,32401
825,0,825,1366,-,32403
13582,8984,4598,874,144900,32404
12143,6405,5738,884,169100,32405
4126,1914,2212,1145,214800,32407
7180,4418,2762,992,211300,32408
3568,3021,547,779,133700,32409
502,363,139,1146,194400,32410
6156,4024,2132,1016,204700,32413
709,562,147,732,72700,32420
1810,1518,292,807,81600,32421
439,376,63,-,77400,32423
1987,1533,454,592,82200,32424
4682,3522,1160,622,87900,32425
343,271,72,668,71500,32426
430,367,63,536,77100,32427
5502,4258,1244,741,103200,32428
406,388,18,-,75200,32430
1603,1284,319,648,74300,32431
22,22,0,-,-,32432
5882,4061,1821,772,87900,32433
2787,2106,681,617,113500,32435
372,281,91,333,73800,32437
1443,1232,211,675,77900,32438
3415,2422,993,1012,199400,32439
1979,1408,571,649,104700,32440
1446,1007,439,533,79900,32442
1099,873,226,647,71800,32443
7798,5622,2176,984,188700,32444
509,369,140,582,86100,32445
4099,2870,1229,693,140400,32446
0,0,0,-,-,32447
3930,2465,1465,597,91300,32448
240,214,26,-,70600,32449
1653,1222,431,728,76600,32455
3068,2158,910,958,168200,32456
5821,3916,1905,1278,339200,32459
1400,1065,335,539,84900,32460
10,10,0,-,-,32461
1249,937,312,544,78200,32462
60,35,25,425,84200,32463
1737,1595,142,400,98800,32464
2429,1907,522,688,94200,32465
1951,1702,249,1103,114200,32466
4498,2076,2422,747,105500,32501
1304,699,605,839,98600,32502
11820,7036,4784,847,135300,32503
9222,5108,4114,908,147800,32504
10773,5407,5366,822,65700,32505
13798,7826,5972,950,110300,32506
12037,6616,5421,944,137300,32507
458,0,458,1183,-,32508
0,0,0,-,-,32509
0,0,0,-,-,32511
16614,8200,8414,950,134500,32514
14084,10446,3638,1028,116700,32526
0,0,0,-,-,32530
2051,1666,385,924,132000,32531
9759,7892,1867,909,155500,32533
5831,4240,1591,906,106800,32534
1778,1094,684,631,83600,32535
8272,5860,2412,1012,180200,32536
9183,6599,2584,965,140200,32539
7638,4751,2887,1341,332900,32541
673,2,671,1338,-,32542
359,0,359,1380,-,32544
14365,6924,7441,951,169400,32547
9085,4792,4293,960,160000,32548
3494,2536,958,1271,323100,32550
3685,2612,1073,1214,395600,32561
9513,7009,2504,1074,201900,32563
965,696,269,1242,153200,32564
2090,1722,368,810,106700,32565
13664,9881,3783,1175,201200,32566
1388,1117,271,688,118900,32567
1078,984,94,786,117600,32568
4851,3234,1617,1044,170400,32569
11223,7539,3684,889,124600,32570
11420,8884,2536,918,161800,32571
1660,1416,244,633,134300,32577
12410,9643,2767,1046,257200,32578
4457,2851,1606,1060,255300,32579
1558,954,604,1063,195800,32580
8996,6557,2439,1009,129200,32583
7686,2117,5569,783,127400,32601
1956,358,1598,782,274600,32603
9768,7023,2745,1114,170600,32605
9379,4840,4539,1115,194500,32606
11895,3922,7973,827,179700,32607
18905,7254,11651,904,218400,32608
6601,3628,2973,802,95400,32609
6,0,6,-,-,32612
5767,4387,1380,951,173000,32615
369,155,214,883,91900,32616
1659,1297,362,549,130200,32617
2926,2402,524,791,163500,32618
1854,1478,376,762,99700,32619
1990,1520,470,588,67900,32621
394,318,76,595,87000,32622
655,511,144,606,114800,32625
3352,2328,1024,629,86600,32626
1315,978,337,639,70800,32628
185,185,0,-,275000,32631
15,15,0,-,-,32639
4392,3441,951,748,100100,32640
4619,2828,1791,779,95800,32641
4073,3434,639,908,123900,32643
165,133,32,-,89200,32648
5820,4422,1398,939,181600,32653
5522,4438,1084,847,106200,32656
84,69,15,-,109000,32658
282,222,60,914,76500,32664
2526,1879,647,711,121300,32666
1475,1147,328,683,221800,32667
1800,1417,383,718,118700,32668
4406,3633,773,891,168300,32669
4347,3395,952,631,63000,32680
62,62,0,-,-,32681
75,71,4,-,-,32683
2016,1457,559,711,114800,32686
128,128,0,-,-,32692
4217,3230,987,636,83300,32693
759,571,188,676,84600,32694
4336,3358,978,686,109800,32696
107,13,94,1019,-,32697
9064,4883,4181,1041,132400,32701
1200,649,551,1781,68800,32702
16662,10031,6631,997,129500,32703
13835,8767,5068,1069,129200,32707
15479,11608,3871,1126,212300,32708
821,745,76,-,117100,32709
15315,12601,2714,1127,185400,32712
8058,6708,1350,1006,154900,32713
13434,6380,7054,1072,152900,32714
11696,8038,3658,874,145300,32720
12859,8542,4317,991,133600,32724
16511,12759,3752,1054,114600,32725
8010,5354,2656,797,121900,32726
2272,1143,1129,909,126300,32730
1697,1552,145,858,258100,32732
1863,1603,260,1039,113900,32735
3404,2958,446,813,193200,32736
14931,11459,3472,1110,109500,32738
1496,1237,259,853,113200,32744
15294,10039,5255,1309,260800,32746
8211,6141,2070,1172,182300,32750
8606,6097,2509,1269,250800,32751
4009,3518,491,764,123700,32754
10428,7248,3180,931,174100,32757
1184,859,325,799,142700,32759
8736,5426,3310,1005,94700,32763
1244,1135,109,1158,153000,32764
19121,13425,5696,1267,238400,32765
4866,4257,609,1498,286500,32766
1002,753,249,694,83800,32767
18139,11293,6846,1029,157700,32771
10327,6199,4128,986,99900,32773
3834,2964,870,1137,156800,32776
8768,6618,2150,890,115900,32778
10284,8478,1806,1287,269300,32779
15429,10423,5006,845,113300,32780
4239,3034,1205,743,120900,32784
10318,6762,3556,1019,383000,32789
20569,9699,10870,1022,175700,32792
8426,6292,2134,863,97200,32796
1309,1123,186,984,68000,32798
7319,1685,5634,1172,290400,32801
9210,5225,3985,1123,218000,32803
8076,4932,3144,1141,266300,32804
7825,2730,5095,759,89300,32805
11223,6617,4606,981,191200,32806
11387,5120,6267,953,108100,32807
17070,6888,10182,898,76600,32808
9551,5096,4455,900,118200,32809
12700,6341,6359,1027,105000,32810
14979,3868,11111,993,74300,32811
14490,7787,6703,1005,174500,32812
3160,1519,1641,1647,400500,32814
11919,6381,5538,1124,161600,32817
16070,8701,7369,1005,123400,32818
10111,6546,3565,1217,275400,32819
2885,2395,490,1354,200800,32820
7412,2914,4498,1160,157600,32821
22075,8718,13357,982,96600,32822
12437,8294,4143,1285,159400,32824
20003,11892,8111,1117,163200,32825
7904,4179,3725,977,131600,32826
3233,1981,1252,1451,262500,32827
20671,12757,7914,1320,217200,32828
6641,4924,1717,1357,169500,32829
7,2,5,-,-,32830
33,10,23,-,-,32831
6851,4279,2572,1427,265600,32832
3260,2513,747,1263,187400,32833
16280,6895,9385,1168,198400,32835
6437,4092,2345,1088,395400,32836
17822,9974,7848,1271,190700,32837
18263,4348,13915,956,104700,32839
10923,5195,5728,812,106100,32901
5860,4516,1344,1155,283400,32903
10837,8192,2645,1117,167500,32904
9696,5049,4647,831,91500,32905
14819,11256,3563,1075,114800,32907
3722,3032,690,1196,113400,32908
10490,8273,2217,949,115900,32909
5316,3117,2199,830,183400,32920
5786,2510,3276,675,81400,32922
401,0,401,1324,-,32925
8170,6555,1615,886,120200,32926
9115,7506,1609,1011,110700,32927
7149,4638,2511,1043,269700,32931
7137,5877,1260,1020,205800,32934
17322,10335,6987,867,112000,32935
10971,7860,3111,1197,232100,32937
14155,11714,2441,1320,222200,32940
1796,1271,525,741,115600,32948
898,804,94,1097,278400,32949
1552,1459,93,1395,244100,32950
5137,4288,849,1329,289300,32951
8283,6797,1486,1125,221000,32952
9630,6731,2899,876,194300,32953
15032,11357,3675,1082,170300,32955
10757,8508,2249,987,145900,32958
8535,4485,4050,818,118400,32960
9308,7033,2275,872,99200,32962
7433,6828,605,1197,556800,32963
7847,5517,2330,927,101300,32966
7291,5113,2178,846,167000,32967
4800,4366,434,1058,201400,32968
89,41,48,-,57600,32970
4300,3696,604,782,70200,32976
124,84,40,-,396000,33001
6805,3091,3714,1145,174700,33004
19058,10300,8758,1111,158500,33009
15126,4558,10568,910,169800,33010
23390,11110,12280,1045,162900,33012
9348,5309,4039,1040,174300,33013
13498,6123,7375,1135,207300,33014
21220,11925,9295,1211,197400,33015
14268,7862,6406,1224,153100,33016
12908,9528,3380,1384,204300,33018
7041,5268,1773,1496,375400,33019
18382,6316,12066,942,158000,33020
18304,12007,6297,1194,216400,33021
20138,13334,6804,1153,155800,33023
23250,15628,7622,1268,176200,33024
22317,11022,11295,1417,175800,33025
11156,9143,2013,1615,219000,33026
21254,17037,4217,1489,264100,33027
8223,6434,1789,1931,319900,33028
12729,11263,1466,2322,333900,33029
9629,3893,5736,910,158700,33030
1882,1496,386,1346,312800,33031
11172,6684,4488,1161,148900,33032
15115,7386,7729,1168,138800,33033
4910,1887,3023,910,80500,33034
4977,2437,2540,1274,122900,33035
1397,1140,257,1315,630700,33036
4539,3529,1010,1366,376300,33037
85,85,0,-,201700,33039
12620,5548,7072,1561,428300,33040
2873,2182,691,1643,424800,33042
2064,1540,524,1372,343800,33043
3496,2067,1429,1224,350300,33050
366,238,128,1551,510400,33051
8794,4439,4355,823,110200,33054
11756,8964,2792,1262,146500,33055
9835,6272,3563,1103,137000,33056
12583,5786,6797,1031,189400,33060
11881,8154,3727,1165,296800,33062
20964,14788,6176,1297,128800,33063
20313,13406,6907,1107,136700,33064
17770,9046,8724,1179,219200,33065
8564,6914,1650,1120,99800,33066
9101,6791,2310,1607,395500,33067
14816,8139,6677,1246,128600,33068
10341,5298,5043,1177,136800,33069
2066,1462,604,1354,395100,33070
12609,8313,4296,1410,309100,33071
10539,6011,4528,1514,266600,33073
10363,8080,2283,2399,436200,33076
0,0,0,-,-,33101
294,247,47,-,-,33109
44,0,44,-,-,33122
20078,5422,14656,921,173500,33125
17785,6182,11603,1117,155800,33126
9362,2774,6588,878,151800,33127
2883,271,2612,742,96300,33128
6144,3041,3103,1671,379200,33129
11477,1730,9747,947,209800,33130
8271,2659,5612,2071,434100,33131
5509,1212,4297,1831,433800,33132
13531,6537,6994,1305,480600,33133
16250,8435,7815,1208,398500,33134
14136,2781,11355,911,225400,33135
5160,841,4319,723,119100,33136
9476,2685,6791,1398,292200,33137
12047,5472,6575,884,360200,33138
20585,6847,13738,1284,382700,33139
9430,5229,4201,1448,582100,33140
17487,5557,11930,1125,282200,33141
18137,4779,13358,820,121600,33142
12216,6897,5319,1192,490600,33143
8704,4973,3731,1164,239200,33144
11535,5575,5960,1252,294000,33145
3969,3086,883,2230,753600,33146
13556,6198,7358,894,110300,33147
4641,3348,1293,2549,1034800,33149
8786,3136,5650,770,133100,33150
6304,3327,2977,1697,514500,33154
14352,10348,4004,1304,279700,33155
11043,7934,3109,1502,745400,33156
19659,13178,6481,1057,234900,33157
2139,1985,154,3419,579000,33158
19140,10917,8223,1406,270000,33160
16038,6225,9813,981,172200,33161
13105,7008,6097,1018,151500,33162
16711,11186,5525,1257,247900,33165
7618,3682,3936,1105,267700,33166
5592,3043,2549,1049,145600,33167
6761,4936,1825,1187,144000,33168
12411,6457,5954,1027,155100,33169
3591,1949,1642,1124,213100,33170
13134,5963,7171,1310,120000,33172
11479,8185,3294,1340,255200,33173
9182,5002,4180,1186,208300,33174
15332,11728,3604,1398,240500,33175
17027,11668,5359,1260,330500,33176
14272,10837,3435,1313,182400,33177
13713,7084,6629,1875,329000,33178
15614,9692,5922,1137,122200,33179
15194,9736,5458,1716,342900,33180
7381,2957,4424,1122,216600,33181
3905,3385,520,1746,270200,33182
11935,8294,3641,1377,193000,33183
6373,4659,1714,1319,199600,33184
8032,6824,1208,2050,290300,33185
21650,14969,6681,1474,231900,33186
4883,4408,475,1588,271400,33187
7757,4708,3049,988,197100,33189
4408,1962,2446,1179,201400,33190
14139,9037,5102,1307,217600,33193
1351,1131,220,1694,274400,33194
12997,8898,4099,1597,256200,33196
7278,3637,3641,1667,477100,33301
9566,3425,6141,1098,334500,33304
6603,4086,2517,1134,346600,33305
1658,1057,601,959,451100,33306
15470,10387,5083,1212,344700,33308
12460,7667,4793,1169,150600,33309
21413,9069,12344,1008,115900,33311
18286,10358,7928,1213,194700,33312
19590,8620,10970,1020,92200,33313
8153,3677,4476,1203,141100,33314
6141,3296,2845,1211,217200,33315
4997,2865,2132,1040,520000,33316
12235,9199,3036,1208,252800,33317
18084,11794,6290,1131,94100,33319
19959,14600,5359,1274,134500,33321
16341,12934,3407,1470,123000,33322
6468,4925,1543,1702,253800,33323
18799,10496,8303,1481,182500,33324
9272,7044,2228,1460,235900,33325
10899,7466,3433,1700,321300,33326
6665,5359,1306,2524,449100,33327
10080,7991,2089,1330,303200,33328
4508,4084,424,2213,464100,33330
7384,6179,1205,2067,417100,33331
3110,2738,372,2458,534500,33332
12598,6476,6122,1076,211900,33334
11510,6194,5316,1300,163000,33351
11272,4286,6986,1080,175100,33401
4457,2128,2329,1011,143600,33403
10094,5709,4385,1042,119800,33404
7307,3920,3387,1066,205300,33405
8596,5299,3297,1167,156800,33406
10822,4740,6082,960,139800,33407
8700,6375,2325,1192,289100,33408
10986,5103,5883,1091,122300,33409
15220,9944,5276,1383,266000,33410
23580,17381,6199,1300,229200,33411
4863,4172,691,1760,299400,33412
4789,3070,1719,1323,205200,33413
19244,14061,5183,1597,305800,33414
16182,9045,7137,1065,86100,33415
13818,8246,5572,1000,64300,33417
16039,12526,3513,1469,358100,33418
9238,5658,3580,1424,153100,33426
13324,9502,3822,1533,217500,33428
6925,2548,4377,616,93900,33430
6947,4650,2297,1555,331200,33431
9840,5709,4131,1391,539600,33432
19084,12438,6646,1587,262300,33433
9740,7948,1792,926,204600,33434
13559,7939,5620,1232,121800,33435
18191,13185,5006,1341,168000,33436
18462,15980,2482,1337,242600,33437
121,90,31,-,70600,33438
6363,4472,1891,739,67000,33440
11307,5650,5657,1090,186900,33441
13653,9512,4141,1422,112700,33442
8206,4423,3783,1198,221500,33444
13310,8697,4613,1381,152100,33445
12128,10521,1607,909,211800,33446
3946,3626,320,1761,385100,33449
9844,7728,2116,939,220700,33455
20325,14176,6149,1441,306000,33458
10796,4808,5988,948,156300,33460
14390,7157,7233,1035,98400,33461
11939,7385,4554,1056,159100,33462
17435,12063,5372,1176,143400,33463
19612,17096,2516,1322,236500,33467
6801,5708,1093,1092,306400,33469
7758,7030,728,1586,247500,33470
1953,1385,568,718,76800,33471
7893,7165,728,1849,254400,33472
2979,2608,371,2902,480100,33473
2505,1151,1354,533,84900,33476
7379,5977,1402,1421,352600,33477
4422,4091,331,1658,332500,33478
5590,4814,776,1512,744700,33480
5958,4263,1695,1457,409100,33483
13875,10896,2979,1239,99500,33484
8893,6844,2049,1424,350000,33486
8472,6617,1855,1565,338700,33487
615,312,303,706,86900,33493
9644,8238,1406,1687,341000,33496
5014,4697,317,2514,365500,33498
25,25,0,-,-,33503
10136,6323,3813,991,137100,33510
20953,10425,10528,1118,163100,33511
3617,2890,727,701,83500,33513
647,489,158,812,89800,33514
183,156,27,681,91400,33521
6302,4405,1897,752,95300,33523
7169,5372,1797,743,116500,33525
4703,3326,1377,859,194500,33527
4720,2817,1903,922,138300,33534
1825,1361,464,588,82900,33538
3713,2600,1113,724,81800,33540
8601,6989,1612,876,68200,33541
9483,6597,2886,765,66600,33542
8217,6748,1469,1247,174400,33543
8567,5961,2606,1345,213900,33544
5113,3841,1272,1366,171800,33545
7512,6092,1420,1629,276200,33547
2363,2008,355,927,299400,33548
6409,4889,1520,1090,191900,33549
7562,6769,793,1165,340500,33556
7944,5364,2580,937,302000,33558
6604,3844,2760,1030,162700,33559
9362,4825,4537,861,106700,33563
6232,4944,1288,961,130800,33565
6791,4978,1813,882,161300,33566
3514,2607,907,693,155300,33567
8867,7221,1646,1270,175100,33569
8440,5932,2508,835,140700,33570
6557,5294,1263,1492,223800,33572
12195,9727,2468,1858,138800,33573
1736,1563,173,730,165900,33576
17441,9010,8431,1108,154600,33578
8999,6910,2089,1503,169100,33579
8813,6782,2031,1044,137200,33584
400,342,58,-,75000,33585
3967,2527,1440,751,89200,33592
12348,9821,2527,1261,162100,33594
9918,8463,1455,1640,235100,33596
3014,2539,475,744,87900,33597
4594,3358,1236,764,176400,33598
7499,2919,4580,1582,254900,33602
8020,4382,3638,894,133200,33603
14746,7276,7470,883,109800,33604
6853,2868,3985,807,77800,33605
7873,3369,4504,1190,432900,33606
10523,4157,6366,1079,108200,33607
8231,4446,3785,1081,286300,33609
15135,6593,8542,873,84000,33610
15059,7882,7177,1046,188200,33611
17968,6408,11560,788,98500,33612
13520,4074,9446,775,126700,33613
17870,6872,10998,886,123600,33614
17061,9514,7547,969,130900,33615
6272,2669,3603,1074,144000,33616
17847,7166,10681,881,126500,33617
10957,6964,3993,962,244700,33618
12096,5476,6620,1030,83600,33619
0,0,0,-,-,33620
574,0,574,1923,-,33621
14774,9743,5031,1085,176600,33624
9655,6266,3389,1170,172400,33625
10748,6920,3828,1341,320900,33626
10572,8352,2220,1108,418200,33629
7285,4595,2690,1124,141800,33634
6746,4015,2731,1256,148000,33635
6159,2784,3375,993,117200,33637
23052,13264,9788,1176,261000,33647
8607,2972,5635,767,283600,33701
12868,8048,4820,913,135000,33702
10269,7711,2558,1043,162600,33703
7296,4928,2368,898,295800,33704
10698,5628,5070,930,147000,33705
8455,6036,2419,1088,352700,33706
12486,8400,4086,975,163900,33707
8658,6088,2570,1078,255300,33708
11454,8027,3427,854,88200,33709
13584,10251,3333,894,154300,33710
7061,3996,3065,1034,122600,33711
9629,4889,4740,904,123100,33712
12305,7747,4558,994,121200,33713
8024,4735,3289,895,69500,33714
3807,3352,455,1441,329900,33715
8704,1419,7285,1096,85300,33716
0,0,0,-,-,33744
9186,4923,4263,921,150600,33755
12784,7554,5230,869,158500,33756
7576,3917,3659,1083,138300,33759
6450,3136,3314,923,117700,33760
8839,7160,1679,865,144000,33761
2666,2004,662,1102,176800,33762
8727,6114,2613,984,101800,33763
11426,7958,3468,970,144000,33764
6006,2670,3336,950,137600,33765
4356,3311,1045,1442,400600,33767
11752,6397,5355,897,139200,33770
13633,7043,6590,897,73800,33771
10193,7396,2797,1097,157400,33772
7196,5022,2174,942,132500,33773
8138,5712,2426,956,169500,33774
4951,4420,531,1376,233000,33776
6868,5237,1631,1118,157900,33777
5996,4697,1299,979,107100,33778
10311,5912,4399,870,107700,33781
9537,7006,2531,1062,120300,33782
3054,1999,1055,1200,376000,33785
771,656,115,2301,569300,33786
12227,6233,5994,772,66000,33801
11911,7071,4840,930,122000,33803
8441,4227,4214,870,71000,33805
10595,7432,3163,949,131700,33809
16974,12772,4202,979,122200,33810
7571,5129,2442,942,140200,33811
4269,3512,757,1081,159200,33812
12192,10046,2146,1049,174000,33813
5234,2722,2512,722,31300,33815
10153,7322,2831,829,108100,33823
8746,6191,2555,678,78500,33825
872,700,172,933,122600,33827
9035,6143,2892,811,94400,33830
1884,1129,755,618,77200,33834
7823,5616,2207,1060,127400,33837
1403,745,658,925,69100,33838
975,643,332,859,107100,33839
2810,2106,704,705,79900,33841
3587,2788,799,648,73400,33843
11625,7615,4010,766,101800,33844
32,32,0,-,-,33847
283,87,196,-,75300,33848
283,283,0,-,166400,33849
3336,2125,1211,852,68500,33850
315,278,37,881,87400,33851
8242,6597,1645,692,103800,33852
4212,2061,2151,732,88100,33853
69,62,7,-,38000,33854
7,7,0,-,-,33855
261,0,261,516,-,33856
751,529,222,746,101200,33857
3980,2701,1279,841,99500,33859
7839,5867,1972,934,102500,33860
140,70,70,-,79200,33865
219,219,0,-,78100,33867
3630,2946,684,882,83300,33868
8504,5601,2903,666,71400,33870
7365,5655,1710,929,79800,33872
4151,2933,1218,624,78400,33873
4548,3925,623,802,112100,33875
1931,1711,220,757,88700,33876
137,31,106,673,-,33877
12761,8490,4271,839,87000,33880
12133,8095,4038,762,81500,33881
11570,8236,3334,1003,149900,33884
1437,1094,343,795,85800,33890
2905,1671,1234,1247,157800,33896
6204,4052,2152,1280,120700,33897
6326,4981,1345,772,97400,33898
8409,3947,4462,745,132200,33901
10541,8157,2384,751,75200,33903
13246,9530,3716,971,183300,33904
10774,6761,4013,885,119700,33905
9187,3892,5295,905,117700,33907
17054,12115,4939,1194,227600,33908
8553,5176,3377,1080,144400,33909
7083,5877,1206,1111,235800,33912
7074,5816,1258,1331,274200,33913
14182,10170,4012,1107,221900,33914
7804,2584,5220,861,79000,33916
12541,10148,2393,779,76000,33917
13547,9641,3906,1033,167100,33919
1776,1379,397,785,231300,33920
448,420,28,-,1101600,33921
1504,1253,251,912,170400,33922
64,45,19,-,410000,33924
10655,8914,1741,1397,267500,33928
250,167,83,-,-,33930
5603,4616,987,1040,294500,33931
6058,4105,1953,658,77000,33935
7750,4915,2835,790,81600,33936
178,99,79,-,-,33944
0,0,0,-,-,33945
1000,859,141,1529,298200,33946
3803,3192,611,1136,210000,33947
6989,5529,1460,950,142500,33948
10704,8543,2161,831,254900,33950
12982,9256,3726,896,103100,33952
2757,2388,369,879,196200,33953
3379,2735,644,1122,160800,33954
4204,3749,455,1038,204000,33955
1776,1590,186,1003,185700,33956
3553,2992,561,1455,693000,33957
324,272,52,-,114700,33960
0,0,0,-,-,33965
3856,2615,1241,946,223200,33966
7996,5835,2161,1097,158200,33967
6560,4195,2365,981,111100,33971
4374,3106,1268,929,110400,33972
3664,652,3012,845,164900,33973
4565,2462,2103,980,110900,33974
4441,2597,1844,1046,98400,33976
5529,4044,1485,806,119200,33980
4231,3434,797,1083,172800,33981
3936,3193,743,786,105600,33982
6007,4565,1442,933,170300,33983
11148,7423,3725,1044,160100,33990
6886,4830,2056,1162,202200,33991
7608,5283,2325,1196,168000,33993
0,0,0,-,-,34101
5455,3846,1609,1039,789300,34102
6056,4947,1109,1305,600000,34103
10117,6726,3391,986,219400,34104
7260,5181,2079,1232,362000,34105
7844,6230,1614,1257,641800,34108
11040,6415,4625,1213,357400,34109
10518,8127,2391,1383,323100,34110
11586,8703,2883,947,169700,34112
6943,5044,1899,1139,248800,34113
6385,5196,1189,1144,207600,34114
9188,4806,4382,1019,174100,34116
4423,3814,609,1140,236300,34117
12011,8798,3213,1495,391500,34119
9242,7541,1701,1407,234000,34120
7053,5945,1108,1129,431700,34134
16648,12902,3746,1145,229500,34135
89,60,29,-,-,34137
81,70,11,-,85100,34138
277,252,25,830,113700,34139
128,77,51,-,-,34140
0,0,0,-,-,34141
5682,2395,3287,726,93100,34142
8352,7203,1149,1437,492000,34145
1854,1617,237,2450,367600,34201
8752,6890,1862,1724,362400,34202
13517,9630,3887,1007,164600,34203
12378,7106,5272,858,107900,34205
13725,7853,5872,832,62000,34207
11585,6044,5541,915,150800,34208
14252,10207,4045,1080,179600,34209
7632,4240,3392,973,165000,34210
2119,1914,205,1643,366200,34211
6076,4829,1247,1322,295900,34212
149,114,35,-,460700,34215
529,471,58,1074,544900,34216
2599,1820,779,1169,444000,34217
7381,6679,702,1678,224100,34219
14702,11204,3498,1014,123900,34221
5292,4133,1159,938,70700,34222
8359,6670,1689,885,191900,34223
7291,5573,1718,889,128200,34224
3845,3519,326,1428,660300,34228
3357,3014,343,1200,367100,34229
14167,8713,5454,1026,172200,34231
13382,9374,4008,1207,169200,34232
7606,5803,1803,1271,216900,34233
8908,4679,4229,862,100400,34234
6210,4745,1465,1171,185900,34235
6470,3740,2730,932,612100,34236
6889,3359,3530,985,106200,34237
9496,7105,2391,1345,299000,34238
6664,4500,2164,1039,222400,34239
4154,3834,320,1302,361300,34240
5616,4825,791,1266,314800,34241
3827,3261,566,1303,621300,34242
12300,8680,3620,1260,224500,34243
1698,1513,185,1167,264100,34251
9412,6062,3350,661,79900,34266
51,23,28,-,-,34268
1967,1748,219,853,104700,34269
8585,6884,1701,889,229600,34275
10093,7734,2359,1095,162600,34285
6849,5490,1359,1221,139000,34286
10965,7951,3014,890,109200,34287
3988,3113,875,1131,175600,34288
1196,686,510,880,175700,34289
2162,1819,343,1066,146700,34291
7485,5562,1923,1269,264300,34292
16042,13262,2780,1109,183000,34293
5661,4212,1449,746,89800,34420
4152,3210,942,699,90400,34428
3493,2834,659,856,114900,34429
3232,2471,761,766,92400,34431
5324,4523,801,923,126000,34432
2520,2246,274,906,114600,34433
3300,2712,588,1159,121700,34434
3486,2866,620,659,87000,34436
6575,5748,827,756,156500,34442
0,0,0,-,-,34445
7479,6785,694,1015,136500,34446
4618,3466,1152,649,68300,34448
1235,875,360,541,88800,34449
4853,3574,1279,723,106200,34450
4800,3991,809,806,95400,34452
4245,3418,827,925,99300,34453
4075,3251,824,717,152100,34461
7647,6035,1612,824,122500,34465
7609,4327,3282,777,86000,34470
9740,6206,3534,843,160200,34471
10181,7251,2930,916,85400,34472
6582,4427,2155,973,131900,34473
6513,3195,3318,891,101500,34474
3754,1731,2023,650,72100,34475
9076,8126,950,851,129900,34476
5148,3690,1458,819,85600,34479
6259,4861,1398,757,142100,34480
9060,8111,949,868,93300,34481
7260,5531,1729,790,129900,34482
1330,981,349,773,198100,34484
4188,3181,1007,632,54600,34488
12225,10318,1907,946,154400,34491
296,237,59,850,180500,34498
8610,6205,2405,727,88900,34601
2762,2356,406,921,111800,34602
3708,3063,645,742,132300,34604
11284,8540,2744,876,103100,34606
4000,3115,885,948,169200,34607
12640,8933,3707,906,104000,34608
14725,11641,3084,1016,132300,34609
4663,3857,806,898,117100,34610
8253,7184,1069,897,83800,34613
2474,2154,320,1061,122500,34614
2108,1863,245,1424,193000,34637
7935,6305,1630,1429,210200,34638
9175,7439,1736,1212,196000,34639
10522,6503,4019,807,79500,34652
14045,8867,5178,904,78400,34653
8560,6459,2101,890,130600,34654
15932,12590,3342,1065,183300,34655
62,52,10,-,44200,34661
14463,10329,4134,873,109100,34667
18173,11743,6430,866,67800,34668
4775,3918,857,953,112900,34669
8454,5933,2521,1080,193200,34677
41,28,13,-,144400,34679
368,368,0,-,411700,34681
13074,9852,3222,1065,217400,34683
13312,8446,4866,1181,150700,34684
7110,5365,1745,1240,293700,34685
2945,2518,427,-,310000,34688
11174,7623,3551,825,160800,34689
5374,3470,1904,898,64700,34690
7991,5476,2515,953,71100,34691
7419,6115,1304,1126,209700,34695
17611,11454,6157,980,153500,34698
895,665,230,847,100400,34705
19133,14614,4519,1167,181700,34711
6461,3386,3075,1083,153100,34714
5115,3586,1529,1153,168900,34715
4485,3498,987,899,98900,34731
1329,1092,237,1378,223800,34734
5294,4082,1212,1068,145100,34736
961,811,150,969,198900,34737
223,169,54,-,94000,34739
15145,4877,10268,946,116400,34741
10728,6712,4016,1118,128700,34743
14663,9262,5401,1120,159300,34744
11858,7500,4358,1255,144400,34746
5868,2769,3099,1300,296300,34747
17475,12878,4597,838,131500,34748
1577,1142,435,883,88600,34753
1241,996,245,1054,218000,34756
9722,6125,3597,1097,135400,34758
10924,7793,3131,1140,145100,34759
292,237,55,1018,167400,34760
14126,9714,4412,1127,180300,34761
162,135,27,-,157500,34762
7999,5348,2651,975,107900,34769
4679,3979,700,1131,191100,34771
8608,7078,1530,1298,163900,34772
1018,647,371,775,160600,34773
8964,7607,1357,809,252300,34785
12384,8984,3400,1592,423900,34786
18641,13011,5630,1024,240500,34787
7800,6472,1328,845,74300,34788
368,344,24,-,243500,34797
1655,1249,406,782,119800,34945
2316,1425,891,797,65400,34946
4257,1693,2564,856,75700,34947
3943,3327,616,1010,249200,34949
5799,2369,3430,728,71000,34950
6513,5525,988,847,84800,34951
16519,11390,5129,1085,102700,34952
20316,15709,4607,1196,146000,34953
2046,1277,769,796,79300,34956
10652,7765,2887,991,203100,34957
5306,3424,1882,644,88600,34972
8938,6801,2137,725,93000,34974
1848,984,864,866,171400,34981
9505,6023,3482,927,94700,34982
13818,10734,3084,1189,131600,34983
5102,4093,1009,1224,139900,34984
10658,8598,2060,1010,195900,34986
2625,1825,800,1623,232100,34987
11551,9781,1770,1351,305000,34990
7039,4036,3003,942,142300,34994
5687,4724,963,995,178600,34996
17174,12858,4316,1014,184300,34997
4225,3460,765,923,150100,35004
2927,2123,804,845,89600,35005
1189,941,248,718,78900,35006
8735,7074,1661,912,159500,35007
7907,5024,2883,559,102600,35010
15,0,15,-,-,35013
1493,1285,208,809,78200,35014
6341,4706,1635,587,132700,35016
874,722,152,845,102800,35019
10082,5543,4539,678,67700,35020
7899,6320,1579,858,168000,35022
8856,6677,2179,782,117000,35023
2979,2089,890,563,115300,35031
18,16,2,-,-,35032
1398,1272,126,575,112800,35033
987,629,358,464,65200,35034
408,380,28,-,-,35035
109,27,82,245,66100,35036
6136,4962,1174,994,138200,35040
2199,1540,659,577,127500,35042
3475,3199,276,1588,228200,35043
3369,2245,1124,559,103700,35044
5734,4207,1527,635,104500,35045
1956,1530,426,810,114600,35046
1404,1228,176,637,138500,35049
3038,2251,787,623,140200,35051
29,29,0,-,-,35052
999,899,100,842,141400,35053
1681,1442,239,610,161900,35054
7963,4808,3155,595,121700,35055
4816,3965,851,665,134000,35057
3744,3017,727,548,128500,35058
157,136,21,-,33400,35060
488,325,163,1071,72500,35061
2848,2351,497,767,111200,35062
1366,1105,261,680,68900,35063
4541,2692,1849,702,95300,35064
3488,2526,962,869,132500,35068
111,63,48,617,103100,35070
6213,5045,1168,898,159500,35071
1689,1349,340,475,76000,35072
878,767,111,950,77700,35073
0,0,0,-,-,35074
4630,3568,1062,593,96600,35077
797,655,142,681,155700,35078
3074,2613,461,632,114900,35079
5914,5447,467,1166,176900,35080
0,0,0,-,-,35082
1395,1114,281,788,111200,35083
3322,2497,825,706,86500,35085
807,490,317,716,78800,35087
809,621,188,637,86900,35089
977,865,112,798,173300,35091
5333,4022,1311,742,139400,35094
3075,2591,484,836,104100,35096
687,546,141,717,138300,35097
480,445,35,-,78800,35098
6091,5391,700,757,186700,35111
81,81,0,-,103900,35112
2832,2410,422,1037,206100,35114
5127,3498,1629,740,113200,35115
1640,1396,244,821,153500,35116
2050,1758,292,1001,155800,35117
1250,996,254,752,125400,35118
42,42,0,-,-,35119
4890,4285,605,760,134300,35120
5540,3790,1750,660,128000,35121
9226,7745,1481,1003,174300,35124
4031,2800,1231,636,118100,35125
7993,6843,1150,902,142900,35126
3758,3314,444,1056,151000,35127
4339,3222,1117,797,167800,35128
1220,953,267,682,80400,35130
1659,1287,372,604,113600,35131
1200,1128,72,569,121800,35133
619,454,165,689,172300,35135
814,645,169,302,96100,35136
65,58,7,-,19200,35139
1315,1178,137,586,157100,35143
3844,3303,541,608,173800,35146
2085,1883,202,1283,164900,35147
1098,744,354,632,92800,35148
225,225,0,-,-,35149
7135,4524,2611,591,88400,35150
2844,2409,435,584,88600,35151
10027,6796,3231,556,83900,35160
1357,1140,217,730,115500,35171
1173,887,286,617,72700,35172
9426,8459,967,1017,217200,35173
1962,1647,315,545,115700,35175
378,326,52,625,61900,35176
1418,1239,179,537,83700,35178
3500,2950,550,666,117900,35179
5285,4693,592,623,130900,35180
261,250,11,-,85000,35183
2012,1544,468,751,87800,35184
1943,1601,342,950,165900,35186
4,4,0,-,-,35187
988,727,261,689,117700,35188
1539,179,1360,616,191200,35203
4572,1746,2826,543,63100,35204
9796,2561,7235,706,159300,35205
6625,3363,3262,766,76700,35206
3448,1857,1591,485,59600,35207
5554,3063,2491,849,74100,35208
12569,5357,7212,883,283500,35209
6184,4176,2008,894,129700,35210
11170,5424,5746,676,77200,35211
5063,2124,2939,541,101300,35212
5432,4257,1175,1091,491600,35213
7248,5454,1794,723,101800,35214
18351,10314,8037,812,98800,35215
14659,7619,7040,938,268600,35216
5293,2950,2343,670,77200,35217
2900,1116,1784,738,62500,35218
1933,1303,630,817,62400,35221
4032,2233,1799,640,220400,35222
3992,3510,482,1148,464900,35223
2221,1373,848,807,68100,35224
13126,10521,2605,1124,247100,35226
3854,2263,1591,849,69500,35228
0,0,0,-,-,35229
799,205,594,1008,233500,35233
1944,923,1021,597,59500,35234
7888,5502,2386,927,120100,35235
20609,14278,6331,1018,331300,35242
7863,4831,3032,1093,329700,35243
12915,8701,4214,1027,282900,35244
135,60,75,555,75000,35254
11048,3964,7084,704,110000,35401
7565,3770,3795,817,125000,35404
15906,8686,7220,791,167900,35405
6540,5105,1435,979,321200,35406
393,329,64,618,106700,35441
1868,1197,671,471,88800,35442
691,426,265,508,46600,35443
1431,1083,348,601,107000,35444
669,522,147,845,110900,35446
1237,962,275,391,81400,35447
1152,887,265,777,147200,35452
3937,3393,544,768,131900,35453
1247,972,275,664,122300,35456
16,16,0,-,-,35457
258,141,117,-,142400,35458
348,300,48,506,76400,35459
280,166,114,630,-,35460
797,685,112,-,91500,35461
1703,1201,502,369,77000,35462
522,502,20,-,116600,35463
245,158,87,264,-,35464
2021,1515,506,467,96200,35466
77,77,0,-,46100,35469
1721,977,744,610,99900,35470
6075,4189,1886,815,168900,35473
2449,2042,407,745,117900,35474
5200,4542,658,776,181000,35475
2921,1458,1463,753,132400,35476
70,58,12,-,41900,35477
413,364,49,1314,152000,35480
1541,1086,455,394,75400,35481
1220,1054,166,832,115600,35490
3815,2293,1522,616,90900,35501
3292,2546,746,714,92600,35503
4898,3729,1169,626,130300,35504
998,761,237,491,69500,35540
1396,1229,167,575,125700,35541
490,431,59,549,78300,35542
565,433,132,534,67600,35543
258,206,52,538,52500,35544
37,35,2,-,51500,35545
1538,1198,340,413,81100,35546
750,550,200,377,63600,35548
1637,1211,426,430,69600,35549
2280,1500,780,593,67200,35550
320,284,36,267,80300,35552
1616,1325,291,494,65600,35553
436,353,83,-,52600,35554
3846,2739,1107,497,78000,35555
14,14,0,-,-,35559
2055,1495,560,427,101100,35563
887,631,256,652,85700,35564
5254,3827,1427,538,64700,35565
4529,3413,1116,535,92400,35570
379,300,79,525,69800,35571
397,364,33,-,82900,35572
693,593,100,396,84600,35574
394,304,90,494,63900,35575
1278,888,390,414,69900,35576
13,11,2,-,-,35577
2337,1917,420,620,71500,35578
1243,1004,239,558,67500,35579
1442,1206,236,527,72400,35580
1947,1419,528,588,74100,35581
1644,1127,517,425,80600,35582
161,121,40,756,51900,35584
581,459,122,759,111500,35585
1868,1346,522,434,72200,35586
446,408,38,-,66000,35587
2061,1460,601,421,72200,35592
802,696,106,446,88800,35593
2950,2250,700,405,102800,35594
12924,7461,5463,616,96200,35601
12585,8566,4019,612,165900,35603
908,701,207,491,104300,35610
10131,5889,4242,600,111700,35611
7276,6550,726,763,170300,35613
3058,2368,690,616,94900,35614
82,57,25,-,-,35615
1732,1328,404,675,77300,35616
904,644,260,379,77000,35618
1702,1466,236,642,86500,35619
3191,2493,698,624,130400,35620
1254,1104,150,608,95100,35621
2732,2244,488,688,102600,35622
14846,7134,7712,579,101000,35630
8509,6767,1742,758,136500,35633
3769,3338,431,770,159600,35634
9423,7336,2087,605,130200,35640
1264,1071,193,592,114000,35643
5270,4309,961,628,152600,35645
1769,1334,435,419,76600,35646
364,291,73,663,114200,35647
1238,1052,186,496,111300,35648
43,43,0,-,-,35649
5653,4362,1291,549,103900,35650
608,496,112,688,97700,35651
3486,2783,703,619,118400,35652
3885,2368,1517,586,92100,35653
3125,2265,860,520,89800,35654
3933,2228,1705,607,88900,35660
6798,5292,1506,679,136000,35661
2844,2364,480,636,110500,35670
818,585,233,582,100700,35671
2430,2024,406,758,96500,35672
2690,2355,335,524,107800,35673
7290,5267,2023,645,105200,35674
565,448,117,646,89600,35677
2072,1549,523,677,128500,35739
1394,948,446,480,90000,35740
1156,885,271,923,300400,35741
825,538,287,583,94900,35744
96,73,23,663,121600,35745
270,239,31,-,-,35746
2167,1768,399,544,119800,35747
2562,2114,448,591,164700,35748
7717,6865,852,1167,174700,35749
4831,3906,925,750,112700,35750
64,53,11,-,-,35751
976,709,267,757,96400,35752
1843,1453,390,549,150300,35754
236,154,82,609,117700,35755
4565,3921,644,966,216800,35756
5413,4597,816,1034,192200,35757
17537,11588,5949,895,219000,35758
2750,2320,430,942,181500,35759
1858,1472,386,709,121300,35760
4607,4040,567,828,140400,35761
6102,5653,449,1126,262600,35763
261,193,68,383,77900,35764
1307,1061,246,505,94200,35765
69,55,14,-,-,35766
4476,3131,1345,583,97900,35768
3958,2959,999,617,138900,35769
1347,918,429,654,128600,35771
1649,972,677,513,98000,35772
4503,3680,823,899,119000,35773
42,36,6,-,-,35774
285,208,77,-,-,35775
1355,1109,246,643,87600,35776
9839,6612,3227,741,240000,35801
10127,6133,3994,776,221900,35802
11197,8962,2235,854,175500,35803
8921,2875,6046,573,75700,35805
9353,4525,4828,884,224400,35806
317,0,317,1162,-,35808
11277,7459,3818,811,86900,35810
10652,8605,2047,804,152900,35811
6269,1521,4748,617,94900,35816
3258,1761,1497,866,214900,35824
0,0,0,-,-,35896
7535,4701,2834,603,102300,35901
6877,4235,2642,622,88900,35903
5418,4072,1346,620,70700,35904
2428,1806,622,542,100900,35905
4077,2587,1490,724,143700,35906
3268,2968,300,763,154200,35907
7096,4567,2529,610,106400,35950
4596,3162,1434,631,87000,35951
2687,2166,521,526,78300,35952
2608,2133,475,627,96900,35953
4487,3271,1216,611,80900,35954
3131,2573,558,661,89700,35956
5507,3438,2069,618,101600,35957
1274,1005,269,628,90100,35958
1981,1510,471,618,106800,35959
4471,3486,985,548,122500,35960
2510,1634,876,441,92400,35961
2844,2011,833,547,75700,35962
494,332,162,347,66600,35963
1431,1132,299,690,106400,35966
6009,4010,1999,569,109800,35967
1482,1222,260,625,107700,35968
1872,1455,417,578,100900,35971
435,417,18,-,121500,35972
1325,1115,210,666,73100,35973
504,322,182,475,76000,35974
224,209,15,-,86200,35975
6788,5063,1725,611,153000,35976
2060,1576,484,552,84100,35978
558,424,134,-,96200,35979
1651,1282,369,568,79200,35980
675,535,140,241,90200,35981
1467,1111,356,774,140000,35983
681,581,100,692,163200,35984
2873,2033,840,574,115200,35986
1016,809,207,580,86900,35987
613,453,160,624,112200,35988
1230,989,241,572,80400,35989
35,15,20,-,-,35990
781,571,210,607,59400,36003
602,456,146,471,72000,36005
465,433,32,-,-,36006
944,701,243,436,83100,36009
1961,1305,656,510,74900,36010
196,165,31,-,287500,36013
1408,966,442,484,83400,36016
642,478,164,648,66200,36017
390,322,68,733,150000,36020
4283,3540,743,726,167800,36022
2090,1755,335,736,125600,36024
1374,839,535,865,125800,36025
388,324,64,-,138900,36026
6050,3584,2466,599,109200,36027
746,608,138,509,79000,36028
344,304,40,-,169400,36029
145,136,9,-,37300,36030
91,86,5,-,56500,36031
852,583,269,521,83400,36032
1563,1189,374,491,68300,36033
261,227,34,675,45700,36034
764,605,159,617,83300,36035
804,608,196,696,84100,36036
5282,3485,1797,573,89600,36037
18,18,0,-,-,36038
51,45,6,-,80700,36039
1369,847,522,588,56300,36040
502,406,96,530,84400,36041
660,521,139,681,71100,36042
1437,1145,292,853,142300,36043
598,546,52,622,86200,36046
505,427,78,-,104500,36047
517,394,123,584,70000,36048
2242,1351,891,477,84400,36049
849,671,178,886,61300,36051
161,142,19,-,457100,36052
769,546,223,479,60300,36053
5752,3898,1854,834,134000,36054
3470,3204,266,1226,259300,36064
7844,4786,3058,997,168200,36066
10121,7747,2374,778,125700,36067
815,657,158,534,82400,36069
264,204,60,521,85600,36071
846,662,184,656,89800,36075
4899,3402,1497,605,102000,36078
3731,2690,1041,673,120500,36079
933,850,83,1056,181900,36080
6440,3104,3336,572,113500,36081
0,0,0,-,-,36082
3760,2372,1388,545,77200,36083
1324,574,750,644,79300,36088
2600,1818,782,588,63800,36089
1343,1009,334,521,85300,36091
7427,5253,2174,770,127200,36092
3923,3452,471,1317,216900,36093
3002,909,2093,589,73700,36104
4046,2521,1525,774,65400,36105
6383,3560,2823,946,153500,36106
3198,1178,2020,719,67100,36107
7754,4182,3572,602,67200,36108
10081,7611,2470,923,115800,36109
4552,2292,2260,781,61400,36110
5022,3005,2017,811,127500,36111
0,0,0,-,-,36112
252,0,252,1465,-,36113
250,0,250,1297,-,36115
17324,9036,8288,819,102900,36116
21758,12984,8774,928,176200,36117
7276,4162,3114,555,65600,36201
6858,4856,2002,770,136700,36203
158,89,69,-,269300,36205
4481,3331,1150,619,89400,36206
8593,5896,2697,702,134100,36207
1782,1513,269,697,117900,36250
2151,1477,674,416,84400,36251
324,267,57,-,68800,36255
674,582,92,541,107900,36256
584,466,118,470,98900,36258
1448,1043,405,632,113200,36260
533,431,102,477,58000,36262
223,123,100,676,136200,36263
3339,2503,836,560,110100,36264
7560,4561,2999,582,139300,36265
2139,1657,482,446,106000,36266
34,7,27,-,-,36267
2250,1873,377,640,102400,36268
475,364,111,555,78800,36269
2157,1824,333,696,102800,36271
5150,4102,1048,502,83900,36272
1285,970,315,710,126300,36273
4432,3109,1323,574,78200,36274
898,672,226,558,84500,36276
2065,1599,466,743,99800,36277
1762,1253,509,654,120200,36278
1061,963,98,667,122300,36279
1433,1070,363,758,94600,36280
13839,8559,5280,677,106900,36301
11922,6924,4998,658,136100,36303
6161,4050,2111,885,178700,36305
2687,2159,528,530,85900,36310
996,881,115,613,96600,36311
2347,1818,529,636,91800,36312
128,108,20,-,-,36313
222,205,17,610,114000,36314
680,560,120,620,141500,36316
175,141,34,600,68200,36317
633,512,121,638,74700,36318
776,606,170,635,77600,36319
1421,1132,289,588,79600,36320
599,433,166,778,91700,36321
3407,1934,1473,653,101400,36322
2991,2045,946,544,95600,36323
13731,8672,5059,772,163300,36330
2259,1606,653,497,86200,36340
564,480,84,597,74100,36343
2243,1669,574,558,83500,36344
3329,2626,703,599,131700,36345
524,413,111,583,83200,36346
2416,1444,972,592,119500,36350
1397,1071,326,683,91800,36351
1878,1401,477,728,144400,36352
740,596,144,494,77900,36353
7875,5224,2651,544,100100,36360
1153,0,1153,1228,-,36362
351,249,102,614,83800,36370
248,156,92,734,155300,36371
203,167,36,-,58200,36373
429,368,61,667,108300,36374
2705,2098,607,588,77100,36375
805,593,212,671,85600,36376
3116,2249,867,544,77200,36401
4369,3081,1288,622,94300,36420
3773,3020,753,568,127800,36421
422,283,139,534,47000,36425
6091,4425,1666,575,90400,36426
990,796,194,500,66300,36432
119,111,8,-,66100,36435
282,189,93,-,54800,36436
247,165,82,839,122400,36439
1411,1073,338,560,84100,36441
1369,1009,360,465,83600,36442
338,173,165,-,46100,36444
1659,1123,536,446,81500,36445
164,96,68,846,54000,36446
1799,1264,535,499,103000,36451
937,729,208,594,78400,36453
16,16,0,-,185700,36454
142,97,45,635,49600,36455
575,443,132,429,59800,36456
3941,2270,1671,496,97400,36460
3883,2757,1126,551,90900,36467
81,20,61,-,-,36470
441,293,148,-,56300,36471
31,29,2,-,45300,36473
1265,1099,166,525,70600,36474
862,704,158,620,64600,36475
20,17,3,-,133900,36476
1904,1331,573,537,60600,36477
615,414,201,688,85000,36480
101,39,62,-,55800,36481
312,175,137,-,-,36482
144,136,8,-,66700,36483
6134,4254,1880,552,101500,36502
572,429,143,1112,110500,36505
6842,4919,1923,639,121500,36507
592,346,246,683,85600,36509
235,178,57,-,-,36511
0,0,0,-,-,36512
284,214,70,-,-,36513
964,790,174,563,89100,36518
1933,1699,234,864,118600,36521
2378,1733,645,886,107300,36522
1001,700,301,818,106300,36523
466,377,89,804,107000,36524
651,480,171,838,109100,36525
11871,7995,3876,1000,188600,36526
5140,3590,1550,1136,270900,36527
499,385,114,1063,212700,36528
78,69,9,-,83800,36529
2688,1938,750,860,159700,36530
11997,9185,2812,1017,234800,36532
11691,8240,3451,764,152800,36535
210,210,0,-,12900,36538
325,223,102,440,-,36539
259,181,78,-,64500,36540
5348,4662,686,720,103100,36541
5767,3371,2396,950,232900,36542
45,45,0,-,91000,36543
3836,2856,980,751,93800,36544
3663,2536,1127,566,84100,36545
464,408,56,-,82700,36548
2100,1987,113,945,131200,36549
141,106,35,-,34400,36550
2900,2078,822,962,137800,36551
1011,878,133,704,104800,36553
333,292,41,833,239100,36555
134,91,43,-,100600,36556
1384,1254,130,552,59100,36558
46,35,11,-,-,36559
1193,870,323,639,75500,36560
2811,2032,779,1019,296000,36561
512,479,33,669,88500,36562
9,9,0,-,-,36564
4864,3330,1534,772,129200,36567
57,57,0,-,-,36568
283,220,63,-,113500,36569
5558,4012,1546,879,134400,36571
2267,2003,264,907,150800,36572
314,290,24,-,102600,36574
6895,5476,1419,866,143000,36575
1649,1135,514,973,155300,36576
484,450,34,1307,151000,36578
487,426,61,-,116400,36579
2161,1733,428,780,130100,36580
38,20,18,-,-,36581
9104,6703,2401,718,116700,36582
254,225,29,-,148200,36583
351,305,46,-,57900,36584
337,258,79,483,90000,36585
3521,3276,245,838,103900,36587
0,0,0,-,-,36590
544,85,459,467,185900,36602
2814,1122,1692,560,76100,36603
4196,2262,1934,767,150300,36604
10135,5934,4201,759,77300,36605
7824,4191,3633,759,95500,36606
2763,1481,1282,746,103300,36607
14332,8421,5911,815,159100,36608
11082,4670,6412,755,138500,36609
4171,2128,2043,656,47400,36610
2145,1229,916,838,78200,36611
1551,787,764,733,60500,36612
4272,3397,875,788,100200,36613
0,0,0,-,-,36615
0,0,0,-,-,36616
5041,3012,2029,749,73200,36617
6314,5081,1233,820,111900,36618
5855,4625,1230,838,130700,36619
0,0,0,-,-,36688
7483,5063,2420,897,145200,36693
18504,12715,5789,953,179100,36695
8768,5371,3397,612,92200,36701
5011,2437,2574,565,73000,36703
317,221,96,923,36300,36720
179,96,83,-,87400,36722
60,23,37,-,63600,36723
1847,1075,772,423,96200,36726
38,33,5,-,21100,36727
146,121,25,-,84300,36728
3496,2078,1418,484,114100,36732
434,365,69,-,54500,36736
347,293,54,-,75700,36738
520,381,139,517,59800,36740
597,474,123,601,56700,36742
2751,1767,984,422,84400,36744
1378,967,411,614,89100,36748
200,160,40,-,93200,36749
1125,819,306,602,106200,36750
179,151,28,510,34800,36751
666,561,105,618,98700,36752
23,6,17,-,-,36753
137,67,70,-,-,36754
1676,1353,323,528,91600,36756
558,356,202,626,82300,36758
643,439,204,534,60600,36759
457,384,73,-,69500,36761
89,74,15,-,83800,36763
500,443,57,903,51700,36765
8,8,0,-,-,36766
742,551,191,461,50600,36767
316,249,67,659,43700,36768
905,587,318,450,71600,36769
209,134,75,605,97500,36773
355,243,112,769,41400,36775
573,481,92,-,92000,36776
1032,857,175,448,76100,36782
277,223,54,425,61900,36783
2860,1801,1059,520,104400,36784
617,463,154,438,61500,36785
1132,645,487,488,54300,36786
49,49,0,-,60400,36790
421,323,98,-,84300,36792
167,149,18,-,-,36793
10031,5617,4414,685,153300,36801
6371,4534,1837,761,111200,36804
14817,7385,7432,827,235300,36830
9755,3898,5857,835,105700,36832
0,0,0,-,-,36849
1113,883,230,325,50400,36850
897,723,174,744,91800,36852
3429,2683,746,643,138200,36853
5850,3885,1965,771,91900,36854
652,546,106,499,108800,36855
2097,1638,459,1221,222200,36856
139,120,19,-,151400,36858
19,19,0,-,-,36859
639,502,137,551,65300,36860
1339,1060,279,636,139700,36861
2636,1877,759,541,72400,36862
4935,3149,1786,657,81600,36863
21,13,8,-,64200,36865
1586,1250,336,564,75900,36866
9513,4753,4760,772,131300,36867
8015,4723,3292,714,104400,36869
6890,4871,2019,855,127000,36870
515,396,119,-,97900,36871
3160,2659,501,749,146500,36874
1571,1154,417,596,105600,36875
4727,3243,1484,854,141000,36877
657,549,108,571,169900,36879
188,121,67,507,-,36901
1765,1180,585,555,76900,36904
793,625,168,651,77400,36907
849,790,59,350,68200,36908
31,18,13,-,-,36910
869,706,163,500,64100,36912
42,42,0,-,40900,36913
241,188,53,486,43300,36915
300,208,92,-,60000,36916
717,646,71,527,46400,36919
464,434,30,585,58500,36921
202,150,52,567,57200,36922
1188,810,378,520,52900,36925
1787,1536,251,967,233800,37010
938,652,286,757,119300,37012
34059,18421,15638,905,149900,37013
803,749,54,832,477000,37014
6752,5055,1697,880,144200,37015
393,257,136,767,208600,37016
843,667,176,967,60700,37018
231,214,17,-,87100,37019
1863,1545,318,696,138300,37020
2173,1795,378,753,121100,37022
521,443,78,848,151900,37023
2063,1765,298,673,126400,37025
846,735,111,717,117200,37026
18848,16234,2614,1376,484100,37027
371,309,62,-,117900,37028
2098,1787,311,748,215000,37029
2876,1867,1009,452,121800,37030
1467,1309,158,916,151400,37031
1612,1201,411,923,185800,37032
3118,2269,849,616,116500,37033
2588,2168,420,788,147000,37034
1241,1081,160,831,137900,37035
2076,1548,528,657,119700,37036
2554,2161,393,876,150700,37037
17014,9337,7677,847,145900,37040
26717,14701,12016,902,128300,37042
16738,11486,5252,866,184400,37043
1572,1381,191,-,272300,37046
943,708,235,791,119400,37047
2204,1964,240,925,195700,37048
1259,934,325,874,165800,37049
598,463,135,492,95000,37050
1401,1066,335,776,139000,37051
1045,783,262,828,162000,37052
10236,6894,3342,737,142000,37055
313,236,77,723,112100,37057
3026,2181,845,571,123500,37058
468,387,81,707,97500,37059
861,730,131,903,150000,37060
1802,1356,446,607,91600,37061
4102,3277,825,909,184200,37062
19723,15127,4596,1070,342300,37064
17236,11434,5802,859,190100,37066
10404,6687,3717,1348,387200,37067
6774,6073,701,1781,396900,37069
12568,8589,3979,930,174400,37072
5383,4097,1286,811,149600,37073
2765,2109,656,586,117100,37074
23818,17167,6651,1037,219800,37075
16078,8939,7139,962,167200,37076
220,156,64,535,97100,37078
650,472,178,640,171300,37079
2968,2407,561,887,169500,37080
2283,1928,355,1081,203900,37082
5744,4215,1529,540,115400,37083
1612,1390,222,1161,186100,37085
10580,7534,3046,1076,128100,37086
15974,10659,5315,813,187000,37087
5233,4080,1153,934,177600,37090
8634,5863,2771,633,105600,37091
773,529,244,626,120900,37095
2253,1843,410,507,81700,37096
921,754,167,488,79200,37097
2221,1651,570,682,88500,37098
2457,1786,671,657,109100,37101
12958,8712,4246,596,100300,37110
16150,7160,8990,819,132500,37115
308,249,59,-,238200,37118
19151,15934,3217,1082,236700,37122
6304,4868,1436,894,178700,37127
16440,10444,5996,1087,184600,37128
19846,13951,5895,962,173800,37129
21703,9626,12077,840,163400,37130
0,0,0,-,-,37132
1079,950,129,784,89900,37134
3726,3366,360,1390,328700,37135
1180,957,223,665,74500,37137
9073,7181,1892,948,169700,37138
25,25,0,-,64400,37140
478,354,124,1007,149500,37141
681,457,224,669,127200,37142
1374,1164,210,834,183900,37143
1155,926,229,632,86300,37144
794,615,179,541,106700,37145
2351,1933,418,1268,197000,37146
8202,5990,2212,786,135500,37148
891,799,92,639,148000,37149
1971,1432,539,522,93200,37150
194,179,15,-,148200,37151
1982,1770,212,1059,200000,37153
12416,7644,4772,685,119000,37160
29,17,12,-,-,37165
5173,3203,1970,575,124600,37166
19865,13596,6269,872,160300,37167
237,237,0,-,87200,37171
10334,7324,3010,798,148900,37172
11129,8330,2799,1197,221600,37174
370,307,63,675,118000,37175
909,745,164,647,92300,37178
4064,3711,353,1221,244900,37179
1207,975,232,638,125200,37180
565,412,153,676,131500,37181
1191,970,221,639,132200,37183
2182,1751,431,737,150300,37184
3311,2556,755,639,109000,37185
3167,2358,809,685,111500,37186
2703,2085,618,741,137600,37187
5157,4313,844,915,172200,37188
1299,1000,299,1054,176000,37189
3465,2441,1024,620,155000,37190
1387,1177,210,872,135200,37191
631,228,403,1298,242300,37201
6338,1497,4841,915,271000,37203
5598,3331,2267,1076,382400,37204
11115,7703,3412,1240,467800,37205
10792,5493,5299,751,224100,37206
13793,7545,6248,789,124900,37207
6977,2298,4679,716,129000,37208
14621,6786,7835,931,218600,37209
6838,2131,4707,690,127100,37210
30161,13835,16326,902,172100,37211
6680,2444,4236,1107,457800,37212
0,0,0,-,-,37213
13286,8104,5182,969,146600,37214
9744,7489,2255,1251,535100,37215
7901,5169,2732,893,176900,37216
12722,5010,7712,844,133900,37217
5358,3635,1723,826,137600,37218
812,215,597,1375,290600,37219
2327,2047,280,1422,373400,37220
16634,11606,5028,1142,235800,37221
577,22,555,889,-,37228
0,0,0,-,-,37240
0,0,0,-,-,37243
0,0,0,-,-,37246
501,386,115,538,74400,37301
1649,1330,319,738,268300,37302
9640,6341,3299,597,130900,37303
370,308,62,817,58000,37305
996,803,193,663,123200,37306
2054,1530,524,637,106800,37307
1047,920,127,588,145600,37308
809,654,155,767,104300,37309
1837,1576,261,542,163000,37310
10392,4800,5592,641,110000,37311
12937,8276,4661,812,170400,37312
508,406,102,528,84300,37313
0,0,0,-,-,37315
1157,903,254,626,115900,37317
771,527,244,537,86500,37318
7047,4737,2310,664,104800,37321
3077,2416,661,651,103900,37322
11768,9085,2683,780,122300,37323
2149,1300,849,557,98100,37324
528,448,80,729,116800,37325
170,69,101,513,81300,37326
4514,3396,1118,654,138300,37327
574,386,188,557,107400,37328
2224,1804,420,611,110200,37329
3027,2483,544,749,99800,37330
3036,2245,791,544,103900,37331
988,795,193,580,118300,37332
220,158,62,663,74300,37333
9195,6403,2792,662,114800,37334
1091,890,201,741,95500,37335
1753,1418,335,945,167800,37336
646,476,170,386,88200,37337
1462,994,468,588,91400,37338
801,694,107,683,82100,37339
305,211,94,-,-,37340
4480,3924,556,918,145400,37341
1262,1048,214,589,98900,37342
16749,12541,4208,780,166400,37343
936,733,203,557,89500,37345
3043,2173,870,688,120600,37347
419,289,130,561,150200,37348
742,657,85,1125,559200,37350
109,15,94,1088,-,37351
1353,1050,303,568,163000,37352
1667,1339,328,770,145300,37353
6543,4840,1703,584,111500,37354
9925,6850,3075,695,128500,37355
973,613,360,539,134500,37356
2063,1585,478,547,132400,37357
286,239,47,599,105300,37359
622,565,57,770,133300,37360
560,429,131,753,155500,37361
1246,882,364,713,118400,37362
13640,11007,2633,905,206000,37363
485,434,51,556,64300,37365
343,231,112,656,95900,37366
3531,2560,971,527,110200,37367
423,394,29,-,84300,37369
1839,1495,344,498,133100,37370
1016,805,211,683,143300,37373
760,562,198,615,118300,37374
1097,754,343,1010,239200,37375
167,141,26,-,103400,37376
5680,4710,970,1118,308400,37377
10765,8994,1771,729,156200,37379
2648,1722,926,648,123500,37380
3752,2868,884,602,118100,37381
3164,2781,383,540,115400,37385
1199,885,314,534,76800,37387
10663,6923,3740,656,115200,37388
641,583,58,568,117600,37391
25,18,7,-,96700,37394
86,25,61,-,-,37396
3820,2981,839,615,110300,37397
5795,4238,1557,526,122100,37398
2041,72,1969,314,409500,37402
1226,420,806,797,276600,37403
4745,2236,2509,709,106200,37404
6999,3813,3186,958,224000,37405
5702,2669,3033,629,87600,37406
3279,1136,2143,717,63400,37407
753,269,484,644,252100,37408
1016,643,373,734,144900,37409
1528,470,1058,565,69500,37410
7463,4421,3042,705,105100,37411
8869,4624,4245,769,116300,37412
10739,5969,4770,807,143100,37415
6245,4042,2203,769,136900,37416
2554,1864,690,717,180200,37419
18942,11563,7379,960,174900,37421
15647,8868,6779,667,140400,37601
15952,8474,7478,710,147600,37604
0,0,0,-,-,37614
8637,6182,2455,684,185100,37615
1996,1721,275,562,117500,37616
5425,4438,987,606,137600,37617
5576,4489,1087,600,123700,37618
16015,11687,4328,642,108300,37620
1525,1336,189,514,96300,37640
3715,2915,800,641,102500,37641
5904,4710,1194,663,117600,37642
14328,9830,4498,589,109400,37643
2027,1501,526,763,130400,37645
5116,3562,1554,613,104700,37650
1794,1449,345,712,115000,37656
453,355,98,610,76100,37657
1870,1489,381,544,100800,37658
11178,9080,2098,752,146800,37659
17431,10661,6770,591,119800,37660
6113,4752,1361,720,158300,37663
11250,8443,2807,633,146900,37664
2589,1726,863,610,89900,37665
225,153,72,355,105400,37680
2358,1857,501,672,124400,37681
36,36,0,-,-,37682
4835,3577,1258,492,126800,37683
3252,2634,618,613,153400,37686
1829,1611,218,513,87900,37687
443,348,95,467,88200,37688
1437,1377,60,-,124600,37690
333,181,152,518,72500,37691
2034,1614,420,639,134600,37692
674,532,142,627,116100,37694
3122,2229,893,750,121100,37701
1606,1339,267,741,174600,37705
2728,2266,462,543,99600,37708
1483,1147,336,635,117700,37709
382,344,38,-,62000,37710
2009,1565,444,573,95700,37711
569,352,217,670,93100,37713
1740,1114,626,578,92500,37714
280,220,60,-,55200,37715
10340,7371,2969,666,145900,37716
62,24,38,-,-,37719
4925,3947,978,889,141800,37721
2340,1832,508,588,123600,37722
405,356,49,628,82700,37723
1174,631,543,595,89800,37724
6636,5467,1169,828,145300,37725
726,665,61,-,88000,37726
942,768,174,571,90900,37727
565,446,119,625,48000,37729
9,9,0,-,-,37730
247,231,16,-,88900,37731
118,85,33,-,54700,37732
21,21,0,-,-,37733
2375,1971,404,645,169600,37737
2634,1623,1011,769,168600,37738
2279,2023,256,715,184300,37742
10118,7214,2904,545,120200,37743
7148,4600,2548,553,124900,37745
6828,4850,1978,681,94900,37748
2375,1832,543,606,111900,37752
306,198,108,458,104300,37753
1972,1473,499,928,116700,37754
1255,824,431,460,86400,37755
1056,725,331,460,57700,37756
3585,2573,1012,596,122000,37757
4771,2650,2121,623,136200,37760
1315,746,569,332,69500,37762
6385,5105,1280,716,158600,37763
3484,2633,851,675,147400,37764
172,155,17,-,113800,37765
7548,5221,2327,546,81800,37766
2097,1409,688,523,76700,37769
960,803,157,722,111700,37770
5752,3944,1808,712,126700,37771
4927,3843,1084,880,212200,37772
7873,6430,1443,678,226400,37774
4905,3011,1894,666,198000,37777
1311,1058,253,512,104200,37779
10176,6977,3199,759,163800,37801
12375,9983,2392,754,183800,37803
9054,6724,2330,815,156000,37804
1067,866,201,658,99800,37806
3767,2685,1082,550,101900,37807
856,680,176,689,84000,37809
769,655,114,562,101400,37810
1423,1199,224,662,96000,37811
6747,4233,2514,643,107800,37813
12890,8420,4470,695,131200,37814
2113,1508,605,543,93500,37818
290,199,91,659,74900,37819
2813,2274,539,721,119600,37820
9190,5849,3341,540,95400,37821
3663,2595,1068,472,83800,37825
1783,1473,310,657,97200,37826
634,479,155,789,223100,37828
662,541,121,888,89800,37829
12841,7765,5076,738,150200,37830
4060,3205,855,636,106900,37840
3722,2596,1126,555,98900,37841
1589,1279,310,666,131600,37843
270,203,67,-,62300,37845
1837,1340,497,622,105500,37846
903,776,127,518,71200,37847
110,110,0,-,99700,37848
9744,7672,2072,853,161200,37849
26,26,0,-,-,37851
924,652,272,532,77500,37852
1551,972,579,815,140300,37853
5304,3820,1484,647,96700,37854
8298,6182,2116,533,98900,37857
1645,1183,462,610,135600,37860
3197,2391,806,561,104200,37861
8568,4805,3763,699,169000,37862
2689,1604,1085,756,169100,37863
8593,6659,1934,775,160900,37865
693,630,63,553,208300,37866
2035,1474,561,424,81000,37869
1988,1455,533,579,93600,37870
3356,2654,702,695,127400,37871
643,498,145,639,91900,37872
1785,1216,569,523,95800,37873
5380,3808,1572,622,103100,37874
12198,8853,3345,776,153900,37876
3407,2751,656,673,133200,37877
232,187,45,484,75800,37878
4110,3007,1103,525,101600,37879
1420,1230,190,491,120300,37880
844,703,141,388,86600,37881
1247,1039,208,634,171300,37882
2207,1712,495,596,161300,37885
1752,1441,311,580,191300,37886
1820,1290,530,630,98600,37887
1082,889,193,655,96600,37888
2682,1833,849,608,123100,37890
1408,1045,363,595,104600,37891
814,555,259,577,83100,37892
1296,255,1041,843,274500,37902
6994,2740,4254,857,170100,37909
10333,5143,5190,740,112800,37912
8338,5258,3080,788,115800,37914
3291,802,2489,515,81500,37915
2673,127,2546,800,119100,37916
11797,5512,6285,723,93800,37917
17410,12058,5352,767,147400,37918
12781,6746,6035,799,272700,37919
16787,10683,6104,721,128700,37920
11548,6913,4635,799,116900,37921
12335,10446,1889,1086,298400,37922
12709,7103,5606,878,181400,37923
4654,3638,1016,704,125600,37924
10917,7772,3145,980,195500,37931
6195,4594,1601,1106,220400,37932
9218,7994,1224,1189,297100,37934
6420,5665,755,786,174800,37938
1720,1133,587,609,88800,38001
13032,11049,1983,1293,216500,38002
3564,2967,597,1117,175000,38004
1888,1302,586,695,104900,38006
25,25,0,-,-,38007
3345,2168,1177,571,88500,38008
3464,2747,717,904,140100,38011
5544,3115,2429,591,101900,38012
938,639,299,571,103600,38015
18171,9893,8278,1056,159100,38016
17774,14256,3518,1164,276600,38017
13644,9068,4576,1105,153300,38018
5949,3521,2428,675,115300,38019
15,15,0,-,-,38021
1933,1434,499,799,138300,38023
11131,6654,4477,613,107700,38024
2444,2254,190,935,332900,38028
0,0,0,-,-,38029
222,91,131,758,105200,38030
1144,871,273,606,91300,38034
199,21,178,403,68300,38036
639,462,177,625,68000,38037
641,479,162,630,83000,38039
1966,1203,763,627,83600,38040
1013,687,326,578,59300,38041
370,307,63,347,64400,38042
349,309,40,531,100400,38044
23,15,8,-,237500,38046
33,22,11,-,-,38047
1548,1123,425,831,95500,38049
201,107,94,700,81200,38050
1418,1059,359,570,84000,38052
10179,6798,3381,829,128000,38053
45,0,45,1781,-,38054
1385,1056,329,686,153800,38057
3389,2201,1188,1010,147700,38058
2812,2158,654,671,103300,38059
3917,3473,444,1160,170800,38060
264,185,79,605,84500,38061
6741,3767,2974,605,84100,38063
1094,853,241,710,225000,38066
533,470,63,786,95700,38067
3867,2645,1222,562,151500,38068
910,727,183,529,80800,38069
142,102,40,-,49600,38070
1309,910,399,687,86700,38075
304,261,43,725,136900,38076
33,15,18,-,-,38077
1161,720,441,552,78300,38079
1158,757,401,445,71900,38080
6825,1860,4965,1158,234000,38103
12647,4183,8464,714,182900,38104
3187,417,2770,631,71700,38105
9772,4795,4977,696,50900,38106
6806,3188,3618,749,83900,38107
6555,2877,3678,734,45700,38108
16572,10280,6292,822,66500,38109
16919,7647,9272,771,97500,38111
6544,3052,3492,723,104900,38112
9870,4398,5472,705,56100,38114
16750,4010,12740,821,87400,38115
14107,7264,6843,800,95300,38116
11227,8916,2311,1091,177700,38117
13133,6312,6821,854,71700,38118
10094,5147,4947,961,165500,38119
6424,4486,1938,1057,294400,38120
9263,4578,4685,862,70600,38122
13702,8843,4859,1107,146000,38125
2060,341,1719,503,46000,38126
14900,7423,7477,835,59200,38127
15773,7365,8408,822,81200,38128
0,0,0,-,-,38131
0,0,0,-,-,38132
7475,5724,1751,1157,145300,38133
14946,7069,7877,889,117900,38134
10403,8519,1884,1208,162200,38135
9857,7775,2082,1196,260800,38138
5518,5138,380,2271,369800,38139
7641,5350,2291,1144,92800,38141
0,0,0,-,-,38152
4207,3005,1202,649,90700,38201
785,514,271,620,76700,38220
1392,1136,256,539,78200,38221
1317,1004,313,666,96600,38222
325,284,41,704,84400,38224
2732,2111,621,581,96200,38225
96,96,0,-,65900,38226
1160,825,335,550,82300,38229
1476,1109,367,555,78600,38230
634,524,110,638,76100,38231
816,664,152,514,79900,38232
1110,816,294,521,90200,38233
113,69,44,564,78100,38235
299,271,28,-,79000,38236
6085,3566,2519,576,118500,38237
1022,707,315,597,71000,38240
360,301,59,316,97600,38241
8360,5633,2727,588,99500,38242
1104,907,197,580,84300,38251
389,313,76,630,102000,38253
25,23,2,-,57500,38254
930,634,296,631,67700,38255
1273,1122,151,551,104900,38256
1844,1364,480,472,87300,38257
591,381,210,568,67900,38258
308,230,78,583,77500,38259
1357,932,425,640,83800,38260
6777,4128,2649,585,94100,38261
13096,6901,6195,676,82800,38301
19703,12988,6715,889,147900,38305
2201,1784,417,497,87400,38310
394,346,48,-,102700,38311
1040,893,147,717,94700,38313
1361,1099,262,575,75700,38315
1287,1043,244,633,81600,38316
954,728,226,593,69100,38317
197,107,90,460,58300,38318
4396,3229,1167,542,95600,38320
914,661,253,642,102300,38321
1138,986,152,839,114900,38326
163,106,57,537,72700,38327
240,207,33,544,90300,38328
1303,1025,278,616,96400,38329
1798,1279,519,582,71700,38330
494,440,54,-,82300,38332
172,167,5,-,85400,38333
725,583,142,445,80400,38334
478,337,141,682,85500,38337
228,182,46,650,81400,38339
4643,3293,1350,664,105000,38340
905,743,162,665,89500,38341
556,461,95,550,53900,38342
5892,4202,1690,636,90200,38343
3343,2513,830,558,98500,38344
915,632,283,801,106200,38345
102,57,45,-,-,38347
454,405,49,550,69800,38348
6726,4726,2000,584,99700,38351
250,145,105,424,114800,38352
2230,1721,509,1085,157800,38355
1036,784,252,581,84400,38356
1030,759,271,571,95900,38357
4401,3324,1077,645,107200,38358
126,108,18,538,89000,38359
395,324,71,688,105800,38361
418,331,87,1092,88400,38362
2340,1725,615,552,86000,38363
12,0,12,-,-,38365
693,564,129,739,115500,38366
1153,854,299,633,86400,38367
800,640,160,682,80000,38368
713,562,151,532,80700,38369
309,250,59,559,69400,38370
436,330,106,609,88100,38371
6544,4840,1704,600,105400,38372
890,600,290,509,84400,38374
3470,2343,1127,575,91400,38375
97,87,10,-,-,38376
538,420,118,619,103800,38379
277,227,50,586,88100,38380
510,341,169,640,88100,38381
3942,2524,1418,609,92900,38382
105,94,11,-,115600,38387
747,541,206,629,78500,38388
341,264,77,501,94400,38390
389,321,68,693,82900,38391
247,239,8,-,83800,38392
21363,13862,7501,698,139600,38401
683,545,138,529,96300,38425
996,681,315,538,99500,38449
1128,966,162,566,78400,38450
1602,1306,296,742,141200,38451
480,436,44,-,102900,38452
150,146,4,-,178700,38453
424,313,111,692,101600,38454
61,54,7,394,135000,38455
1513,1302,211,654,105500,38456
303,252,51,525,103600,38457
209,154,55,704,69200,38459
497,393,104,747,84300,38460
416,378,38,771,88600,38461
3962,2989,973,479,89500,38462
1072,886,186,517,75900,38463
8853,6164,2689,602,103900,38464
1911,1621,290,660,93300,38468
1605,1252,353,563,93500,38469
200,171,29,-,137500,38471
1039,910,129,608,98600,38472
486,343,143,556,87200,38473
3184,2180,1004,542,93400,38474
217,187,30,-,101400,38475
492,377,115,1061,253800,38476
1207,927,280,521,129300,38477
6787,4357,2430,615,119600,38478
388,297,91,523,78200,38481
659,554,105,681,163300,38482
2142,1709,433,634,114100,38483
2688,2146,542,491,85900,38485
418,356,62,764,95800,38486
457,245,212,751,123000,38487
980,840,140,558,125600,38488
16342,8322,8020,621,154000,38501
401,377,24,-,162700,38504
0,0,0,-,-,38505
10973,8550,2423,724,154300,38506
613,545,68,558,74300,38541
0,0,0,-,-,38542
251,212,39,560,85000,38543
2711,1949,762,640,118600,38544
577,399,178,534,100800,38545
706,609,97,783,152700,38547
284,208,76,700,129500,38548
1589,1256,333,445,96700,38549
1577,1072,505,465,103600,38551
85,66,19,-,170000,38552
960,739,221,717,105100,38553
468,383,85,-,89800,38554
7810,4862,2948,612,139300,38555
5136,3669,1467,469,103300,38556
4339,3839,500,904,200800,38558
443,408,35,643,93600,38559
509,441,68,535,97800,38560
2667,2069,598,461,91600,38562
1159,785,374,616,118500,38563
155,133,22,-,88500,38564
484,449,35,-,79500,38565
274,264,10,-,126700,38567
960,750,210,526,71300,38568
132,112,20,-,-,38569
3868,2785,1083,490,107400,38570
5409,4426,983,553,129000,38571
4684,4078,606,671,107800,38572
826,744,82,603,143900,38573
3201,2415,786,523,109200,38574
443,399,44,565,91600,38575
446,407,39,-,112900,38577
70,62,8,-,112500,38578
357,246,111,627,115300,38579
600,464,136,-,123900,38580
1519,1272,247,632,89900,38581
675,638,37,686,133200,38582
8901,6883,2018,640,95200,38583
1282,1109,173,429,89900,38585
566,516,50,489,108700,38587
378,278,100,-,143800,38588
80,37,43,-,-,38589
875,693,182,482,76600,38601
1281,1084,197,536,71200,38603
5311,3798,1513,693,100400,38606
1261,943,318,618,63000,38610
6313,4900,1413,680,120500,38611
6889,3472,3417,587,67100,38614
255,171,84,312,58400,38617
4175,3337,838,688,96900,38618
2106,1373,733,595,69500,38619
1322,1178,144,766,62000,38620
544,355,189,633,45100,38621
258,161,97,551,37500,38622
112,71,41,631,43200,38623
415,313,102,566,78800,38625
667,423,244,474,89800,38626
388,278,110,795,51300,38627
669,569,100,431,114600,38629
99,74,25,-,29100,38630
428,206,222,492,60000,38631
9193,7562,1631,956,173900,38632
755,553,202,544,68600,38633
5491,3963,1528,613,78900,38635
9611,5800,3811,963,96000,38637
447,210,237,349,38200,38639
857,758,99,596,170600,38641
778,711,67,546,74900,38642
944,501,443,484,52300,38643
82,60,22,625,34300,38644
519,253,266,616,71000,38645
1226,921,305,554,66300,38646
320,272,48,-,105800,38647
1420,1072,348,625,71100,38650
2675,2327,348,980,175500,38651
6300,4233,2067,694,96700,38652
17828,13998,3830,1084,179900,38654
16237,8910,7327,854,183100,38655
719,662,57,932,71700,38658
904,781,123,707,85700,38659
752,666,86,-,90000,38661
4720,3442,1278,539,85800,38663
1316,188,1128,736,126700,38664
843,709,134,545,101600,38665
2579,1850,729,603,60400,38666
5044,3401,1643,683,128800,38668
333,287,46,757,39800,38670
13149,7767,5382,959,113200,38671
4289,3790,499,1575,190800,38672
338,287,51,788,48200,38673
303,254,49,-,64000,38674
2179,1108,1071,677,93200,38676
62,0,62,490,-,38677
2199,1477,722,832,136400,38680
2128,1641,487,353,66100,38683
444,419,25,-,126600,38685
8863,4735,4128,644,80200,38701
0,0,0,-,-,38702
4702,2661,2041,648,69000,38703
3,3,0,-,-,38704
312,209,103,635,33200,38720
377,258,119,663,58100,38721
185,99,86,588,51300,38722
7,7,0,-,-,38723
314,155,159,530,43900,38725
183,117,66,608,28300,38726
760,529,231,717,100700,38730
51,9,42,-,-,38731
6935,3579,3356,676,102400,38732
129,100,29,656,97100,38736
1090,498,592,501,61200,38737
76,0,76,201,-,38738
106,60,46,579,58300,38740
350,218,132,424,80800,38744
48,25,23,-,66800,38745
175,69,106,573,36100,38746
1485,883,602,480,63200,38748
8,3,5,-,-,38749
3963,2416,1547,639,72700,38751
529,365,164,561,105700,38753
523,285,238,505,64000,38754
2299,1364,935,628,71300,38756
378,278,100,838,84700,38759
348,190,158,607,58800,38760
737,397,340,522,58400,38761
881,447,434,445,82200,38762
111,49,62,-,41000,38764
22,22,0,-,-,38765
13,13,0,-,-,38767
35,7,28,-,-,38768
721,363,358,476,65000,38769
1051,493,558,554,69800,38771
43,38,5,-,63000,38772
1202,738,464,507,76000,38773
855,429,426,423,62300,38774
576,325,251,527,61400,38778
110,64,46,263,82300,38781
11181,6754,4427,707,118100,38801
6959,4254,2705,685,135700,38804
4811,3561,1250,615,97200,38821
3263,2273,990,511,98700,38824
1972,1552,420,966,136800,38826
1145,819,326,557,105800,38827
1536,1193,343,482,110500,38828
6791,4785,2006,627,80800,38829
1060,777,283,542,48400,38833
11694,7632,4062,632,89700,38834
521,413,108,-,77700,38838
1009,681,328,627,107800,38841
4378,3129,1249,651,88400,38843
78,76,2,-,46700,38844
897,756,141,618,82400,38846
1218,991,227,463,70800,38847
302,286,16,-,70000,38848
2439,1956,483,679,94000,38849
1104,778,326,518,59400,38850
2978,2206,772,568,59800,38851
3714,2770,944,549,86300,38852
1766,1275,491,649,85800,38855
740,722,18,688,88000,38856
1382,1209,173,595,116300,38857
2853,2176,677,552,81900,38858
287,245,42,-,72200,38859
2058,1534,524,547,60100,38860
814,640,174,616,101600,38862
7298,5248,2050,643,89300,38863
678,576,102,698,64600,38864
1777,1464,313,511,80700,38865
4628,3552,1076,481,142800,38866
1982,1520,462,618,77100,38868
150,75,75,767,113200,38869
1042,837,205,598,98000,38870
658,543,115,766,110600,38871
1100,906,194,503,64500,38873
591,457,134,538,86000,38876
1029,811,218,605,59600,38878
356,75,281,571,-,38879
6264,4265,1999,602,97600,38901
131,109,22,-,66900,38913
219,147,72,670,55100,38914
1582,1091,491,477,72000,38915
2235,1462,773,512,70200,38916
1360,1051,309,-,84900,38917
306,253,53,-,62400,38920
1619,1200,419,351,68300,38921
1450,1174,276,504,64400,38922
463,447,16,-,91700,38923
312,224,88,560,53700,38924
1037,806,231,525,72900,38925
435,358,77,-,46000,38927
103,64,39,383,32800,38928
599,490,109,643,70500,38929
8758,4770,3988,536,82000,38930
727,606,121,647,69000,38940
1414,513,901,613,69900,38941
99,99,0,-,74200,38943
217,157,60,443,-,38944
22,0,22,-,-,38945
96,68,28,450,44800,38946
214,202,12,-,81700,38947
1232,1001,231,510,33500,38948
68,52,16,-,97100,38949
149,121,28,-,81500,38950
385,352,33,835,60200,38951
188,110,78,819,75000,38952
198,188,10,-,-,38953
418,243,175,572,64400,38954
302,200,102,228,70500,38957
11,11,0,-,-,38958
228,197,31,-,51900,38961
69,38,31,-,109700,38962
346,237,109,603,54100,38963
42,11,31,504,-,38964
3491,2500,991,546,82700,38965
343,255,88,688,58800,38966
2624,1999,625,466,87200,38967
2167,1223,944,537,59700,39038
804,548,256,911,83900,39039
1391,1039,352,668,68700,39040
1318,1040,278,510,84400,39041
13169,10750,2419,914,155900,39042
1416,1335,81,630,94600,39044
440,428,12,-,97100,39045
9440,5928,3512,734,151800,39046
14898,12463,2435,1233,181900,39047
5869,4242,1627,578,79300,39051
145,83,62,433,-,39054
9256,6287,2969,924,157900,39056
669,493,176,754,70400,39057
4137,3235,902,738,87600,39059
0,0,0,-,-,39061
202,138,64,596,76900,39062
1227,749,478,581,60300,39063
1487,1194,293,508,82200,39066
593,532,61,-,53800,39067
1812,963,849,433,60000,39069
2229,1678,551,703,152500,39071
6955,5315,1640,741,129700,39073
5479,3888,1591,612,66200,39074
345,294,51,335,104200,39078
517,325,192,586,56100,39079
428,358,70,531,65800,39082
3477,2448,1029,612,87000,39083
561,451,110,-,43900,39086
35,7,28,-,-,39088
5123,3399,1724,535,82200,39090
1009,813,196,656,82700,39092
1215,951,264,554,76900,39094
2706,1670,1036,517,50800,39095
430,270,160,550,60500,39096
206,97,109,441,34000,39097
707,619,88,727,59700,39108
14696,13611,1085,1341,252800,39110
3386,2414,972,622,88000,39111
141,64,77,324,-,39113
3534,2950,584,714,83900,39114
16,8,8,-,-,39115
691,531,160,-,71700,39116
3755,2784,971,671,82700,39117
2073,1684,389,664,67600,39119
11686,7460,4226,581,89800,39120
930,722,208,729,80200,39140
234,219,15,-,35800,39144
1914,1596,318,712,124000,39145
860,659,201,457,62100,39146
462,401,61,-,108300,39149
2161,1416,745,579,62800,39150
496,352,144,624,58000,39152
1428,1117,311,512,71200,39153
3328,2831,497,742,151500,39154
155,155,0,-,-,39156
10373,4863,5510,968,176600,39157
1374,757,617,511,58600,39159
1057,835,222,537,34000,39160
21,14,7,-,48800,39162
178,120,58,256,86700,39166
0,0,0,-,-,39167
2513,1962,551,607,75900,39168
929,488,441,360,42300,39169
3605,3242,363,693,166200,39170
42,20,22,-,-,39174
1560,1336,224,780,80600,39175
697,495,202,379,-,39176
64,25,39,-,120800,39177
444,361,83,-,101200,39179
12638,7984,4654,672,104800,39180
5683,3521,2162,624,119700,39183
1376,1115,261,586,80500,39189
2723,2315,408,645,94800,39191
492,389,103,788,64300,39192
0,0,0,-,-,39193
6053,3332,2721,565,69700,39194
298,21,277,1143,-,39201
3569,1001,2568,717,171800,39202
1985,895,1090,603,56100,39203
6339,2448,3891,715,71300,39204
10238,4990,5248,777,103500,39206
11172,6968,4204,789,117300,39208
9746,4556,5190,736,61300,39209
10329,6707,3622,961,159000,39211
11553,7448,4105,834,89500,39212
8568,4705,3863,630,61900,39213
1535,686,849,759,190300,39216
0,0,0,-,-,39217
2478,1412,1066,872,116900,39218
3306,1455,1851,980,187800,39232
0,0,0,-,-,39269
4660,3593,1067,1076,128800,39272
10229,5853,4376,650,77400,39301
8264,5600,2664,778,147400,39305
6184,3585,2599,665,68700,39307
0,0,0,-,-,39309
603,470,133,821,133400,39320
590,562,28,-,71600,39322
501,420,81,545,59000,39323
2416,2217,199,559,103000,39325
238,146,92,690,75500,39326
1444,1094,350,634,111400,39327
1636,1192,444,346,62800,39328
876,789,87,631,97300,39330
611,571,40,582,72700,39332
1150,1079,71,-,60900,39335
426,324,102,-,56000,39336
756,637,119,-,102100,39337
1428,1168,260,580,57500,39338
6161,4103,2058,622,82100,39339
2499,1718,781,610,58800,39341
529,149,380,826,102500,39342
2592,1934,658,539,74000,39345
898,644,254,616,75800,39346
699,563,136,543,90100,39347
428,369,59,-,40900,39348
9157,6556,2601,622,79400,39350
185,161,24,-,79700,39352
769,595,174,756,57500,39354
2830,2288,542,598,67100,39355
281,256,25,-,-,39356
655,501,154,275,51700,39358
107,74,33,613,128600,39359
1451,1196,255,534,62000,39360
631,527,104,-,65000,39361
1010,819,191,452,50800,39362
743,550,193,587,49700,39363
1191,973,218,-,82000,39364
2589,2013,576,536,75200,39365
636,568,68,-,74400,39366
5559,4463,1096,501,72500,39367
16720,7029,9691,680,89900,39401
15772,10079,5693,912,184500,39402
0,0,0,-,-,39406
1018,816,202,526,59000,39421
2032,1674,358,604,66300,39422
1024,914,110,669,71900,39423
642,515,127,534,82500,39425
6172,5418,754,871,138500,39426
651,546,105,526,73700,39427
3322,2644,678,632,68800,39428
6284,4557,1727,630,83900,39429
4882,3808,1074,678,92600,39437
1726,1421,305,577,77700,39439
7856,4310,3546,604,74300,39440
7992,6403,1589,528,90500,39443
1435,1204,231,610,78000,39451
8927,7531,1396,689,104900,39452
3531,2669,862,618,84900,39455
445,367,78,506,129200,39456
1240,1024,216,642,72900,39459
261,241,20,-,103800,39461
380,273,107,540,76500,39462
779,752,27,-,118000,39464
7366,5295,2071,831,137500,39465
10494,7329,3165,741,114300,39466
4407,3414,993,700,100900,39470
2308,1615,693,577,87800,39474
4614,3291,1323,821,150000,39475
2804,2330,474,574,94200,39476
288,239,49,627,86000,39477
925,689,236,534,40800,39478
2192,1825,367,647,99000,39479
1037,839,198,701,108700,39480
621,538,83,742,79200,39481
3472,2935,537,697,154800,39482
2416,2022,394,553,68400,39483
8811,3433,5378,789,88600,39501
19083,12166,6917,843,136900,39503
7764,3688,4076,848,143200,39507
6750,4345,2405,779,128400,39520
3509,2915,594,1045,157000,39525
3439,1446,1993,739,104500,39530
7381,2170,5211,783,138200,39531
13202,8368,4834,910,165800,39532
0,0,0,-,-,39534
3844,1495,2349,955,108700,39540
6311,4071,2240,851,115600,39553
3166,2857,309,790,114300,39556
6656,4258,2398,965,137900,39560
739,586,153,675,122600,39561
6074,5028,1046,809,109800,39562
5289,3644,1645,772,85600,39563
13841,10118,3723,953,146000,39564
6093,5230,863,877,153400,39565
4391,2530,1861,723,115000,39567
5205,4100,1105,807,169300,39571
577,538,39,671,89500,39572
2929,2430,499,710,111300,39573
4569,3846,723,855,130800,39574
2392,1266,1126,721,125000,39576
3395,2424,971,678,106900,39577
4318,2044,2274,752,96400,39581
8707,6050,2657,672,95200,39601
2532,2125,407,708,87100,39629
361,166,195,458,59100,39630
1310,1006,304,384,59700,39631
414,326,88,219,62300,39633
94,94,0,-,-,39635
1357,971,386,611,56000,39638
1550,1240,310,809,92700,39641
435,361,74,917,76500,39643
1948,1802,146,665,84000,39645
458,417,41,-,151400,39647
7895,4532,3363,616,87500,39648
2950,2359,591,712,75700,39652
1097,857,240,498,73200,39653
1999,1588,411,538,96100,39654
308,302,6,-,61400,39656
732,596,136,611,79100,39657
1039,770,269,565,52800,39661
517,470,47,-,94300,39662
1189,898,291,950,87700,39663
788,616,172,-,75100,39664
467,428,39,542,91000,39665
3620,2933,687,604,99300,39666
4820,4222,598,493,93700,39667
228,181,47,-,77200,39668
1500,1255,245,508,67800,39669
5473,2722,2751,571,97600,39701
8379,5538,2841,810,111900,39702
5637,3004,2633,838,155600,39705
4284,3076,1208,557,73100,39730
1454,944,510,397,103800,39735
106,57,49,488,60700,39736
82,82,0,-,106100,39737
855,564,291,546,81700,39739
1854,1447,407,943,135500,39740
606,538,68,860,76600,39741
559,471,88,533,66400,39743
2318,1551,767,469,74800,39744
295,252,43,645,62900,39745
1274,1037,237,560,112600,39746
826,653,173,547,61100,39747
950,685,265,661,65500,39750
601,549,52,478,78200,39751
1124,944,180,494,79700,39752
285,230,55,663,57800,39755
720,520,200,870,48800,39756
15962,8037,7925,737,157500,39759
0,0,0,-,-,39760
15,0,15,-,-,39762
1027,885,142,811,83400,39766
258,226,32,-,65900,39767
801,706,95,578,87000,39769
38,25,13,-,83000,39771
617,440,177,666,66500,39772
6362,4158,2204,644,88300,39773
687,606,81,516,59100,39776
792,550,242,547,56800,39813
700,491,209,627,61900,39815
3862,2148,1714,560,99300,39817
4218,2488,1730,673,132700,39819
3020,1920,1100,610,83800,39823
196,156,40,-,76500,39824
540,294,246,550,139100,39825
173,95,78,603,101000,39826
1457,882,575,736,124600,39827
5491,2916,2575,765,105400,39828
975,735,240,623,94700,39834
155,90,65,-,101300,39836
2385,1653,732,607,94600,39837
2135,1105,1030,595,58300,39840
321,218,103,497,67400,39841
2984,1751,1233,629,87100,39842
3003,2228,775,682,76900,39845
737,419,318,512,61900,39846
850,502,348,418,78200,39851
895,681,214,677,67800,39854
416,322,94,442,80000,39859
536,319,217,593,125400,39861
564,462,102,597,60900,39862
182,155,27,570,75500,39866
189,165,24,-,79200,39867
824,572,252,429,82800,39870
123,101,22,830,61500,39877
34,26,8,-,85700,39885
576,403,173,436,89700,39886
1302,914,388,709,81600,39897
836,662,174,1157,184500,40003
11474,8428,3046,692,139200,40004
1945,1507,438,628,111600,40006
71,62,9,-,-,40007
1382,1147,235,719,143900,40008
378,316,62,610,84600,40009
190,111,79,1042,347700,40010
821,611,210,739,110100,40011
172,144,28,478,102300,40012
2013,1743,270,644,159600,40013
6884,6031,853,823,262500,40014
1523,853,670,747,116300,40019
58,49,9,-,83600,40020
344,321,23,964,247200,40022
1631,1629,2,-,307800,40023
19,19,0,-,906300,40025
1828,1679,149,1208,275900,40026
7258,5650,1608,751,202400,40031
5044,3494,1550,592,99900,40033
83,42,41,-,-,40036
1037,909,128,551,114800,40037
164,127,37,494,89400,40040
198,17,181,876,-,40041
1478,1064,414,739,105700,40045
712,691,21,-,159300,40046
7671,6725,946,690,166400,40047
0,0,0,-,-,40048
0,0,0,-,-,40049
645,332,313,692,108900,40050
1652,1271,381,520,108100,40051
231,155,76,-,98300,40052
740,574,166,1000,184000,40055
1302,1177,125,1173,171100,40056
1325,926,399,758,113900,40057
35,12,23,761,114300,40058
6765,6177,588,1552,385300,40059
423,302,121,683,124300,40060
112,102,10,-,86800,40062
0,0,0,-,-,40063
11089,6911,4178,814,165900,40065
1770,1357,413,903,235100,40067
785,641,144,725,170700,40068
3117,2250,867,570,103100,40069
126,126,0,-,184000,40070
5504,4497,1007,582,178900,40071
571,400,171,844,111700,40075
965,798,167,917,152600,40076
156,145,11,-,160200,40077
971,852,119,580,83200,40078
418,364,54,723,82500,40104
834,662,172,678,157400,40107
4494,3401,1093,673,145500,40108
712,622,90,865,157400,40109
6,0,6,-,-,40110
592,433,159,245,58700,40111
233,230,3,-,110300,40115
876,732,144,1090,131800,40117
3463,2423,1040,768,90500,40118
765,618,147,623,110200,40119
2241,4,2237,1146,-,40121
187,118,69,293,87300,40140
865,699,166,765,106400,40142
2222,1694,528,538,94300,40143
730,608,122,539,141700,40144
232,205,27,-,100600,40145
1428,1043,385,616,81500,40146
1492,1106,386,741,123200,40150
298,290,8,-,113500,40152
481,173,308,614,79400,40155
275,241,34,-,84400,40157
8990,4767,4223,695,122700,40160
59,36,23,-,-,40161
2051,1659,392,779,183700,40162
12453,9759,2694,755,158600,40165
132,93,39,323,67000,40170
160,140,20,-,74000,40171
5538,4426,1112,748,135000,40175
407,394,13,-,107600,40176
599,437,162,628,86000,40177
161,117,44,-,91300,40178
2636,169,2467,423,327800,40202
9276,1283,7993,489,80900,40203
7248,3278,3970,800,176500,40204
10542,7740,2802,775,247100,40205
9557,4769,4788,740,178500,40206
13810,9564,4246,947,275300,40207
6049,1387,4662,728,79000,40208
212,73,139,746,92400,40209
5609,2109,3500,552,62800,40210
8939,3796,5143,688,68300,40211
6604,2844,3760,732,62000,40212
6889,4294,2595,735,108100,40213
17989,9263,8726,700,123400,40214
8124,3616,4508,746,76200,40215
17113,10993,6120,664,108800,40216
5835,3672,2163,738,133100,40217
13631,6675,6956,726,124100,40218
15717,8654,7063,688,122300,40219
14511,9002,5509,850,163600,40220
9863,5742,4121,892,246500,40222
9266,6692,2574,952,246400,40223
6332,5381,951,744,149100,40228
13989,10696,3293,918,121100,40229
0,0,0,-,-,40231
12509,8636,3873,1077,240100,40241
4638,3192,1446,973,183500,40242
4562,3168,1394,997,197300,40243
11773,9896,1877,1126,317000,40245
10634,7955,2679,817,117800,40258
14004,10687,3317,863,116900,40272
129,33,96,948,354200,40280
14320,10744,3576,883,167100,40291
15413,12090,3323,882,188300,40299
238,163,75,642,69200,40310
2843,2103,740,550,87900,40311
2231,1495,736,537,80600,40312
1143,609,534,631,83800,40313
158,158,0,-,68900,40316
1196,889,307,521,77200,40322
16637,11468,5169,793,166600,40324
441,387,54,670,129600,40328
7873,5512,2361,588,132900,40330
44,44,0,-,-,40334
5036,3490,1546,555,77700,40336
1927,1570,357,591,93800,40337
0,0,0,-,-,40339
8391,6304,2087,730,136200,40342
283,248,35,645,70000,40346
1013,722,291,859,176900,40347
253,111,142,614,93200,40348
41,41,0,-,103100,40350
7353,4615,2738,614,123400,40351
8237,4968,3269,657,122200,40353
15815,9986,5829,812,161200,40356
282,239,43,-,55000,40358
2554,1730,824,582,96300,40359
2383,1704,679,587,77100,40360
7362,4516,2846,675,141200,40361
0,0,0,-,-,40363
988,828,160,552,204600,40370
1234,920,314,603,73200,40371
895,692,203,713,149400,40372
687,497,190,574,77500,40374
15,15,0,-,-,40376
1345,891,454,713,138900,40379
2492,1744,748,614,83800,40380
8971,6323,2648,738,187600,40383
1071,769,302,744,95500,40385
901,741,160,492,81200,40387
2295,1252,1043,668,148800,40390
14037,8940,5097,696,137600,40391
1055,739,316,589,89600,40402
9334,6435,2899,668,128800,40403
0,0,0,-,-,40404
1409,964,445,567,69100,40409
1654,1336,318,456,84800,40419
9094,5653,3441,650,146500,40422
90,26,64,-,-,40434
1970,1609,361,538,85500,40437
807,568,239,716,87500,40440
653,417,236,492,79100,40442
5700,4313,1387,648,133400,40444
371,302,69,458,70900,40445
3355,2380,975,516,72700,40447
37,16,21,-,-,40448
3701,2836,865,461,87500,40456
381,302,79,-,48100,40460
1247,886,361,714,134400,40461
504,468,36,733,91600,40464
789,526,263,566,102000,40468
634,459,175,623,50400,40472
22192,12356,9836,648,157000,40475
86,69,17,-,-,40481
4588,3173,1415,603,99500,40484
995,856,139,334,103300,40486
1422,1169,253,742,74300,40489
12241,6842,5399,816,310100,40502
12357,7793,4564,865,170100,40503
11013,3934,7079,645,135000,40504
11173,6360,4813,658,111100,40505
0,0,0,-,-,40506
1222,167,1055,603,237500,40507
9552,2022,7530,689,112000,40508
15222,8975,6247,912,219700,40509
342,273,69,874,380800,40510
12169,7489,4680,823,143700,40511
4129,3277,852,1127,328000,40513
5844,4925,919,1145,189200,40514
14156,9061,5095,935,205200,40515
1206,859,347,959,164400,40516
16241,6036,10205,788,130100,40517
21245,13315,7930,697,139100,40601
0,0,0,-,-,40604
11711,7698,4013,557,99700,40701
2101,1566,535,645,77600,40729
1288,956,332,604,69000,40734
359,244,115,-,-,40737
1155,828,327,569,92000,40740
8876,5782,3094,601,109900,40741
42,42,0,-,-,40743
6976,5194,1782,692,106500,40744
1059,898,161,666,65700,40759
228,165,63,507,33500,40763
6101,3776,2325,564,66500,40769
564,363,201,564,53200,40771
203,152,51,-,49700,40801
1029,683,346,619,55400,40806
169,145,24,725,53100,40807
18,18,0,-,110000,40808
565,429,136,-,43600,40810
259,216,43,-,50900,40813
545,420,125,820,43200,40815
5,0,5,-,-,40816
33,26,7,-,-,40818
282,266,16,-,64800,40819
254,207,47,-,24600,40820
1747,1064,683,411,46100,40823
177,120,57,561,45300,40824
289,224,65,531,48200,40826
322,222,100,-,47600,40827
1306,934,372,484,50700,40828
142,88,54,-,-,40829
109,99,10,-,44100,40830
2230,1340,890,392,72200,40831
90,72,18,-,68300,40840
100,89,11,-,69600,40843
42,19,23,-,-,40844
247,237,10,-,39400,40845
112,106,6,-,35500,40847
133,96,37,-,48000,40849
447,258,189,445,58900,40854
337,236,101,546,55000,40855
300,256,44,-,48800,40856
122,122,0,-,54800,40858
209,202,7,-,55300,40862
246,204,42,-,24500,40863
148,109,39,528,101400,40865
334,264,70,329,46800,40868
179,149,30,-,131700,40870
896,666,230,619,57300,40873
181,136,45,-,-,40874
446,347,99,609,32300,40902
239,205,34,525,75200,40903
4324,2591,1733,593,76700,40906
111,47,64,488,60300,40913
134,74,60,503,56400,40914
285,252,33,-,90000,40915
127,87,40,-,105200,40921
235,140,95,429,54400,40923
97,78,19,-,51000,40927
1124,891,233,668,63300,40935
143,99,44,-,52600,40939
215,188,27,-,44300,40940
165,58,107,501,-,40941
292,236,56,791,84200,40943
91,80,11,-,-,40946
359,249,110,605,109700,40949
277,188,89,475,83200,40953
160,102,58,-,-,40958
6539,4853,1686,470,55400,40962
14,0,14,-,-,40964
5370,3065,2305,532,75300,40965
477,349,128,607,36800,40972
3753,2667,1086,348,53800,40977
49,42,7,-,41600,40979
162,125,37,-,27700,40982
157,122,35,-,101500,40983
215,118,97,570,28800,40988
56,56,0,-,30700,40995
144,118,26,571,-,40997
6120,5348,772,809,169500,41001
926,686,240,558,105100,41002
982,697,285,671,94900,41003
1745,1272,473,568,94400,41004
8358,6201,2157,930,174000,41005
1588,1239,349,587,112900,41006
1474,1270,204,633,186300,41007
2660,1468,1192,610,123700,41008
1372,1164,208,653,105300,41010
11621,4871,6750,679,161500,41011
2982,1315,1667,723,83200,41014
8302,5631,2671,703,113200,41015
2508,1566,942,778,104000,41016
15176,11113,4063,750,186300,41017
10104,6554,3550,851,114500,41018
2113,1323,790,783,127700,41030
6079,4154,1925,572,124600,41031
620,583,37,-,131100,41033
386,299,87,556,107000,41034
3627,2641,986,650,123400,41035
1095,782,313,513,80000,41039
2837,2084,753,596,91800,41040
2994,2008,986,477,105400,41041
20641,13006,7635,865,147100,41042
663,565,98,659,147800,41043
368,309,59,692,103000,41044
619,416,203,766,113000,41045
409,320,89,706,89800,41046
4815,3906,909,1165,211800,41048
847,645,202,667,91200,41049
9621,7989,1632,998,162500,41051
37,37,0,-,-,41052
673,543,130,617,131700,41055
5621,3536,2085,545,100000,41056
931,788,143,627,163200,41059
6,6,0,-,-,41062
1159,1000,159,675,164700,41063
822,606,216,505,103300,41064
8564,4041,4523,697,115000,41071
2574,1734,840,802,116700,41073
2034,1185,849,775,90400,41074
6649,4566,2083,765,201700,41075
7270,5458,1812,934,164600,41076
724,618,106,944,206500,41080
540,389,151,650,97600,41083
306,152,154,852,81000,41085
1048,858,190,731,108300,41086
6135,5499,636,1697,241900,41091
1208,1055,153,833,163000,41092
1034,868,166,506,59400,41093
5003,3675,1328,935,186600,41094
1188,645,543,660,107800,41095
2329,1616,713,751,117900,41097
637,532,105,714,87100,41098
0,0,0,-,-,41099
8033,4881,3152,627,91700,41101
7810,5834,1976,650,107000,41102
568,550,18,-,109100,41121
499,359,140,438,80100,41124
3991,3123,868,581,115900,41129
161,149,12,-,44100,41132
64,49,15,-,-,41135
3356,2272,1084,700,91500,41139
781,657,124,633,59600,41141
45,33,12,-,-,41142
5591,4177,1414,560,89800,41143
3900,3149,751,625,90700,41144
158,66,92,663,-,41146
248,192,56,243,48800,41149
166,114,52,300,41300,41159
5206,4195,1011,573,75200,41164
490,366,124,623,81400,41166
1076,994,82,589,80600,41168
2275,1672,603,575,131800,41169
1440,1082,358,446,72800,41171
421,235,186,447,82700,41174
2031,1610,421,668,89100,41175
3106,2135,971,346,61300,41179
457,389,68,561,54100,41180
612,538,74,595,95900,41183
876,716,160,701,68000,41189
64,51,13,-,-,41201
302,224,78,-,76400,41203
157,132,25,-,57100,41204
226,205,21,-,43100,41214
415,301,114,528,73800,41216
749,634,115,578,57700,41219
948,800,148,731,65000,41222
2089,1486,603,435,93500,41224
107,107,0,-,91500,41226
4567,3487,1080,504,84200,41230
399,199,200,688,71900,41231
313,250,63,664,67600,41232
182,182,0,-,-,41234
253,237,16,-,85000,41238
2839,1742,1097,531,97000,41240
415,313,102,369,48200,41250
156,151,5,-,113800,41254
436,311,125,507,109700,41255
891,758,133,672,77600,41256
173,157,16,-,62300,41257
367,166,201,394,117900,41260
415,340,75,-,104200,41262
204,95,109,-,-,41263
114,94,20,-,119400,41264
668,545,123,809,81000,41265
306,210,96,376,56700,41267
211,201,10,-,60600,41268
108,108,0,-,-,41271
236,140,96,279,-,41274
2358,1490,868,484,58300,41301
2705,1994,711,456,65900,41311
1782,1300,482,354,64000,41314
50,50,0,-,21400,41317
511,372,139,480,74400,41332
4325,3172,1153,472,50300,41339
497,417,80,-,34900,41348
319,254,65,474,83800,41352
173,135,38,-,53100,41360
211,138,73,478,69100,41365
5,5,0,-,-,41366
59,37,22,-,-,41367
147,128,19,-,72500,41385
5,5,0,-,-,41390
11,11,0,-,-,41397
148,107,41,624,81800,41408
155,72,83,-,"10,000-",41421
484,381,103,518,80700,41425
255,180,75,-,37500,41464
4547,3248,1299,526,58800,41465
3688,2644,1044,528,76300,41472
9724,5977,3747,658,106900,41501
266,173,93,607,98000,41503
327,222,105,638,106800,41512
193,161,32,-,69700,41513
1287,757,530,679,72500,41514
32,32,0,-,-,41517
566,470,96,615,93100,41519
2078,1777,301,472,57000,41522
75,67,8,-,34800,41524
28,28,0,-,-,41526
314,206,108,647,134800,41527
385,286,99,-,69500,41528
405,368,37,860,71200,41531
131,118,13,-,26600,41534
207,170,37,-,105700,41535
2082,1578,504,464,63100,41537
35,26,9,-,105900,41538
634,510,124,660,68100,41539
109,84,25,-,52600,41540
174,126,48,-,125900,41543
356,291,65,570,64300,41544
118,76,42,-,-,41547
351,240,111,-,71700,41548
880,790,90,-,60800,41553
415,346,69,571,66600,41554
337,248,89,-,83300,41555
745,638,107,589,80000,41557
301,257,44,-,31300,41558
129,110,19,-,38500,41559
137,101,36,-,42100,41560
1124,834,290,585,61500,41562
184,143,41,-,44200,41563
430,361,69,475,91200,41564
308,291,17,-,46400,41566
98,90,8,-,41800,41567
373,299,74,-,28400,41568
195,166,29,675,31100,41571
1530,1212,318,661,71200,41572
352,283,69,641,70200,41601
210,173,37,-,69600,41602
528,447,81,824,58800,41603
184,160,24,-,65000,41604
239,229,10,-,78100,41605
341,275,66,-,35900,41606
246,211,35,577,-,41607
30,22,8,-,27700,41612
295,224,71,-,50000,41615
293,226,67,753,67600,41616
182,156,26,-,89100,41619
153,88,65,-,96200,41621
106,67,39,-,113500,41622
538,397,141,684,69300,41630
579,449,130,474,82300,41631
225,151,74,-,51600,41632
1164,772,392,634,112400,41635
351,269,82,-,33000,41636
406,317,89,722,55200,41640
326,175,151,575,85800,41642
23,21,2,-,-,41643
624,431,193,510,43000,41645
558,372,186,557,68800,41647
958,622,336,422,70300,41649
206,159,47,-,44400,41650
4551,2797,1754,478,92300,41653
432,335,97,-,61700,41655
117,117,0,-,58900,41659
233,208,25,-,78200,41660
170,129,41,-,22400,41663
351,173,178,706,46800,41666
254,208,46,-,41400,41667
241,159,82,442,39100,41669
6975,4893,2082,566,76500,41701
124,117,7,-,-,41712
47,47,0,-,-,41713
110,110,0,-,48200,41714
402,357,45,-,72300,41719
199,180,19,570,32200,41721
598,480,118,647,63600,41722
586,530,56,-,60400,41723
76,63,13,-,54200,41725
289,253,36,-,83100,41727
45,0,45,-,-,41729
443,349,94,465,49400,41731
65,28,37,618,26300,41735
23,14,9,-,-,41739
370,292,78,457,65300,41740
119,109,10,-,-,41745
209,168,41,-,82000,41746
1344,1047,297,445,38900,41749
138,138,0,-,59100,41751
82,67,15,-,42300,41754
87,69,18,-,-,41759
4,4,0,-,-,41760
24,24,0,-,-,41762
229,141,88,541,82200,41763
332,300,32,-,53800,41764
48,48,0,-,-,41766
74,53,21,-,-,41772
577,476,101,613,45300,41773
927,672,255,-,71800,41774
30,21,9,-,-,41775
444,344,100,489,46600,41776
424,298,126,558,41300,41777
320,284,36,469,-,41804
224,204,20,-,93100,41810
149,139,10,-,-,41812
332,280,52,-,53000,41815
85,55,30,-,-,41817
97,46,51,-,45500,41819
324,293,31,-,41900,41821
864,652,212,268,48800,41822
502,336,166,530,51000,41824
228,142,86,-,49500,41825
396,328,68,-,58100,41826
335,291,44,-,56400,41828
420,358,62,551,74200,41831
82,82,0,-,-,41832
169,96,73,-,44000,41833
221,221,0,-,70500,41834
362,247,115,809,70500,41835
322,189,133,591,52600,41836
472,364,108,678,71100,41837
188,159,29,-,45100,41838
555,366,189,534,46900,41839
430,273,157,571,52700,41840
285,247,38,-,41100,41843
413,273,140,330,38300,41844
99,62,37,-,-,41845
239,239,0,-,30300,41847
0,0,0,-,-,41848
19,19,0,-,-,41849
263,177,86,-,81100,41855
3524,2489,1035,554,59200,41858
156,120,36,-,70900,41859
27,23,4,-,-,41861
347,307,40,393,54300,41862
12513,8143,4370,671,144300,42001
12130,7760,4370,602,108300,42003
916,859,57,-,124400,42020
654,474,180,632,65200,42021
73,73,0,-,273400,42022
993,780,213,609,79600,42023
612,461,151,494,97500,42024
8015,6272,1743,590,118900,42025
906,812,94,606,129200,42027
311,271,40,-,82600,42028
2376,1804,572,602,106000,42029
1098,837,261,531,59300,42031
91,74,17,725,53300,42032
359,322,37,663,86500,42035
589,570,19,-,78400,42036
30,22,8,-,-,42037
2083,1570,513,471,125900,42038
700,619,81,307,91700,42039
410,366,44,812,146700,42040
2047,1341,706,496,69600,42041
1332,1156,176,718,136900,42044
876,579,297,652,94800,42045
109,109,0,-,134900,42047
893,663,230,934,64300,42048
657,538,119,487,113600,42049
1221,741,480,379,48400,42050
1165,1011,154,572,88700,42051
1950,1761,189,711,120500,42053
272,262,10,-,130400,42054
1086,1022,64,498,123000,42055
830,628,202,596,113500,42056
931,739,192,846,97000,42058
26,10,16,-,-,42060
30,30,0,-,-,42061
3326,2630,696,517,79000,42064
9199,6143,3056,589,92000,42066
244,217,27,-,80700,42069
11943,6630,5313,587,126700,42071
534,452,82,473,92000,42076
686,519,167,370,73100,42078
510,448,62,845,123300,42079
919,662,257,477,77600,42081
656,501,155,567,155200,42082
144,98,46,-,111500,42083
75,24,51,605,-,42084
329,281,48,-,73300,42085
1777,1276,501,588,136800,42086
859,723,136,788,96000,42087
974,789,185,730,79600,42088
21312,10239,11073,683,112000,42101
56,45,11,-,-,42102
8067,5545,2522,730,194500,42103
13032,7621,5411,736,167700,42104
1031,682,349,545,72900,42120
1576,1429,147,792,171300,42122
308,246,62,533,83300,42123
0,0,0,-,-,42124
2485,1650,835,548,95500,42127
2727,2008,719,463,80100,42129
84,48,36,744,-,42130
662,528,134,565,86300,42133
6690,4102,2588,679,119500,42134
432,325,107,513,63000,42140
12274,8069,4205,615,112400,42141
104,90,14,-,46200,42151
116,65,51,745,-,42153
257,191,66,620,107700,42154
74,59,15,-,129200,42156
134,104,30,558,85000,42157
467,404,63,389,119800,42159
565,447,118,789,69100,42160
46,10,36,-,-,42163
6290,4425,1865,620,103100,42164
926,845,81,364,76500,42166
3325,2384,941,551,74700,42167
482,428,54,708,110900,42170
2721,2076,645,688,111800,42171
901,606,295,675,90700,42202
197,138,59,839,118600,42204
2113,1592,521,634,111300,42206
571,469,102,567,83800,42207
1637,1286,351,561,83200,42210
5545,4467,1078,563,118200,42211
198,163,35,577,119900,42214
435,378,57,664,112500,42215
1325,1004,321,674,84100,42217
2461,1942,519,567,87700,42220
4327,16,4311,1183,-,42223
263,239,24,-,113500,42232
990,567,423,603,105000,42234
303,272,31,725,104300,42236
16506,8874,7632,659,116100,42240
94,69,25,717,74100,42254
1811,1511,300,611,81800,42256
409,374,35,661,80400,42259
4301,3104,1197,576,94400,42261
3212,876,2336,894,96000,42262
396,333,63,702,67800,42265
818,568,250,545,120000,42266
226,198,28,750,107500,42273
975,688,287,577,144600,42274
286,182,104,753,72100,42275
5959,3762,2197,583,94100,42276
129,97,32,-,-,42280
191,161,30,-,77800,42285
456,284,172,766,114800,42286
17842,11221,6621,669,117800,42301
15683,10547,5136,657,117300,42303
3179,2186,993,510,87800,42320
93,83,10,-,51900,42321
12,12,0,-,-,42322
338,275,63,763,92900,42323
430,379,51,-,72600,42324
810,679,131,399,82200,42325
177,170,7,-,88400,42326
1494,1207,287,450,112500,42327
544,471,73,608,80800,42328
3342,2459,883,517,74500,42330
44,38,6,-,-,42332
393,304,89,284,94500,42333
749,629,120,551,62000,42337
37,37,0,-,-,42338
311,274,37,425,75700,42339
707,530,177,461,73700,42343
426,324,102,-,44100,42344
4117,3242,875,527,105600,42345
2355,1889,466,451,93800,42347
1954,1540,414,532,119000,42348
492,438,54,-,56100,42349
551,453,98,495,77800,42350
1469,1159,310,601,101200,42351
881,677,204,609,85400,42352
91,66,25,490,60000,42354
781,696,85,714,108300,42355
0,0,0,-,-,42356
191,141,50,-,81500,42361
2119,1905,214,768,145200,42366
286,227,59,620,74300,42367
401,371,30,-,89900,42368
94,64,30,538,36000,42369
0,0,0,-,-,42370
224,214,10,-,129400,42371
696,574,122,473,100200,42372
127,111,16,495,154500,42374
2282,1850,432,638,99500,42376
1047,869,178,598,122600,42378
1030,747,283,523,69900,42404
1338,1054,284,550,92600,42406
2698,2007,691,463,61900,42408
982,748,234,553,77600,42409
580,327,253,649,49400,42410
668,526,142,447,90500,42411
1236,1087,149,822,138900,42413
15970,9279,6691,621,116200,42420
10567,7072,3495,634,104200,42431
420,340,80,-,115600,42436
3108,2253,855,611,94700,42437
343,275,68,715,53100,42440
649,511,138,585,95900,42441
1190,930,260,516,83700,42442
4587,3174,1413,542,96800,42445
1654,1083,571,495,62600,42450
325,208,117,-,60900,42451
824,653,171,590,130400,42452
194,147,47,830,-,42453
1137,736,401,650,95400,42455
569,468,101,435,90300,42456
402,313,89,-,107600,42458
1655,1148,507,480,69700,42459
516,327,189,499,52100,42461
392,307,85,772,99800,42462
40,37,3,-,29400,42463
784,682,102,529,73800,42464
7416,4457,2959,575,90200,42501
9190,6502,2688,654,139300,42503
172,142,30,-,-,42516
1118,974,144,639,82300,42518
1397,1133,264,577,56000,42519
574,435,139,439,86600,42528
306,172,134,696,87800,42533
4051,3158,893,512,77500,42539
273,258,15,-,-,42541
2353,1845,508,637,96700,42544
1859,1410,449,471,120100,42553
213,155,58,-,56000,42565
222,214,8,-,74400,42566
2447,1739,708,670,67800,42567
3845,2763,1082,534,66300,42602
13,13,0,-,-,42603
2101,1507,594,522,91500,42629
35,35,0,-,-,42631
7546,5268,2278,487,80500,42633
479,374,105,511,58300,42634
1296,893,403,509,70100,42635
83,0,83,-,-,42638
5024,3779,1245,525,84900,42642
1534,1166,368,638,57300,42647
1050,728,322,643,74800,42649
1687,1122,565,665,57600,42653
19850,12564,7286,751,161600,42701
631,538,93,705,114100,42712
667,545,122,722,83100,42713
116,116,0,-,80000,42715
585,516,69,738,115700,42716
2736,1960,776,386,82700,42717
9707,6165,3542,593,103300,42718
1283,1019,264,476,87900,42721
197,189,8,-,101300,42722
1746,1408,338,756,154800,42724
1917,1469,448,519,103000,42726
6107,4511,1596,493,88800,42728
669,455,214,777,109000,42729
57,57,0,-,-,42731
708,593,115,753,90600,42732
444,370,74,449,90800,42733
726,653,73,911,141600,42740
198,164,34,717,66300,42741
3808,2910,898,528,76200,42743
790,659,131,498,73000,42746
3444,2395,1049,667,110200,42748
2054,1334,720,474,83700,42749
283,252,31,-,63300,42753
5897,4112,1785,520,104500,42754
1173,895,278,683,86600,42757
20,12,8,-,-,42758
123,52,71,-,-,42762
230,157,73,468,75200,42764
2425,1692,733,430,83100,42765
1003,759,244,597,115200,42776
390,350,40,568,74900,42782
942,666,276,653,91700,42784
81,81,0,-,166800,42788
1110,981,129,1447,189300,43001
1653,1420,233,1280,155600,43002
1066,803,263,725,120200,43003
9461,6843,2618,888,159300,43004
54,34,20,-,84500,43005
234,200,34,800,90000,43006
1033,674,359,745,85500,43008
734,643,91,1104,180300,43009
128,82,46,775,83700,43010
2852,2381,471,670,176800,43011
458,416,42,548,135600,43013
1337,886,451,586,120900,43014
19281,13351,5930,874,177700,43015
14317,7789,6528,1119,256000,43016
14550,10320,4230,1142,319600,43017
3242,2555,687,714,125400,43019
3870,3654,216,1134,361200,43021
1104,880,224,686,205800,43022
3931,3397,534,932,271700,43023
2119,1582,537,611,164700,43025
22349,16233,6116,943,188400,43026
3120,2720,400,927,140400,43028
209,143,66,845,158200,43029
0,0,0,-,-,43030
4856,3934,922,769,188600,43031
55,20,35,-,-,43032
151,94,57,648,95600,43033
8636,6931,1705,1025,277000,43035
105,55,50,654,80500,43036
125,64,61,530,101900,43037
11414,8228,3186,857,172000,43040
1909,1514,395,765,128400,43044
646,539,107,921,159600,43045
1418,1081,337,749,168100,43046
11305,7011,4294,701,121300,43050
8885,6459,2426,1270,312700,43054
24616,14853,9763,710,123600,43055
7080,5163,1917,856,137200,43056
962,737,225,754,117700,43060
1565,1387,178,1027,208300,43061
10241,8088,2153,1046,172700,43062
4945,4164,781,706,227400,43064
14275,12727,1548,1002,313200,43065
573,512,61,1189,193800,43066
516,494,22,-,125000,43067
21428,12083,9345,892,135500,43068
40,40,0,-,65600,43070
768,618,150,845,139800,43071
2179,1823,356,667,122700,43072
4299,3595,704,1057,232400,43074
3533,2806,727,853,150800,43076
130,87,43,729,95000,43077
8339,5599,2740,663,123000,43078
1897,1484,413,625,129700,43080
23839,15033,8806,1019,179500,43081
11387,10218,1169,1170,286100,43082
271,234,37,741,116400,43084
10215,7291,2924,1050,227500,43085
116,84,32,575,85000,43101
1656,1231,425,785,158200,43102
3939,3093,846,758,158300,43103
2905,2324,581,917,177300,43105
653,414,239,712,81100,43106
1240,954,286,892,120200,43107
49,37,12,1104,92800,43109
13569,8656,4913,910,158600,43110
144,119,25,-,71200,43111
1546,1308,238,751,230300,43112
9069,6029,3040,736,144200,43113
534,413,121,550,121100,43115
516,465,51,1102,175900,43116
37,37,0,-,-,43117
10064,6954,3110,864,137900,43119
23367,16650,6717,906,151500,43123
5545,3339,2206,917,133300,43125
170,115,55,784,111000,43126
54,54,0,-,104500,43127
886,556,330,677,89000,43128
23237,14795,8442,750,134900,43130
1654,1260,394,564,123700,43135
234,147,87,872,187500,43136
743,603,140,774,126100,43137
7496,5192,2304,560,111700,43138
7548,4883,2665,773,147600,43140
59,31,28,710,63000,43142
2092,1515,577,662,122400,43143
155,108,47,517,46000,43144
640,480,160,817,106700,43145
3160,2748,412,962,168500,43146
13790,11458,2332,1052,191400,43147
838,577,261,715,150500,43148
1019,841,178,642,131000,43149
691,545,146,803,138300,43150
85,65,20,840,85500,43151
311,188,123,611,81600,43152
321,271,50,810,147500,43153
1077,783,294,774,138600,43154
937,774,163,863,141300,43155
69,62,7,544,83300,43156
194,114,80,833,86000,43157
94,94,0,-,59300,43158
9177,5363,3814,690,108900,43160
2555,1936,619,722,134400,43162
664,458,206,890,126500,43164
11484,1930,9554,892,211300,43201
9689,3069,6620,866,186600,43202
3434,949,2485,646,90100,43203
16007,7429,8578,868,98100,43204
5169,1818,3351,685,107400,43205
9734,4634,5100,883,103100,43206
17370,9667,7703,828,84900,43207
11553,6555,4998,800,210700,43209
325,0,325,599,-,43210
8155,3030,5125,773,55800,43211
10026,3934,6092,898,280900,43212
14215,4797,9418,787,97200,43213
12336,7666,4670,864,217800,43214
8615,1858,6757,962,257600,43215
733,23,710,863,28400,43217
11075,5072,6003,816,85700,43219
11876,6531,5345,897,275900,43220
13288,9707,3581,1026,245100,43221
1325,464,861,732,50200,43222
8430,3979,4451,747,80900,43223
16764,7634,9130,694,84600,43224
9177,4425,4752,808,78800,43227
21314,9680,11634,792,110500,43228
20509,8159,12350,775,118800,43229
22842,14363,8479,1035,170800,43230
7918,4192,3726,873,129500,43231
17736,7192,10544,744,92600,43232
17739,9580,8159,985,219100,43235
1812,747,1065,1094,193600,43240
19884,12897,6987,690,86800,43302
1201,1026,175,748,119000,43310
7815,5085,2730,744,124600,43311
1152,1028,124,836,145400,43314
2638,2085,553,699,127800,43315
2333,1800,533,610,121200,43316
43,37,6,-,69300,43317
1659,1192,467,686,133800,43318
410,410,0,-,158300,43319
630,455,175,596,116000,43320
87,70,17,813,96700,43321
135,102,33,663,77800,43322
296,220,76,780,113900,43323
1170,1005,165,829,156500,43324
5131,3742,1389,590,92700,43326
61,37,24,558,66400,43330
2210,1778,432,697,87100,43331
728,506,222,811,93300,43332
290,258,32,-,114200,43333
2377,1907,470,763,142400,43334
0,0,0,-,-,43336
430,407,23,907,118200,43337
3652,2902,750,547,141800,43338
638,518,120,750,117700,43340
448,353,95,858,100200,43341
1219,1035,184,833,123200,43342
442,299,143,517,121100,43343
2168,1684,484,695,128400,43344
294,249,45,717,118400,43345
583,486,97,635,117800,43347
788,520,268,534,86700,43348
4354,2900,1454,618,111600,43351
525,446,79,784,137500,43356
1616,1291,325,580,152800,43357
1028,857,171,739,118000,43358
331,268,63,625,102300,43359
659,530,129,734,183600,43360
13491,6422,7069,671,167600,43402
0,0,0,-,-,43403
709,504,205,858,91800,43406
252,251,1,-,110600,43407
137,132,5,688,79600,43408
4057,3054,1003,695,110700,43410
1861,1502,359,695,157500,43412
546,484,62,810,105900,43413
1080,809,271,581,134500,43416
12397,8718,3679,637,107500,43420
1844,1453,391,693,118500,43430
1711,1330,381,712,112400,43431
504,487,17,-,155200,43432
17,17,0,-,-,43433
23,19,4,-,68300,43434
560,499,61,577,114600,43435
197,134,63,803,97000,43437
89,83,6,-,289700,43438
20,20,0,-,62500,43439
2452,2026,426,742,174000,43440
474,352,122,824,104800,43442
713,593,120,682,149500,43443
414,403,11,-,147800,43445
53,53,0,-,256300,43446
1409,1273,136,692,133100,43447
3282,2579,703,707,129600,43449
1331,1080,251,917,152300,43450
405,313,92,758,142900,43451
6137,4476,1661,683,152100,43452
223,175,48,625,434100,43456
514,394,120,580,98500,43457
158,131,27,725,104900,43458
2687,1947,740,670,131200,43460
476,349,127,821,97300,43462
8,8,0,-,-,43463
396,305,91,623,119400,43464
2453,1774,679,717,99100,43465
887,686,201,769,111200,43466
28,20,8,-,65000,43467
106,88,18,-,93200,43468
1161,885,276,728,143500,43469
317,223,94,638,95000,43501
2423,1811,612,632,136800,43502
506,463,43,742,154900,43504
40,27,13,705,79400,43505
6122,4389,1733,656,102500,43506
379,330,49,1262,126900,43511
11376,8317,3059,696,109600,43512
3304,2823,481,606,135500,43515
1164,933,231,769,96600,43516
1553,1296,257,625,107600,43517
1088,921,167,731,100400,43518
89,63,26,-,63200,43519
1192,872,320,574,78900,43521
1214,1099,115,707,145600,43522
0,0,0,-,-,43523
443,342,101,581,95900,43524
458,400,58,1214,161200,43525
2285,1735,550,562,103500,43526
796,664,132,720,91000,43527
6128,4598,1530,871,171200,43528
99,77,22,736,55900,43529
94,35,59,-,-,43531
1588,1404,184,759,133900,43532
616,523,93,638,131700,43533
665,560,105,627,89500,43534
330,307,23,736,114900,43535
160,153,7,-,125700,43536
11048,8078,2970,778,163700,43537
541,423,118,537,123200,43540
65,60,5,-,80000,43541
1206,1101,105,-,258200,43542
3196,2449,747,627,86100,43543
5687,4215,1472,689,120500,43545
91,91,0,-,181900,43547
281,258,23,540,102600,43548
517,401,116,593,111300,43549
15235,10348,4887,872,186200,43551
62,44,18,-,70000,43553
1112,759,353,728,94800,43554
81,71,10,-,114600,43555
689,559,130,663,108300,43556
917,781,136,628,110900,43557
5061,4387,674,724,141700,43558
12170,9565,2605,798,179700,43560
172,124,48,831,127800,43565
2818,2292,526,963,184500,43566
5000,3541,1459,704,128600,43567
1125,933,192,687,97200,43569
1208,884,324,603,92400,43570
2644,2258,386,742,194900,43571
4171,536,3635,343,29600,43604
10203,4690,5513,629,42200,43605
10145,5345,4800,693,118300,43606
9310,4579,4731,662,55400,43607
5128,3037,2091,728,41700,43608
8992,4148,4844,631,47800,43609
1778,921,857,648,52500,43610
7908,5150,2758,630,83500,43611
12066,6697,5369,685,67200,43612
13700,8856,4844,716,90700,43613
14192,8039,6153,663,112400,43614
17924,9702,8222,733,98200,43615
8369,5820,2549,618,131900,43616
2629,2224,405,863,192000,43617
3021,2387,634,781,117600,43619
2605,640,1965,513,77900,43620
9390,5608,3782,653,115400,43623
22884,14234,8650,637,106600,43701
24,0,24,-,-,43711
2935,2271,664,516,98500,43713
748,657,91,631,107200,43716
82,62,20,575,75000,43717
1268,1074,194,603,98000,43718
1003,785,218,575,101000,43719
552,433,119,732,103900,43720
0,0,0,-,-,43721
155,135,20,-,55800,43722
1923,1119,804,586,77900,43723
2669,2162,507,612,84800,43724
8439,5818,2621,589,102900,43725
468,406,62,-,93100,43727
430,281,149,554,57300,43728
877,794,83,539,82500,43730
2145,1476,669,499,74800,43731
678,563,115,380,110500,43732
0,0,0,-,-,43733
610,454,156,727,91400,43734
200,109,91,642,74800,43735
25,22,3,-,55000,43736
41,22,19,616,81700,43738
864,745,119,685,153400,43739
113,86,27,805,108800,43740
507,417,90,805,163500,43746
338,268,70,921,77100,43747
929,696,233,566,87400,43748
1030,856,174,796,89900,43749
80,80,0,-,72000,43750
647,461,186,517,147500,43754
605,509,96,948,106500,43755
2228,1489,739,532,93300,43756
1236,972,264,598,89500,43758
30,22,8,570,55000,43759
785,675,110,629,157900,43760
23,23,0,-,-,43761
1798,1343,455,683,143100,43762
3180,2008,1172,581,87900,43764
630,466,164,632,70000,43766
467,406,61,1091,144300,43767
138,96,42,900,86300,43768
654,571,83,805,83700,43771
732,606,126,731,71900,43772
1271,1059,212,581,101900,43773
1762,1342,420,472,73300,43777
419,367,52,607,111600,43778
447,404,43,-,92100,43779
746,654,92,650,126600,43780
249,166,83,682,47200,43782
1788,1481,307,590,154100,43783
17,14,3,-,37500,43786
1054,909,145,516,98900,43787
328,254,74,475,102300,43788
2323,1683,640,585,80900,43793
378,328,50,-,88400,43802
929,724,205,520,167900,43804
16,16,0,-,-,43805
339,240,99,550,84200,43811
7829,5315,2514,552,89900,43812
1543,1259,284,673,107900,43821
1711,1331,380,726,116000,43822
1260,1032,228,659,123200,43824
2478,1839,639,621,157100,43830
2767,2064,703,701,93500,43832
66,58,8,538,66800,43836
678,562,116,650,99800,43837
463,383,80,850,134700,43840
114,99,15,-,-,43842
519,484,35,-,151100,43843
1421,1153,268,603,112100,43844
1878,1495,383,608,88800,43845
945,774,171,826,83000,43901
10,10,0,-,-,43902
843,705,138,486,97100,43903
90,59,31,-,-,43905
3582,2345,1237,529,82700,43906
2334,1850,484,580,87600,43907
559,456,103,708,69500,43908
1238,1099,139,769,102800,43910
2874,1968,906,488,80100,43912
726,417,309,481,66700,43913
36,36,0,-,104500,43914
586,512,74,767,106800,43915
1263,1162,101,563,76900,43917
9187,6019,3168,581,80300,43920
119,54,65,-,-,43925
108,68,40,507,-,43926
57,48,9,-,62400,43927
0,0,0,-,-,43928
360,262,98,680,85000,43930
99,76,23,-,111100,43931
300,260,40,602,56200,43932
831,661,170,544,84700,43933
178,156,22,-,79600,43934
3801,2616,1185,467,78500,43935
2268,1878,390,552,69600,43938
198,176,22,1094,67800,43939
98,90,8,-,-,43940
1164,919,245,514,87100,43942
1318,1049,269,720,86300,43943
989,788,201,673,101100,43944
1168,876,292,566,90500,43945
781,598,183,539,99100,43946
2270,1708,562,609,91700,43947
220,190,30,-,64000,43948
5642,4352,1290,701,143900,43950
38,38,0,-,85200,43951
7421,4121,3300,578,82300,43952
4818,3235,1583,709,114800,43953
161,92,69,625,47500,43961
29,27,2,-,68800,43962
545,331,214,611,79900,43963
3929,2854,1075,621,89700,43964
0,0,0,-,-,43967
2845,1889,956,515,80500,43968
23,23,0,-,-,43970
550,310,240,549,77400,43971
52,52,0,-,-,43972
873,653,220,587,85600,43973
28,26,2,-,64300,43974
684,589,95,695,89500,43976
924,665,259,714,74800,43977
246,166,80,863,60000,43983
50,37,13,1125,77500,43985
797,609,188,657,84400,43986
990,797,193,618,82700,43988
8140,6879,1261,842,145700,44001
1893,1522,371,551,87700,44003
13653,8135,5518,641,87600,44004
558,407,151,607,156900,44010
7798,6309,1489,1156,262100,44011
9060,7219,1841,1122,225600,44012
7247,4919,2328,753,128900,44017
2223,1716,507,778,167300,44021
6826,5704,1122,1299,340400,44022
6418,5743,675,1264,282700,44023
9198,7712,1486,722,207800,44024
4401,4117,284,961,220800,44026
3310,2948,362,982,186200,44028
6118,4377,1741,612,95100,44030
730,690,40,841,105000,44032
26874,16275,10599,725,101500,44035
12279,10677,1602,1067,160400,44039
1166,1121,45,1354,403600,44040
5991,4542,1449,634,112500,44041
4249,3638,611,898,166300,44044
147,75,72,871,123500,44045
718,670,48,883,177800,44046
3303,2653,650,598,124300,44047
930,709,221,823,103200,44048
106,81,25,721,92700,44049
2476,2062,414,736,168900,44050
11640,6173,5467,661,76400,44052
7493,5118,2375,649,131000,44053
4915,3756,1159,929,123500,44054
7529,4071,3458,664,67300,44055
4537,4189,348,1202,189800,44056
7446,5596,1850,866,127500,44057
25187,20776,4411,905,165300,44060
4037,2929,1108,647,168400,44062
648,596,52,1036,172600,44064
1654,1283,371,865,216100,44065
8225,6660,1565,973,184300,44067
13137,9627,3510,869,146500,44070
1825,1643,182,929,267500,44072
3920,2624,1296,769,164700,44074
1658,1121,537,676,123700,44076
21854,15394,6460,805,157700,44077
35,25,10,-,-,44080
2495,2186,309,910,167500,44081
506,429,77,649,153000,44082
1221,1083,138,838,141100,44084
1278,1129,149,816,118600,44085
971,850,121,863,178100,44086
8207,5847,2360,1018,206800,44087
6658,4899,1759,850,138200,44089
4361,3143,1218,746,162200,44090
7624,5462,2162,798,122800,44092
477,446,31,850,110500,44093
16319,10337,5982,862,174800,44094
14157,10458,3699,784,120300,44095
715,700,15,-,160000,44099
0,0,0,-,-,44101
18704,6074,12630,670,59400,44102
6982,2173,4809,567,51800,44103
9105,2503,6602,449,49800,44104
15347,7491,7856,669,49200,44105
10961,3238,7723,706,148400,44106
24581,11074,13507,717,134000,44107
9463,4296,5167,665,56600,44108
17343,8020,9323,675,73500,44109
8953,3164,5789,611,52400,44110
17121,9846,7275,694,83000,44111
10120,3935,6185,607,61700,44112
9185,2378,6807,779,156700,44113
3515,283,3232,745,78000,44114
3402,254,3148,505,86400,44115
8929,6483,2446,834,215500,44116
4869,1979,2890,644,90800,44117
15571,9208,6363,900,144100,44118
5257,3095,2162,749,76600,44119
15905,6883,9022,711,95200,44120
13514,9039,4475,858,97700,44121
13473,8761,4712,1109,220600,44122
7695,4183,3512,725,75900,44123
17222,11390,5832,886,148800,44124
11630,8057,3573,857,77500,44125
7288,5326,1962,706,145500,44126
2029,758,1271,636,29200,44127
12707,6666,6041,796,69200,44128
11698,8242,3456,779,100600,44129
21903,13866,8037,759,124600,44130
8158,7708,450,1064,174000,44131
6648,3055,3593,800,81400,44132
12745,8997,3748,820,192800,44133
15895,12320,3575,801,106600,44134
11928,7444,4484,700,77100,44135
10403,7511,2892,843,194600,44136
9375,5958,3417,841,71700,44137
8808,6892,1916,938,153700,44138
8711,7323,1388,1196,272800,44139
6045,5509,536,976,215100,44140
5460,4632,828,1452,255500,44141
7611,5841,1770,850,111800,44142
10849,7673,3176,788,180100,44143
9568,5713,3855,686,91300,44144
13775,10354,3421,1066,236400,44145
13267,7404,5863,756,101200,44146
7594,6154,1440,843,218100,44147
7213,6657,556,1095,192700,44149
2577,2000,577,756,169100,44201
7952,6549,1403,1423,227600,44202
16240,11425,4815,710,103000,44203
17085,13455,3630,836,165200,44212
791,634,157,582,172200,44214
939,752,187,793,137900,44215
3522,3213,309,754,147100,44216
1526,1222,304,765,119600,44217
13267,7312,5955,797,108800,44221
7426,5715,1711,795,147600,44223
15940,10959,4981,925,168900,44224
3404,2923,481,702,134900,44230
3468,3003,465,716,134300,44231
2882,2832,50,-,298300,44233
1398,1158,240,760,183500,44234
562,487,75,-,172900,44235
8956,7815,1141,1775,302700,44236
15868,7980,7888,789,146100,44240
6803,4677,2126,958,140500,44241
0,0,0,-,-,44243
402,347,55,-,118500,44250
377,312,65,1082,219600,44251
1120,1049,71,945,188700,44253
1950,1378,572,575,134300,44254
3082,2420,662,810,144800,44255
23362,18417,4945,877,198300,44256
5002,4068,934,816,147200,44260
2066,1513,553,620,160300,44262
1120,880,240,1045,225700,44264
0,0,0,-,-,44265
13125,9065,4060,719,120500,44266
3257,2311,946,694,119600,44270
1865,1439,426,885,155800,44272
2772,2462,310,763,169700,44273
126,98,28,-,182100,44274
1211,1017,194,721,166100,44275
682,546,136,944,152200,44276
6928,5481,1447,734,155700,44278
1717,1524,193,956,238300,44280
11850,8767,3083,817,174400,44281
23,23,0,-,-,44285
2344,2158,186,888,300300,44286
2600,2129,471,708,115400,44287
1367,785,582,736,101100,44288
6287,3652,2635,794,79100,44301
2517,961,1556,543,87600,44302
3563,2066,1497,687,146400,44303
1448,179,1269,689,72800,44304
9590,5378,4212,675,71700,44305
8958,4228,4730,680,63400,44306
3286,1009,2277,564,63000,44307
325,10,315,530,-,44308
9931,4269,5662,695,67200,44310
3012,631,2381,643,48800,44311
13250,9742,3508,803,97300,44312
11789,6963,4826,781,144700,44313
8295,4263,4032,697,62900,44314
9595,7267,2328,784,139400,44319
8718,4740,3978,680,77300,44320
5795,4239,1556,1003,208600,44321
7487,5797,1690,1186,231000,44333
1139,979,160,837,157200,44401
1171,930,241,585,122500,44402
1711,1528,183,717,107800,44403
698,573,125,558,108600,44404
3332,2258,1074,633,61500,44405
8522,7133,1389,707,173700,44406
4461,3244,1217,659,148800,44408
7519,6019,1500,726,130200,44410
778,633,145,870,140500,44411
1024,801,223,599,157800,44412
3000,2285,715,675,90900,44413
669,538,131,664,137800,44417
543,456,87,525,162300,44418
6802,4650,2152,615,94500,44420
942,700,242,629,141400,44423
6415,5085,1330,638,96400,44425
638,504,134,770,106400,44427
1198,1050,148,522,109200,44428
1111,781,330,782,120900,44429
1383,1068,315,715,77500,44430
1819,1427,392,719,97600,44431
4382,3301,1081,637,102900,44432
1425,1169,256,605,100600,44436
1722,1360,362,716,89700,44437
1780,1139,641,655,67100,44438
48,17,31,-,153800,44439
1947,1522,425,565,126600,44440
613,544,69,674,123900,44441
1647,1337,310,540,115600,44442
670,579,91,754,148000,44443
4430,3071,1359,686,104500,44444
1380,1179,201,557,122600,44445
8885,5069,3816,649,78600,44446
414,344,70,634,141200,44449
684,557,127,667,103900,44450
1312,1020,292,726,151600,44451
1225,917,308,777,178100,44452
401,301,100,-,125600,44454
625,597,28,629,109100,44455
10725,7515,3210,640,115800,44460
1494,1333,161,730,141600,44470
4317,3142,1175,614,73500,44471
1512,1273,239,853,115700,44473
4401,3662,739,585,112700,44481
11290,7136,4154,620,86300,44483
9698,6529,3169,653,116900,44484
6888,3591,3297,620,50600,44485
369,207,162,675,75500,44490
992,917,75,758,150900,44491
16,16,0,-,-,44493
4015,2332,1683,697,30900,44502
474,0,474,230,-,44503
1958,942,1016,714,64600,44504
7374,4403,2971,531,73000,44505
939,607,332,563,14800,44506
1933,836,1097,631,20000,44507
5225,3115,2110,633,46500,44509
1049,384,665,609,15300,44510
8426,6061,2365,642,81700,44511
14857,9741,5116,637,112800,44512
9447,7640,1807,784,140800,44514
12059,7360,4699,613,97300,44515
13508,8671,4837,656,94800,44601
2132,1654,478,596,155600,44606
54,46,8,-,77000,44607
1002,783,219,644,113400,44608
1590,1292,298,635,120700,44609
70,61,9,-,219400,44610
776,647,129,602,119100,44611
2065,1571,494,754,140200,44612
811,555,256,672,89500,44613
5004,3870,1134,751,146100,44614
4109,3127,982,610,113600,44615
2225,1692,533,695,159400,44618
604,488,116,635,139300,44620
1849,1142,707,596,88600,44621
7457,5284,2173,744,126800,44622
1454,1240,214,495,196600,44624
642,394,248,766,151700,44625
1168,976,192,792,114000,44626
1695,1387,308,458,222200,44627
396,348,48,815,117000,44628
918,735,183,679,108900,44629
3480,2717,763,743,160200,44632
854,663,191,783,156100,44633
811,671,140,718,150300,44634
1123,789,334,625,116100,44637
540,411,129,634,162900,44638
71,52,19,845,90000,44640
7960,6138,1822,714,139200,44641
1195,991,204,787,118000,44643
1847,1454,393,582,121200,44644
819,663,156,849,151300,44645
18710,12779,5931,701,128100,44646
7487,5720,1767,708,105800,44647
215,158,57,588,116700,44651
18,18,0,-,-,44652
231,131,100,675,81800,44653
5820,4219,1601,579,185500,44654
1244,991,253,632,89700,44656
3885,2908,977,646,114600,44657
52,37,15,660,91700,44659
82,61,21,613,63000,44661
3552,2954,598,676,116700,44662
10217,6642,3575,690,117700,44663
1117,962,155,722,154400,44666
5380,3787,1593,715,129400,44667
530,487,43,753,139600,44669
108,86,22,-,87700,44670
125,86,39,-,74000,44671
2048,1143,905,740,79400,44672
930,831,99,908,116800,44675
1744,1424,320,626,125300,44676
912,642,270,738,136600,44677
52,41,11,-,-,44678
1798,1303,495,796,144600,44680
2401,1815,586,611,168700,44681
384,275,109,494,87900,44682
3317,2191,1126,638,75000,44683
10368,8442,1926,788,168500,44685
10,0,10,-,-,44687
1207,917,290,600,102600,44688
202,158,44,664,112100,44689
65,45,20,-,164400,44690
17837,11730,6107,682,139600,44691
26,26,0,-,76000,44693
661,557,104,448,110200,44695
116,100,16,660,233300,44697
319,244,75,575,108000,44699
576,15,561,302,-,44702
3678,1437,2241,608,58600,44703
1515,805,710,491,57300,44704
7360,4050,3310,609,68200,44705
7215,5099,2116,691,93900,44706
3790,1860,1930,472,75100,44707
10737,7202,3535,798,116300,44708
8405,4826,3579,642,111800,44709
4282,2358,1924,701,73200,44710
3852,2512,1340,691,91700,44714
5097,3369,1728,694,227500,44718
16095,11736,4359,803,159800,44720
5433,4599,834,777,152600,44721
2360,1984,376,763,109100,44730
346,284,62,567,122700,44802
447,361,86,600,110900,44804
12723,8503,4220,685,115900,44805
931,682,249,712,87900,44807
161,144,17,-,109500,44809
4828,3751,1077,624,114200,44811
3178,2491,687,753,122900,44813
1006,887,119,735,153700,44814
267,199,68,604,76600,44815
37,37,0,-,-,44816
601,540,61,708,118500,44817
928,746,182,581,85400,44818
7418,5109,2309,639,91700,44820
1088,911,177,593,124900,44822
1520,1310,210,670,145300,44824
18,17,1,-,73000,44825
644,556,88,642,134900,44826
2786,1917,869,593,81700,44827
24,24,0,-,-,44828
7621,5533,2088,580,75000,44830
7106,5107,1999,623,83500,44833
959,676,283,717,96200,44836
1621,1269,352,611,119600,44837
92,78,14,713,89000,44838
5198,4070,1128,770,177700,44839
1084,864,220,727,142700,44840
247,184,63,679,91000,44841
2149,1493,656,609,108300,44842
911,670,241,667,140100,44843
231,175,56,775,87700,44844
1110,862,248,912,161700,44846
1480,1143,337,691,126500,44847
895,686,209,743,97000,44849
19,19,0,-,-,44850
1747,1306,441,705,99500,44851
498,412,86,580,138100,44853
618,449,169,627,87700,44854
421,352,69,860,111100,44855
86,80,6,-,74300,44856
9228,6215,3013,625,127200,44857
505,405,100,681,143300,44859
33,28,5,-,67500,44861
1537,1225,312,617,129100,44864
1294,955,339,649,86600,44865
809,648,161,739,143100,44866
897,761,136,633,131600,44867
17358,10789,6569,660,104200,44870
124,97,27,625,85800,44874
5803,3961,1842,681,98600,44875
1094,891,203,677,108600,44878
1014,911,103,1147,143300,44880
11,11,0,-,-,44881
1243,1014,229,703,105400,44882
10930,7646,3284,660,102200,44883
363,331,32,630,96200,44887
2792,2285,507,808,159600,44889
4229,2798,1431,593,100400,44890
0,0,0,-,-,44901
1704,825,879,499,44200,44902
9930,6984,2946,656,113100,44903
5643,3960,1683,681,145900,44904
4513,3137,1376,665,78300,44905
7145,4423,2722,645,85300,44906
6466,3843,2623,579,88200,44907
229,88,141,696,70000,45001
5010,3675,1335,780,203400,45002
260,178,82,808,95200,45003
11994,8189,3805,773,128300,45005
23416,16647,6769,803,173800,45011
20587,14896,5691,773,140000,45013
17363,10895,6468,846,145600,45014
4712,3052,1660,807,88600,45015
7216,5953,1263,726,144500,45030
129,98,31,684,100700,45032
119,69,50,1292,59000,45033
460,410,50,1083,206000,45034
12153,8603,3550,826,192400,45036
8569,6786,1783,1142,186900,45039
19341,15320,4021,1165,239300,45040
20,0,20,-,-,45041
10340,7607,2733,846,130300,45042
19269,11397,7872,756,141300,45044
3245,2388,857,1007,160700,45050
0,0,0,-,-,45051
1572,1336,236,645,228300,45052
1214,1165,49,599,250600,45053
1044,995,49,818,225000,45054
8061,3894,4167,783,189700,45056
277,179,98,777,105200,45062
999,921,78,792,137900,45064
1847,1346,501,826,200000,45065
8456,7470,986,940,224400,45066
5109,3492,1617,937,131500,45067
4215,3430,785,796,212800,45068
18257,14520,3737,1115,202700,45069
78,61,17,719,66100,45070
1018,573,445,530,82900,45101
8648,6112,2536,792,148100,45102
12128,8598,3530,748,156000,45103
4522,3430,1092,636,131500,45106
3426,2549,877,751,126600,45107
121,117,4,-,170500,45111
19,15,4,-,85000,45112
1345,1071,274,796,162000,45113
57,50,7,-,-,45115
1389,1108,281,790,147400,45118
1250,842,408,603,111400,45120
3557,2378,1179,531,117000,45121
3957,3160,797,915,126200,45122
3442,2236,1206,619,94000,45123
1490,1277,213,628,114600,45130
114,86,28,826,80000,45131
102,71,31,573,66800,45132
9337,6519,2818,690,105300,45133
1766,1230,536,581,114100,45135
19784,15508,4276,999,223000,45140
1395,1058,337,721,107400,45142
1916,1299,617,519,87700,45144
11,11,0,-,-,45145
501,331,170,858,114900,45146
33,24,9,-,145000,45147
497,386,111,874,89500,45148
12598,9155,3443,757,169000,45150
4099,3463,636,960,193100,45152
646,579,67,850,143100,45153
3287,2622,665,724,115700,45154
102,79,23,755,75000,45155
33,22,11,-,-,45156
3506,2901,605,686,158400,45157
143,86,57,700,88000,45158
1259,855,404,737,110200,45159
401,125,276,504,105700,45160
981,771,210,714,174000,45162
102,69,33,811,66000,45164
19,19,0,-,82700,45166
1457,968,489,629,93400,45167
596,457,139,642,102500,45168
1733,1135,598,637,88000,45169
2384,1955,429,776,124300,45171
48,39,9,-,77500,45172
793,735,58,1771,496700,45174
3190,2342,848,668,133400,45176
8958,5467,3491,685,134900,45177
7539,1871,5668,880,323600,45202
1454,222,1232,268,166700,45203
2593,841,1752,664,64300,45204
7095,2407,4688,643,69700,45205
5908,1681,4227,605,180200,45206
2292,951,1341,666,76800,45207
9096,5548,3548,896,329400,45208
5700,2163,3537,742,217400,45209
16085,7581,8504,682,100900,45211
10170,4898,5272,686,121900,45212
5301,3108,2193,625,144600,45213
3507,624,2883,559,57600,45214
12325,6995,5330,807,137000,45215
4138,1846,2292,683,80300,45216
2937,1582,1355,668,92700,45217
1487,1036,451,857,115000,45218
5897,1178,4719,787,107500,45219
6354,1846,4508,703,241600,45220
5717,2270,3447,648,105200,45223
8917,5438,3479,663,109700,45224
3741,657,3084,444,58600,45225
2536,1436,1100,788,272700,45226
8364,4068,4296,781,123400,45227
5839,1740,4099,528,116000,45229
11562,8325,3237,680,160400,45230
16250,10594,5656,777,100800,45231
2476,477,1999,378,77000,45232
5774,4911,863,621,194000,45233
11093,6778,4315,877,138900,45236
8968,3851,5117,703,96100,45237
18862,10815,8047,611,117300,45238
11604,7158,4446,734,113300,45239
10223,6507,3716,879,118100,45240
9604,7140,2464,914,207400,45241
8857,7005,1852,1106,273800,45242
5491,4871,620,1159,343600,45243
10305,8079,2226,852,228700,45244
8215,5613,2602,832,167400,45245
5989,3065,2924,888,132400,45246
9163,7271,1892,814,191500,45247
9771,8284,1487,802,138400,45248
5448,3450,1998,1136,316600,45249
8420,5963,2457,884,111100,45251
1855,1753,102,1244,198000,45252
8513,6251,2262,950,185600,45255
36,14,22,-,-,45301
1365,1148,217,722,168000,45302
881,656,225,642,88500,45303
2747,2122,625,646,119100,45304
4141,3377,764,921,196600,45305
924,744,180,658,143100,45306
120,84,36,829,81700,45307
1634,1344,290,640,110700,45308
5358,4003,1355,768,141400,45309
111,108,3,-,107500,45310
2246,1870,376,800,122200,45311
537,483,54,1027,173400,45312
1456,1014,442,661,187600,45314
1696,1445,251,640,163100,45315
40,29,11,1021,118800,45316
315,253,62,674,134400,45317
2148,1600,548,684,139700,45318
147,102,45,753,123300,45319
6104,4261,1843,689,115100,45320
325,245,80,689,91800,45321
8758,6916,1842,757,110700,45322
2308,1810,498,698,122800,45323
16912,8415,8497,782,112800,45324
955,852,103,818,140400,45325
358,311,47,909,132500,45326
3629,2781,848,863,156200,45327
221,149,72,753,76300,45328
348,256,92,721,92700,45330
9749,6302,3447,624,107300,45331
327,226,101,719,109500,45332
467,407,60,783,154500,45333
825,600,225,695,104600,45334
2539,1961,578,823,141800,45335
53,42,11,1097,125000,45336
626,541,85,826,172200,45337
1947,1634,313,740,135200,45338
551,424,127,743,115900,45339
260,245,15,-,148300,45340
1554,1240,314,712,75500,45341
15302,9596,5706,839,136500,45342
6104,4693,1411,777,101100,45344
2450,1544,906,678,92100,45345
831,682,149,790,91500,45346
1792,1318,474,653,105200,45347
332,255,77,840,116500,45348
132,81,51,817,101300,45349
30,26,4,-,92500,45350
94,86,8,700,133900,45351
87,58,29,642,61300,45352
76,53,23,694,-,45353
217,178,39,677,94800,45354
10190,6644,3546,675,92000,45356
134,106,28,590,93500,45358
709,581,128,592,128500,45359
161,107,54,655,81900,45360
116,76,40,775,87700,45361
513,452,61,536,111800,45362
593,523,70,765,172900,45363
11748,7442,4306,705,122100,45365
1906,1404,502,574,114100,45368
1284,1024,260,766,154000,45369
905,844,61,819,232300,45370
7653,5802,1851,748,169400,45371
150,92,58,691,83500,45372
14165,9119,5046,743,144100,45373
6460,4229,2231,650,138400,45377
126,114,12,638,71300,45378
1799,1471,328,589,149500,45380
2084,1661,423,733,125800,45381
431,327,104,771,94300,45382
2933,2264,669,819,121000,45383
71,63,8,-,113500,45384
15458,10912,4546,677,125500,45385
2443,1799,644,780,224100,45387
255,247,8,-,141800,45388
208,146,62,869,73900,45389
1308,837,471,482,78100,45390
4605,1551,3054,560,60200,45402
6032,2877,3155,700,55000,45403
4093,1906,2187,625,58400,45404
7948,3106,4842,651,59800,45405
9050,4731,4319,611,60900,45406
3078,1727,1351,797,152000,45409
6874,3207,3667,663,68400,45410
8908,5470,3438,689,106800,45414
5281,3495,1786,736,121000,45415
2168,1412,756,923,64800,45416
12596,6356,6240,630,52300,45417
675,539,136,713,113500,45418
6647,4571,2076,711,154500,45419
11550,6349,5201,677,83900,45420
19210,13514,5696,888,111300,45424
6854,3014,3840,696,81100,45426
0,0,0,-,-,45428
11560,7863,3697,820,139400,45429
2761,2339,422,1060,170200,45430
11663,5654,6009,1019,127200,45431
6444,4821,1623,767,115900,45432
648,0,648,1247,-,45433
4404,3994,410,1139,192100,45434
4100,2212,1888,819,81300,45439
9122,6072,3050,848,164400,45440
8252,4643,3609,767,100600,45449
12540,9379,3161,869,218400,45458
12476,8802,3674,891,190100,45459
5944,5191,753,699,150000,45502
14354,8445,5909,708,108400,45503
6700,4375,2325,770,111300,45504
8179,4177,4002,612,69800,45505
5407,2825,2582,683,71200,45506
20648,14035,6613,700,113700,45601
2083,1550,533,576,81900,45612
1043,788,255,683,96200,45613
1854,1478,376,620,101500,45614
583,486,97,548,66600,45616
85,60,25,-,-,45617
5,5,0,-,-,45618
2895,2135,760,750,102500,45619
474,384,90,-,82900,45620
137,94,43,720,54700,45621
74,74,0,-,125000,45622
1149,875,274,584,106800,45623
0,0,0,-,-,45624
1880,1430,450,623,122100,45628
1043,771,272,617,86500,45629
37,37,0,-,47100,45630
5994,4348,1646,659,106600,45631
732,544,188,676,76300,45634
55,55,0,-,82800,45636
8046,5723,2323,590,86400,45638
6579,4192,2387,750,97200,45640
0,0,0,-,-,45642
1763,1467,296,773,123000,45644
1303,1228,75,-,82400,45645
100,85,15,-,-,45646
902,743,159,547,79700,45647
4527,3590,937,592,103800,45648
150,103,47,-,65000,45650
2206,1607,599,585,91100,45651
1337,1066,271,540,110100,45652
1783,1500,283,716,120000,45653
317,301,16,-,90200,45654
2455,1670,785,634,86600,45656
804,494,310,853,84400,45657
813,592,221,678,108800,45658
964,664,300,671,88500,45659
3004,2109,895,661,99100,45660
2808,2071,737,570,91500,45661
12133,6534,5599,551,76900,45662
2375,1787,588,509,80100,45663
3919,3089,830,779,133100,45669
162,103,59,1045,-,45671
547,455,92,915,108100,45672
173,96,77,673,76100,45673
123,83,40,621,117200,45674
480,428,52,-,93800,45678
914,669,245,644,108900,45679
4885,3225,1660,642,118000,45680
583,538,45,746,101700,45681
888,697,191,525,83700,45682
884,698,186,599,99300,45684
347,222,125,515,127500,45685
1312,1045,267,668,81300,45686
231,171,60,1053,63900,45688
5850,3750,2100,673,110100,45690
3324,2304,1020,558,82300,45692
3311,1984,1327,540,105900,45693
4565,3565,1000,630,135900,45694
241,223,18,588,55800,45695
519,449,70,-,147700,45696
1834,1536,298,584,114400,45697
194,142,52,569,90300,45698
10975,4926,6049,756,152000,45701
2187,1631,556,627,125800,45710
427,365,62,675,111300,45711
4251,3125,1126,598,106500,45714
890,663,227,559,108100,45715
167,132,35,517,82900,45716
470,248,222,636,49600,45719
22,22,0,-,-,45721
1308,1120,188,781,90600,45723
723,679,44,-,117800,45724
194,126,68,494,78500,45727
452,386,66,873,134300,45729
1727,1209,518,660,82500,45732
236,174,62,728,65000,45734
701,614,87,639,133800,45735
175,123,52,693,62600,45740
402,340,62,461,65200,45741
1245,1036,209,677,142300,45742
544,503,41,591,116900,45743
1054,880,174,670,99900,45744
527,436,91,470,109900,45745
222,173,49,383,54500,45746
11341,7568,3773,655,119200,45750
1474,1021,453,560,56000,45760
714,572,142,762,82000,45761
3200,1842,1358,660,81600,45764
474,432,42,-,120500,45766
1111,808,303,418,96600,45767
763,660,103,456,118200,45768
2611,1940,671,541,95800,45769
179,159,20,-,57300,45770
1425,1095,330,631,88000,45771
783,661,122,-,85900,45772
103,71,32,-,119900,45773
463,361,102,830,129000,45775
280,192,88,624,81700,45776
306,262,44,938,108500,45778
244,191,53,581,85200,45779
1275,594,681,691,95000,45780
159,114,45,540,44000,45782
1143,1000,143,469,125000,45784
1401,1222,179,576,107800,45786
8,8,0,-,-,45787
497,492,5,-,116800,45788
53,53,0,-,-,45789
8471,4916,3555,645,77900,45801
5990,3030,2960,588,58800,45804
9324,5564,3760,749,108600,45805
4336,3472,864,761,123200,45806
4747,3775,972,648,135500,45807
158,106,52,754,70000,45808
57,48,9,-,70000,45809
2788,1725,1063,702,104900,45810
746,548,198,608,62800,45812
1447,1114,333,588,98000,45813
1138,888,250,769,141400,45814
145,117,28,629,97800,45816
2582,1941,641,640,150100,45817
118,74,44,864,81400,45819
177,159,18,675,81300,45820
563,513,50,774,93700,45821
8139,5875,2264,666,133500,45822
148,111,37,570,152700,45826
700,660,40,631,145400,45827
2398,1832,566,553,136000,45828
2225,1855,370,728,118900,45830
1274,1085,189,668,107300,45831
1088,969,119,614,108700,45832
4267,3267,1000,697,111600,45833
262,243,19,-,118800,45835
547,457,90,627,85100,45836
18,18,0,-,-,45838
23719,15375,8344,718,137700,45840
318,254,64,760,155200,45841
1430,1164,266,661,101900,45843
1262,1117,145,677,160200,45844
1023,917,106,581,176800,45845
1406,1190,216,580,142500,45846
478,403,75,832,83900,45849
1277,1106,171,639,150200,45850
262,211,51,563,105400,45851
498,387,111,680,176200,45853
170,128,42,806,86100,45854
67,60,7,708,90000,45855
1951,1520,431,698,116500,45856
1202,978,224,703,132000,45858
173,119,54,608,61100,45859
827,745,82,580,172900,45860
63,51,12,-,75000,45861
572,457,115,688,87700,45862
438,357,81,681,89200,45863
73,66,7,825,97000,45864
1850,1556,294,637,164100,45865
84,54,30,713,75000,45866
370,307,63,700,111800,45867
233,215,18,938,109100,45868
1782,1475,307,598,166500,45869
62,46,16,-,74500,45870
724,530,194,704,147200,45871
1596,1090,506,590,83200,45872
869,690,179,682,82700,45873
877,703,174,598,82100,45874
4408,3314,1094,635,163400,45875
313,259,54,594,154700,45876
869,681,188,683,141400,45877
2477,1757,720,593,88400,45879
1037,824,213,582,84200,45880
527,435,92,907,126000,45881
1087,860,227,685,102500,45882
1323,1004,319,713,174800,45883
62,19,43,-,-,45884
5246,3737,1509,677,132400,45885
214,165,49,558,59000,45886
1702,1355,347,732,98300,45887
68,54,14,1063,76700,45888
434,433,1,-,165300,45889
217,194,23,759,92100,45890
6181,4383,1798,633,103700,45891
270,218,52,535,96200,45894
7079,5376,1703,611,125900,45895
813,734,79,975,114800,45896
27,27,0,-,-,45897
482,438,44,635,73300,45898
88,79,9,-,61600,45899
4130,3117,1013,690,87800,46001
7005,5460,1545,844,98900,46011
7826,5341,2485,742,97600,46012
8037,5441,2596,725,81000,46013
7426,3306,4120,651,40200,46016
2381,1928,453,691,91000,46017
1173,959,214,696,132000,46030
941,803,138,890,161500,46031
18195,12452,5743,1096,284600,46032
13214,12021,1193,1159,307100,46033
2730,2376,354,784,163400,46034
402,320,82,746,86000,46035
4589,3090,1499,705,78200,46036
13584,11446,2138,1215,270500,46037
16214,12018,4196,1110,183200,46038
220,203,17,-,105400,46039
4020,3261,759,753,183800,46040
8426,5901,2525,669,94100,46041
1130,891,239,707,97300,46044
39,39,0,-,-,46045
39,0,39,-,-,46047
741,619,122,965,97500,46048
323,263,60,638,89300,46049
759,650,109,831,108600,46050
1214,927,287,745,116100,46051
9442,6533,2909,714,128100,46052
3807,3514,293,1194,199700,46055
877,758,119,692,119900,46056
449,267,182,680,114600,46057
748,570,178,639,110500,46058
13940,9624,4316,979,171100,46060
12569,9903,2666,896,187700,46062
164,131,33,760,63400,46063
5072,3944,1128,817,150600,46064
1190,967,223,760,153200,46065
1083,970,113,814,122800,46068
2843,2066,777,730,149500,46069
845,700,145,670,97800,46070
1395,1108,287,774,127000,46071
3808,2886,922,708,105500,46072
10120,8135,1985,1176,245300,46074
1629,1268,361,1331,169000,46075
752,582,170,681,87100,46076
9558,7968,1590,1213,345200,46077
63,42,21,1089,92500,46103
385,327,58,684,110300,46104
791,576,215,764,111400,46105
2313,1709,604,932,166500,46106
4933,2992,1941,726,93400,46107
226,174,52,708,155800,46110
132,73,59,743,66200,46111
12655,10105,2550,1050,167000,46112
5434,4226,1208,954,138700,46113
770,585,185,563,130700,46115
246,233,13,-,146200,46117
1896,1576,320,947,160200,46118
2173,1624,549,704,118300,46120
2122,1880,242,683,147100,46121
5686,4096,1590,828,162900,46122
11929,9978,1951,1066,177300,46123
2926,1771,1155,703,99200,46124
23,18,5,-,-,46125
1949,1699,250,902,151000,46126
153,128,25,635,106100,46127
725,610,115,871,120100,46128
924,777,147,725,165200,46130
11448,7736,3712,834,123200,46131
306,241,65,841,87300,46133
6473,4379,2094,703,120200,46135
14809,10384,4425,845,153000,46140
11312,8595,2717,772,161500,46142
19763,12696,7067,892,164500,46143
79,59,20,-,87200,46144
36,27,9,-,62800,46146
1283,1026,257,819,150500,46147
1909,1478,431,666,109000,46148
855,707,148,816,168600,46149
275,222,53,807,103000,46150
11641,8562,3079,757,143700,46151
19,19,0,-,-,46155
672,541,131,684,88100,46156
1364,1168,196,872,148900,46157
8464,6486,1978,768,148200,46158
2254,1811,443,910,147100,46160
1039,810,229,688,135300,46161
210,167,43,-,120300,46162
4236,3911,325,845,194200,46163
1615,1397,218,900,150900,46164
581,504,77,732,180500,46165
662,443,219,739,98100,46166
2124,1932,192,1090,179300,46167
12327,9131,3196,938,161500,46168
655,623,32,-,104800,46171
944,694,250,891,113400,46172
4378,2876,1502,655,92900,46173
260,176,84,741,62300,46175
10820,7050,3770,735,114000,46176
329,264,65,837,201500,46180
1641,1345,296,1255,182600,46181
557,490,67,917,121500,46182
64,64,0,-,-,46183
4516,3892,624,1113,110400,46184
628,500,128,915,146500,46186
12431,5146,7285,727,67500,46201
9168,2125,7043,865,199300,46202
14190,7607,6583,801,76900,46203
3201,504,2697,1023,271400,46204
11424,5196,6228,786,142600,46205
8930,4000,4930,733,110200,46208
9930,4818,5112,819,114900,46214
1256,345,911,860,163200,46216
11752,8731,3021,952,131000,46217
11605,5170,6435,780,57800,46218
15033,8304,6729,781,98200,46219
16534,10280,6254,890,193600,46220
9377,5872,3505,795,97900,46221
11992,5054,6938,769,59700,46222
13611,4537,9074,711,98400,46224
2677,1280,1397,790,65700,46225
17658,8262,9396,771,85600,46226
23415,10266,13149,759,117500,46227
5619,4353,1266,849,145600,46228
10315,6055,4260,824,110200,46229
3462,3124,338,1237,116600,46231
9734,7806,1928,1136,141800,46234
11945,5864,6081,682,99900,46235
10129,8617,1512,1169,171400,46236
15010,10006,5004,880,131100,46237
9559,7893,1666,979,140400,46239
9400,4439,4961,902,205500,46240
11023,6175,4848,768,75100,46241
9102,4082,5020,883,171300,46250
15063,6462,8601,767,112200,46254
10195,7035,3160,822,183900,46256
3663,3503,160,1271,183900,46259
13246,6468,6778,814,171900,46260
10891,5076,5815,857,132600,46268
2789,2404,385,1299,270000,46278
3186,2104,1082,1181,159800,46280
119,119,0,-,508900,46290
341,295,46,858,444100,46301
4968,3865,1103,837,170400,46303
9070,7104,1966,870,172100,46304
22628,18752,3876,950,189500,46307
5054,4264,790,807,147700,46310
7731,7112,619,977,197800,46311
10215,4431,5784,651,75000,46312
6843,4647,2196,826,129500,46319
5250,2186,3064,726,66100,46320
8698,7373,1325,1062,212900,46321
9449,7406,2043,966,153500,46322
8199,5382,2817,869,89700,46323
8368,5261,3107,923,89100,46324
3773,2590,1183,821,80100,46327
349,319,30,-,132500,46340
3659,3119,540,685,161400,46341
11942,9203,2739,832,131100,46342
84,63,21,879,104400,46345
488,307,181,701,68000,46346
1778,1543,235,802,165900,46347
448,376,72,890,113900,46348
1169,925,244,727,157100,46349
17409,12509,4900,673,137100,46350
6178,5279,899,956,176700,46356
17803,11331,6472,719,105700,46360
354,254,100,-,137500,46365
2128,1714,414,570,97800,46366
15264,11059,4205,900,137900,46368
1355,1178,177,770,156600,46371
5209,5043,166,1042,254300,46373
375,325,50,910,152300,46374
9129,7424,1705,933,218200,46375
124,90,34,700,91400,46376
125,76,49,-,88100,46377
81,81,0,-,70600,46379
45,36,9,-,133300,46381
728,716,12,-,152000,46382
15241,10176,5065,855,181000,46383
14337,11948,2389,955,197900,46385
1183,1067,116,969,154000,46390
2068,1819,249,810,172900,46391
2806,2326,480,741,156900,46392
93,83,10,-,116000,46393
4594,2875,1719,798,111200,46394
2627,1034,1593,521,58600,46402
5729,3126,2603,687,99900,46403
6819,4160,2659,731,68900,46404
3929,2823,1106,857,82300,46405
3772,1977,1795,783,53900,46406
4877,1941,2936,650,51000,46407
6149,3598,2551,786,68900,46408
2965,1321,1644,887,57700,46409
15268,9097,6171,921,128400,46410
1325,1001,324,747,98800,46501
89,89,0,-,91300,46502
1381,1102,279,594,116400,46504
3470,2519,951,652,142100,46506
3372,2774,598,748,146000,46507
60,50,10,-,75000,46508
1460,1203,257,686,116200,46510
1559,1174,385,740,132000,46511
15830,10811,5019,757,114000,46514
11740,6517,5223,707,104000,46516
8619,5529,3090,665,116800,46517
773,613,160,804,117000,46524
11429,7454,3975,727,123200,46526
8472,6338,2134,733,146100,46528
10617,9628,989,1182,204500,46530
500,425,75,825,108600,46531
774,669,105,758,108600,46532
4365,3420,945,670,97900,46534
1334,1062,272,756,154800,46536
204,166,38,666,78800,46537
1485,1314,171,775,171600,46538
803,694,109,678,85200,46539
3476,3058,418,827,169000,46540
1495,1086,409,563,117900,46542
1010,835,175,756,225000,46543
12683,8288,4395,707,101400,46544
10895,5237,5658,690,105700,46545
4233,3196,1037,616,161300,46550
2630,2163,467,644,150400,46552
1155,1041,114,548,146400,46553
1984,1555,429,700,137100,46554
1268,867,401,728,154200,46555
253,0,253,642,-,46556
4454,3874,580,912,137400,46561
1909,1467,442,768,117700,46562
8786,6632,2154,661,124200,46563
2308,1919,389,826,246300,46565
3918,3074,844,754,164400,46567
377,311,66,441,124100,46570
1363,1113,250,549,246600,46571
1326,1035,291,666,147300,46573
3384,2948,436,663,110900,46574
8371,6305,2066,719,124700,46580
4814,3679,1135,837,145700,46582
1803,1080,723,812,148800,46590
53,53,0,-,-,46595
2391,522,1869,449,77000,46601
3612,2097,1515,742,47500,46613
12252,8903,3349,610,121000,46614
5790,3668,2122,719,81900,46615
2207,1152,1055,804,76000,46616
3713,2447,1266,873,117000,46617
7583,5316,2267,734,73100,46619
9836,6623,3213,748,105400,46628
2484,2028,456,709,128200,46635
6296,4119,2177,800,123400,46637
3186,2563,623,658,113000,46701
979,841,138,626,108600,46702
6794,4707,2087,705,133400,46703
10,5,5,-,-,46704
634,416,218,436,87300,46705
7580,5811,1769,657,129000,46706
1494,1191,303,626,123700,46710
2431,1749,682,521,120400,46711
5833,4395,1438,567,115000,46714
1741,1398,343,728,95700,46721
3031,2481,550,552,135300,46723
9270,7357,1913,660,135300,46725
469,400,69,620,125800,46730
211,153,58,772,191100,46731
1150,677,473,836,88200,46732
7527,5718,1809,551,111800,46733
3047,2660,387,685,143100,46737
3197,2221,976,701,89800,46738
1385,1049,336,639,105800,46740
1460,1230,230,630,146500,46741
1325,1051,274,636,162500,46742
661,559,102,927,149500,46743
739,621,118,698,160400,46745
1630,1187,443,717,119700,46746
1173,1054,119,756,128900,46747
1840,1669,171,863,163300,46748
10451,7833,2618,659,97600,46750
6090,4251,1839,642,108000,46755
183,172,11,-,95600,46759
515,419,96,900,91800,46760
3816,3068,748,600,145800,46761
792,686,106,624,174100,46763
487,459,28,900,124000,46764
1763,1557,206,939,181400,46765
343,266,77,722,105000,46766
2681,1894,787,649,96900,46767
1097,933,164,676,132900,46770
0,0,0,-,-,46771
774,699,75,713,138400,46772
1254,1069,185,752,110200,46773
6166,4723,1443,782,109300,46774
600,517,83,446,90500,46776
2371,2044,327,646,119100,46777
842,666,176,619,99200,46779
320,310,10,-,114000,46781
2325,2053,272,773,169700,46783
883,695,188,775,145000,46784
492,401,91,666,121600,46785
31,31,0,-,-,46786
1449,1182,267,607,112400,46787
1132,1032,100,726,168900,46788
413,359,54,819,133500,46791
1474,1071,403,874,99800,46792
1504,1243,261,669,109500,46793
634,486,148,643,140900,46794
2406,1973,433,820,160600,46795
1451,1263,188,812,121700,46797
625,568,57,591,119500,46798
93,82,11,800,25500,46799
4599,1502,3097,597,51900,46802
3553,1530,2023,585,39000,46803
11930,8552,3378,798,151000,46804
9004,4974,4030,631,81400,46805
8535,4688,3847,706,48200,46806
6172,3929,2243,725,80900,46807
7993,4694,3299,627,78100,46808
3977,2267,1710,549,83600,46809
4291,3944,347,859,268300,46814
10692,7754,2938,727,115800,46815
7593,3887,3706,578,80700,46816
7596,6468,1128,827,126900,46818
3817,2770,1047,707,100100,46819
12113,7621,4492,782,117200,46825
13926,9982,3944,743,117300,46835
7788,7113,675,1151,203200,46845
16227,10942,5285,633,86300,46901
15461,10143,5318,683,98400,46902
1140,765,375,616,103400,46910
473,385,88,904,96800,46911
448,406,42,595,123700,46913
607,476,131,738,85800,46914
264,209,55,513,113900,46915
724,625,99,647,95800,46917
1045,809,236,635,109800,46919
369,355,14,-,126000,46920
7,7,0,-,-,46922
3145,2489,656,664,113300,46923
629,534,95,824,103000,46926
1723,1366,357,583,89200,46928
1129,829,300,623,106700,46929
32,23,9,675,82500,46930
64,42,22,783,65500,46931
1407,1204,203,735,97400,46932
2587,1747,840,759,79800,46933
2171,1852,319,664,123600,46936
1235,974,261,777,83300,46938
779,647,132,586,72600,46939
1046,855,191,775,92300,46940
391,349,42,638,86100,46941
90,36,54,558,57500,46943
28,14,14,-,-,46946
10604,7641,2963,629,78600,46947
270,245,25,623,88200,46950
734,646,88,610,88100,46951
8313,5621,2692,653,90600,46952
8592,5449,3143,662,67800,46953
248,166,82,520,62500,46957
213,193,20,-,92300,46958
202,161,41,-,-,46959
389,271,118,772,98400,46960
86,59,27,-,-,46961
3639,2447,1192,669,103800,46962
59,38,21,-,60000,46967
55,45,10,-,-,46968
8678,5870,2808,657,80400,46970
604,518,86,820,102300,46974
5760,4519,1241,624,98500,46975
772,684,88,717,92600,46978
1793,1569,224,650,142500,46979
975,790,185,649,98400,46982
101,74,27,-,158900,46984
596,428,168,718,94300,46985
708,604,104,617,93200,46986
316,249,67,631,120600,46987
345,299,46,-,89600,46988
1339,980,359,625,135800,46989
267,267,0,-,124800,46990
697,557,140,692,66200,46991
6804,5107,1697,637,89700,46992
1016,851,165,642,91300,46994
2706,2122,584,643,88800,46996
90,69,21,-,43000,46998
4101,3103,998,723,144800,47001
456,260,196,647,83400,47003
4545,3430,1115,715,174600,47006
131,75,56,-,187500,47010
235,207,28,-,93700,47011
3985,2980,1005,634,135900,47012
365,305,60,800,122700,47016
147,132,15,-,200000,47017
1715,1341,374,712,142200,47018
484,320,164,866,158300,47020
1188,1103,85,774,192000,47022
554,457,97,827,94300,47023
1153,910,243,716,105500,47024
8430,6452,1978,755,161700,47025
630,486,144,606,135300,47030
2075,1665,410,728,133300,47031
1110,998,112,929,129400,47032
48,36,12,580,96000,47034
120,120,0,-,75000,47035
318,283,35,754,173900,47036
1787,1294,493,705,115800,47037
642,422,220,714,146700,47038
2093,1616,477,714,136400,47040
2185,1844,341,685,162100,47041
1617,1211,406,548,119700,47042
2233,1569,664,719,112300,47043
2443,2086,357,635,182100,47060
2771,2105,666,685,86500,47102
17,17,0,-,-,47104
1660,1450,210,809,144600,47106
827,672,155,503,93600,47108
137,137,0,-,144500,47110
5445,4036,1409,724,140300,47111
6449,4746,1703,699,139700,47112
127,85,42,1286,123800,47114
895,729,166,531,109800,47115
277,233,44,-,78100,47116
1542,1448,94,678,120900,47117
1277,1041,236,384,86300,47118
3979,3805,174,1042,239900,47119
344,273,71,831,102000,47120
3603,3193,410,733,197200,47122
45,45,0,-,-,47123
1358,1234,124,1094,187100,47124
602,505,97,869,87300,47125
1515,1240,275,829,135100,47126
8282,4628,3654,755,102000,47129
17590,12303,5287,764,124500,47130
515,466,49,946,128500,47135
1562,1458,104,750,161700,47136
498,424,74,475,100000,47137
1784,1554,230,683,110500,47138
934,723,211,603,94200,47140
566,506,60,718,143900,47141
382,356,26,527,87700,47142
1006,928,78,860,178800,47143
746,635,111,712,95300,47145
386,240,146,744,160500,47147
19398,11977,7421,733,127300,47150
8,8,0,-,78000,47160
1234,1076,158,948,132100,47161
301,205,96,678,87500,47162
762,703,59,523,129800,47163
1538,1115,423,539,107100,47164
2409,1941,468,629,111000,47165
549,515,34,-,129500,47166
5605,4040,1565,628,101600,47167
5365,3737,1628,765,103500,47170
5983,4880,1103,955,162700,47172
403,378,25,-,76600,47175
401,382,19,-,131300,47177
17171,11218,5953,856,128400,47201
10510,7991,2519,778,153900,47203
2007,1458,549,654,130400,47220
525,375,150,695,88800,47223
200,146,54,-,150000,47224
72,51,21,771,70500,47226
754,647,107,672,120000,47227
1133,926,207,655,84800,47229
584,498,86,948,88000,47230
416,356,60,763,105900,47231
1022,874,148,870,129000,47232
566,514,52,685,141100,47234
523,479,44,-,99700,47235
8173,5754,2419,763,124300,47240
1975,1391,584,675,103300,47243
273,221,52,850,108800,47244
1584,1253,331,751,116500,47246
70,59,11,-,85000,47247
9145,6269,2876,705,116100,47250
661,548,113,604,82900,47260
73,54,19,850,90000,47263
514,448,66,685,110600,47264
7863,5582,2281,707,94400,47265
189,183,6,-,91100,47270
867,675,192,804,110300,47272
574,524,50,900,119300,47273
11750,8365,3385,725,124200,47274
312,279,33,-,106000,47280
549,465,84,542,141400,47281
151,112,39,669,95300,47282
1232,907,325,785,108100,47283
11409,7399,4010,641,57200,47302
10378,5288,5090,692,75200,47303
13187,8704,4483,759,116000,47304
1659,617,1042,604,52700,47305
3,0,3,-,-,47306
1659,1307,352,581,88300,47320
66,47,19,825,64200,47324
194,163,31,485,76900,47325
646,572,74,657,93800,47326
1734,1284,450,629,83100,47327
2149,1699,450,825,113200,47330
9099,6255,2844,660,79800,47331
1268,987,281,770,105700,47334
309,231,78,563,72300,47335
1354,1038,316,645,63700,47336
76,64,12,595,72500,47337
1093,861,232,760,83200,47338
251,226,25,-,115300,47339
1147,952,195,656,84000,47340
833,621,212,801,94800,47341
1181,913,268,571,89100,47342
38,27,11,1021,74200,47344
484,374,110,682,127000,47345
1553,1324,229,666,97300,47346
3958,2953,1005,582,66600,47348
127,100,27,645,80600,47351
357,305,52,873,98000,47352
2244,1677,567,750,112300,47353
440,346,94,720,98200,47354
1159,924,235,678,84700,47355
2249,1767,482,671,119800,47356
441,354,87,750,87600,47357
403,340,63,668,93800,47358
1270,909,361,584,75200,47359
499,441,58,499,99700,47360
68,60,8,-,69000,47361
10886,7353,3533,644,86100,47362
12,12,0,-,-,47367
1328,1039,289,656,83400,47368
523,415,108,576,67600,47369
4863,3566,1297,590,87400,47371
971,753,218,541,61600,47373
18521,11602,6919,610,92500,47374
695,532,163,570,79700,47380
53,34,19,475,53300,47381
105,77,28,525,42500,47382
1095,882,213,828,104800,47383
659,565,94,794,85600,47384
626,500,126,744,106600,47385
485,456,29,666,123300,47386
261,208,53,782,90000,47387
125,105,20,625,86100,47388
2091,1455,636,539,62700,47390
540,483,57,773,139100,47393
3307,2442,865,632,80700,47394
2887,2216,671,697,118600,47396
17375,9517,7858,918,213000,47401
13883,8052,5831,814,136100,47403
9155,4662,4493,812,150500,47404
3,3,0,-,-,47405
0,0,0,-,-,47406
9214,3440,5774,842,184300,47408
113,38,75,742,71700,47420
11165,8535,2630,631,108600,47421
3651,3042,609,514,110800,47424
417,319,98,-,88700,47427
3447,2746,701,771,132900,47429
540,483,57,-,98000,47431
1928,1412,516,630,85400,47432
1681,1211,470,711,124500,47433
0,0,0,-,-,47434
540,464,76,618,113500,47436
26,26,0,-,-,47437
1783,1395,388,645,66900,47438
3720,2773,947,526,79600,47441
470,337,133,641,84100,47443
4310,3319,991,565,89500,47446
3057,2294,763,888,183000,47448
140,131,9,525,95000,47449
469,370,99,455,88400,47451
1923,1450,473,572,99600,47452
198,185,13,-,96100,47453
2978,2178,800,572,82200,47454
0,0,0,-,-,47455
522,459,63,713,115800,47456
36,36,0,-,71400,47457
0,0,0,-,-,47458
1437,1175,262,754,123700,47459
4466,3535,931,655,120400,47460
1591,1377,214,646,134000,47462
92,66,26,372,70600,47464
270,231,39,575,94900,47465
36,36,0,-,-,47467
482,448,34,-,244100,47468
676,520,156,543,89800,47469
797,602,195,646,102900,47470
966,776,190,370,87900,47471
6805,4679,2126,639,100100,47501
1541,1078,463,625,57600,47512
913,747,166,521,115300,47513
102,95,7,-,101400,47514
346,326,20,-,123400,47515
457,355,102,410,105700,47516
211,208,3,-,140500,47519
1285,825,460,560,87200,47520
230,214,16,-,162500,47521
120,90,30,625,55200,47522
1303,1057,246,515,110000,47523
139,123,16,633,-,47524
176,151,25,-,139100,47525
722,546,176,819,107400,47527
187,173,14,754,42100,47528
442,319,123,614,73600,47529
358,358,0,-,130400,47531
1772,1445,327,642,142100,47532
206,156,50,-,70900,47535
0,0,0,-,-,47536
353,316,37,675,109700,47537
534,401,133,754,95800,47541
3610,2689,921,550,124000,47542
8368,6401,1967,586,152800,47546
307,297,10,-,136700,47550
308,298,10,-,134500,47551
70,70,0,-,145300,47552
3152,2447,705,567,113100,47553
580,433,147,594,100200,47557
1228,1093,135,643,182300,47558
518,368,150,493,87200,47561
1636,1203,433,534,115900,47562
624,547,77,-,114100,47564
2296,1901,395,550,88200,47567
315,227,88,500,81300,47568
65,65,0,-,-,47574
474,353,121,656,191500,47575
95,62,33,-,86000,47576
468,426,42,510,161800,47577
364,296,68,742,83500,47578
966,796,170,535,172200,47579
95,87,8,-,204500,47580
1631,1391,240,500,89500,47581
77,63,14,625,68100,47584
191,156,35,-,85500,47585
4556,3543,1013,591,100600,47586
279,216,63,578,90000,47588
233,198,35,472,69300,47590
10326,6414,3912,673,94800,47591
45,45,0,-,-,47596
384,317,67,640,93200,47597
1305,1067,238,801,80300,47598
5542,4592,950,657,116700,47601
1981,1511,470,826,105100,47610
524,483,41,475,95900,47611
315,257,58,754,81700,47612
1045,967,78,538,130600,47613
634,457,177,675,80400,47615
112,105,7,-,52500,47616
657,542,115,680,126500,47619
4938,3947,991,660,127900,47620
13412,10582,2830,846,167800,47630
772,647,125,759,131400,47631
1128,917,211,673,134300,47633
889,744,145,655,79900,47634
2255,1653,602,684,113000,47635
495,387,108,716,128300,47637
1539,1374,165,671,158800,47638
1514,1383,131,575,198800,47639
357,329,28,-,86800,47640
1780,1357,423,709,122800,47648
602,536,66,741,89800,47649
19,15,4,575,72500,47654
2068,1532,536,652,86700,47660
1304,1152,152,653,105800,47665
764,683,81,700,72700,47666
4921,3361,1560,643,98300,47670
45,33,12,760,88100,47683
177,69,108,567,245000,47708
7842,4146,3696,621,87800,47710
12860,9651,3209,763,121300,47711
10492,6757,3735,720,125600,47712
4590,1945,2645,639,60400,47713
13443,7783,5660,741,85300,47714
12938,6141,6797,759,130100,47715
7157,5979,1178,806,144800,47720
6034,5542,492,1261,187200,47725
13223,7637,5586,686,113100,47802
8449,5452,2997,826,106400,47803
4586,2718,1868,689,65400,47804
4735,3587,1148,718,101900,47805
4899,1552,3347,624,47300,47807
0,0,0,-,-,47809
378,307,71,675,87900,47832
515,490,25,-,108000,47833
7877,5767,2110,680,99900,47834
14,14,0,-,-,47836
474,379,95,349,92900,47837
688,535,153,709,91800,47838
698,553,145,635,122200,47840
855,685,170,582,88500,47841
4177,3001,1176,538,75900,47842
205,182,23,-,108000,47846
434,362,72,600,83200,47847
734,652,82,555,72700,47848
144,125,19,-,105800,47849
1034,808,226,664,81600,47850
45,18,27,729,83800,47853
315,300,15,-,108800,47854
150,123,27,722,53700,47855
151,128,23,832,66100,47857
245,225,20,-,154500,47858
380,338,42,908,85800,47859
156,133,23,625,34300,47860
252,216,36,625,88400,47861
507,387,120,610,65900,47862
80,51,29,-,-,47863
54,52,2,-,"10,000-",47865
229,229,0,-,85900,47866
1167,903,264,629,94000,47868
37,0,37,-,-,47869
58,48,10,600,73600,47871
2950,2181,769,479,111400,47872
1327,1112,215,594,72800,47874
0,0,0,-,-,47876
1363,992,371,578,68200,47879
26,26,0,-,-,47880
148,104,44,669,63700,47881
3366,2092,1274,668,84800,47882
65,56,9,-,45400,47884
3427,2659,768,657,86100,47885
1992,417,1575,644,144400,47901
6864,3015,3849,754,83900,47904
17102,10432,6670,785,145700,47905
22656,9471,13185,881,185000,47906
0,0,0,-,-,47907
16384,10483,5901,772,123900,47909
19,18,1,-,37500,47916
160,116,44,758,74000,47917
2459,1668,791,607,96100,47918
876,817,59,583,140500,47920
455,344,111,646,63600,47921
555,354,201,645,81800,47922
1415,1129,286,726,121700,47923
48,48,0,-,85000,47924
83,73,10,-,-,47925
417,366,51,688,107700,47926
830,661,169,730,72300,47928
278,243,35,800,101200,47929
479,341,138,581,118800,47930
2152,1692,460,620,110400,47932
10997,7471,3526,635,116000,47933
585,470,115,914,126700,47940
550,389,161,802,111500,47941
305,264,41,721,75600,47942
367,113,254,1017,251600,47943
1405,998,407,660,86700,47944
878,671,207,675,108100,47946
573,371,202,624,79300,47948
597,508,89,755,87500,47949
312,191,121,874,112500,47950
925,579,346,664,89600,47951
1199,989,210,610,87600,47952
921,742,179,772,124600,47954
372,283,89,628,92900,47955
692,521,171,630,93500,47957
82,66,16,600,56100,47958
1042,808,234,654,85600,47959
6283,4857,1426,711,115500,47960
731,550,181,731,104000,47963
67,55,12,565,83100,47964
188,160,28,879,85100,47965
144,140,4,625,42300,47966
280,217,63,844,88100,47967
346,323,23,840,112700,47968
52,37,15,888,57100,47969
828,603,225,775,105000,47970
738,581,157,714,87100,47971
533,398,135,686,83400,47974
292,216,76,675,97100,47975
869,644,225,675,106000,47977
4241,3014,1227,662,135000,47978
421,351,70,710,97400,47980
289,237,52,833,193200,47981
74,62,12,695,57100,47982
148,95,53,-,48300,47983
1582,1274,308,626,79000,47987
573,434,139,759,89800,47989
634,514,120,673,92700,47990
446,298,148,795,78400,47991
661,605,56,-,144400,47992
1401,1105,296,734,108800,47993
148,125,23,703,81300,47994
618,486,132,672,110400,47995
54,43,11,644,85000,47997
5301,4121,1180,850,137600,48001
1205,1115,90,1060,165300,48002
2281,1958,323,803,167600,48003
2006,1790,216,684,176300,48005
1489,1382,107,830,147500,48006
8935,6744,2191,1330,439000,48009
1458,1138,320,836,122600,48014
3650,1751,1899,618,59800,48015
5547,3889,1658,828,139400,48017
12270,8214,4056,1035,59700,48021
924,871,53,656,140300,48022
2009,1589,420,939,160400,48023
5741,5164,577,1242,351300,48025
6254,4485,1769,748,121000,48026
1256,1133,123,1031,143900,48027
561,534,27,1078,269600,48028
7115,3827,3288,914,51200,48030
802,746,56,792,143400,48032
7801,3086,4715,992,93300,48033
7113,1608,5505,1007,134000,48034
14613,8588,6025,874,102000,48035
9301,6847,2454,721,107400,48036
19517,12338,7179,887,158600,48038
3209,2514,695,777,119200,48039
4197,3266,931,738,116500,48040
1663,1347,316,796,159300,48041
9846,9565,281,1543,231200,48042
6777,3900,2877,666,81600,48043
18764,16999,1765,1232,227000,48044
11099,7617,3482,831,157600,48045
15473,12349,3124,860,175100,48047
2397,1911,486,1008,115000,48048
2134,1887,247,724,128300,48049
700,616,84,946,221700,48050
5992,5035,957,902,145000,48051
2926,2460,466,857,173700,48054
6050,4516,1534,773,136100,48059
16356,9047,7309,724,82200,48060
3544,2758,786,640,160400,48062
1482,1206,276,844,188300,48063
1459,1323,136,728,176800,48064
4002,3386,616,912,217900,48065
19743,12580,7163,898,66100,48066
12337,7846,4491,1040,179200,48067
1111,1045,66,1659,268400,48069
2424,2323,101,1944,298800,48070
13164,7970,5194,816,84000,48071
6528,5368,1160,1085,159400,48072
16206,10921,5285,893,173100,48073
3716,3335,381,673,116200,48074
9280,5441,3839,942,110700,48075
9942,7213,2729,1098,127500,48076
4913,4119,794,689,161300,48079
10600,7456,3144,933,95800,48080
8917,7366,1551,884,111300,48081
7180,6008,1172,996,101000,48082
9161,5661,3500,960,179100,48083
6567,3020,3547,1084,277600,48084
8413,7746,667,1423,246500,48085
9110,7640,1470,865,113000,48088
11938,6657,5281,903,56400,48089
11894,7870,4024,837,65600,48091
10395,7812,2583,883,112100,48092
9888,7394,2494,803,107600,48093
7024,5736,1288,1151,241500,48094
1944,1765,179,844,299400,48095
1534,1381,153,950,180800,48096
1989,1550,439,679,106300,48097
7106,6337,769,1129,337400,48098
10805,9054,1751,920,99800,48101
23063,15243,7820,1166,277400,48103
15601,6108,9493,1211,270700,48104
14819,7075,7744,1121,311400,48105
10934,5418,5516,920,225200,48108
0,0,0,-,-,48109
16320,11015,5305,865,139400,48111
7707,7292,415,920,235500,48114
10916,8946,1970,917,223200,48116
3741,3430,311,869,146900,48117
5111,3934,1177,974,227600,48118
2261,853,1408,1019,135200,48120
3899,2420,1479,793,57600,48122
12217,9521,2696,960,109800,48124
7675,5666,2009,970,65500,48125
12858,6930,5928,970,100300,48126
12872,9059,3813,967,111900,48127
3943,3251,692,1292,134100,48128
5432,4766,666,1103,294900,48130
2861,2151,710,781,147600,48131
2325,1908,417,721,104900,48133
7725,6228,1497,745,154100,48134
10284,8330,1954,998,83300,48135
1976,1902,74,889,174500,48137
4164,3755,409,969,254400,48138
82,60,22,-,-,48139
1219,1097,122,710,179200,48140
9477,4679,4798,757,45000,48141
0,0,0,-,-,48143
3878,3381,497,998,166800,48144
1264,1102,162,927,150900,48145
14234,9842,4392,833,60400,48146
10243,8555,1688,1127,138900,48150
12361,9773,2588,939,177200,48152
14560,12891,1669,1028,172300,48154
660,464,196,561,111600,48157
2986,2473,513,707,199100,48158
919,842,77,881,135100,48159
4423,3515,908,885,160200,48160
10295,7581,2714,731,103900,48161
11378,7834,3544,747,132200,48162
3058,2771,287,952,199300,48164
2669,2024,645,1189,198500,48165
4108,3566,542,923,126800,48166
8958,6369,2589,1094,268200,48167
7873,7176,697,1275,383600,48168
8171,7258,913,892,199200,48169
16397,12346,4051,850,259000,48170
4635,3671,964,797,135800,48173
11549,8139,3410,791,72700,48174
8155,6852,1303,746,260100,48176
95,61,34,-,155700,48177
12126,10349,1777,888,235000,48178
1337,1068,269,999,162800,48179
23825,15598,8227,835,75600,48180
8507,7304,1203,827,157200,48182
17266,12521,4745,719,132300,48183
6788,3846,2942,696,65900,48184
21135,11327,9808,804,105100,48185
13061,8738,4323,877,88400,48186
17527,12689,4838,947,205200,48187
14258,11554,2704,1204,216400,48188
5491,4333,1158,911,167800,48189
37,37,0,-,271700,48190
1419,1204,215,969,153700,48191
10932,7838,3094,750,86200,48192
6038,3853,2185,734,122800,48193
12563,7883,4680,814,87900,48195
25336,12566,12770,889,166100,48197
16127,8710,7417,799,93100,48198
7695,585,7110,542,177400,48201
7529,1962,5567,609,72000,48202
9807,4171,5636,627,38000,48203
9557,4742,4815,719,29800,48204
13036,5924,7112,896,29200,48205
6589,3004,3585,706,43200,48206
11327,2658,8669,763,64300,48207
4005,1390,2615,612,58800,48208
9956,4764,5192,646,36900,48209
9114,4789,4325,726,28800,48210
2132,850,1282,722,31500,48211
11092,6254,4838,658,38100,48212
8568,4194,4374,677,28000,48213
9866,3525,6341,662,45000,48214
4747,2158,2589,733,50700,48215
2314,784,1530,579,64800,48216
2843,1653,1190,760,45300,48217
2825,1618,1207,723,35600,48218
18728,10287,8441,825,42300,48219
10818,6323,4495,854,106900,48220
14488,9128,5360,829,64300,48221
9304,5056,4248,781,55600,48223
14273,8023,6250,915,41900,48224
5364,3277,2087,1023,66000,48225
3799,496,3303,1008,176900,48226
15027,8285,6742,821,41400,48227
18532,9433,9099,815,31300,48228
3558,1945,1613,736,39800,48229
6355,4829,1526,1008,305600,48230
0,0,0,-,-,48233
12138,6895,5243,767,35000,48234
17431,10268,7163,876,47900,48235
11293,10030,1263,1206,232600,48236
11657,6508,5149,985,82500,48237
10779,5173,5606,754,37300,48238
13438,9982,3456,1057,66900,48239
6609,4674,1935,1128,61400,48240
0,0,0,-,-,48242
0,0,0,-,-,48243
5531,4785,746,1375,419800,48301
6162,5375,787,953,393500,48302
6535,5673,862,1316,325900,48304
9677,8830,847,1079,350800,48306
17574,11151,6423,1092,211600,48307
10710,8660,2050,1170,257500,48309
14895,10849,4046,984,155300,48310
13230,9364,3866,824,144400,48312
13239,9363,3876,911,154000,48313
8355,5976,2379,964,180300,48314
10376,8998,1378,999,243200,48315
10476,8190,2286,922,209900,48316
11472,6528,4944,924,147500,48317
2151,1380,771,895,156900,48320
12272,8963,3309,1576,243300,48322
6491,5844,647,1815,308800,48323
6374,5741,633,1164,283700,48324
9045,4150,4895,986,123100,48326
9411,6297,3114,768,141800,48327
11079,6451,4628,767,116100,48328
9843,8274,1569,1155,145200,48329
8528,6501,2027,1296,259600,48331
8136,4856,3280,1159,201400,48334
10739,4481,6258,986,225700,48335
11145,7452,3693,841,156900,48336
10072,4234,5838,763,45900,48340
6547,3175,3372,805,61600,48341
6749,2772,3977,708,53800,48342
8977,6467,2510,984,175500,48346
8236,7768,468,1308,269800,48348
2760,2526,234,1003,203900,48350
2403,2017,386,909,187800,48353
3209,2907,302,752,178400,48356
3103,2821,282,920,187000,48357
3329,2465,864,970,206300,48359
4128,3489,639,1029,233800,48360
5789,4603,1186,898,199200,48362
1982,1857,125,1277,329300,48363
1633,1490,143,1252,242100,48367
701,642,59,-,310700,48370
8823,7535,1288,837,201300,48371
4877,4410,467,1944,379600,48374
8847,5858,2989,1236,218700,48375
7438,3448,3990,965,231900,48377
2529,2463,66,-,252100,48380
5293,4025,1268,838,226700,48381
7974,7354,620,1211,252600,48382
4796,4436,360,1122,192600,48383
6810,5865,945,907,187900,48386
10108,7480,2628,1067,168800,48390
7110,4070,3040,667,178100,48393
0,0,0,-,-,48397
650,563,87,738,102200,48401
31,31,0,-,-,48411
2042,1857,185,806,151300,48412
2969,2260,709,614,95500,48413
1017,850,167,862,112900,48414
3796,3266,530,733,120400,48415
1774,1440,334,571,108900,48416
988,906,82,904,96300,48417
1497,1334,163,761,144900,48418
1034,865,169,658,96900,48419
8631,7024,1607,656,104500,48420
2334,2143,191,855,117800,48421
2557,1949,608,708,87800,48422
13648,9042,4606,646,121900,48423
390,296,94,602,94400,48426
1132,876,256,585,84200,48427
1845,1605,240,936,196000,48428
3579,2707,872,658,98000,48429
14258,11179,3079,945,170700,48430
304,276,28,1013,97800,48432
10237,8766,1471,733,119100,48433
30,24,6,-,85000,48434
701,622,79,602,101300,48435
1412,1269,143,787,138000,48436
257,180,77,-,62700,48437
2556,2324,232,990,186900,48438
18999,13392,5607,759,146200,48439
77,67,10,-,211000,48440
1679,1341,338,484,91400,48441
8007,6415,1592,977,148200,48442
3272,2321,951,755,130200,48444
544,449,95,597,79800,48445
11846,9027,2819,746,125500,48446
1121,977,144,708,88100,48449
2303,1969,334,546,116200,48450
5323,4654,669,775,160500,48451
1846,1380,466,613,90400,48453
442,392,50,742,90000,48454
3057,2707,350,832,211000,48455
336,294,42,525,96000,48456
3033,2657,376,684,93200,48457
7970,5290,2680,677,52900,48458
870,741,129,613,121100,48460
2981,2497,484,816,124000,48461
4823,4370,453,984,205900,48462
1930,1725,205,721,102300,48463
770,674,96,867,122600,48464
285,233,52,658,114500,48465
608,509,99,611,79800,48466
1120,947,173,546,122600,48467
605,544,61,621,87000,48468
549,438,111,463,125000,48469
326,283,43,750,99000,48470
2215,1541,674,580,88400,48471
661,563,98,838,103500,48472
8636,7473,1163,799,119900,48473
1007,835,172,653,105700,48475
221,183,38,840,78100,48476
180,5,175,630,-,48502
11248,6163,5085,647,43100,48503
11070,6278,4792,777,35200,48504
8564,4885,3679,674,24900,48505
11396,7441,3955,677,44400,48506
13246,8221,5025,672,54100,48507
3642,3253,389,886,79200,48509
3132,1940,1192,831,76000,48519
3831,2110,1721,730,43000,48529
8167,4963,3204,714,81600,48532
0,0,0,-,-,48551
0,0,0,-,-,48553
0,0,0,-,-,48554
14493,9139,5354,647,43300,48601
11827,7664,4163,649,48400,48602
11811,7410,4401,777,121500,48603
4296,2937,1359,800,75600,48604
555,280,275,476,40700,48607
4864,4272,592,703,122700,48609
1334,1204,130,665,89300,48610
2586,2144,442,744,122600,48611
3906,3272,634,609,88500,48612
427,352,75,786,89500,48613
557,469,88,784,94900,48614
1198,956,242,590,83200,48615
2927,2391,536,623,104000,48616
3261,2471,790,600,108800,48617
2251,1774,477,594,91800,48618
243,227,16,688,86800,48619
530,415,115,597,100200,48621
2579,2216,363,741,99900,48622
4774,4190,584,1057,152300,48623
6607,5507,1100,601,99400,48624
5757,4742,1015,559,67300,48625
2300,1963,337,723,132000,48626
57,54,3,-,-,48627
862,740,122,747,114300,48628
3475,2672,803,664,99600,48629
21,21,0,-,-,48630
1747,1553,194,641,117400,48631
2167,1870,297,698,85700,48632
93,85,8,-,-,48633
1755,1602,153,725,109600,48634
768,683,85,723,87700,48635
391,371,20,470,87200,48636
1253,1118,135,608,104200,48637
5634,3693,1941,711,109600,48638
13146,9521,3625,712,139300,48640
12953,9267,3686,795,138400,48642
1771,1437,334,606,75500,48647
542,507,35,775,96000,48649
2972,2589,383,695,94900,48650
2466,2069,397,591,101900,48651
661,610,51,546,100300,48652
4529,3836,693,651,103000,48653
991,851,140,536,90700,48654
2400,2010,390,657,105500,48655
1872,1478,394,562,61300,48656
3345,2914,431,813,124100,48657
2025,1544,481,542,83600,48658
1078,904,174,590,84700,48659
4505,3536,969,631,103500,48661
612,547,65,900,97000,48662
0,0,0,-,-,48667
592,482,110,842,71600,48701
1498,1253,245,587,106900,48703
249,207,42,523,84600,48705
16444,12976,3468,696,98500,48706
11125,7850,3275,575,72900,48708
0,0,0,-,-,48710
439,388,51,648,87000,48720
220,217,3,-,102100,48721
1383,1218,165,693,86600,48722
4934,3772,1162,639,89600,48723
152,152,0,-,71600,48724
1080,855,225,552,99700,48725
2267,1918,349,653,92500,48726
482,440,42,855,89000,48727
171,153,18,556,144600,48728
599,538,61,850,95600,48729
2067,1482,585,612,102900,48730
665,486,179,494,84800,48731
4876,3432,1444,614,112100,48732
732,624,108,720,82000,48733
3279,2432,847,645,168300,48734
396,343,53,508,77600,48735
612,512,100,617,75500,48737
622,566,56,585,134400,48738
1858,1620,238,629,87500,48739
1031,868,163,615,110600,48740
779,633,146,664,95600,48741
795,699,96,563,100900,48742
32,32,0,-,74000,48743
1739,1417,322,815,95100,48744
530,437,93,497,68800,48745
3283,2934,349,716,111000,48746
588,551,37,645,125200,48747
849,744,105,638,88600,48748
414,368,46,677,88800,48749
3919,2996,923,580,76700,48750
371,342,29,483,79700,48754
1454,1168,286,687,110200,48755
2012,1690,322,669,62700,48756
1507,1266,241,627,108700,48757
1404,1151,253,530,76400,48759
530,465,65,722,91800,48760
478,412,66,415,72800,48761
516,508,8,850,109500,48762
2124,1802,322,685,97900,48763
318,277,41,738,81800,48765
533,471,62,813,78200,48766
803,716,87,600,88200,48767
3737,2929,808,625,100400,48768
774,654,120,579,74100,48770
4899,3249,1650,617,86800,48801
613,515,98,656,95300,48806
305,262,43,586,88300,48807
2141,1784,357,895,159700,48808
4106,3175,931,657,98000,48809
1190,917,273,587,96900,48811
8240,6318,1922,745,132800,48813
856,749,107,817,133100,48815
33,33,0,-,83200,48816
2528,1669,859,696,100000,48817
1003,813,190,723,88200,48818
916,819,97,932,148900,48819
6519,5298,1221,849,194000,48820
2439,2264,175,735,162100,48821
1048,1014,34,1042,165900,48822
19868,8104,11764,892,175300,48823
0,0,0,-,-,48825
6096,4906,1190,842,135800,48827
1162,797,365,641,82400,48829
1365,1100,265,667,102900,48831
519,479,40,697,89800,48832
786,639,147,682,109900,48834
1022,887,135,709,145100,48835
4861,4004,857,895,155000,48836
7957,6216,1741,721,159300,48837
6958,4999,1959,712,111000,48838
5891,3641,2250,736,162800,48840
308,264,44,831,91300,48841
8795,6312,2483,824,140700,48842
16572,12481,4091,929,203000,48843
384,333,51,580,87800,48845
6036,4243,1793,690,92900,48846
2417,1750,667,693,93300,48847
2930,2644,286,797,151200,48848
2333,1805,528,646,117600,48849
1588,1307,281,567,91600,48850
846,669,177,713,106400,48851
48,33,15,731,49600,48852
271,207,64,475,85700,48853
7281,5621,1660,896,157600,48854
5414,4876,538,1012,191300,48855
352,233,119,775,89200,48856
974,858,116,860,111000,48857
17122,8485,8637,700,131800,48858
570,420,150,681,83300,48860
580,478,102,714,114400,48861
8750,5551,3199,895,212500,48864
721,518,203,813,84400,48865
1771,1532,239,632,117000,48866
11077,7867,3210,651,92100,48867
55,48,7,-,80000,48870
736,618,118,708,133200,48871
2810,2183,627,789,116900,48872
547,492,55,638,118500,48873
39,37,2,-,64400,48874
3720,3037,683,844,146500,48875
1531,1174,357,750,114500,48876
912,760,152,656,78100,48877
632,549,83,730,99000,48878
6891,5285,1606,719,146100,48879
2458,1750,708,583,84700,48880
2150,1757,393,555,144200,48881
2782,2305,477,686,117000,48883
1694,1383,311,645,92700,48884
344,266,78,583,96000,48885
852,725,127,608,83200,48886
2362,1915,447,655,97300,48888
523,445,78,788,95000,48889
787,685,102,713,124200,48890
1099,907,192,643,96100,48891
1665,1378,287,865,130600,48892
2003,1766,237,850,122900,48893
651,592,59,636,164000,48894
4495,3732,763,783,181100,48895
53,38,15,825,83300,48896
594,414,180,1019,132400,48897
10404,6813,3591,739,84000,48906
15795,8532,7263,799,73900,48910
15594,7928,7666,728,85200,48911
7708,3536,4172,801,87100,48912
3559,1910,1649,831,72600,48915
14308,8050,6258,819,134300,48917
0,0,0,-,-,48921
1612,105,1507,638,121500,48933
8947,4580,4367,689,84300,49001
8342,5670,2672,596,132500,49002
6112,4581,1531,858,108100,49004
10037,3986,6051,771,120300,49006
4433,1221,3212,674,58600,49007
6574,3877,2697,701,145500,49008
18357,11982,6375,776,198900,49009
6660,5210,1450,793,115200,49010
801,691,110,686,96500,49011
1351,1155,196,692,159500,49012
1933,1481,452,607,84800,49013
8269,6306,1963,708,115200,49014
11023,7442,3581,778,109800,49015
8673,6192,2481,704,97900,49017
2543,2100,443,778,114900,49021
12552,6805,5747,623,89500,49022
11635,7898,3737,802,155800,49024
900,778,122,646,107800,49026
48,43,5,-,83000,49027
2382,1835,547,638,94000,49028
576,485,91,779,103300,49029
821,662,159,646,87300,49030
2957,2238,719,682,130100,49031
1053,872,181,635,119600,49032
575,531,44,855,182200,49033
1021,923,98,658,135300,49034
8635,6412,2223,715,101700,49036
8701,4541,4160,661,66800,49037
3864,2794,1070,764,132900,49038
1319,906,413,650,107800,49040
1906,1542,364,584,103300,49042
889,599,290,710,83600,49043
1940,1451,489,698,97900,49045
3192,2628,564,728,153000,49046
5779,4189,1590,595,101100,49047
9928,6288,3640,747,95900,49048
567,506,61,634,131500,49050
972,925,47,944,134300,49051
355,301,54,627,110300,49052
2677,2186,491,589,139700,49053
2369,1940,429,634,111200,49055
1292,1132,160,648,87500,49056
2289,1703,586,589,84400,49057
7481,5797,1684,776,114200,49058
728,600,128,1056,190200,49060
624,558,66,-,117600,49061
1395,1070,325,607,125300,49064
2484,2019,465,800,139700,49065
238,215,23,860,79500,49066
1667,1401,266,820,120000,49067
5980,4452,1528,704,132100,49068
903,784,119,572,125800,49070
3290,2986,304,789,183000,49071
1197,995,202,700,144900,49072
1764,1326,438,700,101000,49073
69,9,60,414,-,49074
29,13,16,-,-,49075
1404,1066,338,726,135200,49076
3582,2828,754,663,125900,49078
5160,3944,1216,684,132100,49079
5958,4719,1239,718,140900,49080
2290,1879,411,646,98900,49082
2899,2415,484,809,205900,49083
7,0,7,-,-,49084
9887,7286,2601,773,181200,49085
2358,2082,276,682,180400,49087
1256,1148,108,969,180000,49088
623,498,125,675,73200,49089
5985,4297,1688,664,149400,49090
7598,5193,2405,696,106500,49091
755,598,157,768,94400,49092
7030,5160,1870,671,112900,49093
1654,1365,289,592,82000,49094
842,706,136,828,182900,49095
1197,1016,181,830,111200,49096
4047,3423,624,718,152200,49097
2473,1982,491,623,109200,49098
2129,1565,564,677,101200,49099
1276,1090,186,783,136800,49101
568,458,110,1267,140100,49102
3352,2154,1198,668,150800,49103
0,0,0,-,-,49104
1973,1553,420,688,166600,49106
4187,3026,1161,585,119200,49107
1306,1086,220,738,115400,49111
3694,3113,581,749,146200,49112
725,598,127,718,106800,49113
234,234,0,-,298100,49115
148,138,10,-,338700,49116
1732,1331,401,881,263600,49117
48,44,4,-,84200,49119
14849,11040,3809,654,105400,49120
923,759,164,699,194400,49125
542,458,84,838,128100,49126
4476,3497,979,828,182300,49127
1558,1224,334,797,147200,49128
270,231,39,741,341400,49129
709,544,165,833,192600,49130
15345,11426,3919,690,138200,49201
8754,4347,4407,695,64700,49202
15276,10048,5228,745,89700,49203
888,687,201,699,111400,49220
14464,10260,4204,728,100800,49221
5158,3645,1513,610,69400,49224
509,429,80,625,84300,49227
2174,1772,402,889,113500,49228
1244,1095,149,793,151700,49229
4398,3797,601,790,162700,49230
905,738,167,722,122700,49232
1045,918,127,696,131100,49233
1173,1024,149,778,183800,49234
814,654,160,717,100900,49235
1826,1569,257,677,140200,49236
1056,921,135,760,127800,49237
652,479,173,856,119900,49238
3639,3084,555,753,189000,49240
920,811,109,719,128600,49241
5589,3670,1919,629,94600,49242
1800,1314,486,663,95200,49245
1260,1170,90,433,163000,49246
2237,1806,431,762,93900,49247
326,268,58,870,96300,49248
1640,1429,211,810,143700,49249
2325,1919,406,718,91500,49250
2278,1932,346,770,121300,49251
1016,724,292,625,94800,49252
1377,1250,127,838,167100,49253
1249,889,360,844,94200,49254
683,557,126,774,82600,49255
1580,1203,377,767,85700,49256
770,673,97,744,107200,49259
118,101,17,-,60400,49261
513,393,120,618,73600,49262
19,19,0,-,-,49263
790,734,56,790,133200,49264
2136,1891,245,755,170800,49265
1279,1085,194,751,103200,49266
1554,1223,331,751,164600,49267
391,326,65,725,105800,49268
2360,2017,343,773,114500,49269
2074,1806,268,1012,159600,49270
778,624,154,765,101000,49271
946,861,85,637,168600,49272
1317,1063,254,706,92400,49274
383,317,66,1024,122900,49276
1299,1104,195,833,128900,49277
278,234,44,950,112200,49279
202,178,24,950,-,49282
1251,1020,231,541,139600,49283
1127,872,255,791,102500,49284
2147,1789,358,717,145500,49285
6017,4620,1397,802,134500,49286
699,643,56,952,173500,49287
520,429,91,635,69700,49288
75,47,28,807,67300,49289
6615,6225,390,1346,311900,49301
2758,2570,188,789,226700,49302
383,339,44,621,114500,49303
1561,1168,393,546,69500,49304
861,696,165,577,86200,49305
3684,3523,161,868,177400,49306
6749,3896,2853,617,119300,49307
694,556,138,702,76000,49309
1107,967,140,746,110800,49310
132,124,8,500,65000,49312
7810,6895,915,824,200000,49315
7726,6709,1017,1000,195500,49316
498,440,58,663,120800,49318
5935,5070,865,650,132600,49319
35,32,3,-,61400,49320
6513,3967,2546,702,143600,49321
545,439,106,781,109600,49322
3266,3050,216,562,163500,49323
585,514,71,924,121300,49325
1617,1411,206,750,102900,49326
3040,2427,613,702,109500,49327
1379,1222,157,643,136200,49328
2981,2578,403,727,95000,49329
1812,1597,215,718,123800,49330
6328,5326,1002,778,167100,49331
1273,1049,224,588,94400,49332
3925,3343,582,881,158500,49333
166,166,0,-,156500,49335
1563,1321,242,728,93000,49336
4822,4035,787,692,99900,49337
651,568,83,712,89500,49338
850,770,80,766,117600,49339
1093,906,187,383,99100,49340
12253,10994,1259,813,192200,49341
746,573,173,659,105700,49342
2137,1747,390,688,120100,49343
1418,1137,281,829,152000,49344
4930,3869,1061,734,137500,49345
2226,2042,184,829,158600,49346
505,424,81,738,100000,49347
4321,3397,924,807,148200,49348
3053,2545,508,644,81600,49349
5936,2972,2964,891,163700,49401
547,488,59,763,87200,49402
903,848,55,916,197000,49403
3115,2561,554,634,141400,49404
597,534,63,625,97500,49405
409,352,57,-,305800,49406
3712,3015,697,712,131200,49408
851,642,209,675,92400,49410
636,562,74,809,115500,49411
4197,3429,768,600,116600,49412
2582,2351,231,821,138400,49415
12036,9486,2550,771,155300,49417
10517,7647,2870,736,163900,49418
2623,2493,130,943,173100,49419
2311,1676,635,627,96500,49420
2291,1945,346,558,81600,49421
16422,10850,5572,777,135900,49423
17325,13048,4277,819,156100,49424
1204,923,281,767,92900,49425
11444,10084,1360,873,179700,49426
9945,8305,1640,848,151600,49428
7444,5318,2126,691,135100,49431
14,14,0,-,-,49434
1319,1204,115,1015,171500,49435
679,594,85,568,146600,49436
2675,2172,503,627,116900,49437
528,69,459,551,88300,49440
15550,10946,4604,752,99700,49441
14845,9492,5353,648,67400,49442
9966,6848,3118,670,82600,49444
7833,6904,929,734,127200,49445
913,841,72,568,108800,49446
1307,1190,117,697,165600,49448
1151,969,182,700,200500,49449
1100,709,391,621,88800,49450
2156,1877,279,644,121200,49451
743,640,103,779,80600,49452
1173,950,223,631,305600,49453
1784,1405,379,635,110500,49454
1836,1333,503,669,103700,49455
7788,5866,1922,781,176200,49456
3801,3296,505,718,121200,49457
29,29,0,-,112500,49458
465,367,98,704,85000,49459
2790,2571,219,743,193600,49460
3491,2841,650,662,132000,49461
9838,8554,1284,836,160400,49464
14872,5746,9126,771,110100,49503
15384,9355,6029,760,111900,49504
13034,8369,4665,809,114500,49505
12005,8879,3126,921,190700,49506
12105,6850,5255,830,84400,49507
15228,8782,6446,834,134700,49508
9899,6801,3098,693,90400,49509
7373,3055,4318,820,161000,49512
11712,6330,5382,776,117100,49519
11149,8656,2493,829,162300,49525
8592,5991,2601,769,156600,49534
3910,2094,1816,749,134400,49544
12310,8375,3935,881,236800,49546
11549,8182,3367,772,80200,49548
8560,6298,2262,707,95100,49601
100,75,25,691,69300,49611
494,431,63,825,165000,49612
305,265,40,967,157600,49613
1115,984,131,630,131200,49614
1748,1457,291,694,175800,49615
760,566,194,708,121200,49616
1354,1228,126,814,173400,49617
298,267,31,1050,87500,49618
468,420,48,963,95300,49619
952,755,197,927,120000,49620
1250,1134,116,856,208300,49621
1098,886,212,684,132100,49622
415,375,40,725,81300,49623
551,487,64,642,89400,49625
159,144,15,713,73300,49626
89,78,11,-,210000,49627
81,72,9,-,105400,49628
1113,867,246,723,227100,49629
674,595,79,569,257600,49630
2431,1895,536,556,92400,49631
476,374,102,729,88300,49632
1501,1309,192,731,97200,49633
42,42,0,-,81600,49634
1592,1344,248,766,188500,49635
190,190,0,-,648900,49636
1261,1117,144,845,130400,49637
402,345,57,504,87300,49638
822,697,125,751,94200,49639
631,554,77,744,160200,49640
327,246,81,432,67300,49642
2473,2201,272,875,146400,49643
862,804,58,663,95100,49644
665,599,66,732,85000,49645
3357,2528,829,666,94700,49646
887,851,36,589,306000,49648
2298,2046,252,902,127200,49649
1280,1177,103,770,160100,49650
3157,2604,553,736,101100,49651
790,647,143,756,232800,49653
327,280,47,859,350000,49654
1139,981,158,775,93900,49655
579,501,78,678,78400,49656
1312,1069,243,650,115300,49657
2745,2359,386,668,81700,49659
5649,4366,1283,556,112200,49660
2244,1808,436,669,97200,49663
822,743,79,734,230700,49664
1635,1321,314,586,84400,49665
0,0,0,-,-,49666
205,173,32,775,72500,49667
1366,1033,333,756,85700,49668
964,871,93,675,300400,49670
22,22,0,-,197900,49674
445,378,67,605,171400,49675
1544,1333,211,661,141500,49676
2736,2036,700,604,83500,49677
482,436,46,540,88500,49679
669,567,102,721,103600,49680
1695,1387,308,687,240500,49682
828,683,145,639,95000,49683
15952,11866,4086,896,189100,49684
13511,9960,3551,853,193100,49686
972,836,136,669,108000,49688
634,546,88,611,87300,49689
2803,2341,462,1000,220200,49690
412,251,161,641,131900,49701
317,255,62,593,99700,49705
1827,1536,291,749,118700,49706
9842,7280,2562,579,91000,49707
1623,1449,174,559,88900,49709
220,205,15,-,157000,49710
3368,2685,683,689,156500,49712
757,673,84,1000,144300,49713
1216,1002,214,537,123500,49715
350,318,32,886,167600,49716
115,94,21,-,390900,49717
344,302,42,704,111700,49718
690,516,174,531,157000,49719
3978,3011,967,654,168100,49720
6201,4954,1247,658,103700,49721
127,83,44,631,152200,49722
420,353,67,861,123100,49724
331,285,46,-,118400,49725
532,457,75,536,167600,49726
2884,2391,493,667,114500,49727
116,102,14,738,110900,49728
577,452,125,738,113100,49729
804,709,95,717,111500,49730
939,761,178,827,106500,49733
7815,6255,1560,743,126700,49735
225,212,13,-,104100,49736
4250,3261,989,683,92900,49738
3135,2710,425,858,214400,49740
348,328,20,625,107900,49743
393,373,20,575,95900,49744
512,443,69,400,124400,49745
1486,1235,251,486,98700,49746
828,698,130,639,131100,49747
71,65,6,550,87500,49748
1821,1428,393,603,145200,49749
867,790,77,871,114900,49751
213,161,52,-,74400,49752
873,816,57,525,110400,49753
867,692,175,711,133000,49755
1666,1417,249,715,89700,49756
319,121,198,471,609800,49757
743,702,41,746,109300,49759
299,279,20,1042,117000,49760
313,269,44,963,112500,49762
82,24,58,800,-,49764
1732,1535,197,584,86600,49765
928,731,197,496,84700,49766
169,140,29,913,115900,49768
660,473,187,796,92200,49769
7322,5003,2319,773,173800,49770
836,720,116,559,116700,49774
53,43,10,-,115600,49775
792,715,77,569,89500,49776
836,815,21,1125,166000,49777
2045,1660,385,550,81400,49779
660,560,100,905,101600,49780
1892,1190,702,587,117500,49781
266,241,25,663,177800,49782
7907,4954,2953,621,104900,49783
1056,437,619,635,83600,49788
122,105,17,625,93900,49791
136,112,24,429,125000,49793
930,746,184,660,84900,49795
173,130,43,723,291700,49796
963,875,88,748,92800,49799
4892,3881,1011,633,96500,49801
2685,1943,742,667,80800,49802
102,102,0,-,132700,49805
272,263,9,-,165500,49806
1265,1125,140,779,123800,49807
114,101,13,-,145200,49808
387,332,55,514,93600,49812
549,494,55,675,85500,49814
198,167,31,486,61300,49815
258,228,30,716,112500,49816
219,208,11,-,125000,49817
411,397,14,-,139100,49818
14,14,0,-,107100,49819
91,70,21,441,85700,49820
566,511,55,610,103400,49821
122,94,28,688,119000,49822
96,80,16,-,117600,49825
94,86,8,-,123500,49826
376,325,51,503,113200,49827
7657,5335,2322,546,89900,49829
310,286,24,833,102300,49831
157,137,20,-,157800,49833
95,82,13,563,108800,49834
399,361,38,1028,111000,49835
407,351,56,575,117500,49836
4020,3384,636,601,109800,49837
245,198,47,875,110000,49838
176,157,19,-,134000,49839
304,287,17,575,110900,49840
2891,1871,1020,615,105500,49841
423,344,79,447,80500,49847
60,58,2,-,106900,49848
5120,4224,896,531,89800,49849
64,50,14,489,80000,49852
551,490,61,615,105200,49853
2561,1993,568,602,98600,49854
12581,7553,5028,684,171400,49855
5741,4245,1496,538,88900,49858
254,238,16,625,120200,49861
1652,1349,303,550,114900,49862
63,63,0,-,46800,49863
45,26,19,-,58900,49864
3102,2465,637,584,131000,49866
1806,1290,516,621,73500,49868
1597,1291,306,851,72800,49870
187,170,17,820,63000,49871
74,70,4,-,87500,49872
47,47,0,-,78300,49873
388,290,98,469,98800,49874
383,368,15,-,81000,49876
13,12,1,-,40000,49877
1536,1343,193,713,118800,49878
419,368,51,607,90000,49879
486,430,56,753,90400,49880
152,129,23,825,92300,49881
42,34,8,-,74000,49883
164,150,14,-,61000,49884
910,805,105,596,150700,49885
249,219,30,819,87300,49886
1087,898,189,621,99100,49887
287,273,14,920,112500,49891
836,729,107,633,136700,49892
755,669,86,543,112500,49893
271,246,25,-,115600,49894
276,244,32,868,169600,49895
552,390,162,488,112200,49896
165,138,27,1336,50500,49901
72,68,4,-,38300,49902
60,42,18,281,61700,49903
606,540,66,625,127700,49905
706,517,189,514,92500,49908
150,128,22,466,74200,49910
1281,980,301,385,60200,49911
456,405,51,400,97900,49912
2854,2239,615,530,68900,49913
249,225,24,713,49900,49915
1136,926,210,650,136700,49916
98,97,1,-,51800,49917
58,48,10,410,257100,49918
94,90,4,-,76300,49919
1822,1571,251,589,90800,49920
137,105,32,980,-,49921
294,216,78,746,116400,49922
206,177,29,382,74800,49925
168,151,17,821,55500,49927
84,82,2,-,50600,49929
2653,1600,1053,630,116700,49930
3153,1527,1626,714,137200,49931
318,266,52,685,64300,49934
3002,2373,629,460,70000,49935
3425,2585,840,523,66600,49938
37,37,0,-,83000,49942
1134,937,197,475,98000,49945
1719,1456,263,545,85100,49946
278,263,15,-,152800,49947
238,224,14,617,70000,49948
580,506,74,518,105100,49950
40,32,8,-,105000,49952
1321,1108,213,427,70300,49953
170,165,5,-,57200,49955
374,360,14,-,111500,49958
152,115,37,542,40300,49959
77,66,11,375,55000,49960
48,46,2,-,70000,49961
93,90,3,-,109700,49962
353,235,118,501,74500,49963
173,168,5,-,84300,49965
233,214,19,-,90000,49967
953,793,160,495,66500,49968
598,488,110,608,191300,49969
115,115,0,-,114200,49970
200,190,10,542,42900,49971
209,189,20,775,184300,50001
600,453,147,546,116900,50002
2748,2204,544,748,217500,50003
378,340,38,875,87000,50005
646,529,117,668,89900,50006
185,182,3,-,160300,50007
406,307,99,539,68000,50008
6881,5061,1820,794,173600,50009
13972,7145,6827,791,168400,50010
0,0,0,-,-,50011
14,0,14,-,-,50012
12137,4049,8088,859,233000,50014
570,431,139,544,88800,50020
9694,6894,2800,1016,185200,50021
3816,2547,1269,610,96400,50022
11700,8971,2729,827,193400,50023
1448,1184,264,603,59400,50025
285,245,40,579,81900,50026
124,102,22,592,55000,50027
651,496,155,825,120600,50028
272,228,44,558,51200,50029
90,90,0,-,-,50032
14,10,4,-,81700,50033
148,105,43,520,86100,50034
2126,1803,323,933,181100,50035
7045,5073,1972,635,118700,50036
52,52,0,-,123300,50038
141,85,56,715,120400,50039
26,26,0,-,51900,50041
127,82,45,617,-,50042
411,325,86,504,75000,50044
514,442,72,858,163000,50046
2321,1857,464,774,157500,50047
354,283,71,440,73600,50048
2823,2182,641,635,85300,50049
321,249,72,603,67200,50050
155,117,38,349,52900,50051
64,56,8,-,74000,50052
1211,951,260,572,122500,50054
355,299,56,800,153900,50055
538,440,98,740,126800,50056
71,71,0,-,-,50057
838,641,197,534,89100,50058
1017,818,199,466,88500,50060
661,545,116,815,287800,50061
273,240,33,-,87900,50062
1017,804,213,872,168800,50063
44,35,9,588,47500,50064
268,174,94,-,74000,50065
132,93,39,625,89500,50066
105,78,27,438,62900,50067
113,99,14,-,76900,50068
442,352,90,689,131600,50069
607,518,89,921,136500,50070
425,349,76,535,57900,50071
908,780,128,836,164400,50072
475,362,113,536,138400,50073
207,192,15,-,288600,50074
316,240,76,741,89500,50075
707,583,124,469,68800,50076
62,43,19,950,33800,50078
30,30,0,-,-,50101
54,54,0,-,78300,50102
162,135,27,-,71300,50103
48,36,12,-,95000,50104
407,326,81,673,176500,50105
444,370,74,756,103700,50106
456,336,120,582,64200,50107
200,137,63,425,42800,50108
1033,935,98,745,228400,50109
4311,3517,794,1032,204000,50111
4391,2919,1472,712,146000,50112
1120,806,314,560,93700,50115
97,93,4,-,64200,50116
46,41,5,-,167200,50117
394,373,21,875,112800,50118
206,158,48,625,170800,50119
111,100,11,-,118800,50120
555,447,108,587,96500,50122
327,251,76,340,73200,50123
1456,1173,283,710,170500,50124
7459,5367,2092,741,169600,50125
2807,2004,803,585,99000,50126
9,9,0,-,-,50127
156,129,27,566,106600,50128
2184,1642,542,552,95000,50129
675,533,142,616,112100,50130
7807,5923,1884,1071,235200,50131
112,90,22,558,68900,50132
173,114,59,488,46000,50133
289,198,91,643,162500,50134
726,582,144,748,97200,50135
180,149,31,-,79100,50136
4813,3530,1283,578,111500,50138
587,488,99,598,119300,50139
1078,629,449,516,94500,50140
243,139,104,800,93400,50141
413,297,116,740,110400,50142
234,180,54,376,138500,50143
1044,652,392,520,80000,50144
176,167,9,613,105800,50146
199,178,21,395,62200,50147
164,145,19,575,81100,50148
426,341,85,721,127900,50149
416,349,67,542,77100,50150
229,191,38,927,90700,50151
346,282,64,578,111100,50153
177,128,49,611,110000,50154
142,106,36,713,69200,50155
1672,1375,297,783,140300,50156
400,311,89,578,77700,50157
11535,8011,3524,639,105000,50158
172,122,50,607,101900,50160
724,622,102,784,159100,50161
527,411,116,671,106500,50162
343,224,119,537,66100,50163
222,189,33,242,74200,50164
66,64,2,-,-,50165
653,558,95,649,136900,50166
218,172,46,550,99400,50167
256,238,18,550,123400,50168
1077,779,298,652,158900,50169
1080,828,252,594,124100,50170
1102,859,243,566,128100,50171
310,204,106,442,112500,50173
617,510,107,625,83300,50174
3391,2612,779,640,136300,50201
211,155,56,443,80400,50206
957,768,189,581,114400,50207
8022,5470,2552,708,108800,50208
634,551,83,830,168400,50210
4532,3411,1121,843,178200,50211
1328,1075,253,706,115700,50212
2817,1699,1118,701,99300,50213
265,204,61,-,182400,50214
1094,930,164,696,226900,50216
269,195,74,573,61800,50217
68,60,8,867,63300,50218
5038,3465,1573,790,185800,50219
3316,2023,1293,729,91400,50220
190,167,23,-,173900,50222
245,179,66,418,98300,50223
1246,926,320,590,131100,50225
1875,1622,253,1039,267500,50226
13,11,2,-,-,50227
1009,806,203,777,136400,50228
279,270,9,-,257400,50229
440,332,108,393,100000,50230
77,66,11,708,87300,50231
192,168,24,709,144100,50232
563,489,74,650,123900,50233
260,227,33,600,152200,50234
169,127,42,579,82900,50235
602,528,74,611,158000,50236
1241,1147,94,694,210600,50237
478,399,79,591,84800,50238
53,39,14,1375,55000,50239
1100,901,199,921,182900,50240
164,117,47,586,132000,50242
85,80,5,763,100000,50243
637,532,105,788,162600,50244
305,241,64,477,88800,50246
851,697,154,600,123200,50247
1891,1281,610,714,180700,50248
519,401,118,726,105800,50249
974,764,210,708,94500,50250
504,380,124,773,120300,50251
99,82,17,-,159200,50252
127,92,35,-,116300,50254
31,31,0,-,42800,50255
207,170,37,498,96800,50256
398,314,84,782,114800,50257
441,338,103,506,64100,50258
846,713,133,959,176300,50261
186,160,26,-,81300,50262
7450,5798,1652,1093,201500,50263
202,169,33,-,55500,50264
13353,8760,4593,872,181500,50265
12617,6785,5832,984,220600,50266
440,342,98,447,58300,50268
247,179,68,750,76700,50271
45,37,8,-,43800,50272
3416,2447,969,797,160700,50273
163,118,45,572,75000,50274
249,197,52,520,77000,50275
1001,785,216,752,165200,50276
215,143,72,581,78800,50277
334,280,54,630,108000,50278
3452,328,3124,713,200000,50309
13269,8789,4480,824,140500,50310
5750,2862,2888,671,136700,50311
7543,4558,2985,744,172300,50312
6523,4814,1709,817,99700,50313
4164,1603,2561,720,88200,50314
13986,8959,5027,772,109100,50315
5838,3472,2366,778,87100,50316
14448,10045,4403,813,106000,50317
0,0,0,-,-,50319
7571,5061,2510,822,148600,50320
3444,2036,1408,781,188200,50321
13042,9553,3489,847,172500,50322
4297,4077,220,1741,291800,50323
2085,1515,570,960,180300,50324
6498,4936,1562,912,236000,50325
4203,3120,1083,928,196600,50327
13077,8583,4494,652,107000,50401
170,131,39,500,84600,50420
1428,1055,373,539,90200,50421
1207,959,248,516,81200,50423
680,567,113,530,69400,50424
13,11,2,-,48300,50426
4104,3122,982,625,150400,50428
219,168,51,492,63800,50430
93,86,7,-,59500,50431
113,86,27,395,53300,50432
82,80,2,-,82500,50433
187,160,27,738,90900,50434
291,256,35,620,95800,50435
2448,1908,540,534,106400,50436
1604,1253,351,588,143100,50438
125,97,28,567,56000,50439
279,226,53,485,87100,50440
2253,1564,689,607,85200,50441
136,115,21,625,139100,50444
238,195,43,448,135200,50446
484,371,113,492,64300,50447
334,282,52,535,94800,50448
284,194,90,520,56600,50449
1255,876,379,562,105800,50450
201,163,38,463,55300,50451
295,216,79,598,86800,50452
222,165,57,575,94000,50453
39,39,0,-,-,50454
193,181,12,467,91700,50455
748,544,204,533,78600,50456
142,131,11,425,80300,50457
907,771,136,575,102300,50458
1178,951,227,579,101300,50459
114,100,14,-,190400,50460
2378,1893,485,567,114400,50461
228,195,33,639,96800,50464
124,98,26,563,40600,50465
648,585,63,470,97100,50466
33,27,6,550,118800,50467
671,530,141,444,149000,50468
662,575,87,458,127200,50469
104,73,31,533,33800,50470
342,263,79,616,85900,50471
899,787,112,570,118200,50472
90,70,20,383,100900,50473
750,593,157,557,87200,50475
342,289,53,413,89500,50476
139,121,18,688,69000,50477
371,319,52,575,67900,50478
275,208,67,532,67000,50479
410,370,40,594,61000,50480
388,319,69,735,166800,50482
295,246,49,444,71300,50483
187,156,31,413,50800,50484
11284,7301,3983,604,91700,50501
445,345,100,550,79500,50510
3172,2422,750,640,121400,50511
687,526,161,518,74900,50514
103,80,23,421,60800,50515
243,218,25,563,96700,50516
405,335,70,419,95400,50517
155,122,33,625,115500,50518
279,206,73,421,76200,50519
41,37,4,-,41300,50520
91,57,34,-,96300,50521
302,275,27,567,66200,50522
309,227,82,475,79800,50523
223,173,50,667,106300,50524
1486,1039,447,652,83400,50525
124,106,18,600,56900,50527
158,124,34,500,92000,50528
321,264,57,690,79000,50529
484,364,120,492,87900,50530
113,107,6,-,110900,50531
427,335,92,463,83500,50532
1583,1148,435,597,67100,50533
445,299,146,522,78900,50535
1819,1320,499,574,96400,50536
251,193,58,518,70300,50538
248,205,43,525,58900,50539
354,295,59,438,56500,50540
376,281,95,475,63500,50541
427,322,105,612,68500,50542
651,534,117,575,94900,50543
186,163,23,381,62500,50544
100,93,7,-,-,50545
120,93,27,475,64200,50546
2500,1635,865,626,116200,50548
65,52,13,-,62500,50551
740,537,203,525,67700,50554
123,110,13,625,-,50556
330,221,109,627,75500,50557
314,263,51,552,65300,50558
151,103,48,715,60400,50559
227,155,72,548,46900,50560
168,130,38,458,43600,50561
220,173,47,600,63800,50562
1146,851,295,530,89100,50563
196,152,44,585,45900,50565
160,136,24,581,91700,50566
115,99,16,613,105800,50567
633,519,114,485,87100,50568
333,254,79,496,67500,50569
92,67,25,775,73500,50570
195,140,55,517,88000,50571
31,19,12,630,45000,50573
984,759,225,520,76300,50574
497,393,104,486,65400,50575
151,116,35,385,108600,50576
184,157,27,100-,52100,50577
306,231,75,610,49300,50578
1061,773,288,510,74700,50579
415,288,127,517,58300,50581
118,92,26,475,63800,50582
1277,937,340,617,77100,50583
492,401,91,559,85600,50585
128,111,17,688,89400,50586
4357,2650,1707,612,119300,50588
412,328,84,638,60000,50590
138,129,9,455,60500,50591
29,27,2,-,40600,50593
93,73,20,500,86500,50594
3888,2647,1241,633,95300,50595
596,418,178,609,108100,50597
383,318,65,479,79200,50598
164,120,44,485,81000,50599
1048,824,224,486,85500,50601
692,531,161,548,94200,50602
253,217,36,383,69000,50603
761,666,95,618,109400,50604
78,44,34,662,70000,50605
334,267,67,538,87400,50606
195,144,51,525,-,50607
183,152,31,675,89200,50609
167,144,23,297,88300,50611
144,120,24,575,247500,50612
15720,10368,5352,793,173800,50613
4433,2917,1516,541,107900,50616
959,747,212,530,114400,50619
13,8,5,-,23800,50620
665,520,145,660,141400,50621
1382,1167,215,593,185500,50622
649,567,82,635,167000,50624
450,358,92,560,81300,50625
686,576,110,606,155600,50626
1271,965,306,638,87400,50627
491,378,113,483,64700,50628
773,652,121,685,139200,50629
886,693,193,575,87500,50630
439,390,49,575,83500,50632
157,127,30,729,49900,50633
353,275,78,538,142600,50634
679,528,151,561,95800,50635
801,634,167,655,82300,50636
1374,1077,297,568,117100,50638
618,423,195,585,106900,50641
200,151,49,625,116100,50642
1033,874,159,719,172900,50643
3615,2829,786,667,130000,50644
418,358,60,425,78900,50645
697,617,80,556,193400,50647
1719,1460,259,578,158300,50648
260,223,37,608,87200,50650
1420,1130,290,689,129400,50651
53,43,10,742,53800,50652
229,187,42,618,88700,50653
195,136,59,429,122900,50654
314,250,64,466,85000,50655
972,813,159,493,110800,50658
2327,1712,615,574,118200,50659
542,461,81,667,141900,50660
2954,2144,810,597,71500,50662
18,18,0,-,-,50664
1264,985,279,565,146600,50665
409,347,62,588,112500,50666
302,278,24,567,167500,50667
502,441,61,577,139400,50668
1126,897,229,624,128200,50669
888,685,203,612,149200,50670
71,52,19,-,40000,50671
230,171,59,670,90500,50672
68,55,13,750,87900,50673
1524,1216,308,569,116700,50674
954,688,266,720,120000,50675
846,687,159,520,104200,50676
4318,3358,960,612,167000,50677
558,486,72,543,91600,50680
179,169,10,450,84500,50681
677,549,128,397,123800,50682
12850,8677,4173,672,141700,50701
8670,5552,3118,707,104800,50702
7681,4561,3120,662,73600,50703
3484,2436,1048,727,102900,50707
4103,2849,1254,577,89100,50801
724,512,212,609,86500,50830
939,761,178,597,71500,50833
49,49,0,-,-,50835
165,128,37,434,61700,50836
146,124,22,375,60000,50837
22,22,0,-,22000,50839
240,177,63,710,61400,50840
1154,859,295,443,90400,50841
40,36,4,-,60000,50842
245,170,75,542,85700,50843
307,233,74,653,66700,50845
473,358,115,513,75100,50846
45,37,8,-,36900,50847
185,136,49,625,57000,50848
1139,850,289,469,94000,50849
892,510,382,612,86900,50851
299,241,58,608,75600,50853
1006,705,301,554,79500,50854
112,89,23,-,104200,50857
319,261,58,400,91800,50858
276,217,59,673,76400,50859
96,88,8,394,76900,50860
107,90,17,746,84000,50861
64,59,5,681,65000,50862
117,75,42,525,65000,50863
923,683,240,554,66500,50864
1004,778,226,600,103600,51001
1184,896,288,654,109400,51002
683,585,98,589,142900,51003
448,335,113,559,80300,51004
616,513,103,570,93300,51005
482,353,129,437,63600,51006
238,214,24,673,115600,51007
56,51,5,542,84100,51008
79,67,12,-,53100,51009
183,150,33,871,77500,51010
35,30,5,-,38800,51011
2873,1922,951,604,85800,51012
219,202,17,675,98000,51014
533,468,65,625,79800,51016
183,145,38,-,80600,51018
326,246,80,388,88200,51019
259,221,38,600,66900,51020
331,266,65,593,100000,51022
1227,986,241,498,86100,51023
716,600,116,657,187700,51024
832,657,175,509,95700,51025
341,294,47,570,100000,51026
467,337,130,755,109400,51027
777,602,175,628,121900,51028
167,147,20,345,50700,51029
600,525,75,550,167700,51030
4997,3818,1179,555,144500,51031
172,141,31,540,67200,51033
873,701,172,605,88400,51034
691,547,144,559,100200,51035
241,206,35,883,126600,51036
196,157,39,522,90500,51037
712,619,93,696,152800,51038
990,779,211,667,135900,51039
1539,876,663,558,90300,51040
2354,1916,438,715,163900,51041
82,59,23,556,90800,51044
757,606,151,633,98100,51046
312,275,37,538,76300,51047
271,189,82,407,70400,51048
208,170,38,400,52500,51049
1008,784,224,670,122800,51050
41,30,11,331,-,51051
358,288,70,613,114500,51052
439,355,84,533,68100,51053
1835,1419,416,841,194600,51054
622,472,150,588,140500,51055
204,168,36,563,145800,51056
405,320,85,589,79400,51058
256,197,59,400,56900,51060
291,227,64,767,109900,51061
230,212,18,638,121900,51062
495,389,106,676,79800,51063
430,9,421,438,-,51101
6000,3756,2244,688,76300,51103
8329,5531,2798,769,121300,51104
3682,1774,1908,548,62000,51105
10297,7326,2971,730,116000,51106
2204,1763,441,777,124800,51108
1283,852,431,715,94300,51109
66,0,66,691,-,51111
2558,1603,955,588,148200,51201
117,107,10,606,89400,51230
136,116,20,-,77500,51231
325,265,60,556,78800,51232
469,417,52,575,110900,51234
481,380,101,675,122700,51235
644,499,145,563,79900,51237
449,421,28,725,104100,51238
1111,942,169,656,148700,51239
717,568,149,705,155600,51240
640,582,58,591,165500,51241
84,77,7,-,104200,51242
401,285,116,755,70400,51243
28,28,0,-,54000,51244
490,333,157,519,87700,51245
1414,1180,234,430,129300,51246
1792,1370,422,758,157500,51247
794,632,162,540,100600,51248
1427,1005,422,568,93600,51249
2709,2006,703,735,188400,51250
5596,3878,1718,643,119600,51301
555,348,207,739,163900,51331
235,172,63,-,108300,51333
2963,2275,688,574,88400,51334
403,330,73,641,92400,51338
22,12,10,525,37500,51341
502,380,122,513,80400,51342
146,89,57,729,-,51343
169,107,62,-,89000,51345
1042,799,243,584,80600,51346
609,473,136,637,142100,51347
194,172,22,425,75800,51350
2043,1566,477,649,167000,51351
449,375,74,577,74900,51354
391,296,95,822,271900,51355
255,182,73,498,69200,51357
480,362,118,551,80500,51358
4063,3130,933,648,186000,51360
54,48,6,692,65000,51363
302,205,97,686,73100,51364
119,115,4,-,85800,51365
150,129,21,534,64000,51366
5084,3662,1422,562,141000,51401
332,304,28,629,124000,51430
190,159,31,570,58000,51431
237,184,53,545,82700,51433
322,265,57,530,99900,51436
445,368,77,553,64800,51439
143,131,12,-,107600,51440
199,152,47,525,90000,51441
3300,2264,1036,591,104300,51442
726,576,150,594,112300,51443
84,69,15,719,85000,51444
1277,895,382,337,100700,51445
243,183,60,475,63500,51446
93,82,11,-,104200,51447
219,177,42,617,81000,51448
951,711,240,515,76600,51449
683,578,105,522,149000,51450
53,48,5,619,34500,51451
303,270,33,525,54500,51453
674,505,169,464,83600,51454
995,725,270,531,95600,51455
620,515,105,545,76600,51458
34,31,3,-,43100,51459
462,379,83,663,78300,51461
420,340,80,632,76000,51462
231,174,57,521,122100,51463
326,280,46,517,81400,51465
393,325,68,397,87100,51466
270,253,17,850,89600,51467
13630,8296,5334,798,97900,51501
14924,10268,4656,770,167500,51503
1473,1087,386,913,100300,51510
83,60,23,502,33600,51520
794,598,196,631,123300,51521
164,135,29,563,62900,51523
471,377,94,693,153100,51525
561,543,18,850,224100,51526
165,134,31,575,95600,51527
341,257,84,495,67200,51528
784,583,201,530,90100,51529
373,285,88,620,118200,51530
318,258,60,450,130100,51531
292,204,88,758,79300,51532
389,273,116,623,97200,51533
3294,2514,780,707,165400,51534
749,623,126,540,92000,51535
176,153,23,775,92500,51536
2801,2240,561,679,101900,51537
173,135,38,706,98700,51540
122,113,9,-,85000,51541
375,310,65,-,213700,51542
249,190,59,500,79200,51543
369,284,85,689,84200,51544
141,114,27,650,46700,51545
1113,900,213,695,116800,51546
146,132,14,575,163200,51548
177,128,49,733,107800,51549
65,59,6,-,71300,51550
617,500,117,723,161900,51551
115,86,29,575,89100,51552
407,344,63,621,143600,51553
73,70,3,-,97200,51554
2155,1570,585,661,122700,51555
180,140,40,983,113200,51556
387,312,75,693,133700,51557
229,197,32,533,56300,51558
647,500,147,667,151500,51559
827,571,256,618,131100,51560
543,485,58,850,130700,51561
162,139,23,-,127500,51562
275,200,75,731,114300,51563
202,163,39,621,72500,51564
200,168,32,633,113000,51565
2941,1885,1056,640,80900,51566
446,321,125,641,121700,51570
257,223,34,825,162500,51571
187,139,48,456,54800,51572
456,362,94,631,97900,51573
630,515,115,805,185700,51575
699,610,89,700,202000,51576
524,365,159,723,93800,51577
41,31,10,-,87500,51578
983,725,258,619,115900,51579
2602,1855,747,596,98700,51601
86,73,13,-,80400,51630
118,94,24,810,78000,51631
2727,2036,691,516,87200,51632
169,143,26,600,53100,51636
78,66,12,-,40000,51637
548,445,103,652,79200,51638
362,245,117,636,88800,51639
682,484,198,612,78700,51640
106,86,20,-,98300,51645
334,275,59,557,70800,51646
51,50,1,-,48000,51647
86,79,7,-,135100,51648
118,103,15,633,80600,51649
154,141,13,-,58800,51650
675,482,193,590,97200,51652
579,418,161,663,116900,51653
198,186,12,540,144400,51654
29,25,4,-,-,51656
17621,10812,6809,689,121900,52001
6220,4618,1602,901,190100,52002
5434,4617,817,785,173000,52003
181,122,59,668,81300,52030
2164,1717,447,693,141200,52031
606,528,78,-,172000,52032
1267,935,332,629,148300,52033
509,463,46,488,114400,52035
466,420,46,621,119100,52037
219,182,37,-,129300,52038
397,389,8,456,246000,52039
2281,1916,365,561,162800,52040
617,571,46,500,136300,52041
633,492,141,478,105700,52042
996,748,248,616,99700,52043
52,30,22,-,147500,52044
892,752,140,770,163100,52045
773,663,110,725,162900,52046
236,175,61,672,95000,52047
160,143,17,-,116900,52048
622,428,194,570,95500,52049
247,188,59,575,88600,52050
1388,1067,321,523,128800,52052
388,339,49,400,142000,52053
352,257,95,831,123100,52054
3115,2407,708,601,115800,52057
3779,2672,1107,592,103800,52060
371,286,85,648,128500,52064
429,374,55,915,122000,52065
40,29,11,-,68300,52066
1518,1322,196,730,231200,52068
670,490,180,534,109800,52069
412,346,66,736,135700,52070
112,102,10,-,83300,52072
429,369,60,1044,239800,52073
144,135,9,440,136800,52074
903,657,246,561,99000,52076
165,105,60,638,103000,52077
370,354,16,420,156800,52078
349,321,28,732,179300,52079
5212,3940,1272,630,168300,52101
814,528,286,588,129600,52132
242,216,26,719,119400,52133
153,125,28,547,58500,52134
347,298,49,521,91000,52135
2425,1890,535,592,120700,52136
252,194,58,439,-,52140
628,476,152,574,106900,52141
578,372,206,625,118400,52142
558,509,49,613,145100,52144
486,443,43,706,141300,52146
429,351,78,494,86100,52147
822,642,180,613,137300,52151
413,354,59,369,98000,52154
526,465,61,470,111000,52155
281,250,31,588,107600,52156
785,577,208,627,132400,52157
136,95,41,482,104200,52158
1048,868,180,735,113700,52159
484,382,102,393,120500,52160
611,520,91,632,124300,52161
1266,813,453,624,93800,52162
133,99,34,450,70500,52163
101,92,9,488,106300,52164
348,281,67,394,163200,52165
56,47,9,706,78600,52166
109,92,17,-,80000,52168
159,134,25,521,88900,52169
226,193,33,506,144500,52170
334,281,53,413,133900,52171
2610,2058,552,511,108800,52172
1568,1139,429,538,95800,52175
450,391,59,495,133800,52201
364,320,44,572,177600,52202
763,652,111,538,171200,52203
3298,2425,873,601,139700,52205
812,723,89,448,212100,52206
188,151,37,566,76400,52207
1306,988,318,519,93800,52208
439,335,104,829,153000,52209
234,181,53,727,111900,52210
1048,767,281,716,115300,52211
86,80,6,488,62700,52212
1518,1298,220,688,176300,52213
1441,1212,229,604,166900,52214
254,237,17,-,156300,52215
625,438,187,611,120300,52216
215,179,36,-,103600,52217
700,532,168,675,133500,52218
75,47,28,733,83800,52219
197,187,10,-,142300,52220
95,83,12,875,111500,52221
276,236,40,429,85100,52222
537,472,65,625,163100,52223
754,633,121,702,126900,52224
155,127,28,550,80500,52225
1108,969,139,684,195400,52227
1149,1088,61,926,217900,52228
289,242,47,725,88600,52229
106,92,14,542,95600,52231
74,54,20,706,82200,52232
2930,1743,1187,811,137500,52233
311,185,126,943,151900,52235
256,247,9,-,173100,52236
594,471,123,665,121800,52237
14542,7196,7346,914,167100,52240
7920,4328,3592,802,204000,52241
0,0,0,-,-,52242
9133,5809,3324,914,204800,52245
9913,4310,5603,833,230100,52246
2073,1552,521,661,166800,52247
686,527,159,696,106400,52248
469,349,120,677,127100,52249
269,235,34,385,71900,52251
1220,1039,181,705,179300,52253
331,242,89,634,88600,52254
559,418,141,671,103300,52255
120,113,7,-,203000,52257
1630,1149,481,567,105300,52301
15496,11943,3553,660,158800,52302
248,204,44,669,141900,52305
704,569,135,675,116400,52306
44,17,27,-,-,52307
65,54,11,244,73300,52308
181,153,28,522,-,52309
2669,2061,608,606,142700,52310
52,38,14,544,60000,52312
139,107,32,617,106700,52313
1810,1559,251,745,209400,52314
503,395,108,530,143200,52315
638,516,122,708,101300,52316
7161,4997,2164,1050,201300,52317
389,355,34,682,123000,52318
509,364,145,684,93800,52320
224,172,52,650,102800,52321
1148,1063,85,792,152600,52322
434,326,108,638,73300,52323
693,614,79,796,173500,52324
374,326,48,-,195800,52325
214,168,46,675,93200,52326
1201,1024,177,694,233900,52327
1048,1020,28,-,259000,52328
378,324,54,650,152000,52329
328,249,79,911,121300,52330
804,672,132,784,185800,52332
2424,2074,350,804,281400,52333
70,70,0,-,152100,52334
333,302,31,636,73000,52335
908,768,140,658,142400,52336
282,200,82,673,98300,52337
1178,1049,129,1088,306400,52338
1515,1012,503,634,84700,52339
1107,745,362,968,183500,52340
394,327,67,582,255900,52341
1274,946,328,759,90700,52342
571,462,109,571,150300,52345
411,324,87,560,132100,52346
685,492,193,595,98900,52347
30,30,0,-,68000,52348
3057,2445,612,581,129400,52349
503,474,29,596,210100,52351
592,513,79,-,144500,52352
3919,2559,1360,780,112600,52353
158,136,22,-,168400,52354
141,125,16,775,81900,52355
946,793,153,669,140300,52356
1504,1279,225,656,156300,52358
100,76,24,-,82900,52359
1807,1377,430,473,164200,52361
389,316,73,531,87900,52362
997,242,755,548,102100,52401
16907,11548,5359,769,139600,52402
9847,7664,2183,640,139700,52403
16010,10288,5722,683,127700,52404
10681,7814,2867,752,138200,52405
2648,2594,54,-,279000,52411
12084,8652,3432,620,80200,52501
456,366,90,583,95400,52530
2515,1805,710,606,92100,52531
622,470,152,593,89700,52533
117,99,18,775,82500,52534
410,347,63,560,84400,52535
453,373,80,465,137000,52536
2627,2068,559,633,108800,52537
546,424,122,631,86300,52540
206,170,36,-,87800,52542
113,84,29,-,137500,52543
3282,2185,1097,543,80600,52544
43,41,2,-,47100,52548
269,259,10,581,80100,52549
209,147,62,-,71300,52550
231,224,7,-,87300,52551
305,240,65,690,122200,52552
686,565,121,661,99500,52553
590,454,136,592,67000,52554
157,146,11,765,66200,52555
5227,3257,1970,626,115600,52556
0,0,0,-,-,52557
207,175,32,675,129400,52560
358,256,102,571,97500,52561
652,410,242,608,69400,52563
738,611,127,475,92400,52565
75,71,4,-,52800,52566
344,273,71,713,82900,52567
280,251,29,883,108000,52569
295,263,32,650,53600,52570
661,569,92,708,96900,52571
437,331,106,744,73700,52572
28,28,0,-,101900,52573
340,272,68,563,63500,52574
266,226,40,827,104900,52576
6258,4074,2184,605,107200,52577
197,166,31,365,76800,52580
150,143,7,-,98800,52581
99,89,10,-,56800,52583
202,135,67,-,68500,52584
402,308,94,925,84300,52585
190,116,74,635,74000,52586
8,8,0,-,-,52588
397,287,110,479,59400,52590
1328,1045,283,573,96900,52591
48,43,5,-,89300,52593
157,128,29,1018,77100,52594
167,91,76,667,80900,52595
12381,8838,3543,689,95100,52601
197,153,44,-,123400,52619
331,273,58,553,86100,52620
263,218,45,1286,88100,52621
767,642,125,581,133800,52623
105,90,15,-,84600,52624
1065,802,263,588,114700,52625
604,500,104,538,68000,52626
5467,4122,1345,603,85800,52627
186,138,48,700,74000,52630
5167,3546,1621,555,71800,52632
312,257,55,668,141300,52635
959,755,204,565,106900,52637
209,178,31,829,114500,52638
761,605,156,539,109500,52639
573,468,105,595,100700,52640
4439,2920,1519,640,119100,52641
144,108,36,813,117300,52644
1365,1155,210,690,97100,52645
149,125,24,725,132500,52646
87,64,23,563,87500,52647
381,299,82,529,80800,52649
328,271,57,-,126800,52650
285,236,49,332,81900,52651
1388,1113,275,663,120500,52653
599,468,131,513,105600,52654
1826,1370,456,680,98000,52655
973,802,171,617,146500,52656
29,21,8,640,95000,52657
372,352,20,519,130700,52658
603,428,175,617,94500,52659
88,88,0,-,70000,52660
40,32,8,675,87700,52701
343,278,65,-,154000,52720
287,238,49,761,100000,52721
14544,11184,3360,869,197300,52722
1893,1815,78,730,198300,52726
126,82,44,-,207100,52727
433,366,67,590,98500,52728
354,308,46,679,135100,52729
2247,1794,453,598,116300,52730
349,300,49,613,121600,52731
11561,8125,3436,640,94900,52732
159,136,23,538,75600,52737
1422,966,456,519,93400,52738
249,156,93,713,75000,52739
3046,2255,791,634,153000,52742
286,200,86,830,137500,52745
370,253,117,940,163500,52746
875,690,185,731,152700,52747
3532,2645,887,690,197300,52748
369,348,21,775,152200,52749
217,211,6,642,167200,52750
357,313,44,690,154700,52751
184,156,28,775,91000,52752
2187,1740,447,765,225500,52753
537,479,58,642,153700,52754
830,607,223,674,175100,52755
780,713,67,785,226200,52756
80,73,7,950,85600,52757
67,54,13,-,137500,52758
215,178,37,-,153000,52760
11837,8582,3255,787,124700,52761
177,160,17,440,137900,52765
449,401,48,648,124100,52766
66,66,0,-,171200,52767
569,488,81,788,176300,52768
254,215,39,665,162200,52769
2109,1590,519,569,137100,52772
922,736,186,581,142300,52773
41,31,10,658,95000,52774
1472,1014,458,710,131200,52776
478,366,112,754,100000,52777
1657,1230,427,608,142400,52778
549,8,541,605,-,52801
3870,2417,1453,665,74500,52802
8907,5517,3390,741,118500,52803
10820,7653,3167,718,114600,52804
11013,7065,3948,764,134100,52806
6584,3222,3362,682,242400,52807
758,661,97,744,174800,53001
968,843,125,932,210400,53002
50,50,0,-,163900,53003
1245,990,255,907,196200,53004
7597,6768,829,1485,271200,53005
680,520,160,943,183000,53006
910,454,456,702,166700,53007
2992,2504,488,757,186600,53010
926,783,143,822,183200,53011
7031,5403,1628,840,275200,53012
1252,949,303,727,180000,53013
3169,2424,745,598,151100,53014
1016,897,119,672,157300,53015
137,105,32,680,109100,53016
2190,2100,90,1167,309800,53017
3041,2379,662,1113,325100,53018
737,667,70,767,172800,53019
1632,1248,384,692,205200,53020
1917,1511,406,750,215100,53021
7635,6062,1573,998,237300,53022
549,488,61,915,198700,53023
6729,4672,2057,897,227400,53024
8888,6747,2141,782,205300,53027
7652,5866,1786,913,336200,53029
0,0,0,-,-,53031
1839,1282,557,843,138800,53032
1999,1954,45,860,250500,53033
732,492,240,801,166300,53034
933,790,143,806,171200,53035
1053,830,223,910,224800,53036
3933,3105,828,842,208400,53037
1591,1232,359,905,202600,53038
1629,1182,447,695,163100,53039
3010,2396,614,927,217000,53040
2844,2359,485,520,150300,53042
972,869,103,995,226300,53044
8374,6917,1457,1369,308000,53045
474,393,81,770,159400,53046
16,14,2,-,187500,53047
1325,772,553,729,157300,53048
978,892,86,456,208900,53049
2816,1893,923,662,148700,53050
14834,11103,3731,944,228300,53051
624,555,69,558,169900,53057
1519,1037,482,1095,340300,53058
702,558,144,672,225000,53059
2212,1759,453,698,126400,53061
631,567,64,848,166700,53063
884,721,163,731,173900,53065
13386,10578,2808,860,269400,53066
327,327,0,-,294400,53069
1893,1620,273,689,163000,53070
10297,7491,2806,1084,273200,53072
5938,4150,1788,660,172700,53073
5310,3592,1718,838,187400,53074
1311,1014,297,711,194300,53075
1208,1068,140,1114,336300,53076
698,596,102,946,245000,53078
561,486,75,611,156500,53079
2352,1686,666,716,202800,53080
18296,10979,7317,632,110200,53081
7965,6059,1906,751,160400,53083
4871,3518,1353,676,150400,53085
3186,2671,515,841,231900,53086
192,138,54,675,121500,53088
7146,5828,1318,937,266500,53089
8549,6472,2077,854,178400,53090
785,672,113,672,146000,53091
8752,7113,1639,1018,317200,53092
771,672,99,739,182700,53093
7647,4787,2860,729,161100,53094
11555,8034,3521,792,196700,53095
2028,1846,182,1163,349100,53097
4661,3325,1336,890,157300,53098
1455,1312,143,1000,237800,53103
2203,1807,396,885,236100,53104
11191,8585,2606,921,196400,53105
1320,1256,64,750,182600,53108
7512,4186,3326,769,150400,53110
964,682,282,989,156700,53114
6303,4088,2215,822,158100,53115
2867,2399,468,1105,282000,53118
1969,1766,203,1022,257200,53119
3897,3130,767,801,223200,53120
7386,5340,2046,839,185800,53121
2292,2197,95,887,355000,53122
845,724,121,932,348500,53125
2643,2176,467,1049,228000,53126
3170,2439,731,1053,154500,53128
5921,4071,1850,869,200300,53129
3330,1958,1372,1026,217300,53130
13315,10278,3037,977,226700,53132
646,556,90,1100,213500,53137
1139,1047,92,775,173500,53139
11871,5412,6459,792,127900,53140
11874,8729,3145,968,167100,53142
8964,4956,4008,852,125500,53143
9675,5528,4147,797,167100,53144
3017,2853,164,1149,237600,53146
6768,4490,2278,879,209700,53147
7445,6110,1335,853,268200,53149
9346,7842,1504,1009,270300,53150
13666,9966,3700,1114,234600,53151
937,818,119,864,250600,53153
14068,8481,5587,987,209800,53154
1199,932,267,720,185200,53156
6138,5023,1115,1029,207500,53158
235,172,63,-,161200,53167
3314,2636,678,1106,166100,53168
938,682,256,831,196800,53170
8578,5124,3454,774,154300,53172
2552,1958,594,954,150400,53177
1141,875,266,846,199900,53178
2325,1906,419,952,179800,53179
2739,2062,677,887,188400,53181
3383,2371,1012,815,208600,53182
1007,757,250,1064,284100,53183
1636,1019,617,814,198800,53184
6992,6004,988,905,237300,53185
13873,7703,6170,853,188600,53186
14360,9407,4953,872,215400,53188
9732,7796,1936,935,256500,53189
6601,3130,3471,725,183400,53190
1213,932,281,852,268900,53191
60,60,0,-,-,53192
54,36,18,750,175000,53195
15463,3282,12181,887,227700,53202
769,154,615,1185,256800,53203
13159,3559,9600,737,73100,53204
3539,1113,2426,572,72700,53205
8365,2695,5670,784,49800,53206
16519,9712,6807,846,152200,53207
12233,4186,8047,740,132100,53208
18396,8653,9743,814,93500,53209
9729,3766,5963,831,99500,53210
14440,5771,8669,957,298000,53211
13393,3865,9528,794,120300,53212
11436,6414,5022,921,219100,53213
15706,7797,7909,798,130500,53214
19233,8460,10773,754,101800,53215
13023,6051,6972,792,90500,53216
11852,9021,2831,1176,318700,53217
13850,6355,7495,848,82400,53218
15215,9216,5999,737,136000,53219
11596,6524,5072,819,156400,53220
15681,9331,6350,809,140400,53221
11389,7757,3632,797,139300,53222
12479,6765,5714,826,121100,53223
8022,4064,3958,910,131900,53224
9752,3940,5812,863,117000,53225
8322,5316,3006,983,216600,53226
10847,5227,5620,814,153100,53227
6315,3567,2748,999,185700,53228
4683,160,4523,625,77500,53233
4663,2357,2306,711,146600,53235
0,0,0,-,-,53295
13171,9290,3881,824,153400,53402
10284,5736,4548,753,111500,53403
5414,2424,2990,726,111600,53404
9820,6636,3184,836,116700,53405
11036,7892,3144,790,173300,53406
46,46,0,-,-,53501
992,704,288,679,182000,53502
770,598,172,745,167100,53503
849,643,206,625,145300,53504
164,132,32,1023,212500,53505
445,332,113,630,103300,53506
843,707,136,717,202600,53507
2079,1655,424,1016,215000,53508
593,429,164,620,149300,53510
18852,12241,6611,736,95600,53511
948,759,189,747,216500,53515
908,774,134,872,185100,53516
693,598,95,850,229700,53517
578,499,79,602,120700,53518
2579,1992,587,662,136900,53520
1424,1249,175,975,233400,53521
431,359,72,595,149100,53522
2023,1651,372,938,241400,53523
1472,1059,413,751,148200,53525
270,205,65,670,124600,53526
3732,3179,553,1015,257500,53527
2311,1817,494,858,278600,53528
818,601,217,918,253600,53529
1807,1274,533,690,119600,53530
1671,1320,351,856,230800,53531
5633,4355,1278,887,226900,53532
3002,2082,920,764,167300,53533
4953,3762,1191,705,162800,53534
3423,2451,972,753,183500,53536
275,224,51,721,99200,53537
7456,5330,2126,800,166700,53538
99,86,13,-,72500,53540
350,278,72,382,119200,53541
678,554,124,550,129200,53543
319,279,40,692,163900,53544
9739,5943,3796,758,128700,53545
12352,9145,3207,790,138000,53546
7337,4940,2397,725,125900,53548
3879,2547,1332,748,162400,53549
420,372,48,811,167200,53550
3305,2203,1102,881,185400,53551
222,168,54,583,102400,53553
421,338,83,792,116800,53554
3507,2878,629,814,241900,53555
1113,871,242,682,127800,53556
161,123,38,650,133000,53557
4614,3784,830,935,248200,53558
2151,1649,502,918,189100,53559
1499,1164,335,735,229300,53560
747,654,93,1022,287100,53561
10992,6833,4159,950,337900,53562
4246,3291,955,769,174300,53563
1987,1491,496,681,176400,53565
6403,4238,2165,669,141400,53566
488,399,89,654,138500,53569
1103,824,279,643,167300,53570
113,113,0,-,188400,53571
4130,3008,1122,874,255000,53572
1263,972,291,674,110300,53573
1480,1260,220,807,197100,53574
5861,4640,1221,783,246000,53575
910,642,268,648,148900,53576
566,443,123,705,188200,53577
2526,1821,705,971,220800,53578
682,534,148,876,163300,53579
219,173,46,604,89100,53580
4464,3062,1402,603,124200,53581
442,373,69,667,164000,53582
2294,1638,656,680,198600,53583
877,557,320,702,152900,53585
931,687,244,595,107600,53586
493,388,105,633,114100,53587
1692,1271,421,719,186700,53588
8008,6043,1965,881,212700,53589
14862,9030,5832,975,225900,53590
8432,6355,2077,1107,330900,53593
2033,1633,400,720,163700,53594
6722,5320,1402,987,293200,53597
938,644,294,1111,254700,53598
34,21,13,-,90800,53599
32,32,0,-,-,53702
14884,2191,12693,950,286300,53703
20419,10992,9427,920,177800,53704
11600,5912,5688,929,296300,53705
79,0,79,832,-,53706
20204,12976,7228,952,248600,53711
9864,2609,7255,812,172300,53713
7143,4068,3075,890,167300,53714
5109,760,4349,1208,241600,53715
8195,5679,2516,896,199500,53716
6029,3128,2901,982,286300,53717
5550,3653,1897,1188,216600,53718
13307,6707,6600,1027,227000,53719
2259,745,1514,992,438000,53726
0,0,0,-,-,53792
382,325,57,454,90900,53801
25,18,7,575,95000,53802
531,438,93,646,108200,53803
541,424,117,483,111400,53804
2103,1431,672,627,112700,53805
730,591,139,448,110200,53806
1927,1561,366,643,156100,53807
471,324,147,668,141700,53808
1589,1186,403,608,114000,53809
151,128,23,356,128300,53810
1214,923,291,698,157800,53811
2356,1691,665,534,136400,53813
264,224,40,605,167900,53816
70,54,16,725,78200,53817
5154,2928,2226,734,159400,53818
986,824,162,537,150900,53820
3356,2404,952,548,125900,53821
181,143,38,425,121300,53825
470,358,112,504,111200,53826
89,70,19,738,120000,53827
5865,3780,2085,715,146200,53901
1308,914,394,670,96000,53910
519,397,122,980,189200,53911
8506,5281,3225,730,156200,53913
9016,6208,2808,752,135500,53916
1015,850,165,644,153700,53919
189,172,17,908,161300,53920
390,325,65,665,169300,53922
723,611,112,671,157000,53923
596,467,129,663,157400,53924
3269,2390,879,750,190000,53925
475,418,57,494,149600,53926
45,32,13,1069,95000,53928
1065,764,301,591,125000,53929
520,416,104,667,135600,53930
90,70,20,710,113800,53931
984,702,282,925,182400,53932
1263,933,330,730,166000,53933
1795,1506,289,680,110200,53934
110,84,26,725,122700,53935
563,481,82,838,96300,53936
352,304,48,532,163100,53937
102,84,18,679,102100,53939
1158,1016,142,734,173500,53941
402,277,125,666,160900,53943
815,644,171,648,129800,53944
1836,1419,417,603,155200,53946
69,56,13,446,112500,53947
3188,2337,851,673,125100,53948
2569,2058,511,681,140500,53949
1896,1454,442,678,124000,53950
916,708,208,675,139400,53951
1302,1067,235,713,139400,53952
91,74,17,681,57400,53953
2777,2340,437,751,174600,53954
2380,1914,466,695,200600,53955
1209,928,281,694,149100,53956
5384,3686,1698,716,152300,53959
1391,1086,305,856,173100,53960
297,252,45,800,169200,53961
4757,3413,1344,686,131400,53963
1365,1039,326,763,141000,53964
4092,2835,1257,734,165500,53965
960,725,235,582,99200,53968
117,85,32,-,150600,53969
3366,2729,637,794,153200,54001
2600,1745,855,866,171400,54002
347,327,20,944,225400,54003
987,768,219,693,138000,54004
1201,987,214,646,145400,54005
293,232,61,678,155000,54006
483,393,90,578,158800,54007
997,744,253,933,166700,54009
22,0,22,687,-,54010
2603,2036,567,660,185500,54011
1345,1058,287,841,162600,54013
830,746,84,806,180500,54014
1284,986,298,850,170900,54015
12029,9027,3002,1039,261700,54016
6457,4829,1628,894,177700,54017
2819,2182,637,780,172100,54020
2458,2055,403,812,228700,54021
8026,4948,3078,822,218900,54022
1449,1203,246,928,207000,54023
2091,1521,570,710,160100,54024
2497,2026,471,923,184300,54025
738,598,140,738,193900,54026
373,351,22,925,200300,54027
881,679,202,788,162900,54028
526,494,32,-,257600,54082
1048,961,87,780,177100,54101
437,381,56,557,124600,54102
197,186,11,-,113500,54103
567,507,60,761,121500,54104
1896,1593,303,667,160400,54106
1349,1105,244,589,149900,54107
2008,1599,409,630,139800,54110
894,711,183,710,160300,54111
967,763,204,633,114900,54112
1346,1263,83,822,160000,54113
2430,2064,366,628,129900,54114
16842,11099,5743,839,188600,54115
242,183,59,722,127800,54119
106,93,13,485,147500,54120
1377,1155,222,519,152200,54121
92,86,6,-,136700,54123
1506,1159,347,597,109800,54124
271,201,70,401,72600,54125
1333,1074,259,708,174800,54126
25,11,14,-,93800,54127
682,535,147,633,116800,54128
1336,1158,178,548,166500,54129
10064,7242,2822,779,158000,54130
877,613,264,467,97300,54135
2702,1836,866,741,136400,54136
466,444,22,-,148600,54137
442,387,55,664,168400,54138
1234,1054,180,708,151600,54139
3756,2566,1190,765,138100,54140
872,784,88,737,175500,54141
6863,4598,2265,686,102000,54143
644,580,64,719,160900,54149
335,163,172,481,47400,54150
1500,1315,185,544,88900,54151
2933,2178,755,615,113400,54153
2377,1765,612,590,141300,54154
2335,1994,341,711,174800,54155
647,549,98,668,101300,54156
2363,1584,779,632,119000,54157
606,572,34,1042,144500,54159
103,76,27,715,127100,54160
1252,1029,223,601,132400,54161
3419,2741,678,700,170300,54162
2886,2164,722,634,167000,54165
7354,5050,2304,609,129800,54166
983,935,48,775,223300,54169
1403,1194,209,640,166200,54170
1290,1263,27,-,227000,54171
1551,1339,212,1080,220100,54173
1237,1013,224,661,124000,54174
444,386,58,683,198300,54175
1379,1107,272,521,124700,54177
1178,904,274,867,169000,54180
2223,1631,592,557,118900,54201
678,571,107,749,276100,54202
713,596,117,636,184900,54204
807,723,84,600,162100,54205
65,54,11,-,126900,54207
2356,1978,378,670,180300,54208
614,537,77,783,268500,54209
457,357,100,723,276500,54210
121,103,18,483,416700,54211
496,454,42,744,342500,54212
519,419,100,679,132000,54213
96,61,35,625,145200,54214
2727,2196,531,611,134800,54216
2698,2239,459,720,174700,54217
17200,12148,5052,640,117700,54220
636,559,77,692,180700,54227
1075,897,178,650,131900,54228
1698,1485,213,862,185900,54229
1789,1553,236,543,160400,54230
327,237,90,538,115100,54232
774,618,156,748,290800,54234
7964,6001,1963,710,172900,54235
6287,4542,1745,635,107400,54241
916,770,146,711,160500,54245
425,376,49,764,277100,54246
938,844,94,627,153200,54247
9183,6140,3043,669,142600,54301
12887,6265,6622,663,107000,54302
11877,5542,6335,637,112800,54303
12593,7428,5165,685,126100,54304
0,0,0,-,-,54307
13077,8940,4137,790,184100,54311
14272,11893,2379,842,196400,54313
12911,8511,4400,702,130500,54401
10206,6744,3462,643,139000,54403
1129,791,338,540,114800,54405
1324,1076,248,658,172800,54406
611,556,55,707,191100,54407
425,365,60,570,126500,54408
5689,4037,1652,616,93000,54409
838,773,65,583,146200,54410
1894,1639,255,670,141700,54411
798,672,126,586,158800,54412
59,45,14,444,101100,54413
1292,1071,221,544,132300,54414
709,553,156,513,90900,54416
11,10,1,-,95000,54417
387,323,64,700,119000,54418
482,391,91,654,138800,54420
1246,871,375,574,113300,54421
378,308,70,563,108100,54422
884,812,72,650,182600,54423
728,678,50,596,161800,54424
783,565,218,621,110800,54425
1585,1362,223,621,147700,54426
468,372,96,675,134700,54427
483,418,65,536,160000,54428
50,39,11,705,112500,54430
729,618,111,475,120500,54433
923,796,127,660,142000,54435
774,668,106,686,113600,54436
1156,872,284,528,120500,54437
1224,1088,136,649,157900,54440
310,287,23,604,182400,54441
463,411,52,775,169800,54442
881,752,129,527,169000,54443
1140,852,288,618,103500,54446
210,174,36,629,115000,54447
1638,1407,231,633,173600,54448
11361,7636,3725,598,149700,54449
190,98,92,515,58500,54450
5090,3758,1332,598,133800,54451
8001,6006,1995,610,120700,54452
542,424,118,717,124200,54454
6609,5557,1052,826,162400,54455
2507,1948,559,584,114900,54456
3541,3034,507,760,120000,54457
34,27,7,580,135400,54458
573,503,70,620,111800,54459
1022,811,211,517,96200,54460
162,141,21,660,113000,54462
257,229,28,733,176800,54463
305,293,12,-,166500,54465
1189,939,250,562,139100,54466
5705,3703,2002,754,166400,54467
693,550,143,788,98400,54469
888,641,247,546,124700,54470
684,630,54,750,181000,54471
1026,883,143,675,158800,54473
1635,1157,478,681,127900,54474
656,564,92,598,138400,54475
7674,4670,3004,756,145700,54476
1521,1289,232,592,123900,54479
555,374,181,692,112300,54480
11414,6158,5256,650,130200,54481
3657,3127,530,723,171000,54482
1955,1588,367,608,153900,54484
141,120,21,-,160000,54485
987,777,210,518,111700,54486
4548,3645,903,660,162300,54487
430,356,74,521,118200,54488
650,562,88,502,133400,54489
370,293,77,527,126200,54490
695,585,110,569,116600,54491
252,243,9,506,125400,54493
11728,9301,2427,686,122000,54494
3444,2079,1365,628,90000,54495
858,702,156,554,111900,54498
1173,881,292,560,119600,54499
8139,6462,1677,754,138700,54501
561,500,61,533,125700,54511
403,327,76,810,247000,54512
200,173,27,608,116000,54513
861,726,135,550,146800,54514
226,209,17,850,93000,54515
55,54,1,-,207100,54517
600,533,67,821,243400,54519
1846,1203,643,450,124600,54520
3811,2790,1021,715,184100,54521
384,235,149,510,139700,54524
109,72,37,396,71300,54525
347,290,57,611,91800,54526
477,403,74,488,83100,54527
453,434,19,625,204700,54529
357,329,28,675,77400,54530
587,563,24,713,212700,54531
1145,824,321,460,75300,54534
107,83,24,-,50500,54536
223,213,10,431,115700,54537
1510,928,582,543,179200,54538
522,476,46,677,178900,54539
477,384,93,446,190000,54540
468,358,110,468,133100,54541
224,210,14,-,95000,54542
492,428,64,863,299200,54545
559,433,126,489,92500,54546
756,561,195,608,206900,54547
2116,1829,287,720,229500,54548
313,268,45,513,79700,54550
2065,1546,519,517,109200,54552
529,410,119,825,172800,54554
2331,1762,569,684,139100,54555
589,463,126,417,89800,54556
465,434,31,921,305200,54557
987,754,233,704,203600,54558
324,221,103,405,116300,54559
266,214,52,763,176900,54560
26,26,0,-,227300,54561
892,764,128,630,265500,54562
313,269,44,750,113600,54563
228,220,8,625,109800,54564
36,35,1,-,85000,54565
583,462,121,487,125900,54566
2298,1760,538,684,167600,54568
19948,10979,8969,761,146100,54601
6364,3472,2892,651,123000,54603
726,545,181,618,161900,54610
478,364,114,625,106300,54611
1848,1281,567,756,142900,54612
788,678,110,647,117700,54613
1135,861,274,676,149700,54614
4119,2930,1189,604,126900,54615
1015,723,292,661,128800,54616
810,682,128,830,136000,54618
1217,991,226,705,151700,54619
483,422,61,659,175700,54621
938,788,150,492,137000,54622
767,661,106,618,169400,54623
657,571,86,582,149000,54624
130,81,49,552,153800,54625
507,407,100,625,117200,54626
775,605,170,607,163800,54627
422,346,76,590,153500,54628
1103,863,240,650,165500,54629
1663,1178,485,679,159500,54630
746,654,92,544,112600,54631
437,388,49,739,164700,54632
1626,1270,356,642,131600,54634
746,586,160,643,135200,54635
5359,4227,1132,889,187200,54636
82,51,31,634,85800,54637
602,474,128,608,136700,54638
988,796,192,582,124300,54639
1,1,0,-,-,54641
774,588,186,713,152900,54642
2,2,0,-,-,54643
548,447,101,811,160800,54644
37,24,13,807,68300,54645
1456,1161,295,803,114900,54646
569,459,110,666,118500,54648
9607,7145,2462,811,169000,54650
542,449,93,570,120700,54651
378,301,77,575,118800,54652
325,237,88,794,138500,54653
48,35,13,-,93900,54654
735,560,175,633,142300,54655
7228,4980,2248,757,133200,54656
152,125,27,708,116000,54657
1068,870,198,738,172300,54658
530,366,164,613,141400,54659
6425,3887,2538,808,141900,54660
1556,1216,340,676,176000,54661
619,509,110,658,115800,54664
3439,2556,883,581,143200,54665
1082,815,267,806,143100,54666
1844,1441,403,693,141800,54667
2955,2295,660,801,184200,54669
563,470,93,728,148800,54670
15867,9189,6678,756,169100,54701
17449,10610,6839,773,139500,54703
2980,1995,985,769,151700,54720
551,442,109,638,133700,54721
1419,997,422,678,140700,54722
522,422,100,642,157800,54723
2941,2227,714,670,148600,54724
1119,875,244,650,123900,54725
656,531,125,684,117400,54726
1991,1625,366,682,145700,54727
2556,2029,527,658,153700,54728
13377,9030,4347,770,161200,54729
1922,1596,326,752,158400,54730
251,200,51,617,88900,54731
1146,845,301,636,116400,54732
486,381,105,688,124300,54733
323,290,33,713,144400,54734
1600,1276,324,561,135100,54736
222,167,55,954,146300,54737
1199,973,226,578,178100,54738
1733,1369,364,860,167200,54739
812,628,184,644,135000,54740
666,550,116,642,120800,54741
1729,1399,330,650,158800,54742
860,779,81,646,184000,54745
299,226,73,767,114800,54746
1089,690,399,669,132300,54747
581,500,81,702,131500,54748
495,387,108,657,166100,54749
434,394,40,787,160400,54750
9343,5658,3685,717,156000,54751
744,531,213,521,114000,54754
2936,2174,762,702,149200,54755
404,325,79,546,156100,54756
1356,1153,203,700,151500,54757
1808,1414,394,673,132600,54758
638,518,120,586,146500,54759
98,47,51,663,155400,54760
444,333,111,672,143800,54761
500,387,113,660,114800,54762
468,400,68,679,145300,54763
24,21,3,-,54200,54765
620,538,82,667,121200,54766
1317,1080,237,878,170600,54767
1749,1231,518,590,117300,54768
246,217,29,625,217000,54769
830,678,152,680,146100,54770
1521,1181,340,631,121800,54771
406,308,98,626,131500,54772
1340,981,359,579,139000,54773
2980,2228,752,660,147600,54801
556,404,152,663,98400,54805
4889,3226,1663,656,121300,54806
990,825,165,656,169500,54810
1989,1321,668,661,106300,54812
240,204,36,588,164800,54813
1074,741,333,498,166100,54814
1080,879,201,692,167100,54817
1138,889,249,575,103100,54819
344,296,48,668,149300,54820
658,592,66,650,179200,54821
1843,1398,445,809,134500,54822
937,681,256,732,150800,54824
312,277,35,821,157100,54826
120,115,5,-,153400,54827
351,244,107,525,150900,54828
2260,1676,584,618,152600,54829
1552,1375,177,653,163800,54830
207,155,52,600,164900,54832
417,340,77,588,121000,54835
402,346,56,775,157000,54836
1552,1238,314,590,126300,54837
569,504,65,659,189100,54838
128,109,19,-,129200,54839
1954,1545,409,607,132300,54840
140,119,21,688,86100,54841
54,48,6,-,125000,54842
5129,3643,1486,656,171600,54843
141,133,8,-,172400,54844
56,55,1,-,87300,54845
235,216,19,595,101700,54846
1016,879,137,608,175200,54847
2522,1699,823,621,101000,54848
807,705,102,748,173800,54849
99,89,10,-,195800,54850
1763,1384,379,716,152900,54853
381,326,55,770,148800,54854
230,217,13,725,156700,54855
651,572,79,629,134900,54856
27,18,9,-,-,54857
780,533,247,636,115600,54858
783,608,175,732,144700,54859
67,23,44,-,-,54861
156,138,18,725,83800,54862
539,450,89,903,172100,54864
231,213,18,538,132000,54865
189,144,45,674,86000,54867
6842,4730,2112,639,149000,54868
726,653,73,780,189700,54870
1360,1018,342,571,141800,54871
1220,887,333,638,126900,54872
1303,1092,211,612,171700,54873
1451,1340,111,998,151100,54874
502,402,100,717,114600,54875
653,513,140,750,173500,54876
12937,7653,5284,718,121400,54880
611,540,71,738,147300,54888
1096,765,331,630,137700,54889
1509,1166,343,630,154000,54891
1827,1413,414,588,159700,54893
469,386,83,761,154200,54895
715,599,116,648,121300,54896
13794,6690,7104,687,116900,54901
10091,6263,3828,639,110500,54902
8740,6834,1906,752,191400,54904
878,772,106,547,124400,54909
10446,6164,4282,698,131000,54911
7704,5537,2167,836,239600,54913
12779,8019,4760,698,139700,54914
16383,11598,4785,695,160700,54915
439,400,39,654,105900,54921
569,446,123,650,123900,54922
3818,2596,1222,596,129600,54923
245,192,53,770,187500,54927
150,142,8,-,120700,54928
3592,2791,801,684,115900,54929
664,560,104,646,133500,54930
118,106,12,-,138500,54931
524,501,23,638,182000,54932
98,72,26,781,86200,54933
121,69,52,-,105600,54934
17553,10466,7087,684,123000,54935
7467,5944,1523,861,176900,54937
1694,1509,185,669,180100,54940
1105,829,276,668,184100,54941
3192,2868,324,797,221200,54942
817,698,119,594,121400,54943
3277,2828,449,683,196000,54944
1538,1216,322,585,148900,54945
0,0,0,-,-,54946
1002,935,67,830,172500,54947
102,82,20,792,141700,54948
1377,1086,291,591,138200,54949
1213,975,238,592,118700,54950
10832,7205,3627,706,131600,54952
18332,12898,5434,755,153600,54956
1240,1144,96,644,148900,54960
5699,4146,1553,683,141900,54961
501,420,81,597,149400,54962
2701,2007,694,694,163700,54963
389,328,61,986,211900,54964
577,519,58,756,168000,54965
771,621,150,683,132200,54966
181,120,61,526,80000,54967
1218,971,247,688,117300,54968
1280,930,350,649,107900,54970
4504,3166,1338,679,129200,54971
558,469,89,663,165400,54974
563,503,60,761,181000,54977
562,512,50,980,170600,54979
52,33,19,-,126400,54980
6268,4365,1903,732,141000,54981
2888,2236,652,663,134700,54982
1773,1431,342,752,142800,54983
1340,1110,230,722,146500,54984
0,0,0,-,-,54985
2003,1662,341,593,192700,54986
1155,1112,43,1469,408700,55001
937,646,291,909,198600,55003
1489,1377,112,1414,198300,55005
1497,1101,396,827,120900,55006
909,820,89,772,131300,55007
5601,4244,1357,902,161300,55008
3123,2492,631,808,227000,55009
3528,3438,90,1406,227600,55011
706,623,83,987,224100,55012
2722,2239,483,724,245000,55013
9859,8488,1371,1058,211100,55014
11707,10068,1639,1172,216000,55016
295,273,22,956,169000,55017
383,367,16,-,278400,55018
705,629,76,1267,206000,55019
1248,1211,37,2113,303700,55020
10849,7713,3136,738,160900,55021
11622,10312,1310,1122,213100,55024
8909,7006,1903,981,237300,55025
174,171,3,-,253100,55026
1110,953,157,863,202500,55027
37,37,0,-,87900,55029
502,459,43,775,149000,55030
805,699,106,868,267200,55031
1240,1173,67,538,217400,55032
11865,9017,2848,839,212100,55033
37,28,9,781,66700,55036
1966,1342,624,681,119900,55037
7399,6554,845,1362,249500,55038
4854,4032,822,850,165100,55040
3318,2662,656,840,167900,55041
3100,2878,222,1016,384100,55042
1467,1297,170,1069,221800,55043
17321,15014,2307,1212,303700,55044
2912,2514,398,739,205800,55045
1806,1534,272,1262,192300,55046
972,842,130,1457,365500,55047
885,776,109,727,151200,55049
3721,2793,928,745,134800,55051
770,673,97,788,150200,55052
404,388,16,1000,209800,55053
815,725,90,825,279000,55054
1377,836,541,794,180100,55055
4936,4283,653,875,172500,55056
8118,5815,2303,760,224100,55057
11517,8495,3022,730,151400,55060
3678,2868,810,694,151400,55063
414,365,49,1102,246800,55065
7838,5415,2423,759,165800,55066
10083,8690,1393,1157,220900,55068
1815,1335,480,716,165400,55069
2685,2267,418,902,167000,55070
2095,1626,469,986,163300,55071
1384,957,427,750,120400,55072
1255,1164,91,-,304000,55073
787,674,113,1031,173000,55074
8256,5487,2769,850,160700,55075
8923,6544,2379,1031,191000,55076
4922,2977,1945,971,337000,55077
3057,2795,262,990,200600,55079
963,911,52,1278,208400,55080
13793,10927,2866,1074,302100,55082
638,499,139,776,180700,55084
171,152,19,950,175800,55085
138,120,18,-,115200,55087
659,594,65,1210,368100,55088
720,671,49,595,277100,55089
163,141,22,1319,125700,55090
3950,3376,574,1224,199200,55092
4221,872,3349,1099,164100,55101
8916,3524,5392,813,181100,55102
4905,1731,3174,713,151800,55103
16964,8725,8239,837,193200,55104
10900,7230,3670,897,303200,55105
17836,9738,8098,862,132200,55106
5371,2905,2466,804,162200,55107
6251,3006,3245,929,245100,55108
13220,8604,4616,894,185700,55109
15885,12433,3452,982,216900,55110
4,0,4,-,-,55111
17064,11679,5385,888,213700,55112
17419,10714,6705,923,224600,55113
1624,361,1263,963,193200,55114
3278,2754,524,943,314000,55115
11298,5938,5360,930,280800,55116
15999,8828,7171,851,171900,55117
11962,8016,3946,878,216300,55118
15292,9407,5885,881,156700,55119
1824,1464,360,1097,302600,55120
3707,1739,1968,1043,196300,55121
13001,9019,3982,1039,224200,55122
9440,7305,2135,1147,292400,55123
19316,15180,4136,1119,218100,55124
16384,12616,3768,1329,264800,55125
11095,9001,2094,1157,238600,55126
7645,6611,1034,1191,252600,55127
11586,8779,2807,1037,198200,55128
7899,6369,1530,1629,348100,55129
5176,1731,3445,745,138600,55130
84,41,43,1148,225000,55150
0,0,0,-,-,55155
3859,3058,801,981,196900,55301
2870,2480,390,823,208500,55302
17624,13075,4549,962,199600,55303
15731,14620,1111,1354,248600,55304
9408,5256,4152,1187,295700,55305
6433,4123,2310,1096,232200,55306
1304,938,366,562,140700,55307
3067,2552,515,1208,198000,55308
6143,5535,608,832,179800,55309
576,513,63,525,102100,55310
12858,11141,1717,1415,331700,55311
627,527,100,795,127300,55312
8438,6336,2102,932,211800,55313
489,392,97,650,120200,55314
1796,1670,126,940,306700,55315
8670,7331,1339,1130,205700,55316
7455,6369,1086,1203,322300,55317
9880,6755,3125,1020,252100,55318
1992,1847,145,1113,222300,55319
1870,1593,277,772,195000,55320
1861,1355,506,711,170100,55321
1216,1054,162,1125,248500,55322
506,427,79,850,244500,55324
1720,1427,293,770,212100,55325
1258,1203,55,-,244200,55327
3266,2774,492,710,259000,55328
819,608,211,671,127300,55329
13156,10896,2260,1057,202100,55330
6902,5677,1225,915,465000,55331
719,547,172,669,92900,55332
346,255,91,483,74100,55333
1189,842,347,588,114600,55334
666,551,115,671,94800,55335
3172,2521,651,762,147500,55336
18162,11650,6512,1022,211700,55337
381,357,24,880,154200,55338
390,343,47,695,183000,55339
2410,2214,196,1457,382800,55340
994,968,26,669,269200,55341
794,626,168,738,104400,55342
11491,5253,6238,1030,213900,55343
7085,2320,4765,1189,221500,55344
8864,7056,1808,1175,315200,55345
6397,5632,765,1455,302700,55346
11233,9993,1240,1450,368800,55347
1558,1148,410,779,173400,55349
7502,5519,1983,773,151600,55350
3162,2412,750,1000,250900,55352
1222,1095,127,813,182700,55353
1063,904,159,510,157100,55354
3871,2937,934,723,146500,55355
2024,1654,370,1049,542600,55356
1165,1061,104,663,312700,55357
2009,1678,331,915,200200,55358
2357,1998,359,835,319900,55359
942,843,99,1125,208700,55360
6771,5340,1431,972,190300,55362
1685,1377,308,886,158200,55363
5965,4792,1173,864,300200,55364
182,149,33,539,78600,55366
389,317,72,736,180700,55367
904,565,339,561,182600,55368
14254,11365,2889,1242,216200,55369
317,296,21,1031,196700,55370
6137,4884,1253,907,163200,55371
11615,9925,1690,1135,305400,55372
2061,1611,450,874,195600,55373
5002,4159,843,1235,277000,55374
1541,1385,156,1288,276500,55375
5273,4680,593,1537,223300,55376
9859,8504,1355,1110,264500,55378
14145,10815,3330,1154,224400,55379
845,683,162,618,147200,55381
1439,1298,141,950,220800,55382
1003,213,790,991,327800,55384
525,411,114,681,110000,55385
2469,2268,201,919,383800,55386
4669,3695,974,875,261300,55387
2289,1763,526,631,184700,55388
984,863,121,531,139700,55389
925,818,107,1053,190400,55390
6556,5276,1280,1068,500500,55391
1158,909,249,659,141300,55395
873,688,185,692,113900,55396
1114,903,211,783,189300,55397
5246,4572,674,1090,189000,55398
5122,2245,2877,1471,315700,55401
217,0,217,1258,-,55402
10924,2156,8768,831,270000,55403
12040,1864,10176,723,186200,55404
7397,2669,4728,841,331600,55405
15019,10225,4794,866,197300,55406
14421,7943,6478,918,183400,55407
15280,3630,11650,932,238300,55408
4885,3026,1859,1029,220700,55409
8432,6629,1803,1149,370500,55410
9471,3703,5768,915,127500,55411
8387,4820,3567,928,122900,55412
6332,2481,3851,947,208500,55413
10460,2069,8391,907,247400,55414
1404,592,812,1252,323600,55415
15660,8184,7476,1127,303400,55416
10938,8745,2193,994,228000,55417
13140,8577,4563,919,194800,55418
10745,8496,2249,1037,298900,55419
9076,5889,3187,937,187200,55420
11373,6759,4614,910,155300,55421
12501,8663,3838,1004,187200,55422
14954,9240,5714,898,188100,55423
3426,3061,365,1060,620300,55424
3895,1964,1931,968,191300,55425
11715,6999,4716,994,220300,55426
9682,6887,2795,904,210600,55427
12072,6854,5218,896,164100,55428
10337,5444,4893,867,143700,55429
8036,4912,3124,974,131100,55430
8036,5384,2652,1084,230100,55431
12275,8049,4226,914,164800,55432
13526,9372,4154,1018,162900,55433
11179,9255,1924,958,163400,55434
6774,3228,3546,1266,249200,55435
5538,4296,1242,1335,436200,55436
7885,5578,2307,1006,252600,55437
7321,5619,1702,1144,273800,55438
3485,3075,410,1115,470000,55439
7805,4332,3473,1073,293800,55441
5624,4295,1329,1345,300800,55442
10918,8308,2610,1081,218700,55443
4985,4251,734,1134,175100,55444
3644,3272,372,1385,189000,55445
8846,6648,2198,1323,346700,55446
8470,6608,1862,1190,300600,55447
10405,8656,1749,1147,184400,55448
9616,8279,1337,1408,240700,55449
0,0,0,-,-,55450
3158,390,2768,539,141000,55454
0,0,0,-,-,55455
31,31,0,-,240600,55601
99,86,13,-,134400,55602
316,294,22,629,155600,55603
1508,1250,258,652,258200,55604
302,137,165,702,100900,55605
148,133,15,-,298800,55606
65,64,1,-,185700,55607
110,110,0,-,-,55609
460,254,206,-,242200,55612
94,89,5,-,202100,55613
1165,1007,158,647,107600,55614
149,105,44,745,181300,55615
3343,2537,806,720,170000,55616
212,197,15,1125,180600,55702
350,318,32,541,133600,55703
447,338,109,407,140600,55704
1401,1165,236,515,86000,55705
863,663,200,640,75700,55706
1343,1148,195,726,157100,55707
426,298,128,511,78100,55708
1684,1417,267,673,161800,55709
526,489,37,327,191300,55710
182,157,25,533,155700,55711
239,217,22,767,141900,55712
500,396,104,459,76500,55713
159,124,35,675,63100,55716
137,129,8,-,220200,55717
1303,1073,230,673,171900,55718
2391,1882,509,509,86800,55719
6364,4778,1586,678,150400,55720
1490,1335,155,721,192300,55721
427,311,116,677,121900,55722
1045,867,178,722,152900,55723
354,335,19,675,154900,55724
69,65,4,-,412500,55725
446,328,118,862,182800,55726
2872,2210,662,536,168400,55731
621,569,52,746,114100,55732
1631,1473,158,894,205600,55733
2721,2004,717,586,105500,55734
751,651,100,689,159300,55735
672,573,99,418,121000,55736
219,206,13,1063,103900,55738
1553,1347,206,568,116000,55741
171,166,5,-,156000,55742
8525,6391,2134,624,163500,55744
7589,5408,2181,574,100200,55746
661,470,191,571,129000,55748
193,182,11,1000,145700,55749
922,816,106,767,66000,55750
647,606,41,875,130700,55751
182,178,4,-,130400,55752
439,387,52,914,64500,55753
161,148,13,-,173200,55756
349,299,50,800,141100,55757
60,52,8,-,61900,55758
1557,1218,339,633,173600,55760
296,259,37,865,141200,55763
245,159,86,331,79700,55764
340,297,43,588,102800,55765
18,13,5,-,225000,55766
1559,1074,485,699,143000,55767
1334,874,460,522,143800,55768
1051,852,199,799,129500,55769
791,614,177,625,92600,55771
32,11,21,754,-,55772
615,551,64,941,174200,55775
1507,1382,125,948,200000,55779
71,58,13,731,163300,55780
324,322,2,-,295700,55781
216,192,24,643,74500,55782
919,815,104,796,160800,55783
41,40,1,-,98300,55784
98,96,2,-,153800,55785
142,112,30,515,91200,55786
249,219,30,675,175700,55787
1008,787,221,900,211900,55790
4657,2742,1915,529,93100,55792
237,214,23,825,147600,55793
557,463,94,826,136600,55795
584,536,48,1111,166800,55797
261,215,46,684,146600,55798
1331,416,915,420,300000,55802
7120,6084,1036,1032,190800,55803
5813,4985,828,1017,183400,55804
4761,1459,3302,690,116000,55805
4147,1721,2426,683,101400,55806
4438,2989,1449,695,113900,55807
2538,1722,816,653,113700,55808
3648,3129,519,721,152300,55810
10453,7320,3133,902,185400,55811
3492,1717,1775,818,192800,55812
0,0,0,-,-,55814
21524,14577,6947,925,169500,55901
9629,7010,2619,959,257900,55902
10079,7297,2782,731,143000,55904
0,0,0,-,-,55905
7282,5856,1426,750,204000,55906
544,448,96,463,121000,55909
574,457,117,678,167700,55910
11270,7774,3496,705,107500,55912
1402,1193,209,668,142000,55917
423,355,68,454,113600,55918
463,377,86,600,156800,55919
2596,2277,319,885,202500,55920
1990,1614,376,605,155800,55921
312,242,70,428,97500,55922
1793,1394,399,711,202500,55923
571,491,80,592,140200,55924
443,410,33,1021,186900,55925
302,240,62,419,155900,55926
1541,1207,334,615,141400,55927
453,384,69,900,164700,55929
162,142,20,638,110700,55931
780,627,153,562,180100,55932
96,79,17,750,104700,55933
1262,1072,190,612,181800,55934
352,287,65,700,181600,55935
720,568,152,672,129400,55936
785,609,176,592,127300,55939
987,817,170,725,159100,55940
379,316,63,780,159800,55941
1290,1059,231,667,151000,55943
2715,2226,489,622,163300,55944
522,459,63,958,170300,55945
1318,1015,303,766,162900,55946
3167,2574,593,652,194800,55947
756,626,130,529,170800,55949
66,49,17,-,79200,55950
599,484,115,675,112500,55951
881,646,235,619,162500,55952
354,293,61,700,108900,55953
610,496,114,710,100800,55954
943,870,73,940,238400,55955
777,646,131,685,191200,55956
269,222,47,713,157600,55957
917,807,110,673,130900,55959
1272,1179,93,658,290100,55960
169,140,29,625,108800,55961
308,253,55,692,155400,55962
2007,1559,448,928,200100,55963
1780,1441,339,640,150400,55964
1052,828,224,622,138100,55965
356,333,23,800,177700,55967
60,43,17,950,147500,55968
411,355,56,575,171600,55969
387,332,55,750,127000,55970
1233,936,297,659,159700,55971
1642,1300,342,621,177400,55972
111,98,13,850,158000,55973
845,657,188,488,108900,55974
1832,1488,344,591,125900,55975
3017,2362,655,828,169300,55976
73,54,19,-,183300,55977
348,274,74,600,188500,55979
1846,1413,433,691,172900,55981
175,155,20,625,155100,55982
643,477,166,592,153200,55983
738,595,143,598,135600,55985
13486,8861,4625,628,149200,55987
351,293,58,613,103500,55990
544,429,115,751,239300,55991
2029,1593,436,618,193100,55992
18179,10231,7948,792,168500,56001
6117,4438,1679,803,173400,56003
9119,6469,2650,622,103400,56007
589,504,85,610,115100,56009
466,382,84,625,132500,56010
2925,2586,339,818,196400,56011
2016,1434,582,538,92100,56013
311,238,73,706,73500,56014
397,353,44,479,101700,56016
639,551,88,741,188300,56017
373,312,61,629,115900,56019
55,55,0,-,59700,56020
403,338,65,742,183700,56021
31,31,0,-,23900,56022
202,163,39,613,81600,56023
1131,848,283,1065,168000,56024
218,201,17,675,100500,56025
770,659,111,673,157400,56026
403,314,89,775,56000,56027
521,460,61,638,215400,56028
327,279,48,538,90400,56029
5335,3776,1559,579,122500,56031
133,115,18,619,53200,56032
156,142,14,594,64500,56033
230,193,37,938,168000,56034
144,130,14,-,123000,56035
773,662,111,642,111200,56036
640,558,82,633,172200,56037
408,335,73,529,110400,56039
448,393,55,750,146300,56041
260,226,34,550,102200,56042
244,212,32,450,100000,56043
877,694,183,674,173000,56044
352,296,56,675,117400,56045
41,28,13,910,85000,56046
64,46,18,638,80000,56047
1550,1352,198,671,150500,56048
629,515,114,671,174800,56050
332,270,62,555,52100,56051
324,293,31,932,226300,56052
352,305,47,583,133000,56054
1530,1238,292,750,159900,56055
32,31,1,-,54500,56056
1555,1231,324,630,160500,56057
2409,1811,598,644,157400,56058
179,143,36,538,71800,56060
1307,938,369,679,111100,56062
1126,917,209,703,268500,56063
1012,822,190,661,139800,56065
441,384,57,500,117300,56068
1779,1451,328,688,160500,56069
4127,3522,605,819,234600,56071
887,736,151,554,122600,56072
7003,5508,1495,604,144900,56073
763,636,127,633,171800,56074
79,69,10,630,62700,56075
161,134,27,919,126900,56078
278,231,47,589,139300,56080
2445,1753,692,560,97900,56081
4587,3117,1470,855,176800,56082
381,334,47,361,90000,56083
2177,1731,446,583,130900,56085
1235,1002,233,575,96600,56087
773,607,166,611,96700,56088
85,58,27,575,43300,56089
271,210,61,806,122400,56090
143,119,24,521,103000,56091
4833,3442,1391,600,144700,56093
1304,997,307,738,174900,56096
1630,1254,376,564,97000,56097
917,676,241,572,88600,56098
2542,1986,556,593,99600,56101
819,672,147,466,104800,56110
169,140,29,610,115600,56111
107,93,14,650,85000,56113
133,109,24,688,76100,56114
525,442,83,614,116700,56115
271,210,61,650,122800,56116
119,91,28,706,90600,56117
148,131,17,488,133800,56118
389,319,70,489,113400,56119
420,347,73,713,64500,56120
263,217,46,615,58300,56121
258,181,77,679,100600,56122
235,215,20,1025,99400,56123
38,35,3,-,36600,56125
168,137,31,675,66100,56127
815,680,135,701,116200,56128
350,301,49,479,77900,56129
1026,795,231,620,108700,56131
218,179,39,591,168800,56132
206,160,46,521,97500,56134
491,381,110,575,74600,56136
496,386,110,603,86700,56137
371,296,75,733,103100,56138
177,151,26,500,113500,56139
23,21,2,-,47500,56140
128,109,19,470,78600,56141
471,352,119,526,80500,56142
1935,1352,583,563,124500,56143
499,425,74,654,87300,56144
243,208,35,475,58100,56145
24,24,0,-,49200,56146
63,56,7,750,87100,56147
535,420,115,503,112800,56149
1123,946,177,614,107000,56150
324,292,32,575,109600,56151
593,473,120,526,81400,56152
94,91,3,-,55000,56153
144,127,17,1063,96900,56155
2453,1703,750,671,147500,56156
302,267,35,728,150400,56157
179,150,29,477,98300,56158
1114,811,303,639,77400,56159
83,76,7,-,75600,56160
143,123,20,456,75000,56161
90,86,4,433,80000,56162
2402,1705,697,537,93800,56164
172,151,21,1069,107300,56165
89,84,5,700,73800,56166
299,235,64,613,71100,56167
348,288,60,681,114100,56168
273,231,42,663,116100,56169
259,218,41,-,81500,56170
751,565,186,807,97400,56171
1397,1119,278,502,98500,56172
138,112,26,980,110900,56173
144,109,35,613,60800,56174
1236,955,281,475,84300,56175
468,377,91,492,67800,56176
24,24,0,-,-,56177
688,573,115,628,104400,56178
537,380,157,504,84000,56180
456,373,83,613,84500,56181
567,471,96,479,69200,56183
244,196,48,625,84200,56185
146,113,33,460,89000,56186
4878,3089,1789,649,128200,56187
9082,5571,3511,663,150000,56201
85,72,13,825,91700,56207
984,650,334,508,66400,56208
937,789,148,597,137300,56209
1,1,0,-,-,56210
189,149,40,522,75800,56211
217,194,23,517,66200,56212
308,255,53,811,75000,56214
1936,1262,674,631,111200,56215
268,235,33,850,115500,56216
239,218,21,663,106900,56218
390,331,59,522,48000,56219
1266,968,298,557,99600,56220
280,210,70,555,81800,56221
748,565,183,609,99100,56222
561,423,138,561,83800,56223
135,124,11,830,73300,56224
313,258,55,829,87200,56225
95,87,8,-,99600,56226
90,86,4,-,109100,56227
413,322,91,692,79700,56228
714,536,178,665,159600,56229
334,291,43,689,87800,56230
167,145,22,1021,114000,56231
1056,797,259,554,84800,56232
224,193,31,583,118800,56235
142,129,13,800,110200,56236
217,192,25,444,78400,56237
209,194,15,425,126900,56239
415,317,98,532,94400,56240
1647,1197,450,604,119200,56241
645,490,155,697,129700,56243
463,369,94,583,117000,56244
226,181,45,669,89500,56245
363,300,63,416,80300,56248
128,110,18,500,80000,56249
381,295,86,582,143800,56251
484,373,111,616,105700,56252
459,408,51,763,165100,56253
136,118,18,489,85700,56255
1132,871,261,575,76600,56256
238,209,29,490,52500,56257
6027,3544,2483,615,150700,56258
336,291,45,756,84200,56260
274,216,58,575,70000,56262
231,197,34,500,93800,56263
858,720,138,713,106200,56264
3235,2296,939,549,108600,56265
666,548,118,536,87400,56266
2564,1609,955,709,160600,56267
363,301,62,577,76500,56270
468,392,76,683,105100,56271
1936,1645,291,791,210000,56273
48,46,2,-,112500,56274
145,130,15,-,70800,56276
1267,946,321,660,115500,56277
1182,900,282,466,110800,56278
452,396,56,850,170700,56279
212,172,40,595,89400,56280
269,229,40,698,129000,56281
542,442,100,638,120600,56282
2617,1973,644,670,115400,56283
874,696,178,546,94100,56284
456,369,87,-,75900,56285
22,21,1,-,54200,56287
1921,1683,238,739,241500,56288
286,261,25,497,229400,56289
193,167,26,475,122300,56291
234,199,35,580,79500,56292
450,371,79,517,105200,56293
32,32,0,-,58300,56294
125,109,16,-,69200,56295
964,790,174,536,75700,56296
350,279,71,568,96100,56297
11522,6146,5376,796,176500,56301
10870,6426,4444,689,138400,56303
6219,3211,3008,682,141200,56304
1959,1625,334,701,169600,56307
10779,7814,2965,733,195200,56308
535,451,84,684,159700,56309
1995,1811,184,682,203300,56310
269,222,47,783,119300,56311
902,730,172,781,159100,56312
31,23,8,1375,-,56313
472,415,57,782,160900,56314
619,571,48,754,173000,56315
590,489,101,625,139000,56316
462,434,28,625,211600,56318
570,504,66,743,167800,56319
3188,2780,408,790,192700,56320
0,0,0,-,-,56321
246,190,56,496,95400,56323
434,377,57,546,213100,56324
84,66,18,783,120800,56325
625,528,97,554,139300,56326
292,277,15,725,247700,56327
61,48,13,675,95000,56328
2644,2272,372,597,167100,56329
636,569,67,818,163200,56330
723,656,67,814,185700,56331
593,563,30,914,242100,56332
2540,1980,560,667,167300,56334
92,88,4,-,95400,56335
638,586,52,604,214100,56336
681,633,48,798,177100,56338
487,372,115,517,117700,56339
902,761,141,602,176000,56340
1215,1017,198,638,161800,56342
409,363,46,554,130600,56343
6173,4478,1695,645,147400,56345
2710,2060,650,604,119600,56347
323,278,45,663,133000,56349
234,221,13,-,136200,56350
2228,1757,471,783,152300,56352
3331,2662,669,729,143700,56353
572,514,58,618,193800,56354
203,169,34,688,174500,56355
122,109,13,755,114900,56356
383,364,19,944,203200,56357
1283,1097,186,898,151000,56358
1431,912,519,683,134800,56359
1622,1324,298,722,160700,56360
949,771,178,590,137300,56361
2453,1932,521,576,160300,56362
67,30,37,788,100000,56363
2028,1703,325,714,162300,56364
2460,2245,215,665,177000,56367
1750,1615,135,619,214900,56368
261,150,111,632,139200,56369
43,39,4,900,108800,56371
1135,949,186,664,175500,56373
3056,2406,650,722,181000,56374
325,289,36,604,161700,56375
128,124,4,167,122400,56376
6869,4709,2160,888,186800,56377
3105,2200,905,580,167600,56378
6675,4644,2031,679,158300,56379
1015,818,197,535,141500,56381
541,463,78,488,162500,56382
162,77,85,616,112500,56384
363,299,64,783,129200,56385
284,221,63,650,172000,56386
3331,1272,2059,780,141700,56387
38,36,2,-,85000,56389
12243,8512,3731,715,165800,56401
3202,2147,1055,944,192100,56425
4127,3404,723,638,172600,56431
810,668,142,721,163000,56433
79,73,6,675,101800,56434
1146,974,172,823,146400,56435
27,19,8,-,123400,56436
538,432,106,627,91900,56437
1115,965,150,575,134200,56438
516,406,110,425,99200,56440
1553,1096,457,904,115100,56441
1033,909,124,811,356600,56442
597,545,52,845,196100,56443
1382,1188,194,550,221600,56444
649,530,119,396,108200,56446
493,442,51,950,240200,56447
136,127,9,-,253800,56448
651,618,33,964,206000,56449
441,360,81,853,153800,56450
961,787,174,641,251200,56452
350,293,57,672,120200,56453
670,517,153,727,117600,56455
18,14,4,-,137500,56456
147,113,34,725,166300,56458
1347,1179,168,776,169500,56461
1725,1353,372,555,140600,56464
859,784,75,942,229800,56465
1405,1094,311,604,141800,56466
1085,965,120,820,202900,56467
1941,1738,203,805,285900,56468
524,501,23,907,164600,56469
4500,3404,1096,524,184200,56470
3186,2644,542,673,196000,56472
1445,1206,239,909,172800,56473
1770,1385,385,693,142600,56474
654,543,111,679,134600,56475
1013,856,157,641,124100,56477
2194,1655,539,571,115500,56479
856,748,108,549,123200,56481
2783,1938,845,592,109700,56482
1561,1152,409,671,182400,56484
7290,5456,1834,727,187000,56501
928,685,243,482,86200,56510
769,674,95,675,203100,56511
1447,1193,254,630,150600,56514
1413,1172,241,683,263800,56515
106,91,15,283,84400,56516
109,84,25,825,85700,56517
128,115,13,842,142000,56518
130,107,23,821,101400,56519
1831,1262,569,480,109000,56520
286,248,38,688,135900,56521
204,185,19,975,72200,56522
216,167,49,525,103800,56523
297,264,33,763,202600,56524
46,46,0,-,105900,56525
319,286,33,525,119900,56527
710,656,54,743,216900,56528
1632,1167,465,734,163800,56529
869,675,194,538,90400,56531
114,95,19,366,107500,56533
486,424,62,800,175000,56534
528,443,85,510,157500,56535
203,181,22,410,123000,56536
7918,5566,2352,605,147800,56537
817,670,147,719,112700,56540
4,4,0,-,-,56541
1171,846,325,628,125300,56542
97,85,12,875,108800,56543
1969,1677,292,640,173100,56544
298,269,29,661,99700,56545
104,100,4,-,172500,56546
927,852,75,650,176400,56547
303,248,55,600,91100,56548
1731,1426,305,798,189200,56549
167,149,18,533,83500,56550
888,713,175,541,141500,56551
171,158,13,458,109300,56552
121,117,4,-,114600,56553
1067,940,127,582,216800,56554
466,348,118,598,104400,56556
1050,715,335,528,90100,56557
15971,10246,5725,752,167900,56560
24,24,0,-,85000,56565
169,84,85,347,62200,56566
1364,1000,364,606,132100,56567
81,69,12,-,97500,56568
501,359,142,357,115100,56569
481,422,59,860,178900,56570
743,660,83,850,218700,56571
2185,1746,439,603,186500,56572
2597,1994,603,732,174200,56573
90,79,11,-,91300,56574
307,246,61,519,124600,56575
287,250,37,810,238900,56576
2,2,0,-,-,56577
303,270,33,-,231700,56578
490,423,67,672,109100,56579
461,444,17,713,170800,56580
111,98,13,608,61200,56581
45,40,5,-,60000,56583
582,475,107,702,81100,56584
436,355,81,804,119900,56585
799,722,77,686,191600,56586
609,531,78,625,207200,56587
250,221,29,600,189000,56588
786,591,195,550,121000,56589
130,110,20,-,85300,56590
58,51,7,369,72500,56591
178,157,21,625,79700,56592
0,0,0,-,-,56593
194,167,27,675,161100,56594
13054,8950,4104,710,161600,56601
1843,1336,507,608,116600,56621
1088,854,234,643,148800,56623
122,93,29,621,60700,56626
152,109,43,414,55000,56627
777,642,135,807,169000,56628
83,81,2,-,168800,56629
775,606,169,560,111800,56630
1673,1144,529,548,101400,56633
636,523,113,455,122400,56634
1976,1631,345,601,150200,56636
89,74,15,820,132500,56637
185,164,21,731,173100,56639
114,101,13,275,174100,56641
320,280,40,345,95500,56644
195,163,32,567,153700,56646
345,315,30,738,138800,56647
4272,3389,883,584,109300,56649
293,248,45,375,107400,56650
245,206,39,825,117000,56651
194,184,10,775,122600,56652
557,440,117,584,98300,56653
62,47,15,938,120300,56654
696,599,97,396,259700,56655
149,145,4,-,227600,56657
0,0,0,-,-,56658
28,22,6,-,167900,56659
136,121,15,-,85500,56660
395,331,64,540,100900,56661
292,267,25,625,255000,56662
73,73,0,-,96100,56663
244,119,125,528,58800,56666
231,213,18,-,156900,56667
48,35,13,-,147500,56668
172,147,25,1136,157500,56669
385,220,165,552,73300,56670
880,422,458,581,58700,56671
968,781,187,570,174600,56672
267,248,19,-,97900,56673
663,595,68,655,139300,56676
496,430,66,716,134800,56678
78,75,3,-,164100,56680
130,98,32,657,150000,56681
295,279,16,1563,190200,56683
119,104,15,-,107500,56684
54,49,5,-,129700,56685
395,382,13,-,73000,56686
24,23,1,-,102100,56687
69,64,5,-,131300,56688
5522,3993,1529,603,126300,56701
257,207,50,603,91900,56710
20,7,13,-,-,56711
402,344,58,476,93800,56713
503,422,81,538,96500,56714
149,122,27,300,109100,56715
3477,2354,1123,623,111600,56716
7,7,0,-,45000,56720
4070,2827,1243,722,172800,56721
163,134,29,725,155800,56722
398,312,86,595,173800,56723
66,56,10,-,85000,56724
342,301,41,671,101300,56725
629,506,123,608,104100,56726
297,247,50,566,113300,56727
579,466,113,530,88000,56728
64,60,4,-,39500,56729
37,30,7,817,40000,56731
492,353,139,473,77700,56732
209,194,15,630,63500,56733
210,175,35,450,54100,56734
308,268,40,497,83600,56735
467,404,63,666,210900,56736
390,332,58,427,98100,56737
580,515,65,521,110700,56738
0,0,0,-,-,56741
344,278,66,533,80800,56742
229,196,33,475,113600,56744
285,219,66,643,101400,56748
991,812,179,452,112300,56750
2223,1741,482,707,128700,56751
187,154,33,813,103000,56754
39,37,2,-,56500,56755
245,214,31,646,117900,56756
416,328,88,478,72800,56757
186,166,20,-,86400,56758
123,107,16,-,98300,56759
165,128,37,881,104400,56760
205,177,28,838,119100,56761
1023,745,278,555,103300,56762
2029,1546,483,652,114900,56763
719,576,143,475,109800,57001
407,326,81,573,137000,57002
712,633,79,586,161000,57003
1381,1045,336,577,142700,57004
4090,3097,993,842,193200,57005
9394,5018,4376,672,167600,57006
232,217,15,-,180200,57010
450,333,117,563,128400,57012
1763,1331,432,654,147200,57013
564,447,117,416,95500,57014
323,287,36,830,117000,57015
257,242,15,-,164200,57016
666,457,209,542,168300,57017
546,463,83,717,148100,57018
490,431,59,1295,167200,57020
112,112,0,-,170800,57021
1711,1426,285,774,162600,57022
167,145,22,713,83500,57024
1096,867,229,783,130800,57025
516,356,160,683,116900,57026
38,26,12,-,75000,57027
1426,981,445,514,106600,57028
794,531,263,537,80600,57029
1141,979,162,642,187600,57030
328,249,79,547,100300,57031
2268,2005,263,808,188500,57032
1765,1449,316,806,205500,57033
277,229,48,453,112500,57034
513,462,51,768,156500,57035
304,254,50,675,84500,57036
362,270,92,576,111900,57037
581,549,32,400,157600,57038
1251,983,268,752,133700,57039
162,152,10,-,48500,57040
74,74,0,-,77800,57041
3522,2508,1014,514,142100,57042
604,464,140,752,87300,57043
486,377,109,409,68800,57045
296,259,37,913,97900,57046
123,64,59,654,71700,57047
442,368,74,493,135000,57048
2618,1704,914,837,216100,57049
71,64,7,-,117900,57050
117,83,34,525,47500,57051
104,74,30,378,78200,57052
782,640,142,775,147300,57053
226,203,23,-,98300,57054
434,368,66,648,227400,57055
63,60,3,-,82500,57057
821,619,202,632,109400,57058
587,440,147,411,61700,57059
36,30,6,-,53300,57061
525,415,110,458,86900,57062
388,310,78,398,71100,57063
1917,1494,423,875,192300,57064
174,127,47,663,87100,57065
657,447,210,491,82000,57066
139,121,18,800,246400,57067
570,505,65,615,159900,57068
4504,2069,2435,695,138800,57069
643,410,233,576,101200,57070
1170,940,230,717,158200,57071
229,216,13,775,133700,57072
294,224,70,752,68000,57073
453,397,56,750,209200,57075
118,81,37,-,106700,57076
529,471,58,697,141700,57077
7597,4831,2766,597,134700,57078
13751,9544,4207,724,150100,57103
11542,4088,7454,611,103700,57104
9040,6113,2927,763,151000,57105
17864,10917,6947,791,163400,57106
3536,2748,788,825,153200,57107
7868,5746,2122,909,266600,57108
5873,3986,1887,814,212600,57110
0,0,0,-,-,57117
0,0,0,-,-,57197
10774,6945,3829,665,164700,57201
843,630,213,600,123300,57212
219,201,18,-,140600,57213
24,21,3,-,65000,57214
477,414,63,690,101000,57216
126,117,9,-,70600,57217
167,152,15,-,137500,57218
226,191,35,431,69400,57219
271,185,86,626,108200,57220
262,199,63,453,84200,57221
513,441,72,630,124100,57223
76,60,16,563,-,57224
827,598,229,522,75100,57225
871,690,181,424,121500,57226
179,163,16,-,113100,57227
795,655,140,347,100400,57231
158,137,21,338,-,57232
59,54,5,-,56100,57233
542,454,88,681,92500,57234
347,302,45,713,113600,57235
22,21,1,-,25400,57236
262,217,45,430,-,57237
247,168,79,516,157300,57238
131,115,16,-,146300,57239
382,297,85,598,120700,57241
142,119,23,-,180100,57242
315,262,53,808,95500,57243
42,42,0,-,97500,57245
81,72,9,-,63800,57246
131,103,28,-,259400,57247
380,323,57,610,127700,57248
459,365,94,388,89300,57249
71,52,19,-,131300,57251
2110,1688,422,561,122500,57252
175,133,42,545,42100,57255
51,50,1,-,52500,57256
209,131,78,494,83800,57257
71,61,10,-,44200,57258
189,150,39,605,112100,57259
400,316,84,741,102100,57260
141,125,16,-,70700,57261
1789,979,810,556,90900,57262
236,171,65,473,81000,57263
93,69,24,638,150800,57264
85,72,13,-,110200,57265
260,192,68,456,81400,57266
190,161,29,708,71100,57268
192,162,30,533,132000,57269
327,149,178,493,59000,57270
77,62,15,725,-,57271
70,60,10,-,60000,57272
488,351,137,454,75000,57273
1296,895,401,538,85800,57274
441,377,64,615,128200,57276
295,237,58,513,79300,57278
467,399,68,531,92300,57279
8032,4717,3315,653,141200,57301
461,414,47,825,122600,57311
244,182,62,677,66400,57312
583,460,123,571,67800,57313
372,278,94,522,73900,57314
432,345,87,465,69500,57315
243,157,86,518,45300,57317
371,290,81,480,88800,57319
162,132,30,535,92500,57321
151,107,44,702,-,57322
98,77,21,460,33500,57323
120,98,22,634,151100,57324
1279,856,423,528,149100,57325
447,349,98,656,83100,57328
107,82,25,-,107700,57329
241,214,27,658,78300,57330
147,119,28,517,98200,57331
281,245,36,492,97700,57332
361,293,68,690,97900,57334
134,93,41,531,69000,57335
66,55,11,-,62100,57337
363,126,237,441,43800,57339
121,96,25,-,106700,57340
58,46,12,-,73800,57341
244,219,25,421,74100,57342
67,57,10,-,89400,57344
518,421,97,612,78800,57345
25,11,14,617,-,57346
223,175,48,708,89400,57348
643,503,140,493,78000,57349
6332,3958,2374,569,107400,57350
331,287,44,344,103200,57353
470,333,137,638,80800,57355
592,403,189,457,54400,57356
23,23,0,-,111300,57358
306,232,74,589,95700,57359
39,4,35,519,-,57361
989,626,363,496,94700,57362
414,302,112,632,90000,57363
16,8,8,-,-,57364
268,210,58,605,127400,57365
996,757,239,648,91400,57366
75,57,18,619,179200,57367
449,334,115,621,88300,57368
977,715,262,523,105900,57369
300,237,63,672,81600,57370
73,59,14,-,-,57371
175,159,16,-,111900,57373
99,95,4,375,67900,57374
331,281,50,545,60500,57375
450,388,62,467,44500,57376
34,34,0,-,93800,57379
1194,735,459,463,89100,57380
277,190,87,545,92500,57381
604,424,180,464,81500,57382
311,258,53,640,46500,57383
371,307,64,535,105700,57384
520,376,144,491,75800,57385
99,93,6,-,108900,57386
13478,8651,4827,621,149400,57401
41,39,2,-,104200,57420
47,30,17,-,56800,57421
142,85,57,-,81000,57422
113,107,6,625,57300,57424
25,25,0,-,-,57426
289,246,43,-,136300,57427
268,220,48,-,58100,57428
44,29,15,-,35800,57429
825,624,201,552,89100,57430
144,130,14,-,88000,57432
148,125,23,507,118800,57433
211,182,29,290,118300,57434
128,109,19,531,58800,57435
189,162,27,335,61100,57436
623,456,167,649,54700,57437
595,424,171,545,83100,57438
42,42,0,-,-,57439
156,101,55,554,63600,57440
287,259,28,675,104000,57441
758,576,182,611,84100,57442
922,717,205,751,160100,57445
152,116,36,357,55400,57446
171,133,38,625,40500,57448
69,69,0,-,223300,57449
294,263,31,525,80100,57450
877,747,130,627,163800,57451
109,95,14,-,51700,57452
223,193,30,719,66300,57454
34,30,4,-,85000,57455
362,265,97,510,53300,57456
40,40,0,-,120500,57457
145,100,45,525,105600,57460
137,134,3,-,93300,57461
140,124,16,525,154500,57465
97,74,23,-,82700,57466
108,88,20,431,36700,57467
106,79,27,650,75800,57468
1461,969,492,541,74000,57469
31,18,13,-,58000,57470
261,221,40,398,64300,57471
409,293,116,609,65200,57472
77,74,3,-,123200,57473
63,61,2,-,85000,57474
59,53,6,-,89000,57475
191,138,53,650,90000,57476
45,36,9,-,52500,57477
247,199,48,841,168800,57479
139,119,20,-,77900,57481
6971,4402,2569,585,172300,57501
67,40,27,-,55000,57520
78,60,18,-,50700,57521
216,170,46,680,90000,57522
477,317,160,520,69700,57523
374,297,77,543,71500,57528
154,106,48,-,111100,57529
96,89,7,-,56300,57531
1238,945,293,681,148800,57532
907,630,277,517,64400,57533
105,76,29,-,-,57534
164,111,53,468,76300,57536
44,38,6,-,-,57537
111,100,11,638,60000,57538
32,30,2,-,-,57540
96,30,66,526,-,57541
369,294,75,243,57900,57543
206,170,36,644,82600,57544
59,54,5,-,-,57547
362,131,231,447,44600,57548
715,469,246,514,61800,57551
193,165,28,479,58500,57552
69,41,28,-,57900,57553
1251,565,686,445,48500,57555
286,167,119,375,54600,57559
113,67,46,388,-,57560
20,17,3,-,153800,57562
84,41,43,-,31900,57563
419,327,92,509,135200,57564
309,103,206,492,67900,57566
662,516,146,650,79500,57567
289,238,51,567,61400,57568
156,139,17,650,103000,57569
571,243,328,427,38400,57570
9,6,3,-,-,57571
414,162,252,399,40800,57572
52,45,7,-,74200,57574
74,58,16,-,57100,57576
289,62,227,502,45000,57577
484,343,141,405,43600,57579
1890,1248,642,574,86000,57580
33,29,4,-,43600,57584
96,65,31,-,30800,57585
1656,1045,611,582,84200,57601
207,153,54,540,59000,57620
74,9,65,432,"10,000-",57621
82,26,56,413,17500,57622
317,197,120,610,61000,57623
1235,667,568,529,62000,57625
374,275,99,543,81100,57626
15,15,0,-,112500,57630
154,135,19,521,112500,57631
285,240,45,-,64100,57632
150,103,47,500,67500,57633
40,36,4,-,142900,57634
49,15,34,485,42500,57636
867,624,243,519,70000,57638
86,27,59,393,39400,57639
67,32,35,-,145000,57640
132,87,45,513,40800,57641
598,248,350,407,54600,57642
121,85,36,-,72100,57644
77,59,18,708,69200,57645
108,102,6,-,59500,57646
171,131,40,450,66400,57648
83,59,24,283,59500,57649
16,9,7,-,-,57650
49,27,22,-,76900,57651
85,61,24,510,53600,57652
277,201,76,484,67400,57656
71,65,6,-,76300,57657
104,50,54,381,38800,57658
41,39,2,-,112500,57660
23,12,11,661,110000,57661
17896,9970,7926,724,140700,57701
14336,10916,3420,878,220400,57702
5474,4646,828,934,154100,57703
895,3,892,988,-,57706
168,60,108,425,81300,57714
154,100,54,458,61000,57716
3167,2243,924,641,128200,57717
2751,2359,392,839,149000,57718
2691,1748,943,862,148500,57719
284,190,94,546,88700,57720
202,176,26,-,98000,57722
65,53,12,500,88300,57724
101,73,28,-,235500,57725
2545,1993,552,817,213100,57730
1039,672,367,587,160500,57732
659,518,141,757,57300,57735
57,53,4,-,87900,57738
16,0,16,-,-,57741
912,781,131,1179,222600,57744
1040,818,222,572,193400,57745
2484,1764,720,604,142600,57747
143,79,64,500,-,57748
117,80,37,458,114100,57750
277,219,58,530,200800,57751
456,305,151,552,16400,57752
1776,1246,530,586,109700,57754
28,28,0,-,133300,57755
182,98,84,267,25000,57756
56,34,22,-,-,57758
91,91,0,-,-,57759
616,500,116,604,87600,57760
426,373,53,605,138100,57761
302,259,43,608,83900,57762
127,98,29,530,67200,57763
361,219,142,425,25100,57764
108,62,46,419,152600,57766
62,62,0,-,162500,57767
1437,1337,100,1055,198800,57769
1206,544,662,507,17900,57770
413,224,189,474,16400,57772
142,125,17,650,169200,57773
82,72,10,-,95000,57775
0,0,0,-,-,57776
69,57,12,-,82300,57779
45,39,6,-,-,57780
38,35,3,-,55900,57782
6609,3904,2705,661,212300,57783
4314,2864,1450,615,170000,57785
146,112,34,610,97100,57787
149,112,37,-,269500,57788
451,322,129,602,118100,57790
92,80,12,-,68000,57791
36,36,0,-,197500,57792
874,754,120,670,199200,57793
151,49,102,471,43300,57794
4,0,4,-,-,57799
20,19,1,-,202500,58001
25,25,0,-,50700,58002
82,79,3,-,172900,58004
269,265,4,-,218900,58005
202,137,65,529,126400,58006
32,19,13,-,82500,58007
81,75,6,-,101800,58008
10,10,0,-,-,58009
163,142,21,383,125000,58011
1003,730,273,655,171500,58012
51,44,7,-,33000,58013
118,112,6,-,151900,58015
41,39,2,-,131900,58016
148,114,34,483,50000,58017
123,118,5,-,201900,58018
149,132,17,556,158700,58021
659,454,205,665,96700,58027
69,59,10,-,-,58029
254,203,51,488,84400,58030
236,203,33,941,-,58031
355,233,122,559,96400,58032
151,119,32,538,87700,58033
124,99,25,336,50600,58035
128,128,0,-,161700,58036
138,119,19,486,151300,58038
432,277,155,664,98800,58040
671,564,107,396,88600,58041
583,562,21,1304,214100,58042
64,54,10,-,61400,58043
954,686,268,526,138200,58045
309,231,78,541,96800,58046
1391,1253,138,776,266500,58047
214,178,36,606,97500,58048
184,172,12,-,160200,58049
606,498,108,591,206500,58051
232,178,54,573,158800,58052
548,417,131,481,55000,58053
1334,858,476,557,117300,58054
103,97,6,-,55000,58056
29,27,2,-,61700,58057
49,42,7,-,46700,58058
472,416,56,850,175900,58059
511,403,108,599,102200,58060
151,143,8,-,97800,58061
81,60,21,-,253800,58062
125,91,34,709,-,58063
185,148,37,578,88700,58064
16,16,0,-,24000,58065
125,102,23,248,71000,58067
188,152,36,-,130800,58068
52,44,8,-,87500,58069
205,170,35,425,118600,58071
3664,2281,1383,663,100000,58072
3916,2388,1528,550,116500,58075
0,0,0,-,-,58076
242,225,17,488,163400,58077
12500,8442,4058,770,191600,58078
209,203,6,-,171700,58079
385,333,52,667,95500,58081
13643,6870,6773,631,162200,58102
23689,8539,15150,702,153000,58103
14728,7449,7279,867,244200,58104
0,0,0,-,-,58105
17055,8683,8372,782,191000,58201
0,0,0,-,-,58202
7552,2899,4653,751,145600,58203
715,5,710,1202,-,58204
0,0,0,-,-,58205
177,140,37,575,58800,58210
324,194,130,475,81300,58212
171,134,37,-,140400,58214
37,37,0,-,38300,58216
317,262,55,888,134700,58218
19,19,0,-,172900,58219
1055,778,277,540,102700,58220
148,131,17,413,70300,58222
129,127,2,-,89800,58223
27,27,0,-,94600,58224
459,340,119,487,89100,58225
220,178,42,625,66000,58227
382,264,118,638,118600,58228
50,35,15,775,61700,58229
309,231,78,638,55600,58230
176,149,27,-,54500,58231
107,91,16,-,88100,58233
159,135,24,575,87400,58235
2392,1594,798,528,86600,58237
66,59,7,-,-,58238
17,17,0,-,109800,58239
480,374,106,493,99500,58240
61,54,7,-,74800,58241
243,211,32,628,63400,58243
74,57,17,-,75000,58244
1171,947,224,506,95900,58249
131,112,19,667,70600,58250
835,606,229,567,114400,58251
247,185,62,375,56800,58254
318,263,55,784,158700,58256
845,534,311,565,105800,58257
98,88,10,900,155600,58258
200,166,34,408,69400,58259
89,87,2,-,81700,58260
483,425,58,719,87000,58261
23,16,7,-,-,58262
219,190,29,875,98300,58265
85,75,10,531,77500,58266
573,459,114,571,114800,58267
85,74,11,-,50000,58269
820,601,219,567,89500,58270
316,239,77,531,92300,58271
123,101,22,431,84600,58272
114,92,22,513,82500,58273
389,323,66,488,118100,58274
280,228,52,692,118500,58275
246,198,48,645,68900,58276
124,89,35,334,85000,58277
699,645,54,669,178300,58278
43,43,0,-,-,58281
689,516,173,498,63600,58282
4433,2674,1759,530,117100,58301
24,15,9,-,-,58311
2146,1347,799,332,73500,58316
101,94,7,-,55000,58317
1701,1267,434,624,162300,58318
60,45,15,-,106900,58321
9,9,0,-,-,58323
584,409,175,503,75300,58324
32,25,7,-,-,58325
128,113,15,-,114100,58327
1020,709,311,344,64200,58329
128,101,27,488,61700,58330
58,55,3,-,82100,58331
177,158,19,500,75700,58332
400,115,285,401,21600,58335
47,41,6,-,-,58338
17,11,6,-,131300,58339
1279,985,294,401,80600,58341
38,30,8,-,-,58343
421,322,99,1010,104600,58344
51,44,7,-,48900,58345
300,225,75,453,80400,58346
323,244,79,505,75500,58348
209,127,82,429,84100,58351
205,162,43,-,80000,58352
29,26,3,-,-,58353
37,37,0,-,101100,58355
808,563,245,454,73800,58356
110,80,30,470,66000,58357
94,84,10,-,75000,58361
17,17,0,-,-,58362
30,28,2,-,55400,58363
134,107,27,400,41000,58365
478,358,120,458,85000,58366
614,392,222,543,79500,58367
1796,1288,508,624,103600,58368
501,411,90,-,69900,58369
379,221,158,449,43400,58370
51,46,5,-,53300,58372
228,169,59,383,60400,58374
115,85,30,1042,65000,58377
113,51,62,417,131300,58379
221,183,38,418,39200,58380
111,97,14,550,86400,58381
77,73,4,-,130400,58382
264,227,37,363,80800,58384
90,77,13,1083,71900,58385
73,73,0,-,89000,58386
7755,4808,2947,630,129600,58401
0,0,0,-,-,58402
0,0,0,-,-,58405
506,425,81,589,61800,58413
65,62,3,-,135700,58415
187,132,55,319,88900,58416
161,151,10,-,57000,58418
118,112,6,-,162500,58420
1284,901,383,523,126000,58421
88,71,17,-,73100,58422
30,28,2,-,78000,58423
111,101,10,-,82600,58424
608,438,170,433,87900,58425
88,79,9,-,164200,58426
99,95,4,-,-,58428
197,155,42,339,105600,58429
48,44,4,-,82900,58430
43,42,1,-,70000,58431
466,376,90,525,93500,58433
820,569,251,463,91800,58436
299,259,40,575,72100,58438
59,58,1,-,115000,58439
69,61,8,-,55800,58440
138,101,37,-,61700,58441
227,194,33,542,67900,58442
83,66,17,388,63000,58443
125,97,28,433,36300,58444
50,33,17,-,68800,58445
144,90,54,363,49100,58448
78,61,17,533,65000,58451
6,6,0,-,-,58452
205,156,49,433,65000,58454
168,140,28,-,63600,58455
244,206,38,513,71100,58456
503,368,135,634,88400,58458
115,100,15,446,52000,58460
209,161,48,836,67500,58461
326,245,81,268,54100,58463
88,72,16,-,51000,58464
162,121,41,631,97900,58466
231,183,48,615,64200,58467
197,169,28,707,116500,58472
1169,851,318,625,117300,58474
95,66,29,-,-,58475
128,105,23,541,69300,58476
91,74,17,-,76700,58477
78,57,21,444,41300,58478
69,58,11,-,71400,58479
137,106,31,765,82500,58480
93,84,9,-,191700,58481
474,326,148,526,114000,58482
123,105,18,356,78300,58483
14,14,0,-,116700,58484
98,70,28,425,141700,58486
185,155,30,336,66100,58487
111,105,6,230,69700,58488
106,81,25,850,75800,58490
189,151,38,667,74800,58492
128,99,29,483,78300,58494
636,472,164,497,74100,58495
99,89,10,663,106300,58496
135,108,27,1069,87800,58497
13320,7659,5661,760,200800,58501
12417,9274,3143,874,270900,58503
10868,8074,2794,772,189300,58504
0,0,0,-,-,58505
141,117,24,650,128900,58520
266,236,30,825,245700,58521
1544,1255,289,580,159900,58523
33,27,6,-,68300,58524
185,55,130,441,94400,58528
266,215,51,600,61200,58529
480,402,78,763,114000,58530
198,185,13,-,203500,58531
115,84,31,864,105000,58532
458,369,89,470,81400,58533
303,263,40,683,79000,58535
652,207,445,451,79200,58538
1112,842,270,614,148300,58540
197,165,32,-,85500,58541
112,106,6,675,58300,58542
256,224,32,425,100000,58544
1519,1276,243,823,161500,58545
78,64,14,-,157500,58549
797,633,164,434,97000,58552
10647,7622,3025,767,188400,58554
382,360,22,-,220000,58558
107,107,0,-,179600,58559
84,73,11,479,123400,58560
473,383,90,604,74900,58561
200,184,16,325,88600,58562
857,701,156,667,126800,58563
55,51,4,-,65000,58564
122,110,12,-,151300,58565
41,41,0,-,-,58566
172,124,48,444,52900,58568
46,44,2,-,92500,58569
134,115,19,638,116100,58570
270,234,36,683,114600,58571
122,109,13,538,172500,58572
278,252,26,463,64200,58573
406,312,94,668,111600,58575
400,336,64,717,127900,58576
860,688,172,719,180000,58577
565,456,109,411,135300,58579
167,145,22,991,92700,58580
117,93,24,640,-,58581
10094,6423,3671,911,232500,58601
54,44,10,-,162500,58620
625,428,197,593,114000,58621
717,538,179,804,155000,58622
995,737,258,615,167800,58623
134,100,34,-,86400,58625
139,125,14,850,114800,58626
65,60,5,-,137500,58627
198,179,19,1330,121500,58630
466,379,87,638,110200,58631
99,45,54,425,181300,58632
68,55,13,-,246900,58634
310,237,73,672,119600,58636
458,391,67,608,87200,58638
789,586,203,461,151900,58639
581,430,151,794,169200,58640
45,45,0,-,307100,58641
129,103,26,1161,154200,58642
93,76,17,588,50000,58643
146,63,83,823,205000,58645
506,411,95,1011,87000,58646
490,421,69,581,153800,58647
179,125,54,429,72100,58649
181,157,24,592,102800,58650
249,200,49,-,110800,58651
475,386,89,1050,140900,58652
280,229,51,495,105500,58653
115,83,32,-,115600,58654
203,177,26,1125,200500,58655
208,183,25,681,156000,58656
13869,8494,5375,882,210800,58701
0,0,0,-,-,58702
8447,5343,3104,995,216200,58703
1681,45,1636,1456,272400,58704
0,0,0,-,-,58705
0,0,0,-,-,58707
267,217,50,498,94200,58710
85,53,32,-,160400,58711
67,47,20,-,106300,58712
12,11,1,-,-,58713
70,66,4,-,109100,58716
356,309,47,-,177500,58718
288,199,89,718,108200,58721
512,411,101,1270,204400,58722
105,93,12,288,113000,58723
101,83,18,1063,116200,58725
129,88,41,905,165000,58727
637,516,121,544,113600,58730
106,90,16,-,122200,58731
124,123,1,-,158700,58733
122,115,7,-,97900,58734
152,151,1,-,238600,58735
280,216,64,515,66400,58736
75,63,12,-,63800,58737
314,236,78,938,170500,58740
219,192,27,665,125000,58741
50,42,8,-,75000,58744
540,432,108,725,115200,58746
58,50,8,-,-,58748
281,239,42,852,152200,58750
88,54,34,443,116300,58752
33,23,10,-,43800,58755
73,60,13,511,137500,58756
235,106,129,492,62500,58757
127,126,1,-,77400,58758
374,288,86,427,104700,58759
120,88,32,1107,108300,58760
403,296,107,678,110400,58761
124,96,28,500,110500,58762
1298,761,537,508,139000,58763
176,138,38,-,125000,58765
94,85,9,-,203100,58768
90,76,14,630,81000,58769
429,256,173,711,105000,58770
258,163,95,1332,156300,58771
75,59,16,850,77000,58772
360,269,91,879,141300,58773
99,27,72,400,101600,58775
90,69,21,1141,-,58776
90,89,1,-,195800,58778
211,162,49,570,110900,58779
242,209,33,675,181300,58781
159,139,20,525,95000,58782
201,168,33,921,97200,58783
1114,838,276,723,191500,58784
464,399,65,1131,196100,58785
96,72,24,-,109000,58787
595,492,103,391,84400,58788
138,108,30,811,65000,58789
763,556,207,563,179400,58790
120,115,5,-,158600,58792
263,167,96,521,82500,58793
54,40,14,-,120000,58794
63,47,16,-,119600,58795
10918,6843,4075,939,232000,58801
111,111,0,-,87200,58830
214,183,31,1563,185200,58831
35,33,2,-,103800,58833
81,76,5,-,152800,58835
69,49,20,1125,193800,58838
146,144,2,-,245800,58843
80,63,17,-,131600,58844
141,105,36,510,155200,58845
116,92,24,-,268500,58847
290,230,60,744,208800,58849
681,517,164,891,187500,58852
109,59,50,467,-,58853
2384,1311,1073,1013,209000,58854
69,51,18,992,225000,58856
682,581,101,695,186300,59001
75,49,26,1047,151800,59002
391,176,215,495,82200,59003
363,260,103,671,-,59006
68,56,12,550,174000,59007
162,122,40,825,94200,59008
45,34,11,-,141700,59010
1227,887,340,661,198000,59011
89,49,40,963,-,59012
82,69,13,-,-,59013
704,517,187,675,168100,59014
159,138,21,686,147100,59015
249,161,88,654,91200,59016
202,158,44,914,244700,59018
1643,1285,358,757,215700,59019
24,23,1,-,263900,59020
436,264,172,498,81500,59022
195,134,61,-,112500,59024
12,7,5,-,235000,59025
75,72,3,-,143200,59026
330,214,116,862,285700,59027
239,166,73,647,283300,59028
361,323,38,711,132700,59029
610,386,224,631,298900,59030
69,44,25,-,68000,59031
151,123,28,625,85800,59032
116,110,6,-,293300,59033
1846,1071,775,724,111600,59034
33,18,15,-,82500,59035
579,383,196,516,87000,59036
701,610,91,933,199400,59037
316,205,111,577,79300,59038
20,18,2,-,-,59039
753,610,143,750,177500,59041
760,402,358,520,61000,59043
4405,3423,982,722,194500,59044
176,130,46,800,84000,59046
5459,3975,1484,716,212900,59047
371,290,81,495,72900,59050
93,52,41,717,233300,59052
139,65,74,-,312500,59053
124,98,26,391,117600,59054
27,13,14,-,-,59055
259,250,9,475,290500,59057
29,19,10,-,245800,59058
76,52,24,-,68800,59059
92,77,15,615,375000,59061
14,7,7,-,-,59062
777,614,163,581,213300,59063
76,34,42,-,214600,59064
49,44,5,-,1069400,59065
170,103,67,458,98300,59066
107,69,38,625,229200,59067
1564,1143,421,848,256500,59068
213,171,42,769,175900,59069
396,302,94,900,257100,59070
59,52,7,-,525000,59071
1834,1278,556,580,154800,59072
151,111,40,827,127500,59074
58,31,27,-,127100,59075
41,27,14,-,-,59076
26,20,6,-,270000,59077
71,56,15,-,106300,59078
1236,1079,157,735,212200,59079
4,4,0,-,-,59081
16,10,6,-,225000,59082
61,44,17,-,154200,59085
368,281,87,640,212000,59086
173,119,54,484,81000,59087
615,464,151,-,173500,59088
107,68,39,538,80000,59089
16495,9363,7132,698,164800,59101
20787,13744,7043,894,196200,59102
11680,8398,3282,799,212500,59105
5695,4655,1040,1057,331700,59106
1504,928,576,495,119400,59201
72,56,16,-,147200,59211
155,130,25,555,173100,59212
196,104,92,281,90000,59213
56,39,17,-,104700,59214
457,361,96,569,170400,59215
109,48,61,1186,158900,59217
339,257,82,683,174600,59218
94,86,8,-,118800,59219
677,473,204,625,187500,59221
59,54,5,-,74300,59222
143,122,21,-,189100,59223
176,79,97,356,52500,59225
158,112,46,729,112500,59226
1987,1399,588,503,158400,59230
260,118,142,690,32500,59231
10,8,2,-,210000,59240
226,182,44,579,95000,59241
43,28,15,-,113600,59242
93,61,32,907,154200,59243
13,6,7,-,37500,59244
151,126,25,613,151400,59247
309,245,64,522,145400,59248
92,69,23,508,60700,59250
44,41,3,-,104800,59252
45,43,2,-,155400,59253
955,746,209,702,160200,59254
1045,430,615,307,81200,59255
44,30,14,-,306300,59256
32,9,23,-,-,59257
52,31,21,-,118100,59258
166,122,44,457,79100,59259
59,48,11,-,166200,59260
238,196,42,435,79100,59261
243,154,89,681,145800,59262
766,569,197,733,119600,59263
3558,2224,1334,812,213100,59270
115,105,10,-,104900,59274
159,108,51,508,53900,59275
17,17,0,-,-,59276
4764,3313,1451,640,143700,59301
76,69,7,-,49200,59311
5,3,2,-,-,59312
970,688,282,649,154000,59313
49,28,21,-,-,59314
53,46,7,-,156300,59315
510,337,173,554,107700,59317
53,33,20,-,-,59318
22,14,8,-,162500,59322
856,783,73,685,118800,59323
379,309,70,706,86600,59324
142,111,31,-,-,59326
1208,894,314,524,160100,59327
3660,2453,1207,612,162600,59330
75,51,24,-,110200,59332
6,6,0,-,-,59333
80,46,34,545,156300,59336
304,229,75,513,104400,59337
44,39,5,-,173400,59338
69,56,13,-,137500,59339
52,37,15,-,-,59343
182,126,56,725,83300,59344
111,95,16,663,86100,59347
458,421,37,670,78500,59349
68,58,10,-,110700,59351
496,386,110,708,109600,59353
12,6,6,-,-,59354
6640,3385,3255,573,143900,59401
10461,8475,1986,748,180900,59404
13261,7053,6208,699,163700,59405
276,164,112,592,194400,59410
122,77,45,-,141500,59411
636,505,131,541,143600,59412
530,311,219,502,98500,59414
212,176,36,494,138600,59416
2345,1314,1031,427,77600,59417
45,20,25,-,-,59418
61,34,27,492,115000,59419
88,78,10,-,172500,59420
791,588,203,688,206800,59421
1061,671,390,578,141200,59422
23,20,3,-,115000,59424
1352,941,411,663,120200,59425
1505,929,576,603,123400,59427
175,130,45,600,93300,59430
54,44,10,-,86300,59432
259,229,30,575,99600,59433
216,150,66,575,153800,59434
725,523,202,653,171800,59436
74,26,48,-,187500,59440
50,33,17,-,-,59441
745,504,241,537,131600,59442
188,161,27,-,188400,59443
97,38,59,-,87100,59444
233,166,67,425,90700,59446
129,89,40,488,215000,59447
190,94,96,404,55000,59448
219,164,55,700,175000,59450
103,86,17,-,111200,59451
236,195,41,515,133800,59452
136,112,24,575,129200,59453
114,91,23,883,81000,59454
153,47,106,-,-,59456
3958,2786,1172,706,122600,59457
101,83,18,-,68200,59460
13,13,0,-,-,59461
63,55,8,-,122900,59462
65,61,4,-,294600,59463
182,141,41,658,131300,59464
16,9,7,665,87500,59465
36,28,8,-,-,59466
39,31,8,-,210700,59467
234,185,49,850,169000,59468
63,59,4,-,158900,59469
133,83,50,542,155200,59471
299,188,111,1006,97500,59472
1338,774,564,555,143600,59474
167,112,55,495,131300,59477
370,245,125,509,114600,59479
170,154,16,-,151300,59480
219,148,71,750,110500,59482
184,154,30,625,189300,59483
63,41,22,-,120100,59484
217,215,2,-,202800,59485
424,343,81,515,123900,59486
545,438,107,559,158200,59487
145,111,34,475,113100,59489
5018,3295,1723,606,140500,59501
456,317,139,435,116000,59520
983,414,569,296,67600,59521
629,416,213,511,113100,59522
968,699,269,525,111700,59523
259,168,91,565,59500,59524
108,76,32,933,85300,59525
741,371,370,493,71300,59526
305,147,158,375,58900,59527
97,65,32,-,62800,59528
71,46,25,-,209400,59529
38,27,11,-,27000,59530
128,99,29,-,76900,59531
96,81,15,-,126000,59532
32,16,16,-,-,59535
7,4,3,-,-,59537
1276,892,384,498,136000,59538
128,114,14,729,68800,59540
51,36,15,244,68000,59542
91,38,53,294,-,59544
13,7,6,-,-,59545
35,28,7,-,165600,59546
20,20,0,-,-,59547
13274,7510,5764,765,209100,59601
9783,8146,1637,929,227300,59602
99,84,15,392,133300,59631
750,547,203,729,149200,59632
118,115,3,-,290200,59633
1777,1654,123,971,317400,59634
2690,2048,642,776,184000,59635
0,0,0,-,-,59636
251,195,56,717,305400,59638
471,393,78,560,171800,59639
52,52,0,-,216700,59640
26,13,13,-,-,59642
278,208,70,523,158900,59643
1683,1321,362,634,176700,59644
668,460,208,631,120400,59645
125,117,8,-,-,59647
239,187,52,658,230600,59648
14358,9336,5022,587,130500,59701
15,13,2,-,364300,59703
106,81,25,-,253600,59710
3960,2839,1121,502,123100,59711
68,35,33,635,188400,59713
7131,5053,2078,875,230800,59714
13614,7083,6531,797,370600,59715
753,432,321,1315,344300,59716
12673,7867,4806,1077,276400,59718
152,148,4,-,462500,59720
159,129,30,644,176600,59721
1889,1277,612,533,133500,59722
42,25,17,-,177500,59724
3427,2146,1281,589,167800,59725
121,104,17,950,213900,59727
161,128,33,630,150000,59728
999,740,259,792,326300,59729
906,576,330,838,439100,59730
60,55,5,-,156300,59731
68,24,44,1050,195000,59732
79,63,16,554,227500,59733
105,79,26,-,160400,59735
41,21,20,575,212500,59736
132,109,23,708,107500,59739
101,83,18,-,411000,59740
1712,1349,363,860,248400,59741
64,40,24,-,131300,59743
53,31,22,-,251600,59745
46,41,5,-,295000,59746
96,90,6,-,155000,59747
83,75,8,-,130400,59748
653,537,116,686,199800,59749
192,177,15,-,227900,59750
111,71,40,816,145800,59751
1468,1103,365,745,225500,59752
377,287,90,825,172100,59754
108,89,19,630,184400,59755
0,0,0,-,-,59756
870,422,448,581,250900,59758
1649,1366,283,661,195700,59759
114,67,47,663,221200,59760
133,72,61,538,185000,59761
106,90,16,-,320800,59762
13781,5382,8399,766,227700,59801
9035,4289,4746,740,235100,59802
6517,4877,1640,751,274700,59803
3162,1988,1174,952,290700,59804
7752,5407,2345,853,221200,59808
591,461,130,928,211900,59820
952,766,186,563,197600,59821
715,550,165,968,261800,59823
537,368,169,581,208100,59824
994,796,198,773,222000,59825
252,226,26,588,303700,59826
124,105,19,-,170800,59827
2112,1658,454,663,276000,59828
992,768,224,547,232400,59829
18,9,9,-,-,59830
182,128,54,433,82000,59831
353,234,119,509,160900,59832
1995,1646,349,963,304800,59833
761,617,144,-,291100,59834
157,126,31,468,211400,59837
6114,3898,2216,719,197200,59840
172,114,58,550,150000,59841
7,7,0,-,-,59842
87,55,32,588,220800,59843
300,246,54,643,211500,59844
558,383,175,479,109100,59845
462,445,17,-,286800,59846
2054,1683,371,667,229600,59847
69,45,24,423,145800,59848
86,65,21,-,114200,59851
427,330,97,498,166700,59853
102,75,27,625,277100,59854
344,82,262,663,65000,59855
126,109,17,525,146600,59856
543,392,151,590,218100,59858
1330,1052,278,650,202600,59859
4368,2978,1390,650,233000,59860
33,25,8,-,96900,59863
2581,1684,897,628,193000,59864
1306,1011,295,634,157500,59865
326,222,104,591,150000,59866
17,7,10,-,-,59867
754,611,143,605,212700,59868
4090,3185,905,752,240300,59870
100,43,57,-,264100,59871
914,648,266,295,200000,59872
1524,1065,459,788,201700,59873
537,466,71,603,231200,59874
1503,1062,441,747,262400,59875
20109,13922,6187,808,218900,59901
245,228,17,-,227900,59910
3578,2895,683,935,312200,59911
5518,3926,1592,764,200600,59912
253,161,92,766,200800,59913
107,84,23,717,-,59914
207,108,99,-,-,59915
60,49,11,-,341700,59916
1860,1543,317,676,147600,59917
274,231,43,696,145800,59918
292,241,51,-,55400,59919
714,620,94,675,270100,59920
1219,815,404,962,303200,59922
4225,3146,1079,600,160900,59923
504,420,84,942,251100,59925
103,41,62,-,-,59926
140,120,20,792,282400,59927
103,103,0,-,285000,59928
116,78,38,-,283300,59929
253,216,37,-,226500,59930
135,110,25,-,425000,59931
517,486,31,-,243400,59932
28,25,3,-,-,59933
228,205,23,525,260700,59934
1671,1401,270,593,194600,59935
159,114,45,819,293800,59936
5608,3875,1733,856,324700,59937
9035,7154,1881,935,198900,60002
19782,15654,4128,1224,330800,60004
12719,8371,4348,1120,294500,60005
13523,9955,3568,1085,261200,60007
8355,5841,2514,1212,212500,60008
16215,14567,1648,1366,527700,60010
3835,3465,370,1865,297800,60012
8957,7793,1164,1202,218800,60013
17290,13233,4057,1174,210600,60014
9520,8263,1257,1602,503000,60015
23166,15253,7913,1039,213300,60016
10225,7211,3014,935,227200,60018
4318,3004,1314,898,133300,60020
2063,1794,269,947,244100,60021
2934,2769,165,1164,887800,60022
14563,11903,2660,1201,419600,60025
5362,3770,1592,1691,552600,60026
136,134,2,-,798600,60029
14029,10765,3264,1102,205400,60030
13809,10044,3765,1193,241100,60031
4525,2835,1690,969,143000,60033
751,513,238,1012,157100,60034
11539,9542,1997,1561,535200,60035
2007,831,1176,1122,350600,60040
3629,2895,734,988,173000,60041
3197,2659,538,1350,155400,60042
797,724,73,-,1095600,60043
3741,2681,1060,1334,470800,60044
7182,6245,937,1771,817500,60045
12296,10281,2015,1150,208000,60046
13705,12475,1230,1322,412600,60047
10436,8665,1771,1189,435000,60048
12339,8605,3734,1095,168600,60050
8978,7193,1785,1212,190900,60051
8139,7526,613,1516,283700,60053
20534,14188,6346,983,294600,60056
12931,10034,2897,1166,240300,60060
9892,6967,2925,1236,326500,60061
15683,12818,2865,1607,493200,60062
4839,2138,2701,898,102400,60064
15364,11725,3639,1185,341700,60067
14017,11469,2548,1235,397400,60068
3360,2722,638,2371,436300,60069
5936,3950,1986,985,261300,60070
1492,995,497,850,203400,60071
303,251,52,1125,278900,60072
18113,13987,4126,1191,142800,60073
14315,8724,5591,1085,220200,60074
10809,8504,2305,1213,289800,60076
10269,6413,3856,1113,247400,60077
3428,2891,537,1319,267900,60081
3588,2922,666,1684,239700,60083
5972,4572,1400,1039,218600,60084
22709,9443,13266,863,99000,60085
9256,5714,3542,1001,124600,60087
1148,0,1148,1527,-,60088
15835,12490,3345,1404,299800,60089
14088,8651,5437,1142,176000,60090
9609,8318,1291,1713,636300,60091
6671,5889,782,1679,890900,60093
2527,1889,638,1083,191900,60096
4113,3385,728,1116,144800,60097
11987,7893,4094,948,187300,60098
10871,6646,4225,977,130300,60099
13108,8715,4393,932,226600,60101
11173,9878,1295,1358,242000,60102
14032,12661,1371,1379,263100,60103
6039,4266,1773,1063,116000,60104
6897,3762,3135,1028,211200,60106
13341,11210,2131,1582,171200,60107
8976,6356,2620,1187,284700,60108
198,138,60,1269,168100,60109
11075,7566,3509,1004,151000,60110
107,99,8,-,272200,60111
1370,1156,214,970,141600,60112
152,82,70,875,123300,60113
15938,6442,9496,840,154200,60115
6268,4704,1564,1204,253200,60118
3541,3032,509,1539,281900,60119
15207,9831,5376,993,154900,60120
16058,9871,6187,964,159600,60123
7120,6404,716,2097,280700,60124
16502,13183,3319,1451,378200,60126
62,42,20,983,155000,60129
7287,3834,3453,967,205500,60130
6412,4710,1702,798,171800,60131
11290,8466,2824,1141,168000,60133
10202,8416,1786,1329,326100,60134
2606,1668,938,798,172300,60135
2187,2059,128,1639,255100,60136
14119,11299,2820,984,372500,60137
11408,7290,4118,1115,169200,60139
5745,5111,634,1217,228000,60140
18,0,18,-,-,60141
11158,10354,804,1186,233700,60142
3895,2786,1109,1257,292000,60143
30,16,14,830,200000,60144
919,725,194,978,203100,60145
947,693,254,725,146300,60146
20273,14851,5422,1216,244200,60148
630,515,115,892,144600,60150
1522,1109,413,1274,221600,60151
4564,3497,1067,893,209600,60152
7307,4337,2970,918,133800,60153
6755,6029,726,1333,217100,60154
3361,2249,1112,908,136600,60155
9717,8059,1658,1365,203700,60156
784,774,10,-,346100,60157
7840,4000,3840,872,168700,60160
2983,1836,1147,1009,152000,60162
1746,1441,305,984,166100,60163
6446,4690,1756,863,160700,60164
1311,755,556,1078,121100,60165
11668,7666,4002,1135,200300,60169
4135,2426,1709,888,188700,60171
8937,6916,2021,1252,241100,60172
5844,1817,4027,1285,317900,60173
12387,8647,3740,1086,267000,60174
8188,7842,346,1733,387300,60175
4335,2838,1497,888,178200,60176
7550,6313,1237,1254,199600,60177
8552,5829,2723,958,194800,60178
652,483,169,1683,270400,60180
10436,7232,3204,1180,220900,60181
922,867,55,-,526300,60184
10636,7926,2710,1042,245600,60185
9398,6938,2460,1182,332000,60187
15475,10442,5033,1081,235200,60188
11986,8974,3012,1321,362900,60189
4149,3840,309,1680,299900,60190
5182,4185,997,1278,213800,60191
5496,5022,474,2194,332600,60192
15375,11918,3457,1271,244400,60193
7392,5342,2050,1418,208400,60194
2224,718,1506,1188,194600,60195
15444,8852,6592,1374,444200,60201
13443,7124,6319,1181,287600,60202
1541,1453,88,1490,392700,60203
1399,384,1015,1688,174500,60301
13856,7879,5977,986,378400,60302
6291,4366,1925,1130,352300,60304
3801,3290,511,1215,574600,60305
3052,2589,463,847,171600,60401
20635,12479,8156,924,173500,60402
6933,4493,2440,1022,152100,60403
5995,5371,624,1513,232700,60404
9016,4833,4183,813,111000,60406
625,489,136,896,133800,60407
2146,1539,607,861,157500,60408
14052,7934,6118,930,101500,60409
3955,3578,377,1333,194300,60410
20234,12395,7839,887,98500,60411
5110,2420,2690,936,152800,60415
3297,2368,929,941,179000,60416
5880,4988,892,1030,173500,60417
7502,4874,2628,1115,92100,60419
2149,1398,751,701,139700,60420
1496,1318,178,953,174900,60421
3496,3149,347,2006,220200,60422
10279,9749,530,1415,296700,60423
897,685,212,856,143900,60424
3283,2511,772,974,127700,60425
11090,5262,5828,825,72300,60426
4427,3028,1399,1085,88000,60428
5621,3743,1878,1432,109400,60429
7513,5846,1667,1129,158300,60430
7422,6545,877,1205,172300,60431
6340,3229,3111,888,99000,60432
5427,3181,2246,982,108900,60433
18072,11347,6725,908,150000,60435
6067,3615,2452,989,108800,60436
70,47,23,-,101100,60437
11256,7996,3260,943,124000,60438
8130,6749,1381,1076,348800,60439
16425,12480,3945,1181,176600,60440
11926,9949,1977,1041,197800,60441
3332,2866,466,1306,228600,60442
7717,6315,1402,1170,149700,60443
660,437,223,899,179200,60444
10554,8113,2441,892,147000,60445
11872,9749,2123,1435,166800,60446
4650,4187,463,1402,180300,60447
8549,7760,789,983,283600,60448
3368,3169,199,1287,186300,60449
8185,5442,2743,889,206300,60450
11322,10052,1270,1019,269100,60451
10390,8316,2074,923,183000,60452
21559,17203,4356,1002,187200,60453
5505,4009,1496,885,167500,60455
1938,1579,359,436,104600,60456
4816,3541,1275,888,216600,60457
4991,2626,2365,931,165600,60458
9093,7125,1968,1017,176000,60459
501,373,128,807,114500,60460
1914,1669,245,1667,235300,60461
15406,13298,2108,1119,256500,60462
5537,5181,356,1720,271800,60463
3818,3366,452,1292,367700,60464
6875,5285,1590,986,189300,60465
8569,5343,3226,1056,76800,60466
9661,9354,307,1213,316600,60467
2136,1789,347,787,197500,60468
1780,1341,439,1002,107500,60469
239,192,47,830,156800,60470
5401,2927,2474,1042,138300,60471
1736,780,956,844,72600,60472
7412,6461,951,1418,147900,60473
348,277,71,900,128300,60474
4213,2600,1613,864,110300,60475
1061,777,284,834,115300,60476
15151,11721,3430,1053,200300,60477
5898,4369,1529,1332,130200,60478
246,222,24,817,171300,60479
2098,1741,357,1019,340900,60480
4687,3554,1133,786,166900,60481
4072,2875,1197,885,157600,60482
2507,1412,1095,964,107900,60484
8671,7881,790,1038,250000,60487
5595,5344,251,1859,265300,60490
7926,7367,559,1708,304600,60491
3349,1769,1580,844,156200,60501
7996,6185,1811,1482,277400,60502
4860,4422,438,1752,220400,60503
13171,8089,5082,1324,189200,60504
21166,12051,9115,984,111700,60505
17291,11085,6206,951,164200,60506
10662,8285,2377,1135,286600,60510
598,504,94,1310,237700,60511
733,587,146,-,176300,60512
6865,5182,1683,986,227400,60513
3864,2896,968,933,466400,60514
11303,8359,2944,1073,339700,60515
11433,8959,2474,1261,323900,60516
12612,8581,4031,1135,248300,60517
1352,969,383,754,129400,60518
11,5,6,-,-,60519
1019,782,237,884,186000,60520
5804,4976,828,1794,847600,60521
4397,3616,781,700,696700,60523
11793,9225,2568,972,336100,60525
5206,3565,1641,1072,320500,60526
11528,8752,2776,1276,424800,60527
167,129,38,717,124600,60530
669,528,141,905,170600,60531
12026,7280,4746,1167,298200,60532
3998,2435,1563,957,155900,60534
48,39,9,950,156300,60536
249,222,27,863,180400,60537
9078,7175,1903,1227,172600,60538
0,0,0,-,-,60539
15828,11931,3897,1310,388300,60540
1196,1022,174,833,245600,60541
6197,4922,1275,963,229300,60542
12684,10459,2225,1558,223000,60543
9166,7255,1911,1608,201900,60544
4429,3017,1412,881,151800,60545
5824,4137,1687,909,281200,60546
4145,3145,1000,975,164800,60548
250,183,67,-,148700,60549
620,417,203,797,167700,60550
1540,1159,381,819,180900,60551
1790,1391,399,1005,177800,60552
285,219,66,921,166100,60553
4263,3743,520,994,267700,60554
5016,3965,1051,1358,198300,60555
621,452,169,829,158700,60556
17,17,0,-,-,60557
4387,4196,191,1677,530800,60558
10482,5528,4954,1009,278200,60559
7607,6365,1242,1025,235800,60560
9135,7643,1492,1147,299100,60561
14765,8029,6736,1331,320200,60563
13097,11573,1524,1795,430000,60564
13788,12187,1601,1326,370300,60565
6921,6229,692,1852,299600,60585
13682,12782,900,1525,197000,60586
8248,3434,4814,1973,463300,60601
607,197,410,2255,375400,60602
466,241,225,2343,613400,60603
381,149,232,1964,460400,60604
13320,6470,6850,1847,378100,60605
1999,856,1143,2060,393500,60606
12465,5793,6672,1683,348700,60607
25372,8526,16846,834,226700,60608
19717,7853,11864,789,157500,60609
23208,8855,14353,1398,431300,60610
20267,9169,11098,1816,476300,60611
13300,3342,9958,926,242600,60612
26096,10089,16007,1236,314500,60613
33696,14273,19423,1426,518600,60614
20281,5872,14409,1021,221100,60615
23203,7907,15296,945,292100,60616
27752,16151,11601,785,124800,60617
35533,15340,20193,1078,335600,60618
25789,10648,15141,840,145700,60619
25623,11886,13737,856,132300,60620
11047,2772,8275,804,103000,60621
23600,8455,15145,1264,427800,60622
24958,8484,16474,799,140800,60623
11912,3157,8755,877,159100,60624
29157,11233,17924,1037,312100,60625
22314,5231,17083,918,187200,60626
23528,13060,10468,936,117900,60628
30979,17659,13320,883,147000,60629
20854,12945,7909,1005,274400,60630
11596,8678,2918,1119,323200,60631
24405,12881,11524,828,163700,60632
4721,3268,1453,904,118400,60633
25559,18232,7327,983,232100,60634
11258,5370,5888,867,89200,60636
18877,4937,13940,899,170500,60637
19865,15266,4599,934,195500,60638
25457,11242,14215,925,190700,60639
34543,10226,24317,920,272100,60640
24671,12272,12399,934,259700,60641
9185,3342,5843,1412,380000,60642
17919,13514,4405,944,175100,60643
16490,4615,11875,861,155400,60644
16074,8093,7981,995,257300,60645
10676,7794,2882,888,369500,60646
34086,12583,21503,1092,337500,60647
20735,4613,16122,826,159100,60649
19080,7918,11162,921,152600,60651
13131,10833,2298,1026,158700,60652
13892,3036,10856,726,223600,60653
11526,4346,7180,1930,401200,60654
10078,8759,1319,1036,232600,60655
11887,7761,4126,1019,250100,60656
36872,13605,23267,1370,389700,60657
12452,5245,7207,1063,272500,60659
20329,7341,12988,917,217600,60660
5653,1713,3940,1814,336000,60661
8908,6788,2120,976,255300,60706
15568,10260,5308,946,219400,60707
4190,3599,591,1784,379500,60712
10974,8233,2741,1047,257200,60714
8305,5319,2986,900,158100,60803
21975,10504,11471,855,129000,60804
7256,5759,1497,966,180400,60805
10506,4493,6013,726,89700,60827
12851,7793,5058,796,108200,60901
172,138,34,756,90900,60910
583,478,105,715,131900,60911
186,150,36,829,80700,60912
605,508,97,626,176000,60913
10193,7557,2636,921,166700,60914
4030,2576,1454,815,114100,60915
191,171,20,786,144700,60917
371,308,63,761,85800,60918
208,171,37,740,83600,60919
51,33,18,910,75000,60920
566,328,238,661,78200,60921
850,642,208,794,130900,60922
662,502,160,530,111400,60924
7,7,0,-,61700,60926
804,595,209,614,145200,60927
310,261,49,680,93100,60928
351,245,106,585,86500,60929
332,256,76,920,131700,60930
213,155,58,623,82100,60931
36,27,9,-,77200,60932
110,91,19,625,86300,60933
89,61,28,346,156300,60934
349,315,34,1021,211300,60935
1763,1246,517,572,113400,60936
829,542,287,629,98000,60938
1242,969,273,888,201500,60940
784,599,185,669,161200,60941
2615,1562,1053,540,68800,60942
78,74,4,-,65500,60945
165,118,47,660,76400,60946
666,593,73,673,138700,60948
209,143,66,733,85000,60949
4487,3263,1224,866,183100,60950
305,251,54,757,110800,60951
254,206,48,602,75500,60952
1052,834,218,553,83900,60953
2131,1581,550,809,140200,60954
687,509,178,713,103600,60955
2238,1671,567,567,103100,60957
856,411,445,671,73400,60958
440,330,110,742,81700,60959
400,294,106,607,73300,60960
300,251,49,1125,116000,60961
226,160,66,767,60800,60962
784,541,243,582,75000,60963
1946,1462,484,719,130300,60964
622,463,159,667,62400,60966
159,137,22,650,110600,60968
11,10,1,-,100000,60969
3146,2306,840,546,83700,60970
188,127,61,775,81400,60973
163,132,31,591,50000,60974
481,426,55,516,152700,61001
748,514,234,739,114800,61006
235,188,47,684,122700,61007
12131,9126,3005,713,131300,61008
2927,2371,556,669,170600,61010
898,831,67,1339,205100,61011
862,654,208,750,133900,61012
196,178,18,529,100500,61013
540,437,103,613,105500,61014
330,310,20,592,135700,61015
2077,1671,406,839,160400,61016
376,275,101,607,108400,61018
1457,1339,118,859,145600,61019
997,863,134,817,142100,61020
8861,6513,2348,653,119200,61021
982,772,210,678,143000,61024
2035,1553,482,667,143700,61025
8,0,8,-,-,61027
1000,701,299,660,128200,61028
996,763,233,668,107300,61030
585,481,104,603,112900,61031
13219,8468,4751,616,86800,61032
2739,2276,463,699,193400,61036
52,52,0,-,96000,61037
394,332,62,-,210600,61038
371,279,92,1012,126700,61039
518,394,124,454,85400,61041
240,179,61,417,90700,61042
37,22,15,850,120800,61043
119,96,23,468,145000,61044
1181,985,196,507,134700,61046
850,711,139,723,157000,61047
1638,1257,381,544,119500,61048
211,183,28,850,163600,61049
183,160,23,-,76900,61050
705,516,189,574,101900,61051
424,381,43,821,183400,61052
1205,883,322,497,97000,61053
1715,1141,574,575,96500,61054
72,72,0,-,98800,61057
78,61,17,794,105400,61059
643,454,189,545,104900,61060
3015,2129,886,571,148100,61061
744,655,89,564,122800,61062
1776,1356,420,807,126600,61063
1381,1118,263,686,98800,61064
3412,2905,507,1100,146000,61065
254,226,28,650,116700,61067
5529,3679,1850,713,122800,61068
518,426,92,753,144100,61070
5957,4383,1574,706,86000,61071
4480,3706,774,735,158300,61072
7249,6017,1232,977,165800,61073
1998,1419,579,618,77700,61074
428,355,73,690,144600,61075
20,20,0,-,-,61077
550,415,135,556,112300,61078
67,55,12,933,115600,61079
3833,2914,919,667,124100,61080
8783,6314,2469,646,97100,61081
1210,1033,177,910,162900,61084
1500,1149,351,543,110400,61085
799,589,210,448,90500,61087
2154,1884,270,663,157500,61088
313,258,55,533,97100,61089
54,54,0,-,90500,61091
7785,3989,3796,684,71100,61101
6509,4242,2267,674,79900,61102
9947,5122,4825,669,84200,61103
7502,2403,5099,652,57400,61104
13285,8841,4444,852,122500,61107
11223,7653,3570,773,96800,61108
10780,6504,4276,690,99400,61109
9692,6669,3023,786,111900,61111
95,0,95,2868,-,61112
6307,4590,1717,896,144300,61114
8613,6574,2039,872,115600,61115
15495,10038,5457,704,98100,61201
553,463,90,660,124000,61230
2228,1583,645,585,101300,61231
527,460,67,794,137900,61232
618,425,193,647,110800,61234
606,528,78,572,106800,61235
40,27,13,-,101100,61236
1296,1080,216,730,113900,61238
485,221,264,739,94500,61239
2466,2259,207,990,176800,61240
2600,2309,291,546,117800,61241
459,373,86,716,134900,61242
105,93,12,-,129700,61243
9319,6135,3184,602,112100,61244
1048,863,185,680,136500,61250
140,140,0,-,121300,61251
2373,1791,582,605,127400,61252
4344,3477,867,665,164500,61254
787,669,118,998,144700,61256
488,391,97,695,121200,61257
97,80,17,608,54500,61258
495,394,101,995,164700,61259
413,318,95,576,78500,61260
340,287,53,697,81700,61261
504,473,31,664,155500,61262
248,198,50,378,90000,61263
4780,3717,1063,619,114400,61264
18860,12474,6386,686,115300,61265
2762,2242,520,662,116700,61270
608,478,130,445,86800,61272
1339,1156,183,634,145700,61273
95,58,37,-,80600,61274
1764,1539,225,903,166100,61275
36,36,0,-,126300,61276
1214,967,247,691,92000,61277
137,127,10,575,166300,61278
352,300,52,728,116900,61279
964,843,121,753,155100,61281
3215,2076,1139,686,113700,61282
526,404,122,606,96100,61283
893,778,115,-,173100,61284
674,551,123,734,130200,61285
4376,2734,1642,773,86200,61301
1578,1159,419,718,98800,61310
94,83,11,-,161700,61311
186,147,39,993,104200,61312
77,45,32,-,135200,61313
320,230,90,696,68000,61314
85,67,18,708,48800,61315
130,110,20,850,82500,61316
190,155,35,675,80500,61317
265,211,54,950,110100,61318
470,388,82,706,114100,61319
302,257,45,769,129300,61320
106,87,19,-,80800,61321
510,324,186,637,62200,61322
38,31,7,-,59400,61323
41,30,11,-,-,61324
389,348,41,928,113900,61325
998,807,191,646,105300,61326
554,398,156,785,160000,61327
0,0,0,-,-,61328
514,423,91,671,105000,61329
561,443,118,733,118600,61330
12,12,0,-,-,61331
48,48,0,-,85000,61332
111,108,3,-,87100,61333
269,230,39,880,95400,61334
193,150,43,658,135300,61335
185,166,19,473,118300,61336
171,139,32,775,82100,61337
135,105,30,608,76300,61338
111,82,29,616,96000,61340
2933,2222,711,697,136700,61341
3423,2403,1020,541,126100,61342
135,95,40,675,60500,61344
330,302,28,675,90000,61345
31,31,0,-,59200,61346
1861,1479,382,610,119200,61348
315,261,54,765,93200,61349
9900,6798,3102,727,138000,61350
510,374,136,703,134400,61353
4617,3405,1212,671,117900,61354
4847,3416,1431,578,124300,61356
172,152,20,519,76800,61358
130,110,20,713,82500,61359
1285,940,345,770,164000,61360
462,346,116,638,79400,61361
2486,1857,629,681,106300,61362
110,74,36,486,90000,61363
7885,5810,2075,574,92300,61364
358,239,119,689,124800,61367
609,550,59,741,100000,61368
712,594,118,553,83400,61369
588,440,148,738,121800,61370
73,52,21,1034,98900,61372
852,717,135,780,171500,61373
56,46,10,-,85700,61374
534,519,15,542,153800,61375
985,742,243,632,117600,61376
638,432,206,764,105200,61377
208,176,32,900,109800,61378
528,462,66,673,90600,61379
14061,8254,5807,592,75300,61401
1521,1110,411,521,69400,61410
172,153,19,-,109800,61411
622,519,103,743,71900,61412
442,380,62,548,97500,61413
384,293,91,600,72400,61414
689,580,109,650,84100,61415
100,58,42,438,35700,61416
128,122,6,-,82700,61417
289,248,41,582,94500,61418
75,62,13,-,72900,61419
522,410,112,622,80900,61420
492,406,86,555,82800,61421
1296,965,331,352,63800,61422
209,183,26,-,95000,61423
46,21,25,-,106300,61424
157,145,12,-,116800,61425
48,48,0,-,112500,61426
864,738,126,693,73900,61427
395,395,0,-,209300,61428
322,231,91,650,90600,61430
172,133,39,604,57400,61431
228,210,18,600,81700,61432
23,23,0,-,-,61433
1356,986,370,511,75200,61434
39,39,0,-,84200,61435
381,298,83,644,150000,61436
393,348,45,660,105300,61437
374,304,70,673,111200,61438
112,103,9,645,74400,61439
313,297,16,590,79500,61440
450,375,75,464,84600,61441
296,216,80,382,52800,61442
5799,3816,1983,569,63600,61443
373,327,46,671,78700,61447
1469,1089,380,654,102400,61448
197,177,20,447,68800,61449
763,626,137,550,68300,61450
177,165,12,-,96800,61451
145,129,16,556,63500,61452
303,219,84,540,67600,61453
263,217,46,511,65000,61454
7632,4423,3209,665,109000,61455
378,290,88,900,83200,61458
179,145,34,621,111500,61459
126,96,30,647,74400,61460
4413,3052,1361,539,81700,61462
502,388,114,608,92100,61465
146,106,40,613,75600,61466
383,315,68,647,94500,61467
17,17,0,-,106300,61468
934,710,224,496,72400,61469
180,164,16,618,62800,61470
43,42,1,-,47100,61471
206,180,26,568,122200,61472
650,497,153,564,78300,61473
92,79,13,-,59400,61474
68,51,17,634,121900,61475
192,144,48,-,80900,61476
258,209,49,775,87600,61477
131,124,7,-,141100,61478
66,50,16,-,-,61479
529,345,184,603,82400,61480
264,235,29,675,73900,61482
824,683,141,609,79300,61483
342,299,43,604,50100,61484
193,160,33,718,67100,61485
547,458,89,675,99200,61486
421,355,66,528,84500,61488
394,303,91,625,82100,61489
516,405,111,705,94400,61490
916,726,190,573,92400,61491
739,637,102,473,55700,61501
308,240,68,665,118100,61516
1334,1121,213,760,216600,61517
113,87,26,805,70300,61519
6407,4357,2050,646,88100,61520
4485,3381,1104,689,140000,61523
116,74,42,791,70000,61524
3135,2602,533,885,253900,61525
301,291,10,-,214300,61526
1109,895,214,1088,240700,61528
1041,860,181,611,121700,61529
2569,1931,638,523,141600,61530
1303,1161,142,680,101400,61531
246,231,15,690,91000,61532
959,831,128,673,123300,61533
704,612,92,593,127100,61534
524,524,0,-,204400,61535
1206,960,246,676,134600,61536
1054,825,229,642,94000,61537
94,74,20,655,65000,61539
1163,977,186,528,104100,61540
57,54,3,-,61300,61541
1539,1258,281,517,83100,61542
77,51,26,423,40400,61543
257,220,37,1075,63200,61544
287,245,42,405,105400,61545
1633,1392,241,668,118500,61546
1472,1374,98,789,177500,61547
4334,3607,727,897,209200,61548
7287,5643,1644,858,188200,61550
73,57,16,-,110400,61552
89,77,12,563,59200,61553
17391,12533,4858,668,107100,61554
1159,951,208,793,148800,61559
256,239,17,-,156300,61560
1057,873,184,692,129900,61561
0,0,0,-,-,61562
247,188,59,620,67700,61563
383,311,72,673,76500,61564
613,558,55,711,130800,61565
263,229,34,613,83700,61567
1485,1229,256,727,177500,61568
456,429,27,636,141900,61569
634,489,145,748,109100,61570
9678,7676,2002,759,156900,61571
446,366,80,817,102400,61572
641,111,530,490,210400,61602
6407,3144,3263,700,72100,61603
13166,8400,4766,700,88300,61604
5826,2409,3417,667,38500,61605
2246,820,1426,693,124300,61606
4582,3860,722,834,128600,61607
2253,1619,634,717,81200,61610
10909,8294,2615,684,139000,61611
12811,8247,4564,780,148200,61614
10139,6392,3747,810,191900,61615
2738,1646,1092,673,91100,61616
5,0,5,-,-,61625
15078,7754,7324,714,114700,61701
14613,10035,4578,888,199600,61704
4645,3801,844,780,245500,61705
68,53,15,775,81900,61720
271,210,61,693,118100,61721
176,138,38,734,104500,61722
863,678,185,713,107800,61723
232,202,30,755,99300,61724
569,541,28,875,161000,61725
1032,800,232,759,109500,61726
4058,3082,976,545,100400,61727
499,382,117,656,101500,61728
402,327,75,565,168100,61729
151,125,26,770,126300,61730
61,61,0,-,121800,61731
772,667,105,675,144200,61732
367,300,67,847,146700,61733
1125,890,235,623,121900,61734
203,190,13,600,160900,61735
624,539,85,817,187000,61736
226,178,48,650,138600,61737
1576,1235,341,781,139800,61738
2009,1420,589,585,121000,61739
655,522,133,708,116000,61740
597,428,169,613,98800,61741
444,395,49,581,204000,61742
87,79,8,-,117000,61743
749,645,104,648,128400,61744
1587,1347,240,785,165000,61745
520,373,147,708,123900,61747
1047,962,85,777,208600,61748
231,196,35,673,78100,61749
49,49,0,-,-,61750
54,49,5,-,133100,61751
1709,1392,317,699,148000,61752
1228,1049,179,670,161600,61753
475,384,91,983,111800,61754
1903,1577,326,664,179400,61755
921,753,168,534,91400,61756
666,537,129,754,133200,61759
976,808,168,692,93600,61760
19270,10842,8428,876,163200,61761
5454,3766,1688,626,106200,61764
218,184,34,560,90000,61769
454,366,88,733,102800,61770
322,306,16,758,116500,61771
103,72,31,473,109100,61772
219,154,65,665,68400,61773
363,326,37,758,99000,61774
131,101,30,594,104700,61775
556,486,70,663,174100,61776
351,305,46,809,104900,61777
316,272,44,430,80200,61778
10984,3622,7362,784,151200,61801
8259,5040,3219,798,111500,61802
133,101,32,640,83500,61810
183,137,46,679,72800,61811
143,128,15,482,107100,61812
793,644,149,723,88300,61813
459,356,103,780,98400,61814
107,79,28,793,110200,61815
195,160,35,715,77700,61816
1052,881,171,768,107100,61817
602,502,100,468,94000,61818
13511,3258,10253,817,133300,61820
13389,7924,5465,868,134600,61821
9880,7121,2759,1123,208800,61822
131,109,22,800,87700,61830
73,60,13,-,112500,61831
14592,8714,5878,663,63900,61832
1039,827,212,618,64600,61833
2594,2198,396,718,116700,61834
274,198,76,675,81500,61839
347,289,58,926,256900,61840
557,489,68,575,101100,61841
1166,901,265,826,111400,61842
895,772,123,640,138000,61843
340,296,44,733,96500,61844
103,97,6,1063,-,61845
2032,1512,520,643,68000,61846
448,405,43,638,136600,61847
77,55,22,525,58100,61848
688,561,127,686,113300,61849
197,174,23,610,58800,61850
125,107,18,-,91500,61851
89,74,15,-,66700,61852
4916,3912,1004,1016,197800,61853
538,451,87,823,121500,61854
51,51,0,-,124200,61855
2999,2507,492,904,166700,61856
84,66,18,539,66000,61857
1231,997,234,660,98000,61858
456,410,46,789,133900,61859
208,165,43,669,157400,61862
257,243,14,913,112500,61863
614,505,109,821,155900,61864
509,408,101,632,91300,61865
5464,2848,2616,688,95800,61866
518,415,103,605,76900,61870
102,96,6,-,133900,61871
410,307,103,675,112200,61872
2342,1983,359,738,168900,61873
3352,1556,1796,858,208200,61874
348,296,52,848,193800,61875
298,253,45,492,73500,61876
704,578,126,885,148200,61877
681,480,201,570,95100,61878
1493,1329,164,756,153100,61880
292,252,40,613,73600,61882
1691,1324,367,597,73600,61883
504,432,72,618,190200,61884
1549,1042,507,669,99900,61910
1611,1105,506,579,112000,61911
604,507,97,606,90900,61912
607,493,114,769,88700,61913
778,608,170,519,89500,61914
268,214,54,675,64100,61917
390,353,37,713,131100,61919
9446,4923,4523,652,106900,61920
1012,838,174,523,82400,61924
209,188,21,875,96200,61925
348,284,64,626,69500,61928
307,223,84,516,79000,61929
211,174,37,633,66100,61930
473,341,132,674,92700,61931
209,152,57,563,64500,61932
425,303,122,504,65700,61933
73,73,0,-,72100,61936
802,626,176,527,85300,61937
9156,5983,3173,616,86500,61938
97,83,14,538,19900,61940
38,15,23,-,-,61941
508,370,138,591,70000,61942
702,547,155,652,82300,61943
5255,3802,1453,599,82200,61944
70,66,4,-,61300,61949
3238,2343,895,604,113500,61951
2426,1848,578,642,111500,61953
79,54,25,865,53300,61955
1098,850,248,683,96500,61956
869,707,162,686,77000,61957
620,519,101,543,198600,62001
13685,8905,4780,738,89400,62002
201,194,7,625,131300,62006
703,518,185,701,71900,62009
4587,3249,1338,724,144100,62010
87,73,14,507,154900,62011
2482,2141,341,679,151500,62012
238,173,65,638,109500,62013
1642,1354,288,645,113800,62014
223,196,27,588,126300,62015
1532,1131,401,645,94800,62016
430,360,70,575,73900,62017
1379,939,440,785,71700,62018
182,161,21,775,63100,62019
395,380,15,-,171500,62021
389,382,7,-,110200,62022
44,42,2,-,70000,62023
4214,2769,1445,826,100300,62024
12057,8968,3089,924,201700,62025
214,186,28,550,88700,62027
254,207,47,950,140200,62028
52,31,21,579,44200,62030
374,337,37,615,107700,62031
295,273,22,650,78500,62032
1962,1516,446,623,79600,62033
5326,3904,1422,905,194700,62034
6517,5336,1181,797,135200,62035
326,297,29,700,156300,62036
863,687,176,712,162700,62037
17867,12324,5543,709,85300,62040
837,688,149,575,88500,62044
171,164,7,-,137500,62045
309,247,62,844,176700,62046
649,483,166,604,115400,62047
664,483,181,706,70300,62048
2031,1560,471,639,90500,62049
155,106,49,625,34700,62050
355,319,36,508,78700,62051
5088,3693,1395,627,125500,62052
216,164,52,-,60000,62053
318,252,66,525,84000,62054
4264,3053,1211,585,82800,62056
366,267,99,634,80400,62058
316,112,204,379,34700,62059
1925,925,1000,701,46900,62060
745,543,202,762,167400,62061
3248,2604,644,955,190300,62062
461,411,50,615,107100,62063
23,18,5,-,-,62065
1066,842,224,824,162100,62067
1261,1095,166,730,73900,62069
12,12,0,-,-,62070
470,399,71,648,141600,62074
1443,1108,335,638,74100,62075
48,37,11,-,53800,62076
130,112,18,725,48800,62077
43,34,9,-,42500,62078
103,103,0,-,170800,62079
1044,942,102,563,81000,62080
143,129,14,-,77400,62081
1117,840,277,570,68900,62082
133,118,15,-,143100,62083
692,429,263,728,81000,62084
77,64,13,1000,70000,62085
603,520,83,753,71800,62086
854,524,330,755,65100,62087
2910,2013,897,646,99900,62088
130,101,29,613,66900,62089
476,177,299,721,41100,62090
137,137,0,-,113900,62091
1118,840,278,533,63800,62092
180,131,49,738,52500,62093
470,399,71,552,52800,62094
4611,2932,1679,730,86100,62095
1086,957,129,800,179800,62097
19,19,0,-,20500,62098
2684,715,1969,369,61400,62201
2771,1836,935,814,53600,62203
3440,1261,2179,411,51800,62204
3368,1749,1619,767,54000,62205
5548,2826,2722,838,49800,62206
3391,1465,1926,565,40100,62207
7033,5028,2005,1001,118700,62208
484,418,66,611,126700,62214
599,482,117,689,163900,62215
1066,913,153,747,169700,62216
286,194,92,773,77100,62217
584,533,51,850,199800,62218
397,341,56,760,96700,62219
7769,4970,2799,801,106400,62220
11394,7532,3862,884,160800,62221
7194,5286,1908,832,111000,62223
1398,31,1367,1368,-,62225
12200,7881,4319,803,119100,62226
2533,2208,325,935,152400,62230
3011,2493,518,731,128200,62231
2595,2103,492,830,90600,62232
2738,2015,723,611,95100,62233
13186,8929,4257,820,136100,62234
5257,4410,847,805,204700,62236
985,887,98,600,97900,62237
257,197,60,717,54800,62238
1951,1473,478,825,85100,62239
604,505,99,778,59200,62240
402,336,66,588,101500,62241
494,447,47,688,86900,62242
2364,2063,301,867,167200,62243
488,449,39,-,208600,62244
660,574,86,682,160300,62245
3219,2200,1019,650,128500,62246
133,89,44,704,122700,62248
6035,4576,1459,736,171800,62249
180,156,24,650,95300,62250
283,220,63,596,98800,62253
2184,1492,692,789,145600,62254
406,316,90,667,149200,62255
1217,967,250,711,99800,62257
3343,2429,914,974,154100,62258
2773,2370,403,784,198600,62260
47,47,0,-,-,62261
734,664,70,594,78700,62262
2081,1591,490,637,112800,62263
1267,987,280,686,135000,62264
1664,1398,266,1056,137800,62265
53,53,0,-,221800,62266
285,217,68,685,130100,62268
11586,8436,3150,959,184100,62269
902,726,176,709,118900,62271
653,521,132,623,99200,62272
142,82,60,773,103900,62273
2536,1922,614,481,82200,62274
1361,1206,155,804,121900,62275
540,426,114,654,91900,62277
2514,2078,436,695,154900,62278
13,13,0,-,-,62279
181,131,50,670,89300,62280
849,738,111,1105,182800,62281
179,158,21,788,117700,62282
228,197,31,929,110600,62284
1599,1435,164,691,176800,62285
2547,1776,771,615,89400,62286
1209,932,277,634,103700,62288
128,94,34,839,76000,62289
336,251,85,645,62800,62292
1793,1396,397,736,162100,62293
5207,4044,1163,772,187500,62294
526,436,90,950,159100,62295
178,160,18,-,137500,62297
6395,5274,1121,863,190600,62298
13901,8211,5690,583,93800,62301
7650,6340,1310,677,166000,62305
261,233,28,466,70600,62311
935,703,232,471,69300,62312
139,134,5,-,88900,62313
214,133,81,1022,70300,62314
246,217,29,800,54600,62316
130,110,20,-,93600,62319
758,570,188,830,119000,62320
1753,1286,467,539,98500,62321
94,87,7,-,87500,62323
432,334,98,385,73500,62324
198,160,38,675,146300,62325
1023,822,201,498,78900,62326
792,658,134,542,75400,62330
63,52,11,671,60000,62334
16,14,2,-,52900,62336
472,389,83,446,144000,62338
342,272,70,466,90700,62339
689,565,124,513,70600,62340
1472,1087,385,642,101300,62341
284,235,49,533,63200,62343
38,31,7,-,72300,62344
201,173,28,484,87500,62345
98,76,22,-,65000,62346
879,727,152,593,142100,62347
60,60,0,-,100000,62348
231,186,45,544,98800,62349
752,584,168,606,113200,62351
100,83,17,-,61100,62352
1592,1211,381,568,85500,62353
675,502,173,912,106300,62354
389,360,29,525,62200,62355
203,148,55,483,62900,62356
91,59,32,570,65600,62357
299,282,17,675,110300,62358
74,74,0,-,83100,62359
680,521,159,704,93700,62360
186,140,46,581,82600,62361
171,142,29,313,52800,62362
2471,1808,663,566,90300,62363
208,186,22,575,88900,62365
622,497,125,502,62800,62366
376,295,81,539,48900,62367
182,167,15,-,81900,62370
121,112,9,-,95000,62373
114,101,13,570,56900,62374
128,121,7,-,124000,62375
464,354,110,603,92500,62376
398,306,92,650,87100,62378
764,636,128,534,79400,62379
143,103,40,292,31300,62380
7655,5583,2072,575,140400,62401
403,351,52,519,87800,62410
1616,1290,326,683,104600,62411
158,117,41,821,84100,62413
736,636,100,539,113600,62414
1030,763,267,538,70800,62417
707,586,121,617,58400,62418
140,136,4,-,47100,62419
1976,1489,487,649,76200,62420
261,205,56,736,86500,62421
474,381,93,644,78100,62422
229,188,41,-,132500,62423
875,796,79,836,131300,62424
163,142,21,-,103600,62425
326,264,62,625,71500,62426
658,500,158,544,106900,62427
1182,908,274,471,76400,62428
397,338,59,607,67700,62431
186,176,10,292,86700,62432
377,326,51,-,69200,62433
174,150,24,-,82900,62434
215,155,60,548,91000,62436
135,127,8,-,86600,62438
3254,2308,946,608,67900,62439
503,473,30,650,93300,62440
2866,1966,900,650,110900,62441
1133,915,218,559,80400,62442
598,543,55,809,127400,62443
102,86,16,-,138900,62444
443,347,96,564,109800,62445
157,142,15,-,85600,62446
1430,1207,223,536,94300,62447
2289,1847,442,552,97600,62448
1253,1031,222,550,78600,62449
5151,3567,1584,535,86900,62450
856,633,223,528,66000,62451
158,128,30,672,103600,62452
4333,3407,926,588,86700,62454
759,589,170,448,69300,62458
121,103,18,338,68500,62459
417,342,75,663,78500,62460
274,252,22,910,152700,62461
334,287,47,493,95900,62462
547,449,98,490,85700,62463
370,334,36,438,98600,62465
838,611,227,553,79600,62466
1333,1181,152,578,166000,62467
969,736,233,544,103000,62468
207,179,28,-,122600,62469
3195,2455,740,621,86500,62471
555,518,37,658,83900,62473
387,339,48,756,78000,62474
144,144,0,-,96100,62475
692,605,87,388,64400,62476
400,342,58,683,53300,62477
145,145,0,-,77500,62478
282,229,53,536,153500,62479
207,165,42,520,55900,62480
145,142,3,-,-,62481
1124,992,132,715,129400,62501
745,568,177,459,81500,62510
117,82,35,-,159100,62512
638,509,129,764,87600,62513
97,92,5,-,79500,62514
422,295,127,485,115400,62515
78,70,8,550,60700,62517
139,120,19,-,114400,62518
42,42,0,-,65700,62519
647,588,59,725,161100,62520
15087,10802,4285,708,98200,62521
6242,4041,2201,638,80300,62522
429,8,421,326,-,62523
14134,8630,5504,648,79000,62526
701,501,200,798,107600,62530
802,659,143,638,103300,62531
34,34,0,-,80000,62532
420,315,105,517,99200,62533
526,388,138,580,88200,62534
1406,1262,144,1535,206800,62535
315,268,47,-,194000,62536
33,33,0,-,76800,62537
149,124,25,632,72900,62538
526,433,93,750,91700,62539
671,499,172,568,76000,62540
35,35,0,-,-,62541
192,112,80,725,102200,62543
714,590,124,571,95400,62544
440,402,38,706,126000,62545
583,524,59,700,85500,62546
312,281,31,722,82100,62547
857,732,125,544,113000,62548
2454,1985,469,589,133300,62549
1118,936,182,675,102600,62550
300,252,48,482,88100,62551
212,193,19,817,86800,62553
605,509,96,644,141500,62554
201,181,20,533,88900,62555
139,118,21,675,76400,62556
3222,2416,806,523,77400,62557
1358,1120,238,799,137400,62558
533,429,104,600,76600,62560
2076,1547,529,728,124800,62561
2157,1905,252,852,187200,62563
3314,2458,856,470,85600,62565
434,351,83,775,91800,62567
6399,4430,1969,668,87800,62568
198,173,25,430,67100,62570
492,446,46,594,69400,62571
256,227,29,540,102200,62572
651,502,149,518,113200,62573
174,151,23,-,100500,62601
73,47,26,591,47000,62610
435,334,101,570,103400,62611
779,619,160,690,92700,62612
1459,1151,308,705,131200,62613
2066,1698,368,654,119200,62615
327,221,106,680,61600,62617
2921,2025,896,610,72400,62618
480,351,129,527,83500,62621
18,10,8,-,-,62622
229,221,8,-,75200,62624
352,326,26,-,160600,62625
3048,2286,762,591,102100,62626
413,337,76,520,76300,62627
350,278,72,713,88100,62628
5070,4101,969,1010,179100,62629
150,142,8,-,81300,62630
112,98,14,788,85000,62631
309,268,41,735,81400,62633
271,207,64,516,91300,62634
239,205,34,725,104400,62635
514,415,99,696,102000,62638
126,114,12,-,76700,62639
1484,1155,329,727,115100,62640
638,509,129,652,98700,62642
217,142,75,714,91500,62643
2123,1531,592,544,80700,62644
164,126,38,605,114400,62649
10441,6869,3572,661,106800,62650
222,147,75,589,58000,62655
7509,4768,2741,677,95100,62656
533,401,132,688,152300,62661
116,99,17,525,62100,62663
1322,947,375,591,79700,62664
598,456,142,533,70500,62665
247,198,49,582,108800,62666
157,106,51,809,79600,62667
579,472,107,498,85700,62668
1198,914,284,671,143600,62670
208,138,70,580,78100,62671
105,91,14,585,64200,62672
191,162,29,758,83800,62673
615,483,132,494,97900,62674
2634,1922,712,628,155500,62675
971,811,160,721,144400,62677
2188,1746,442,586,82400,62681
392,328,64,627,69100,62682
1994,1685,309,853,198900,62684
885,768,117,675,113700,62685
278,211,67,756,90600,62688
238,190,48,730,77400,62689
1600,1161,439,579,90100,62690
915,678,237,562,79500,62691
843,757,86,709,83900,62692
521,476,45,775,163000,62693
1219,944,275,535,89000,62694
97,81,16,636,95800,62695
588,13,575,597,-,62701
15708,9783,5925,725,79200,62702
12203,6983,5220,743,84500,62703
18770,11494,7276,748,132900,62704
3152,2676,476,773,147900,62707
6813,5846,967,921,232300,62711
4157,3274,883,747,207500,62712
8685,6192,2493,624,69300,62801
338,273,65,344,92000,62803
1444,1151,293,504,78000,62806
318,242,76,500,68500,62807
551,432,119,690,86000,62808
61,53,8,-,73800,62809
361,298,63,533,89000,62810
95,87,8,575,61700,62811
4568,3137,1431,643,70400,62812
733,664,69,650,76900,62814
154,131,23,317,64500,62815
584,439,145,608,69700,62816
235,189,46,612,89800,62817
93,89,4,-,74700,62818
184,138,46,652,46300,62819
54,54,0,-,41700,62820
3270,2424,846,573,78500,62821
1288,871,417,650,58600,62822
734,631,103,360,77400,62823
655,532,123,552,61200,62824
65,53,12,-,58800,62825
541,403,138,569,53800,62827
553,490,63,523,110400,62828
7,7,0,-,-,62829
575,379,196,458,108200,62830
216,183,33,494,101300,62831
3711,2616,1095,513,74600,62832
134,123,11,-,178100,62833
412,349,63,448,50900,62835
250,214,36,733,88100,62836
3998,2948,1050,565,75700,62837
647,536,111,534,53500,62838
2691,1922,769,507,76700,62839
54,53,1,-,97400,62841
330,262,68,625,60000,62842
45,40,5,-,61000,62843
900,700,200,405,69000,62844
282,197,85,620,65600,62846
261,170,91,593,77700,62848
850,745,105,638,85800,62849
129,122,7,-,108600,62850
127,96,31,-,85000,62851
41,36,5,392,50000,62852
337,321,16,-,62900,62853
639,533,106,725,73500,62854
184,122,62,695,46300,62856
1282,1038,244,579,83400,62858
2297,1725,572,566,86200,62859
242,216,26,541,79300,62860
50,37,13,-,18500,62861
154,101,53,-,50600,62862
4181,2992,1189,570,79400,62863
10288,7040,3248,601,87400,62864
794,771,23,-,99500,62865
211,170,41,457,44300,62867
584,531,53,607,72200,62868
1147,897,250,418,71200,62869
757,646,111,569,64400,62870
306,255,51,350,72200,62871
389,358,31,692,77200,62872
191,162,29,655,40500,62874
449,398,51,385,76900,62875
80,73,7,-,82500,62876
220,181,39,708,88500,62877
145,134,11,-,50000,62878
39,31,8,617,27500,62879
250,199,51,358,75500,62880
4594,3312,1282,589,79900,62881
892,696,196,575,62500,62882
316,277,39,342,118800,62883
1170,814,356,595,78600,62884
341,311,30,-,93100,62885
148,138,10,-,76700,62886
168,134,34,-,-,62887
859,718,141,577,80500,62888
314,270,44,500,106600,62889
1089,883,206,775,83900,62890
243,222,21,603,52000,62891
154,134,20,-,100000,62892
411,364,47,548,101000,62893
373,303,70,619,145300,62894
786,642,144,666,94400,62895
5077,3545,1532,552,67700,62896
173,158,15,-,83800,62897
818,725,93,605,104800,62898
720,607,113,407,73000,62899
10498,3339,7159,655,122700,62901
2090,1342,748,723,151500,62902
1017,484,533,682,150000,62903
305,269,36,513,107600,62905
2565,1949,616,395,87300,62906
957,815,142,584,119600,62907
202,166,36,556,70000,62908
990,872,118,483,61200,62910
468,418,50,739,75300,62912
1163,685,478,323,27700,62914
139,103,36,806,71900,62915
333,291,42,525,103800,62916
1117,806,311,494,65300,62917
4014,2874,1140,723,137000,62918
344,301,43,492,64400,62919
1318,1080,238,442,128000,62920
143,129,14,681,24400,62921
1104,1004,100,613,126100,62922
178,152,26,810,73800,62923
1142,744,398,786,82400,62924
928,748,180,612,86600,62926
132,100,32,717,46700,62927
92,54,38,364,57500,62928
2380,1711,669,669,63100,62930
623,510,113,377,96500,62931
677,520,157,616,78000,62932
569,282,287,694,128300,62933
447,354,93,400,62700,62934
693,558,135,475,73400,62935
1038,826,212,354,85400,62938
1325,1075,250,673,116900,62939
130,119,11,525,-,62940
304,251,53,1049,79300,62941
262,178,84,479,47300,62942
175,151,24,-,92100,62943
5344,3721,1623,555,80800,62946
187,187,0,-,112100,62947
5275,3753,1522,596,84700,62948
324,222,102,350,48500,62949
101,101,0,-,69000,62950
2121,1519,602,512,73900,62951
1280,984,296,571,102300,62952
106,64,42,609,50000,62953
144,117,27,-,91700,62954
313,272,41,653,63000,62956
376,272,104,795,56900,62957
909,628,281,645,151100,62958
10949,7590,3359,680,123000,62959
4620,3350,1270,720,86200,62960
15,15,0,-,-,62961
12,8,4,-,-,62962
226,130,96,444,29000,62963
564,396,168,335,54200,62964
33,24,9,513,46700,62965
6128,4181,1947,584,98500,62966
114,104,10,442,67500,62967
168,134,34,-,68300,62969
271,214,57,476,67300,62970
418,370,48,-,100500,62972
577,503,74,753,95900,62974
157,94,63,-,74300,62975
180,168,12,-,99000,62976
244,210,34,677,104000,62977
507,399,108,469,78800,62979
394,306,88,268,52500,62982
601,466,135,652,57300,62983
747,558,189,361,63600,62984
348,334,14,-,108000,62985
464,398,66,-,81000,62987
514,389,125,474,65300,62988
288,235,53,368,103300,62990
323,178,145,500,55000,62992
210,179,31,-,85900,62994
1617,1260,357,511,91600,62995
183,161,22,-,75600,62996
205,134,71,685,53900,62997
165,134,31,-,63800,62998
639,471,168,583,48500,62999
6134,5340,794,998,529200,63005
13742,10769,2973,857,150900,63010
14294,11660,2634,1156,254100,63011
3841,3454,387,902,145800,63012
657,575,82,-,164700,63013
279,236,43,700,144300,63014
892,737,155,645,124700,63015
2680,2404,276,916,143200,63016
16707,12946,3761,1118,336500,63017
1734,1058,676,832,125100,63019
7888,5958,1930,709,119200,63020
21460,17523,3937,1019,225400,63021
2148,1762,386,775,153400,63023
4730,4038,692,994,249500,63025
16373,13626,2747,811,185600,63026
9738,7588,2150,758,152800,63028
73,64,9,-,157100,63030
18070,13643,4427,1012,99100,63031
16993,10894,6099,935,104200,63033
6628,6257,371,1444,165700,63034
486,401,85,757,100900,63036
1150,936,214,764,131100,63037
2495,2272,223,1153,396000,63038
335,248,87,782,142600,63039
2913,2557,356,1130,286600,63040
235,225,10,-,189100,63041
8707,4726,3981,825,95900,63042
9059,5993,3066,957,153500,63043
4200,2940,1260,822,158800,63044
0,0,0,-,-,63045
19,19,0,-,-,63047
1297,1114,183,902,155500,63048
6082,5179,903,785,149400,63049
5951,5094,857,803,170100,63050
5237,4169,1068,844,139600,63051
9186,7623,1563,851,169500,63052
24,17,7,-,137500,63053
995,730,265,789,224700,63055
791,695,96,539,149500,63056
0,0,0,-,-,63057
971,815,156,611,124000,63060
45,45,0,-,97100,63061
1998,1656,342,764,154200,63068
5691,4200,1491,729,188000,63069
3107,2173,934,685,116700,63070
422,340,82,415,54900,63071
1147,921,226,827,164600,63072
326,312,14,-,731400,63073
6897,3342,3555,745,87500,63074
4439,3032,1407,710,131000,63077
0,0,0,-,-,63079
5390,3328,2062,700,119900,63080
7046,5130,1916,636,157600,63084
297,240,57,668,167800,63087
3840,2375,1465,887,174700,63088
2181,1881,300,1085,143500,63089
8638,5972,2666,669,180200,63090
484,409,75,525,142400,63091
2012,221,1791,1017,213300,63101
1073,14,1059,824,-,63102
4026,569,3457,839,161500,63103
9626,3665,5961,777,199000,63104
6465,3705,2760,1118,557000,63105
4691,621,4070,582,103700,63106
4300,1748,2552,691,53000,63107
10527,2978,7549,852,308600,63108
13493,7947,5546,771,163300,63109
7906,3330,4576,778,165600,63110
8534,3027,5507,711,79500,63111
8525,3213,5312,814,147000,63112
4522,1788,2734,737,60400,63113
14421,8785,5636,818,84200,63114
7560,3681,3879,754,57600,63115
19204,10675,8529,714,109900,63116
4374,2393,1981,903,223400,63117
11447,4113,7334,751,110000,63118
13929,10613,3316,966,216300,63119
3394,1804,1590,757,50100,63120
10663,5983,4680,790,75200,63121
16005,12728,3277,1067,294200,63122
22439,16502,5937,772,142500,63123
4472,3261,1211,1074,732600,63124
13799,9760,4039,754,117500,63125
6326,5378,948,875,183000,63126
1930,1379,551,1738,389500,63127
12463,9846,2617,927,215900,63128
21945,16982,4963,780,198500,63129
12459,7313,5146,943,245300,63130
6367,5914,453,1223,523200,63131
5515,2965,2550,954,248100,63132
3039,1154,1885,734,55000,63133
5356,2929,2427,952,69400,63134
8594,5441,3153,905,81400,63135
17236,8459,8777,843,69600,63136
7506,3966,3540,943,65700,63137
7526,3676,3850,702,96000,63138
11234,6391,4843,745,136400,63139
129,29,100,708,-,63140
8231,6381,1850,1112,388600,63141
5128,2335,2793,689,146600,63143
4209,2820,1389,1135,209000,63144
13775,7986,5789,1016,195600,63146
3787,2182,1605,724,65800,63147
0,0,0,-,-,63155
19463,12872,6591,828,161300,63301
19314,14162,5152,960,201800,63303
14918,13226,1692,1228,215700,63304
77,59,18,544,131300,63330
588,525,63,680,321900,63332
273,197,76,766,78200,63333
2760,2010,750,620,107600,63334
546,379,167,522,116700,63336
382,306,76,628,112200,63339
1229,1202,27,775,343400,63341
1603,1131,472,660,140800,63343
547,471,76,727,96900,63344
163,124,39,528,55000,63345
1063,837,226,764,89400,63347
2306,2102,204,901,249900,63348
665,562,103,677,182400,63349
275,233,42,754,98200,63350
612,465,147,793,147400,63351
462,295,167,557,75500,63352
1845,1192,653,700,81600,63353
2015,1595,420,588,174100,63357
457,390,67,700,90400,63359
1893,1250,643,573,103600,63361
2358,1600,758,895,139100,63362
754,562,192,625,102800,63363
18133,14398,3735,898,181300,63366
7901,6420,1481,997,241700,63367
15763,12892,2871,1188,220900,63368
653,518,135,748,120800,63369
9,9,0,-,-,63370
192,142,50,871,141700,63373
27942,23044,4898,953,170700,63376
906,739,167,845,134100,63377
8215,6251,1964,804,155600,63379
203,169,34,931,118800,63381
1384,910,474,551,70000,63382
5276,3993,1283,773,139500,63383
720,548,172,654,73300,63384
13212,11317,1895,971,211400,63385
201,152,49,870,90000,63386
31,22,9,-,-,63387
296,258,38,-,66000,63388
2261,1819,442,822,139400,63389
3963,3090,873,719,171400,63390
8639,5420,3219,615,105400,63401
182,150,32,515,72600,63430
151,103,48,-,114300,63431
186,154,32,-,-,63432
29,29,0,-,-,63433
230,123,107,497,66300,63434
1601,1135,466,524,85300,63435
471,367,104,620,92500,63436
641,476,165,463,68500,63437
189,160,29,707,117900,63438
31,27,4,-,-,63439
450,350,100,391,98900,63440
471,359,112,543,127200,63441
182,150,32,319,78500,63443
1533,1105,428,542,85600,63445
284,220,64,601,75000,63446
475,279,196,364,55000,63447
630,485,145,564,83900,63448
22,22,0,-,75000,63450
61,56,5,-,102800,63451
455,349,106,482,73500,63452
194,156,38,907,94700,63453
313,222,91,673,106800,63454
1782,1235,547,557,87900,63456
110,92,18,625,139600,63457
80,62,18,910,112500,63458
1566,1347,219,796,122600,63459
152,120,32,655,55000,63460
2250,1687,563,602,118800,63461
670,561,109,454,133400,63462
259,204,55,488,116200,63463
6,6,0,-,-,63464
192,161,31,606,127100,63465
7,7,0,-,-,63467
978,689,289,485,73400,63468
471,350,121,574,94100,63469
261,206,55,747,82000,63471
228,147,81,475,52300,63472
101,97,4,-,78300,63473
189,140,49,400,105000,63474
7992,4285,3707,598,118200,63501
419,343,76,552,77400,63530
145,125,20,350,46500,63531
587,508,79,550,59300,63532
295,260,35,525,80000,63533
259,214,45,432,65600,63534
38,38,0,-,112500,63535
301,235,66,313,92900,63536
795,590,205,503,73900,63537
113,108,5,-,129200,63538
72,64,8,-,70000,63539
45,42,3,-,32500,63540
122,82,40,407,121900,63541
123,96,27,477,58900,63543
323,282,41,669,78800,63544
466,331,135,510,81100,63545
605,495,110,386,105800,63546
179,138,41,532,74100,63547
523,344,179,636,68200,63548
936,713,223,465,96500,63549
110,92,18,720,23800,63551
3107,2037,1070,468,95100,63552
1260,924,336,437,73300,63555
1224,891,333,611,86200,63556
85,79,6,-,89400,63557
287,242,45,1007,87300,63558
613,515,98,663,70500,63559
78,61,17,582,74500,63560
459,311,148,575,68400,63561
210,145,65,-,151000,63563
1593,1110,483,523,93300,63565
58,58,0,-,44400,63566
87,62,25,379,-,63567
6540,4225,2315,585,80300,63601
521,348,173,529,75500,63620
567,334,233,386,97400,63621
423,366,57,-,78000,63622
264,227,37,683,83200,63623
1706,1347,359,646,85000,63624
150,124,26,-,90000,63625
522,456,66,516,100000,63626
1250,942,308,488,162300,63627
5116,3582,1534,634,120200,63628
545,399,146,398,101000,63629
1355,1250,105,568,52200,63630
418,369,49,704,88000,63631
250,186,64,651,118400,63633
293,193,100,359,64200,63636
661,505,156,604,87700,63637
1077,818,259,569,84500,63638
10469,7100,3369,660,131700,63640
4363,3304,1059,582,96500,63645
488,421,67,650,82500,63648
1486,1072,414,559,85000,63650
443,266,177,709,52700,63653
236,218,18,-,94000,63654
650,510,140,655,78100,63655
165,140,25,506,102000,63656
1262,1015,247,557,64400,63660
497,469,28,-,79800,63662
314,147,167,579,75500,63663
3235,2374,861,488,95000,63664
100,89,11,-,95000,63665
73,73,0,-,24400,63666
4526,3448,1078,617,133200,63670
717,617,100,725,115300,63673
57,57,0,-,-,63674
77,72,5,-,63500,63675
14582,8859,5723,697,151200,63701
3592,1517,2075,757,75800,63703
1323,1018,305,537,92000,63730
354,307,47,704,94600,63732
313,209,104,496,55300,63735
1285,1041,244,632,88600,63736
42,33,9,-,-,63738
118,110,8,-,153300,63739
1895,1285,610,503,94100,63740
21,15,6,-,57000,63742
29,29,0,-,170100,63743
47,41,6,-,42500,63744
11,5,6,725,-,63745
17,9,8,-,-,63746
183,155,28,-,105900,63747
420,367,53,475,120800,63748
0,0,0,-,-,63750
449,381,68,696,98600,63751
9393,7050,2343,748,160200,63755
84,62,22,617,150000,63758
259,241,18,538,148200,63760
52,52,0,-,113500,63763
2173,1584,589,595,92700,63764
506,467,39,-,150500,63766
256,175,81,689,71500,63767
570,522,48,854,129700,63769
67,64,3,-,85300,63770
1074,773,301,489,96300,63771
36,20,16,-,30800,63774
6493,4954,1539,632,128000,63775
2610,1941,669,711,116900,63780
460,443,17,600,112200,63781
131,85,46,378,53400,63782
56,56,0,-,112500,63783
62,54,8,-,60000,63784
319,257,62,791,116200,63785
314,202,112,534,66100,63787
9324,6071,3253,628,100900,63801
75,63,12,-,34600,63820
355,264,91,508,41100,63821
1125,732,393,595,68900,63822
531,373,158,523,81000,63823
54,13,41,761,101800,63824
1670,1195,475,535,89900,63825
20,20,0,-,62900,63826
339,250,89,650,65600,63827
68,45,23,625,-,63828
478,296,182,528,45100,63829
3044,1494,1550,555,77800,63830
90,65,25,-,-,63833
2298,1200,1098,703,69500,63834
612,385,227,423,35600,63837
137,70,67,547,46700,63839
5551,3652,1899,574,102800,63841
2193,1413,780,492,79100,63845
597,447,150,680,69800,63846
50,29,21,-,-,63847
522,306,216,628,44600,63848
53,29,24,-,90800,63849
1483,718,765,576,64500,63851
472,355,117,580,64800,63852
84,54,30,635,31300,63853
488,379,109,385,80400,63855
5245,3061,2184,522,92500,63857
92,82,10,-,-,63860
636,385,251,576,63300,63862
2605,1449,1156,640,66500,63863
137,74,63,773,39200,63866
439,338,101,427,76500,63867
323,178,145,587,47500,63868
1380,734,646,511,91400,63869
376,222,154,632,61400,63870
2009,1184,825,533,69000,63873
156,108,48,657,33300,63874
891,663,228,471,58700,63876
1366,766,600,559,82700,63877
53,43,10,-,-,63878
288,200,88,513,46800,63879
23,23,0,-,43200,63880
190,120,70,546,39400,63882
13697,8382,5315,674,104000,63901
0,0,0,-,-,63902
552,426,126,396,80200,63932
1454,1044,410,470,60400,63933
41,41,0,-,-,63934
3799,2866,933,505,85900,63935
323,180,143,616,55700,63936
1107,747,360,557,88700,63937
578,423,155,564,57500,63939
552,435,117,479,75800,63940
155,117,38,-,76200,63941
260,201,59,454,86300,63942
257,175,82,616,76400,63943
736,535,201,540,69900,63944
278,217,61,398,127300,63945
100,53,47,553,-,63951
183,137,46,538,129000,63952
697,520,177,534,67900,63953
364,237,127,465,41000,63954
57,44,13,-,131300,63955
448,409,39,-,71400,63956
2480,1792,688,585,73900,63957
1127,910,217,534,106400,63960
630,451,179,498,57800,63961
0,0,0,-,-,63962
331,243,88,565,55400,63964
1264,963,301,454,127700,63965
1133,1011,122,826,67100,63966
729,572,157,485,59600,63967
269,205,64,645,100700,64001
1325,1099,226,757,152600,64011
10037,6915,3122,987,129900,64012
8931,6229,2702,938,143800,64014
11389,8237,3152,894,152700,64015
1725,1238,487,805,111500,64016
177,128,49,713,83000,64017
405,329,76,588,198600,64018
956,830,126,600,133200,64019
1396,1007,389,551,122500,64020
244,212,32,669,66100,64021
93,81,12,-,82500,64022
6376,4478,1898,682,123100,64024
6191,4294,1897,960,166000,64029
9393,4964,4429,763,103100,64030
2732,2471,261,1116,166100,64034
412,307,105,810,86100,64035
110,90,20,725,47100,64036
2554,1726,828,677,105400,64037
2483,1942,541,621,125000,64040
1526,1452,74,856,179300,64048
9157,4708,4449,681,79700,64050
9020,5273,3747,800,81500,64052
2041,1011,1030,810,47600,64053
1854,1028,826,686,73100,64054
14626,10243,4383,856,111700,64055
5884,3923,1961,755,102100,64056
5923,3496,2427,837,146600,64057
2372,1771,601,937,120500,64058
4856,3864,992,990,201900,64060
1302,1140,162,831,149800,64061
2072,1803,269,761,144300,64062
7545,5046,2499,920,150700,64063
6222,5066,1156,1074,248200,64064
7,0,7,638,-,64065
9,5,4,-,159400,64066
2352,1617,735,654,101800,64067
13812,10477,3335,826,165100,64068
1213,1008,205,1057,209400,64070
278,251,27,606,65000,64071
160,127,33,842,100700,64072
291,231,60,881,133100,64074
4298,3177,1121,848,143100,64075
3680,2888,792,677,147200,64076
651,548,103,604,122100,64077
3510,3060,450,652,168900,64078
5040,3382,1658,978,210400,64079
4862,3809,1053,875,190400,64080
9478,7114,2364,1131,214300,64081
5129,4582,547,1283,245500,64082
8137,6537,1600,1114,181300,64083
601,546,55,757,159700,64084
3249,2183,1066,627,112700,64085
8319,6249,2070,923,173900,64086
559,475,84,854,154800,64088
4569,3697,872,823,192500,64089
34,29,5,-,68800,64090
0,0,0,-,-,64092
10356,5233,5123,714,150900,64093
396,239,157,557,100200,64096
604,448,156,600,110700,64097
1234,943,291,867,189700,64098
8,8,0,-,-,64101
0,0,0,-,-,64102
2921,316,2605,915,169900,64105
3687,672,3015,739,196600,64106
3913,1297,2616,918,175600,64108
4524,1738,2786,611,107500,64109
6426,3041,3385,806,134100,64110
9815,2344,7471,780,160300,64111
4873,2037,2836,1002,295200,64112
4880,4525,355,1576,326400,64113
12235,7373,4862,949,154300,64114
7196,3393,3803,794,145300,64116
5865,2957,2908,802,97800,64117
17002,10122,6880,831,133500,64118
10520,8106,2414,938,126600,64119
140,99,41,745,16100,64120
3106,1897,1209,746,55400,64123
4082,1801,2281,658,56400,64124
593,283,310,740,47100,64125
2292,898,1394,730,47600,64126
6531,2590,3941,688,42100,64127
4709,2047,2662,700,41900,64128
3816,1834,1982,749,72400,64129
8490,4355,4135,770,57600,64130
9943,4935,5008,796,135400,64131
5421,2412,3009,768,57800,64132
14270,9233,5037,858,100800,64133
8583,4223,4360,926,83400,64134
960,360,600,832,159700,64136
4351,2328,2023,818,106900,64137
10290,6214,4076,779,99100,64138
520,437,83,1203,275000,64139
2111,1750,361,1153,215900,64145
639,540,99,571,161300,64146
168,0,168,458,-,64147
97,97,0,-,270200,64149
1352,384,968,641,182700,64150
10701,6378,4323,909,184300,64151
10226,8006,2220,919,212600,64152
2448,1310,1138,980,186900,64153
4301,2041,2260,984,217600,64154
8178,6328,1850,913,167100,64155
2441,1810,631,1070,242300,64156
5903,5603,300,1241,222000,64157
1977,1043,934,918,207900,64158
145,106,39,885,75600,64161
310,162,148,491,97800,64163
141,94,47,-,276300,64164
36,22,14,-,-,64165
95,95,0,-,249200,64166
107,107,0,-,320400,64167
0,0,0,-,-,64192
601,543,58,715,157100,64401
1072,793,279,561,82200,64402
33,23,10,-,69400,64420
308,265,43,667,107500,64421
106,61,45,-,91700,64422
323,277,46,683,83400,64423
1872,1229,643,538,90900,64424
157,112,45,488,68900,64426
270,204,66,423,106400,64427
322,248,74,517,63700,64428
3808,2203,1605,659,122500,64429
302,238,64,622,124100,64430
164,127,37,617,82800,64431
26,24,2,-,85000,64432
35,33,2,-,51700,64433
164,131,33,610,143100,64434
307,289,18,940,172000,64436
295,225,70,636,72100,64437
106,97,9,-,137500,64438
563,495,68,679,149800,64439
279,248,31,607,122500,64440
88,87,1,-,108500,64441
328,243,85,629,77900,64442
411,320,91,681,212000,64443
569,494,75,600,150800,64444
152,100,52,620,62900,64445
496,333,163,525,74400,64446
392,359,33,697,133700,64448
209,187,22,750,64600,64449
190,119,71,461,73200,64451
77,74,3,-,65000,64453
930,735,195,778,150600,64454
150,123,27,328,76900,64455
624,458,166,473,59300,64456
87,70,17,870,141700,64457
60,42,18,706,71100,64458
196,196,0,-,151800,64459
306,229,77,583,69800,64461
621,451,170,663,88000,64463
1857,1369,488,757,135700,64465
246,171,75,482,69800,64466
78,56,22,-,71000,64467
5692,2563,3129,629,147100,64468
894,639,255,511,92400,64469
747,468,279,426,114400,64470
160,120,40,445,50000,64471
625,480,145,538,88700,64473
370,269,101,575,96300,64474
149,103,46,571,-,64475
151,114,37,697,85500,64476
1427,1109,318,754,120200,64477
384,305,79,632,112800,64479
129,109,20,725,-,64480
433,349,84,556,65000,64481
971,673,298,473,103500,64482
269,207,62,734,122000,64483
415,302,113,676,109400,64484
3144,2222,922,697,117000,64485
226,163,63,510,59600,64486
309,237,72,638,68100,64487
761,526,235,409,87800,64489
910,622,288,794,124000,64490
816,562,254,572,72900,64491
736,584,152,832,168100,64492
194,181,13,-,115700,64493
378,300,78,538,89300,64494
22,19,3,-,-,64496
130,112,18,535,152100,64497
173,126,47,579,49500,64498
24,23,1,-,35400,64499
4543,1870,2673,634,77900,64501
4925,3294,1631,744,101600,64503
3974,2883,1091,745,80500,64504
5202,3616,1586,719,121500,64505
8936,5259,3677,745,162700,64506
5130,3418,1712,757,103800,64507
4556,2911,1645,603,111200,64601
186,163,23,631,111300,64620
173,149,24,-,97500,64622
190,163,27,455,52300,64623
643,486,157,660,77600,64624
216,155,61,440,82900,64625
2351,1665,686,506,77800,64628
209,177,32,375,55400,64630
366,316,50,338,58900,64631
212,159,53,378,57200,64632
2073,1444,629,532,84000,64633
221,162,59,735,75500,64635
98,74,24,667,47700,64636
213,174,39,429,111300,64637
244,202,42,781,81700,64638
117,84,33,-,68200,64639
1216,921,295,497,95800,64640
276,210,66,400,76700,64641
398,312,86,658,63200,64642
476,394,82,563,99100,64643
1216,897,319,563,102800,64644
79,64,15,318,133800,64645
111,87,24,356,55300,64646
151,107,44,577,78500,64647
698,542,156,432,101700,64648
213,178,35,622,125000,64649
276,216,60,494,103000,64650
295,222,73,596,94000,64651
171,141,30,500,48800,64652
265,208,57,515,60000,64653
13,13,0,-,73800,64654
171,136,35,706,219800,64655
103,87,16,475,62500,64656
122,89,33,913,63000,64657
1264,893,371,508,85900,64658
328,252,76,558,112500,64659
183,164,19,736,61300,64660
407,293,114,535,85000,64661
200,176,24,806,140900,64664
143,117,26,508,60600,64667
622,493,129,538,86900,64668
433,353,80,481,103100,64670
862,612,250,691,116200,64671
68,63,5,-,62000,64672
905,695,210,521,78800,64673
183,146,37,284,102600,64674
83,79,4,-,52300,64676
244,210,34,473,64300,64679
61,50,11,913,73300,64681
144,127,17,-,57000,64682
3299,2159,1140,585,85900,64683
87,71,16,-,81900,64686
173,148,25,618,70000,64688
220,172,48,807,95700,64689
5578,3457,2121,814,150900,64701
1480,1118,362,675,121800,64720
149,126,23,1083,105000,64722
246,215,31,925,91300,64723
780,583,197,511,95400,64724
922,716,206,850,139000,64725
159,133,26,1063,141300,64726
192,145,47,627,80400,64728
2789,1652,1137,604,109700,64730
492,390,102,618,121800,64733
688,626,62,773,226600,64734
5729,4152,1577,710,102600,64735
422,354,68,427,78300,64738
301,243,58,615,128800,64739
862,700,162,594,71200,64740
125,102,23,579,137500,64741
927,689,238,741,156000,64742
88,59,29,604,81300,64743
3458,2353,1105,561,82400,64744
105,75,30,818,107600,64745
614,494,120,741,137900,64746
1542,1168,374,672,114400,64747
536,387,149,481,66100,64748
143,122,21,-,66500,64750
265,197,68,663,88800,64752
998,748,250,567,84300,64755
264,207,57,671,75000,64756
3344,2244,1100,495,103400,64759
562,454,108,713,106900,64761
657,453,204,512,78300,64762
640,512,128,704,70900,64763
20,18,2,-,"10,000-",64765
245,194,51,-,102300,64767
195,133,62,515,55800,64769
450,332,118,555,80000,64770
270,222,48,542,68300,64771
5552,3327,2225,630,98100,64772
1552,1096,456,469,87100,64776
228,196,32,640,156000,64778
1034,835,199,429,72500,64779
227,185,42,610,173800,64780
43,36,7,-,39000,64781
319,255,64,516,55800,64783
472,384,88,607,80500,64784
679,489,190,604,88800,64788
339,243,96,544,84800,64790
15154,8492,6662,730,112300,64801
14330,9662,4668,691,126600,64804
248,159,89,675,68600,64830
2299,1730,569,646,102200,64831
286,241,45,975,90600,64832
27,21,6,-,77500,64833
3332,2515,817,789,128900,64834
685,537,148,776,65900,64835
8869,5990,2879,693,108100,64836
1245,1006,239,506,109600,64840
203,181,22,634,94600,64841
301,197,104,470,73500,64842
1081,812,269,619,72200,64843
1716,1307,409,633,82600,64844
231,90,141,573,48800,64847
312,277,35,800,140200,64848
55,41,14,650,94200,64849
8885,5843,3042,631,104600,64850
1412,840,572,524,76500,64854
881,728,153,918,106200,64855
1523,1133,390,704,105800,64856
144,127,17,860,92100,64857
42,0,42,-,-,64858
493,408,85,587,107200,64859
523,460,63,560,86800,64861
1106,754,352,609,89600,64862
550,300,250,481,80500,64863
2202,1677,525,734,106900,64865
501,348,153,575,111600,64866
577,423,154,665,57800,64867
5704,3766,1938,702,111000,64870
443,393,50,430,88000,64873
292,149,143,536,84600,64874
162,134,28,-,90000,65001
2400,1773,627,712,178700,65010
699,569,130,685,139200,65011
1344,864,480,570,97600,65013
807,575,232,663,115300,65014
558,494,64,666,144100,65016
377,377,0,-,-,65017
3024,2169,855,541,119600,65018
5282,3902,1380,709,161400,65020
639,592,47,480,141600,65023
449,386,63,503,111800,65024
276,206,70,580,107800,65025
4534,3201,1333,656,110400,65026
713,643,70,492,106000,65032
216,154,62,575,117700,65034
664,595,69,435,151100,65035
2012,1602,410,800,175300,65037
1006,913,93,521,221500,65039
498,468,30,614,173300,65040
2386,1800,586,600,142300,65041
4053,3088,965,803,129400,65043
448,398,50,600,118200,65046
497,337,160,390,112600,65047
71,71,0,-,106900,65048
2521,1915,606,744,221200,65049
216,175,41,633,173600,65050
1812,1311,501,489,135900,65051
1272,996,276,906,191300,65052
576,531,45,933,230500,65053
289,283,6,-,152400,65054
402,343,59,331,139800,65058
293,247,46,-,130800,65059
313,271,42,763,56300,65061
5,5,0,-,-,65062
1335,989,346,817,170600,65063
147,136,11,658,152900,65064
2612,1732,880,648,223000,65065
2683,2030,653,580,125500,65066
136,136,0,-,178800,65067
310,230,80,809,152700,65068
320,304,16,1097,113800,65069
609,467,142,705,176600,65072
1090,846,244,517,128600,65074
313,277,36,413,148800,65075
291,277,14,-,135200,65076
241,211,30,-,102700,65077
1546,1234,312,568,85300,65078
1626,1438,188,650,220100,65079
358,338,20,-,159500,65080
1112,759,353,496,90500,65081
373,320,53,625,125000,65082
128,128,0,-,57200,65083
2645,1798,847,570,92800,65084
450,342,108,562,160500,65085
10812,6930,3882,597,156600,65101
16039,10773,5266,615,146900,65109
15316,4400,10916,803,168000,65201
19348,10926,8422,831,146600,65202
23655,14150,9505,797,211300,65203
0,0,0,-,-,65215
298,257,41,583,-,65230
1225,998,227,650,88400,65231
113,92,21,-,65000,65232
4367,2870,1497,659,129500,65233
588,416,172,408,75400,65236
338,257,81,790,93700,65237
422,359,63,735,104400,65239
3261,2557,704,566,126300,65240
645,565,80,669,143300,65243
141,129,12,-,103700,65244
35,25,10,-,-,65246
241,217,24,-,66800,65247
1481,1097,384,752,107800,65248
229,197,32,821,126000,65250
7179,4638,2541,613,118900,65251
725,608,117,484,105100,65254
1457,1125,332,817,156400,65255
646,567,79,559,164700,65256
657,551,106,630,58900,65257
155,129,26,443,133100,65258
964,815,149,523,92600,65259
223,214,9,538,100000,65260
379,253,126,378,59000,65261
288,164,124,675,158900,65262
739,555,184,591,91700,65263
253,214,39,495,150000,65264
6094,3986,2108,651,97700,65265
5913,4068,1845,616,88600,65270
780,502,278,575,94300,65274
1082,819,263,573,92300,65275
601,449,152,580,108200,65276
58,49,9,675,65000,65278
736,639,97,788,231600,65279
87,64,23,642,25700,65280
1117,857,260,548,83100,65281
85,85,0,-,95000,65282
209,173,36,371,130200,65283
898,732,166,808,159200,65284
237,189,48,-,148800,65285
51,44,7,-,57800,65286
209,189,20,-,128100,65287
13133,8465,4668,682,102700,65301
836,30,806,955,85000,65305
25,22,3,-,131300,65320
226,151,75,720,110200,65321
191,166,25,608,91300,65322
381,307,74,617,78600,65323
665,568,97,438,125700,65324
1383,1182,201,540,106900,65325
904,815,89,448,119200,65326
95,74,21,678,94400,65327
169,141,28,-,126700,65329
174,147,27,444,68200,65330
523,444,79,725,114900,65332
289,243,46,588,101800,65333
362,314,48,525,120600,65334
77,66,11,-,82700,65335
2365,1377,988,803,134500,65336
679,411,268,561,100800,65337
1171,893,278,576,96500,65338
271,224,47,578,70000,65339
5799,3675,2124,647,106300,65340
95,77,18,665,159400,65344
189,88,101,685,208000,65345
284,233,51,618,109500,65347
485,413,72,492,97600,65348
1018,727,291,532,56500,65349
675,559,116,645,112200,65350
929,682,247,636,79500,65351
271,230,41,702,59200,65354
4593,3689,904,646,112300,65355
1830,1545,285,631,79700,65360
11862,6571,5291,677,129200,65401
21,21,0,-,143800,65436
1006,771,235,517,108900,65438
128,99,29,-,105700,65439
141,137,4,-,109700,65440
2076,1490,586,645,118300,65441
15,15,0,-,-,65443
389,334,55,682,107300,65444
131,114,17,-,-,65446
114,98,16,-,102000,65449
1043,815,228,630,128500,65452
3316,2403,913,569,118900,65453
249,219,30,-,148200,65456
104,65,39,630,-,65457
2729,2114,615,664,119200,65459
39,26,13,-,107500,65461
648,562,86,669,109100,65462
421,384,37,672,66400,65463
287,261,26,-,136600,65464
659,496,163,570,112200,65466
86,86,0,-,-,65468
397,340,57,-,132100,65470
2315,9,2306,1233,-,65473
119,53,66,-,-,65479
1647,1069,578,592,111400,65483
43,30,13,-,-,65484
1250,1024,226,602,111700,65486
76,76,0,-,74000,65501
53,42,11,-,-,65529
299,273,26,-,114100,65534
604,375,229,571,84000,65535
11437,7663,3774,592,106000,65536
61,48,13,-,-,65541
2012,1446,566,500,98100,65542
131,131,0,-,150500,65543
2154,1437,717,496,98900,65548
1341,1076,265,651,83800,65550
756,580,176,869,115700,65552
465,402,63,471,70000,65555
2222,1553,669,560,108400,65556
32,32,0,-,-,65557
3573,2428,1145,669,109600,65559
5484,3803,1681,481,99400,65560
102,55,47,-,66900,65564
1949,1540,409,594,115000,65565
335,268,67,619,72100,65566
555,462,93,500,97100,65567
211,199,12,315,59100,65570
904,599,305,605,98300,65571
357,291,66,589,134500,65580
799,681,118,549,111100,65582
3906,2308,1598,901,160700,65583
4168,1547,2621,918,156900,65584
29,29,0,-,-,65586
1094,803,291,575,76000,65588
92,92,0,-,-,65589
523,414,109,488,104400,65590
548,426,122,590,124000,65591
297,257,40,563,72500,65601
86,61,25,818,-,65603
1528,1103,425,693,141200,65604
4873,3584,1289,658,86100,65605
1421,1099,322,451,63000,65606
3627,2690,937,591,89100,65608
303,227,76,503,78600,65609
2145,1725,420,571,141600,65610
821,558,263,834,195400,65611
555,395,160,733,128600,65612
6847,3960,2887,664,127700,65613
249,194,55,555,107300,65614
10799,5032,5767,745,152100,65616
561,420,141,827,99000,65617
128,128,0,-,-,65618
2833,2388,445,749,137500,65619
99,99,0,-,-,65620
3110,2065,1045,612,100600,65622
10,9,1,-,43800,65623
746,606,140,-,151600,65624
2904,2184,720,589,102200,65625
690,501,189,420,84500,65626
287,272,15,-,115800,65627
259,234,25,719,97100,65629
130,129,1,-,381000,65630
1790,1371,419,873,119400,65631
972,678,294,667,92200,65632
1567,1113,454,592,107200,65633
327,257,70,538,77000,65634
212,182,30,619,92100,65635
570,477,93,531,99300,65637
172,153,19,-,85000,65638
326,286,40,-,93300,65640
489,407,82,495,163600,65641
938,705,233,598,118800,65644
802,646,156,489,103600,65646
735,560,175,561,92200,65647
2383,1928,455,622,138200,65648
576,437,139,640,65600,65649
502,454,48,830,83100,65650
1227,1004,223,701,121200,65652
2343,1658,685,688,98900,65653
74,50,24,245,72000,65654
1511,1041,470,525,88100,65655
1925,1555,370,738,134500,65656
63,47,16,-,92100,65657
681,587,94,467,142200,65658
59,59,0,-,93100,65660
1099,839,260,552,67900,65661
546,444,102,-,74900,65662
941,735,206,562,140500,65663
61,33,28,575,72800,65664
1225,881,344,594,121600,65667
752,565,187,398,90800,65668
718,617,101,625,148600,65669
3586,2108,1478,652,135000,65672
1052,765,287,596,79000,65674
193,156,37,566,151900,65676
921,577,344,577,116900,65679
537,475,62,594,93000,65680
754,616,138,549,145200,65681
853,605,248,643,83800,65682
250,198,52,392,66300,65685
1872,1506,366,733,167300,65686
1756,1196,560,478,114200,65689
102,86,16,-,114300,65690
508,429,79,475,81900,65692
141,118,23,-,67800,65702
1467,1086,381,439,119800,65704
1609,1092,517,651,91400,65705
5787,3908,1879,597,118000,65706
841,699,142,607,85700,65707
4429,3013,1416,627,117600,65708
451,343,108,437,139300,65710
3976,2536,1440,543,82900,65711
3150,2164,986,639,119400,65712
897,676,221,542,83100,65713
11770,8233,3537,796,162400,65714
23,5,18,-,-,65715
1021,764,257,555,100400,65717
249,223,26,-,86800,65720
11137,8038,3099,841,151000,65721
553,416,137,524,-,65722
1331,973,358,576,102700,65723
720,607,113,729,88800,65724
1014,889,125,677,148700,65725
137,137,0,-,-,65727
16,16,0,-,-,65728
173,130,43,-,-,65729
37,37,0,-,-,65730
150,108,42,808,83600,65731
363,310,53,684,112500,65732
360,319,41,903,120800,65733
1141,921,220,576,105000,65734
39,30,9,-,-,65735
3471,2757,714,732,168800,65737
6863,4786,2077,776,129500,65738
481,446,35,938,153800,65739
1398,951,447,633,71500,65740
4649,3526,1123,736,181500,65742
50,50,0,-,75000,65744
1004,718,286,600,81200,65745
2489,1946,543,578,111600,65746
1790,1470,320,531,155800,65747
111,83,28,375,69500,65752
1832,1369,463,643,122800,65753
313,261,52,-,195400,65754
112,73,39,-,-,65755
230,212,18,525,156400,65756
2689,2132,557,760,150700,65757
569,452,117,625,85500,65759
330,323,7,-,48700,65760
546,465,81,495,100500,65761
158,131,27,536,76300,65762
571,485,86,-,68800,65764
45,40,5,-,55700,65766
731,552,179,545,78600,65767
131,70,61,426,126300,65768
1070,778,292,742,101900,65769
1100,833,267,724,122800,65770
487,387,100,472,178900,65771
734,613,121,617,86600,65772
226,170,56,-,64100,65773
391,270,121,563,97900,65774
10125,6828,3297,606,110100,65775
161,124,37,-,58800,65777
235,159,76,560,111700,65778
808,648,160,475,89000,65779
3253,2584,669,739,138100,65781
49,49,0,-,-,65783
8,3,5,-,-,65784
2127,1411,716,731,100800,65785
793,609,184,544,105300,65786
666,509,157,677,188600,65787
123,90,33,-,116700,65788
715,613,102,572,76500,65789
350,312,38,714,157800,65790
1758,1291,467,463,80700,65791
2618,1943,675,416,93800,65793
18173,9790,8383,657,101800,65802
17189,9166,8023,659,101100,65803
18110,10405,7705,713,145200,65804
5421,773,4648,587,69000,65806
24244,11715,12529,746,119500,65807
4561,4032,529,800,248000,65809
9249,6613,2636,848,189900,65810
4734,3247,1487,606,97700,66002
2623,1889,734,860,198800,66006
2266,1843,423,1039,198600,66007
108,89,19,468,109200,66008
332,285,47,546,74100,66010
4241,3231,1010,767,189300,66012
684,626,58,-,313200,66013
118,55,63,-,-,66014
340,229,111,525,76400,66015
84,84,0,-,84200,66016
160,140,20,375,72000,66017
2278,1476,802,732,208200,66018
96,0,96,722,-,66019
487,424,63,828,179800,66020
917,814,103,1061,148400,66021
528,371,157,656,106500,66023
329,199,130,626,72300,66024
2727,1768,959,913,154300,66025
264,243,21,850,185900,66026
1499,27,1472,1629,82500,66027
7985,5573,2412,942,169000,66030
0,0,0,-,-,66031
2150,1466,684,672,101500,66032
250,181,69,530,84600,66033
335,210,125,561,80700,66035
225,204,21,675,90000,66039
1266,882,384,595,93500,66040
322,282,40,632,105200,66041
329,281,48,605,112500,66042
3061,2209,852,980,173300,66043
10427,3996,6431,748,144700,66044
0,0,0,-,-,66045
7913,3637,4276,820,157300,66046
8000,3826,4174,905,216900,66047
13200,8174,5026,794,135100,66048
11703,6922,4781,992,218500,66049
833,720,113,836,177800,66050
981,832,149,1064,177400,66052
2912,2190,722,880,192700,66053
1174,956,218,775,146400,66054
756,646,110,651,97400,66056
144,107,37,530,67900,66058
405,314,91,515,87800,66060
20863,14957,5906,811,199800,66061
27027,19828,7199,996,209700,66062
2314,1631,683,633,97700,66064
1059,780,279,820,126900,66066
6097,4086,2011,755,110600,66067
1130,1016,114,848,132800,66070
4845,3745,1100,800,174000,66071
516,506,10,929,123900,66072
946,798,148,842,141900,66073
1016,722,294,653,83200,66075
824,685,139,691,135600,66076
450,371,79,697,151900,66078
297,260,37,840,143800,66079
338,274,64,745,98800,66080
3169,2695,474,837,193600,66083
2785,2542,243,1196,331400,66085
3668,2805,863,819,182000,66086
822,645,177,542,86700,66087
984,747,237,598,112400,66088
1126,826,300,703,115900,66090
70,59,11,-,-,66091
1371,1131,240,760,149900,66092
247,216,31,-,105700,66093
194,123,71,483,78100,66094
399,346,53,900,87100,66095
548,371,177,562,109200,66097
4623,1861,2762,638,52000,66101
10289,4959,5330,755,66500,66102
6101,2043,4058,806,85200,66103
9367,5615,3752,880,72000,66104
764,460,304,743,46500,66105
8401,5295,3106,744,91300,66106
7906,6475,1431,1100,158000,66109
3522,2661,861,866,95500,66111
5314,2566,2748,834,102700,66112
0,0,0,-,-,66115
0,0,0,-,-,66118
8021,3807,4214,865,150300,66202
8330,5008,3322,823,152500,66203
9086,4279,4807,929,140600,66204
6139,4738,1401,1104,184900,66205
3977,3654,323,1665,367400,66206
5804,4527,1277,1332,249000,66207
9146,7552,1594,1298,233700,66208
8200,5736,2464,1126,357900,66209
8621,4797,3824,1069,221500,66210
2142,1380,762,1202,470000,66211
14643,8605,6038,909,169500,66212
11611,7426,4185,1076,297400,66213
5241,2695,2546,821,187600,66214
10802,6991,3811,988,194600,66215
8993,7394,1599,965,202700,66216
2428,1278,1150,896,302400,66217
2557,2185,372,1374,236300,66218
4784,2227,2557,1051,235300,66219
2612,2489,123,1043,383100,66220
5588,4384,1204,1145,408700,66221
8885,5670,3215,1236,269900,66223
4358,3946,412,990,436900,66224
4367,3968,399,943,241300,66226
1994,1809,185,1557,234100,66227
699,613,86,636,119100,66401
1198,956,242,677,158600,66402
284,244,40,679,118900,66403
161,90,71,552,200000,66404
204,140,64,331,86700,66406
167,99,68,869,164000,66407
153,115,38,533,87500,66408
1149,1071,78,1196,205100,66409
469,389,80,544,83000,66411
70,66,4,-,-,66412
717,576,141,614,88600,66413
1140,818,322,566,94500,66414
340,294,46,372,77800,66415
193,165,28,1275,94500,66416
135,113,22,731,100900,66417
187,166,21,-,150000,66418
170,150,20,-,100900,66419
144,104,40,827,84000,66422
329,242,87,578,98300,66423
232,191,41,483,78200,66424
190,170,20,465,71800,66425
526,428,98,532,83600,66427
191,169,22,908,-,66428
179,179,0,-,140000,66429
241,216,25,450,81800,66431
167,121,46,685,88200,66432
2001,1343,658,539,103800,66434
2359,1662,697,523,128400,66436
102,102,0,-,117600,66438
1114,720,394,514,73600,66439
715,573,142,695,138100,66440
10486,4640,5846,939,133400,66441
3238,29,3209,1201,-,66442
309,266,43,605,100000,66449
666,505,161,680,113100,66451
141,126,15,775,64100,66501
18077,7111,10966,843,175100,66502
6114,3768,2346,998,230700,66503
26,7,19,-,-,66506
464,425,39,1290,152400,66507
2008,1371,637,512,98200,66508
1015,744,271,736,124600,66509
306,229,77,643,98300,66510
1233,1036,197,682,134700,66512
567,432,135,628,191200,66514
186,169,17,706,69700,66515
140,116,24,525,81700,66516
786,284,502,773,77100,66517
51,48,3,-,105600,66518
228,200,28,908,118500,66520
691,549,142,569,99700,66521
12,11,1,-,49200,66522
1549,1041,508,534,93000,66523
953,758,195,889,144300,66524
268,235,33,644,117800,66526
95,60,35,572,97500,66527
384,310,74,647,134500,66528
555,456,99,788,138500,66531
207,181,26,925,85300,66532
565,426,139,917,119200,66533
1472,1001,471,578,111600,66534
994,772,222,833,169500,66535
1175,896,279,683,146400,66536
485,423,62,900,95000,66537
1476,1187,289,501,120600,66538
1058,861,197,611,171700,66539
196,159,37,463,99500,66540
99,74,25,-,47500,66541
1212,1131,81,-,157900,66542
435,392,43,817,127200,66543
207,182,25,-,74700,66544
484,451,33,603,161300,66546
3265,2445,820,740,169200,66547
369,304,65,611,80800,66548
636,528,108,581,153200,66549
264,172,92,625,58700,66550
205,168,37,707,74300,66552
251,211,40,708,140600,66554
792,137,655,555,-,66603
9845,5354,4491,711,98300,66604
7112,4711,2401,694,99100,66605
5123,2634,2489,796,79600,66606
2828,1406,1422,588,50600,66607
2074,1264,810,721,61400,66608
3348,2124,1224,640,110200,66609
3419,3261,158,1261,226600,66610
4448,2144,2304,824,107400,66611
1312,192,1120,439,50500,66612
13858,8880,4978,777,142000,66614
1342,895,447,922,166400,66615
2346,1671,675,573,65700,66616
3428,2904,524,787,153100,66617
3383,3022,361,839,159600,66618
902,324,578,999,77000,66619
17,9,8,-,-,66621
0,0,0,-,-,66622
4751,3167,1584,591,84500,66701
283,249,34,669,49600,66710
254,213,41,592,45000,66711
743,520,223,603,77700,66712
1969,1493,476,604,67900,66713
80,79,1,-,-,66714
178,146,32,644,44100,66716
277,255,22,475,37900,66717
4545,3084,1461,582,73300,66720
447,377,70,635,65500,66724
2330,1666,664,551,87300,66725
18,8,10,-,-,66728
120,107,13,583,44300,66732
812,599,213,659,60500,66733
106,88,18,-,110000,66734
193,171,22,-,90100,66735
1618,1167,451,613,68000,66736
124,117,7,438,61300,66738
1922,1473,449,728,67100,66739
164,151,13,-,76500,66740
59,59,0,-,-,66741
1497,1049,448,830,84700,66743
102,97,5,-,32200,66746
1038,793,245,593,77400,66748
3207,2122,1085,577,80500,66749
345,305,40,582,51700,66751
429,319,110,446,56900,66753
163,142,21,-,73300,66754
448,359,89,532,52300,66755
338,251,87,475,31600,66756
1401,972,429,546,65800,66757
95,78,17,615,34200,66758
0,0,0,-,-,66760
153,139,14,-,85300,66761
9588,5141,4447,703,88100,66762
1309,956,353,735,119800,66763
242,188,54,489,102200,66767
148,129,19,813,40900,66769
432,339,93,594,73700,66770
371,330,41,529,91900,66771
108,101,7,-,76500,66772
327,267,60,671,57500,66773
78,63,15,-,150700,66775
456,369,87,611,85800,66776
281,236,45,475,37800,66777
0,0,0,-,-,66778
226,162,64,400,83200,66779
227,203,24,-,71800,66780
454,353,101,804,81500,66781
99,70,29,533,31700,66782
1000,774,226,548,54300,66783
11255,6208,5047,619,96400,66801
80,72,8,-,-,66830
225,186,39,725,72000,66833
394,312,82,629,88400,66834
518,441,77,617,89400,66835
62,59,3,-,43500,66838
1607,1104,503,599,117400,66839
283,222,61,573,86200,66840
130,80,50,490,57300,66842
96,94,2,-,-,66843
461,362,99,418,71100,66845
1361,1019,342,487,94500,66846
169,138,31,681,88800,66849
80,58,22,713,-,66850
269,182,87,537,33300,66851
266,207,59,550,75400,66852
179,147,32,525,-,66853
344,226,118,671,58800,66854
689,559,130,653,127100,66856
411,288,123,650,80600,66857
203,177,26,592,69400,66858
98,81,17,769,72500,66859
610,448,162,580,73300,66860
1251,1028,223,603,87000,66861
46,34,12,438,66000,66862
22,18,4,-,-,66863
156,137,19,588,75000,66864
484,399,85,608,114900,66865
644,458,186,540,68200,66866
310,254,56,550,89200,66868
307,220,87,545,78600,66869
60,51,9,-,32500,66870
577,503,74,614,84600,66871
439,327,112,779,87300,66872
118,111,7,525,-,66873
2641,1802,839,626,80100,66901
97,97,0,-,44800,66930
54,46,8,-,82900,66932
146,133,13,-,71900,66933
1074,785,289,441,55900,66935
154,142,12,725,53300,66936
335,288,47,425,66000,66937
436,351,85,510,81800,66938
274,222,52,539,61600,66939
167,144,23,-,58800,66940
89,79,10,631,46300,66941
90,71,19,592,55000,66942
216,173,43,375,48700,66943
80,42,38,471,25000,66944
407,331,76,710,83300,66945
54,46,8,-,89300,66946
197,166,31,522,62800,66948
378,292,86,413,43200,66949
353,271,82,445,61500,66951
182,152,30,533,48800,66952
275,203,72,414,74800,66953
45,33,12,-,117200,66955
509,394,115,485,56100,66956
133,107,26,824,20600,66958
119,102,17,-,28900,66959
63,45,18,504,14000,66960
125,96,29,473,76700,66962
70,53,17,363,29800,66963
77,62,15,425,45000,66964
331,265,66,604,61300,66966
933,698,235,449,70400,66967
711,558,153,418,78200,66968
52,52,0,-,85000,66970
411,363,48,850,186200,67001
5008,4047,961,1115,174200,67002
1089,858,231,674,64700,67003
316,214,102,619,84400,67004
6189,3779,2410,640,76600,67005
238,185,53,767,74300,67008
354,261,93,570,59400,67009
5228,3356,1872,677,130300,67010
10,10,0,-,-,67012
964,690,274,774,80300,67013
157,140,17,775,106000,67016
795,712,83,827,202700,67017
63,51,12,-,-,67018
458,393,65,725,82000,67019
668,500,168,624,110600,67020
22,17,5,-,80700,67021
714,560,154,468,57100,67022
108,101,7,531,61700,67023
305,223,82,504,43000,67024
1342,1146,196,690,147800,67025
1715,1474,241,708,158600,67026
104,82,22,759,105000,67028
456,323,133,522,72300,67029
895,798,97,1010,168400,67030
942,775,167,634,108700,67031
399,301,98,-,89700,67035
31,24,7,-,95000,67036
10787,7802,2985,869,161800,67037
252,218,34,496,76700,67038
1251,991,260,671,116900,67039
105,89,16,-,100500,67041
6669,4367,2302,677,97600,67042
1456,1029,427,514,57400,67045
342,274,68,663,47400,67047
33,33,0,-,155500,67049
545,487,58,717,154200,67050
174,145,29,579,61000,67051
2668,2235,433,983,165300,67052
260,204,56,460,85600,67053
565,339,226,606,167100,67054
48,32,16,-,"10,000-",67055
1027,833,194,584,127500,67056
91,75,16,386,62500,67057
804,604,200,633,76600,67058
336,258,78,425,83100,67059
5202,3894,1308,870,107700,67060
76,65,11,475,-,67061
1678,1199,479,528,145300,67062
1352,1088,264,559,93100,67063
83,68,15,1100,94000,67065
157,142,15,800,96700,67066
669,628,41,867,154600,67067
1660,1255,405,595,87000,67068
460,348,112,532,83600,67070
62,50,12,-,111300,67071
91,48,43,706,54000,67072
121,99,22,525,73800,67073
686,558,128,650,98000,67074
1367,1051,316,941,154400,67101
83,74,9,-,110000,67103
1066,687,379,607,77700,67104
72,54,18,-,-,67105
77,77,0,-,112500,67106
1201,941,260,488,133200,67107
590,445,145,727,103000,67108
161,110,51,547,81400,67109
3125,2631,494,907,128400,67110
102,87,15,-,104200,67111
92,78,14,275,51300,67112
8745,5913,2832,710,109700,67114
672,399,273,602,148900,67117
253,205,48,675,92100,67118
576,426,150,464,93200,67119
564,528,36,-,158700,67120
53,46,7,-,-,67122
284,194,90,675,83800,67123
3200,2053,1147,687,86500,67124
251,215,36,378,54200,67127
119,86,33,384,45600,67131
186,176,10,-,90000,67132
2340,1884,456,850,148100,67133
137,118,19,840,60000,67134
1148,901,247,838,144100,67135
249,227,22,494,52400,67137
107,102,5,-,66400,67138
318,265,53,656,65800,67140
194,170,24,744,82000,67142
8,7,1,-,33800,67143
980,786,194,765,136400,67144
763,604,159,686,91600,67146
3523,2965,558,780,157100,67147
329,322,7,-,219400,67149
21,10,11,-,-,67150
198,181,17,675,87200,67151
3677,2538,1139,652,76500,67152
460,352,108,743,122500,67154
78,56,22,-,-,67155
5602,3646,1956,698,90600,67156
65,53,12,-,53900,67159
961,48,913,828,288900,67202
12757,6238,6519,680,94100,67203
7888,5958,1930,644,101600,67204
5807,5092,715,959,212500,67205
7050,4563,2487,811,236400,67206
11393,5625,5768,757,133900,67207
7284,4163,3121,788,112300,67208
5139,3712,1427,758,142000,67209
3308,1329,1979,619,124900,67210
8069,3635,4434,668,68800,67211
18321,12262,6059,794,134500,67212
8710,4067,4643,697,65800,67213
6075,2195,3880,615,48700,67214
1975,1804,171,1083,140100,67215
9108,5663,3445,697,68500,67216
11209,7460,3749,754,80700,67217
9568,4646,4922,707,84000,67218
4328,2924,1404,810,93400,67219
5704,3440,2264,733,138000,67220
208,193,15,-,278900,67223
7779,4465,3314,910,194000,67226
89,89,0,-,189600,67227
690,690,0,-,314200,67228
3506,3352,154,1583,283500,67230
109,109,0,-,261500,67232
4049,3850,199,1627,212400,67235
0,0,0,-,-,67260
5231,3468,1763,657,80700,67301
623,494,129,628,93000,67330
72,61,11,425,61500,67332
1230,930,300,638,75000,67333
28,28,0,-,25000,67334
1415,1123,292,639,74200,67335
697,437,260,659,56900,67336
5061,3438,1623,604,66500,67337
176,130,46,692,42900,67340
99,92,7,-,71100,67341
388,313,75,555,84300,67342
319,270,49,664,67000,67344
65,58,7,-,95000,67345
167,157,10,570,74100,67346
189,172,17,-,75000,67347
511,374,137,446,49600,67349
223,209,14,-,65000,67351
241,200,41,475,50000,67352
259,210,49,675,44700,67353
299,224,75,519,79000,67354
81,76,5,738,-,67355
1088,831,257,544,61800,67356
5024,3240,1784,574,74900,67357
152,118,34,533,48900,67360
780,618,162,669,61000,67361
29,29,0,-,46200,67363
82,67,15,638,58800,67364
20793,13624,7169,719,122800,67401
4239,2944,1295,631,129800,67410
427,344,83,627,148500,67416
106,93,13,-,66600,67417
69,67,2,-,24200,67418
1924,1315,609,531,99100,67420
513,432,81,742,128400,67422
130,92,38,609,65000,67423
265,214,51,613,154200,67425
184,153,31,576,54300,67427
583,484,99,738,118400,67428
314,255,59,544,55600,67430
928,656,272,645,141100,67431
2380,1883,497,606,98300,67432
314,276,38,588,57500,67436
516,381,135,436,69400,67437
120,110,10,608,65000,67438
1296,940,356,578,111000,67439
408,306,102,919,74300,67441
89,81,8,-,174200,67442
684,555,129,741,153500,67443
253,207,46,440,65000,67444
257,207,50,564,54500,67445
273,232,41,365,78100,67446
126,91,35,722,110800,67447
573,449,124,783,152200,67448
1287,908,379,544,66800,67449
282,227,55,563,65000,67450
394,270,124,780,77500,67451
95,78,17,-,57100,67452
247,209,38,560,77700,67454
785,652,133,527,74800,67455
1796,1229,567,684,165000,67456
332,226,106,567,74000,67457
106,74,32,653,65300,67458
120,87,33,619,54300,67459
6299,4500,1799,692,139000,67460
447,358,89,605,82300,67464
361,286,75,481,54900,67466
1109,860,249,628,84000,67467
102,91,11,594,73600,67468
185,147,38,1080,106700,67470
815,606,209,524,71900,67473
92,68,24,-,60000,67474
102,86,16,575,75000,67475
36,35,1,-,-,67478
711,601,110,638,114500,67480
244,209,35,400,58100,67481
29,29,0,-,70700,67482
125,99,26,-,57900,67483
336,292,44,500,77900,67484
166,129,37,333,92600,67485
556,426,130,925,135400,67487
411,310,101,683,71500,67490
175,150,25,650,127100,67491
102,80,22,776,75000,67492
9787,5432,4355,638,65600,67501
9916,7231,2685,766,130800,67502
1093,624,469,511,89000,67505
141,127,14,-,73200,67510
162,150,12,538,74000,67511
70,54,16,-,52500,67512
25,21,4,-,33800,67513
374,280,94,711,58500,67514
24,14,10,-,-,67515
165,152,13,395,63600,67516
30,23,7,-,153100,67518
107,67,40,467,-,67519
152,132,20,444,78000,67520
61,52,9,-,32300,67521
834,655,179,596,123700,67522
160,106,54,533,55600,67523
266,224,42,500,23800,67524
405,307,98,588,78800,67525
1238,940,298,599,79100,67526
131,99,32,463,63100,67529
8012,5336,2676,613,86700,67530
776,605,171,730,97700,67543
1208,790,418,665,80500,67544
82,68,14,-,55000,67545
1034,817,217,801,138500,67546
744,581,163,508,57100,67547
640,449,191,549,79900,67548
2170,1536,634,555,78800,67550
255,200,55,388,56800,67552
71,68,3,-,35800,67553
1661,1260,401,516,78400,67554
131,111,20,850,53900,67556
222,186,36,518,41800,67557
15,8,7,-,-,67559
744,575,169,607,75800,67560
563,413,150,646,65900,67561
151,129,22,488,80700,67563
121,103,18,543,62300,67564
208,180,28,500,48000,67565
209,173,36,770,66700,67566
242,176,66,507,47500,67567
108,99,9,625,96400,67568
532,436,96,702,81300,67570
221,181,40,475,53100,67572
91,68,23,754,92700,67573
120,86,34,408,51200,67574
191,160,31,655,57300,67575
811,695,116,664,83200,67576
568,465,103,575,56400,67578
1194,828,366,518,86500,67579
109,93,16,400,35500,67581
351,274,77,492,44200,67583
140,107,33,531,40700,67584
9665,5828,3837,649,163200,67601
163,126,37,380,53100,67621
328,233,95,516,68800,67622
98,83,15,500,-,67623
162,137,25,469,62100,67625
67,62,5,-,67100,67626
24,17,7,-,-,67628
100,76,24,-,-,67629
90,83,7,-,92500,67631
93,74,19,525,86000,67632
124,94,30,425,43800,67634
63,60,3,-,33800,67635
1176,956,220,625,103300,67637
122,104,18,-,59400,67638
68,61,7,-,82500,67639
248,194,54,630,90000,67640
812,637,175,468,75900,67642
121,83,38,580,41700,67643
131,109,22,689,38800,67644
299,260,39,553,73000,67645
311,240,71,506,71700,67646
129,83,46,425,75400,67647
292,225,67,455,54600,67648
139,96,43,415,58000,67649
109,70,39,383,56700,67650
240,194,46,413,43300,67651
137,125,12,-,60800,67653
1319,932,387,789,67200,67654
23,9,14,-,-,67656
164,118,46,361,80900,67657
105,62,43,-,-,67658
73,70,3,-,70000,67659
14,10,4,-,95000,67660
1379,1037,342,529,84700,67661
1130,819,311,616,86000,67663
148,123,25,-,73800,67664
2250,1684,566,590,89200,67665
73,68,5,600,103600,67667
733,585,148,504,62600,67669
713,571,142,641,139200,67671
1124,878,246,544,81700,67672
40,36,4,-,61100,67673
19,19,0,-,-,67674
103,101,2,-,40400,67675
2644,1911,733,448,117100,67701
748,566,182,616,90000,67730
295,228,67,673,64100,67731
225,178,47,604,84500,67732
115,105,10,-,88200,67733
106,58,48,570,47500,67734
2546,1568,978,642,76800,67735
110,82,28,720,73300,67736
204,171,33,583,75500,67737
256,220,36,550,76800,67738
89,82,7,394,48000,67739
783,595,188,470,93900,67740
114,74,40,514,65500,67741
78,53,25,-,89600,67743
102,74,28,-,85000,67744
135,113,22,425,57700,67745
91,88,3,-,58000,67747
1026,776,250,702,91700,67748
1113,808,305,561,66300,67749
125,101,24,-,51700,67751
546,407,139,566,80200,67752
207,146,61,570,78200,67753
947,749,198,538,88000,67756
241,203,38,-,89500,67757
412,302,110,431,77400,67758
87,65,22,-,98300,67761
100,81,19,425,87800,67762
173,113,60,463,60400,67764
9840,5947,3893,682,102900,67801
445,318,127,603,53400,67831
340,265,75,569,82000,67834
970,661,309,719,120700,67835
44,24,20,-,48300,67836
333,232,101,467,97100,67837
336,284,52,729,72400,67838
626,539,87,479,78300,67839
43,34,9,-,22100,67840
131,119,12,-,71400,67841
167,121,46,535,48000,67842
146,0,146,-,-,67843
360,240,120,591,87400,67844
11544,6895,4649,719,120800,67846
164,133,31,392,64500,67849
199,119,80,570,64400,67850
877,728,149,510,144800,67851
302,229,73,671,101000,67853
601,434,167,688,88000,67854
681,531,150,564,84100,67855
58,42,16,-,212500,67857
265,201,64,669,78900,67859
946,709,237,583,96700,67860
711,561,150,688,80100,67861
132,99,33,617,-,67862
135,75,60,472,82500,67863
810,640,170,589,89500,67864
430,275,155,709,89700,67865
639,486,153,633,135700,67867
128,106,22,-,-,67868
537,347,190,780,108000,67869
444,325,119,703,93500,67870
2145,1570,575,770,134400,67871
476,397,79,565,136900,67876
798,607,191,667,120900,67877
813,565,248,568,87500,67878
478,342,136,803,89100,67879
2711,2124,587,658,100400,67880
158,108,50,675,156700,67882
7067,4826,2241,701,89900,67901
874,611,263,568,108900,67950
1662,1240,422,681,96200,67951
226,169,57,590,106300,67952
70,46,24,-,120000,67953
250,171,79,583,84000,67954
46,42,4,-,70000,68001
832,721,111,886,162600,68002
1789,1322,467,776,171000,68003
370,279,91,563,87800,68004
9207,5209,3998,798,130200,68005
3095,2737,358,788,214100,68007
4962,3723,1239,691,164600,68008
20,0,20,-,-,68010
148,141,7,500,112500,68014
442,362,80,843,143800,68015
204,180,24,1156,225800,68016
607,493,114,743,141900,68017
245,231,14,900,146800,68018
220,189,31,675,90800,68019
311,241,70,456,57900,68020
7174,5531,1643,903,283200,68022
960,825,135,686,266600,68023
12261,7755,4506,720,125000,68025
4086,3356,730,867,224300,68028
384,242,142,592,133300,68029
324,247,77,789,106400,68030
799,632,167,564,117400,68031
146,132,14,1000,163000,68033
312,264,48,1310,174100,68034
127,82,45,708,54000,68036
739,600,139,827,165100,68037
595,447,148,526,90800,68038
287,83,204,514,44400,68039
137,127,10,-,135600,68040
397,295,102,727,125300,68041
38,33,5,875,78800,68042
219,191,28,758,125400,68044
708,539,169,686,86800,68045
9714,7229,2485,837,188800,68046
696,534,162,620,109300,68047
4758,3757,1001,765,161200,68048
306,243,63,713,99700,68050
113,89,24,625,45000,68055
689,518,171,542,84600,68057
159,149,10,-,275000,68058
1217,1082,135,811,189000,68059
943,710,233,579,99200,68061
126,104,22,550,119400,68062
104,82,22,397,60000,68063
1550,1014,536,764,150000,68064
649,517,132,755,173400,68065
2097,1529,568,589,153100,68066
343,221,122,507,39800,68067
29,27,2,-,121900,68068
1204,972,232,1131,209700,68069
244,208,36,591,156300,68070
521,216,305,527,68500,68071
27,16,11,738,70000,68072
689,617,72,1028,166800,68073
3188,439,2749,914,273900,68102
14031,7827,6204,801,98700,68104
9336,3983,5353,683,115500,68105
9495,5831,3664,811,126400,68106
9395,5620,3775,726,89200,68107
5172,2510,2662,782,83600,68108
2994,1365,1629,762,65800,68110
7897,3347,4550,808,63900,68111
4293,2904,1389,814,94900,68112
187,0,187,1091,-,68113
8155,4026,4129,919,163300,68114
10442,8384,2058,1019,209000,68116
3148,2295,853,928,108100,68117
3481,3044,437,1250,246900,68118
4058,3315,743,1006,141000,68122
11332,6677,4655,1010,168300,68123
6520,4281,2239,991,174100,68124
10365,4821,5544,766,144100,68127
7505,4271,3234,909,152800,68128
7395,5727,1668,1212,247100,68130
5446,1472,3974,665,107400,68131
6271,3140,3131,682,230000,68132
3448,3173,275,1166,231600,68133
12287,6525,5762,772,129300,68134
9108,8234,874,1362,213100,68135
5589,4957,632,1112,215900,68136
10140,6949,3191,990,141500,68137
4775,3617,1158,768,140000,68138
1297,1134,163,1064,208200,68142
10169,7098,3071,833,155900,68144
3758,2604,1154,929,120600,68147
2470,1948,522,769,177300,68152
10044,6038,4006,840,192700,68154
2214,1811,403,952,140600,68157
11685,7471,4214,939,146100,68164
0,0,0,-,-,68178
529,449,80,831,201100,68301
140,131,9,-,46800,68303
144,121,23,961,237500,68304
1727,1097,630,640,129800,68305
158,115,43,493,95000,68307
46,31,15,706,44400,68309
6074,3808,2266,629,104100,68310
286,246,40,619,117200,68313
252,195,57,763,108600,68314
47,45,2,-,-,68315
175,150,25,545,83800,68316
636,594,42,971,171700,68317
224,174,50,763,64400,68318
267,221,46,650,114200,68319
167,139,28,-,102300,68320
159,153,6,-,115100,68321
209,178,31,531,67900,68322
128,108,20,-,109400,68323
65,18,47,626,50000,68324
102,90,12,680,67500,68325
108,81,27,569,63800,68326
150,136,14,425,44400,68327
210,165,45,683,109900,68328
223,167,56,571,71400,68329
347,310,37,643,151300,68331
50,48,2,-,-,68332
2915,1710,1205,736,118100,68333
212,171,41,425,56000,68335
184,167,17,-,166100,68336
136,114,22,525,70000,68337
139,111,28,438,82700,68338
450,415,35,780,256900,68339
386,266,120,602,64700,68340
438,359,79,588,110700,68341
179,154,25,575,95700,68342
396,303,93,716,112200,68343
180,159,21,722,144800,68344
127,118,9,910,57900,68345
193,144,49,543,155400,68346
909,847,62,1063,202900,68347
145,98,47,563,212000,68348
433,394,39,648,146100,68349
78,73,5,-,55900,68350
345,258,87,616,83800,68351
2335,1682,653,518,71700,68352
389,302,87,563,71600,68354
2313,1664,649,496,87700,68355
153,137,16,1069,127100,68357
614,561,53,540,247500,68358
600,507,93,638,107000,68359
217,177,40,1310,152000,68360
1000,689,311,530,76400,68361
34,34,0,-,-,68362
52,41,11,580,116300,68364
117,101,16,530,115600,68365
403,311,92,977,145300,68366
165,136,29,625,82900,68367
181,136,45,830,215400,68368
998,702,296,520,86500,68370
641,536,105,-,115500,68371
982,787,195,849,174400,68372
45,41,4,-,-,68375
660,474,186,439,56600,68376
170,143,27,-,92500,68377
301,266,35,654,99200,68378
33,29,4,-,72300,68379
38,30,8,-,37500,68380
89,75,14,-,78800,68381
13,12,1,-,85000,68382
300,229,71,719,138500,68401
482,405,77,943,221300,68402
72,61,11,690,121700,68403
359,325,34,1070,244300,68404
1213,798,415,662,158700,68405
231,166,65,661,66200,68406
276,215,61,650,149400,68407
323,275,48,800,139500,68409
3606,2506,1100,648,113700,68410
240,212,28,669,117600,68413
130,104,26,569,108300,68414
288,267,21,513,95500,68415
115,83,32,550,36100,68416
120,104,16,822,73300,68417
483,405,78,892,152400,68418
95,76,19,747,136500,68419
632,432,200,481,66700,68420
323,211,112,526,70200,68421
211,158,53,766,140600,68422
404,371,33,621,214200,68423
330,266,64,615,99400,68424
411,390,21,443,286000,68428
559,506,53,1113,301700,68430
171,154,17,-,53300,68431
97,68,29,514,41800,68433
3114,2145,969,720,153100,68434
249,194,55,615,78700,68436
136,116,20,581,71000,68437
51,45,6,680,112500,68438
195,134,61,623,112800,68439
63,58,5,392,-,68440
88,86,2,-,95000,68441
169,156,13,575,55000,68442
460,372,88,586,97500,68443
30,27,3,-,57500,68444
47,41,6,600,46900,68445
1166,875,291,652,134400,68446
233,186,47,469,65500,68447
170,122,48,635,61400,68448
996,699,297,633,78800,68450
43,38,5,-,40000,68452
137,89,48,832,46600,68453
213,172,41,638,98000,68454
274,246,28,629,220300,68455
455,332,123,794,136800,68456
120,110,10,464,49300,68457
62,53,9,850,95000,68458
350,258,92,870,150000,68460
196,151,45,-,492100,68461
1469,1221,248,671,166400,68462
609,467,142,657,140500,68463
213,159,54,575,62100,68464
881,599,282,620,100200,68465
794,602,192,517,56500,68466
3805,2495,1310,622,126500,68467
11307,5848,5459,594,137700,68502
6133,1892,4241,676,97200,68503
7916,2755,5161,764,106000,68504
6970,4119,2851,788,133500,68505
12926,7783,5143,879,152800,68506
6076,4191,1885,705,123700,68507
4758,537,4221,524,89400,68508
9312,5252,4060,643,139600,68510
5064,3343,1721,889,207400,68512
49,13,36,-,-,68514
16088,11922,4166,855,209400,68516
168,168,0,-,261800,68517
563,540,23,1148,315600,68520
12906,7563,5343,807,146000,68521
4319,3223,1096,852,146300,68522
473,439,34,-,304800,68523
1970,1202,768,777,123200,68524
2123,1810,313,1091,285500,68526
325,325,0,-,343300,68527
2538,1375,1163,885,135900,68528
35,35,0,-,-,68531
229,229,0,-,307100,68532
11051,7816,3235,679,133900,68601
1128,884,244,587,122300,68620
233,206,27,-,118300,68621
149,107,42,384,102100,68622
156,130,26,529,30500,68623
398,364,34,784,136800,68624
265,221,44,750,113300,68626
308,270,38,646,68000,68627
365,290,75,620,68600,68628
580,472,108,397,92000,68629
174,141,33,625,115800,68631
1679,1175,504,644,99300,68632
485,402,83,550,82000,68633
189,157,32,1107,89000,68634
181,149,32,825,111300,68635
551,438,113,550,82300,68636
150,122,28,542,74500,68637
778,601,177,551,80700,68638
607,453,154,533,89400,68640
435,336,99,544,104500,68641
698,544,154,578,149300,68642
452,347,105,530,118400,68643
298,229,69,574,122300,68644
247,207,40,552,101500,68647
150,138,12,538,162500,68648
782,614,168,661,112700,68649
578,481,97,494,100200,68651
298,222,76,596,58700,68652
275,231,44,700,89900,68653
215,168,47,628,63800,68654
64,57,7,775,-,68655
308,269,39,763,119800,68658
55,47,8,538,91300,68659
473,352,121,601,96700,68660
2260,1534,726,550,94900,68661
528,398,130,649,105500,68662
314,260,54,660,69400,68663
157,100,57,766,60000,68664
404,347,57,538,70200,68665
606,461,145,667,105000,68666
61,61,0,-,103200,68667
182,155,27,725,88600,68669
12310,7990,4320,622,126300,68701
295,253,42,732,103200,68710
115,115,0,-,72100,68711
983,734,249,547,90200,68713
591,407,184,518,75200,68714
581,480,101,674,130900,68715
434,304,130,536,67800,68716
99,93,6,-,112500,68717
778,573,205,582,81700,68718
55,47,8,-,52500,68719
112,82,30,575,83300,68720
224,175,49,454,48800,68722
198,165,33,585,90700,68723
40,35,5,-,52500,68724
227,189,38,582,59700,68725
295,257,38,625,100500,68726
335,270,65,518,86400,68727
95,74,21,425,68600,68728
816,636,180,589,87600,68729
742,612,130,586,131400,68730
973,732,241,560,109200,68731
73,50,23,983,65000,68732
579,400,179,525,85600,68733
39,28,11,-,106800,68734
355,268,87,528,70000,68735
217,169,48,440,159200,68736
1235,1014,221,570,124200,68739
352,297,55,784,137800,68740
283,233,50,921,141300,68741
60,50,10,575,33000,68742
235,214,21,755,175000,68743
669,466,203,677,104100,68745
189,158,31,356,33600,68746
69,60,9,569,112500,68747
1093,787,306,753,89500,68748
25,21,4,-,55000,68749
26,24,2,-,57500,68751
313,257,56,654,89700,68752
40,33,7,-,131300,68753
128,108,20,-,117100,68755
820,580,240,553,76900,68756
341,303,38,810,91500,68757
513,379,134,520,78400,68758
123,104,19,519,41400,68759
530,301,229,323,70800,68760
154,140,14,-,24600,68761
2113,1460,653,585,113400,68763
337,258,79,434,64500,68764
554,428,126,540,95300,68765
210,183,27,506,102800,68766
1272,1023,249,601,99800,68767
259,204,55,668,100800,68768
778,657,121,540,71600,68769
621,484,137,755,100000,68770
613,496,117,580,98700,68771
73,46,27,-,80000,68773
134,123,11,625,114100,68774
5232,3279,1953,688,104700,68776
362,296,66,559,76000,68777
249,169,80,533,72500,68778
1036,851,185,531,109400,68779
461,332,129,495,104700,68780
667,440,227,520,85000,68781
429,330,99,554,67400,68783
742,531,211,646,80400,68784
106,97,9,-,115800,68785
463,371,92,434,80200,68786
2452,1345,1107,537,134500,68787
2002,1341,661,613,123600,68788
67,60,7,-,-,68789
325,230,95,575,88200,68790
742,501,241,674,103600,68791
157,132,25,625,74500,68792
10970,6335,4635,709,100700,68801
9351,5806,3545,682,156900,68803
356,294,62,792,78300,68810
274,224,50,655,115500,68812
239,193,46,425,101100,68813
386,304,82,605,54600,68814
256,173,83,496,104900,68815
90,81,9,-,131700,68816
141,130,11,475,68000,68817
2175,1729,446,646,122400,68818
169,126,43,458,76000,68820
56,32,24,-,60000,68821
2035,1335,700,590,103300,68822
1014,779,235,393,96400,68823
493,377,116,661,143000,68824
452,333,119,572,117900,68825
1731,1149,582,535,87700,68826
248,215,33,725,94600,68827
132,110,22,631,-,68828
297,253,44,641,100500,68831
785,625,160,764,203500,68832
191,107,84,690,118000,68833
76,59,17,650,88300,68834
231,169,62,542,110800,68835
636,492,144,713,107100,68836
60,44,16,-,109400,68837
117,109,8,-,56600,68838
1187,824,363,741,130600,68840
236,216,20,725,122000,68841
218,152,66,506,64000,68842
344,283,61,489,109900,68843
100,90,10,-,152200,68844
7619,4358,3261,747,183800,68845
146,110,36,621,80000,68846
6993,4394,2599,708,149000,68847
0,0,0,-,-,68849
4074,2530,1544,684,88400,68850
285,222,63,647,69000,68852
680,489,191,517,83700,68853
343,273,70,950,134500,68854
196,160,36,731,70900,68855
232,159,73,608,78300,68856
124,98,26,588,80600,68858
275,210,65,389,80000,68859
150,131,19,775,61100,68860
37,30,7,-,94200,68861
1335,933,402,597,89300,68862
473,350,123,694,107800,68863
441,312,129,675,79600,68864
381,317,64,-,139200,68865
340,293,47,788,166400,68866
846,654,192,622,111100,68869
202,173,29,633,204500,68870
107,77,30,-,115600,68871
337,323,14,-,122000,68872
1434,1033,401,564,124900,68873
440,345,95,521,71000,68874
280,222,58,443,82400,68875
605,447,158,581,102200,68876
157,106,51,705,103800,68878
169,132,37,508,102100,68879
17,8,9,-,-,68881
166,135,31,569,34000,68882
875,657,218,597,133100,68883
10604,6922,3682,640,106700,68901
682,497,185,531,88200,68920
531,372,159,674,72100,68922
41,40,1,-,65000,68923
485,411,74,577,125200,68924
225,187,38,867,171400,68925
414,270,144,346,45000,68926
509,328,181,788,110700,68927
161,134,27,529,77500,68928
83,73,10,-,38100,68929
608,494,114,428,119300,68930
198,180,18,575,52100,68932
398,295,103,487,77300,68933
47,41,6,-,35800,68934
271,184,87,535,73500,68935
108,77,31,-,39400,68936
661,501,160,702,126000,68937
223,195,28,525,65000,68938
515,406,109,525,53600,68939
244,202,42,750,153400,68940
341,285,56,975,95800,68941
180,149,31,492,45400,68942
119,86,33,425,38300,68943
479,346,133,540,75800,68944
144,112,32,-,74300,68945
17,13,4,-,40800,68946
269,215,54,485,85700,68947
130,102,28,620,49400,68948
2738,1844,894,560,112800,68949
195,132,63,504,82900,68950
50,40,10,-,-,68952
30,14,16,-,-,68954
784,656,128,611,161100,68955
496,411,85,684,104400,68956
289,243,46,480,69200,68957
239,197,42,688,116300,68958
1660,1112,548,699,122600,68959
79,65,14,429,46900,68960
346,254,92,513,55400,68961
52,47,5,-,67500,68964
323,236,87,478,56500,68966
493,369,124,489,61200,68967
26,25,1,-,62100,68969
638,463,175,342,54900,68970
222,176,46,510,180700,68971
92,90,2,-,22700,68972
179,163,16,595,96100,68973
79,73,6,-,69000,68974
51,51,0,-,100800,68975
127,88,39,644,120500,68976
132,128,4,-,52500,68977
1068,747,321,483,54300,68978
786,594,192,610,99200,68979
144,120,24,765,115400,68980
157,136,21,-,68200,68981
291,210,81,625,96000,68982
3861,2926,935,566,90800,69001
219,182,37,679,74400,69020
580,413,167,505,74300,69021
768,517,251,571,98800,69022
132,116,16,-,114000,69023
546,406,140,657,79300,69024
441,287,154,561,83900,69025
92,81,11,-,45000,69026
39,39,0,-,97500,69027
323,259,64,663,101100,69028
165,139,26,392,66800,69029
114,58,56,544,60000,69030
201,141,60,554,65800,69032
1118,867,251,569,103400,69033
409,309,100,600,83800,69034
34,28,6,-,57500,69036
35,33,2,-,-,69037
212,158,54,675,76300,69038
30,24,6,-,95000,69039
309,227,82,533,61400,69040
63,47,16,-,-,69041
20,11,9,-,137500,69042
210,168,42,708,44800,69043
361,259,102,656,50300,69044
481,362,119,604,66800,69045
78,78,0,-,75000,69046
12391,7824,4567,648,119000,69101
501,364,137,532,141300,69120
167,105,62,683,100600,69121
287,221,66,613,73600,69122
364,297,67,763,121300,69123
170,114,56,606,24400,69125
416,320,96,666,131000,69127
95,89,6,725,151400,69128
566,440,126,625,72900,69129
2152,1407,745,651,96400,69130
235,180,55,931,85500,69131
76,58,18,-,-,69132
179,132,47,950,74500,69133
143,115,28,625,87500,69134
58,22,36,-,-,69135
1682,1284,398,651,107500,69138
813,580,233,644,101000,69140
169,135,34,718,73600,69141
49,45,4,-,73800,69142
542,474,68,782,126000,69143
33,25,8,-,-,69144
1357,880,477,675,83300,69145
207,139,68,-,119600,69146
315,259,56,633,110600,69147
63,50,13,-,84000,69148
299,228,71,440,68700,69149
145,124,21,686,92500,69150
367,274,93,607,119000,69151
343,259,84,625,80900,69152
2686,1696,990,579,103500,69153
524,440,84,540,84000,69154
490,315,175,608,82500,69155
260,201,59,756,86000,69156
13,9,4,-,107500,69157
41,25,16,431,33800,69161
3543,2392,1151,626,125500,69162
367,263,104,547,118600,69163
765,550,215,704,122400,69165
293,193,100,534,147700,69166
159,104,55,636,115600,69167
120,98,22,619,64300,69168
257,198,59,656,96000,69169
129,98,31,575,117600,69170
5,5,0,-,-,69171
1904,1141,763,586,126700,69201
1246,893,353,487,80400,69210
152,101,51,775,66100,69211
104,77,27,-,-,69212
88,72,16,-,109000,69214
47,29,18,-,74200,69216
171,130,41,613,50000,69217
91,61,30,-,38100,69218
65,34,31,431,76400,69219
8,6,2,-,-,69220
74,48,26,-,103600,69221
4233,2869,1364,546,103500,69301
9,3,6,-,-,69331
126,93,33,-,54300,69333
898,710,188,713,84900,69334
17,8,9,-,-,69335
1016,599,417,679,87600,69336
2765,1521,1244,607,123000,69337
783,629,154,552,73300,69339
48,45,3,-,221200,69340
4137,3003,1134,691,117000,69341
1039,681,358,586,85300,69343
201,140,61,436,133000,69345
265,200,65,542,86500,69346
542,460,82,571,80400,69347
601,455,146,575,87100,69348
171,145,26,331,55400,69350
99,52,47,-,-,69351
283,208,75,826,93300,69352
13,12,1,-,-,69353
47,36,11,-,-,69354
71,68,3,-,78900,69355
757,559,198,613,86100,69356
1501,1147,354,682,116600,69357
780,547,233,663,78000,69358
556,393,163,653,69300,69360
7099,4444,2655,727,112600,69361
24,24,0,-,-,69365
91,60,31,763,125000,69366
119,94,25,488,77500,69367
17534,8968,8566,857,219300,70001
8610,4408,4202,880,273800,70002
16051,12207,3844,861,177900,70003
11353,6926,4427,949,266200,70005
6067,3789,2278,950,245900,70006
1496,1326,170,906,175600,70030
533,460,73,1012,159100,70031
1706,1093,613,870,134300,70032
457,427,30,-,115400,70036
5913,3603,2310,1042,238900,70037
160,146,14,-,103600,70038
872,586,286,881,144100,70039
350,317,33,792,92400,70040
1069,951,118,945,64800,70041
7308,4158,3150,852,134800,70043
4581,3764,817,1006,221700,70047
899,640,259,652,158000,70049
38,38,0,-,-,70050
813,605,208,536,134500,70051
1237,945,292,947,137500,70052
6376,2845,3531,842,150800,70053
14045,8085,5960,978,165200,70056
1593,1203,390,466,174100,70057
13427,8787,4640,954,143300,70058
6118,3132,2986,872,139300,70062
19488,12190,7298,965,180000,70065
908,811,97,1099,155600,70067
11351,8632,2719,973,162300,70068
4430,3672,758,1022,203300,70070
1474,1037,437,770,136500,70071
19621,14201,5420,892,140400,70072
1675,1300,375,904,161400,70075
132,95,37,-,-,70076
1142,949,193,921,154000,70079
517,451,66,823,160900,70080
129,125,4,-,83500,70082
893,803,90,565,77900,70083
2557,2015,542,815,109100,70084
1662,1502,160,761,107300,70085
742,498,244,715,81000,70086
2907,1887,1020,691,160500,70087
2752,2164,588,505,123700,70090
92,69,23,-,103500,70091
2381,1826,555,923,123600,70092
11160,6735,4425,876,108100,70094
1549,232,1317,1299,316900,70112
3691,806,2885,712,170200,70113
9872,4060,5812,822,144900,70114
15627,7294,8333,1069,382000,70115
6241,2323,3918,889,249100,70116
11045,5216,5829,880,159600,70117
13029,5974,7055,966,314400,70118
16366,5300,11066,954,220500,70119
5552,3005,2547,849,169700,70121
13894,7817,6077,926,172600,70122
12083,7183,4900,1005,235200,70123
8340,5868,2472,1350,366900,70124
6118,2613,3505,939,286800,70125
9426,4524,4902,867,151400,70126
9265,3955,5310,832,151400,70127
7134,4543,2591,879,164200,70128
3095,1870,1225,716,143100,70129
8045,2395,5650,1129,352900,70130
12107,6999,5108,858,167100,70131
0,0,0,-,-,70139
0,0,0,-,-,70163
16492,11566,4926,748,158300,70301
2589,2208,381,677,115300,70339
58,44,14,-,-,70340
1568,1131,437,808,94200,70341
1803,1262,541,591,98300,70342
1773,1507,266,643,176300,70343
2048,1748,300,593,86700,70344
3523,2786,737,698,122400,70345
3776,2714,1062,589,105400,70346
71,64,7,-,-,70352
482,420,62,-,66600,70353
1819,1479,340,706,100000,70354
369,334,35,513,79400,70355
805,679,126,710,87800,70356
1041,718,323,772,83600,70357
342,229,113,725,161900,70358
3126,2426,700,693,128700,70359
10438,7129,3309,966,211300,70360
8280,5740,2540,701,111400,70363
11243,7722,3521,911,148400,70364
960,643,317,636,108500,70372
2601,2138,463,635,135200,70373
2574,1821,753,779,119600,70374
40,40,0,-,204500,70375
1602,1441,161,620,78800,70377
8893,5388,3505,699,109000,70380
2475,2022,453,665,106000,70390
41,41,0,-,116500,70391
3166,2141,1025,795,114900,70392
317,317,0,-,134400,70393
5334,4311,1023,764,131700,70394
1902,1728,174,893,118000,70395
322,255,67,650,136700,70397
7485,3697,3788,769,157100,70401
0,0,0,-,-,70402
10360,6476,3884,791,147900,70403
2981,2551,430,966,197000,70420
5172,3986,1186,652,115100,70422
1743,1377,366,634,76200,70426
7635,4997,2638,541,76100,70427
2102,1922,180,678,208000,70431
13195,9347,3848,1018,232100,70433
6391,5740,651,984,196300,70435
219,150,69,-,-,70436
3284,2771,513,934,197700,70437
7040,5174,1866,635,102200,70438
1625,1230,395,603,103400,70441
93,53,40,-,238300,70442
3449,2708,741,646,98300,70443
3837,2983,854,812,89600,70444
4219,3604,615,956,151500,70445
2614,1979,635,715,163800,70446
3988,3615,373,1119,244600,70447
9466,7630,1836,1189,233100,70448
1366,1256,110,1071,102900,70449
1244,1029,215,582,59400,70450
11,11,0,-,-,70451
4419,3250,1169,724,148600,70452
349,334,15,-,112200,70453
10611,8270,2341,757,159900,70454
429,294,135,-,50900,70455
825,547,278,640,68200,70456
14171,10176,3995,1019,169500,70458
7708,5422,2286,963,136600,70460
9761,7180,2581,919,195200,70461
2288,1955,333,851,142800,70462
84,77,7,-,116200,70463
233,179,54,-,164000,70464
251,148,103,581,40900,70465
3255,2084,1171,755,98000,70466
8033,5968,2065,1016,286500,70471
11245,5311,5934,684,95700,70501
11098,7777,3321,943,225000,70503
17763,9135,8628,809,161300,70506
6281,4185,2096,775,139200,70507
15520,10188,5332,924,235900,70508
9378,6661,2717,641,99900,70510
3447,2774,673,538,98100,70512
123,23,100,-,-,70513
910,629,281,649,71100,70514
1104,789,315,495,76700,70515
256,242,14,-,119300,70516
9881,7815,2066,709,114000,70517
5240,4014,1226,807,196100,70518
89,89,0,-,83700,70519
6847,5545,1302,664,148600,70520
318,279,39,756,66700,70523
136,109,27,-,83300,70524
4977,3734,1243,530,86000,70525
6915,4264,2651,601,94000,70526
893,634,259,666,96100,70528
4253,3013,1240,664,113800,70529
536,448,88,-,115600,70531
997,673,324,574,79900,70532
2608,2081,527,599,103800,70533
337,259,78,700,74300,70534
6583,4278,2305,619,100600,70535
205,188,17,-,-,70537
5021,3301,1720,618,80800,70538
149,128,21,675,88000,70541
1474,1326,148,617,90400,70542
1791,1461,330,521,98200,70543
4395,3261,1134,671,70800,70544
5893,4124,1769,541,99000,70546
3925,3028,897,588,87500,70548
1517,1026,491,581,88900,70549
48,48,0,-,-,70550
645,422,223,785,109100,70552
1866,1141,725,567,78500,70554
2878,2303,575,750,145300,70555
124,65,59,256,71400,70556
0,0,0,-,-,70558
916,731,185,620,80600,70559
14497,9267,5230,676,84000,70560
6827,5549,1278,760,149800,70563
13958,9397,4561,605,97300,70570
43,43,0,-,-,70575
275,181,94,609,85300,70576
1580,1186,394,730,66600,70577
5862,4131,1731,575,96400,70578
77,35,42,-,-,70580
339,319,20,-,84100,70581
6886,5396,1490,545,97500,70582
4593,3378,1215,730,123400,70583
2800,2063,737,568,116700,70584
76,64,12,-,105000,70585
7621,5040,2581,511,96000,70586
1210,909,301,484,111100,70589
1960,1383,577,672,111700,70591
8110,6571,1539,900,187600,70592
13655,6682,6973,654,104400,70601
14082,9835,4247,931,197100,70605
10644,6340,4304,763,98000,70607
7183,6038,1145,831,175600,70611
4610,3112,1498,825,81100,70615
501,413,88,638,120400,70630
249,237,12,-,93500,70631
224,224,0,-,113000,70632
2661,1998,663,782,88600,70633
9277,6722,2555,679,124800,70634
222,186,36,-,58900,70637
264,209,55,395,77000,70638
169,141,28,-,84000,70639
136,99,37,475,58100,70640
109,99,10,-,-,70643
47,47,0,-,75400,70644
481,424,57,781,95600,70645
255,202,53,-,90600,70646
3220,2508,712,673,116000,70647
2445,1874,571,701,96100,70648
106,106,0,-,113800,70650
123,100,23,-,-,70651
859,633,226,691,100300,70652
1301,995,306,414,72700,70653
115,115,0,-,"10,000-",70654
1065,736,329,558,89900,70655
1342,1148,194,505,61100,70656
1744,1587,157,1060,86200,70657
343,294,49,800,80500,70658
548,320,228,860,128400,70659
592,529,63,-,74800,70660
962,864,98,354,70900,70661
164,164,0,-,133900,70662
10733,8008,2725,771,116100,70663
3989,3233,756,831,155900,70665
2641,1898,743,627,80100,70668
4005,3084,921,764,108400,70669
7579,6650,929,830,157200,70706
1665,1341,324,1022,169400,70710
1749,1403,346,693,130700,70711
140,58,82,1161,21700,70712
7165,5143,2022,877,133100,70714
547,440,107,667,101700,70715
1662,1298,364,791,191100,70719
299,98,201,806,66700,70721
2323,1899,424,719,159500,70722
526,412,114,549,105100,70723
565,501,64,-,157300,70725
19510,14489,5021,883,158300,70726
343,290,53,-,-,70729
1409,1258,151,729,108200,70730
450,405,45,-,95800,70732
595,491,104,775,121400,70733
2591,2015,576,1199,184400,70734
246,180,66,574,114000,70736
15254,11476,3778,948,167600,70737
4763,4307,456,708,197100,70739
542,436,106,764,105900,70740
56,44,12,-,154700,70743
2356,1896,460,641,94800,70744
96,57,39,-,55400,70747
1334,1030,304,656,111900,70748
608,426,182,932,167400,70749
674,512,162,488,68000,70750
302,242,60,-,155500,70752
369,244,125,847,72000,70753
3850,2954,896,805,132600,70754
860,738,122,619,137900,70755
178,151,27,-,93000,70756
1148,914,234,482,91500,70757
676,562,114,646,93800,70759
2407,1450,957,584,119200,70760
305,227,78,325,84000,70761
297,281,16,-,173000,70762
1459,1285,174,-,183000,70763
6192,4756,1436,706,111300,70764
5608,3856,1752,776,158700,70767
13496,11957,1539,1027,215300,70769
1061,992,69,-,167600,70770
350,306,44,619,89100,70772
57,57,0,-,136000,70773
3839,3126,713,751,152300,70774
3630,2792,838,784,205200,70775
1047,854,193,583,198700,70776
1728,1337,391,777,151000,70777
1220,1055,165,900,158400,70778
553,476,77,-,150900,70780
109,83,26,-,-,70782
1192,1020,172,462,171900,70783
7647,6160,1487,761,158300,70785
0,0,0,-,-,70787
1514,1021,493,612,131700,70788
291,223,68,539,122100,70789
8976,6763,2213,910,203500,70791
32,0,32,-,-,70801
10101,3806,6295,686,78900,70802
51,0,51,638,-,70803
10281,4709,5572,703,77700,70805
12609,5527,7082,736,196100,70806
5906,2964,2942,643,80200,70807
12978,7511,5467,962,294800,70808
10961,5559,5402,1093,265100,70809
15133,10759,4374,996,240700,70810
4692,3249,1443,803,115700,70811
3835,2329,1506,912,108800,70812
5341,3980,1361,805,141300,70814
10818,6986,3832,756,160200,70815
17845,8639,9206,904,176000,70816
12546,10179,2367,1160,223800,70817
3763,2869,894,798,190000,70818
1776,1316,460,1114,128400,70819
7555,1575,5980,861,228000,70820
0,0,0,-,-,70836
1834,1134,700,508,87900,71001
432,406,26,460,83500,71003
252,180,72,756,128200,71004
4397,3741,656,848,188900,71006
444,431,13,-,110300,71007
286,258,28,313,86000,71008
766,562,204,627,63000,71016
686,524,162,492,59100,71018
3306,2432,874,515,85000,71019
360,195,165,479,49500,71021
1304,1083,221,690,95500,71023
687,493,194,337,-,71024
565,482,83,476,94000,71027
669,430,239,403,87800,71028
57,47,10,-,150800,71029
661,509,152,-,124200,71030
519,364,155,756,74600,71031
825,653,172,597,120000,71032
1475,1127,348,724,123100,71033
126,95,31,1261,79000,71034
7582,6363,1219,679,153100,71037
1769,1090,679,603,69400,71038
540,530,10,675,64000,71039
3001,1838,1163,673,81900,71040
220,188,32,850,82700,71043
293,252,41,880,74300,71044
263,231,32,528,80400,71045
475,443,32,-,118000,71046
3979,3373,606,752,155300,71047
23,23,0,-,-,71048
1110,784,326,654,83100,71049
879,722,157,591,132300,71051
3973,2439,1534,491,79200,71052
7659,5106,2553,657,84900,71055
1139,882,257,689,128000,71060
667,371,296,471,121300,71061
284,229,55,-,77200,71063
1547,1202,345,508,59700,71064
446,324,122,280,80500,71065
1371,994,377,753,89800,71067
1430,1033,397,468,74600,71068
249,205,44,-,29900,71069
766,681,85,577,54300,71070
955,778,177,725,107500,71071
510,437,73,680,72300,71072
1046,782,264,500,99700,71073
2618,1724,894,510,71900,71075
2333,1912,421,728,139200,71078
118,82,36,-,-,71079
2066,1365,701,540,62300,71082
3096,939,2157,558,64800,71101
2838,1060,1778,684,51000,71103
6263,3048,3215,783,126000,71104
9846,5434,4412,957,173400,71105
12998,9015,3983,753,214800,71106
11474,7267,4207,690,111400,71107
6609,3437,3172,723,67900,71108
8218,3812,4406,683,61500,71109
843,35,808,1379,-,71110
16665,9152,7513,864,199300,71111
12688,8085,4603,920,145000,71112
6971,4107,2864,877,207200,71115
10235,6318,3917,828,144500,71118
4338,3360,978,856,132700,71119
5202,2750,2452,768,136300,71129
9009,4948,4061,665,189100,71201
8831,3965,4866,605,64800,71202
13622,7678,5944,724,132400,71203
0,0,0,-,-,71209
474,435,39,425,83100,71219
8709,5485,3224,565,78900,71220
1251,896,355,381,64200,71222
150,120,30,488,40700,71223
2582,2170,412,598,118000,71225
744,476,268,286,58800,71226
1501,1198,303,803,106800,71227
511,367,144,629,85600,71229
2472,1614,858,520,82300,71232
98,55,43,438,34200,71233
1440,1241,199,613,116700,71234
1709,1376,333,611,107100,71235
568,387,181,534,56300,71237
1098,1003,95,685,99200,71238
3476,2666,810,504,106300,71241
85,61,24,-,-,71243
1507,538,969,579,88000,71245
401,182,219,415,77900,71247
92,40,52,-,43300,71250
3227,2075,1152,513,83900,71251
110,64,46,530,47400,71253
2255,849,1406,505,52800,71254
285,221,64,338,92200,71256
628,495,133,643,83200,71259
1211,965,246,600,87400,71260
541,391,150,366,90100,71261
3092,2225,867,505,75900,71263
450,382,68,627,127200,71264
482,390,92,594,83300,71266
996,907,89,585,114600,71268
4582,2959,1623,549,87200,71269
11992,5896,6096,673,157000,71270
0,0,0,-,-,71272
922,659,263,837,78600,71275
93,67,26,-,83000,71276
687,621,66,333,41400,71277
31,0,31,-,-,71279
1433,1088,345,800,150600,71280
3741,1981,1760,488,62800,71282
193,148,45,-,58800,71286
12917,8241,4676,749,144400,71291
7619,5104,2515,693,95700,71292
5001,3348,1653,534,86900,71295
8223,3917,4306,745,114000,71301
5592,3203,2389,689,97900,71302
8314,4499,3815,859,184800,71303
28,28,0,-,-,71316
2488,1726,762,631,82700,71322
337,299,38,1063,95900,71323
400,246,154,476,63200,71325
404,269,135,434,51700,71326
1519,1055,464,700,94300,71327
2667,2156,511,737,127300,71328
379,321,58,-,81100,71331
251,140,111,286,102200,71333
3364,1797,1567,496,74500,71334
640,408,232,490,84300,71336
59,59,0,-,-,71339
332,227,105,490,77200,71340
1181,931,250,654,128100,71341
2946,2119,827,563,72600,71342
2988,2326,662,523,68000,71343
39,0,39,-,-,71345
1015,635,380,580,150100,71346
1803,1090,713,609,122700,71350
4061,2734,1327,620,92400,71351
713,472,241,560,81400,71353
757,545,212,530,99400,71354
1284,896,388,568,90000,71355
319,269,50,-,86900,71356
790,491,299,412,67200,71357
437,320,117,422,57300,71358
12671,8079,4592,723,138100,71360
646,553,93,542,87900,71362
685,398,287,444,49200,71366
477,409,68,-,75200,71367
613,380,233,478,87600,71368
993,581,412,478,70400,71369
818,647,171,382,75000,71371
2667,1739,928,537,79000,71373
466,284,182,446,55000,71375
53,19,34,-,-,71377
962,616,346,451,64600,71378
65,65,0,-,-,71401
1525,1233,292,679,96400,71403
285,191,94,568,87900,71404
2136,1512,624,821,123600,71405
79,79,0,-,-,71406
342,210,132,691,-,71407
2391,1832,559,628,146000,71409
44,31,13,-,114600,71410
1162,687,475,606,77300,71411
58,43,15,-,65000,71414
400,253,147,544,71400,71416
1890,1338,552,651,77200,71417
2384,1700,684,540,63500,71418
879,699,180,342,76300,71419
705,579,126,419,66400,71422
1647,1202,445,928,124300,71423
382,290,92,850,104900,71424
81,35,46,-,83500,71425
87,63,24,817,76800,71426
136,116,20,-,102000,71427
1084,967,117,550,84800,71429
956,596,360,750,111300,71430
428,309,119,500,72300,71432
1636,1316,320,597,86300,71433
1260,1142,118,614,56000,71435
605,499,106,-,73700,71438
647,422,225,523,86300,71439
277,182,95,650,45700,71441
8630,5297,3333,839,112600,71446
555,454,101,513,70200,71447
3575,2557,1018,506,101600,71449
383,329,54,727,89500,71450
36,36,0,-,51700,71452
1000,659,341,707,81000,71454
35,35,0,-,33500,71455
390,250,140,521,96700,71456
10030,4809,5221,631,134600,71457
3252,30,3222,1012,-,71459
910,425,485,726,96300,71461
520,439,81,553,47100,71462
3096,2146,950,395,71700,71463
998,821,177,547,73100,71465
258,232,26,-,81400,71466
1886,1452,434,676,97300,71467
407,244,163,563,65900,71468
920,727,193,717,74200,71469
109,109,0,-,-,71472
165,139,26,530,-,71473
200,160,40,924,139000,71474
313,248,65,543,53300,71479
210,168,42,-,58300,71480
3585,2202,1383,555,73200,71483
724,560,164,458,197300,71485
2120,1603,517,499,66200,71486
5652,2759,2893,619,59900,71601
6471,4361,2110,719,97600,71602
12989,8342,4647,700,89100,71603
275,210,65,575,42000,71630
221,181,40,-,62900,71631
4885,3515,1370,617,75600,71635
1275,751,524,610,52200,71638
2394,1270,1124,576,54200,71639
1280,846,434,531,45300,71640
257,207,50,617,43400,71642
453,287,166,443,64300,71643
408,237,171,384,61700,71644
2468,2014,454,633,71600,71646
870,529,341,456,79500,71647
69,69,0,-,80400,71651
525,347,178,542,53500,71652
2053,1433,620,605,76700,71653
1905,1035,870,495,70400,71654
5673,3347,2326,622,97600,71655
241,189,52,662,37700,71658
48,42,6,-,-,71659
303,290,13,-,70000,71660
132,100,32,-,42200,71661
80,0,80,-,-,71662
279,202,77,585,74100,71663
2324,1735,589,672,89800,71665
10,10,0,-,-,71666
2986,2193,793,604,68700,71667
581,444,137,533,54100,71670
3470,2238,1232,599,71500,71671
245,210,35,525,53900,71674
828,663,165,693,92800,71675
260,176,84,339,32900,71676
66,30,36,606,28800,71677
7916,5199,2717,555,72700,71701
3,0,3,-,-,71711
917,698,219,413,55400,71720
31,22,9,-,53000,71722
150,126,24,442,55600,71724
230,188,42,419,45000,71725
644,536,108,370,47100,71726
12681,8618,4063,620,83900,71730
661,543,118,456,68200,71740
2343,1406,937,628,62900,71742
1697,1232,465,602,85800,71743
1249,1011,238,644,76400,71744
126,93,33,422,61500,71745
354,278,76,480,43000,71747
893,808,85,540,69400,71749
405,308,97,610,70600,71751
371,194,177,508,55500,71752
6377,3983,2394,659,91000,71753
206,206,0,-,107200,71758
236,166,70,632,82500,71759
962,734,228,665,59500,71762
687,622,65,525,58700,71763
858,599,259,519,47400,71764
957,809,148,523,49600,71765
269,204,65,588,51000,71766
1590,1186,404,634,77100,71770
2,2,0,-,-,71772
5636,3550,2086,613,80000,71801
29,29,0,-,-,71820
3629,2565,1064,524,78500,71822
24,20,4,-,60000,71823
240,219,21,-,69700,71825
464,312,152,429,53100,71826
272,249,23,417,55900,71827
3583,2669,914,532,74200,71832
752,592,160,571,74000,71833
628,467,161,714,87400,71834
634,512,122,443,62100,71835
1177,875,302,609,61500,71836
1907,1648,259,613,106100,71837
413,310,103,469,56400,71838
103,70,33,-,55000,71839
382,283,99,561,63800,71841
832,602,230,500,62100,71842
837,552,285,296,60900,71845
1221,906,315,497,65900,71846
213,152,61,525,60000,71847
838,531,307,561,88700,71851
3657,2428,1229,534,95900,71852
124,109,15,-,29800,71853
14365,8844,5521,700,99400,71854
236,191,45,-,105100,71855
2096,1346,750,675,69400,71857
879,741,138,750,55600,71858
175,157,18,-,98300,71859
1119,777,342,503,59900,71860
910,782,128,555,59800,71861
171,141,30,754,77500,71862
69,55,14,-,45000,71865
156,106,50,766,82100,71866
11955,6779,5176,630,123400,71901
7392,6410,982,970,189400,71909
19214,12370,6844,748,133600,71913
1322,1097,225,545,68100,71921
46,37,9,-,48900,71922
6136,3608,2528,582,107800,71923
1666,1292,374,759,95800,71929
389,302,87,521,160800,71933
220,201,19,-,72300,71935
714,544,170,539,55400,71937
744,557,187,521,57100,71940
845,741,104,547,81100,71941
1816,1276,540,481,77500,71943
316,240,76,432,60000,71944
533,403,130,461,93300,71945
1066,869,197,-,108000,71949
450,390,60,535,80700,71950
75,75,0,-,-,71952
5802,4563,1239,546,91800,71953
698,559,139,656,45100,71956
1319,1071,248,543,124300,71957
932,603,329,513,81300,71958
237,198,39,-,83900,71959
615,470,145,604,71100,71960
375,303,72,587,87400,71961
428,302,126,618,56300,71962
1523,1180,343,856,138600,71964
117,86,31,-,-,71965
1550,1417,133,749,131600,71968
138,108,30,475,76700,71969
358,307,51,523,107900,71970
230,180,50,-,87900,71971
113,71,42,542,89000,71972
508,347,161,385,66900,71973
0,0,0,-,-,71998
0,0,0,-,-,71999
189,163,26,773,83500,72001
5735,4800,935,763,137800,72002
372,328,44,546,63000,72003
466,318,148,483,60000,72004
68,37,31,-,46800,72005
1203,744,459,396,64900,72006
2687,2120,567,789,139900,72007
2608,1748,860,568,79000,72010
1444,1253,191,709,96700,72011
4742,3126,1616,756,131400,72012
820,650,170,615,91700,72013
29,23,6,-,32100,72014
10500,7171,3329,805,119900,72015
1190,1111,79,672,102200,72016
359,251,108,466,44900,72017
8934,7318,1616,742,166900,72019
1583,1314,269,559,62000,72020
1740,1046,694,511,69200,72021
6572,4305,2267,855,147800,72022
13463,9177,4286,747,146400,72023
1270,900,370,704,86000,72024
272,231,41,585,83500,72025
160,105,55,657,53300,72026
547,468,79,453,79300,72027
818,467,351,418,48400,72029
273,236,37,-,106700,72030
2787,2100,687,573,103500,72031
11695,7110,4585,758,133900,72032
18927,9851,9076,741,168400,72034
0,0,0,-,-,72035
367,258,109,455,24200,72036
8,0,8,-,-,72037
24,24,0,-,153600,72038
799,610,189,625,95800,72039
1267,883,384,432,66800,72040
618,405,213,517,58800,72041
2014,1235,779,561,70700,72042
345,318,27,623,192400,72044
445,266,179,-,145700,72045
1781,1080,701,517,89900,72046
325,289,36,705,81200,72047
17,17,0,-,82900,72048
269,191,78,-,86000,72051
395,276,119,566,73800,72055
339,272,67,816,97400,72057
5650,4253,1397,822,152100,72058
0,0,0,-,-,72059
237,109,128,586,67900,72060
43,43,0,-,187500,72061
621,546,75,505,98500,72063
1139,814,325,613,74800,72064
1784,1431,353,701,127000,72065
1101,806,295,668,122500,72067
161,90,71,812,68300,72068
587,488,99,463,67100,72069
692,574,118,669,78900,72070
168,140,28,592,82100,72072
481,327,154,625,59900,72073
66,52,14,692,52900,72074
14365,8505,5860,755,107500,72076
243,243,0,-,57900,72079
164,140,24,-,80000,72080
2638,2061,577,670,95500,72081
738,448,290,528,49500,72082
96,60,36,835,80000,72083
510,386,124,520,57400,72084
67,51,16,525,61900,72085
3856,2950,906,768,119000,72086
833,690,143,-,207700,72087
1218,1058,160,863,112300,72088
0,0,0,-,-,72099
1153,749,404,480,73300,72101
1144,849,295,621,89400,72102
4876,3693,1183,767,107500,72103
8480,5847,2633,655,82100,72104
2021,1510,511,793,117600,72106
101,84,17,657,89400,72107
34,34,0,-,-,72108
4469,2876,1593,568,105000,72110
451,377,74,763,125800,72111
3575,2164,1411,547,69500,72112
10015,6124,3891,867,212500,72113
5133,1457,3676,627,66800,72114
9505,6149,3356,868,169400,72116
5249,3226,2023,749,81500,72117
8677,5261,3416,741,97700,72118
0,0,0,-,-,72119
12370,8491,3879,813,151200,72120
1246,1073,173,668,86000,72121
314,314,0,-,-,72122
173,114,59,546,30000,72123
315,243,72,645,58100,72125
1328,871,457,590,79700,72126
1053,784,269,682,86800,72127
314,260,54,839,103300,72128
547,461,86,700,76100,72129
263,237,26,-,122500,72130
1833,1513,320,566,120300,72131
1318,972,346,776,94500,72132
125,88,37,619,49200,72134
979,808,171,825,222600,72135
586,517,69,774,92500,72136
988,725,263,727,85300,72137
109,52,57,285,57100,72139
185,168,17,663,78900,72140
215,176,39,-,74600,72141
1031,833,198,757,171500,72142
12989,8161,4828,658,138900,72143
0,0,0,-,-,72149
4694,3638,1056,704,133900,72150
160,114,46,-,46000,72152
1027,859,168,581,84900,72153
228,165,63,-,97000,72156
564,487,77,825,124000,72157
4230,2655,1575,661,83600,72160
15,15,0,-,-,72165
101,76,25,-,62000,72166
507,447,60,839,98500,72167
132,95,37,-,32900,72168
70,49,21,-,37300,72169
98,57,41,535,59600,72170
3326,2808,518,748,145400,72173
124,81,43,488,53200,72175
3231,2057,1174,724,114600,72176
178,157,21,-,-,72179
11,3,8,-,-,72181
551,223,328,1050,297200,72201
5121,1627,3494,737,107800,72202
11652,6436,5216,767,87900,72204
10538,5505,5033,835,161300,72205
9283,5757,3526,666,86900,72206
4935,3278,1657,762,243500,72207
10898,5392,5506,728,80100,72209
6322,3974,2348,806,162400,72210
9510,5324,4186,875,181000,72211
4698,4068,630,914,279600,72212
8673,5641,3032,972,338500,72223
4769,3084,1685,792,183700,72227
9613,4508,5105,687,82700,72301
43,18,25,-,-,72311
9155,5421,3734,642,83900,72315
42,26,16,-,-,72320
60,49,11,-,77000,72321
70,49,21,-,33600,72322
863,652,211,670,70900,72324
9,0,9,-,-,72325
890,567,323,623,47300,72326
654,435,219,627,95400,72327
10,10,0,-,-,72328
62,20,42,809,-,72329
232,155,77,785,56200,72330
1178,710,468,619,73700,72331
16,4,12,540,-,72332
333,124,209,519,36800,72333
5942,3295,2647,594,68500,72335
0,0,0,-,-,72338
59,41,18,-,65000,72339
23,15,8,-,-,72340
86,73,13,704,57900,72341
1897,783,1114,574,87600,72342
265,211,54,1058,62100,72346
308,221,87,263,39000,72347
1059,651,408,433,78100,72348
467,261,206,597,44700,72350
210,123,87,627,70700,72351
14,14,0,-,-,72353
926,508,418,487,65800,72354
954,711,243,666,62100,72355
431,187,244,563,54100,72358
235,107,128,426,34600,72359
2598,1342,1256,503,66900,72360
5635,3865,1770,768,145300,72364
1203,702,501,560,63800,72365
910,436,474,591,45200,72366
42,4,38,-,-,72367
515,346,169,488,54700,72368
2995,1304,1691,608,77300,72370
818,576,242,659,67800,72372
575,340,235,439,56500,72373
453,355,98,-,55000,72374
672,551,121,659,66800,72376
7,7,0,-,-,72377
21,16,5,-,-,72379
42,42,0,-,-,72383
311,155,156,473,55500,72384
696,478,218,516,59600,72386
112,51,61,316,-,72389
3289,1370,1919,607,63800,72390
200,168,32,340,54500,72392
338,180,158,655,53200,72394
419,258,161,466,84600,72395
4900,3167,1733,689,89800,72396
21564,11366,10198,686,128800,72401
9922,6570,3352,735,167200,72404
195,150,45,540,55700,72410
887,580,307,660,77800,72411
293,218,75,742,100800,72412
213,160,53,536,49400,72413
156,92,64,575,77800,72414
496,371,125,516,73800,72415
2175,1490,685,640,120300,72416
1639,1077,562,804,120300,72417
554,350,204,448,49500,72419
250,144,106,575,67800,72421
2093,1359,734,453,61700,72422
27,20,7,375,32500,72424
137,92,45,-,47400,72425
82,51,31,475,98300,72426
88,48,40,580,63100,72427
25,14,11,817,-,72428
149,116,33,517,49500,72429
139,118,21,-,61300,72430
195,135,60,529,49800,72431
2387,1603,784,619,85800,72432
1292,760,532,498,62000,72433
791,658,133,450,65000,72434
195,158,37,525,47800,72435
306,279,27,820,65500,72436
1352,887,465,799,68700,72437
942,586,356,459,56000,72438
97,74,23,488,69000,72440
40,32,8,-,-,72441
1618,1042,576,554,86800,72442
1147,853,294,542,63400,72443
711,551,160,483,86400,72444
40,34,6,-,57500,72445
802,572,230,428,84400,72447
80,61,19,715,30800,72449
14486,9468,5018,688,110500,72450
74,54,20,525,46700,72453
2091,1631,460,569,75200,72454
5168,3585,1583,562,82800,72455
229,127,102,647,47800,72456
68,41,27,444,60700,72457
362,302,60,-,100900,72458
697,536,161,450,60400,72459
295,253,42,432,60100,72460
1490,1151,339,490,72900,72461
177,102,75,343,45800,72462
29,17,12,463,41000,72464
543,407,136,604,69100,72466
0,0,0,-,-,72467
455,344,111,540,69000,72469
96,66,30,-,55000,72470
440,328,112,530,63500,72471
3736,2222,1514,515,82500,72472
1067,817,250,568,63900,72473
2461,1509,952,571,79000,72476
126,111,15,-,84300,72478
638,467,171,605,60500,72479
506,447,59,677,67800,72482
10040,7167,2873,601,110300,72501
1178,893,285,683,64200,72512
999,806,193,450,88700,72513
0,0,0,-,-,72515
113,86,27,-,51000,72517
1036,730,306,555,78600,72519
108,51,57,-,-,72520
1930,1261,669,547,72500,72521
181,157,24,-,72800,72522
492,388,104,540,64300,72523
118,94,24,-,116400,72524
88,76,12,-,70900,72526
119,119,0,-,130500,72527
37,9,28,-,-,72528
2173,1744,429,686,75500,72529
641,516,125,542,75100,72530
414,392,22,-,124200,72531
630,508,122,434,69500,72532
200,184,16,467,68800,72533
631,569,62,-,87300,72534
198,162,36,479,79300,72536
293,215,78,634,121300,72537
102,80,22,-,117500,72538
69,69,0,-,-,72539
123,101,22,550,103500,72540
1759,1404,355,526,104000,72542
4963,3385,1578,687,139400,72543
254,237,17,-,109900,72544
52,39,13,-,95000,72546
288,213,75,-,94600,72550
25,24,1,-,40000,72553
1212,864,348,482,88500,72554
58,58,0,-,-,72555
1308,1022,286,556,90000,72556
3606,2652,954,560,122400,72560
333,284,49,489,96200,72561
898,602,296,628,79700,72562
252,130,122,501,-,72564
261,203,58,578,82900,72565
277,261,16,-,47700,72566
102,84,18,-,70800,72567
529,407,122,1011,80400,72568
166,166,0,-,62300,72569
115,65,50,-,158200,72571
71,71,0,-,82100,72572
73,47,26,-,159200,72573
1884,1314,570,503,84100,72576
165,125,40,388,78600,72577
73,73,0,-,-,72578
527,308,219,599,87800,72579
464,403,61,769,123100,72581
781,614,167,510,88800,72583
276,257,19,-,70700,72584
133,133,0,-,-,72585
69,53,16,-,-,72587
11914,8275,3639,600,113600,72601
507,363,144,481,95300,72611
3815,2801,1014,572,115800,72616
123,60,63,427,-,72617
1003,746,257,641,116800,72619
362,345,17,-,109600,72623
137,137,0,-,-,72624
539,376,163,548,123900,72626
340,299,41,435,72800,72628
213,137,76,567,82100,72629
114,88,26,660,77100,72630
1981,1657,324,694,175900,72631
1912,1503,409,613,148800,72632
738,657,81,640,105000,72633
1833,1319,514,537,100500,72634
1396,988,408,617,103600,72635
8,8,0,-,225000,72636
2654,1937,717,575,79300,72638
253,176,77,-,-,72639
87,66,21,-,51400,72640
1080,843,237,345,94800,72641
886,729,157,774,140100,72642
1198,997,201,677,116800,72644
852,625,227,439,92500,72645
304,278,26,-,-,72648
1592,1275,317,478,82300,72650
671,446,225,622,92500,72651
12374,9324,3050,643,128100,72653
180,167,13,-,74500,72655
807,548,259,706,108300,72658
245,173,72,438,75000,72660
186,169,17,-,-,72661
1096,916,180,595,117100,72662
158,101,57,-,114000,72663
92,92,0,-,153900,72666
167,167,0,-,226300,72668
19,17,2,-,-,72669
60,60,0,-,-,72670
94,53,41,558,64200,72672
635,574,61,-,74900,72675
190,104,86,484,81400,72677
29,29,0,-,-,72679
317,267,50,594,60500,72680
188,182,6,-,73400,72682
112,73,39,-,60700,72683
486,407,79,605,80600,72685
37,37,0,-,-,72686
2336,1897,439,562,108400,72687
16058,6665,9393,720,177800,72701
14518,6144,8374,688,198400,72703
9812,5686,4126,893,168300,72704
17475,10534,6941,829,195200,72712
4854,4158,696,988,145700,72714
7191,6145,1046,925,159800,72715
381,326,55,-,152500,72717
745,687,58,1023,214700,72718
3686,1974,1712,936,139000,72719
188,127,61,-,54100,72721
1120,764,356,642,114500,72722
2246,1745,501,823,115000,72727
92,92,0,-,138300,72729
3141,1880,1261,864,153700,72730
1719,1439,280,689,165000,72732
2815,2032,783,701,130500,72734
2230,1612,618,812,137500,72736
936,812,124,815,108100,72738
179,132,47,-,145200,72739
3538,2531,1007,602,104000,72740
240,186,54,-,127200,72742
2010,1355,655,591,89100,72744
4506,2897,1609,766,138100,72745
84,74,10,-,"10,000-",72747
31,31,0,-,87000,72749
2324,1826,498,944,126100,72751
180,180,0,-,54000,72752
3183,2425,758,697,142600,72753
14908,9419,5489,685,139000,72756
13609,8477,5132,903,180700,72758
175,162,13,-,54500,72760
7461,4673,2788,711,132900,72761
13785,8889,4896,779,162700,72762
17754,8467,9287,671,138300,72764
408,302,106,709,81400,72768
295,266,29,-,112700,72769
401,306,95,1188,82200,72773
2284,1874,410,627,135100,72774
286,246,40,-,118600,72776
6576,2418,4158,654,100400,72801
7982,6349,1633,728,146800,72802
840,586,254,577,79500,72821
2325,1740,585,631,85800,72823
518,403,115,603,79500,72824
19,9,10,-,-,72826
72,72,0,-,-,72827
21,21,0,-,-,72828
5880,3875,2005,609,95800,72830
383,282,101,506,57600,72832
1399,941,458,523,113900,72833
3839,2598,1241,608,115500,72834
332,267,65,489,71400,72835
2872,2420,452,582,107100,72837
33,29,4,-,63800,72838
146,100,46,-,65500,72839
793,625,168,543,63800,72840
56,48,8,-,56700,72841
436,335,101,694,90300,72842
1003,765,238,533,102000,72843
522,405,117,438,111300,72845
1449,1201,248,580,94300,72846
1128,850,278,697,100300,72847
299,279,20,829,74100,72851
77,67,10,-,58300,72852
702,419,283,523,78400,72853
398,329,69,643,79400,72854
2321,1712,609,550,85000,72855
177,158,19,-,103800,72856
510,402,108,518,90500,72857
1324,1079,245,644,114300,72858
223,152,71,-,-,72860
571,491,80,705,86100,72863
495,421,74,634,98500,72865
9187,3732,5455,562,87400,72901
11540,5772,5768,630,159300,72903
7607,4092,3515,584,73300,72904
5601,3403,2198,783,137600,72908
3036,2391,645,853,184300,72916
5043,4116,927,643,138200,72921
1868,1198,670,799,93000,72923
268,208,60,607,75300,72926
3333,2277,1056,588,95300,72927
227,194,33,630,96400,72928
130,91,39,-,-,72930
724,594,130,641,97200,72932
1901,1466,435,623,95700,72933
310,246,64,653,105400,72934
177,136,41,529,77800,72935
5334,4220,1114,711,127200,72936
1376,1164,212,712,87300,72937
522,466,56,757,60400,72938
998,886,112,593,81900,72940
2106,1708,398,724,108000,72941
943,694,249,544,73800,72943
1180,937,243,676,88300,72944
86,64,22,500,58200,72945
1446,1296,150,540,91100,72946
1748,1418,330,548,85700,72947
175,153,22,-,86300,72948
3661,2668,993,583,95800,72949
139,130,9,-,54600,72950
399,305,94,585,102700,72951
1078,855,223,811,103700,72952
141,96,45,-,-,72955
13129,9429,3700,660,108100,72956
2732,1872,860,503,74200,72958
1107,991,116,455,108700,72959
369,281,88,513,69000,73002
8580,5162,3418,1048,159500,73003
362,282,80,703,115000,73004
3153,1991,1162,559,72300,73005
1337,1007,330,536,82000,73006
839,755,84,1406,287200,73007
7966,4438,3528,770,118400,73008
495,354,141,541,85900,73009
6434,5432,1002,801,147500,73010
173,126,47,810,57200,73011
11380,9827,1553,1575,204500,73012
18340,14131,4209,1078,198500,73013
697,540,157,850,97900,73014
1084,734,350,461,60300,73015
667,577,90,579,138700,73016
659,529,130,504,74600,73017
7807,4963,2844,672,87800,73018
0,0,0,-,-,73019
8258,6969,1289,927,167600,73020
124,121,3,-,89500,73021
299,221,78,733,93900,73024
3691,3627,64,-,313900,73025
3937,3577,360,753,171300,73026
532,384,148,625,94100,73027
1421,1121,300,676,102000,73028
638,447,191,486,83000,73029
1612,1121,491,619,108400,73030
96,74,22,488,64600,73032
149,88,61,544,58800,73033
16241,11469,4772,814,246200,73034
6480,4261,2219,725,103600,73036
759,594,165,493,76100,73038
693,432,261,661,78200,73040
126,91,35,558,54100,73041
395,294,101,547,77500,73042
98,94,4,-,56800,73043
7729,5519,2210,687,128600,73044
3905,3073,832,715,148500,73045
1506,1151,355,686,98900,73047
858,629,229,610,78600,73048
2188,1820,368,730,136900,73049
21,6,15,575,-,73050
2671,2054,617,739,110500,73051
2571,1920,651,664,87800,73052
269,198,71,563,100000,73053
1473,1211,262,801,119600,73054
3815,2946,869,599,109100,73055
183,159,24,531,71500,73056
933,661,272,572,80900,73057
106,87,19,486,90600,73058
1025,814,211,646,100800,73059
688,550,138,773,116500,73061
650,501,149,455,47000,73062
238,203,35,689,88500,73063
7773,6184,1589,938,152400,73064
2800,2357,443,678,172000,73065
129,83,46,448,74600,73066
854,680,174,596,101800,73067
4492,3147,1345,835,109300,73068
10069,4788,5281,761,142800,73069
15990,7909,8081,810,134000,73071
16578,9820,6758,838,204300,73072
244,211,33,663,129200,73073
409,294,115,604,85300,73074
3378,2114,1264,606,96900,73075
2883,2063,820,686,91200,73077
2913,2719,194,938,194900,73078
175,144,31,619,100000,73079
3599,2589,1010,662,147100,73080
1061,749,312,525,56300,73082
2741,1964,777,632,80100,73084
3378,2233,1145,653,104700,73086
4147,3660,487,773,167400,73089
335,270,65,672,121000,73090
363,277,86,695,76600,73092
979,848,131,650,173700,73093
735,493,242,583,101700,73095
5270,2675,2595,672,154500,73096
53,35,18,-,-,73097
1767,1229,538,617,87000,73098
22178,16858,5320,1019,151600,73099
1091,78,1013,1089,112500,73102
2459,902,1557,736,195000,73103
1113,250,863,1073,245000,73104
2803,1177,1626,858,97300,73105
4419,1836,2583,682,89500,73106
10750,5760,4990,768,94600,73107
4621,1434,3187,593,48000,73108
6986,3267,3719,616,68600,73109
14398,6873,7525,774,87300,73110
4746,2387,2359,682,71600,73111
14626,7522,7104,753,117300,73112
7425,2764,4661,831,83100,73114
8513,4985,3528,820,80300,73115
4438,3076,1362,916,216200,73116
2428,1001,1427,488,75400,73117
6349,3597,2752,847,140500,73118
9851,4632,5219,724,62900,73119
17833,9450,8383,781,149500,73120
1318,1011,307,942,158900,73121
5268,3010,2258,676,115100,73122
9135,4407,4728,683,105400,73127
1592,1211,381,1201,152800,73128
6014,3302,2712,700,49500,73129
8041,6044,1997,919,128500,73130
1302,861,441,1107,248300,73131
10958,6171,4787,785,148000,73132
2360,602,1758,970,232200,73134
7836,4292,3544,919,132400,73135
7358,3217,4141,735,120000,73139
1025,590,435,750,75800,73141
5737,3075,2662,891,218500,73142
537,0,537,1178,-,73145
1921,986,935,761,59900,73149
1678,1520,158,945,216500,73150
531,519,12,-,400300,73151
12071,7427,4644,827,104100,73159
21707,14350,7357,913,127400,73160
11721,8256,3465,942,173200,73162
2151,2026,125,839,197400,73165
739,637,102,957,128200,73169
13760,11309,2451,1221,181900,73170
695,661,34,639,296500,73173
1439,1220,219,1473,201900,73179
13500,8954,4546,715,113000,73401
21,21,0,-,39600,73425
437,406,31,1083,97700,73430
394,283,111,629,108000,73432
1074,888,186,612,99400,73433
182,135,47,675,119600,73434
37,37,0,-,53000,73437
1369,987,382,586,70100,73438
3023,2406,617,648,93000,73439
117,84,33,439,59200,73440
56,45,11,675,-,73441
148,122,26,-,73200,73442
1342,1076,266,598,104300,73443
63,23,40,-,-,73444
2829,2055,774,625,81900,73446
457,365,92,690,73700,73447
1907,1431,476,645,90400,73448
1059,833,226,571,82400,73449
483,401,82,805,87100,73450
192,161,31,-,153900,73453
203,170,33,713,56800,73455
791,598,193,531,64300,73456
318,230,88,671,82500,73458
364,290,74,752,96700,73459
1893,1155,738,520,74000,73460
262,221,41,563,78900,73461
1209,1004,205,574,79800,73463
365,308,57,620,61300,73481
80,65,15,725,34000,73487
275,219,56,556,77300,73491
7086,2984,4102,705,98800,73501
1501,5,1496,1178,-,73503
18518,9906,8612,787,119300,73505
8704,4937,3767,797,124500,73507
52,35,17,538,65000,73520
8331,4534,3797,702,92000,73521
883,684,199,633,119700,73526
1907,1508,399,640,148600,73527
229,189,40,694,79700,73528
2158,1686,472,630,77300,73529
205,171,34,500,55600,73530
161,129,32,900,84500,73531
190,140,50,485,93600,73532
11148,7479,3669,667,107300,73533
266,217,49,467,45600,73537
1997,1513,484,787,170000,73538
96,91,5,-,71900,73539
174,123,51,902,86100,73540
962,781,181,694,124100,73541
1758,1283,475,664,53300,73542
622,439,183,590,111900,73543
123,83,40,-,46600,73544
529,373,156,623,55700,73546
694,487,207,460,59500,73547
175,175,0,-,56200,73548
103,81,22,-,79400,73549
974,707,267,469,50700,73550
15,15,0,-,-,73551
533,444,89,575,114800,73552
32,32,0,-,225000,73553
1267,864,403,812,79400,73554
82,59,23,623,39300,73555
68,48,20,488,58600,73556
143,118,25,-,191700,73557
275,191,84,458,28600,73559
249,192,57,492,63300,73560
261,200,61,544,86300,73562
207,161,46,270,60600,73564
378,274,104,439,61400,73565
790,499,291,516,75100,73566
301,209,92,484,78400,73567
427,333,94,578,44600,73568
222,170,52,400,43600,73569
473,344,129,485,58800,73570
64,35,29,-,-,73571
1460,1086,374,584,84700,73572
999,680,319,485,62000,73573
3577,2199,1378,690,108000,73601
346,300,46,582,104600,73620
87,60,27,675,82000,73622
735,357,378,679,76200,73624
255,222,33,833,105800,73625
395,307,88,827,81100,73626
221,127,94,688,75700,73627
541,389,152,409,87100,73628
1402,991,411,604,79500,73632
109,68,41,-,220400,73638
233,194,39,507,104100,73639
261,234,27,425,46200,73641
78,61,17,-,103800,73642
4877,3125,1752,784,147300,73644
560,384,176,642,67700,73645
171,130,41,338,57500,73646
303,257,46,408,110400,73647
311,237,74,525,80300,73650
1669,1080,589,607,66000,73651
289,191,98,779,93200,73654
360,296,64,478,55300,73655
61,59,2,-,80900,73658
69,59,10,-,-,73659
159,121,38,-,68600,73660
173,144,29,794,94000,73661
1986,1254,732,571,87000,73662
434,300,134,605,98400,73663
459,342,117,494,66300,73664
85,49,36,1054,76400,73666
263,187,76,600,80400,73667
608,473,135,536,78400,73669
128,97,31,931,79200,73673
8675,5159,3516,695,66300,73701
12261,7981,4280,864,135000,73703
0,0,0,-,-,73705
244,213,31,575,98900,73716
2488,1659,829,668,95400,73717
247,209,38,766,85900,73718
18,18,0,-,-,73719
85,80,5,-,93600,73720
204,153,51,753,156500,73722
408,320,88,571,69600,73724
239,196,43,656,53600,73726
77,65,12,-,217900,73727
780,563,217,693,64100,73728
237,193,44,634,91200,73729
295,227,68,450,75800,73730
40,36,4,-,62500,73731
117,116,1,-,139300,73733
291,221,70,725,75900,73734
255,215,40,600,104700,73735
202,183,19,-,79700,73736
1351,933,418,526,80100,73737
434,322,112,563,58900,73738
163,134,29,388,81700,73739
301,197,104,715,81300,73741
1486,1204,282,641,105000,73742
78,68,10,-,58500,73743
82,66,16,-,74400,73744
9,9,0,-,-,73746
148,76,72,664,104000,73747
188,139,49,646,63300,73749
2706,2081,625,742,130700,73750
146,117,29,675,109200,73753
468,394,74,835,86200,73754
366,300,66,661,75000,73755
109,94,15,675,120300,73756
86,72,14,-,141200,73757
43,35,8,-,150800,73758
682,489,193,596,80600,73759
160,140,20,763,102800,73760
184,142,42,-,77000,73761
760,628,132,817,161300,73762
642,522,120,658,77800,73763
50,35,15,-,126600,73764
508,371,137,797,84300,73766
574,475,99,675,112300,73768
229,162,67,653,46700,73771
1495,1088,407,508,87900,73772
680,524,156,632,79800,73773
5403,3696,1707,711,128200,73801
407,360,47,663,76300,73832
662,500,162,482,68400,73834
105,93,12,-,78100,73835
142,116,26,588,69100,73838
299,225,74,833,85000,73840
174,143,31,1034,87000,73841
207,181,26,419,112500,73842
318,255,63,646,87900,73843
103,77,26,379,101600,73844
761,637,124,549,80100,73848
32,31,1,-,106300,73851
1023,815,208,654,111700,73852
211,157,54,663,156500,73853
44,44,0,-,68600,73855
302,248,54,588,147000,73857
619,454,165,636,73200,73858
635,444,191,661,85900,73859
613,397,216,604,73100,73860
37,37,0,-,82700,73901
217,153,64,775,91000,73931
878,640,238,635,94900,73932
657,495,162,467,58500,73933
82,47,35,683,61700,73937
281,249,32,663,82100,73938
480,246,234,577,101000,73939
4543,2739,1804,686,116500,73942
144,98,46,679,75000,73944
1015,808,207,666,85900,73945
25,19,6,-,55000,73946
180,135,45,-,42100,73947
533,375,158,568,83300,73949
507,389,118,797,104900,73950
384,292,92,700,64200,73951
139,111,28,583,49400,74001
809,627,182,608,70400,74002
5858,3360,2498,650,75000,74003
10781,7953,2828,748,132600,74006
9131,7079,2052,877,191500,74008
3949,2858,1091,566,95600,74010
9910,8191,1719,1055,160000,74011
22204,15289,6915,951,157100,74012
13199,11481,1718,1074,163600,74014
3309,2327,982,845,140100,74015
2265,1755,510,635,91700,74016
11050,7654,3396,806,127000,74017
6874,5624,1250,770,158900,74019
2814,2080,734,673,90400,74020
6898,5703,1195,922,153300,74021
749,648,101,675,97100,74022
4196,2771,1425,670,91500,74023
334,238,96,633,57600,74026
409,304,105,518,66000,74027
624,507,117,625,76000,74028
2003,1497,506,628,81500,74029
1519,1082,437,485,72500,74030
765,642,123,714,105100,74032
3746,2901,845,963,128900,74033
56,40,16,742,50000,74034
1377,996,381,506,68800,74035
2559,2115,444,738,126600,74036
5830,4677,1153,1093,187100,74037
812,693,119,550,87400,74038
1403,1134,269,688,86300,74039
866,698,168,774,131900,74041
168,115,53,794,62200,74042
2838,2262,576,765,104200,74044
128,111,17,-,63800,74045
41,31,10,475,88300,74046
2461,1951,510,778,120500,74047
2371,1722,649,654,77700,74048
143,82,61,625,40000,74050
748,630,118,613,109900,74051
442,304,138,582,53300,74052
1703,1395,308,753,145700,74053
285,252,33,430,55700,74054
15728,11778,3950,933,175200,74055
2246,1479,767,567,73900,74056
1579,1087,492,609,86500,74058
2005,1349,656,659,116700,74059
203,174,29,675,71800,74060
819,666,153,652,138500,74061
389,317,72,619,89800,74062
11984,9314,2670,758,117800,74063
11912,8632,3280,792,118700,74066
19,12,7,463,-,74068
5360,4049,1311,795,125400,74070
54,46,8,-,55400,74071
739,592,147,692,87900,74072
2152,1730,422,833,123600,74073
11675,5601,6074,826,184400,74074
10622,3801,6821,692,147300,74075
0,0,0,-,-,74078
1753,1212,541,635,89800,74079
1078,874,204,858,146300,74080
641,576,65,721,78700,74081
23,17,6,925,63800,74082
414,349,65,569,91600,74083
238,196,42,525,56700,74084
950,699,251,621,73700,74085
260,5,255,1604,-,74103
5482,2422,3060,814,143900,74104
12539,6921,5618,689,174300,74105
7189,3172,4017,573,63800,74106
8184,4327,3857,702,82000,74107
2693,1617,1076,826,84400,74108
4977,2370,2607,704,48500,74110
9120,4882,4238,778,99800,74112
7389,5719,1670,987,160300,74114
8172,4241,3931,791,61000,74115
1453,637,816,682,89100,74116
44,39,5,-,178900,74117
2489,612,1877,778,130000,74119
2367,842,1525,675,248500,74120
3625,2072,1553,739,46400,74126
6670,3824,2846,734,80900,74127
4516,2855,1661,799,82300,74128
7171,3595,3576,697,102300,74129
710,496,214,809,51600,74130
1171,947,224,755,144200,74131
3442,2241,1201,889,166500,74132
19177,10003,9174,867,177100,74133
6074,3488,2586,767,118000,74134
9779,4906,4873,707,158900,74135
13917,4869,9048,706,206300,74136
10921,7374,3547,917,284000,74137
7665,3936,3729,814,119700,74145
5714,1941,3773,644,88700,74146
4386,3226,1160,628,96500,74301
1138,885,253,685,125100,74330
2939,2344,595,701,122000,74331
612,535,77,817,110900,74332
395,318,77,744,101700,74333
2052,1616,436,698,99300,74337
1947,1453,494,632,84100,74338
919,625,294,552,59000,74339
116,90,26,705,85700,74340
1146,815,331,522,85400,74342
1177,884,293,612,86600,74343
6609,4938,1671,683,132100,74344
2816,2045,771,541,107500,74346
881,660,221,618,76300,74347
123,81,42,525,76500,74349
336,237,99,608,89800,74350
2460,1922,538,585,85800,74352
6872,4448,2424,673,86600,74354
83,59,24,606,53600,74358
201,148,53,531,62200,74359
8,5,3,-,-,74360
6323,4308,2015,669,117700,74361
1029,799,230,696,77700,74363
596,516,80,634,94100,74364
1793,1386,407,659,87200,74365
563,489,74,527,73600,74366
182,114,68,516,62000,74367
40,38,2,-,51400,74368
741,617,124,645,95800,74369
1363,1124,239,653,86100,74370
6606,3796,2810,634,81700,74401
11891,7757,4134,668,95000,74403
1760,1431,329,667,103700,74421
242,222,20,575,97200,74422
346,287,59,460,80600,74423
519,405,114,438,100200,74425
3906,3080,826,621,102000,74426
421,394,27,513,107600,74427
446,370,76,523,125700,74428
5249,4071,1178,767,143400,74429
190,154,36,658,85700,74430
304,235,69,633,56800,74431
4372,3435,937,519,86400,74432
3407,2738,669,662,147300,74434
1229,981,248,570,76200,74435
1837,1417,420,671,107600,74436
3835,2739,1096,598,76500,74437
48,35,13,606,34600,74438
1880,1539,341,486,93800,74441
362,327,35,631,70600,74442
1211,900,311,684,120500,74445
198,130,68,675,83800,74446
6532,4146,2386,587,72000,74447
693,612,81,733,93000,74450
1477,1181,296,539,109800,74451
145,116,29,596,112500,74452
1196,959,237,700,82000,74454
1297,1064,233,534,75300,74455
78,66,12,517,66000,74456
211,177,34,772,85700,74457
41,25,16,369,55000,74458
46,42,4,-,104500,74459
75,54,21,525,55000,74460
2957,2133,824,552,85100,74462
80,44,36,506,60000,74463
10619,6102,4517,605,113300,74464
6047,4171,1876,712,99400,74467
91,77,14,700,78600,74468
829,528,301,590,86100,74469
684,581,103,494,74600,74470
581,461,120,530,74000,74471
275,198,77,729,91000,74472
0,0,0,-,-,74477
10959,7480,3479,708,108800,74501
76,53,23,563,61300,74521
114,100,14,850,78500,74522
2467,1841,626,495,68700,74523
3699,2550,1149,553,97100,74525
87,67,20,467,85000,74528
82,73,9,-,49000,74530
357,293,64,613,83800,74531
316,232,84,633,85300,74533
80,70,10,533,110700,74534
40,30,10,-,133300,74535
694,466,228,510,72900,74536
1645,1099,546,584,83600,74538
86,76,10,-,103600,74540
183,144,39,-,80800,74543
303,222,81,536,51300,74546
1366,969,397,604,85800,74547
36,22,14,-,53300,74549
421,333,88,644,79200,74552
493,364,129,555,81400,74553
767,455,312,690,92800,74554
315,249,66,455,83700,74555
142,121,21,588,65800,74556
200,174,26,583,95700,74557
194,171,23,467,75500,74558
222,166,56,638,69100,74560
820,637,183,463,78600,74561
364,288,76,363,66200,74562
814,670,144,542,79700,74563
272,211,61,675,78100,74565
37,37,0,-,77500,74567
245,203,42,569,81500,74569
384,297,87,863,88600,74570
1349,921,428,455,73200,74571
260,212,48,604,73300,74572
447,383,64,588,81800,74574
60,56,4,-,125000,74576
86,56,30,450,83300,74577
2381,1486,895,546,81700,74578
7528,4323,3205,651,66900,74601
5063,4170,893,639,126900,74604
284,161,123,588,74200,74630
3218,2281,937,600,53600,74631
265,219,46,690,78800,74632
166,148,18,715,46400,74633
144,109,35,-,96800,74636
762,623,139,478,41500,74637
126,103,23,694,83000,74640
295,262,33,663,84100,74641
175,155,20,673,50800,74643
202,153,49,628,49500,74644
92,92,0,-,-,74646
1394,1046,348,570,83600,74647
278,229,49,625,45800,74650
284,204,80,364,33500,74651
334,266,68,415,40400,74652
1458,1017,441,571,68900,74653
9024,5020,4004,704,117800,74701
193,159,34,638,51700,74720
95,74,21,454,63800,74722
577,421,156,539,83800,74723
136,106,30,-,58100,74724
922,731,191,762,74800,74726
813,560,253,543,77800,74727
4290,2943,1347,583,83900,74728
1165,882,283,690,81800,74729
1657,1206,451,718,92700,74730
564,374,190,534,68700,74731
1162,881,281,688,84800,74733
464,382,82,494,84100,74734
604,499,105,625,84500,74735
410,333,77,495,71300,74736
238,190,48,492,55600,74738
903,739,164,571,63500,74740
402,317,85,720,87600,74741
3255,2090,1165,528,88100,74743
4097,2436,1661,602,80700,74745
68,57,11,550,57500,74747
242,223,19,765,74500,74748
142,115,27,627,61300,74750
33,33,0,-,-,74753
154,127,27,469,49000,74754
55,55,0,-,42500,74755
299,249,50,680,85800,74756
551,459,92,585,84000,74759
131,109,22,500,127500,74760
38,20,18,756,75000,74761
1376,1097,279,564,68900,74764
575,462,113,468,50400,74766
8493,4999,3494,640,90100,74801
7629,5142,2487,676,134200,74804
12218,7444,4774,633,118400,74820
479,389,90,766,98100,74824
778,624,154,553,85700,74825
438,330,108,658,65000,74826
147,106,41,590,125000,74827
217,144,73,521,57900,74829
92,71,21,525,43100,74830
316,233,83,511,79600,74831
311,240,71,449,93900,74832
287,238,49,538,80900,74833
2808,2179,629,592,113500,74834
73,36,37,-,86300,74836
95,77,18,556,49000,74837
246,191,55,469,59800,74839
659,540,119,703,99700,74840
42,37,5,-,-,74842
123,97,26,733,117600,74843
135,90,45,682,67100,74844
185,155,30,392,61000,74845
2321,1686,635,518,67900,74848
1143,776,367,544,67100,74849
104,92,12,-,60000,74850
3088,2517,571,618,109000,74851
519,423,96,857,103400,74852
664,531,133,408,62900,74854
1862,1542,320,600,104800,74855
293,209,84,692,78600,74856
3019,2744,275,803,122400,74857
2155,1469,686,545,85200,74859
577,475,102,573,88100,74860
2028,1539,489,651,141400,74864
650,531,119,675,104300,74865
342,252,90,438,70000,74867
4807,3355,1452,608,79900,74868
295,270,25,544,92400,74869
819,693,126,567,99400,74871
1340,951,389,517,88800,74872
4373,3231,1142,715,93200,74873
446,391,55,747,100200,74875
587,479,108,669,89800,74878
767,608,159,395,68500,74880
1755,1445,310,686,87700,74881
864,609,255,467,61100,74883
2145,1492,653,529,58200,74884
797,529,268,543,67100,74901
1529,1197,332,697,90100,74902
751,600,151,664,80300,74930
446,390,56,706,77000,74931
939,690,249,663,90000,74932
61,46,15,475,35000,74935
410,321,89,644,77700,74936
2002,1390,612,534,59800,74937
268,227,41,636,80100,74939
924,675,249,544,86600,74940
999,775,224,608,76600,74941
61,41,20,370,75000,74942
41,33,8,-,95000,74943
406,306,100,553,64800,74944
151,111,40,669,66300,74945
55,17,38,513,41300,74946
4519,3504,1015,632,97400,74948
141,123,18,342,78100,74949
535,366,169,618,53300,74951
4310,2976,1334,588,115200,74953
1738,996,742,714,93800,74954
5585,3676,1909,641,96700,74955
670,457,213,608,80900,74956
440,371,69,364,68300,74957
2713,1976,737,644,78500,74959
4738,3203,1535,529,76700,74960
1898,1498,400,588,78400,74962
215,203,12,525,59000,74963
984,736,248,602,78800,74964
1788,1264,524,529,76900,74965
1361,1133,228,527,104800,74966
8384,1525,6859,1144,290100,75001
22000,16961,5039,1258,205400,75002
17852,9440,8412,982,155300,75006
19273,14083,5190,1092,186400,75007
3462,2894,568,996,256400,75009
10064,4610,5454,1150,228100,75010
12151,9111,3040,1343,353000,75013
14883,10449,4434,1232,317900,75019
8786,5771,3015,743,94300,75020
3216,2513,703,670,91000,75021
7328,6933,395,2108,360000,75022
18443,11946,6497,1256,195500,75023
17212,7595,9617,1230,330100,75024
19016,13569,5447,1272,283200,75025
15485,12827,2658,1593,259300,75028
10634,8703,1931,1234,241500,75032
30892,22118,8774,1215,330900,75034
19657,15707,3950,1568,261700,75035
12377,1866,10511,925,194900,75038
8290,1410,6880,1267,414500,75039
18213,13090,5123,1056,116000,75040
9792,5712,4080,879,96600,75041
11584,6101,5483,822,110400,75042
20737,11804,8933,996,130300,75043
15116,10008,5108,1110,148600,75044
7353,6232,1121,1332,184200,75048
14797,6205,8592,909,104000,75050
12533,5874,6659,842,90300,75051
28784,21957,6827,1159,142000,75052
2896,2583,313,2087,265800,75054
19961,12859,7102,1203,193100,75056
5041,1692,3349,1054,105500,75057
925,725,200,969,192100,75058
14568,9045,5523,855,112500,75060
17575,6508,11067,828,120800,75061
16513,7112,9401,885,129300,75062
15725,6092,9633,1075,292800,75063
4389,3288,1101,1087,168400,75065
25014,9819,15195,1008,159200,75067
15804,12255,3549,1520,182000,75068
13547,7100,6447,946,206100,75069
30528,22908,7620,1398,241400,75070
15032,10788,4244,1310,224600,75071
16263,9619,6644,1105,158000,75074
13997,9248,4749,1076,203000,75075
3113,2401,712,870,132500,75076
12897,10314,2583,1251,234500,75077
5300,4371,929,1277,383800,75078
18431,10169,8262,1131,209100,75080
14360,8176,6184,1179,175400,75081
8564,6343,2221,1347,274900,75082
10930,8559,2371,1247,226600,75087
8666,7288,1378,1340,165400,75088
10177,8937,1240,1515,169500,75089
8041,4987,3054,814,81000,75090
9781,5413,4368,800,136500,75092
19431,12426,7005,1215,392200,75093
6079,5319,760,2122,296100,75094
16402,13309,3093,1243,165400,75098
191,137,54,886,69800,75101
499,406,93,965,82200,75102
5022,3933,1089,884,117700,75103
15845,11184,4661,1248,139900,75104
87,81,6,-,72100,75105
1527,1263,264,1105,114400,75109
10097,6083,4014,730,85100,75110
1744,1446,298,1093,112600,75114
19325,11959,7366,995,148000,75115
6733,3998,2735,897,110400,75116
1497,1148,349,667,111200,75117
9149,5551,3598,851,109900,75119
1509,1098,411,545,103400,75124
2039,1640,399,877,81600,75125
12051,10527,1524,1256,168100,75126
602,405,197,646,93000,75127
490,454,36,-,143800,75132
7090,4101,2989,960,109500,75134
2010,1615,395,794,120200,75135
6920,4888,2032,1124,128000,75137
2178,1609,569,688,98300,75140
1191,786,405,865,74000,75141
6019,4461,1558,851,110800,75142
5432,4133,1299,800,80500,75143
1372,928,444,653,82100,75144
6602,4303,2299,943,104700,75146
2338,1568,770,671,101900,75147
2143,1460,683,653,67800,75148
17983,11005,6978,971,98600,75149
21361,9788,11573,955,105600,75150
1550,1197,353,904,135000,75152
150,146,4,-,68000,75153
12464,9490,2974,1030,147500,75154
904,729,175,800,73000,75155
5975,4683,1292,829,93700,75156
94,65,29,689,60800,75157
1437,1314,123,986,137500,75158
5233,3826,1407,907,91500,75159
7977,4720,3257,865,113000,75160
2175,1630,545,1028,103300,75161
1046,768,278,972,106800,75163
235,158,77,943,107400,75164
14366,8862,5504,971,143200,75165
1227,1077,150,1461,197700,75166
3252,2901,351,1379,197100,75167
4939,3934,1005,732,87100,75169
1114,576,538,754,56200,75172
1420,1307,113,1030,159500,75173
6251,3564,2687,902,80600,75180
7993,6533,1460,1614,147500,75181
1783,1729,54,2242,311400,75182
7673,6400,1273,1145,163700,75189
7994,932,7062,1505,458300,75201
1417,235,1182,1468,222300,75202
6213,1807,4406,730,69500,75203
16323,3315,13008,1308,300200,75204
8933,5813,3120,1390,1059600,75205
20632,5005,15627,1117,317100,75206
1362,0,1362,1504,-,75207
10170,5661,4509,816,153100,75208
6641,3843,2798,1195,542700,75209
2788,763,2025,659,63700,75210
21450,10814,10636,813,90700,75211
7334,3929,3405,638,78500,75212
15746,8833,6913,953,392500,75214
5918,2117,3801,751,58800,75215
17140,9043,8097,757,60600,75216
22825,13495,9330,881,74600,75217
10441,6861,3580,981,257100,75218
13361,4904,8457,1131,272900,75219
14469,4620,9849,746,184000,75220
4538,2520,2018,841,100400,75223
10732,5271,5461,777,92800,75224
8828,6561,2267,1738,905100,75225
1649,81,1568,1074,231700,75226
16962,9532,7430,824,89300,75227
25361,11370,13991,745,115500,75228
11169,7910,3259,887,316800,75229
12555,7542,5013,887,497400,75230
15829,3132,12697,751,266900,75231
10188,6151,4037,869,89400,75232
4798,2662,2136,839,118800,75233
11127,6833,4294,1046,146100,75234
6967,1938,5029,1018,118900,75235
6177,2128,4049,846,111800,75236
7974,1193,6781,762,107600,75237
12674,6160,6514,801,286600,75238
9983,2276,7707,852,175400,75240
10264,6172,4092,857,75800,75241
26227,6851,19376,791,179800,75243
5932,3071,2861,1260,325700,75244
1357,245,1112,674,156600,75246
217,0,217,789,-,75247
16110,8718,7392,1053,311700,75248
4846,3829,1017,1250,128200,75249
1595,0,1595,1220,-,75251
12266,4990,7276,884,314700,75252
5843,3739,2104,916,43600,75253
11526,2139,9387,949,336100,75254
0,0,0,-,-,75270
27041,5537,21504,912,262400,75287
0,0,0,-,-,75390
6404,3478,2926,747,60600,75401
6080,4059,2021,809,123300,75402
5446,3893,1553,981,127300,75407
4430,3504,926,1350,158500,75409
1798,1437,361,752,89900,75410
459,333,126,663,78700,75411
212,193,19,-,65000,75412
82,54,28,1000,37500,75413
1229,997,232,768,115100,75414
74,63,11,-,-,75415
1011,793,218,757,80700,75416
1092,851,241,506,68800,75417
4545,3118,1427,719,87700,75418
397,313,84,688,145800,75420
285,225,60,763,85000,75421
995,855,140,828,92800,75422
1030,853,177,881,105700,75423
1248,1056,192,970,121400,75424
2107,1384,723,619,51600,75426
3440,1633,1807,782,80200,75428
737,506,231,703,91400,75431
1324,872,452,547,72700,75432
1058,889,169,766,96000,75433
606,403,203,475,56300,75435
753,549,204,505,69200,75436
467,436,31,428,111200,75437
355,310,45,714,96000,75438
351,233,118,841,93100,75439
2494,2015,479,576,117100,75440
49,49,0,-,-,75441
3281,2338,943,982,136700,75442
1267,1009,258,422,96500,75446
380,297,83,704,108100,75447
224,215,9,-,44300,75448
553,414,139,714,58100,75449
69,52,17,-,73300,75450
474,390,84,584,102700,75451
1571,1187,384,592,107400,75452
1333,1118,215,796,90200,75453
2385,1998,387,1121,187500,75454
9224,6040,3184,646,102000,75455
2448,1760,688,766,113500,75457
1742,1298,444,620,123000,75459
9119,4547,4572,646,66700,75460
4390,3393,997,766,143100,75462
343,301,42,-,-,75468
160,128,32,391,75900,75469
152,116,36,-,45500,75470
462,391,71,-,85500,75471
1435,1056,379,708,82100,75472
1428,1188,240,819,102700,75473
5609,4236,1373,711,81000,75474
85,80,5,-,60800,75475
465,408,57,706,85800,75476
373,228,145,536,58200,75477
372,306,66,633,86900,75478
669,518,151,600,83900,75479
611,522,89,663,168800,75480
151,131,20,-,73800,75481
9188,6143,3045,696,95300,75482
843,710,133,815,88000,75486
650,466,184,503,61600,75487
354,310,44,759,92900,75488
407,272,135,596,101100,75489
839,715,124,783,115600,75490
1964,1472,492,702,97600,75491
201,178,23,480,114200,75492
124,85,39,604,51700,75493
3714,2847,867,717,92900,75494
2681,2123,558,903,147800,75495
1186,939,247,456,85000,75496
1497,1301,196,681,146000,75497
12881,7972,4909,641,88800,75501
9397,5930,3467,825,162100,75503
341,278,63,581,106000,75550
4304,3346,958,590,103200,75551
760,657,103,522,64000,75554
581,512,69,733,81200,75555
406,338,68,725,62200,75556
567,445,122,662,67600,75558
2114,1717,397,545,77100,75559
353,333,20,950,84700,75560
1975,1358,617,733,94200,75561
56,56,0,-,-,75562
2003,1486,517,535,84300,75563
119,77,42,825,65600,75565
325,278,47,842,102700,75566
1773,1349,424,826,96700,75567
1092,723,369,476,66400,75568
1360,636,724,865,105200,75569
3224,2239,985,589,89500,75570
1130,902,228,597,99500,75571
1368,961,407,638,70500,75572
26,24,2,-,84300,75573
693,585,108,703,63500,75574
6088,3508,2580,728,124700,75601
6916,3981,2935,697,77100,75602
2230,1727,503,645,95700,75603
11535,6133,5402,800,130000,75604
11887,7633,4254,864,174600,75605
1081,951,130,331,94900,75630
1069,856,213,709,86400,75631
5290,4016,1274,702,104700,75633
2377,1848,529,766,67300,75638
1206,929,277,806,76600,75639
1768,1435,333,1125,95200,75640
67,64,3,-,76500,75641
6,6,0,-,-,75642
811,653,158,688,83100,75643
4273,3220,1053,696,97500,75644
3264,2746,518,875,106900,75645
4559,3201,1358,837,118600,75647
3209,2428,781,820,136000,75650
726,676,50,1030,87400,75651
4676,3239,1437,705,117900,75652
4496,3441,1055,678,118300,75654
1630,1210,420,515,86400,75656
3290,2455,835,668,89800,75657
1197,934,263,620,83100,75661
8982,6170,2812,758,104800,75662
410,273,137,526,90200,75667
794,496,298,632,83200,75668
260,238,22,-,87900,75669
5863,3543,2320,636,68300,75670
6264,4727,1537,775,123800,75672
960,795,165,675,76300,75681
174,149,25,950,85000,75682
1635,1363,272,676,75900,75683
2486,1767,719,740,85300,75684
4684,3335,1349,693,86400,75686
1173,840,333,577,82000,75691
1669,1340,329,775,89900,75692
2403,1647,756,847,140800,75693
12813,7201,5612,840,123000,75701
8046,4079,3967,669,67800,75702
16445,9011,7434,851,197400,75703
2885,2153,732,876,87700,75704
771,580,191,698,89300,75705
2998,1983,1015,799,82500,75706
5429,3714,1715,942,158800,75707
2195,1530,665,686,65700,75708
1972,1195,777,1083,99600,75709
1408,1170,238,-,134700,75750
5927,3789,2138,780,95200,75751
2707,2226,481,769,104700,75752
2147,1765,382,830,122400,75754
1989,1428,561,675,93000,75755
1498,1354,144,750,89900,75756
4238,3579,659,702,168800,75757
3409,2663,746,709,124000,75758
25,20,5,-,56300,75759
1013,833,180,564,83700,75760
4804,3828,976,1173,161100,75762
2218,1782,436,711,104300,75763
62,54,8,-,47500,75764
2816,2389,427,817,133300,75765
9209,6446,2763,667,85900,75766
1108,921,187,-,91500,75770
7203,5743,1460,882,144500,75771
4762,3568,1194,755,120600,75773
1267,978,289,639,95400,75778
62,57,5,-,-,75779
91,67,24,494,61700,75780
2931,2366,565,728,93500,75783
275,262,13,-,60000,75784
3173,2478,695,754,80700,75785
88,88,0,-,-,75788
2748,2213,535,786,123100,75789
1650,1243,407,564,109200,75790
4646,3591,1055,1031,155100,75791
1266,853,413,833,107900,75792
5847,3633,2214,762,87700,75801
6278,4724,1554,710,86500,75803
2012,1627,385,634,86700,75831
13,0,13,-,-,75832
1394,1108,286,571,105500,75833
4531,2925,1606,634,82800,75835
331,235,96,662,93400,75838
2023,1683,340,597,61200,75839
2706,2048,658,688,89800,75840
2593,1991,602,625,72600,75844
1231,990,241,605,75800,75845
1003,691,312,589,89500,75846
731,586,145,584,65300,75847
55,44,11,-,55700,75848
36,29,7,-,81900,75849
252,150,102,1120,-,75850
749,618,131,735,95400,75851
379,283,96,780,123600,75852
301,239,62,473,60400,75853
1039,890,149,792,64800,75855
23,23,0,-,-,75856
15,15,0,-,-,75858
743,664,79,563,78300,75859
2082,1593,489,640,77700,75860
575,349,226,808,87000,75861
3790,3064,726,726,77600,75862
10703,6809,3894,792,94600,75901
12319,7247,5072,787,97100,75904
1563,1134,429,605,73300,75925
437,342,95,613,57100,75926
298,194,104,505,69800,75928
577,529,48,481,81500,75929
787,693,94,432,74000,75930
863,785,78,736,90300,75931
578,506,72,770,56700,75932
466,425,41,-,48300,75933
73,42,31,-,75200,75934
4905,3332,1573,556,74300,75935
342,282,60,391,74500,75936
339,275,64,588,72800,75937
1102,999,103,700,87900,75938
1658,1113,545,439,72100,75939
2569,1867,702,558,67700,75941
47,47,0,-,-,75942
561,438,123,569,95600,75943
592,543,49,763,76300,75944
1257,803,454,643,82300,75946
2139,1864,275,532,92900,75948
2648,2146,502,663,82400,75949
5061,3427,1634,701,88400,75951
1182,917,265,703,75300,75954
2698,2064,634,563,80000,75956
288,249,39,706,104900,75959
363,299,64,685,71600,75960
6103,3074,3029,795,93300,75961
0,0,0,-,-,75962
6620,4002,2618,654,77700,75964
7823,3836,3987,762,167800,75965
1609,1195,414,507,63600,75966
550,441,109,740,58300,75968
1327,1069,258,725,96200,75969
2150,1685,465,617,79300,75972
903,744,159,590,75900,75973
1007,672,335,561,68900,75974
1423,1059,364,543,86000,75975
332,174,158,463,90000,75976
308,185,123,-,64100,75977
37,37,0,-,131300,75978
3726,2981,745,712,76900,75979
1065,779,286,511,72900,75980
9704,7795,1909,1245,158700,76001
9389,8070,1319,1713,155600,76002
11734,2921,8813,856,195800,76006
5187,4649,538,1244,269900,76008
6527,4970,1557,891,89600,76009
18122,5976,12146,762,82800,76010
9692,2197,7495,768,98100,76011
10178,6502,3676,916,170000,76012
13093,6747,6346,818,153200,76013
10840,5612,5228,1018,96000,76014
6498,3266,3232,1051,117200,76015
11342,9171,2171,1306,164200,76016
17019,11397,5622,1038,147100,76017
9200,6575,2625,1227,116700,76018
10086,7507,2579,822,130800,76020
15575,8885,6690,917,182600,76021
5561,3088,2473,978,132400,76022
2227,1571,656,927,109200,76023
23102,18027,5075,1138,152500,76028
5682,4283,1399,825,98400,76031
9453,5704,3749,849,112500,76033
8637,8266,371,1692,432800,76034
559,508,51,950,164300,76035
8557,6242,2315,1046,151800,76036
13953,5668,8285,1081,164700,76039
11363,4961,6402,825,156800,76040
113,71,42,697,76500,76041
2847,1927,920,813,153000,76043
1364,1097,267,936,165500,76044
8891,6225,2666,833,131400,76048
10655,8656,1999,909,185600,76049
1941,1613,328,763,154400,76050
19381,11069,8312,1121,258200,76051
6307,5211,1096,1406,253500,76052
10992,6217,4775,864,128400,76053
4468,3929,539,1042,191100,76054
1029,825,204,667,68000,76055
5912,4816,1096,854,106700,76058
1537,598,939,842,102000,76059
2535,1911,624,997,171900,76060
37,37,0,-,-,76061
22484,17039,5445,1183,205400,76063
562,455,107,735,160800,76064
11009,8875,2134,1076,184700,76065
1264,995,269,626,141600,76066
7126,4415,2711,735,80800,76067
203,203,0,-,211800,76070
1236,936,300,996,151500,76071
2048,1772,276,883,126900,76073
159,141,18,-,-,76077
3375,2772,603,1061,137800,76078
6126,4963,1163,877,127800,76082
2363,2031,332,803,94700,76084
3170,2527,643,770,144500,76085
7895,3890,4005,958,120100,76086
10158,8923,1235,945,197800,76087
4017,3417,600,926,192900,76088
9223,8572,651,1287,586900,76092
564,413,151,713,100600,76093
3493,872,2621,1238,189600,76102
4820,2866,1954,730,83200,76103
6066,2542,3524,737,59600,76104
6509,3329,3180,751,51200,76105
9583,5143,4440,845,71100,76106
13282,6431,6851,1015,241900,76107
14802,9666,5136,913,119400,76108
9665,5512,4153,1025,368600,76109
9589,5835,3754,801,88500,76110
6516,4034,2482,866,81300,76111
16055,7513,8542,771,96200,76112
8911,5179,3732,853,83600,76114
5740,2861,2879,799,68000,76115
21440,8437,13003,822,140500,76116
10331,5611,4720,800,88500,76117
5562,4100,1462,861,137600,76118
13972,7109,6863,795,62900,76119
7060,2603,4457,861,136800,76120
9930,7549,2381,1421,146500,76123
8123,6500,1623,1020,165100,76126
35,4,31,1375,-,76127
0,0,0,-,-,76129
10830,7789,3041,1330,139100,76131
12474,4009,8465,906,241700,76132
18205,11559,6646,962,111500,76133
8432,5243,3189,978,94400,76134
8193,5514,2679,856,119100,76135
20035,12319,7716,1132,142800,76137
9383,6549,2834,1140,91800,76140
8143,6457,1686,1263,105200,76148
2573,0,2573,971,-,76155
4446,2696,1750,742,66200,76164
3077,1710,1367,1256,183500,76177
17547,13565,3982,1248,149500,76179
14233,6652,7581,964,138500,76180
11032,8999,2033,1193,180700,76182
9666,1775,7891,796,129600,76201
7291,2750,4541,959,186500,76205
5184,3343,1841,1047,187500,76207
7771,4812,2959,1055,201400,76208
9051,4400,4651,886,129200,76209
14273,10951,3322,1183,175800,76210
1103,875,228,900,127800,76225
7559,6797,762,1685,347000,76226
9014,6911,2103,1532,172200,76227
364,300,64,625,78300,76228
3933,2713,1220,787,97700,76230
1279,934,345,934,132000,76233
5405,3985,1420,939,154100,76234
176,137,39,676,105100,76238
450,352,98,771,148300,76239
10361,6740,3621,750,125200,76240
22330,17052,5278,1547,190300,76244
741,663,78,689,73900,76245
3924,3045,879,1158,153100,76247
12769,10334,2435,1207,300400,76248
2526,1954,572,1223,159100,76249
340,291,49,1078,175700,76250
293,231,62,906,153800,76251
1040,854,186,784,162200,76252
104,77,27,466,162500,76253
2422,1698,724,586,81200,76255
2444,2037,407,1044,145100,76258
1781,1326,455,1065,146600,76259
119,100,19,-,82500,76261
11896,8951,2945,1111,294400,76262
20,12,8,-,-,76263
564,396,168,846,69200,76264
716,608,108,528,94100,76265
5262,3977,1285,1048,141600,76266
93,75,18,-,44500,76268
700,516,184,-,77200,76270
595,420,175,936,122800,76271
1672,1343,329,610,117900,76272
3414,2496,918,686,131200,76273
6764,3440,3324,610,46900,76301
5120,3024,2096,726,106400,76302
1860,1554,306,538,103200,76305
5905,3572,2333,740,75900,76306
8114,4441,3673,795,130300,76308
5233,3030,2203,715,97100,76309
7351,5063,2288,776,132800,76310
608,4,604,1198,-,76311
726,495,231,603,60900,76351
4736,3091,1645,829,97800,76354
236,205,31,550,61500,76357
1539,1116,423,690,39900,76360
109,83,26,379,24300,76363
59,41,18,-,64500,76364
1824,1451,373,629,76800,76365
793,636,157,754,91100,76366
3705,3093,612,825,85500,76367
110,90,20,336,43300,76370
601,452,149,413,50700,76371
442,301,141,528,68000,76372
75,65,10,-,-,76373
1574,1080,494,544,57200,76374
335,313,22,588,58400,76377
222,172,50,628,102300,76379
1727,1326,401,453,71600,76380
5020,3168,1852,622,72200,76384
118,104,14,-,-,76388
449,362,87,880,121100,76389
10447,5752,4695,752,135300,76401
0,0,0,-,-,76402
3088,2350,738,555,76600,76424
4039,2753,1286,842,132100,76426
381,267,114,585,59100,76427
72,72,0,-,167200,76429
1016,824,192,546,80500,76430
1071,940,131,897,101600,76431
525,477,48,630,115200,76432
528,407,121,832,191400,76433
213,172,41,613,35400,76435
92,92,0,-,-,76436
2178,1617,561,550,60100,76437
2677,2104,573,510,81900,76442
802,604,198,627,70300,76443
1454,1179,275,472,75200,76444
167,147,20,-,72200,76445
2770,2064,706,691,87700,76446
1901,1462,439,549,79200,76448
941,729,212,592,107400,76449
5257,4373,884,698,91500,76450
20,11,9,-,-,76452
554,502,52,726,135000,76453
616,445,171,357,58100,76454
396,296,100,611,63600,76455
1485,1021,464,649,131000,76457
1928,1515,413,759,80100,76458
82,76,6,-,52900,76459
163,136,27,-,179300,76460
1054,896,158,747,182900,76462
187,157,30,575,80600,76463
217,163,54,625,58300,76464
126,65,61,-,-,76466
20,20,0,-,62200,76469
1188,786,402,425,55900,76470
712,561,151,571,51600,76471
638,528,110,-,154400,76472
106,95,11,675,115900,76474
376,281,95,571,67600,76475
987,776,211,783,132000,76476
41,41,0,-,-,76481
488,357,131,408,67500,76483
316,250,66,673,119400,76484
507,436,71,615,72000,76486
898,736,162,963,130600,76487
34,34,0,-,-,76490
151,107,44,557,39200,76491
6280,3889,2391,695,99600,76501
13646,9021,4625,952,151800,76502
8511,3358,5153,785,91000,76504
0,0,0,-,-,76508
681,529,152,600,83200,76511
12603,8618,3985,812,152200,76513
532,379,153,610,70800,76518
228,157,71,565,-,76519
3147,2134,1013,561,71500,76520
13898,7905,5993,856,109400,76522
0,0,0,-,-,76523
1113,986,127,729,94800,76524
421,303,118,725,100800,76525
1267,965,302,738,135500,76527
6031,4330,1701,739,104100,76528
781,590,191,633,122700,76530
1903,1505,398,537,100100,76531
835,614,221,646,92200,76534
1658,1229,429,1004,146100,76537
314,245,69,806,117800,76538
2992,2704,288,917,159400,76539
7600,2223,5377,687,69900,76541
16417,9470,6947,1014,143700,76542
11112,4394,6718,807,89000,76543
4764,26,4738,1160,82500,76544
9360,5876,3484,822,169900,76548
15633,8282,7351,1014,127100,76549
4666,3055,1611,754,121600,76550
703,537,166,841,96500,76554
502,407,95,394,87900,76556
1696,1494,202,763,98100,76557
1769,973,796,919,125600,76559
411,303,108,722,80100,76561
24,24,0,-,-,76565
139,81,58,295,225000,76566
3487,2009,1478,677,99100,76567
803,619,184,750,99500,76569
872,657,215,623,56100,76570
2401,2073,328,655,259400,76571
10,0,10,-,-,76573
6495,4030,2465,853,122600,76574
1283,939,344,676,115600,76577
543,434,109,907,137500,76578
1389,1024,365,902,116200,76579
0,0,0,-,-,76596
0,0,0,-,-,76597
0,0,0,-,-,76598
0,0,0,-,-,76599
362,316,46,875,117300,76621
407,310,97,617,81800,76622
50,47,3,-,70800,76623
722,572,150,783,108800,76624
518,389,129,812,95000,76626
573,490,83,753,90800,76627
23,15,8,-,82100,76628
702,473,229,468,77700,76629
325,257,68,916,128100,76630
181,151,30,767,71100,76631
475,396,79,986,48900,76632
1946,1611,335,898,168100,76633
2805,2110,695,632,109500,76634
431,308,123,601,52500,76635
586,481,105,783,114300,76636
231,195,36,615,106800,76637
1091,913,178,940,225900,76638
583,423,160,547,59400,76639
1243,837,406,790,78800,76640
630,507,123,714,69900,76641
2465,1865,600,648,90400,76642
5144,3742,1402,1047,142900,76643
3774,2254,1520,689,86000,76645
1008,755,253,688,87300,76648
318,286,32,710,91300,76649
50,43,7,-,55000,76650
1293,911,382,644,94100,76651
458,395,63,680,80500,76652
393,329,64,767,113000,76653
55,51,4,-,62500,76654
3033,2542,491,884,161800,76655
726,545,181,511,96300,76656
3242,2292,950,825,163700,76657
213,188,25,617,67600,76660
2468,1515,953,485,55500,76661
1195,852,343,775,75100,76664
934,606,328,570,93600,76665
104,88,16,725,82000,76666
3716,2581,1135,704,82900,76667
466,359,107,850,89000,76670
802,606,196,701,84600,76671
413,316,97,593,77300,76673
111,88,23,575,81000,76676
106,74,32,775,-,76678
543,422,121,441,80000,76679
160,160,0,-,74300,76680
260,181,79,1040,-,76681
973,751,222,748,91100,76682
33,12,21,-,-,76685
105,78,27,796,75000,76686
620,454,166,569,105700,76687
1254,1081,173,645,107500,76689
378,272,106,763,64700,76690
2324,1678,646,631,105900,76691
3925,2987,938,600,89200,76692
531,315,216,683,81200,76693
669,58,611,842,200000,76701
3187,1236,1951,669,64400,76704
9760,5521,4239,724,86500,76705
12904,5019,7885,789,102100,76706
5069,2389,2680,744,62800,76707
9430,5672,3758,825,114700,76708
10486,5087,5399,721,118900,76710
3080,1757,1323,883,59000,76711
9860,6617,3243,891,174700,76712
0,0,0,-,-,76798
8813,5811,3002,667,85900,76801
1575,1210,365,704,112900,76802
51,51,0,-,-,76820
1798,1390,408,563,72700,76821
1167,910,257,530,85800,76823
15,0,15,-,-,76824
2594,1845,749,688,72900,76825
172,154,18,-,95000,76827
97,89,8,-,64300,76828
32,32,0,-,-,76831
231,184,47,-,-,76832
2174,1568,606,670,62200,76834
8,8,0,-,-,76836
492,336,156,628,83800,76837
13,13,0,-,-,76841
120,106,14,-,-,76842
1459,1215,244,454,125400,76844
51,32,19,-,51100,76845
36,36,0,-,-,76848
1771,1265,506,624,111000,76849
96,78,18,617,102800,76852
554,421,133,477,100800,76853
188,144,44,-,-,76854
1490,1112,378,811,134400,76856
741,637,104,-,80500,76857
118,107,11,-,23100,76858
820,511,309,610,53400,76859
720,513,207,667,93400,76861
72,51,21,-,190600,76862
262,224,38,540,107400,76864
30,30,0,-,-,76865
189,158,31,-,120200,76866
33,21,12,-,167000,76869
75,58,17,475,-,76870
317,237,80,525,66200,76871
319,287,32,900,141400,76872
22,17,5,-,-,76873
57,35,22,-,-,76874
260,208,52,900,101000,76875
1431,905,526,675,82000,76877
716,462,254,557,65200,76878
122,97,25,-,104600,76882
67,42,25,-,31500,76884
56,21,35,-,-,76885
67,67,0,-,-,76887
47,47,0,-,93800,76888
319,260,59,870,125000,76890
11362,7473,3889,839,96900,76901
11873,6726,5147,709,72800,76903
14057,7829,6228,842,173900,76904
4525,3128,1397,1018,111400,76905
0,0,0,-,-,76908
45,24,21,-,-,76930
1214,835,379,637,86900,76932
615,425,190,500,84900,76933
437,374,63,714,114600,76934
540,497,43,856,159800,76935
1091,846,245,518,72300,76936
22,22,0,-,-,76937
18,4,14,-,-,76939
52,38,14,-,-,76940
560,445,115,828,155000,76941
1389,1063,326,554,76600,76943
778,568,210,545,64900,76945
4,4,0,-,-,76949
1495,985,510,638,91700,76950
453,358,95,817,95100,76951
35,15,20,-,-,76953
52,40,12,-,-,76955
0,0,0,-,-,76957
69,52,17,-,118800,76958
3248,801,2447,1355,229700,77002
4434,1954,2480,916,229700,77003
13097,4590,8507,914,225600,77004
9899,7386,2513,1739,886100,77005
12159,4177,7982,1174,388400,77006
18345,9034,9311,1499,376500,77007
15671,8756,6915,1175,367800,77008
14260,7745,6515,836,227000,77009
529,59,470,3111,-,77010
5511,2385,3126,634,84700,77011
6204,2419,3785,670,77000,77012
6033,2216,3817,827,83300,77013
11285,5067,6218,874,128800,77014
17403,8947,8456,821,91600,77015
9506,6007,3499,770,62100,77016
10073,5401,4672,765,87500,77017
10864,7214,3650,820,301900,77018
10867,5410,5457,1435,474800,77019
8538,3951,4587,647,74500,77020
10538,4216,6322,814,84800,77021
9347,4244,5103,693,81600,77022
9549,4197,5352,733,104500,77023
15254,10330,4924,1441,837800,77024
12847,5420,7427,1105,376100,77025
8234,3546,4688,642,61600,77026
8764,3054,5710,1408,629600,77027
5348,3051,2297,786,56100,77028
5730,3148,2582,722,69400,77029
4858,2137,2721,1394,481500,77030
5983,2634,3349,792,124000,77031
4100,1352,2748,844,81000,77032
8738,5304,3434,864,62100,77033
12139,5623,6516,845,104800,77034
13720,5484,8236,757,188500,77035
26430,5223,21207,717,121400,77036
5339,3509,1830,898,86500,77037
8123,4183,3940,916,95700,77038
7335,4356,2979,815,87100,77039
17502,9242,8260,946,136500,77040
11527,8876,2651,1199,147800,77041
18835,4993,13842,948,231600,77042
8709,5253,3456,910,171000,77043
11963,9195,2768,1143,168600,77044
10038,6871,3167,876,79900,77045
782,249,533,1706,317100,77046
8860,6475,2385,1075,118400,77047
5445,3556,1889,661,68800,77048
9882,6526,3356,951,122100,77049
1392,1114,278,813,69200,77050
5833,2370,3463,794,73200,77051
8744,5786,2958,1084,85000,77053
12686,1890,10796,1048,124000,77054
15089,6540,8549,852,343400,77055
10351,4470,5881,1444,628800,77056
20112,6630,13482,986,271100,77057
8335,2406,5929,968,166400,77058
5949,5466,483,1511,266300,77059
13891,3278,10613,713,89900,77060
8742,2936,5806,708,113500,77061
9851,7619,2232,1074,169100,77062
18303,4980,13323,952,198000,77063
16015,9295,6720,1134,139800,77064
15028,7017,8011,1036,145600,77065
9942,6847,3095,1074,120000,77066
10087,4062,6025,786,95000,77067
3919,2457,1462,1033,183900,77068
8188,4706,3482,1127,216800,77069
19183,10041,9142,1193,160400,77070
9905,5512,4393,782,126300,77071
17652,8392,9260,875,94700,77072
12437,6835,5602,979,115000,77073
12738,4399,8339,785,108700,77074
12829,6912,5917,880,120800,77075
9812,4643,5169,804,86100,77076
26193,9429,16764,1096,244400,77077
4916,2897,2019,862,69600,77078
12461,8023,4438,1215,405700,77079
15087,6090,8997,848,157600,77080
17675,955,16720,744,205500,77081
21891,7571,14320,1041,138800,77082
21483,14461,7022,963,120700,77083
33717,20872,12845,1141,134300,77084
5044,3425,1619,979,103900,77085
7907,4565,3342,927,92800,77086
10920,5451,5469,747,86500,77087
17297,10744,6553,809,95600,77088
16997,10952,6045,1025,129900,77089
15211,3351,11860,898,142300,77090
9054,3745,5309,727,108100,77091
14073,5207,8866,775,139500,77092
12057,6919,5138,756,76400,77093
3076,2570,506,1443,351000,77094
24353,17779,6574,1197,182200,77095
14884,7113,7771,881,292300,77096
7915,2551,5364,1470,440000,77098
16570,6447,10123,846,98800,77099
0,0,0,-,-,77201
9717,4671,5046,780,103400,77301
6377,5397,980,779,135100,77302
6466,4901,1565,924,110400,77303
10993,6326,4667,959,181100,77304
3739,2873,866,900,75600,77306
6583,5778,805,968,240900,77316
5857,4525,1332,1167,189100,77318
8833,5643,3190,779,110300,77320
14,14,0,-,-,77326
7242,4970,2272,742,84600,77327
4705,3840,865,836,95700,77328
2924,2627,297,735,104400,77331
145,98,47,-,-,77334
966,788,178,731,96300,77335
4373,3232,1141,994,158900,77336
13017,7270,5747,933,114100,77338
15749,10143,5606,1177,163500,77339
10052,4155,5897,831,152900,77340
0,0,0,-,-,77342
10012,8320,1692,1217,261500,77345
19962,16057,3905,1355,170900,77346
39,36,3,-,66300,77350
12437,9495,2942,664,89400,77351
11414,9734,1680,1176,228100,77354
8828,7331,1497,1005,189100,77355
10612,8635,1977,1281,237500,77356
7212,5269,1943,809,94900,77357
1839,1417,422,908,95400,77358
295,233,62,-,156300,77359
2195,1769,426,775,62100,77360
1431,1215,216,1304,144200,77362
1180,980,200,947,107300,77363
714,674,40,638,109300,77364
10056,7537,2519,977,163000,77365
96,60,36,647,66300,77367
91,91,0,-,119800,77368
279,264,15,-,71400,77369
2611,1950,661,579,63900,77371
4182,3220,962,822,80300,77372
19275,13928,5347,1281,121200,77373
161,161,0,-,97700,77374
14669,10420,4249,1096,159700,77375
127,127,0,-,-,77376
11248,9096,2152,1121,233700,77377
4723,3450,1273,753,96200,77378
26133,20673,5460,1156,215600,77379
11295,4928,6367,1235,198600,77380
13944,10265,3679,1333,322800,77381
12446,9522,2924,1725,377400,77382
6615,3953,2662,1365,269100,77384
7364,5695,1669,1171,190000,77385
15652,12276,3376,1359,195100,77386
15392,12784,2608,1488,162100,77388
9733,8363,1370,1538,267900,77389
15845,9089,6756,1126,124200,77396
6682,5565,1117,1502,768800,77401
12428,11025,1403,1189,246200,77406
13129,10945,2184,1481,203500,77407
47,43,4,-,94100,77412
8565,4918,3647,716,105100,77414
33,33,0,-,-,77415
1093,736,357,924,92300,77417
4088,2937,1151,867,198400,77418
482,356,126,823,89500,77419
855,715,140,541,92100,77420
4887,3831,1056,771,86200,77422
3360,2377,983,860,150700,77423
820,701,119,-,155700,77426
0,0,0,-,-,77428
26801,22368,4433,1226,209100,77429
670,590,80,822,124200,77430
16,16,0,-,-,77432
20969,17883,3086,1479,211700,77433
1521,1146,375,709,64700,77434
1716,1262,454,961,122600,77435
14,14,0,-,-,77436
5923,4077,1846,725,119600,77437
0,0,0,-,-,77440
2827,2660,167,628,416700,77441
427,347,80,543,94400,77442
53,53,0,-,-,77443
261,210,51,542,66700,77444
4284,2466,1818,766,150400,77445
393,112,281,989,150900,77446
4651,3774,877,1143,127900,77447
17,0,17,-,-,77448
32207,22682,9525,1326,132500,77449
24746,17478,7268,1237,227800,77450
20,18,2,-,62500,77451
124,67,57,697,-,77453
40,40,0,-,-,77454
831,678,153,735,110800,77455
504,461,43,-,78500,77456
238,209,29,-,131300,77457
111,111,0,-,62600,77458
20804,17904,2900,1599,229600,77459
27,18,9,-,-,77460
3778,3004,774,787,128600,77461
98,50,48,936,135400,77464
2857,2423,434,665,99400,77465
303,178,125,945,192900,77466
53,0,53,-,-,77467
13,13,0,-,-,77468
13812,10061,3751,985,182900,77469
131,131,0,-,35200,77470
12217,6851,5366,922,125400,77471
32,22,10,963,215600,77473
4618,3368,1250,846,162700,77474
175,175,0,-,80900,77475
82,68,14,-,346400,77476
13070,5887,7183,1153,151800,77477
8929,7028,1901,1419,263500,77478
26324,22104,4220,1737,327200,77479
2818,2109,709,684,105500,77480
8,2,6,-,-,77481
974,801,173,663,78500,77482
116,68,48,-,-,77483
3611,2695,916,828,162600,77484
1622,1222,400,740,135000,77485
2494,1991,503,835,114100,77486
5365,3211,2154,680,97100,77488
11943,8975,2968,1235,112800,77489
8412,6630,1782,1248,162800,77493
29979,24499,5480,1553,303500,77494
15335,11471,3864,1358,175000,77498
10809,6565,4244,872,91600,77502
7959,4113,3846,820,89100,77503
8834,3576,5258,809,128000,77504
8403,5739,2664,968,164100,77505
11055,4350,6705,743,70400,77506
0,0,0,-,-,77507
5430,4292,1138,906,153300,77510
16037,11347,4690,821,117400,77511
1675,1333,342,709,105100,77514
10541,7326,3215,779,108400,77515
1779,1638,141,1032,143300,77517
3313,2126,1187,764,79500,77518
447,414,33,-,56200,77519
12507,7303,5204,832,78600,77520
18984,11680,7304,838,124500,77521
6625,5342,1283,940,188800,77523
9242,5948,3294,795,88000,77530
6118,3043,3075,800,102400,77531
9844,7711,2133,952,126300,77532
336,226,110,658,63800,77533
930,750,180,859,132400,77534
9430,7333,2097,861,95700,77535
10790,8307,2483,1135,141100,77536
317,298,19,735,86800,77538
14775,10342,4433,879,141500,77539
6127,3712,2415,748,87000,77541
6402,5412,990,1293,146600,77545
17357,13663,3694,1163,204600,77546
2710,1750,960,856,66900,77547
9831,3917,5914,836,122400,77550
7945,3313,4632,891,148800,77551
3705,2337,1368,926,266100,77554
265,254,11,-,92100,77560
46,39,7,-,-,77561
3645,2729,916,891,96400,77562
3900,2710,1190,859,124300,77563
882,796,86,-,77800,77564
3424,1845,1579,1192,216300,77565
11602,7912,3690,937,153600,77566
5541,3872,1669,860,87600,77568
13228,9652,3576,1044,128800,77571
28795,21384,7411,1238,208300,77573
5912,4298,1614,832,97900,77575
483,444,39,628,116500,77577
5637,4820,817,1095,196000,77578
72,72,0,-,312500,77580
16128,12054,4074,1027,188900,77581
7540,6161,1379,711,156200,77583
28069,20666,7403,1326,205600,77584
354,270,84,-,28800,77585
8580,5813,2767,980,197200,77586
4551,2675,1876,750,83500,77587
10842,6453,4389,815,93100,77590
5244,2904,2340,885,112000,77591
277,228,49,-,-,77597
10354,2076,8278,970,132000,77598
3095,2382,713,767,141300,77611
3226,2679,547,737,104200,77612
441,335,106,682,110200,77613
222,169,53,-,94600,77614
324,287,37,498,77300,77615
290,267,23,-,76700,77616
47,47,0,-,260700,77617
6281,4641,1640,842,98800,77619
462,422,40,782,129800,77622
192,131,61,548,91000,77623
384,319,65,-,100300,77624
3072,2621,451,793,86200,77625
8940,6542,2398,854,131800,77627
266,193,73,515,103000,77629
11595,7696,3899,782,96800,77630
8680,7141,1539,775,122400,77632
6351,4134,2217,757,63400,77640
13886,7592,6294,695,64400,77642
646,479,167,580,202800,77650
5004,3737,1267,878,142900,77651
150,138,12,-,95800,77655
6535,4939,1596,765,82900,77656
7698,5910,1788,848,146600,77657
1754,1520,234,869,131000,77659
454,418,36,-,63100,77660
244,139,105,-,-,77661
9898,7822,2076,724,86600,77662
556,556,0,-,159200,77663
987,933,54,-,89400,77664
2203,1711,492,734,114100,77665
5218,2704,2514,668,55100,77701
1112,475,637,797,85900,77702
5099,2416,2683,693,61800,77703
10856,6786,4070,691,77600,77705
12813,7305,5508,825,166300,77706
6463,4428,2035,886,103000,77707
4566,2683,1883,785,104300,77708
5750,3761,1989,999,139700,77713
6653,1045,5608,748,103600,77801
10763,5442,5321,894,157400,77802
8928,5115,3813,783,84800,77803
3251,2147,1104,821,150700,77807
3806,3386,420,968,188500,77808
1084,837,247,563,148700,77830
1268,1149,119,638,101600,77831
9766,7238,2528,808,160900,77833
961,749,212,1013,146500,77835
4198,3374,824,765,106000,77836
666,400,266,616,87900,77837
21109,2753,18356,857,161600,77840
21166,14138,7028,1132,210100,77845
467,400,67,-,98500,77853
16,16,0,-,-,77855
2036,1581,455,621,151600,77856
295,240,55,559,96700,77857
2632,1882,750,664,87700,77859
1011,889,122,841,115500,77861
2934,1878,1056,784,99400,77864
621,568,53,533,117500,77865
37,33,4,-,77500,77867
4746,3381,1365,694,101800,77868
1152,951,201,722,141700,77871
610,518,92,804,101100,77872
523,399,124,529,85700,77873
74,58,16,-,-,77876
154,86,68,777,380000,77878
1975,1633,342,718,80600,77879
638,550,88,734,158000,77880
14947,7732,7215,795,87400,77901
10401,7492,2909,898,164800,77904
5209,4556,653,811,146400,77905
87,62,25,-,88300,77950
720,542,178,598,63200,77951
3835,2724,1111,824,114000,77954
3038,2098,940,816,93100,77957
10,10,0,-,-,77960
64,64,0,-,-,77961
1085,813,272,859,93800,77962
2168,1766,402,706,119500,77963
3301,2560,741,648,157700,77964
986,809,177,775,171300,77968
63,46,17,-,-,77969
196,122,74,523,200000,77970
364,264,100,-,82000,77971
21,0,21,-,-,77973
148,129,19,-,112500,77974
754,526,228,776,110900,77975
55,36,19,-,144400,77976
220,134,86,584,66700,77977
302,181,121,1052,83900,77978
6272,4235,2037,731,104900,77979
326,284,42,-,165900,77982
833,632,201,678,152400,77983
1626,1336,290,729,140300,77984
106,85,21,-,74000,77987
135,102,33,-,153000,77988
285,197,88,770,84000,77990
91,68,23,-,68100,77991
77,50,27,-,1034500,77993
165,138,27,-,155000,77994
3459,2547,912,629,98900,77995
0,0,0,-,-,78001
2115,1590,525,649,111000,78002
3623,2942,681,849,173100,78003
433,386,47,-,317300,78004
209,202,7,-,-,78005
10822,7848,2974,1113,285700,78006
29,20,9,-,108300,78007
140,140,0,-,105700,78008
2842,2427,415,767,139900,78009
1236,1034,202,838,181100,78010
678,503,175,757,48600,78011
176,159,17,914,32500,78012
1927,1465,462,660,151900,78013
1651,1142,509,369,69400,78014
4224,3738,486,1441,399000,78015
3178,2491,687,612,99300,78016
1181,708,473,813,53900,78017
375,284,91,775,50500,78019
68,64,4,-,-,78021
1482,1167,315,711,90600,78022
8887,7971,916,1251,267700,78023
545,432,113,476,276000,78024
1543,1209,334,790,94500,78025
2006,1467,539,844,81800,78026
226,173,53,-,327900,78027
16622,11073,5549,785,162500,78028
0,0,0,-,-,78029
548,480,68,536,90500,78039
11751,5254,6497,624,73800,78040
13564,7438,6126,768,138700,78041
11779,6824,4955,734,93100,78043
91,51,40,-,54400,78044
17757,13825,3932,1122,160700,78045
15701,11316,4385,786,84200,78046
168,96,72,-,-,78050
2095,1637,458,687,118200,78052
628,469,159,877,152100,78055
699,655,44,-,343000,78056
250,231,19,-,-,78057
429,386,43,429,181000,78058
1947,1705,242,636,112800,78059
16,16,0,-,-,78060
3118,2114,1004,625,78200,78061
3625,3098,527,830,145600,78063
5179,3586,1593,938,130600,78064
3142,2387,755,618,79300,78065
129,81,48,-,160300,78066
239,199,40,-,-,78067
1719,1277,442,701,85000,78069
5634,4911,723,1255,276900,78070
1132,806,326,675,80000,78071
187,151,36,520,71700,78072
2369,1781,588,656,72800,78073
58,38,20,-,-,78075
4075,3153,922,448,61200,78076
2324,2213,111,841,204700,78101
7401,4252,3149,861,78000,78102
30,28,2,-,-,78104
137,77,60,-,-,78107
10761,8647,2114,1574,197200,78108
11589,7892,3697,1108,129800,78109
2291,1888,403,779,80100,78112
986,777,209,950,145700,78113
7220,5682,1538,822,141500,78114
123,108,15,-,230800,78116
214,189,25,840,152900,78117
1162,813,349,725,87700,78118
1822,1365,457,613,77300,78119
4088,3745,343,989,193600,78121
163,139,24,-,94400,78122
1011,704,307,698,106700,78123
2021,1640,381,885,144300,78124
37,31,6,-,202800,78125
23505,15015,8490,1020,168800,78130
8858,7551,1307,896,306400,78132
7435,6012,1423,956,174500,78133
1068,700,368,602,71000,78140
222,198,24,704,76100,78141
46,37,9,-,110600,78142
72,72,0,-,-,78143
29,20,9,-,-,78144
31,25,6,-,117000,78145
172,134,38,1114,84600,78146
614,427,187,803,121500,78147
7953,4403,3550,889,149100,78148
0,0,0,-,-,78150
556,381,175,470,89800,78151
723,622,101,725,173500,78152
12901,9150,3751,1112,174500,78154
16848,11938,4910,803,123600,78155
317,228,89,477,106100,78159
1690,1303,387,916,135600,78160
289,266,23,-,98600,78161
113,104,9,-,76700,78162
3662,3391,271,1052,318000,78163
1425,1239,186,601,87300,78164
16059,7855,8204,729,84600,78201
3841,1940,1901,699,65100,78202
1910,857,1053,729,60900,78203
4251,2442,1809,796,76700,78204
797,76,721,538,374500,78205
15397,7136,8261,608,56500,78207
1501,509,992,685,68600,78208
18062,10200,7862,946,313300,78209
13236,6928,6308,752,80100,78210
9145,5740,3405,770,63100,78211
10665,5118,5547,765,124300,78212
16166,7423,8743,849,108300,78213
7649,4245,3404,715,66600,78214
1325,38,1287,1205,270000,78215
17690,6236,11454,863,167300,78216
13810,5988,7822,867,122000,78217
12429,5629,6800,834,94300,78218
5681,3037,2644,840,80300,78219
5403,3132,2271,822,69800,78220
11293,6820,4473,770,78800,78221
7221,4930,2291,809,101700,78222
17398,10280,7118,757,86500,78223
5543,3383,2160,857,81700,78224
4409,2829,1580,764,66100,78225
2320,901,1419,623,66200,78226
14140,7208,6932,788,81000,78227
19105,11353,7752,752,86400,78228
13971,2205,11766,859,125200,78229
18617,8916,9701,933,198000,78230
3363,2437,926,980,239300,78231
15842,9182,6660,1066,211300,78232
17169,10193,6976,985,117500,78233
991,21,970,1582,171900,78234
333,0,333,1313,-,78235
439,0,439,1585,-,78236
11098,6928,4170,757,58300,78237
9153,4100,5053,869,115000,78238
9231,6281,2950,1123,118600,78239
23715,8085,15630,938,149900,78240
8921,5243,3678,829,69800,78242
0,0,0,-,-,78243
9139,6267,2872,1146,109400,78244
19954,13596,6358,1058,125100,78245
17694,13550,4144,1155,156500,78247
5475,4316,1159,1172,288300,78248
18993,11113,7880,1114,169200,78249
18696,13797,4899,1083,128700,78250
19476,11320,8156,1039,151200,78251
2143,1694,449,1158,113700,78252
11886,9694,2192,1385,213200,78253
15656,12524,3132,1236,163600,78254
4344,3672,672,1528,290700,78255
3496,1470,2026,1166,408100,78256
1908,1330,578,1060,612800,78257
15682,10172,5510,1374,292900,78258
8568,6171,2397,1253,231500,78259
8610,7436,1174,1591,290500,78260
5084,3890,1194,1498,262400,78261
1579,1374,205,-,170700,78263
2888,2385,503,876,80200,78264
2353,2162,191,1870,370200,78266
313,253,60,681,65400,78330
9444,6352,3092,717,73300,78332
0,0,0,-,-,78335
4690,2829,1861,770,104900,78336
12,4,8,-,-,78338
202,115,87,788,56900,78339
199,166,33,708,82600,78340
904,587,317,608,41100,78341
139,86,53,773,-,78342
1507,1120,387,681,72800,78343
148,114,34,683,97400,78344
190,177,13,-,41900,78349
142,116,26,1063,38600,78351
75,75,0,-,24300,78352
135,101,34,-,62800,78353
1964,1291,673,544,55100,78355
946,674,272,720,54600,78357
293,142,151,878,31900,78358
656,425,231,785,58600,78359
1611,1234,377,556,66400,78361
3448,2420,1028,930,115500,78362
10283,5461,4822,782,86400,78363
3201,2397,804,580,56400,78368
125,86,39,679,56000,78369
1692,1313,379,740,78700,78370
127,101,26,-,63900,78371
1882,1378,504,749,87400,78372
1885,1182,703,1161,268000,78373
6151,4033,2118,1155,151000,78374
1007,831,176,650,60700,78375
260,188,72,528,34300,78376
1417,967,450,599,74800,78377
493,429,64,825,102800,78379
7478,5297,2181,674,77400,78380
8130,6278,1852,794,162400,78382
1445,1283,162,-,114200,78383
1919,1173,746,721,43600,78384
132,56,76,467,-,78385
3105,2244,861,764,68800,78387
511,402,109,665,69800,78389
1849,1319,530,665,68900,78390
93,74,19,-,53900,78391
805,653,152,928,75600,78393
1833,400,1433,611,60500,78401
206,68,138,1346,153600,78402
6872,3157,3715,833,98400,78404
5327,2946,2381,670,52900,78405
304,280,24,-,56000,78406
1185,614,571,848,61800,78407
4254,2136,2118,672,65100,78408
993,590,403,695,79600,78409
9226,5977,3249,951,134600,78410
10303,6129,4174,869,106600,78411
14805,6637,8168,951,116000,78412
14988,8235,6753,1056,162400,78413
13490,8865,4625,1150,182300,78414
13583,7865,5718,830,84800,78415
4956,3171,1785,805,67000,78416
1359,1020,339,675,83100,78417
12568,7204,5364,982,164600,78418
197,4,193,1464,-,78419
20053,10335,9718,671,94700,78501
6467,4174,2293,777,90300,78503
16557,11486,5071,859,144300,78504
9474,7261,2213,497,54400,78516
17955,10937,7018,579,82000,78520
25380,15241,10139,656,66000,78521
12358,9259,3099,772,105500,78526
192,120,72,778,57800,78535
112,89,23,-,-,78536
11095,8227,2868,556,55000,78537
3052,2221,831,509,49700,78538
11123,6584,4539,747,119000,78539
12467,6963,5504,700,85200,78541
16118,12039,4079,567,74200,78542
2453,1531,922,510,56200,78543
194,144,50,-,40000,78545
176,172,4,-,51200,78548
215,192,23,-,53500,78549
16447,8753,7694,680,76000,78550
11647,9168,2479,772,96000,78552
3212,2362,850,610,90300,78557
256,174,82,579,72600,78558
3743,2694,1049,620,61200,78559
1426,946,480,670,89800,78560
159,135,24,560,38400,78561
784,618,166,474,47700,78562
97,75,22,-,-,78563
54,0,54,-,-,78564
92,72,20,-,36000,78565
4769,3554,1215,696,87500,78566
197,189,8,-,54200,78567
1119,975,144,629,57500,78569
8859,6424,2435,535,56200,78570
23862,16531,7331,721,80600,78572
9396,6252,3144,670,87900,78573
15089,11524,3565,660,79200,78574
2677,2082,595,800,135000,78575
2309,1897,412,610,62400,78576
20942,12626,8316,704,73600,78577
4358,2991,1367,693,114100,78578
1032,810,222,563,57000,78579
3854,2817,1037,558,49400,78580
10643,8084,2559,554,66700,78582
2556,2116,440,493,54600,78583
4943,3360,1583,496,68800,78584
141,123,18,-,37400,78585
15432,11402,4030,563,58500,78586
73,52,21,390,32500,78588
10341,7994,2347,585,82600,78589
79,65,14,-,33000,78590
70,53,17,-,-,78591
281,231,50,605,32700,78592
1637,1210,427,496,54200,78593
520,465,55,-,39400,78594
1730,1415,315,549,59600,78595
18970,13511,5459,636,74400,78596
1661,1124,537,925,254000,78597
76,64,12,-,118800,78598
9069,6832,2237,871,156800,78602
1879,1553,326,851,155200,78605
2012,1538,474,765,193600,78606
61,54,7,-,-,78607
206,150,56,-,155900,78608
989,794,195,819,165900,78609
10252,8188,2064,1058,208400,78610
4825,3402,1423,742,153600,78611
3662,3095,567,1159,138100,78612
24414,17312,7102,1229,235700,78613
190,158,32,-,163300,78614
373,323,50,941,151600,78615
2256,1565,691,748,111500,78616
6265,4809,1456,1061,115600,78617
150,135,15,831,220800,78618
1342,1206,136,891,424300,78619
5407,4637,770,976,337200,78620
7366,5711,1655,893,123400,78621
101,74,27,785,-,78622
285,242,43,-,179400,78623
8933,6717,2216,913,265200,78624
9742,6365,3377,956,171200,78626
10309,7496,2813,1028,244200,78628
4046,2605,1441,633,114500,78629
959,803,156,-,188300,78631
363,306,57,-,131900,78632
10710,9863,847,1598,265300,78633
8569,6842,1727,1185,160100,78634
11,11,0,-,-,78635
1631,1179,452,721,218100,78636
766,586,180,672,155300,78638
3349,2211,1138,743,124700,78639
14443,10617,3826,1304,152500,78640
17274,13960,3314,1368,186100,78641
3263,2848,415,872,228800,78642
2320,1779,541,671,128100,78643
5905,3872,2033,847,125300,78644
4455,3630,825,1033,203600,78645
2851,1889,962,643,107500,78648
596,441,155,920,127700,78650
1918,1342,576,1136,216500,78652
5914,4762,1152,1251,152600,78653
6963,5189,1774,817,171600,78654
1101,842,259,793,122700,78655
725,440,285,801,118200,78656
2504,2084,420,988,316700,78657
977,807,170,672,150700,78659
27246,20615,6631,1209,180800,78660
183,142,41,687,58300,78661
871,774,97,869,135300,78662
325,234,91,-,138800,78663
19868,10840,9028,1111,161100,78664
13709,9907,3802,1268,215200,78665
26902,10062,16840,943,148100,78666
3926,3387,539,1202,380200,78669
66,38,28,925,104700,78670
262,228,34,-,161500,78671
628,567,61,575,96400,78672
111,111,0,-,-,78675
5505,4640,865,1134,241000,78676
18,18,0,-,-,78677
17328,13434,3894,1136,239400,78681
4570,1880,2690,1734,447100,78701
8738,3956,4782,990,251000,78702
9998,5009,4989,1362,735000,78703
22701,7944,14757,1167,421800,78704
8307,877,7430,1140,432800,78705
0,0,0,-,-,78712
9403,6001,3402,1188,286400,78717
444,346,98,848,121200,78719
4126,2173,1953,970,178100,78721
3082,1391,1691,1170,313300,78722
12292,5135,7157,889,231300,78723
6112,3678,2434,1038,111500,78724
2438,1788,650,1307,123300,78725
5345,2649,2696,1092,378200,78726
12900,6158,6742,1192,226300,78727
9937,3049,6888,1046,188100,78728
13052,5677,7375,1100,218600,78729
3752,2308,1444,1219,641200,78730
12588,7201,5387,1186,509600,78731
5327,4230,1097,1489,484100,78732
2991,2690,301,1608,528100,78733
7395,5772,1623,1495,352300,78734
6983,3606,3377,1304,426500,78735
2973,2517,456,1219,290200,78736
4979,4628,351,2023,370800,78737
5423,4148,1275,1407,486000,78738
6254,5922,332,2316,394600,78739
20617,2998,17619,951,141300,78741
280,151,129,963,80600,78742
13528,6111,7417,1067,111400,78744
25592,11688,13904,1140,204500,78745
10817,7627,3190,1449,749000,78746
6158,4190,1968,1309,177600,78747
18310,11073,7237,1240,221000,78748
15015,9278,5737,1307,275600,78749
11374,7350,4024,1222,330500,78750
7444,2145,5299,1087,366100,78751
7663,1937,5726,892,202800,78752
19163,6711,12452,933,150700,78753
7610,3675,3935,1121,169300,78754
4326,2056,2270,1157,454300,78756
10715,6097,4618,1082,321200,78757
18977,5567,13410,998,159600,78758
20118,9146,10972,1150,367600,78759
6811,4711,2100,628,77800,78801
154,113,41,-,158800,78802
467,346,121,454,52000,78827
38,38,0,-,82500,78828
358,279,79,653,41900,78829
231,173,58,636,45500,78830
1139,911,228,515,72700,78832
458,314,144,746,68000,78833
2663,1911,752,850,64500,78834
60,60,0,-,38100,78836
66,50,16,-,66700,78837
104,94,10,-,245800,78838
2716,1750,966,495,38600,78839
14889,9473,5416,675,94200,78840
10,0,10,-,-,78843
416,357,59,683,135100,78850
9,7,2,-,-,78851
15730,10726,5004,600,92800,78852
71,71,0,-,53600,78860
3714,2678,1036,726,114900,78861
370,272,98,525,76700,78870
4,4,0,-,-,78871
600,492,108,522,45200,78872
720,577,143,842,150200,78873
375,303,72,-,153800,78877
87,78,9,-,140300,78879
629,554,75,473,62900,78880
761,632,129,785,65400,78881
170,154,16,838,575800,78883
382,305,77,525,195500,78884
63,60,3,-,-,78885
195,172,23,-,162500,78886
86,63,23,-,-,78931
223,192,31,682,128600,78932
458,449,9,-,162000,78933
2146,1605,541,614,127700,78934
437,428,9,-,171900,78935
151,129,22,-,66700,78938
884,785,99,750,146500,78940
1086,815,271,570,135800,78941
2882,1908,974,786,110300,78942
70,60,10,-,155300,78943
269,239,30,585,172300,78944
3846,2896,950,892,165500,78945
409,332,77,814,154200,78946
1624,1393,231,803,159300,78947
271,258,13,-,224200,78948
215,166,49,526,152900,78949
993,796,197,764,156900,78950
0,0,0,-,-,78951
274,253,21,1048,121900,78953
521,470,51,1011,264500,78954
2076,1568,508,697,134900,78956
3700,2792,908,876,140400,78957
687,515,172,536,76600,78959
2288,1952,336,700,122700,78962
330,306,24,-,136600,78963
105,75,30,-,90800,79001
83,59,24,-,102500,79003
587,444,143,668,123400,79005
5224,3723,1501,675,73100,79007
637,369,268,602,72700,79009
217,128,89,428,-,79010
121,83,38,-,-,79011
482,425,57,-,247000,79012
863,451,412,574,50600,79013
1355,923,432,771,133400,79014
7741,4762,2979,813,172300,79015
0,0,0,-,-,79016
137,75,62,759,47900,79018
625,486,139,733,120100,79019
46,17,29,419,77500,79021
3516,2133,1383,715,100200,79022
187,136,51,745,74200,79024
28,11,17,-,-,79025
1623,1016,607,626,73200,79027
5121,3455,1666,727,108800,79029
463,349,114,644,73000,79031
48,37,11,-,93400,79032
37,33,4,-,-,79033
226,187,39,610,102700,79034
1555,1111,444,628,73400,79035
1995,1782,213,701,74800,79036
374,313,61,581,103500,79039
580,345,235,710,97900,79040
1198,847,351,630,71400,79041
471,356,115,710,69400,79042
452,331,121,829,50500,79043
252,111,141,630,113200,79044
6070,3985,2085,734,86700,79045
213,148,65,713,66000,79046
20,0,20,-,-,79051
407,296,111,588,77500,79052
61,34,27,511,118200,79053
221,164,57,563,31300,79054
20,19,1,-,-,79056
513,371,142,528,48400,79057
0,0,0,-,-,79058
294,239,55,900,113200,79059
150,105,45,528,55400,79061
70,51,19,830,-,79062
235,205,30,-,131900,79063
829,483,346,599,62800,79064
7527,5477,2050,718,76400,79065
1155,983,172,728,110900,79068
3466,2432,1034,727,92300,79070
8614,5004,3610,606,80700,79072
100,91,9,-,-,79078
1222,769,453,617,84000,79079
245,205,40,850,50200,79080
1442,1117,325,627,87700,79081
87,73,14,971,142000,79082
789,630,159,843,66500,79083
781,608,173,608,83200,79084
12,12,0,-,-,79085
790,587,203,626,81700,79086
260,163,97,682,77900,79087
1940,1351,589,664,73800,79088
75,66,9,-,75000,79091
353,318,35,750,88000,79092
22,22,0,-,-,79093
26,26,0,-,54500,79094
956,718,238,583,58100,79095
835,604,231,679,92600,79096
398,356,42,796,99500,79097
174,150,24,825,101000,79098
1128,211,917,731,77400,79101
4096,2044,2052,651,94700,79102
3832,2772,1060,798,84100,79103
2366,1445,921,690,60800,79104
0,0,0,-,-,79105
11681,6032,5649,725,111200,79106
11002,6582,4420,717,63000,79107
4305,3293,1012,737,102800,79108
18398,10981,7417,750,151100,79109
7304,5057,2247,853,109700,79110
473,5,468,951,-,79111
7137,5591,1546,1061,145300,79118
5676,4234,1442,971,253600,79119
2880,1976,904,795,178000,79121
3167,2612,555,937,225100,79124
2365,1381,984,741,73400,79201
125,67,58,529,102500,79220
385,277,108,547,44600,79225
1136,848,288,618,70500,79226
547,428,119,438,48200,79227
176,143,33,607,47400,79229
48,45,3,-,-,79230
23,0,23,-,-,79231
39,31,8,-,27100,79233
33,20,13,-,65000,79234
1473,1073,400,674,48700,79235
104,23,81,729,62500,79236
182,135,47,427,49400,79237
73,50,23,-,70000,79239
0,0,0,-,-,79240
919,623,296,634,73000,79241
31,20,11,-,-,79243
274,203,71,-,56500,79244
943,564,379,523,46700,79245
26,26,0,-,27800,79247
651,429,222,-,40500,79248
530,402,128,671,60000,79250
19,19,0,-,55000,79251
1237,900,337,473,36900,79252
284,186,98,567,64600,79255
162,100,62,605,51600,79256
416,347,69,630,61500,79257
10,3,7,-,-,79258
12,12,0,-,-,79259
180,135,45,604,56100,79261
1327,967,360,723,78100,79311
378,279,99,458,55300,79312
607,412,195,576,62200,79313
41,39,2,-,35800,79314
3781,2718,1063,708,65900,79316
767,531,236,588,49400,79322
2193,1731,462,719,79900,79323
6,6,0,-,35000,79324
840,627,213,706,120800,79325
42,42,0,-,-,79326
1155,852,303,831,126600,79329
54,42,12,-,-,79330
4199,2974,1225,586,62900,79331
6042,3935,2107,655,85600,79336
2474,1735,739,674,67600,79339
189,87,102,424,72100,79342
517,338,179,533,65500,79343
11,11,0,-,95000,79344
276,223,53,510,70500,79345
779,619,160,461,32600,79346
2421,1786,635,682,65300,79347
115,71,44,685,74700,79350
469,335,134,644,61700,79351
9,2,7,-,-,79353
680,473,207,825,83100,79355
1547,1037,510,737,81900,79356
803,540,263,641,53700,79357
371,316,55,725,86700,79358
823,555,268,713,54400,79359
4378,3463,915,815,114200,79360
1837,1355,482,759,117200,79363
3267,2442,825,623,71800,79364
529,478,51,867,213100,79366
266,210,56,910,57100,79367
51,44,7,-,18000,79369
557,421,136,463,51300,79370
502,401,101,583,58500,79371
434,305,129,725,72800,79372
1205,823,382,698,67300,79373
19,15,4,-,154200,79376
72,55,17,-,64100,79377
145,74,71,328,62000,79378
190,140,50,433,35000,79379
78,47,31,765,-,79380
510,399,111,670,95400,79381
2221,1733,488,909,148400,79382
3181,345,2836,892,68000,79401
5215,3344,1871,744,52200,79403
3170,1948,1222,710,52500,79404
0,0,0,-,-,79406
8224,3873,4351,764,98900,79407
3771,1557,2214,1018,124100,79410
3327,1309,2018,840,56000,79411
5366,2616,2750,788,75700,79412
8538,4828,3710,999,125700,79413
7952,2904,5048,804,85700,79414
6236,2717,3519,762,59100,79415
13050,6387,6663,946,114900,79416
13955,10055,3900,935,130000,79423
17907,12513,5394,895,177400,79424
1174,876,298,715,77800,79501
456,341,115,407,50700,79502
104,90,14,-,-,79503
1238,1032,206,625,65400,79504
119,83,36,642,42500,79505
373,269,104,466,72600,79506
534,451,83,738,166300,79508
2791,2258,533,823,76000,79510
520,455,65,740,102700,79511
2294,1698,596,618,63700,79512
96,78,18,-,230600,79517
33,31,2,-,81700,79518
33,33,0,-,166100,79519
927,667,260,564,44000,79520
1379,1058,321,430,60300,79521
937,713,224,741,93400,79525
387,319,68,847,74500,79526
91,83,8,-,62800,79527
242,173,69,492,70300,79528
500,380,120,424,38400,79529
195,186,9,-,52200,79530
285,236,49,558,43600,79532
136,98,38,-,36000,79533
50,39,11,-,86300,79534
50,42,8,-,60000,79535
1883,1413,470,832,69600,79536
22,22,0,-,48000,79537
98,88,10,330,-,79538
66,50,16,513,26700,79539
24,24,0,-,83600,79540
326,277,49,-,202400,79541
481,384,97,482,61000,79543
213,155,58,563,30900,79544
659,520,139,753,73900,79545
800,510,290,525,63800,79546
287,206,81,575,28600,79547
90,52,38,-,93300,79548
5419,3898,1521,752,91600,79549
1456,1005,451,623,45400,79553
4866,3248,1618,600,65300,79556
54,45,9,-,62100,79560
248,176,72,605,61400,79561
1378,1312,66,838,166200,79562
381,272,109,590,51900,79563
94,81,13,-,73900,79565
146,135,11,-,203400,79566
1169,785,384,528,55000,79567
7778,3504,4274,755,89700,79601
7909,5488,2421,790,140400,79602
8641,5510,3131,683,69100,79603
11316,6135,5181,813,97100,79605
9670,5209,4461,906,156600,79606
629,0,629,1211,-,79607
0,0,0,-,-,79699
9462,6104,3358,913,102800,79701
7324,4999,2325,1178,135700,79703
13611,9297,4314,1193,215200,79705
7519,5956,1563,1085,118800,79706
14184,8548,5636,1229,261300,79707
139,93,46,617,83100,79713
5392,3893,1499,960,122000,79714
275,196,79,575,41000,79718
209,156,53,656,30000,79719
10712,7030,3682,831,80500,79720
105,79,26,-,28400,79730
1482,1153,329,690,80600,79731
65,40,25,439,61100,79733
962,747,215,661,114600,79734
3631,2573,1058,797,71100,79735
95,57,38,-,61700,79738
371,239,132,1048,214000,79739
127,111,16,-,63500,79741
173,130,43,333,-,79742
110,88,22,430,60900,79743
413,308,105,569,77600,79744
2274,1771,503,734,48700,79745
48,45,3,-,83600,79748
98,77,21,475,119300,79749
839,621,218,544,58000,79752
35,17,18,850,-,79754
80,41,39,661,87900,79755
3261,2304,957,736,88500,79756
717,499,218,878,59000,79758
7,7,0,-,-,79759
11249,7211,4038,863,115300,79761
15757,9167,6590,1028,135200,79762
11613,7978,3635,800,88300,79763
7116,5310,1806,887,78100,79764
4515,3109,1406,1318,200900,79765
1770,1433,337,829,77200,79766
8,8,0,-,-,79770
3429,2423,1006,800,46300,79772
77,39,38,-,55000,79777
344,272,72,514,69000,79778
59,52,7,-,-,79780
82,54,28,668,37500,79781
1321,981,340,860,102600,79782
96,84,12,-,140600,79783
32,22,10,-,-,79785
166,132,34,647,44500,79788
336,264,72,492,58600,79789
1677,1122,555,572,94800,79821
3356,1893,1463,697,128600,79830
8,4,4,-,-,79831
82,2,80,543,-,79834
3403,2120,1283,688,68200,79835
1707,1429,278,684,79200,79836
172,92,80,-,29500,79837
2015,1417,598,481,62100,79838
493,436,57,638,44900,79839
235,149,86,530,92500,79842
853,647,206,738,106300,79843
1698,1012,686,409,45800,79845
6,0,6,-,-,79846
54,23,31,-,19200,79847
382,262,120,743,64400,79848
3157,2175,982,615,62500,79849
200,133,67,592,48800,79851
333,246,87,396,76900,79852
746,592,154,449,41900,79853
48,27,21,463,-,79854
757,505,252,510,60100,79855
3993,429,3564,360,56600,79901
8273,3372,4901,575,150400,79902
6044,3314,2730,495,89000,79903
10906,4712,6194,769,99900,79904
7964,4210,3754,433,81600,79905
1094,0,1094,1289,-,79906
16521,9954,6567,643,87000,79907
680,0,680,1473,-,79908
1248,1028,220,1258,217600,79911
28138,15388,12750,880,179800,79912
12500,7250,5250,564,85200,79915
5,0,5,-,-,79916
0,0,0,-,-,79920
2719,2364,355,805,270800,79922
19769,12146,7623,823,97200,79924
14804,7705,7099,780,136900,79925
10903,8205,2698,659,84700,79927
14898,12179,2719,1011,114000,79928
10391,4979,5412,716,92000,79930
8750,6360,2390,806,156500,79932
8094,5754,2340,1143,131600,79934
6383,3508,2875,776,140800,79935
34912,23998,10914,957,121700,79936
19806,14749,5057,1022,138800,79938
8,8,0,-,-,79942
8196,4322,3874,993,230400,80002
13970,9738,4232,1160,229000,80003
14915,10536,4379,1077,278300,80004
10923,9425,1498,1348,318700,80005
3124,3079,45,2688,499800,80007
13090,4479,8611,863,159200,80010
15991,8030,7961,1038,152000,80011
18720,8498,10222,984,184800,80012
24822,18045,6777,1286,222900,80013
17957,9852,8105,1119,199500,80014
21918,17685,4233,1391,274700,80015
16800,12893,3907,1391,424100,80016
12627,6653,5974,1134,174800,80017
3642,3155,487,1604,278300,80018
855,572,283,1107,210400,80019
18638,13431,5207,1364,280000,80020
13467,7459,6008,1383,264800,80021
13694,9162,4532,997,199500,80022
7304,6207,1097,1517,471300,80023
111,72,39,869,117900,80024
154,124,30,1625,791700,80025
11583,8361,3222,1272,325300,80026
12477,8510,3967,1470,445000,80027
6060,3188,2872,837,183400,80030
13237,9415,3822,1247,253300,80031
11590,6090,5500,909,270200,80033
513,0,513,1375,-,80045
148,125,23,1097,271300,80101
1939,1645,294,1030,250100,80102
962,872,90,1094,230400,80103
10362,7828,2534,1277,299700,80104
570,477,93,704,208600,80105
1695,1571,124,1042,374100,80106
4177,3761,416,1326,366400,80107
8969,7295,1674,1406,514000,80108
6617,5713,904,1408,364900,80109
8907,4935,3972,1056,214700,80110
12224,7605,4619,1442,538500,80111
13140,8032,5108,1395,343100,80112
9783,5391,4392,969,326200,80113
1468,1371,97,"3,500+",544500,80116
1065,939,126,1220,276200,80117
2442,2231,211,2100,496600,80118
13549,7870,5679,976,302500,80120
7290,6179,1111,1170,368300,80121
12330,10318,2012,1399,326600,80122
18903,13528,5375,1250,305600,80123
8051,4937,3114,1433,443900,80124
3865,3656,209,1816,371100,80125
15831,13124,2707,1493,384500,80126
16242,14052,2190,1387,354500,80127
13925,11572,2353,1318,288700,80128
11045,8581,2464,1670,363000,80129
10417,8131,2286,1690,373400,80130
104,77,27,-,242800,80131
6954,6302,652,1500,402900,80132
976,654,322,972,216500,80133
21879,18101,3778,1466,349600,80134
1595,1424,171,1092,523600,80135
1725,1469,256,1087,239000,80136
397,304,93,-,398400,80137
11336,9379,1957,1352,371400,80138
8089,2239,5850,1586,416700,80202
14157,2749,11408,931,266300,80203
12210,4052,8158,823,222400,80204
13290,6096,7194,1024,304700,80205
12984,6004,6980,974,487200,80206
9621,6520,3101,1084,330400,80207
13390,6700,6690,1274,538100,80209
15520,9420,6100,1102,479200,80210
15739,8311,7428,963,371900,80211
9020,5543,3477,1012,346200,80212
11366,4128,7238,879,245200,80214
8222,4716,3506,1000,342400,80215
3502,1324,2178,1055,153300,80216
11063,3876,7187,956,350300,80218
20389,10488,9901,945,177500,80219
15930,9210,6720,985,398700,80220
13312,8198,5114,1006,191300,80221
10048,5194,4854,996,280100,80222
7214,3356,3858,895,186800,80223
8383,4551,3832,975,306200,80224
13353,7581,5772,1083,249700,80226
14949,9140,5809,1108,261900,80227
13751,9080,4671,1118,303400,80228
17529,10595,6934,1111,174500,80229
3963,2159,1804,1331,473100,80230
16668,5738,10930,1027,266200,80231
8953,6499,2454,1155,249600,80232
17120,10419,6701,1224,209800,80233
10428,6165,4263,1133,255000,80234
3323,1851,1472,1046,265400,80235
6302,3790,2512,1008,245900,80236
9826,4980,4846,1287,340700,80237
5447,4107,1340,1648,478700,80238
11312,6515,4797,1205,177700,80239
11659,8681,2978,1340,259300,80241
7194,1434,5760,942,279800,80246
13668,5119,8549,1077,145000,80247
8754,6514,2240,1521,219900,80249
11643,6763,4880,986,85500,80260
0,0,0,-,-,80264
0,0,0,-,-,80290
0,0,0,-,-,80293
0,0,0,-,-,80294
11275,6929,4346,1362,420300,80301
11626,4498,7128,1243,636900,80302
11285,4924,6361,1220,574800,80303
11123,7604,3519,1346,624900,80304
7175,4302,2873,1687,554800,80305
150,0,150,850,-,80310
16255,10976,5279,1136,398200,80401
7631,6320,1311,1289,432200,80403
0,0,0,-,-,80419
346,228,118,1219,284000,80420
3768,3179,589,1323,247300,80421
1931,1682,249,1150,272500,80422
25,22,3,-,-,80423
3230,2432,798,1238,536900,80424
165,165,0,-,431000,80425
35,30,5,-,406300,80426
456,158,298,947,185700,80427
266,224,42,-,456100,80428
137,122,15,-,139700,80432
3255,2891,364,1216,380500,80433
17,17,0,-,71700,80434
2389,1411,978,1168,486800,80435
242,230,12,-,274400,80436
232,162,70,688,164300,80438
9864,8398,1466,1361,446700,80439
1033,710,323,1240,268400,80440
844,467,377,960,347100,80442
1365,811,554,1587,537600,80443
618,400,218,820,259300,80444
1603,1110,493,1107,264900,80446
756,681,75,669,367900,80447
129,91,38,-,343100,80448
399,394,5,-,179700,80449
293,182,111,1099,218900,80451
1554,1051,503,782,226400,80452
144,106,38,1153,278600,80453
487,385,102,1173,280700,80454
217,139,78,840,317300,80455
371,293,78,-,283100,80456
192,21,171,1190,-,80457
903,576,327,881,217700,80459
3040,1664,1376,846,177700,80461
66,56,10,-,-,80463
6162,5586,576,1463,314200,80465
1675,992,683,958,361200,80466
965,716,249,1111,228800,80467
199,166,33,-,294200,80468
181,116,65,-,163700,80469
1304,1228,76,1683,314200,80470
0,0,0,-,-,80471
2,2,0,-,-,80473
77,37,40,-,-,80475
108,77,31,775,183000,80476
61,61,0,-,875000,80477
635,521,114,1095,504900,80478
11,11,0,-,-,80479
597,402,195,704,174100,80480
339,326,13,1542,681500,80481
544,332,212,872,347400,80482
244,160,84,872,218300,80483
6737,4477,2260,1181,528100,80487
40,0,40,1315,-,80488
291,257,34,-,349600,80497
2439,1621,818,1267,483500,80498
16300,8497,7803,961,226700,80501
13042,8969,4073,1130,385000,80503
17752,14556,3196,1263,301500,80504
264,183,81,813,359500,80510
0,0,0,-,-,80511
810,718,92,1044,299200,80512
4349,3747,602,930,321600,80513
1743,1091,652,941,178400,80514
411,359,52,-,232500,80515
8169,7138,1031,1518,382400,80516
4542,3121,1421,889,346600,80517
457,335,122,1315,173000,80520
12899,4973,7926,1080,277300,80521
13615,9073,4542,971,282200,80524
21013,12874,8139,1145,299400,80525
18000,10558,7442,1125,275400,80526
6843,5568,1275,1413,358100,80528
1588,1374,214,1326,205400,80530
41,41,0,-,-,80532
5706,4996,710,1532,267700,80534
1137,734,403,903,265000,80535
957,828,129,1093,286600,80536
17613,10826,6787,967,249100,80537
18501,12853,5648,1088,244800,80538
1863,1543,320,1302,433500,80540
1430,1397,33,1875,329100,80542
2056,1758,298,1307,201400,80543
15,15,0,-,-,80544
301,258,43,-,250000,80545
91,91,0,-,171500,80546
543,495,48,1194,415500,80547
3318,2724,594,1284,236100,80549
8628,7143,1485,1221,305100,80550
11420,7293,4127,1075,217200,80601
10053,9152,901,1606,342600,80602
4133,3521,612,1326,253200,80603
1102,754,348,827,216500,80610
262,211,51,643,234200,80611
149,134,15,-,320500,80612
2852,2124,728,928,254100,80615
6436,3435,3001,1041,153700,80620
4221,2980,1241,842,188700,80621
61,50,11,-,230000,80622
298,209,89,1004,150200,80623
408,230,178,859,289700,80624
16853,7714,9139,756,141000,80631
21037,14486,6551,966,210600,80634
3577,2714,863,1361,260000,80640
1289,1002,287,1047,292800,80642
1153,929,224,1096,288600,80643
1165,772,393,810,182400,80644
1495,1082,413,889,190600,80645
421,359,62,1115,277000,80648
102,88,14,880,-,80649
547,432,115,733,164300,80650
1529,1117,412,795,223600,80651
186,144,42,-,120600,80652
383,285,98,758,176700,80653
1020,777,243,875,207600,80654
5758,3740,2018,658,150600,80701
437,272,165,819,75500,80705
1139,815,324,604,102000,80720
83,43,40,-,163500,80721
97,48,49,768,165000,80722
2570,1616,954,762,146000,80723
271,220,51,694,161000,80726
141,71,70,803,71000,80727
382,303,79,700,109800,80728
217,147,70,817,171600,80729
594,465,129,588,117300,80731
175,116,59,815,105700,80733
1110,702,408,634,148400,80734
134,80,54,750,233300,80735
178,145,33,525,132000,80736
677,438,239,576,109300,80737
69,39,30,590,-,80740
337,219,118,745,129200,80741
86,80,6,-,65700,80742
432,301,131,641,157900,80743
197,151,46,563,72300,80744
86,72,14,-,-,80745
31,30,1,-,87500,80746
165,144,21,545,120400,80747
134,114,20,675,74500,80749
107,73,34,679,184900,80750
6499,3884,2615,700,137900,80751
61,41,20,-,-,80754
31,22,9,-,131800,80755
121,63,58,-,141100,80757
1385,774,611,688,134900,80758
2081,1345,736,595,137000,80759
56,46,10,367,131800,80801
117,87,30,739,100900,80802
135,98,37,525,60000,80804
210,181,29,850,125600,80805
1829,1210,619,802,130500,80807
2396,1796,600,843,185300,80808
637,552,85,943,235400,80809
472,360,112,584,93300,80810
89,79,10,-,105100,80812
774,460,314,846,163500,80813
1455,1329,126,1145,242500,80814
334,235,99,561,117900,80815
2484,2120,364,1078,216200,80816
9793,6403,3390,1256,191600,80817
125,101,24,1042,156300,80818
370,244,126,776,237000,80819
361,361,0,-,263200,80820
403,293,110,684,140800,80821
104,85,19,619,205200,80822
65,45,20,644,210700,80823
96,71,25,-,86500,80824
154,113,41,636,71900,80825
349,349,0,-,314300,80827
747,493,254,807,133200,80828
2731,1748,983,841,298800,80829
119,91,28,1292,203600,80830
7885,6758,1127,1470,266000,80831
222,181,41,780,159700,80832
246,198,48,744,193100,80833
122,100,22,661,100900,80834
348,286,62,691,175000,80835
425,292,133,655,121900,80836
527,0,527,1485,-,80840
325,234,91,618,95300,80860
113,94,19,-,150000,80861
24,22,2,-,53300,80862
4839,3780,1059,1124,273800,80863
490,378,112,988,198900,80864
2895,10,2885,1418,-,80902
6973,2698,4275,734,201500,80903
10285,5633,4652,866,218800,80904
7812,3606,4206,813,186600,80905
15404,9569,5835,1072,329600,80906
12618,7242,5376,797,185200,80907
5324,4968,356,1823,414600,80908
16329,7761,8568,733,172200,80909
11964,4748,7216,784,135700,80910
11161,9058,2103,1168,170300,80911
40,0,40,1388,-,80913
13,0,13,-,-,80914
7773,5258,2515,921,164800,80915
13852,6635,7217,980,142500,80916
13267,7305,5962,858,199000,80917
18939,11119,7820,1077,216000,80918
11154,8561,2593,1151,326700,80919
13804,10148,3656,1297,282300,80920
7299,5627,1672,1418,387900,80921
9439,6698,2741,1422,221800,80922
10230,7207,3023,1513,243800,80923
2191,1600,591,1853,393000,80924
2600,1962,638,1538,235200,80925
598,498,100,491,210500,80926
608,532,76,2217,333500,80927
455,387,68,1043,122300,80928
97,38,59,-,233300,80929
606,264,342,1315,178000,80930
33,33,0,-,-,80938
0,0,0,-,-,80939
1380,909,471,1610,202700,80951
11973,6093,5880,741,106800,81001
5641,2305,3336,648,87700,81003
10654,5372,5282,732,93800,81004
12203,8741,3462,835,141400,81005
4489,3784,705,922,173200,81006
11118,8848,2270,962,178000,81007
4216,2739,1477,968,162700,81008
630,541,89,920,173200,81019
361,229,132,660,143200,81020
7,3,4,-,-,81021
564,434,130,-,120900,81022
536,460,76,1140,195700,81023
74,64,10,-,-,81024
319,223,96,575,95000,81025
73,57,16,-,34500,81027
88,60,28,394,34700,81029
60,45,15,581,68300,81030
53,32,21,675,63000,81033
418,337,81,638,82100,81036
0,0,0,-,-,81038
680,479,201,596,105700,81039
249,235,14,-,123600,81040
284,190,94,554,65900,81041
21,11,10,-,-,81043
165,122,43,-,80000,81044
29,29,0,-,50800,81045
604,450,154,570,107400,81047
129,111,18,475,156300,81049
3825,2340,1485,673,94000,81050
3662,2324,1338,657,88000,81052
1289,858,431,641,67600,81054
693,521,172,750,246200,81055
195,124,71,706,99500,81057
366,249,117,514,76500,81058
75,60,15,-,115000,81059
371,274,97,809,83600,81062
547,425,122,597,67400,81063
119,88,31,614,73300,81064
2363,1617,746,650,90100,81067
734,686,48,761,202700,81069
127,62,65,569,116100,81071
800,621,179,556,80800,81073
190,174,16,650,91300,81076
242,135,107,557,112200,81077
23,19,4,-,305000,81081
5050,3435,1615,690,146000,81082
61,30,31,-,32500,81084
73,54,19,667,62500,81087
1976,1352,624,585,99500,81089
421,290,131,441,65700,81090
304,220,84,912,198900,81091
394,274,120,645,98700,81092
5657,3198,2459,623,141800,81101
806,573,233,465,94600,81120
155,131,24,768,227300,81121
3403,2741,662,1321,277800,81122
335,242,93,895,98300,81123
46,34,12,-,160000,81124
1102,649,453,430,86300,81125
117,109,8,-,89500,81126
53,35,18,-,487500,81128
39,39,0,-,69200,81129
415,358,57,639,271400,81130
601,482,119,818,194200,81131
1284,955,329,599,124400,81132
415,348,67,556,152300,81133
71,46,25,500,90000,81136
2246,1538,708,932,224700,81137
42,22,20,-,-,81138
928,721,207,571,138800,81140
467,403,64,565,117500,81141
323,254,69,683,100000,81143
2646,1668,978,585,129900,81144
218,136,82,766,160500,81146
5072,3759,1313,891,268200,81147
119,100,19,682,66700,81148
408,284,124,579,146400,81149
505,440,65,419,113300,81151
562,401,161,279,111500,81152
562,451,111,727,249500,81154
165,134,31,-,245000,81155
4136,3179,957,806,296800,81201
128,49,79,-,281000,81210
2777,2073,704,913,270900,81211
10596,7404,3192,731,160600,81212
77,77,0,-,414400,81220
101,87,14,1313,112500,81221
222,105,117,838,219500,81222
714,626,88,680,149700,81223
1504,997,507,1217,450700,81224
564,339,225,1269,423000,81225
2308,1678,630,815,132200,81226
7,7,0,-,-,81227
4003,2165,1838,762,264300,81230
0,0,0,-,-,81231
7,7,0,-,-,81232
479,383,96,531,229300,81233
348,244,104,696,281300,81235
494,450,44,1054,353500,81236
28,28,0,-,-,81237
8,8,0,-,-,81239
1628,1322,306,817,173700,81240
27,26,1,-,270000,81241
331,168,163,796,197000,81242
58,47,11,-,292500,81243
162,130,32,780,107100,81244
66,45,21,-,-,81248
81,73,8,-,-,81251
1742,1361,381,725,227700,81252
270,270,0,-,242100,81253
12070,7646,4424,996,387900,81301
3175,2142,1033,1022,328500,81303
94,94,0,-,118500,81320
5888,4004,1884,737,166100,81321
1847,1375,472,979,228000,81323
499,395,104,595,102400,81324
99,89,10,-,247500,81325
855,732,123,1017,305500,81326
231,192,39,-,165300,81327
1637,1205,432,887,237600,81328
59,0,59,567,-,81330
241,197,44,-,325000,81331
96,54,42,807,244400,81332
464,277,187,278,123500,81334
22,10,12,-,-,81335
9294,5859,3435,783,183200,81401
4184,3506,678,944,250000,81403
616,472,144,747,181000,81410
10,5,5,-,-,81411
2102,1656,446,766,201100,81413
564,492,72,685,268400,81415
5378,3446,1932,837,179200,81416
743,533,210,981,192900,81418
1579,1113,466,793,234700,81419
300,188,112,660,130300,81422
669,515,154,914,289800,81423
504,374,130,731,164600,81424
1955,1294,661,753,176400,81425
65,53,12,1333,456300,81426
476,327,149,998,360400,81427
1407,1056,351,781,202900,81428
36,36,0,-,-,81429
328,272,56,1096,606700,81430
179,167,12,-,184900,81431
1397,993,404,1179,438400,81432
267,186,81,1092,219200,81433
81,49,32,-,-,81434
2122,1028,1094,1188,695500,81435
9559,3880,5679,756,167300,81501
6166,4476,1690,860,172200,81503
11446,8289,3157,1018,168900,81504
3969,2812,1157,1042,234900,81505
5021,3097,1924,1011,275200,81506
6164,5444,720,1191,291200,81507
5325,3550,1775,684,123000,81520
5978,4370,1608,1125,217200,81521
10,10,0,-,-,81522
505,505,0,-,383000,81523
805,584,221,831,338000,81524
401,235,166,1166,234500,81525
2160,1540,620,818,250400,81526
811,728,83,1105,288500,81527
5951,3546,2405,1173,365500,81601
143,124,19,842,75700,81610
4426,2665,1761,1403,622500,81611
0,0,0,-,-,81612
1316,648,668,-,873500,81615
3533,1766,1767,1264,451400,81620
2416,1676,740,1626,493500,81621
5362,3909,1453,1331,519700,81623
476,367,109,891,250800,81624
4626,3264,1362,727,172600,81625
334,276,58,758,191300,81630
2556,2102,454,1479,446600,81631
3050,2131,919,1239,545700,81632
0,0,0,-,-,81633
2507,1370,1137,877,200400,81635
2575,1965,610,1155,303000,81637
75,53,22,-,341700,81638
883,570,313,991,254900,81639
76,51,25,555,115800,81640
1464,953,511,742,249800,81641
15,0,15,-,-,81642
318,269,49,1025,288700,81643
431,220,211,1135,545900,81645
85,68,17,-,426700,81646
2429,1916,513,1382,280200,81647
961,685,276,786,167100,81648
86,61,25,1725,332800,81649
4481,3094,1387,955,217100,81650
1829,1369,460,1219,263600,81652
26,7,19,-,-,81653
559,452,107,2938,265200,81654
16,0,16,-,-,81655
113,113,0,-,1355000,81656
2388,1503,885,1370,580400,81657
14788,8868,5920,821,172200,82001
19,0,19,-,-,82005
7685,4986,2699,912,136600,82007
12989,10291,2698,806,262400,82009
92,72,20,-,-,82050
27,4,23,928,-,82051
5,5,0,-,-,82052
603,406,197,984,211200,82053
267,199,68,-,210200,82054
92,92,0,-,187500,82055
30,30,0,-,"2,000,000+",82058
82,82,0,-,341700,82059
236,236,0,-,203600,82060
0,0,0,-,-,82061
82,19,63,-,-,82063
8322,4619,3703,752,220500,82070
6846,2675,4171,703,224500,82072
0,0,0,-,-,82073
25,25,0,-,-,82081
586,435,151,621,163200,82082
137,81,56,850,95000,82083
0,0,0,-,-,82084
86,0,86,341,-,82190
2803,2122,681,614,171700,82201
179,101,78,803,106300,82210
192,167,25,640,138600,82212
239,205,34,456,128100,82213
499,368,131,778,125000,82214
68,61,7,-,191100,82215
8,0,8,-,-,82217
10,10,0,-,-,82219
199,120,79,488,111700,82221
34,21,13,-,258300,82222
505,435,70,731,192800,82223
11,11,0,-,-,82224
806,544,262,628,139600,82225
74,72,2,-,-,82227
9,9,0,-,-,82229
4160,3123,1037,663,148500,82240
25,25,0,-,267200,82242
31,19,12,-,-,82243
203,185,18,633,184500,82244
3428,2309,1119,849,147900,82301
291,205,86,737,206600,82321
55,44,11,-,-,82322
55,50,5,-,205600,82323
111,69,42,-,180200,82324
402,326,76,820,221000,82325
344,225,119,675,74600,82327
169,133,36,588,93000,82329
1019,764,255,850,189200,82331
58,47,11,-,-,82332
166,125,41,836,121600,82334
34,34,0,-,-,82335
133,72,61,704,-,82336
3240,2397,843,600,155600,82401
743,573,170,680,156000,82410
162,118,44,583,240000,82411
187,148,39,788,121200,82412
6385,4730,1655,750,266300,82414
316,260,56,654,139000,82420
132,109,23,569,152700,82421
44,44,0,-,-,82422
83,66,17,467,154200,82423
1102,789,313,685,141100,82426
59,51,8,-,419400,82428
44,37,7,850,89600,82430
1326,938,388,493,137000,82431
113,77,36,615,109700,82432
426,279,147,633,168600,82433
50,44,6,-,137500,82434
4782,3431,1351,714,197700,82435
49,49,0,-,219400,82440
107,51,56,-,335400,82441
310,238,72,615,203600,82442
2199,1615,584,688,148000,82443
83,14,69,-,-,82450
7158,4947,2211,709,178600,82501
122,106,16,425,66700,82510
64,60,4,-,-,82512
911,669,242,663,220700,82513
454,272,182,541,123000,82514
164,124,40,800,135000,82515
179,136,43,818,165000,82516
5261,3765,1496,737,214200,82520
334,276,58,925,175000,82523
11486,7218,4268,751,184500,82601
10506,7641,2865,943,194800,82604
7388,4464,2924,866,226600,82609
81,49,32,-,-,82620
8,8,0,-,-,82630
4028,3048,980,700,198300,82633
105,53,52,783,58100,82635
1842,1349,493,746,199900,82636
1547,1038,509,605,188500,82637
0,0,0,-,-,82638
325,207,118,625,115100,82639
24,24,0,-,-,82640
54,35,19,-,-,82642
229,192,37,485,35600,82643
769,295,474,809,106100,82644
0,0,0,-,-,82646
0,0,0,-,-,82648
458,328,130,633,129000,82649
2327,1809,518,804,170100,82701
141,135,6,-,248400,82710
52,35,17,-,541700,82711
182,124,58,-,246300,82712
54,38,16,-,-,82714
0,0,0,-,-,82715
6796,4558,2238,850,189700,82716
9089,6380,2709,991,229500,82718
388,288,100,575,157400,82720
1136,915,221,761,225600,82721
154,113,41,-,261500,82723
119,119,0,-,160600,82725
591,571,20,-,206400,82727
964,776,188,748,198600,82729
727,551,176,757,173000,82730
36,13,23,-,-,82731
903,600,303,1113,199400,82732
10676,7228,3448,787,235800,82801
60,29,31,950,370000,82831
289,284,5,-,316400,82832
0,0,0,-,-,82833
3277,2427,850,881,254500,82834
145,69,76,820,121500,82835
491,359,132,621,202700,82836
23,11,12,-,-,82837
139,75,64,-,230400,82838
448,347,101,1024,246400,82839
484,330,154,-,236800,82842
8,8,0,-,-,82844
14,14,0,-,-,82845
10760,7807,2953,928,193800,82901
65,65,0,-,-,82922
76,59,17,-,-,82923
164,164,0,-,-,82925
86,0,86,-,-,82929
5146,3422,1724,626,171700,82930
212,152,60,-,275400,82932
201,180,21,-,160100,82933
106,49,57,-,-,82934
4787,3525,1262,797,193000,82935
0,0,0,-,-,82936
1371,1098,273,679,193600,82937
74,74,0,-,-,82938
668,448,220,681,193700,82939
1672,1117,555,1164,247100,82941
46,46,0,-,"10,000-",82942
126,106,20,-,-,82943
91,91,0,-,-,82944
148,119,29,-,105600,82945
6257,3459,2798,1198,667100,83001
27,27,0,-,-,83011
108,14,94,-,-,83012
265,151,114,-,1063700,83013
1466,1163,303,1555,1107800,83014
153,74,79,-,1534900,83025
1294,991,303,877,181800,83101
1532,1156,376,718,205700,83110
158,124,34,-,210900,83111
170,135,35,-,-,83112
833,616,217,865,214000,83113
315,274,41,675,212800,83114
393,264,129,1585,321200,83115
287,226,61,957,131800,83116
487,342,145,832,182300,83118
31,20,11,-,-,83119
337,301,36,-,201300,83120
6,0,6,-,-,83121
192,175,17,-,-,83122
200,147,53,715,173000,83123
61,50,11,-,88300,83124
101,101,0,-,223200,83126
1371,1130,241,760,272000,83127
560,444,116,950,256800,83128
13733,8716,5017,626,143100,83201
7782,5826,1956,695,157500,83202
85,77,8,-,93700,83203
7058,4653,2405,611,133100,83204
153,0,153,603,-,83209
1070,642,428,562,111000,83210
1882,1352,530,618,130600,83211
71,62,9,-,158300,83212
600,455,145,593,86300,83213
204,193,11,529,131500,83214
6,5,1,-,-,83215
309,271,38,492,125800,83217
113,96,17,675,120400,83218
59,51,8,-,160400,83220
8735,6333,2402,661,143500,83221
45,45,0,-,202100,83223
954,838,116,638,161900,83226
132,56,76,-,-,83227
192,148,44,742,163300,83228
136,109,27,688,158800,83232
12,12,0,-,-,83233
591,470,121,692,98100,83234
13,13,0,-,-,83235
669,566,103,535,144600,83236
354,282,72,650,158500,83237
33,23,10,-,-,83238
217,197,20,594,115800,83239
726,568,158,524,114700,83241
22,10,12,-,-,83243
78,68,10,-,119600,83244
766,688,78,645,170700,83245
327,257,70,703,173500,83246
478,390,88,780,158500,83250
477,337,140,603,169000,83251
1529,1204,325,575,143100,83252
41,24,17,-,-,83253
1508,1083,425,541,129200,83254
478,427,51,625,116100,83255
247,213,34,630,142900,83261
460,413,47,1054,128300,83262
3114,2454,660,684,164700,83263
207,170,37,704,100000,83271
103,102,1,-,181300,83272
2965,2324,641,721,157000,83274
1468,1244,224,625,126400,83276
103,103,0,-,117700,83277
126,100,26,455,226900,83278
60,43,17,-,111300,83281
51,46,5,-,-,83283
65,42,23,705,270000,83285
379,322,57,846,167700,83286
95,86,9,-,200000,83287
19894,12746,7148,739,150700,83301
43,24,19,621,55000,83302
207,163,44,548,144900,83311
79,44,35,-,135900,83312
1426,938,488,915,304200,83313
467,291,176,576,149600,83314
3602,2554,1048,666,127700,83316
5748,4125,1623,613,124800,83318
295,180,115,584,146700,83320
208,127,81,708,88000,83321
11,11,0,-,316700,83322
590,425,165,610,131300,83323
189,146,43,763,137500,83324
291,229,62,541,131300,83325
323,216,107,659,165300,83327
1949,1386,563,855,170400,83328
2340,1567,773,794,107400,83330
1137,811,326,681,176200,83332
3983,2649,1334,1011,350600,83333
687,542,145,717,108700,83334
652,419,233,670,158600,83335
1739,1189,550,593,123600,83336
19,19,0,-,-,83337
6715,4476,2239,725,138800,83338
2362,1528,834,964,657200,83340
2470,1991,479,730,165400,83341
463,357,106,388,125200,83342
414,193,221,585,160600,83344
539,374,165,623,150000,83346
1069,848,221,579,122400,83347
68,59,9,-,428000,83348
383,268,115,495,132900,83349
4564,3162,1402,525,115600,83350
1049,721,328,804,128100,83352
546,489,57,1213,802500,83353
0,0,0,-,-,83354
1492,966,526,729,129900,83355
13105,8823,4282,745,150600,83401
8990,5955,3035,627,139300,83402
8322,6319,2003,902,169000,83404
5659,4534,1125,789,170300,83406
300,244,56,-,302700,83414
865,689,176,870,177700,83420
27,13,14,-,-,83421
1234,772,462,852,236700,83422
253,147,106,375,97300,83423
81,43,38,-,-,83424
209,170,39,578,110200,83425
512,485,27,1031,169300,83427
185,151,34,-,180800,83428
371,356,15,-,291100,83429
243,198,45,527,152400,83431
5,5,0,-,-,83433
522,420,102,808,136100,83434
134,102,32,-,85900,83435
144,109,35,700,142200,83436
10049,4725,5324,652,187200,83440
6200,5108,1092,698,170000,83442
345,254,91,632,144400,83443
378,295,83,505,116400,83444
2485,1988,497,660,127200,83445
19,19,0,-,182500,83446
639,482,157,646,182300,83448
99,92,7,-,268200,83449
329,247,82,750,113400,83450
322,251,71,831,121100,83451
517,462,55,581,271100,83452
173,130,43,639,138000,83454
1893,1385,508,921,263600,83455
0,0,0,-,-,83460
344,243,101,-,315200,83462
64,50,14,-,363600,83463
127,68,59,386,100000,83464
46,43,3,-,257400,83465
126,109,17,-,224200,83466
2856,1990,866,556,160700,83467
75,68,7,-,250000,83468
26,26,0,-,293800,83469
14331,9832,4499,671,170800,83501
95,68,27,535,-,83520
659,506,153,688,163700,83522
324,268,56,580,124000,83523
356,266,90,711,150000,83524
206,194,12,-,142900,83525
119,107,12,775,225900,83526
2227,1759,468,663,153200,83530
63,56,7,-,206300,83533
483,412,71,744,135400,83535
1787,1262,525,633,143700,83536
483,386,97,645,167100,83537
946,784,162,652,154100,83539
710,428,282,664,107900,83540
454,387,67,692,189700,83541
72,63,9,-,204200,83542
284,214,70,658,117400,83543
2347,1721,626,669,146900,83544
195,160,35,755,117200,83545
323,293,30,758,84900,83546
119,98,21,842,138200,83547
48,40,8,663,112500,83548
333,220,113,753,198300,83549
367,280,87,563,145800,83552
568,470,98,544,104300,83553
213,168,45,822,167500,83554
234,199,35,583,126100,83555
27,27,0,-,222500,83601
14,14,0,-,-,83602
282,138,144,-,144100,83604
13574,8638,4936,693,111500,83605
7670,5555,2115,808,165100,83607
384,341,43,525,154600,83610
984,854,130,656,215800,83611
806,598,208,524,125000,83612
460,318,142,696,233000,83615
9654,7881,1773,1024,334700,83616
5731,4110,1621,773,134700,83617
2697,2231,466,705,147900,83619
739,567,172,663,225000,83622
546,336,210,592,96900,83623
402,219,183,564,106800,83624
482,328,154,694,114200,83626
212,181,31,725,192500,83627
1472,1035,437,596,89300,83628
682,575,107,684,167400,83629
450,337,113,709,139600,83631
102,97,5,-,139600,83632
188,114,74,504,113000,83633
7001,5411,1590,1002,148800,83634
0,0,0,-,-,83636
78,54,24,-,179200,83637
1985,1456,529,794,271000,83638
1178,771,407,420,137300,83639
1251,969,282,639,173600,83641
15032,10638,4394,895,194300,83642
63,63,0,-,156600,83643
3533,2888,645,734,172100,83644
298,227,71,-,173200,83645
19160,15581,3579,1101,218400,83646
7952,5005,2947,743,138900,83647
851,0,851,918,-,83648
196,97,99,504,128100,83650
10993,6937,4056,799,112100,83651
712,569,143,576,211900,83654
1526,1167,359,664,119100,83655
265,205,60,1019,90700,83656
74,65,9,-,401700,83657
2232,1667,565,606,138000,83660
3586,2470,1116,655,119300,83661
12,11,1,-,131300,83666
3252,2570,682,1068,230900,83669
188,165,23,-,205000,83670
9,9,0,-,-,83671
3196,2264,932,662,127200,83672
1413,1025,388,606,162900,83676
42,42,0,-,-,83677
16203,11054,5149,811,143900,83686
10291,6872,3419,862,139900,83687
10564,5216,5348,722,314800,83702
7171,4526,2645,861,182900,83703
15983,9217,6766,856,153600,83704
11957,5900,6057,779,153100,83705
13595,7164,6431,802,206000,83706
19267,15310,3957,1041,191000,83709
3669,2366,1303,808,348700,83712
10178,6848,3330,997,194700,83713
9156,6163,2993,812,190600,83714
6171,4706,1465,1110,236400,83716
2340,1979,361,1035,210700,83801
40,8,32,442,-,83802
373,233,140,972,326400,83803
592,495,97,616,176700,83804
3050,2267,783,614,173400,83805
90,66,24,639,57100,83806
78,66,12,-,88900,83808
75,75,0,-,337500,83809
445,373,72,900,232000,83810
612,419,193,727,141800,83811
31,29,2,-,83800,83812
341,285,56,-,287100,83813
10784,6117,4667,785,249400,83814
13167,8625,4542,930,176700,83815
98,70,28,524,330800,83821
781,637,144,604,146400,83822
540,441,99,669,158800,83823
122,90,32,400,96300,83824
135,90,45,-,162500,83825
0,0,0,-,-,83826
71,48,23,-,87500,83827
304,216,88,-,163900,83830
561,448,113,805,180700,83832
538,421,117,890,375000,83833
120,99,21,-,-,83834
7792,6448,1344,911,229700,83835
449,349,100,729,281500,83836
1305,671,634,693,105700,83837
600,481,119,711,185500,83839
88,69,19,785,159400,83840
182,115,67,-,265600,83841
75,51,24,1028,145300,83842
11014,4918,6096,659,212700,83843
0,0,0,-,-,83844
688,489,199,850,146200,83845
337,273,64,575,74000,83846
655,363,292,473,245500,83847
149,114,35,-,257100,83848
929,711,218,588,116700,83849
997,790,207,517,150200,83850
611,433,178,757,135300,83851
367,104,263,688,84300,83852
14928,10349,4579,904,172000,83854
879,614,265,634,149000,83855
2484,2004,480,744,162900,83856
353,236,117,960,192300,83857
5157,4035,1122,959,181800,83858
2374,2005,369,1033,262300,83860
2571,1952,619,638,153900,83861
7490,4951,2539,737,230300,83864
56,56,0,-,97600,83866
211,185,26,-,123100,83867
371,192,179,547,64300,83868
1726,1366,360,707,177800,83869
141,94,47,500,127300,83870
797,682,115,692,184600,83871
232,214,18,-,296100,83872
703,424,279,669,113500,83873
12,12,0,-,-,83874
613,471,142,738,221300,83876
268,229,39,833,175600,84001
106,83,23,-,211600,84002
11852,9370,2482,1137,294900,84003
2669,2252,417,1532,456000,84004
6081,5143,938,1396,220100,84005
225,187,38,-,164600,84006
213,168,45,622,197500,84007
15137,10638,4499,906,256300,84010
278,247,31,940,213900,84013
5368,4511,857,1085,252500,84014
19492,14204,5288,938,173900,84015
1454,1166,288,917,284400,84017
25,25,0,-,-,84018
12938,10388,2550,1281,394400,84020
1381,1020,361,881,151000,84021
204,3,201,715,-,84022
69,54,15,338,240900,84023
30,22,8,-,-,84024
6191,5146,1045,1032,314500,84025
380,299,81,830,122600,84026
232,194,38,1513,173100,84027
207,138,69,598,256000,84028
3029,2485,544,805,199500,84029
82,63,19,-,191300,84031
6334,4415,1919,1181,304900,84032
378,311,67,733,238600,84033
71,52,19,-,105000,84034
125,106,19,-,146700,84035
2223,1541,682,998,283900,84036
10079,8929,1150,792,292100,84037
92,81,11,-,295000,84038
299,253,46,938,173300,84039
7256,6169,1087,1259,253200,84040
15526,10111,5415,866,188400,84041
2642,2203,439,1040,334200,84042
14824,11889,2935,1321,264100,84043
8018,6153,1865,1040,150400,84044
5402,4475,927,1427,271800,84045
148,148,0,-,185000,84046
12606,5476,7130,980,203000,84047
1667,1291,376,1150,401500,84049
3054,2585,469,1043,281800,84050
136,122,14,-,258300,84051
444,316,128,850,155300,84052
317,272,45,786,173000,84053
5964,4337,1627,1000,240900,84054
392,295,97,879,273900,84055
904,14,890,1123,-,84056
11325,6552,4773,933,198400,84057
9694,5000,4694,901,219400,84058
3434,2051,1383,1296,879700,84060
183,154,29,-,298200,84061
12603,8812,3791,1078,259600,84062
122,117,5,-,114000,84063
248,186,62,593,136800,84064
10968,9925,1043,1069,304600,84065
3798,2804,994,858,176600,84066
12150,10231,1919,937,157900,84067
167,146,21,825,174100,84069
9325,5804,3521,1015,218700,84070
381,302,79,781,219200,84071
145,133,12,950,181000,84072
59,53,6,-,170500,84073
14654,11631,3023,917,180100,84074
6914,6417,497,1478,255800,84075
111,94,17,-,142300,84076
8952,6522,2430,984,198700,84078
94,80,14,1021,164300,84080
12527,10383,2144,1210,238900,84081
224,217,7,-,328700,84082
515,97,418,515,52500,84083
11667,8525,3142,1104,208800,84084
125,105,20,-,160300,84085
78,64,14,-,123700,84086
4687,4240,447,1371,231800,84087
11090,7946,3144,1055,233200,84088
8969,7983,986,1510,380400,84092
7360,6634,726,1662,339900,84093
9003,7004,1999,1257,237800,84094
18447,14356,4091,1385,347500,84095
10252,8033,2219,1199,295100,84096
6110,4710,1400,875,242500,84097
6864,5284,1580,1511,631400,84098
2505,621,1884,876,221600,84101
8774,2344,6430,803,251900,84102
10152,4859,5293,828,371300,84103
7588,3653,3935,909,145100,84104
9291,5801,3490,870,306200,84105
14043,8462,5581,980,252500,84106
13553,6340,7213,940,216900,84107
7665,5457,2208,869,434100,84108
8502,6506,1996,1108,354000,84109
6006,1406,4600,668,188600,84111
172,5,167,836,-,84112
0,0,0,-,-,84113
10556,4136,6420,769,177000,84115
10693,5866,4827,884,155300,84116
10357,6725,3632,987,308200,84117
19415,15504,3911,1115,175500,84118
16391,9353,7038,931,155200,84119
13189,9541,3648,1001,170300,84120
15385,11437,3948,1102,311800,84121
14084,8270,5814,911,202900,84123
8057,5923,2134,992,349900,84124
6824,5700,1124,1311,183700,84128
144,38,106,1618,300000,84144
0,0,0,-,-,84180
292,270,22,-,168400,84301
8268,5978,2290,694,166700,84302
0,0,0,-,-,84304
224,210,14,1125,159600,84305
127,80,47,-,246900,84306
444,365,79,1056,173500,84307
91,69,22,883,157500,84308
178,140,38,813,193200,84309
1520,1321,199,1353,333300,84310
265,212,53,625,168300,84311
1123,933,190,739,156300,84312
34,16,18,-,-,84313
305,270,35,667,185600,84314
2411,2226,185,1291,274100,84315
97,88,9,775,129200,84316
768,686,82,891,329400,84317
1220,1113,107,1115,233900,84318
2085,1753,332,784,167100,84319
803,667,136,657,171400,84320
14164,7122,7042,646,175300,84321
249,232,17,738,201100,84324
635,602,33,669,273000,84325
505,454,51,617,210100,84326
312,299,13,725,184100,84327
524,480,44,746,237900,84328
29,26,3,-,137500,84329
150,147,3,675,150400,84330
121,95,26,932,143800,84331
2272,1881,391,941,244800,84332
883,735,148,703,189600,84333
147,28,119,565,-,84334
3603,3061,542,866,202300,84335
79,58,21,-,153800,84336
3589,2766,823,672,164600,84337
145,121,24,632,169700,84338
1432,1205,227,668,224900,84339
1130,966,164,679,239900,84340
7195,3422,3773,785,208500,84341
12995,6711,6284,710,172100,84401
12738,8733,4005,746,181900,84403
19505,13856,5649,811,145900,84404
11077,7866,3211,802,177500,84405
8972,7798,1174,987,225400,84414
4667,3297,1370,639,146800,84501
1199,990,209,628,162100,84511
322,257,65,-,86900,84512
539,439,100,559,126000,84513
0,0,0,-,-,84515
62,58,4,-,158300,84516
280,243,37,1050,200800,84518
463,368,95,539,55100,84520
230,188,42,575,130900,84521
118,109,9,-,110600,84522
545,465,80,610,141600,84523
405,293,112,489,142900,84525
1691,1229,462,638,123200,84526
859,709,150,581,137500,84528
131,131,0,-,79000,84529
149,71,78,-,174700,84530
184,168,16,-,72200,84531
3949,2719,1230,675,225500,84532
42,42,0,-,109200,84533
538,450,88,546,62700,84534
931,714,217,725,161700,84535
373,331,42,418,43000,84536
476,387,89,719,129800,84537
135,107,28,679,48000,84539
22,22,0,-,-,84540
662,471,191,615,118300,84542
10520,4885,5635,759,170000,84601
11639,6114,5525,800,286200,84604
10354,2325,8029,748,187600,84606
345,325,20,967,147900,84620
77,69,8,-,-,84621
464,361,103,-,151000,84622
159,112,47,-,282500,84623
1922,1480,442,623,140400,84624
69,69,0,-,166500,84626
1915,950,965,651,187500,84627
294,228,66,1013,107400,84628
826,713,113,886,190100,84629
113,108,5,-,164300,84630
1004,760,244,570,131600,84631
347,293,54,691,148300,84632
354,313,41,492,169600,84633
350,273,77,783,147200,84634
243,218,25,881,115500,84635
153,124,29,713,163300,84636
235,192,43,757,148100,84637
91,69,22,654,171300,84638
271,201,70,724,149600,84639
52,50,2,-,125000,84640
1077,827,250,701,162600,84642
169,136,33,907,160000,84643
716,598,118,-,254300,84645
564,485,79,673,119500,84646
1418,1128,290,630,162700,84647
1828,1465,363,804,164000,84648
303,236,67,592,163700,84649
6859,5579,1280,838,206300,84651
246,223,23,-,133200,84652
2318,1977,341,1092,292500,84653
984,772,212,693,112400,84654
2885,2373,512,962,205200,84655
143,122,21,775,161900,84656
235,179,56,636,140300,84657
10710,8300,2410,997,213600,84660
414,310,104,646,169200,84662
9049,6344,2705,936,211300,84663
2342,2128,214,1277,349200,84664
114,104,10,738,176900,84665
95,91,4,-,150800,84667
2994,2001,993,732,154600,84701
45,41,4,-,204200,84710
223,193,30,845,170800,84711
88,60,28,-,93800,84712
1283,867,416,521,159600,84713
194,151,43,-,73400,84714
161,155,6,-,225000,84715
106,54,52,766,228300,84716
68,63,5,-,118800,84718
35,20,15,642,-,84719
6770,4116,2654,668,192800,84720
6532,4190,2342,716,163200,84721
305,244,61,839,166200,84722
276,235,41,561,134700,84723
417,347,70,564,116300,84724
478,391,87,866,153400,84725
295,245,50,689,156800,84726
17,0,17,-,-,84728
94,84,10,633,207100,84729
83,79,4,-,212900,84730
54,54,0,-,145500,84731
19,19,0,-,-,84732
65,32,33,-,-,84733
61,30,31,525,137500,84734
105,95,10,-,166300,84735
76,73,3,488,123600,84736
5200,3700,1500,1019,186900,84737
2848,2174,674,1192,221000,84738
173,123,50,746,150400,84739
40,38,2,-,146400,84740
2171,1652,519,930,198600,84741
95,80,15,754,-,84742
7,7,0,-,-,84743
84,72,12,538,144400,84744
1243,964,279,991,136800,84745
402,371,31,767,305600,84746
327,261,66,534,157400,84747
104,85,19,-,201600,84749
178,163,15,-,135600,84750
591,448,143,664,121600,84751
333,259,74,938,133200,84752
17,17,0,-,-,84753
1275,1103,172,763,178300,84754
24,24,0,-,-,84755
184,106,78,-,157700,84756
391,259,132,1202,248900,84757
216,165,51,788,127700,84758
640,521,119,797,163800,84759
228,175,53,673,164200,84760
1075,889,186,870,164500,84761
42,42,0,-,-,84762
126,105,21,817,430400,84763
67,27,40,417,-,84764
1856,1567,289,1456,262000,84765
68,62,6,-,228300,84766
208,137,71,768,503000,84767
14149,8276,5873,862,200400,84770
58,58,0,-,238500,84772
116,90,26,-,307500,84773
510,441,69,1100,251800,84774
209,191,18,569,233600,84775
186,154,32,747,191700,84776
171,136,35,713,200000,84779
7850,6010,1840,1114,223900,84780
45,45,0,-,255000,84781
258,243,15,-,207400,84782
225,225,0,-,383300,84783
308,27,281,983,121100,84784
13640,10181,3459,1058,244100,84790
3994,1411,2583,789,307800,85003
2250,599,1651,850,236400,85004
9044,3447,5597,708,150000,85006
5002,1644,3358,734,211100,85007
21245,5433,15812,792,118500,85008
11860,5124,6736,723,66600,85009
3293,1672,1621,917,357300,85012
10045,4440,5605,870,221400,85013
12356,4412,7944,858,196400,85014
14604,5114,9490,727,131000,85015
16305,7300,9005,857,232100,85016
11731,4117,7614,714,83600,85017
16806,9146,7660,842,393100,85018
6941,3445,3496,873,92300,85019
15010,8043,6967,857,204800,85020
15707,6008,9699,741,202800,85021
21056,11168,9888,892,196200,85022
12333,6853,5480,838,173000,85023
9867,6704,3163,1255,210100,85024
14870,8289,6581,1011,141500,85027
8132,6479,1653,1316,319600,85028
17094,8294,8800,826,133000,85029
7636,3658,3978,889,86700,85031
27365,14726,12639,898,177200,85032
15446,6903,8543,914,87800,85033
1500,333,1167,611,112500,85034
14322,4887,9435,914,90400,85035
13775,7426,6349,1098,118700,85037
9530,4005,5525,786,90700,85040
16544,9954,6590,1001,121700,85041
13481,7888,5593,940,138400,85042
9387,5075,4312,1096,123100,85043
16923,9499,7424,1131,246600,85044
2523,2145,378,1856,375100,85045
13086,9164,3922,1294,345200,85048
11332,7858,3474,1439,277500,85050
14544,7498,7046,790,117600,85051
10922,6295,4627,876,153800,85053
3310,1308,2002,1290,385800,85054
6331,5522,809,1822,310900,85083
7875,4745,3130,1170,336400,85085
14221,11073,3148,1581,286800,85086
3144,2743,401,1275,259900,85087
5725,5143,582,1222,247900,85118
9913,7624,2289,770,122400,85119
13055,9406,3649,816,68600,85120
557,237,320,-,51700,85121
18218,12001,6217,870,111200,85122
3909,2483,1426,844,96200,85123
4749,2762,1987,719,87400,85128
3393,2133,1260,608,74900,85131
8082,5977,2105,890,117000,85132
203,129,74,508,32200,85135
914,693,221,850,86300,85137
10993,8384,2609,1284,159100,85138
5559,3838,1721,1130,132800,85139
12624,9615,3009,1155,165800,85140
126,93,33,960,55000,85141
16700,13419,3281,1201,240700,85142
11267,7541,3726,1200,162700,85143
834,666,168,1094,132600,85145
1286,546,740,-,55500,85147
457,163,294,945,238000,85172
1055,713,342,733,75700,85173
531,467,64,544,81600,85192
1341,901,440,691,75600,85193
2916,2291,625,820,169300,85194
19230,6807,12423,825,124100,85201
15748,6758,8990,867,170600,85202
12223,6836,5387,848,188500,85203
21284,11702,9582,880,132300,85204
17336,11882,5454,886,148900,85205
14956,9489,5467,1081,160900,85206
17202,13497,3705,1031,222300,85207
14728,10884,3844,1076,110400,85208
16056,11750,4306,1184,176200,85209
13603,5573,8030,816,143200,85210
8444,6556,1888,1330,238300,85212
12395,8807,3588,985,207500,85213
7040,5738,1302,1269,213500,85215
16787,9030,7757,1145,197100,85224
24570,13229,11341,1010,187400,85225
13986,8188,5798,1176,243300,85226
12698,8572,4126,1127,241600,85233
15727,11208,4519,1159,255300,85234
14799,11668,3131,1314,286400,85248
13048,11046,2002,1713,328100,85249
8660,5953,2707,1189,277000,85250
19298,9294,10004,1057,258100,85251
7243,6152,1091,1313,1177100,85253
18263,12808,5455,1355,382800,85254
16142,12779,3363,1706,600200,85255
1543,1183,360,725,83200,85256
12953,7596,5357,1098,202900,85257
12072,8570,3502,1302,436800,85258
9012,7028,1984,1084,580900,85259
17273,9973,7300,1215,391100,85260
4695,4274,421,2423,675800,85262
1160,1140,20,-,479200,85263
380,293,87,736,174000,85264
4960,4629,331,2239,648600,85266
11529,9276,2253,1186,362200,85268
22058,4529,17529,930,169000,85281
20971,9066,11905,974,176200,85282
18963,8930,10033,1038,206700,85283
6706,5807,899,1722,374500,85284
12900,8508,4392,1367,310700,85286
13147,8468,4679,1293,249400,85295
13094,9915,3179,1431,242700,85296
9035,6345,2690,1529,281400,85297
9003,7930,1073,1803,337600,85298
21664,7617,14047,712,76700,85301
14126,7838,6288,849,139200,85302
9040,5185,3855,971,141200,85303
9522,6567,2955,990,163600,85304
4351,2199,2152,1056,201700,85305
8660,5229,3431,1014,169900,85306
2887,1228,1659,1028,145700,85307
24302,16388,7914,1124,227900,85308
0,0,0,-,-,85309
6628,5546,1082,1457,258300,85310
330,226,104,347,153800,85320
1881,1251,630,713,79400,85321
266,157,109,526,117500,85322
11720,5717,6003,1022,136700,85323
1158,972,186,720,95800,85324
494,467,27,-,108200,85325
15005,9486,5519,1083,150300,85326
204,108,96,1056,95000,85328
11031,9391,1640,1550,396600,85331
649,620,29,1050,140400,85332
214,149,65,580,75500,85333
445,311,134,977,61300,85334
9907,6068,3839,1094,124800,85335
177,113,64,583,-,85336
871,401,470,615,78200,85337
14469,10078,4391,1210,196100,85338
11740,8221,3519,1381,180300,85339
9774,7315,2459,1326,265700,85340
16,0,16,-,-,85341
609,496,113,611,157200,85342
54,21,33,653,-,85343
3883,2643,1240,682,91400,85344
19794,12334,7460,1025,126600,85345
2503,2041,462,454,50100,85346
275,151,124,711,73800,85347
1248,1048,200,474,53800,85348
8248,5915,2333,631,112200,85349
5754,4101,1653,618,114500,85350
17577,14663,2914,980,113400,85351
162,110,52,517,39100,85352
9789,6102,3687,1097,158900,85353
2230,1668,562,798,117500,85354
3248,2714,534,1399,274900,85355
1985,1590,395,648,75600,85356
233,177,56,503,67500,85357
124,45,79,270,58100,85360
2216,1950,266,1135,159000,85361
321,275,46,723,119100,85362
2289,1037,1252,950,120600,85363
26120,14272,11848,805,112900,85364
17987,13177,4810,1055,115500,85365
10041,8256,1785,1103,122000,85367
171,90,81,334,22500,85371
8966,7401,1565,1245,165500,85373
20844,15208,5636,1083,181600,85374
16395,14308,2087,1294,182800,85375
1659,1323,336,1018,602800,85377
13459,9587,3872,1327,196000,85379
8898,5882,3016,1157,214100,85381
15681,10432,5249,1213,219600,85382
13261,11443,1818,1758,337200,85383
4612,3999,613,1142,265700,85387
8206,5872,2334,1315,206200,85388
4087,3043,1044,684,218000,85390
12448,6944,5504,1101,178700,85392
9381,7172,2209,1270,299500,85395
5376,4228,1148,1378,223400,85396
5256,3514,1742,783,97600,85501
466,335,131,336,33600,85530
114,94,20,-,219600,85531
1060,650,410,422,81500,85533
1050,819,231,766,80100,85534
0,0,0,-,-,85535
189,181,8,-,-,85536
1953,1423,530,732,79000,85539
1156,0,1156,410,-,85540
9652,7047,2605,833,196500,85541
720,405,315,396,45000,85542
1268,1011,257,881,124400,85543
925,848,77,-,250000,85544
243,218,25,-,104800,85545
5900,4102,1798,827,125700,85546
1288,717,571,372,42000,85550
113,100,13,-,105000,85551
2197,1390,807,797,143000,85552
805,711,94,443,149800,85553
261,215,46,725,193500,85554
349,250,99,675,77200,85601
4216,3038,1178,715,97100,85602
3334,2272,1062,640,126900,85603
207,122,85,488,64400,85605
614,561,53,521,114200,85606
4576,3062,1514,545,87400,85607
0,0,0,-,-,85608
182,172,10,-,186100,85609
470,392,78,566,102500,85610
369,345,24,-,328700,85611
910,5,905,1218,-,85613
12670,10070,2600,1037,161400,85614
3932,3348,584,1165,180100,85615
2389,1649,740,605,116900,85616
558,420,138,552,129700,85617
602,428,174,582,63300,85618
49,17,32,-,-,85619
234,138,96,539,102100,85620
7087,3730,3357,545,115300,85621
3646,3336,310,1004,215400,85622
1992,1579,413,690,201600,85623
625,448,177,564,238900,85624
942,815,127,754,107900,85625
321,246,75,-,60900,85626
440,352,88,996,127800,85627
8293,6570,1723,1386,164000,85629
1015,940,75,543,175600,85630
1345,1006,339,824,70400,85631
407,342,65,628,180400,85632
22,5,17,1042,-,85633
1554,1058,496,496,63700,85634
14269,7465,6804,858,161100,85635
586,528,58,1057,345300,85637
967,732,235,592,114500,85638
222,133,89,-,537200,85640
8616,7515,1101,1358,216300,85641
3311,2171,1140,559,100700,85643
731,592,139,774,103400,85645
932,690,242,1013,293100,85646
5816,4534,1282,819,122600,85648
6453,5555,898,1208,206600,85650
5441,4262,1179,876,120900,85653
14,14,0,-,-,85654
4547,3752,795,1385,294500,85658
2841,771,2070,748,231100,85701
14074,8045,6029,886,236800,85704
24006,10350,13656,660,72200,85705
16862,9856,7006,734,78000,85706
0,0,0,-,-,85707
1234,20,1214,1200,-,85708
25416,12881,12535,770,146300,85710
16591,7689,8902,701,135400,85711
16252,5640,10612,749,129100,85712
16955,10493,6462,740,83800,85713
5120,2736,2384,618,80700,85714
8049,5437,2612,1001,208200,85715
15617,5842,9775,732,170000,85716
12574,8745,3829,858,447600,85718
17209,4628,12581,795,193100,85719
0,0,0,-,-,85723
0,0,0,-,-,85724
0,0,0,-,-,85726
15657,10185,5472,880,125000,85730
4048,3404,644,797,103900,85735
1687,1410,277,633,90200,85736
8923,6565,2358,1135,276000,85737
8419,7626,793,1019,288200,85739
13584,7632,5952,989,155200,85741
9919,7689,2230,1218,180300,85742
11025,8885,2140,1179,188200,85743
15398,9163,6235,849,193800,85745
14123,9523,4600,886,104300,85746
8259,6307,1952,1349,192900,85747
7334,5505,1829,1095,208800,85748
7721,6308,1413,1157,352400,85749
11175,7695,3480,952,361900,85750
6685,5783,902,1514,294400,85755
10585,7820,2765,1013,98600,85756
5647,4281,1366,995,121100,85757
6541,4506,2035,826,143700,85901
496,281,215,525,43800,85911
111,111,0,-,74200,85912
179,143,36,681,242600,85920
31,31,0,-,268800,85922
127,98,29,-,215000,85923
987,918,69,836,110100,85924
1592,1270,322,777,161500,85925
103,70,33,395,52000,85926
80,58,22,-,414300,85927
495,315,180,855,158300,85928
2892,1940,952,784,156200,85929
261,136,125,624,84200,85930
89,89,0,-,288400,85931
202,156,46,-,262100,85932
1137,855,282,727,163100,85933
167,132,35,-,200000,85934
2017,1585,432,836,236500,85935
1217,920,297,744,89600,85936
2631,2191,440,677,120400,85937
686,469,217,629,124400,85938
1596,1165,431,827,133300,85939
465,426,39,1038,161600,85940
2599,1590,1009,441,55400,85941
68,68,0,-,-,85942
16959,8011,8948,1121,294400,86001
4,4,0,-,-,86003
13668,8474,5194,1101,265600,86004
36,0,36,619,-,86011
128,89,39,-,-,86015
24,24,0,-,70000,86016
408,346,62,987,266000,86017
422,365,57,1273,268100,86018
608,517,91,-,57800,86020
748,195,553,778,183200,86021
714,513,201,575,129900,86022
850,148,702,387,-,86023
276,241,35,1056,271900,86024
1724,1212,512,681,79000,86025
0,0,0,-,-,86028
111,111,0,-,"10,000-",86029
418,379,39,525,90200,86030
550,427,123,500,74700,86031
397,288,109,648,97500,86032
2045,1169,876,548,37300,86033
612,386,226,475,83000,86034
540,425,115,559,71700,86035
167,105,62,-,158800,86036
12,12,0,-,-,86038
376,318,58,530,86300,86039
3229,2281,948,810,136800,86040
513,340,173,850,56200,86042
536,467,69,546,82900,86043
994,828,166,538,67500,86044
3167,2049,1118,627,62800,86045
2499,1783,716,818,169200,86046
4274,2473,1801,563,80500,86047
8,0,8,-,-,86052
579,436,143,558,53900,86053
541,420,121,508,56600,86054
9863,6239,3624,921,224600,86301
8343,5898,2445,819,296500,86303
7904,6192,1712,867,346800,86305
0,0,0,-,-,86313
14485,8226,6259,879,164500,86314
2915,2589,326,1559,256900,86315
877,694,183,611,71600,86320
736,147,589,472,48300,86321
4545,3325,1220,826,157600,86322
6580,5144,1436,801,171500,86323
2031,1401,630,888,186500,86324
2383,2058,325,1218,259200,86325
10135,6120,4015,902,147700,86326
4504,3950,554,1142,186700,86327
363,301,62,-,226500,86329
331,258,73,786,188000,86331
765,624,141,802,108700,86332
2502,1913,589,771,99100,86333
1721,1175,546,863,118500,86334
2249,1541,708,957,139500,86335
5804,4176,1628,1199,418800,86336
512,354,158,544,115100,86337
228,183,45,1034,319800,86338
53,46,7,-,170000,86343
3195,2207,988,1139,399300,86351
9521,6531,2990,823,120000,86401
7212,4013,3199,788,176200,86403
7346,5106,2240,880,191300,86404
10111,7436,2675,916,230100,86406
10932,7451,3481,745,79900,86409
130,120,10,-,165400,86411
4680,3904,776,720,77600,86413
5603,4098,1505,961,139300,86426
3678,1834,1844,737,195100,86429
207,194,13,-,45800,86431
1272,988,284,747,87600,86432
65,16,49,-,-,86433
408,218,190,396,103700,86434
10,7,3,-,-,86435
787,594,193,432,85600,86436
34,24,10,933,55000,86437
461,382,79,574,-,86438
2873,1997,876,638,113100,86440
1084,804,280,377,63500,86441
14014,8229,5785,749,93800,86442
0,0,0,-,-,86443
523,413,110,665,63500,86444
135,127,8,-,90200,86445
332,307,25,425,71600,86502
2940,1960,980,424,49600,86503
1661,1087,574,566,53200,86504
2054,1657,397,457,50300,86505
349,301,48,558,55900,86506
528,468,60,541,61200,86507
195,187,8,-,76800,86508
1388,1165,223,448,74200,86510
912,870,42,428,71800,86511
624,438,186,542,82700,86512
723,589,134,589,81800,86514
1214,705,509,427,54200,86515
506,437,69,569,55900,86520
296,282,14,-,58900,86535
612,415,197,413,56300,86538
275,237,38,475,79800,86540
287,247,40,658,80600,86544
321,282,39,433,64000,86545
270,252,18,289,61200,86547
381,227,154,291,49800,86556
848,781,67,544,123700,87001
7924,5896,2028,780,125100,87002
3777,2918,859,740,142900,87004
254,213,41,-,81800,87005
262,239,23,-,176100,87006
284,273,11,-,81600,87007
1191,1075,116,1333,239100,87008
575,468,107,881,250000,87010
21,21,0,-,-,87011
89,74,15,-,175000,87012
1428,1130,298,558,62600,87013
207,172,35,-,157500,87014
4759,4306,453,876,187600,87015
1080,897,183,586,119000,87016
127,107,20,475,161200,87017
153,118,35,322,25000,87018
4048,2500,1548,555,100400,87020
1000,684,316,643,92700,87021
356,294,62,425,80800,87022
230,201,29,-,112500,87023
555,495,60,492,110400,87024
567,520,47,691,253100,87025
1120,883,237,391,71800,87026
131,98,33,-,116700,87027
74,74,0,-,72400,87028
123,123,0,-,-,87029
15058,11980,3078,792,132600,87031
72,40,32,-,-,87032
506,448,58,570,70300,87034
2469,1925,544,776,103000,87035
759,669,90,675,114600,87036
183,153,30,-,52300,87037
175,121,54,-,42100,87038
151,151,0,-,81300,87040
284,235,49,676,115000,87041
1394,1184,210,702,188900,87042
2463,2248,215,992,318800,87043
140,140,0,-,-,87044
413,375,38,-,45700,87045
33,30,3,-,250000,87046
1724,1560,164,1206,286800,87047
3734,3376,358,867,419000,87048
348,309,39,668,29600,87049
423,403,20,-,107000,87051
589,494,95,663,69700,87052
316,271,45,763,93200,87053
411,369,42,-,281900,87056
3714,3409,305,1123,254500,87059
104,104,0,-,67800,87061
347,291,56,622,94200,87062
75,54,21,588,53600,87063
54,36,18,-,225000,87064
1880,1664,216,921,160600,87068
32,12,20,-,-,87070
179,159,20,525,92100,87072
305,278,27,994,155700,87083
8959,3227,5732,671,133800,87102
5401,3200,2201,741,223900,87104
19577,13978,5599,710,133900,87105
11341,4423,6918,693,231700,87106
13091,8302,4789,701,211200,87107
16846,5326,11520,626,155500,87108
17625,9192,8433,808,205900,87109
16883,11086,5797,816,179700,87110
24895,15787,9108,985,249300,87111
18251,10875,7376,770,174000,87112
5763,4302,1461,1129,240900,87113
24178,16208,7970,1036,204300,87114
1225,0,1225,1312,-,87116
0,0,0,-,-,87117
23134,16735,6399,1023,190000,87120
22945,16833,6112,934,125000,87121
6887,6129,758,1302,451400,87122
17341,10809,6532,790,170600,87123
19939,15878,4061,993,168400,87124
13509,10777,2732,1256,178500,87144
7084,4203,2881,701,128000,87301
942,845,97,582,44400,87305
267,248,19,567,55300,87310
941,783,158,625,32700,87311
160,143,17,-,30400,87312
1493,974,519,552,61900,87313
67,38,29,-,162500,87315
374,211,163,750,29800,87316
352,317,35,-,36300,87317
492,453,39,-,53400,87319
181,169,12,-,50600,87320
683,565,118,381,107500,87321
37,35,2,-,-,87322
1192,880,312,639,55400,87323
825,676,149,543,53800,87325
438,390,48,592,52400,87326
1937,1580,357,553,72000,87327
682,327,355,399,60600,87328
74,56,18,-,166400,87347
233,130,103,539,45000,87357
301,257,44,450,46500,87364
761,705,56,425,49900,87375
15134,9881,5253,774,158800,87401
3640,2970,670,995,217400,87402
6443,5011,1432,771,149200,87410
311,270,41,580,101400,87412
5254,3922,1332,736,135100,87413
653,605,48,852,168200,87415
1372,1102,270,824,71700,87416
1779,1264,515,788,106100,87417
388,307,81,592,196000,87418
122,99,23,-,-,87419
3088,1986,1102,500,81200,87420
506,386,120,1036,120800,87421
544,426,118,569,51900,87455
426,381,45,1036,55300,87461
137,130,7,-,47500,87499
8334,5174,3160,1043,386100,87501
14101,8657,5444,974,310800,87505
5725,4653,1072,883,386400,87506
17297,11460,5837,914,206500,87507
7704,6308,1396,1255,362500,87508
313,214,99,-,125000,87510
729,544,185,538,150800,87511
38,38,0,-,-,87512
359,282,77,880,341100,87513
305,302,3,-,-,87514
135,135,0,-,123800,87515
36,36,0,-,161400,87516
118,105,13,-,162500,87517
40,26,14,-,116700,87518
144,59,85,-,-,87519
385,260,125,681,158700,87520
568,534,34,613,130600,87521
824,583,241,565,76300,87522
146,128,18,-,338500,87523
38,12,26,-,-,87524
37,14,23,-,531300,87525
306,275,31,-,107300,87527
947,638,309,481,77900,87528
1849,1312,537,904,231200,87529
345,306,39,-,155000,87530
214,139,75,539,-,87531
6666,4541,2125,709,174000,87532
58,40,18,533,16100,87533
448,371,77,-,184100,87535
983,725,258,497,147900,87537
277,277,0,-,165400,87538
59,59,0,-,-,87539
479,391,88,1005,409500,87540
72,72,0,-,54800,87543
7586,5510,2076,951,274200,87544
289,243,46,-,138100,87548
409,354,55,-,172300,87549
178,169,9,-,262900,87551
1437,1021,416,768,166500,87552
459,357,102,617,124700,87553
0,0,0,-,-,87554
1097,822,275,609,122700,87556
2494,2061,433,858,235500,87557
204,108,96,636,297500,87558
597,379,218,-,85900,87560
190,170,20,-,159700,87562
171,171,0,-,338200,87564
195,148,47,-,59000,87565
900,815,85,579,155300,87566
682,452,230,669,151600,87567
169,150,19,-,195000,87569
4646,3033,1613,663,233200,87571
42,42,0,-,-,87573
101,87,14,-,-,87574
368,344,24,-,322900,87575
129,129,0,-,122000,87577
217,207,10,-,279900,87578
236,160,76,800,160200,87579
277,172,105,-,-,87580
0,0,0,-,-,87581
288,212,76,-,173200,87582
53,53,0,-,63600,87583
6909,4580,2329,601,120400,87701
638,448,190,740,370600,87710
170,132,38,-,44700,87711
97,40,57,-,-,87712
70,70,0,-,-,87713
443,353,90,714,87800,87714
263,194,69,-,-,87715
181,134,47,1071,254300,87718
155,155,0,-,113100,87722
106,77,29,-,-,87723
0,0,0,-,-,87724
148,101,47,475,69000,87728
48,46,2,-,-,87729
7,4,3,-,-,87730
109,109,0,-,"10,000-",87731
400,303,97,688,72600,87732
48,41,7,-,-,87733
86,74,12,-,-,87734
43,30,13,-,-,87735
88,88,0,-,123700,87736
3226,2074,1152,582,89700,87740
217,191,26,-,257000,87742
115,86,29,519,64000,87743
238,216,22,-,194700,87745
54,42,12,-,60500,87746
563,433,130,368,110000,87747
120,87,33,-,164900,87749
0,0,0,-,-,87750
190,121,69,479,57500,87752
34,6,28,-,-,87753
3030,1847,1183,595,122800,87801
41,41,0,-,-,87820
388,388,0,-,155300,87821
274,258,16,-,171400,87823
109,109,0,-,320200,87824
503,420,83,-,120500,87825
103,103,0,-,284100,87827
161,161,0,-,-,87828
251,228,23,-,155700,87829
432,358,74,663,116900,87830
53,53,0,-,90200,87831
191,182,9,-,103800,87832
3260,2124,1136,525,78300,87901
273,238,35,-,77000,87930
271,230,41,-,149600,87931
0,0,0,-,-,87933
819,682,137,697,126000,87935
159,109,50,-,83400,87936
921,565,356,465,63900,87937
32,32,0,-,360000,87939
225,182,43,-,-,87940
245,216,29,-,78600,87941
447,346,101,790,135900,87942
95,95,0,-,-,87943
13729,5890,7839,642,103600,88001
337,18,319,1074,-,88002
0,0,0,-,-,88003
0,0,0,-,-,88004
10781,7099,3682,691,151500,88005
8446,6390,2056,681,162300,88007
2156,1241,915,794,167600,88008
23,0,23,-,-,88009
12603,6961,5642,890,238400,88011
9596,7168,2428,1010,137700,88012
313,252,61,1065,82000,88020
5580,4022,1558,518,88300,88021
480,434,46,713,106800,88022
999,694,305,627,85800,88023
108,90,18,-,-,88024
167,98,69,457,-,88025
567,434,133,663,82100,88026
169,161,8,-,89400,88027
156,148,8,-,197800,88028
503,344,159,484,57300,88029
8225,5323,2902,586,88200,88030
134,89,45,-,90900,88032
0,0,0,-,-,88033
42,42,0,-,-,88034
111,111,0,-,118800,88038
97,97,0,-,149200,88039
51,48,3,-,75000,88040
511,430,81,823,110600,88041
114,114,0,-,-,88042
639,549,90,696,81600,88043
1318,902,416,598,106300,88044
1310,868,442,493,74400,88045
368,237,131,639,223000,88046
847,625,222,538,148700,88047
1048,921,127,789,82900,88048
208,208,0,-,-,88049
31,25,6,-,162500,88051
83,66,17,-,-,88052
74,9,65,607,-,88053
7,7,0,-,-,88055
108,89,19,-,113300,88056
7640,5489,2151,672,166700,88061
3413,2239,1174,579,88700,88063
265,165,100,927,133400,88065
471,418,53,-,68800,88072
4090,3195,895,777,67900,88081
17166,9905,7261,820,128800,88101
0,0,0,-,-,88103
57,43,14,663,179200,88112
15,11,4,-,95000,88113
7,3,4,-,-,88114
30,24,6,-,-,88115
166,138,28,488,119600,88116
109,64,45,440,143300,88118
540,411,129,579,69100,88119
76,54,22,638,-,88120
37,28,9,425,73300,88121
468,386,82,754,93400,88124
23,9,14,-,-,88125
24,24,0,-,54700,88126
6648,3987,2661,729,115600,88130
77,47,30,1094,168800,88132
7,7,0,-,-,88134
567,422,145,680,89300,88135
16,12,4,-,-,88136
10000,6992,3008,763,136500,88201
10696,6577,4119,677,86300,88203
6788,4782,2006,688,153800,88210
13044,9430,3614,808,127900,88220
1523,1105,418,732,88100,88230
1114,870,244,721,91800,88231
652,531,121,495,84100,88232
12190,7897,4293,827,114700,88240
2296,1934,362,1001,163300,88242
96,28,68,-,-,88250
753,542,211,697,68500,88252
324,223,101,-,87700,88253
29,29,0,-,-,88254
49,10,39,-,-,88255
774,582,192,856,107200,88256
4639,3171,1468,709,103100,88260
4,4,0,-,-,88262
48,39,9,-,216100,88263
9,0,9,-,-,88264
52,30,22,-,107100,88265
478,360,118,580,58900,88267
59,30,29,-,-,88268
582,488,94,617,88000,88301
14091,8717,5374,782,118000,88310
500,372,128,673,62900,88311
1201,997,204,790,331500,88312
52,31,21,-,-,88314
911,755,156,743,167200,88316
689,547,142,839,163400,88317
130,116,14,-,129200,88318
52,34,18,-,60000,88321
0,0,0,-,-,88323
92,66,26,-,227100,88324
328,271,57,596,207600,88325
1082,7,1075,1142,-,88330
124,75,49,-,160900,88336
1006,886,120,584,119700,88337
97,97,0,-,162300,88338
233,186,47,-,141700,88339
894,510,384,327,52700,88340
200,200,0,-,244100,88341
56,48,8,-,-,88342
12,6,6,-,-,88343
12,12,0,-,-,88344
3391,2699,692,831,165900,88345
1115,703,412,533,118800,88346
70,33,37,-,-,88347
105,75,30,-,-,88348
12,12,0,-,-,88349
259,259,0,-,79700,88350
75,67,8,-,-,88351
1880,1480,400,732,85000,88352
125,61,64,840,45600,88353
31,16,15,-,-,88354
0,0,0,-,-,88355
2418,1574,844,478,69600,88401
25,11,14,-,-,88410
28,21,7,-,95000,88411
17,11,6,-,-,88414
1181,698,483,645,81800,88415
15,15,0,-,-,88416
13,13,0,-,-,88417
98,67,31,-,-,88418
93,76,17,631,185000,88419
33,33,0,-,-,88421
51,51,0,-,210200,88422
36,31,5,-,"2,000,000+",88424
454,396,58,639,90200,88426
46,36,10,-,-,88427
53,49,4,-,63000,88430
9,9,0,-,-,88431
130,100,30,608,74300,88434
912,644,268,429,93600,88435
62,22,40,-,157800,88436
379,288,91,905,113900,89001
11431,8084,3347,1254,210800,89002
347,189,158,545,59500,89003
144,133,11,-,375000,89004
6256,4229,2027,938,223200,89005
349,243,106,1217,139700,89007
464,287,177,800,135200,89008
203,116,87,-,118800,89010
8290,4885,3405,1110,193500,89011
12918,7999,4919,1199,258800,89012
175,122,53,492,66300,89013
15514,6685,8829,990,196900,89014
14782,8760,6022,945,162200,89015
53,53,0,-,-,89017
379,249,130,781,84200,89018
837,519,318,604,104200,89019
387,168,219,633,87200,89020
929,767,162,1089,214700,89021
31,31,0,-,38600,89022
387,308,79,639,122500,89025
0,0,0,-,-,89026
7379,4945,2434,805,193200,89027
4011,1673,2338,683,140600,89029
13122,4736,8386,789,79800,89030
19905,12825,7080,1326,161300,89031
13404,7424,5980,1127,146400,89032
102,97,5,-,75000,89039
1247,940,307,875,141900,89040
514,269,245,581,-,89042
425,356,69,-,171700,89043
8081,6645,1436,1578,284500,89044
700,535,165,823,75300,89045
206,121,85,803,93000,89046
52,16,36,448,46200,89047
8524,5945,2579,797,117300,89048
1207,531,676,558,85900,89049
20307,13427,6880,1387,337700,89052
25,25,0,-,89400,89054
3772,2699,1073,784,104800,89060
2245,1763,482,1081,150000,89061
18994,11289,7705,1230,218900,89074
10035,5332,4703,1231,170200,89081
8768,5628,3140,1272,225100,89084
1236,1004,232,1852,244200,89085
1926,561,1365,1002,217400,89086
13827,2765,11062,661,82200,89101
14020,3378,10642,774,160000,89102
21336,7116,14220,870,110300,89103
14021,6159,7862,771,111800,89104
8680,2702,5978,801,108600,89106
12426,6341,6085,875,116500,89107
25670,11484,14186,948,125200,89108
3929,1212,2717,896,300000,89109
20877,11326,9551,923,126700,89110
10311,5241,5070,1109,220300,89113
17427,5764,11663,848,87100,89115
22419,10333,12086,1071,258100,89117
8130,3109,5021,996,183700,89118
20273,3898,16375,792,139800,89119
9147,4857,4290,938,164900,89120
23737,11059,12678,863,122300,89121
17575,9780,7795,951,116000,89122
22715,12472,10243,1167,207600,89123
303,251,52,971,368300,89124
14458,7151,7307,1008,188000,89128
19825,12927,6898,1187,211200,89129
12563,8843,3720,1290,192500,89130
15725,11965,3760,1359,257600,89131
11679,9254,2425,1450,245900,89134
10750,7014,3736,1547,354800,89135
5007,3363,1644,1721,364900,89138
11793,6566,5227,1391,224400,89139
9627,6429,3198,1504,255100,89141
10575,5744,4831,1039,130700,89142
4094,2962,1132,1396,210600,89143
7132,4578,2554,1406,276800,89144
9442,5616,3826,1187,154400,89145
6411,2743,3668,905,223300,89146
18889,9715,9174,1153,184200,89147
16174,7445,8729,1262,232600,89148
13091,8245,4846,1173,242500,89149
9055,4942,4113,893,118300,89156
44,44,0,-,-,89161
5094,2830,2264,1158,231600,89166
8990,1557,7433,763,131400,89169
11679,7733,3946,1356,237500,89178
1694,1400,294,1411,231800,89179
13897,6483,7414,1180,192500,89183
0,0,0,-,-,89191
2439,1769,670,693,140200,89301
255,227,28,-,174400,89310
48,38,10,-,-,89311
170,82,88,369,70000,89314
535,337,198,664,118200,89316
87,87,0,-,137500,89317
457,349,108,755,85000,89318
122,61,61,998,-,89319
7,7,0,-,-,89402
5512,3923,1589,950,163900,89403
23,23,0,-,-,89404
10,0,10,-,-,89405
9476,5744,3732,826,158100,89406
6914,4513,2401,1019,149800,89408
83,83,0,-,-,89409
4478,2939,1539,960,274800,89410
387,338,49,1031,656700,89411
132,132,0,-,-,89412
252,186,66,2364,1425700,89413
145,89,56,894,85800,89414
1587,1061,526,526,90100,89415
115,52,63,-,-,89418
1524,1006,518,548,107000,89419
13,0,13,-,-,89420
193,135,58,478,71200,89421
37,37,0,-,63500,89422
4390,3475,915,1208,331100,89423
112,82,30,325,81700,89424
215,187,28,-,-,89425
147,121,26,-,-,89426
406,247,159,345,57500,89427
76,64,12,-,217600,89428
2811,2143,668,855,90400,89429
199,153,46,-,333800,89430
14094,6197,7897,782,144400,89431
6597,4488,2109,978,113700,89433
10238,6291,3947,1073,193200,89434
14626,10528,4098,1386,258000,89436
43,43,0,-,"10,000-",89438
648,452,196,1159,244800,89439
505,340,165,759,256600,89440
4187,3417,770,1424,295600,89441
426,302,124,714,102700,89442
1189,996,193,959,180300,89444
5789,4337,1452,791,165000,89445
17,17,0,-,-,89446
3324,2059,1265,633,113100,89447
691,483,208,1218,654400,89448
1496,764,732,1101,419800,89449
82,41,41,-,-,89450
3696,2667,1029,1351,737400,89451
5330,3527,1803,959,241800,89460
2429,490,1939,620,268900,89501
17682,6097,11585,736,158700,89502
11160,4911,6249,812,200900,89503
13092,8736,4356,1082,167200,89506
4224,3580,644,1314,186600,89508
15977,8128,7849,843,327500,89509
618,560,58,518,322600,89510
10609,7438,3171,1023,474400,89511
9403,3166,6237,715,112900,89512
3581,2776,805,1408,407000,89519
10937,7593,3344,1496,290800,89521
13689,7384,6305,1092,288300,89523
9751,5310,4441,782,179800,89701
0,0,0,-,-,89702
4404,3122,1282,874,313000,89703
1793,1568,225,1122,316900,89704
2138,1457,681,1156,209200,89705
8269,4117,4152,862,137500,89706
8461,5796,2665,971,208700,89801
4913,4256,657,1330,216300,89815
1895,1503,392,622,121100,89820
232,199,33,-,88500,89821
742,541,201,1051,102300,89822
76,65,11,-,631400,89823
584,192,392,561,11900,89825
25,0,25,-,-,89826
191,191,0,-,236200,89828
91,23,68,-,-,89830
15,15,0,-,-,89831
504,277,227,420,79800,89832
51,14,37,268,-,89833
37,9,28,-,-,89834
718,415,303,717,138300,89835
1298,648,650,702,128400,89883
13594,4640,8954,1009,272200,90001
12543,4611,7932,1035,248200,90002
16496,4724,11772,1099,268500,90003
22431,3779,18652,1125,838000,90004
16086,1282,14804,988,672600,90005
19474,1579,17895,984,469200,90006
11672,1328,10344,1079,421200,90007
14590,4866,9724,1044,507900,90008
2041,418,1623,1656,759400,90010
23258,6035,17223,1011,294800,90011
11344,1316,10028,1208,432700,90012
6786,674,6112,770,476700,90013
4871,272,4599,789,403100,90014
8043,1129,6914,961,560300,90015
17213,6260,10953,1132,394100,90016
10288,393,9895,897,511300,90017
16290,4880,11410,1017,407600,90018
24599,6612,17987,1189,694200,90019
16649,1576,15073,1164,566500,90020
1728,78,1650,456,556500,90021
17436,5691,11745,1000,326400,90022
11239,3131,8108,1009,324900,90023
17206,5042,12164,1976,1091100,90024
22097,5600,16497,1724,729100,90025
25299,5681,19618,1162,647200,90026
21996,4168,17828,1259,884800,90027
16201,781,15420,1181,654200,90028
14187,1317,12870,1056,584100,90029
11651,3716,7935,1024,396000,90031
13409,6439,6970,1093,382000,90032
13170,2181,10989,934,327800,90033
25918,4915,21003,1472,715000,90034
13140,4172,8968,1749,927800,90035
18527,2900,15627,1942,1039300,90036
16798,4008,12790,1003,300100,90037
11458,982,10476,1103,600300,90038
11476,5001,6475,1440,681900,90039
3563,1502,2061,1029,346000,90040
9434,5015,4419,1295,611400,90041
20299,9003,11296,1186,451100,90042
16825,8566,8259,1043,394300,90043
27063,7915,19148,988,300300,90044
15561,8156,7405,1741,774000,90045
29071,6286,22785,1464,929600,90046
16852,9175,7677,1114,322300,90047
11984,3508,8476,1854,1068100,90048
16367,8531,7836,1991,1735800,90049
3336,2298,1038,1537,839800,90056
16484,599,15885,910,363700,90057
802,51,751,547,313600,90058
10371,4653,5718,902,261000,90059
7238,2899,4339,1097,283600,90061
9550,3850,5700,1053,315000,90062
13590,5064,8526,1037,322600,90063
10947,6021,4926,1778,974000,90064
14993,7171,7822,1144,563200,90065
24745,9427,15318,1501,834900,90066
1457,1118,339,2372,1077900,90067
11785,5576,6209,1560,1053900,90068
12548,4655,7893,1631,738100,90069
0,0,0,-,-,90071
0,0,0,-,-,90073
3381,2818,563,2418,1657700,90077
0,0,0,-,-,90079
6,0,6,-,-,90089
0,0,0,-,-,90090
3528,1535,1993,2624,754000,90094
0,0,0,-,-,90095
23937,5318,18619,1112,317900,90201
8138,5557,2581,2274,"2,000,000+",90210
3652,1162,2490,1762,1190000,90211
5784,1855,3929,2009,1578800,90212
13376,8177,5199,1131,248100,90220
12066,5993,6073,1087,275400,90221
7776,3678,4098,1114,258600,90222
13186,7001,6185,1553,603900,90230
6416,2527,3889,1546,789400,90232
7118,4773,2345,1444,487800,90240
13615,5569,8046,1219,465400,90241
12062,5836,6226,1294,412600,90242
6673,2929,3744,1638,828300,90245
15922,6517,9405,1150,367100,90247
3479,2526,953,1180,379600,90248
8780,5349,3431,1086,386600,90249
31864,9737,22127,1084,432600,90250
9197,4348,4849,1963,1166800,90254
18669,5818,12851,966,324900,90255
10551,4174,6377,1350,429900,90260
15296,6442,8854,1057,311800,90262
0,0,0,-,-,90263
7346,5288,2058,2736,1641200,90265
13808,9452,4356,2232,1537200,90266
6517,1651,4866,981,325600,90270
9103,7162,1941,2530,1841000,90272
9268,8173,1095,2627,1385800,90274
15823,12643,3180,2348,1004800,90275
16011,7148,8863,1850,898500,90277
15662,8757,6905,1721,721800,90278
23465,10491,12974,1012,329000,90280
2250,1828,422,1884,913000,90290
13826,4606,9220,1780,1165900,90291
12179,3240,8939,2463,810000,90292
6655,3118,3537,1834,664100,90293
12068,2918,9150,1106,306700,90301
10894,3014,7880,1151,353100,90302
7297,2721,4576,1135,362100,90303
6549,1972,4577,1021,342500,90304
5793,3805,1988,1296,385500,90305
4689,335,4354,1672,919000,90401
5029,3294,1735,1875,"2,000,000+",90402
13598,3064,10534,1745,972800,90403
9726,2183,7543,1449,723100,90404
14365,4705,9660,1589,1078800,90405
14391,6499,7892,1239,549900,90501
5762,3823,1939,1407,375800,90502
16954,8619,8335,1564,664800,90503
11491,6874,4617,1359,554500,90504
14253,7986,6267,1594,764000,90505
0,0,0,-,-,90506
11187,6726,4461,1256,451100,90601
7949,3149,4800,1110,453200,90602
6456,5094,1362,1758,477800,90603
12015,7723,4292,1287,414800,90604
10572,7299,3273,1358,394000,90605
8741,5687,3054,1273,361900,90606
12922,8938,3984,1655,444300,90620
10096,4050,6046,1351,467400,90621
5010,3415,1595,1503,602600,90623
15995,10646,5349,1670,539700,90630
21388,12507,8881,1358,475600,90631
14665,11255,3410,1639,448500,90638
19810,8912,10898,1158,414000,90640
27286,17179,10107,1384,350600,90650
16776,11223,5553,1229,351300,90660
4826,3075,1751,1295,371200,90670
9019,4649,4370,1310,331200,90680
4674,2412,2262,1396,420600,90701
15451,12122,3329,2176,619300,90703
1382,260,1122,1391,680300,90704
23238,9014,14224,1195,367300,90706
9076,4977,4099,1101,423400,90710
10522,7731,2791,1544,446900,90712
9230,7516,1714,1848,466300,90713
5939,3358,2581,1443,384200,90715
3786,1391,2395,1160,293100,90716
8459,3739,4720,1258,523900,90717
7894,5194,2700,1691,816500,90720
14017,5443,8574,1204,283400,90723
22279,6887,15392,1167,467500,90731
8567,5770,2797,1776,536000,90732
12276,9210,3066,1670,304800,90740
334,149,185,2177,1165300,90742
167,85,82,1968,-,90743
14385,5749,8636,1032,333900,90744
15095,10413,4682,1387,350800,90745
8118,7010,1108,1581,399000,90746
0,0,0,-,-,90747
4102,1844,2258,1217,444000,90755
20610,4258,16352,1092,320400,90802
16785,7144,9641,1418,747900,90803
14626,3073,11553,1157,420900,90804
26343,11207,15136,1081,324100,90805
12509,4201,8308,1072,381400,90806
12589,6651,5938,1226,533100,90807
13920,10740,3180,1560,562600,90808
9132,5049,4083,1085,338400,90810
16683,2152,14531,972,322700,90813
9042,2969,6073,1238,599500,90814
14343,9606,4737,1640,552800,90815
0,0,0,-,-,90822
0,0,0,-,-,90831
12739,9625,3114,1500,615800,91001
10403,7142,3261,1609,838300,91006
11647,6316,5331,1405,878300,91007
448,293,155,2300,1448900,91008
7742,4798,2944,1415,375500,91010
6682,5958,724,2000,1210500,91011
14699,7210,7489,1314,558600,91016
3345,1003,2342,1414,570700,91020
4403,2682,1721,1469,861200,91024
10150,4476,5674,1464,876900,91030
7236,5031,2205,1201,458600,91040
10008,5112,4896,1211,456300,91042
111,0,111,1061,-,91046
10745,1855,8890,1419,452300,91101
8381,3871,4510,1256,598900,91103
13081,6665,6416,1230,622000,91104
5485,3044,2441,2106,911900,91105
10540,3794,6746,1485,601600,91106
12502,7656,4846,1438,711400,91107
4778,4149,629,"3,500+",1489700,91108
8247,2567,5680,1335,639800,91201
8768,3360,5408,1531,656100,91202
4950,1156,3794,1359,428600,91203
6002,670,5332,1237,435500,91204
14266,2148,12118,1253,467900,91205
13005,4504,8501,1365,650900,91206
3954,2306,1648,1529,858000,91207
5876,4025,1851,1633,759700,91208
324,59,265,2995,578700,91210
10371,7797,2574,1662,640300,91214
9183,7045,2138,2025,706400,91301
9331,6723,2608,2176,1073500,91302
9636,2388,7248,1287,366600,91303
16992,8578,8414,1289,492300,91304
14501,8398,6103,1212,416600,91306
8674,7287,1387,2576,578600,91307
13869,9342,4527,1567,489100,91311
12299,6180,6119,1459,607200,91316
15099,11636,3463,2069,619100,91320
11118,6007,5111,1399,380300,91321
9835,5126,4709,1535,497700,91324
11768,5380,6388,1356,555100,91325
12285,8574,3711,1820,648400,91326
0,0,0,-,-,91330
22579,13435,9144,1315,329800,91331
23927,11717,12210,1249,389200,91335
8287,4691,3596,1217,338400,91340
24457,16251,8206,1389,365200,91342
17414,9173,8241,1183,427600,91343
16907,12543,4364,1621,506900,91344
5171,3741,1430,1430,360000,91345
11413,9372,2041,1749,432300,91350
10157,6888,3269,1510,339000,91351
12242,6453,5789,1232,381300,91352
9838,7583,2255,2153,494800,91354
12530,7400,5130,1786,458400,91355
11493,6410,5083,1363,781700,91356
15029,9913,5116,1797,597800,91360
8570,6572,1998,2007,832600,91361
13481,9612,3869,1882,704000,91362
10415,7107,3308,1964,699400,91364
17426,9083,8343,1841,593900,91367
0,0,0,-,-,91371
5407,3740,1667,2073,688300,91377
6744,4454,2290,1848,616900,91381
7073,5750,1323,1266,420000,91384
13757,8661,5096,1698,414100,91387
6475,5852,623,1785,508100,91390
14835,4995,9840,1212,568100,91401
18950,6446,12504,1128,317100,91402
11355,5214,6141,1591,804900,91403
17213,4268,12945,1110,387100,91405
18094,7280,10814,1193,424100,91406
9607,2621,6986,1197,524500,91411
15246,5999,9247,1614,803400,91423
5492,4460,1032,2189,1062800,91436
7598,2420,5178,1468,651900,91501
5334,495,4839,1281,395600,91502
9497,4964,4533,1399,607500,91504
13051,5958,7093,1627,594400,91505
7275,4068,3207,1324,609100,91506
16972,3224,13748,1289,498500,91601
9485,3311,6174,1499,665700,91602
14334,6551,7783,1724,918600,91604
15932,6093,9839,1157,385100,91605
15328,4491,10837,1159,426200,91606
13678,4022,9656,1340,656300,91607
0,0,0,-,-,91608
13203,10329,2874,1455,424300,91701
15056,8683,6373,1295,339700,91702
17921,10257,7664,1278,333900,91706
326,240,86,2422,391400,91708
24034,18628,5406,1916,537800,91709
21430,13949,7481,1415,370300,91710
11955,7913,4042,1427,579800,91711
10036,6926,3110,1371,367700,91722
6079,2489,3590,1262,406500,91723
8057,5666,2391,1428,453600,91724
23234,10426,12808,1511,326200,91730
8345,3023,5322,1034,383800,91731
16134,6806,9328,1171,374400,91732
11216,4594,6622,1130,363600,91733
8201,5737,2464,1650,522100,91737
11533,7954,3579,1708,500100,91739
8337,5623,2714,1383,413700,91740
8753,6314,2439,1612,594700,91741
18454,12305,6149,1243,338600,91744
16003,12168,3835,1713,517900,91745
6704,4866,1838,1317,350300,91746
13505,8600,4905,1430,530200,91748
11818,8612,3206,1408,507000,91750
8129,4990,3139,1227,359000,91752
10828,5945,4883,1211,539600,91754
8761,4286,4475,1279,523700,91755
217,137,80,1500,376700,91759
16392,10526,5866,1348,310400,91761
16967,8308,8659,1198,292700,91762
10365,5919,4446,1173,281500,91763
15566,7129,8437,1336,274900,91764
15008,11396,3612,1841,596700,91765
17809,9392,8417,1214,314600,91766
13957,7287,6670,1168,314000,91767
8140,4146,3994,1118,287600,91768
17107,8608,8499,1210,447900,91770
11831,8521,3310,1595,481100,91773
8164,5547,2617,1361,683600,91775
11593,4633,6960,1283,548900,91776
11305,7086,4219,1290,627200,91780
9158,7797,1361,2170,550000,91784
19186,7998,11188,1222,368300,91786
13126,10815,2311,1996,654700,91789
12398,8512,3886,1380,414100,91790
10023,6810,3213,1394,487600,91791
8670,4783,3887,1539,398800,91792
19536,7159,12377,1248,501400,91801
9566,4577,4989,1203,539400,91803
6516,4855,1661,1290,486800,91901
6001,4398,1603,1711,576500,91902
537,345,192,641,277400,91905
1236,853,383,864,182600,91906
25272,11793,13479,1225,395700,91910
24309,12096,12213,1266,333200,91911
14051,9908,4143,1857,430200,91913
4582,3970,612,2250,537400,91914
7993,5976,2017,2136,432700,91915
587,545,42,826,306300,91916
213,197,16,-,196800,91917
132,105,27,-,-,91931
9044,2784,6260,1255,380900,91932
187,129,58,-,125700,91934
2718,2348,370,-,539300,91935
12004,7387,4617,1316,537000,91941
16700,6444,10256,1338,392400,91942
8538,4637,3901,1197,346400,91945
13,13,0,-,-,91948
16204,5406,10798,1024,317300,91950
751,591,160,1114,366400,91962
321,272,49,1170,170800,91963
18648,10820,7828,1241,342900,91977
3168,2054,1114,1636,392200,91978
78,59,19,-,-,91980
1811,1294,517,1441,504200,92003
1230,829,401,975,164200,92004
4461,2579,1882,1885,877700,92007
11263,5008,6255,1626,658000,92008
16396,11995,4401,1898,742000,92009
5736,4124,1612,2116,549700,92010
9388,6172,3216,2022,699900,92011
6148,4232,1916,2073,1354100,92014
14972,9725,5247,1455,440000,92019
19188,7492,11696,1141,446400,92020
22405,11170,11235,1190,328300,92021
19249,12569,6680,1759,812800,92024
15184,6114,9070,1197,448400,92025
16733,10158,6575,1310,404800,92026
16137,9267,6870,1204,355200,92027
16610,11138,5472,1079,463100,92028
6929,5156,1773,1475,510500,92029
1161,795,366,724,282800,92036
16818,9475,7343,1812,1182500,92037
14792,9315,5477,1223,376200,92040
15622,6005,9617,1260,459500,92054
103,0,103,-,-,92055
19769,12622,7147,1597,392100,92056
19025,12191,6834,1693,375700,92057
14066,4020,10046,1706,316900,92058
352,260,92,825,306400,92059
50,50,0,-,275000,92060
596,334,262,1497,353700,92061
15822,11657,4165,1497,583700,92064
11843,8816,3027,1288,414300,92065
169,93,76,1125,361400,92066
3110,2768,342,1871,"2,000,000+",92067
14405,7879,6526,1301,415500,92069
389,267,122,778,383300,92070
19436,13646,5790,1469,362900,92071
5449,3021,2428,1879,1053600,92075
17317,11381,5936,1575,432600,92078
10622,5516,5106,1560,433800,92081
6057,4658,1399,1045,459900,92082
10851,5050,5801,1254,341000,92083
15391,8383,7008,1262,435500,92084
728,580,148,757,150000,92086
640,576,64,2000,974400,92091
21461,4975,16486,1413,485500,92101
14365,3751,10614,1104,325200,92102
17848,6246,11602,1314,637600,92103
21147,6144,15003,1150,496900,92104
21342,6092,15250,1031,295400,92105
7145,4229,2916,1796,856200,92106
13105,4842,8263,1396,745600,92107
10440,2801,7639,1891,299400,92108
22637,6578,16059,1482,740300,92109
11087,4889,6198,1414,516400,92110
16792,8218,8574,1358,434000,92111
12899,3574,9325,1010,284000,92113
17705,11713,5992,1269,324200,92114
20896,6995,13901,1169,413000,92115
16219,5301,10918,1153,529600,92116
20688,12283,8405,1415,503700,92117
8986,4402,4584,2268,1332500,92118
9393,6361,3032,1612,470900,92119
11141,7628,3513,1548,522500,92120
1685,888,797,1837,694300,92121
19734,6266,13468,1817,628800,92122
11195,5342,5853,1826,442800,92123
10750,4968,5782,2106,543400,92124
23694,13325,10369,1791,434900,92126
14317,9891,4426,1795,670600,92127
20364,13281,7083,1837,545900,92128
17685,12107,5578,1763,621000,92129
18424,12100,6324,2245,890000,92130
11613,9021,2592,2185,660500,92131
0,0,0,-,-,92132
0,0,0,-,-,92134
0,0,0,-,-,92135
10189,6076,4113,1442,316600,92139
11,0,11,-,-,92140
587,372,215,1242,1239700,92145
0,0,0,-,-,92147
21433,12336,9097,1392,321300,92154
0,0,0,-,-,92155
7946,2296,5650,1030,314300,92173
20093,11635,8458,977,194100,92201
10605,7422,3183,1304,292600,92203
2657,2267,390,725,658800,92210
12578,9405,3173,1273,342300,92211
11762,7710,4052,971,180700,92220
0,0,0,-,-,92222
15596,11534,4062,1148,244000,92223
5969,3156,2813,705,125200,92225
7452,4047,3405,777,151000,92227
967,482,485,1098,132700,92230
9382,4745,4637,840,165300,92231
994,487,507,699,96600,92233
17665,10566,7099,1132,203700,92234
11425,7388,4037,893,161600,92236
61,46,15,-,109400,92239
11754,5949,5805,932,140400,92240
3823,2966,857,701,59200,92241
705,585,120,550,58800,92242
13581,7040,6541,751,163700,92243
1763,1158,605,762,170400,92249
2578,1479,1099,740,162800,92250
5039,3752,1287,1178,193800,92251
3799,2076,1723,848,117900,92252
14958,10624,4334,1431,360900,92253
2949,1594,1355,682,97700,92254
1430,1090,340,835,108900,92256
808,582,226,538,48900,92257
170,127,43,-,-,92258
78,68,10,-,-,92259
15501,8833,6668,1129,304500,92260
12861,7233,5628,958,320800,92262
11002,6786,4216,996,278700,92264
88,59,29,-,-,92266
0,0,0,-,-,92267
285,263,22,-,207200,92268
9510,7525,1985,1245,471300,92270
432,181,251,740,100600,92273
5164,3066,2098,705,62100,92274
641,434,207,866,94000,92275
2726,1987,739,1131,152500,92276
9225,3180,6045,923,117300,92277
221,0,221,1340,-,92278
16,0,16,-,-,92280
645,302,343,649,115600,92281
425,265,160,1296,126000,92282
757,358,399,532,77100,92283
10430,6814,3616,951,139900,92284
1065,832,233,933,83400,92285
8288,3948,4340,1026,127400,92301
14,0,14,-,-,92304
220,104,116,1231,263500,92305
12493,8558,3935,939,205500,92307
13772,8587,5185,978,182200,92308
228,56,172,704,21900,92309
2337,23,2314,1223,-,92310
10781,5337,5444,754,102000,92311
4403,2695,1708,1280,250500,92313
4604,2831,1773,1051,237600,92314
2206,1249,957,925,382300,92315
7314,5236,2078,1155,214700,92316
3308,2773,535,990,168200,92320
464,338,126,1169,285200,92321
296,178,118,1028,170700,92322
17388,8955,8433,1050,190600,92324
3515,2317,1198,853,193800,92325
221,124,97,910,115200,92327
186,85,101,192,-,92328
3,3,0,-,-,92332
154,98,56,-,370000,92333
24299,12106,12193,1031,224400,92335
22957,17105,5852,1677,331100,92336
9677,6988,2689,1558,277200,92337
0,0,0,-,-,92338
453,343,110,1273,229300,92339
133,113,20,-,194900,92341
2462,1736,726,1373,214200,92342
6070,4784,1286,1460,256500,92344
23428,14232,9196,1046,168400,92345
16853,11145,5708,968,262900,92346
338,257,81,-,122100,92347
2488,1960,528,1315,348000,92352
7534,2808,4726,1110,299400,92354
2159,1521,638,713,105200,92356
467,336,131,1115,216200,92358
2951,1793,1158,910,230900,92359
2226,1209,1017,575,84200,92363
0,0,0,-,-,92364
882,754,128,-,112500,92365
273,156,117,867,120500,92368
5231,3910,1321,1029,160200,92371
2088,1686,402,1154,173500,92372
13350,6671,6679,1208,396800,92373
12761,7811,4950,1148,277400,92374
21205,12477,8728,1079,210200,92376
5360,4644,716,1879,295900,92377
49,49,0,-,216200,92378
1984,1368,616,1181,193000,92382
13,4,9,-,-,92384
136,102,34,673,320800,92385
962,481,481,925,152100,92386
78,50,28,554,65600,92389
1081,641,440,1068,256500,92391
15709,9524,6185,1276,166500,92392
7907,4748,3159,1181,167700,92394
12969,6177,6792,1043,157500,92395
1819,1205,614,1206,262300,92397
512,218,294,619,93800,92398
18532,13466,5066,1033,246500,92399
615,55,560,745,-,92401
16872,7603,9269,933,193000,92404
8605,3967,4638,919,161300,92405
15798,8973,6825,1145,242400,92407
3747,1159,2588,933,184300,92408
12534,4916,7618,858,99700,92410
6329,3100,3229,975,142400,92411
6838,3128,3710,985,231300,92501
25143,15384,9759,1210,276800,92503
16503,9577,6926,1165,264900,92504
13484,7116,6368,1286,277500,92505
15310,11466,3844,1295,366000,92506
16815,5474,11341,1147,252400,92507
10188,8261,1927,1940,383200,92508
19779,12893,6886,1162,257300,92509
552,60,492,1493,285300,92518
14871,8381,6490,1134,219300,92530
6026,4283,1743,1756,307000,92532
980,757,223,862,258000,92536
1449,903,546,780,158300,92539
13046,6204,6842,887,85400,92543
15325,9912,5413,990,162100,92544
14653,9595,5058,1188,168600,92545
2210,1338,872,976,80900,92548
1284,888,396,1086,252800,92549
8046,5136,2910,1328,197300,92551
18690,9094,9596,1179,197300,92553
10683,7384,3299,1636,283000,92555
14164,9162,5002,1341,250600,92557
725,591,134,948,463900,92561
20148,13289,6859,1493,357900,92562
16875,11929,4946,1655,341300,92563
2654,1928,726,1114,225100,92567
13888,8424,5464,1076,226500,92570
12126,7647,4479,1426,215400,92571
4236,3190,1046,1305,190800,92582
9374,5925,3449,900,137600,92583
14196,11164,3032,1709,301400,92584
5847,4226,1621,1421,242800,92585
9116,6060,3056,1064,155300,92586
5825,4629,1196,1542,331500,92587
1512,606,906,888,893300,92590
12746,7173,5573,1523,354800,92591
23486,17399,6087,1805,382400,92592
9016,6409,2607,1455,272300,92595
7074,5393,1681,1717,329500,92596
8591,4238,4353,1954,706200,92602
7731,5157,2574,2213,1127600,92603
9953,5892,4061,1968,643500,92604
7982,3289,4693,2087,721500,92606
4053,3081,972,1897,619100,92610
12468,3664,8804,2008,641300,92612
9564,4608,4956,1989,659500,92614
4160,1098,3062,1330,400500,92617
12169,4850,7319,2162,658200,92618
17312,10185,7127,1986,796700,92620
2772,1807,965,1731,720100,92624
5682,3928,1754,2193,1961600,92625
18870,8235,10635,1777,639700,92626
22246,7603,14643,1528,635300,92627
11579,7039,4540,1813,798300,92629
20919,14171,6748,1748,533800,92630
11299,8587,2712,1537,228700,92637
21104,15840,5264,1901,632700,92646
20479,9536,10943,1600,622200,92647
19459,9745,9714,1681,814400,92648
14032,8732,5300,1717,663000,92649
11366,7011,4355,2055,1478600,92651
9507,6771,2736,1875,644200,92653
2543,987,1556,1340,409800,92655
19395,11549,7846,1924,534100,92656
3866,2959,907,2623,"2,000,000+",92657
14786,7889,6897,2184,1471000,92660
1590,758,832,1854,1824100,92661
1462,743,719,1974,"2,000,000+",92662
10228,4724,5504,1853,1101900,92663
14313,7495,6818,1638,783000,92672
10208,8321,1887,2175,813100,92673
12087,8983,3104,1759,591700,92675
849,657,192,1944,491100,92676
25118,17404,7714,1913,712000,92677
217,122,95,1175,487500,92678
10685,9263,1422,2218,784500,92679
27274,14363,12911,1362,499400,92683
15947,10743,5204,1750,543100,92688
16461,12511,3950,1962,594800,92691
18052,13754,4298,1951,627100,92692
7433,5520,1913,2257,751100,92694
12709,3243,9466,1097,358900,92701
13358,6113,7245,1384,342100,92703
19793,10329,9464,1491,375900,92704
15137,10262,4875,1445,770100,92705
9197,4681,4516,1230,477100,92706
13458,6770,6688,1508,375600,92707
19162,13158,6004,1761,626300,92708
19424,8773,10651,1489,504400,92780
8306,5171,3135,2093,673600,92782
18166,6161,12005,1358,379800,92801
11582,4352,7230,1301,418200,92802
24166,9753,14413,1350,415900,92804
18383,7222,11161,1316,412900,92805
12356,4893,7463,1639,455000,92806
12170,9585,2585,1943,602800,92807
7426,5569,1857,2073,637100,92808
13541,7891,5650,1605,564600,92821
1148,1057,91,2760,711100,92823
12234,4639,7595,1363,559600,92831
8182,3253,4929,1331,456600,92832
16021,9207,6814,1482,518500,92833
8335,6032,2303,1489,678200,92835
15001,8183,6818,1407,424100,92840
9530,5008,4522,1339,447200,92841
11535,5259,6276,1306,408100,92843
6605,2771,3834,1394,410600,92844
5728,4754,974,1536,534200,92845
7133,5672,1461,1826,447300,92860
1975,1866,109,2913,1034400,92861
6186,3807,2379,1700,500100,92865
5445,1942,3503,1480,582300,92866
12821,8344,4477,1559,632400,92867
7763,2664,5099,1591,373700,92868
11444,8221,3223,1637,594800,92869
16947,11115,5832,1587,554900,92870
14526,8412,6114,1446,316700,92879
17133,12393,4740,2031,441900,92880
9828,7616,2212,1712,433400,92881
21580,14113,7467,1340,370300,92882
9933,8369,1564,2291,386100,92883
16079,13091,2988,1750,700300,92886
6704,5670,1034,1849,777000,92887
12617,5482,7135,1316,468100,93001
19146,11038,8108,1522,459600,93003
10665,6663,4002,1588,442800,93004
15631,9802,5829,1632,532400,93010
12774,9698,3076,1974,531700,93012
6223,3481,2742,1622,668500,93013
5002,3277,1725,1182,330400,93015
11294,8244,3050,1800,570300,93021
2488,1960,528,1587,446400,93022
7699,5012,2687,1305,586500,93023
14995,7439,7556,1297,386900,93030
16943,9363,7580,1344,311100,93033
10011,5855,4156,1830,448600,93035
12607,6442,6165,1399,380000,93036
588,408,180,977,261500,93040
7279,3176,4103,1566,317800,93041
0,0,0,-,-,93042
13,4,9,-,-,93043
9845,5365,4480,1138,329900,93060
19164,13690,5474,1660,460500,93063
0,0,0,-,-,93064
24084,17694,6390,1842,484900,93065
1073,701,372,1304,860700,93066
408,202,206,1224,754700,93067
12520,2674,9846,1406,734800,93101
7186,3056,4130,1750,876900,93103
10796,5955,4841,1689,947700,93105
4224,3203,1021,2449,"2,000,000+",93108
4583,2864,1719,2074,942000,93109
6096,3940,2156,1626,764700,93110
6314,4299,2015,2076,800400,93111
15684,5987,9697,1484,668400,93117
328,154,174,755,89300,93201
1035,612,423,902,114500,93202
5047,2227,2820,799,117100,93203
2120,899,1221,726,120400,93204
699,535,164,843,101900,93205
553,262,291,783,164600,93206
128,119,9,-,152900,93207
39,37,2,-,-,93208
4570,2401,2169,822,152100,93210
4312,1892,2420,753,114500,93212
11650,6415,5235,789,161600,93215
277,168,109,754,102100,93218
2355,955,1400,690,118800,93219
78,0,78,-,-,93220
5001,3251,1750,839,197700,93221
685,510,175,1254,167500,93222
2631,1738,893,730,124400,93223
153,101,52,775,93000,93224
1805,976,829,968,172600,93225
118,99,19,900,179200,93226
21286,11607,9679,914,177600,93230
1717,532,1185,665,119100,93234
1083,623,460,714,109500,93235
779,501,278,879,231400,93238
357,158,199,775,76700,93239
2837,1922,915,810,122100,93240
4176,1623,2553,751,95700,93241
1065,480,585,813,126700,93242
709,400,309,793,-,93243
172,150,22,575,230400,93244
11929,5432,6497,997,193700,93245
5088,2595,2493,729,141600,93247
540,173,367,632,105300,93249
3307,1766,1541,849,139200,93250
70,41,29,408,61000,93251
557,313,244,754,73300,93252
242,141,101,944,114400,93254
354,283,71,-,94200,93255
1340,506,834,761,110700,93256
21429,11599,9830,804,159200,93257
620,314,306,759,95200,93258
73,35,38,2138,201900,93260
689,277,412,621,102000,93261
0,0,0,-,-,93262
5136,2679,2457,759,154200,93263
1642,1336,306,990,253300,93265
363,207,156,776,117400,93266
1845,916,929,735,154700,93267
5565,2978,2587,815,128200,93268
1438,900,538,721,182200,93270
945,764,181,824,296200,93271
994,337,657,811,118100,93272
21571,12171,9400,926,165300,93274
62,39,23,823,63000,93276
18208,10341,7867,935,179200,93277
5659,2811,2848,689,153500,93280
1103,828,275,697,93600,93283
1029,914,115,597,155100,93285
2893,1889,1004,647,148500,93286
55,53,2,-,263800,93287
16261,9642,6619,891,240900,93291
13157,7937,5220,963,178600,93292
4771,1272,3499,747,148200,93301
15371,6369,9002,854,118700,93304
10749,3628,7121,787,114900,93305
21531,13471,8060,943,170900,93306
21661,10759,10902,900,119700,93307
19558,9353,10205,916,176000,93308
21727,9724,12003,926,169400,93309
14182,9689,4493,1388,277800,93311
18759,14159,4600,1489,269000,93312
12875,9570,3305,1408,213200,93313
8211,7028,1183,1346,326900,93314
12151,5289,6862,1240,606600,93401
6447,4206,2241,1366,436100,93402
8349,2919,5430,1443,611100,93405
0,0,0,-,-,93410
11789,8179,3610,1228,557300,93420
12526,7815,4711,1230,413700,93422
541,352,189,1207,610400,93424
526,377,149,1076,411700,93426
2095,1438,657,1335,418900,93427
2859,2073,786,1302,614800,93428
41,41,0,-,168800,93429
1562,962,600,1215,679000,93430
423,377,46,-,607300,93432
5543,2398,3145,1200,430200,93433
1933,1029,904,1140,210900,93434
17885,9029,8856,1053,274200,93436
938,0,938,1721,-,93437
468,235,233,1586,373000,93440
409,280,129,1447,901400,93441
5231,2860,2371,1341,505200,93442
6853,5012,1841,1421,444500,93444
2621,1383,1238,1084,323400,93445
16903,10918,5985,1145,401100,93446
4059,2352,1707,1431,633300,93449
258,58,200,841,152300,93450
1319,853,466,1276,360300,93451
186,53,133,973,-,93452
1270,884,386,1230,430200,93453
11501,5924,5577,1242,287800,93454
15078,11272,3806,1573,351000,93455
13169,5862,7307,1145,242600,93458
1965,1545,420,1630,840700,93460
529,274,255,1275,254800,93461
3388,2080,1308,1489,762900,93463
3153,2395,758,1263,518800,93465
1986,916,1070,654,88800,93501
4283,2398,1885,869,92900,93505
2622,2353,269,1675,457000,93510
148,107,41,365,-,93512
745,498,247,845,198400,93513
6031,4095,1936,869,281500,93514
897,559,338,702,57900,93516
266,227,39,-,181300,93517
445,343,102,1283,164100,93518
36,36,0,-,-,93519
25,25,0,-,-,93522
1050,215,835,1364,47800,93523
0,0,0,-,-,93524
335,226,109,764,174200,93526
880,699,181,698,166900,93527
63,36,27,-,-,93528
186,107,79,874,235300,93529
19,19,0,-,48800,93530
167,153,14,-,205400,93531
989,729,260,1107,216000,93532
14081,4555,9526,965,147600,93534
21098,12424,8674,1117,138500,93535
21179,14925,6254,1264,244000,93536
147,95,52,-,319400,93541
3655,2377,1278,1307,170600,93543
432,372,60,-,201100,93544
813,444,369,694,227500,93545
3236,1470,1766,1171,385300,93546
120,99,21,-,147300,93549
21130,10793,10337,993,163300,93550
16056,12187,3869,1589,285800,93551
9921,7246,2675,1485,189900,93552
832,616,216,720,204700,93553
103,96,7,-,52300,93554
13181,8316,4865,859,169300,93555
79,62,17,-,-,93558
6556,4233,2323,1026,148500,93560
11152,8253,2899,888,225100,93561
703,407,296,556,42700,93562
137,97,40,967,278800,93563
1807,1145,662,1101,131300,93591
27,22,5,-,-,93592
710,574,136,1256,322300,93601
1608,1291,317,807,261700,93602
93,70,23,-,416700,93603
314,287,27,-,539100,93604
73,28,45,755,317600,93605
227,168,59,733,151900,93606
256,111,145,867,-,93608
1540,697,843,839,186600,93609
5058,2375,2683,943,173100,93610
15719,11265,4454,1425,270900,93611
13483,4892,8591,920,158600,93612
4468,3713,755,1120,229600,93614
1443,577,866,721,98400,93615
682,375,307,540,235200,93616
8044,4044,4000,850,161400,93618
11106,9444,1662,1742,369200,93619
2793,1682,1111,759,132800,93620
164,100,64,-,346500,93621
2846,1255,1591,676,123300,93622
63,63,0,-,325000,93623
298,10,288,535,-,93624
2175,1127,1048,766,217900,93625
638,482,156,1384,310900,93626
26,0,26,-,-,93627
68,51,17,-,-,93628
5235,2678,2557,785,193900,93630
5165,3163,2002,849,243000,93631
0,0,0,-,-,93633
4,2,2,-,-,93634
11581,6081,5500,1070,184900,93635
3823,3276,547,1325,267500,93636
11716,6181,5535,1002,182500,93637
11964,6081,5883,905,160800,93638
2982,1016,1966,722,116200,93640
117,117,0,-,272700,93641
1199,904,295,597,246800,93643
3373,2324,1049,882,263500,93644
61,61,0,-,329100,93645
2660,1065,1595,755,125100,93646
2771,1459,1312,749,138400,93647
4093,1775,2318,744,125600,93648
1413,602,811,1025,45400,93650
697,555,142,1013,359600,93651
80,44,36,586,98500,93652
553,476,77,746,244600,93653
8833,5461,3372,905,183000,93654
1723,956,767,849,165600,93656
10117,6324,3793,873,195400,93657
1129,419,710,550,120200,93660
8452,4818,3634,854,171900,93662
222,152,70,939,478000,93664
264,232,32,-,93300,93665
222,42,180,629,65400,93666
918,634,284,936,259300,93667
332,209,123,1064,258400,93668
129,76,53,-,-,93669
197,103,94,780,99000,93673
1236,1085,151,1079,162400,93675
3097,408,2689,668,92900,93701
11873,3957,7916,773,96100,93702
10074,3385,6689,856,111000,93703
10909,6065,4844,883,212500,93704
12075,5129,6946,868,133700,93705
10864,4466,6398,804,123700,93706
11090,4629,6461,884,193700,93710
15734,9706,6028,1076,312100,93711
17778,10368,7410,1317,278400,93720
1809,157,1652,706,123400,93721
24429,13861,10568,1111,189600,93722
3261,2557,704,1095,272600,93723
6852,3542,3310,886,148100,93725
14308,5505,8803,828,141000,93726
23399,12851,10548,848,207700,93727
5715,2543,3172,819,109800,93728
4082,3234,848,1808,389600,93730
9744,3781,5963,1120,376800,93901
12827,4938,7889,1080,258900,93905
16862,8502,8360,1307,303000,93906
7190,4950,2240,1383,382300,93907
4552,3766,786,2049,662600,93908
394,105,289,715,1611800,93920
1523,860,663,1998,1221200,93921
5620,4204,1416,2027,983200,93923
2629,1902,727,1749,837400,93924
393,213,180,858,350000,93925
2245,1003,1242,1127,261300,93926
4100,1941,2159,1140,235600,93927
30,0,30,-,-,93928
4078,2176,1902,999,237100,93930
200,124,76,860,285300,93932
8687,3149,5538,1232,395400,93933
13421,5274,8147,1567,673900,93940
0,0,0,-,-,93943
6838,3272,3566,1478,699600,93950
1801,1451,350,2819,1051400,93953
98,35,63,933,154200,93954
10268,3918,6350,1480,366600,93955
4318,2575,1743,1113,259300,93960
252,159,93,-,431900,93962
10245,6173,4072,1782,1070100,94002
1862,1318,544,1698,699800,94005
16319,9489,6830,1809,1795900,94010
13743,7974,5769,1539,585800,94014
20162,11004,9158,1875,629600,94015
7472,5399,2073,1871,813900,94019
583,408,175,1656,740400,94020
58,17,41,964,-,94021
7485,6188,1297,2419,"2,000,000+",94022
7865,6933,932,2591,"2,000,000+",94024
14701,9107,5594,1912,1506200,94025
2416,2227,189,2659,"2,000,000+",94027
2641,2286,355,2979,"2,000,000+",94028
8071,4991,3080,1936,1036000,94030
1104,958,146,1682,824800,94037
1152,882,270,1571,740200,94038
13878,5637,8241,1902,1199000,94040
6269,2117,4152,1976,1015100,94041
12814,5644,7170,1911,819900,94043
13898,9462,4436,1937,680500,94044
452,255,197,1142,834100,94060
14028,7148,6880,1792,908100,94061
10187,7267,2920,1814,1351300,94062
9437,3367,6070,1588,571400,94063
5151,3623,1528,2758,1026800,94065
14842,8325,6517,1834,668200,94066
11701,8333,3368,1847,1113500,94070
106,58,48,-,1021700,94074
21131,12743,8388,1609,644700,94080
8135,2765,5370,1927,631400,94085
19608,6317,13291,1892,829400,94086
20211,11713,8498,1975,1117500,94087
7806,4971,2835,2275,214400,94089
17135,1495,15640,896,665800,94102
13501,2110,11391,1029,733900,94103
274,24,250,429,1593800,94104
4015,1955,2060,3173,790100,94105
13873,5603,8270,2176,850000,94107
8067,791,7276,1128,891300,94108
33730,5290,28440,1533,852600,94109
28183,9824,18359,1533,886000,94110
2118,561,1557,2227,945000,94111
23369,14873,8496,1593,660700,94112
16580,7714,8866,1958,1151900,94114
17343,4314,13029,1777,1075800,94115
16032,10427,5605,1744,861800,94116
18404,5264,13140,1888,1085700,94117
17784,5708,12076,1764,1205800,94118
17405,7245,10160,1648,956700,94121
23189,11237,11952,1799,874100,94122
13931,3509,10422,2069,1483400,94123
10612,5501,5111,947,565600,94124
7535,6078,1457,2429,1054900,94127
0,0,0,-,-,94128
1285,26,1259,2991,-,94129
602,0,602,1856,-,94130
13088,7176,5912,1911,1018300,94131
10388,4527,5861,1899,802600,94132
13105,2178,10927,1268,1107000,94133
11927,7078,4849,1390,624800,94134
3296,823,2473,2799,802600,94158
7265,3570,3695,2028,"2,000,000+",94301
13913,7137,6776,1735,1175700,94303
1845,339,1506,2807,1657500,94304
3240,922,2318,1539,1523300,94305
10696,6013,4683,2160,1536400,94306
12692,5569,7123,1661,647800,94401
9356,6418,2938,1927,1167900,94402
15649,8779,6870,2104,888800,94403
14564,8354,6210,2523,909700,94404
25507,10324,15183,1452,669900,94501
5171,4021,1150,1981,693500,94502
5694,4348,1346,1610,374400,94503
5182,4016,1166,2167,461300,94505
8207,7367,840,2518,1041800,94506
5500,4906,594,2911,1411000,94507
1082,545,537,1438,656000,94508
21443,12040,9403,1234,262500,94509
11007,7471,3536,1424,475500,94510
1058,918,140,1245,-,94511
31,31,0,-,-,94512
18745,13533,5212,1967,429100,94513
434,285,149,1111,425800,94514
2804,1661,1143,1164,558400,94515
68,48,20,850,520800,94516
4737,4146,591,2090,624100,94517
10249,6815,3434,1480,477300,94518
6804,4494,2310,1522,396600,94519
13242,4609,8633,1262,295000,94520
16069,11160,4909,1525,464800,94521
13943,8303,5640,1694,586800,94523
1436,700,736,1148,420200,94525
11986,10102,1884,2350,898300,94526
318,300,18,-,1277800,94528
10127,6040,4087,1559,635200,94530
12533,8604,3929,2011,330000,94531
22886,11333,11553,1177,249400,94533
12767,9594,3173,1856,399100,94534
1089,13,1076,1790,-,94535
24293,14039,10254,1771,642600,94536
21489,9882,11607,1855,595600,94538
16121,13236,2885,2077,1036200,94539
21204,9108,12096,1331,417200,94541
4293,2678,1615,1662,629100,94542
22570,10772,11798,1406,372000,94544
9213,6364,2849,1612,416100,94545
16329,10050,6279,1442,548200,94546
8158,6439,1719,1693,422300,94547
144,86,58,1364,892900,94548
10880,8039,2841,1792,1096000,94549
17991,12830,5161,1600,667100,94550
14574,10216,4358,1779,555000,94551
5007,4490,517,2774,738500,94552
19051,12644,6407,1462,432200,94553
11106,7832,3274,2139,658700,94555
5698,4730,968,1913,975500,94556
24081,15730,8351,1540,523500,94558
10570,4838,5732,1330,484900,94559
13522,9455,4067,1744,547800,94560
11897,8777,3120,1489,324300,94561
6847,5971,876,2337,1123500,94563
6810,4726,2084,1552,387100,94564
27453,15155,12298,1407,264800,94565
15829,11359,4470,1792,877200,94566
231,182,49,1469,235000,94567
17249,11076,6173,2140,673000,94568
142,44,98,1125,-,94569
4203,3147,1056,1313,271700,94571
3184,2020,1164,1178,345300,94572
23,0,23,-,-,94573
3670,2237,1433,1454,959600,94574
0,0,0,-,-,94575
36,19,17,-,-,94576
17284,9170,8114,1340,433900,94577
14330,5430,8900,1221,402500,94578
7183,5125,2058,1486,433000,94579
8734,5804,2930,1540,407200,94580
13097,9055,4042,2033,885300,94582
12308,8456,3852,1959,736600,94583
9059,5355,3704,1570,255100,94585
371,285,86,1415,804500,94586
20698,13490,7208,1756,561200,94587
11849,7969,3880,2117,763400,94588
9510,5519,3991,1390,212000,94589
14386,5594,8792,1059,219000,94590
18493,11957,6536,1447,302800,94591
294,229,65,2353,372700,94592
9489,7803,1686,1469,464400,94595
9705,4100,5605,1637,808500,94596
10134,4639,5495,1736,633600,94597
10137,7783,2354,1995,805700,94598
1428,973,455,2073,576000,94599
14930,4558,10372,1082,303800,94601
11804,6695,5109,1201,606200,94602
9620,4462,5158,1233,255600,94603
15607,8754,6853,1228,422600,94605
14935,2869,12066,1082,389000,94606
11356,2933,8423,987,392800,94607
13862,4830,9032,1423,435800,94608
9834,2902,6932,1267,628200,94609
15594,5716,9878,1390,761200,94610
17020,10351,6669,1332,887500,94611
8333,654,7679,951,417600,94612
0,0,0,-,-,94613
6991,4652,2339,1648,975100,94618
8979,5690,3289,1395,549300,94619
9422,2888,6534,1107,223800,94621
7726,3445,4281,1359,617400,94702
8863,3674,5189,1479,671900,94703
8139,832,7307,1355,717900,94704
5789,3312,2477,1507,1039000,94705
7958,3827,4131,1650,693000,94706
4982,4068,914,1674,931400,94707
4853,4141,712,2327,921400,94708
5201,1315,3886,1510,838900,94709
2972,1147,1825,1429,640000,94710
29,13,16,-,-,94720
9234,3779,5455,1098,226700,94801
9286,6492,2794,1422,394300,94803
14536,6605,7931,1200,302500,94804
5349,3320,2029,1394,353200,94805
19455,8877,10578,1231,274200,94806
0,0,0,-,-,94850
15587,7771,7816,1530,841600,94901
12226,8350,3876,1905,689900,94903
5421,3318,2103,1753,1280500,94904
5402,3684,1718,2373,"2,000,000+",94920
241,66,175,830,675500,94922
439,320,119,1194,647400,94923
557,372,185,1806,963200,94924
3802,2617,1185,2025,1061700,94925
15936,8341,7595,1407,340500,94928
72,45,27,-,831500,94929
3739,2566,1173,1691,765200,94930
3273,2006,1267,1345,444200,94931
285,193,92,-,566200,94933
433,143,290,1435,729800,94937
319,196,123,1745,708300,94938
3301,1650,1651,1969,1401300,94939
128,64,64,1150,1550000,94940
13117,8669,4448,1847,1120500,94941
7198,4815,2383,1788,682900,94945
296,244,52,1750,1574100,94946
10067,7267,2800,1726,628200,94947
7175,4658,2517,1844,644800,94949
52,28,24,-,1055600,94950
1684,1163,521,1220,696300,94951
13492,7939,5553,1435,619300,94952
13449,9427,4022,1678,475800,94954
728,323,405,1082,939100,94956
416,365,51,2063,"2,000,000+",94957
6416,4929,1487,1685,975600,94960
257,186,71,1917,924200,94963
54,11,43,1750,-,94964
5810,2698,3112,1874,971700,94965
324,205,119,3103,1685100,94970
168,76,92,1327,601600,94971
10,10,0,-,-,94972
745,578,167,1158,704800,94973
552,350,202,1346,485100,95002
10164,7152,3012,1818,703200,95003
1164,840,324,1458,498700,95004
2568,1997,571,1413,567100,95005
3876,2843,1033,1443,471200,95006
285,244,41,-,607400,95007
18050,8863,9187,1786,803600,95008
4166,1909,2257,1706,570900,95010
2445,1102,1343,977,245200,95012
25,0,25,-,-,95013
21360,12993,8367,2530,1215600,95014
285,156,129,1111,700000,95017
2771,2236,535,1405,484600,95018
1905,751,1154,1025,374000,95019
18045,10688,7357,1509,566800,95020
15010,9582,5428,1338,415300,95023
5337,3980,1357,2038,1980700,95030
9872,6744,3128,1905,1205600,95032
3740,3060,680,1549,910400,95033
21519,13789,7730,1993,636000,95035
16180,11534,4646,1709,709400,95037
400,292,108,981,212200,95039
113,58,55,853,500000,95041
268,147,121,1196,598000,95043
1560,769,791,1176,489900,95045
1795,1330,465,1658,827700,95046
14603,5042,9561,1668,697700,95050
20371,10213,10158,1960,743400,95051
24,24,0,-,642900,95053
8525,3430,5095,2338,758900,95054
18739,8786,9953,1504,748000,95060
15048,7523,7525,1506,625200,95062
435,158,277,1713,300000,95064
3217,2195,1022,1948,723700,95065
5690,4085,1605,1922,710300,95066
10897,9205,1692,2424,1734300,95070
4119,2911,1208,1349,650200,95073
136,80,56,1625,494400,95075
23102,12001,11101,1320,430300,95076
6389,2544,3845,1652,482700,95110
15938,9065,6873,1372,403800,95111
20146,5758,14388,1347,495400,95112
772,129,643,2101,654100,95113
14340,5461,8879,1308,413700,95116
10735,3739,6996,1624,728700,95117
11330,7385,3945,1709,707700,95118
3188,2379,809,1958,631100,95119
12591,11144,1447,2495,1064500,95120
9765,6959,2806,1864,558300,95121
12986,6463,6523,1579,426800,95122
22032,13781,8251,1973,596500,95123
16965,12905,4060,1784,830300,95124
20923,13700,7223,1594,840600,95125
14807,5012,9795,1570,658600,95126
16734,10503,6231,1688,536600,95127
13815,5485,8330,1566,688600,95128
14119,8090,6029,1842,1052600,95129
4954,3022,1932,1498,874300,95130
9273,6072,3201,2063,618000,95131
11906,8809,3097,2037,647000,95132
8119,4646,3473,1465,536800,95133
8901,2018,6883,2481,157000,95134
7387,6366,1021,2352,852500,95135
15516,9083,6433,1865,608200,95136
5957,5009,948,2267,823800,95138
2249,1699,550,2093,617200,95139
90,58,32,937,"2,000,000+",95140
11966,9507,2459,2175,670000,95148
3004,136,2868,577,160800,95202
5035,1773,3262,826,160900,95203
11100,5813,5287,928,156500,95204
10371,4493,5878,882,111900,95205
16850,8699,8151,1107,154700,95206
18141,6933,11208,887,190700,95207
12987,8602,4385,1253,229800,95209
11667,5104,6563,1035,149500,95210
0,0,0,-,-,95211
7049,5270,1779,1503,273300,95212
6692,3917,2775,944,157000,95215
10930,5904,5026,1144,320100,95219
2551,1952,599,1307,391400,95220
2258,1512,746,833,276900,95222
1368,1032,336,1189,293400,95223
158,124,34,-,-,95224
193,129,64,-,306000,95225
14,0,14,-,-,95226
264,195,69,-,-,95227
1690,1427,263,1521,234700,95228
233,111,122,-,597700,95230
766,314,452,888,174200,95231
76,76,0,-,313600,95232
235,172,63,1322,247800,95233
23,0,23,-,-,95234
1480,1021,459,657,357600,95236
1141,811,330,1134,235200,95237
15870,7813,8057,933,226700,95240
9925,6685,3240,1181,304600,95242
761,628,133,893,260800,95245
584,476,108,1057,343900,95246
2048,1548,500,1156,295600,95247
70,70,0,-,-,95248
1586,947,639,949,196800,95249
0,0,0,-,-,95250
232,168,64,1013,265600,95251
5124,4258,866,1581,252400,95252
372,372,0,-,306500,95254
791,597,194,826,191700,95255
170,115,55,1354,-,95257
1489,1052,437,996,319500,95258
11413,6557,4856,896,187000,95301
255,85,170,833,-,95303
3896,2789,1107,1458,438400,95304
12,0,12,-,-,95305
449,368,81,757,355300,95306
12125,7465,4660,1010,185400,95307
967,688,279,955,230300,95310
862,740,122,726,220700,95311
95,81,14,-,201200,95312
447,182,265,804,259600,95313
0,0,0,-,-,95314
3579,2382,1197,967,153200,95315
2082,1446,636,955,269100,95316
296,112,184,496,196400,95317
161,39,122,1078,411400,95318
503,196,307,702,164200,95319
4278,2884,1394,1145,281700,95320
1527,1138,389,841,261100,95321
2977,1645,1332,814,168100,95322
357,219,138,883,248300,95323
2628,1729,899,1029,224100,95324
17,7,10,-,-,95325
3348,2148,1200,1156,273400,95326
2354,1815,539,862,188700,95327
1266,792,474,942,154000,95328
1002,797,205,1078,214700,95329
5306,3664,1642,1601,250600,95330
843,553,290,817,165000,95333
4121,2467,1654,894,192100,95334
103,42,61,-,-,95335
15135,8584,6551,1203,257800,95336
10629,6472,4157,1277,315400,95337
4457,3098,1359,920,248600,95338
11952,6044,5908,860,203200,95340
8411,3382,5029,806,131000,95341
350,212,138,596,249000,95345
762,571,191,1088,276300,95346
10757,4660,6097,905,181500,95348
19520,9789,9731,966,185100,95350
13299,5459,7840,958,133900,95351
8839,4179,4660,912,169300,95354
21228,12276,8952,1096,240200,95355
11322,6868,4454,1125,267700,95356
3665,2633,1032,1206,247400,95357
8777,5130,3647,1109,175800,95358
3681,2172,1509,1004,160000,95360
11851,7529,4322,938,301300,95361
7185,4338,2847,1236,231100,95363
0,0,0,-,-,95364
1310,649,661,659,112400,95365
5907,4032,1875,1189,370300,95366
7215,4835,2380,1067,223400,95367
4055,2966,1089,1279,217100,95368
345,170,175,661,197500,95369
12070,7640,4430,958,271000,95370
757,604,153,1166,238600,95372
508,271,237,949,336900,95374
31,31,0,-,-,95375
15445,8779,6666,1378,286300,95376
8792,6162,2630,1941,385200,95377
1469,828,641,686,170200,95379
14083,6383,7700,890,201900,95380
12922,7693,5229,1129,276500,95382
1538,1212,326,838,304300,95383
185,99,86,572,-,95385
2912,1933,979,924,188700,95386
124,17,107,437,-,95387
3751,1914,1837,828,140400,95388
350,67,283,384,290400,95389
3886,2937,949,2257,458000,95391
13421,6958,6463,1318,348900,95401
17336,9199,8137,1422,400000,95403
16357,9019,7338,1317,560900,95404
8463,4902,3561,1495,474300,95405
12304,5999,6305,1271,318200,95407
11992,7758,4234,1546,480200,95409
375,238,137,1125,425400,95410
146,81,65,990,535300,95412
488,238,250,907,371100,95415
123,123,0,-,266900,95417
273,143,130,-,523300,95420
666,471,195,977,433100,95421
6496,3272,3224,814,85900,95422
1614,1090,524,846,155900,95423
4009,2732,1277,1136,376500,95425
605,438,167,944,211800,95426
142,69,73,-,398600,95427
929,632,297,860,242600,95428
28,28,0,-,-,95429
0,0,0,-,-,95430
0,0,0,-,-,95431
226,131,95,1394,426000,95432
69,69,0,-,-,95435
2613,1810,803,1274,398000,95436
5908,3091,2817,1021,350800,95437
282,175,107,881,635400,95439
642,345,297,1133,721300,95441
1494,905,589,1319,669600,95442
148,52,96,677,-,95443
225,205,20,-,402400,95444
933,677,256,1165,475900,95445
2306,1389,917,1105,362300,95446
7005,4218,2787,1412,666800,95448
545,252,293,892,411800,95449
156,68,88,977,438500,95450
4692,3337,1355,1320,191900,95451
580,478,102,1269,604700,95452
4470,2736,1734,861,199600,95453
988,553,435,430,343400,95454
399,230,169,945,307700,95456
1309,1041,268,860,138700,95457
1268,659,609,813,88600,95458
270,149,121,1095,364300,95459
1229,846,383,885,434000,95460
1148,725,423,829,294500,95461
578,383,195,945,364200,95462
49,33,16,-,-,95463
1098,670,428,832,150000,95464
1033,765,268,1303,587700,95465
367,141,226,732,923400,95466
1995,1560,435,1529,229800,95467
617,387,230,828,384900,95468
730,405,325,1321,457100,95469
2202,1618,584,1166,335800,95470
281,72,209,1335,558800,95471
12774,8137,4637,1364,661000,95472
15376,9779,5597,1362,547800,95476
11659,6146,5513,958,291000,95482
1092,781,311,863,170000,95485
26,0,26,-,-,95486
125,86,39,-,651300,95488
5464,3151,2313,1028,234500,95490
9984,7277,2707,1621,450200,95492
150,118,32,-,353300,95493
78,42,36,-,1062500,95494
610,499,111,1509,674900,95497
9592,4135,5457,848,243700,95501
9967,6418,3549,971,267200,95503
136,102,34,-,171400,95511
94,94,0,-,282900,95514
7196,4399,2797,971,289100,95519
8353,3365,4988,883,324000,95521
798,589,209,1323,429400,95524
650,389,261,1029,275700,95525
127,72,55,631,250000,95526
237,197,40,789,275000,95527
461,362,99,1184,322200,95528
7912,4711,3201,827,184400,95531
1185,640,545,1023,349100,95536
124,53,71,-,-,95537
5075,2909,2166,914,249500,95540
942,531,411,915,438000,95542
358,303,55,643,162500,95543
38,38,0,-,-,95545
1158,730,428,469,118000,95546
458,366,92,883,374400,95547
414,223,191,729,109400,95548
373,281,92,832,429000,95549
68,8,60,1017,-,95550
622,405,217,725,230700,95551
284,175,109,756,268100,95552
561,299,262,980,477500,95553
163,129,34,-,396900,95554
173,89,84,688,205400,95555
268,169,99,433,217100,95556
235,175,60,683,345000,95558
89,43,46,-,-,95559
546,230,316,975,352200,95560
1435,887,548,766,205500,95562
327,172,155,865,447800,95563
147,34,113,988,300000,95564
339,84,255,1060,200000,95565
759,511,248,747,229800,95567
50,33,17,770,229200,95568
140,89,51,-,334600,95569
965,719,246,942,418600,95570
84,62,22,-,324400,95571
733,435,298,738,262600,95573
258,159,99,683,309600,95585
85,85,0,-,446300,95587
432,406,26,-,385100,95589
60,55,5,-,-,95595
93,50,43,830,-,95601
7061,5090,1971,1119,396700,95602
11733,7501,4232,1117,346500,95603
58,47,11,-,667900,95604
4850,1874,2976,856,186200,95605
52,11,41,-,-,95606
259,202,57,-,539500,95607
25040,13619,11421,943,331500,95608
17641,8411,9230,1019,248000,95610
379,272,107,1131,435100,95612
1515,1310,205,1867,323000,95614
287,99,188,1050,309600,95615
17181,6094,11087,1235,575600,95616
9834,5357,4477,1452,591500,95618
1922,1469,453,1358,246700,95619
6540,4287,2253,1155,310700,95620
16254,10286,5968,1107,196200,95621
1465,1037,428,1086,294500,95623
19443,14789,4654,1395,318900,95624
45,9,36,-,-,95625
1970,1507,463,1401,245300,95626
1190,763,427,1272,202700,95627
16355,10903,5452,1168,350500,95628
301,218,83,-,287500,95629
26246,18089,8157,1465,433800,95630
2503,1730,773,1150,286700,95631
9323,6667,2656,1133,258700,95632
1210,1119,91,-,298600,95633
1151,833,318,1115,251700,95634
401,370,31,-,270800,95635
327,327,0,-,166900,95636
123,98,25,-,353700,95637
743,664,79,1310,416900,95638
82,59,23,-,354000,95639
2735,2042,693,1074,243200,95640
839,521,318,907,216400,95641
3067,2110,957,984,273500,95642
724,340,384,834,168400,95645
12,0,12,-,-,95646
18770,14661,4109,1593,367700,95648
4769,3855,914,1434,475400,95650
243,191,52,-,570500,95651
193,0,193,723,-,95652
182,156,26,-,191100,95653
1345,1105,240,-,282700,95655
2595,2141,454,1500,434400,95658
353,222,131,941,348800,95659
10685,5253,5432,1022,152500,95660
11948,7089,4859,1320,373600,95661
12057,8679,3378,1280,307800,95662
797,712,85,1583,500000,95663
494,441,53,-,424000,95664
2022,1659,363,1109,257800,95665
2403,2013,390,1206,218800,95666
14443,10791,3652,1043,328200,95667
332,246,86,1214,397000,95668
983,745,238,1224,328300,95669
20448,11097,9351,972,247000,95670
1656,1444,212,2047,414400,95672
4827,3601,1226,1182,194800,95673
289,200,89,1109,412100,95674
182,174,8,-,150800,95675
8925,5697,3228,1307,341100,95677
15880,8609,7271,1298,289400,95678
10,10,0,-,-,95679
59,9,50,-,-,95680
425,345,80,1450,311200,95681
11019,7846,3173,1135,397900,95682
2576,2311,265,1656,438700,95683
1270,1051,219,986,266100,95684
1900,1262,638,1028,376000,95685
357,143,214,807,137500,95686
21705,12943,8762,1442,304600,95687
12784,8261,4523,1342,397500,95688
545,497,48,-,327200,95689
828,429,399,744,427700,95690
13059,7859,5200,1027,291600,95691
1701,1093,608,992,229200,95692
2227,1894,333,955,454300,95693
3450,2043,1407,1000,321500,95694
14360,7676,6684,951,313500,95695
133,61,72,988,-,95697
81,52,29,-,376500,95698
50,50,0,-,341400,95699
319,262,57,1313,326200,95701
431,317,114,1067,308600,95703
1841,1544,297,1379,323700,95709
3906,2720,1186,1303,289200,95713
187,138,49,944,268400,95714
50,40,10,-,227800,95715
86,50,36,1125,337500,95717
28,25,3,-,218800,95720
13,13,0,-,-,95721
1914,1797,117,1518,422900,95722
0,0,0,-,-,95724
3403,2767,636,1090,259900,95726
157,70,87,-,627900,95728
7,7,0,-,625000,95735
60,0,60,513,-,95736
3032,2574,458,1887,339200,95742
8108,7031,1077,1836,642800,95746
21220,16318,4902,1503,384500,95747
12819,9030,3789,1658,356900,95757
20877,14213,6664,1439,283300,95758
13510,11736,1774,1940,546900,95762
12505,8441,4064,1446,409100,95765
6997,4494,2503,1173,278900,95776
3775,595,3180,802,390600,95811
5743,429,5314,827,344900,95814
8907,2695,6212,932,136400,95815
9859,2744,7115,942,477500,95816
5900,2402,3498,900,247700,95817
9586,4981,4605,864,465600,95818
7778,5367,2411,1317,438000,95819
12492,6235,6257,1057,180100,95820
14739,6321,8418,825,270200,95821
15784,8451,7333,1053,241400,95822
23078,9991,13087,954,169000,95823
8875,3353,5522,921,122100,95824
15414,3783,11631,880,235200,95825
14776,7842,6934,993,229500,95826
7235,4238,2997,1113,187000,95827
17681,10168,7513,1128,178000,95828
7788,5827,1961,1532,316600,95829
311,280,31,1354,398800,95830
18250,10232,8018,1155,354800,95831
2872,1398,1474,1162,174200,95832
14461,6506,7955,1140,206500,95833
9747,3760,5987,1124,254200,95834
13153,7932,5221,1522,304800,95835
152,130,22,-,437500,95837
10852,5392,5460,1033,151300,95838
7808,2751,5057,928,187700,95841
11173,5773,5400,1008,169300,95842
14144,9043,5101,1356,251100,95843
9470,7144,2326,1273,501900,95864
11609,5806,5803,893,177100,95901
369,0,369,1448,-,95903
56,56,0,-,-,95910
1426,963,463,925,240600,95912
297,278,19,979,189000,95914
9,9,0,-,-,95915
443,335,108,792,170700,95916
1039,674,365,946,164800,95917
1027,921,106,-,350800,95918
573,417,156,630,161600,95919
97,47,50,556,-,95920
282,213,69,829,175600,95922
4,4,0,-,-,95923
121,53,68,-,-,95925
14946,6323,8623,945,274600,95926
14022,6511,7511,977,307100,95928
48,31,17,-,-,95930
2736,1695,1041,833,217700,95932
164,96,68,725,225000,95934
270,164,106,-,320700,95935
109,68,41,-,226000,95936
465,332,133,1027,126600,95937
1559,950,609,1102,374700,95938
204,92,112,488,171900,95939
253,224,29,-,206600,95941
466,448,18,-,352100,95942
356,177,179,896,355000,95943
31,13,18,-,-,95944
11362,6579,4783,1027,313600,95945
3888,3176,712,1434,337200,95946
753,528,225,863,165500,95947
3768,2092,1676,775,182300,95948
8085,6880,1205,1372,335700,95949
136,37,99,698,-,95950
805,533,272,730,161600,95951
3136,2067,1069,793,169000,95953
5072,4005,1067,1072,157900,95954
492,316,176,819,193800,95955
163,163,0,-,210400,95956
312,174,138,806,275000,95957
7187,5484,1703,1187,385500,95959
302,196,106,1284,216700,95960
8577,5562,3015,916,179300,95961
664,433,231,791,241500,95962
5364,3350,2014,753,230600,95963
6895,4032,2863,775,156500,95965
11294,7810,3484,912,169300,95966
442,326,116,675,109000,95968
11485,8250,3235,978,206600,95969
216,164,52,906,173600,95970
2503,1607,896,881,214800,95971
13678,7987,5691,954,282400,95973
15,0,15,-,-,95974
691,583,108,-,276400,95975
632,465,167,1277,249800,95977
38,9,29,-,-,95978
292,211,81,825,145800,95979
45,0,45,-,-,95981
1185,817,368,1059,204000,95982
238,230,8,-,179200,95983
39,39,0,-,-,95984
54,48,6,-,-,95986
1745,1161,584,1023,171300,95987
3121,1547,1574,751,203100,95988
14160,6604,7556,884,174200,95991
11925,7807,4118,1110,248700,95993
13610,7836,5774,898,255800,96001
12325,6943,5382,958,215200,96002
17842,10170,7672,1055,233500,96003
147,139,8,-,148200,96006
9108,6011,3097,819,188200,96007
491,446,45,834,271600,96008
144,131,13,-,183800,96009
67,51,16,563,284400,96010
59,38,21,575,165000,96011
1808,958,850,642,135100,96013
94,94,0,-,158300,96014
116,84,32,-,-,96015
244,198,46,725,204700,96016
76,47,29,814,350000,96017
3686,2173,1513,983,156800,96019
1070,714,356,888,207700,96020
5793,3880,1913,747,157300,96021
6269,4971,1298,931,232100,96022
457,281,176,658,109000,96023
418,312,106,950,241900,96024
988,579,409,898,150500,96025
998,739,259,894,227600,96027
518,443,75,639,271500,96028
65,47,18,781,391700,96029
63,51,12,606,146900,96031
960,663,297,758,248900,96032
230,168,62,833,80000,96033
120,66,54,1078,165800,96034
1131,769,362,730,143800,96035
88,78,10,-,112500,96037
251,141,110,898,153900,96038
515,309,206,656,129700,96039
141,115,26,-,204200,96040
1312,859,453,729,269200,96041
436,328,108,874,159700,96044
54,31,23,-,-,96046
330,217,113,893,222100,96047
248,209,39,775,277400,96048
14,14,0,-,155000,96049
206,162,44,418,190500,96050
534,412,122,750,228600,96051
569,423,146,838,232700,96052
123,103,20,-,161000,96054
1450,964,486,732,183300,96055
773,579,194,700,214800,96056
589,421,168,808,184500,96057
276,176,100,640,160700,96058
233,148,85,645,225000,96059
15,15,0,-,541700,96061
432,353,79,1133,338800,96062
103,44,59,650,167500,96063
1862,1316,546,784,158500,96064
149,112,37,650,310500,96065
3355,2135,1220,946,250600,96067
33,21,12,-,110900,96068
379,321,58,905,233700,96069
61,61,0,-,133400,96071
1496,1367,129,1759,360100,96073
49,36,13,838,-,96074
110,92,18,700,111500,96075
54,43,11,-,307500,96076
10678,6480,4198,786,180900,96080
189,144,45,938,158700,96084
33,33,0,-,-,96085
148,125,23,838,166800,96086
319,268,51,483,242500,96087
1938,1662,276,1026,203600,96088
184,129,55,856,170300,96090
260,209,51,735,348800,96091
149,127,22,843,192200,96092
1613,984,629,710,257900,96093
2724,1707,1017,882,187100,96094
274,220,54,725,276600,96096
4388,2493,1895,804,157300,96097
2278,1646,632,744,111200,96101
764,579,185,914,285000,96103
254,207,47,572,252500,96104
57,57,0,-,66800,96105
112,112,0,-,455600,96106
446,323,123,771,230800,96107
4,4,0,-,-,96108
423,325,98,786,157300,96109
72,44,28,500,-,96110
23,23,0,-,187500,96111
107,64,43,248,225000,96112
342,132,210,893,61300,96113
1353,1121,232,897,226700,96114
84,75,9,-,162100,96115
75,75,0,-,-,96116
107,61,46,1111,231300,96117
629,492,137,981,112500,96118
35,12,23,-,-,96119
312,261,51,950,316000,96120
127,110,17,-,270800,96121
1534,981,553,700,184800,96122
16,8,8,-,95000,96123
214,166,48,-,139100,96124
119,115,4,-,354400,96125
19,19,0,-,-,96126
337,297,40,-,240900,96128
64,52,12,-,-,96129
5323,3145,2178,958,173000,96130
44,21,23,-,59200,96132
51,12,39,-,-,96133
813,443,370,585,118600,96134
75,75,0,-,-,96135
36,36,0,-,241200,96136
1675,1152,523,795,206300,96137
353,261,92,988,546400,96140
228,166,62,1388,581600,96141
313,191,122,1254,443400,96142
1324,644,680,1105,384700,96143
1112,743,369,1284,603500,96145
450,315,135,937,862600,96146
242,155,87,1063,614600,96148
11277,6071,5206,924,367300,96150
0,0,0,-,-,96155
7024,4694,2330,1468,515100,96161
12988,8155,4833,1584,611400,96701
592,476,116,886,432500,96703
2552,1823,729,1316,409900,96704
748,517,231,1118,400300,96705
18471,12504,5967,2141,494000,96706
12542,8186,4356,2149,512100,96707
3601,2295,1306,1364,699700,96708
128,103,25,-,805000,96710
2528,1331,1197,1793,965400,96712
493,313,180,889,423600,96713
275,189,86,1390,875000,96714
858,632,226,1150,396900,96716
1356,668,688,1586,560800,96717
596,370,226,964,380300,96719
16660,10484,6176,972,297400,96720
893,637,256,1739,770400,96722
1136,664,472,1136,601200,96725
195,104,91,675,525600,96726
1486,1047,439,1038,362900,96727
209,165,44,1130,232700,96728
358,302,56,883,168900,96729
507,326,181,1382,652900,96730
738,528,210,990,499400,96731
7236,4259,2977,1222,490000,96732
15978,9750,6228,2404,868800,96734
1599,1211,388,1001,126200,96737
2528,1915,613,1466,381000,96738
12739,7889,4850,1236,460600,96740
2086,1405,681,1407,614200,96741
55,2,53,960,-,96742
4163,2589,1574,1523,424900,96743
16551,12034,4517,1794,669800,96744
6673,4169,2504,1371,493800,96746
212,0,212,635,-,96747
1588,1016,572,747,297900,96748
6050,4597,1453,1099,243600,96749
1169,636,533,824,445300,96750
48,48,0,-,-,96751
1034,740,294,883,385600,96752
10832,5671,5161,1491,548300,96753
1128,704,424,1667,712300,96754
1018,679,339,1054,338200,96755
2004,1085,919,1211,628100,96756
238,136,102,1242,216700,96757
113,0,113,1188,-,96759
1001,753,248,995,220700,96760
7483,3640,3843,1417,577500,96761
975,463,512,1506,643100,96762
1261,643,618,1015,373100,96763
241,196,45,857,430800,96764
223,168,55,1388,490900,96765
4905,3149,1756,1209,456200,96766
6208,3850,2358,1268,593400,96768
113,0,113,437,-,96769
275,79,196,704,-,96770
2789,2027,762,1073,176900,96771
800,609,191,942,195900,96772
54,54,0,-,384000,96773
86,46,40,-,-,96774
451,334,117,929,281100,96776
461,325,136,681,208800,96777
5405,3590,1815,1047,188400,96778
902,604,298,2105,644400,96779
211,135,76,624,152000,96780
489,307,182,1035,193100,96781
11554,7861,3693,1777,592800,96782
646,451,195,372,259000,96783
1232,910,322,1022,195900,96785
12655,3403,9252,2132,494900,96786
17864,13018,4846,1877,573100,96789
3580,2421,1159,1275,703300,96790
2306,1357,949,1572,598200,96791
11480,6609,4871,1267,335900,96792
9803,6141,3662,1109,461200,96793
2402,1644,758,1173,540200,96795
638,285,353,1246,378300,96796
19007,12022,6985,1583,539100,96797
9604,4539,5065,1210,574600,96813
9733,3748,5985,1295,484900,96814
13802,5775,8027,1445,475900,96815
17198,10507,6691,1594,827800,96816
19305,7416,11889,1092,628300,96817
17824,6342,11482,2490,473100,96818
12179,5325,6854,1409,643200,96819
6588,5444,1144,2145,991000,96821
18221,8705,9516,1323,637600,96822
10517,8672,1845,2593,786200,96825
14562,3888,10674,1195,373500,96826
0,0,0,-,-,96850
0,0,0,-,-,96853
0,0,0,-,-,96857
0,0,0,-,-,96859
0,0,0,-,-,96860
0,0,0,-,-,96863
85,21,64,700,325000,97001
2206,1956,250,1015,333300,97002
1566,1400,166,1182,357700,97004
10684,3660,7024,965,249000,97005
25060,12644,12416,1186,259900,97006
25055,17072,7983,1169,288500,97007
11748,6569,5179,1005,296400,97008
2953,2506,447,952,340200,97009
252,132,120,1558,184100,97011
8421,5728,2693,923,274500,97013
583,354,229,604,177000,97014
8206,4652,3554,1048,292700,97015
2572,1994,578,797,182000,97016
973,864,109,979,289800,97017
893,705,188,986,249100,97018
1202,1023,179,1215,333400,97019
342,311,31,1300,167800,97020
478,306,172,877,193800,97021
1089,936,153,867,314800,97022
3860,2975,885,1031,318400,97023
4149,2433,1716,1028,207200,97024
1202,911,291,1139,168600,97026
4903,3003,1900,1053,235500,97027
68,68,0,-,351400,97028
113,73,40,929,123200,97029
14433,6323,8110,971,211700,97030
6968,4432,2536,1089,330600,97031
1680,1276,404,891,183800,97032
56,29,27,-,167300,97033
7908,6046,1862,1455,611500,97034
10690,6548,4142,1306,435500,97035
466,269,197,684,149300,97037
5629,4030,1599,960,234400,97038
252,147,105,743,167000,97039
545,380,165,708,306900,97040
711,542,169,875,361100,97041
1143,973,170,1204,337200,97042
19679,14738,4941,1054,296600,97045
2425,1720,705,724,208100,97048
765,624,141,-,216800,97049
120,72,48,715,116100,97050
5781,3796,1985,849,190900,97051
1249,983,266,1108,305300,97053
684,590,94,850,214200,97054
6846,5116,1730,1128,256700,97055
4593,3188,1405,835,241100,97056
5,5,0,-,-,97057
7627,4816,2811,749,181900,97058
7745,4776,2969,994,236000,97060
11341,6502,4839,1080,346900,97062
480,368,112,850,174000,97063
1287,1049,238,789,181300,97064
263,173,90,753,129700,97065
1016,770,246,765,252900,97067
11112,8590,2522,1303,413600,97068
9179,4237,4942,1126,362400,97070
9069,5685,3384,797,165900,97071
14987,10223,4764,1058,253200,97080
10264,6878,3386,1122,382600,97086
4444,4031,413,1401,362200,97089
1244,893,351,950,267600,97101
87,71,16,-,615100,97102
7353,4708,2645,783,234100,97103
1565,1363,202,1072,370100,97106
624,482,142,1000,197100,97107
163,138,25,-,242500,97108
223,217,6,-,325600,97109
567,233,334,801,493000,97110
1248,991,257,1270,275000,97111
762,571,191,739,247700,97112
4215,3232,983,882,202600,97113
1553,1105,448,1058,242300,97114
1396,1211,185,1159,256600,97115
8818,5463,3355,842,242400,97116
242,212,30,-,360300,97117
355,269,86,960,158900,97118
1514,1224,290,1154,350800,97119
587,327,260,881,257500,97121
213,200,13,-,198300,97122
15381,10362,5019,1066,249700,97123
19916,9773,10143,1215,290200,97124
24,24,0,-,333300,97125
1158,919,239,962,170400,97127
13545,8193,5352,870,216500,97128
190,145,45,906,448200,97130
1108,901,207,950,210500,97131
10124,6721,3403,976,259600,97132
1409,1157,252,1054,316600,97133
131,123,8,-,-,97134
391,362,29,-,220100,97135
791,557,234,929,176400,97136
406,250,156,744,338900,97137
4396,2278,2118,887,275100,97138
8777,6821,1956,1266,347800,97140
4963,3051,1912,755,220500,97141
51,31,20,-,-,97144
171,105,66,888,491100,97145
2344,1540,804,983,228600,97146
168,72,96,657,247500,97147
1190,1030,160,1052,320400,97148
287,244,43,-,394800,97149
8751,2691,6060,1197,550200,97201
18010,8860,9150,995,411800,97202
11848,6536,5312,962,252000,97203
396,40,356,604,464500,97204
4901,856,4045,880,512300,97205
19875,12182,7693,1104,257300,97206
0,0,0,-,-,97208
10736,2617,8119,1049,396800,97209
6287,2576,3711,1112,656900,97210
12752,8486,4266,1224,353400,97211
10822,6999,3823,1203,551400,97212
13694,8380,5314,976,359800,97213
11869,4302,7567,996,440600,97214
7708,4990,2718,1000,408200,97215
6461,2891,3570,1063,227300,97216
13794,8480,5314,1076,300600,97217
5476,3181,2295,896,273500,97218
16513,11613,4900,1134,376500,97219
11330,6201,5129,984,215200,97220
5144,3897,1247,951,485500,97221
15006,8066,6940,1004,239400,97222
19042,11079,7963,1039,332600,97223
14291,9668,4623,1083,325500,97224
11331,6331,5000,1151,417300,97225
2046,646,1400,1063,404300,97227
23715,16673,7042,1161,443000,97229
15134,8324,6810,907,233300,97230
1617,1411,206,1443,550800,97231
6387,2111,4276,1095,497500,97232
13039,6043,6996,911,183400,97233
12650,6901,5749,955,203600,97236
8123,3830,4293,1233,469100,97239
12170,6550,5620,944,195900,97266
12568,8794,3774,1045,273200,97267
17978,8013,9965,744,141700,97301
15918,9153,6765,822,223200,97302
14416,8910,5506,857,203800,97303
11380,7421,3959,905,235500,97304
13754,7216,6538,779,164800,97305
11665,7138,4527,943,237100,97306
7761,4863,2898,967,208800,97317
10148,7639,2509,856,232300,97321
13199,7146,6053,849,168700,97322
499,374,125,774,213400,97324
2658,2106,552,839,197100,97325
406,339,67,767,241100,97326
1124,816,308,930,192700,97327
68,68,0,-,229600,97329
17301,8756,8545,886,291100,97330
0,0,0,-,-,97331
8912,4137,4775,945,275700,97333
7637,5347,2290,731,204000,97338
1141,795,346,920,235900,97341
75,24,51,645,156300,97342
122,85,37,-,225000,97343
415,341,74,865,145900,97344
157,104,53,1082,162500,97345
358,261,97,622,166000,97346
794,501,293,597,190800,97347
598,331,267,575,160700,97348
97,54,43,709,112500,97350
3690,2089,1601,875,158600,97351
2156,1570,586,916,219800,97352
11078,7316,3762,859,165200,97355
104,104,0,-,338500,97357
1104,949,155,934,209800,97358
943,565,378,716,156300,97360
4090,2297,1793,758,213000,97361
1443,907,536,817,206300,97362
320,206,114,1137,371400,97364
4843,2528,2315,822,220800,97365
686,496,190,823,199400,97366
4187,2140,2047,801,227400,97367
1457,1138,319,834,161800,97368
90,86,4,-,275000,97369
3276,2558,718,777,247000,97370
182,143,39,-,373800,97371
0,0,0,-,-,97373
1934,1614,320,825,287300,97374
469,415,54,1142,200800,97375
589,487,102,1114,188300,97376
250,237,13,-,342000,97377
2441,1576,865,814,170000,97378
1091,829,262,571,170600,97380
5467,3999,1468,901,252000,97381
3410,1815,1595,827,209400,97383
0,0,0,-,-,97384
1297,855,442,900,240500,97385
5423,3716,1707,850,146400,97386
331,253,78,-,332200,97388
622,442,180,1080,202200,97389
379,211,168,688,257700,97390
1972,1326,646,852,195600,97391
2238,1737,501,1108,235800,97392
2171,1514,657,815,221200,97394
1129,829,300,875,157600,97396
18990,5896,13094,898,274000,97401
20983,10388,10595,858,175500,97402
3702,1797,1905,938,343600,97403
12973,8866,4107,988,216000,97404
19276,12716,6560,1024,286800,97405
17,17,0,-,-,97406
5187,3509,1678,1120,266400,97408
422,293,129,543,267900,97410
3242,2055,1187,671,220700,97411
188,147,41,1048,253800,97412
385,278,107,664,230000,97413
196,28,168,983,-,97414
6507,4061,2446,866,238200,97415
405,292,113,611,191300,97416
1081,568,513,693,127200,97417
532,420,112,1108,264600,97419
10842,6638,4204,736,167100,97420
2658,1876,782,713,154900,97423
7274,4916,2358,835,180900,97424
3786,2983,803,871,211800,97426
331,242,89,588,198500,97429
165,109,56,833,199000,97430
922,765,157,865,295700,97431
331,249,82,708,176000,97434
915,644,271,638,150900,97435
373,265,108,715,254800,97436
1045,837,208,857,249100,97437
384,320,64,648,256700,97438
6940,4727,2213,793,207000,97439
111,91,20,-,166100,97441
867,601,266,713,167000,97442
818,538,280,594,258200,97443
2402,1725,677,791,208800,97444
1653,1207,446,967,167800,97446
339,192,147,726,86100,97447
4702,3294,1408,865,239300,97448
967,814,153,718,156100,97449
254,225,29,-,188800,97450
148,130,18,-,329600,97451
609,513,96,918,207800,97452
441,273,168,700,219900,97453
504,422,82,988,240500,97454
959,790,169,993,299000,97455
1078,769,309,668,233600,97456
3923,2704,1219,802,154200,97457
1944,1404,540,683,148300,97458
5527,3607,1920,763,183800,97459
272,189,83,-,247000,97461
1675,1182,493,766,216300,97462
1691,1159,532,700,118500,97463
1129,748,381,635,164700,97465
390,289,101,321,111500,97466
2201,1421,780,585,143500,97467
1041,756,285,782,147600,97469
8438,5315,3123,743,157500,97470
11861,8306,3555,853,205300,97471
142,138,4,-,178400,97473
87,87,0,-,-,97476
15579,7626,7953,782,172200,97477
14211,9410,4801,898,196500,97478
3758,2577,1181,825,152500,97479
143,88,55,615,175000,97480
301,243,58,585,213700,97481
97,74,23,761,163100,97484
330,271,59,786,293400,97486
3109,2316,793,979,184700,97487
465,384,81,870,334000,97488
349,304,45,-,361000,97489
106,83,23,-,332100,97490
304,240,64,874,131300,97492
146,123,23,-,280500,97493
14,14,0,-,-,97494
684,572,112,900,284700,97495
2891,1768,1123,682,154600,97496
647,479,168,639,221500,97497
812,533,279,924,313100,97498
751,494,257,604,153000,97499
16694,9013,7681,836,163700,97501
10811,7727,3084,893,200400,97502
3627,2784,843,1022,155800,97503
18301,10208,8093,901,248500,97504
11481,6687,4794,971,371900,97520
205,158,47,815,127400,97522
2898,1955,943,710,185400,97523
5284,3844,1440,1046,238700,97524
1865,1570,295,770,207600,97525
14362,8939,5423,792,225900,97526
14088,9530,4558,932,226600,97527
3040,2284,756,932,310400,97530
234,142,92,-,-,97531
952,792,160,685,287800,97532
316,128,188,525,182800,97534
2428,1654,774,728,175800,97535
466,336,130,761,184400,97536
3340,2113,1227,772,217100,97537
781,602,179,658,207100,97538
1578,1225,353,1015,168600,97539
3575,2301,1274,978,218100,97540
603,427,176,826,212300,97541
275,217,58,931,276500,97543
896,683,213,563,285600,97544
9261,4694,4567,739,151700,97601
11683,7884,3799,721,147200,97603
9,0,9,-,-,97604
87,31,56,243,117700,97620
68,46,22,-,-,97621
177,149,28,670,102700,97622
987,784,203,672,143800,97623
1570,1259,311,694,133200,97624
109,80,29,-,118400,97625
45,35,10,-,-,97626
384,384,0,-,173200,97627
2123,1220,903,631,129900,97630
523,356,167,656,131100,97632
517,363,154,610,175200,97633
77,77,0,-,134800,97634
115,92,23,-,155400,97635
219,120,99,435,90000,97636
40,26,14,525,116700,97637
167,154,13,-,110600,97638
372,327,45,-,151600,97639
63,42,21,250,187500,97640
601,426,175,384,67900,97641
26221,15634,10587,1012,320500,97701
17435,12451,4984,1076,298900,97702
2571,1815,756,933,225800,97707
68,38,30,-,237500,97710
34,28,6,750,328600,97711
5,5,0,-,-,97712
1886,1385,501,570,86700,97720
151,100,51,-,-,97721
38,15,23,675,-,97722
112,81,31,850,418400,97730
107,79,28,-,"10,000-",97731
47,26,21,496,183300,97732
166,83,83,-,161300,97733
1004,733,271,790,163000,97734
47,47,0,-,178100,97735
43,19,24,850,208300,97736
332,161,171,882,141500,97737
674,472,202,553,110800,97738
4802,3705,1097,859,156700,97739
3991,2440,1551,792,124700,97741
183,140,43,594,125000,97750
26,26,0,-,-,97751
29,5,24,-,-,97752
867,696,171,1408,400900,97753
8110,5533,2577,757,162600,97754
13922,8440,5482,895,224700,97756
46,27,19,-,338900,97758
2583,1935,648,1030,372600,97759
2741,2349,392,936,201300,97760
1081,712,369,511,114300,97761
7672,4574,3098,656,155500,97801
313,245,68,950,191100,97810
330,210,120,768,134800,97812
469,312,157,770,145900,97813
5296,3610,1686,641,142500,97814
8,8,0,-,-,97817
1375,949,426,708,121300,97818
16,8,8,-,-,97819
465,371,94,546,141500,97820
440,279,161,824,96800,97823
688,547,141,856,255200,97824
140,106,34,585,115900,97825
391,263,128,695,121300,97826
984,709,275,700,147600,97827
1365,902,463,716,199300,97828
355,245,110,554,104200,97830
415,231,184,724,165100,97833
429,294,135,617,190000,97834
114,90,24,821,145300,97835
782,529,253,737,154100,97836
43,21,22,-,-,97837
9119,5971,3148,703,151000,97838
104,85,19,1080,88900,97839
55,16,39,252,333300,97840
191,159,32,1060,208300,97841
69,49,20,-,-,97842
237,183,54,822,159900,97843
1344,1015,329,732,120800,97844
1089,719,370,731,151200,97845
861,618,243,625,274600,97846
94,65,29,475,245000,97848
6676,3863,2813,686,163900,97850
137,95,42,581,233900,97856
218,131,87,854,259400,97857
5,5,0,-,-,97859
4226,2783,1443,656,128700,97862
98,72,26,594,160000,97864
591,467,124,518,198300,97865
294,190,104,775,209500,97867
759,502,257,729,113600,97868
414,280,134,805,133800,97869
262,212,50,494,156300,97870
84,79,5,-,67900,97873
168,137,31,600,115100,97874
1020,637,383,876,119900,97875
356,321,35,917,296200,97876
175,157,18,820,147200,97877
142,102,40,758,109600,97880
1955,1049,906,608,118500,97882
904,628,276,685,132300,97883
77,48,29,813,157100,97884
526,362,164,664,163600,97885
501,415,86,716,115300,97886
287,175,112,696,161300,97901
57,32,25,-,223300,97903
88,61,27,-,222900,97904
79,44,35,-,-,97905
115,81,34,608,187500,97906
208,155,53,533,75800,97907
24,12,12,938,-,97908
23,23,0,-,-,97909
233,159,74,575,116900,97910
34,15,19,-,-,97911
1751,1110,641,660,106700,97913
6048,3438,2610,639,126600,97914
1608,1000,608,580,132700,97918
105,63,42,-,187300,97920
10871,8329,2542,1373,265400,98001
12765,6290,6475,998,169400,98002
18010,8636,9374,1030,220600,98003
15598,7330,8268,1809,866600,98004
7520,4151,3369,1557,616400,98005
13378,10416,2962,1729,679900,98006
10639,3872,6767,1492,438600,98007
9038,6467,2571,1557,515700,98008
1981,1775,206,974,342600,98010
12820,8483,4337,1403,382400,98011
21330,14651,6679,1456,371700,98012
2634,2111,523,1161,423000,98014
4098,3439,659,1457,409600,98019
8530,6351,2179,1288,472700,98020
10334,8277,2057,1616,387000,98021
8474,5934,2540,956,313200,98022
17681,11883,5798,1211,280900,98023
2118,1766,352,1114,596300,98024
14559,10737,3822,1220,364800,98026
11142,7814,3328,1389,516900,98027
8227,5961,2266,1196,427700,98028
10547,7077,3470,1841,470800,98029
11789,5791,5998,1105,256700,98030
12382,8097,4285,1134,275400,98031
13567,5553,8014,1032,226200,98032
15883,10174,5709,1667,617200,98033
17194,10622,6572,1440,405300,98034
14215,9035,5180,1093,332800,98036
10326,5847,4479,1167,325400,98037
12084,10227,1857,1559,337300,98038
1141,1019,122,"3,500+",1654600,98039
9820,7022,2798,1793,956200,98040
16059,13125,2934,1533,303800,98042
8194,4654,3540,1233,274600,98043
5426,4140,1286,1280,391800,98045
2382,1162,1220,1070,202500,98047
49,49,0,-,-,98050
1261,966,295,1475,377700,98051
25255,13590,11665,1618,542400,98052
8043,6657,1386,1763,605000,98053
9133,4705,4428,1356,274900,98055
13830,7348,6482,1243,378000,98056
5854,1522,4332,1137,291000,98057
15690,11309,4381,1323,320000,98058
13408,10480,2928,1352,391400,98059
4703,3852,851,1782,460200,98065
108,101,7,-,398700,98068
4635,3590,1045,967,399900,98070
8695,6445,2250,1416,531700,98072
8913,7711,1202,2191,613400,98074
7470,6496,974,1930,704100,98075
4895,4588,307,1917,627200,98077
12725,6504,6221,1381,294000,98087
15488,10868,4620,1205,299400,98092
8213,1553,6660,1324,463800,98101
14565,4333,10232,1348,470000,98102
23311,10880,12431,1342,552600,98103
7529,836,6693,940,387000,98104
15779,5580,10199,1199,652200,98105
10454,4953,5501,1078,306100,98106
12429,4634,7795,1356,528700,98107
8336,4665,3671,946,341600,98108
14729,4153,10576,1517,524700,98109
9655,7468,2187,1233,569700,98110
10645,5846,4799,1375,825100,98112
21330,13340,7990,1436,559800,98115
11860,6766,5094,1323,559300,98116
14039,9962,4077,1472,548700,98117
16039,9128,6911,1066,370500,98118
11911,4887,7024,1348,650900,98119
10066,1875,8191,1489,434300,98121
17119,5628,11491,1267,485000,98122
18188,8638,9550,1135,402500,98125
9749,5510,4239,1165,391800,98126
21269,10109,11160,1120,346200,98133
199,59,140,1142,276100,98134
7223,4897,2326,1246,512500,98136
12594,5758,6836,1003,449600,98144
9670,5812,3858,1042,315700,98146
4464,1767,2697,1036,265800,98148
0,0,0,-,-,98154
13261,9087,4174,1248,368900,98155
0,0,0,-,-,98158
97,76,21,-,619800,98164
8372,5385,2987,955,403900,98166
11472,5856,5616,1049,243100,98168
0,0,0,-,-,98174
7951,6272,1679,1322,530700,98177
8973,5260,3713,1224,295900,98178
9631,4202,5429,978,241700,98188
0,0,0,-,-,98195
13382,7322,6060,1123,265200,98198
9267,5994,3273,1341,656800,98199
12631,4855,7776,876,227700,98201
13257,7819,5438,1150,265300,98203
16574,5285,11289,1065,194300,98204
4475,3646,829,1531,273300,98205
0,0,0,-,-,98207
20028,13328,6700,1248,298900,98208
287,204,83,-,219900,98220
9142,6382,2760,1055,350500,98221
27,27,0,-,587500,98222
15093,11588,3505,1141,276600,98223
139,92,47,638,188500,98224
19623,7991,11632,901,306200,98225
16294,10274,6020,984,303000,98226
12187,7998,4189,977,303200,98229
6608,4935,1673,1018,258300,98230
1711,1457,254,1027,344200,98232
5882,3667,2215,991,222900,98233
41,28,13,-,179400,98235
2639,2037,602,1058,371100,98236
1648,1132,516,949,168500,98237
6,6,0,-,-,98238
3220,2505,715,884,318700,98239
1174,913,261,1299,263300,98240
818,530,288,826,172900,98241
217,176,41,-,561400,98243
1253,915,338,550,269600,98244
1892,1299,593,828,439300,98245
3335,2461,874,845,256600,98247
8502,6235,2267,921,268800,98248
1920,1429,491,994,307800,98249
3536,2531,1005,1045,437900,98250
1812,1448,364,1113,180300,98251
3631,2716,915,1273,212300,98252
890,785,105,-,389900,98253
54,33,21,869,87500,98255
195,129,66,930,160100,98256
1739,1280,459,1171,283200,98257
11052,8317,2735,1372,292000,98258
2591,1948,643,1117,417900,98260
1233,905,328,1009,482000,98261
468,368,100,968,402700,98262
36,20,16,1050,112500,98263
7242,5308,1934,947,282700,98264
1408,845,563,934,129100,98266
225,158,67,-,193800,98267
17224,11394,5830,1183,255400,98270
10204,7431,2773,1283,236200,98271
8855,6617,2238,1156,289200,98272
10591,6419,4172,838,228400,98273
6562,4969,1593,1130,263700,98274
8047,5541,2506,1479,454300,98275
184,150,34,1364,235700,98276
15647,8169,7478,1079,247600,98277
0,0,0,-,-,98278
276,220,56,825,556100,98279
252,228,24,850,527200,98280
650,512,138,779,229200,98281
6481,5543,938,1322,305600,98282
152,99,53,-,210600,98283
9141,6178,2963,1026,220900,98284
87,67,20,863,703100,98286
95,74,21,842,293800,98288
12431,9544,2887,998,356700,98290
8299,6496,1803,990,308200,98292
2679,1840,839,1333,192000,98294
946,570,376,891,216800,98295
9689,8392,1297,1649,428700,98296
33,27,6,-,562500,98297
614,570,44,-,237800,98303
311,226,85,709,133800,98304
149,132,17,-,190600,98305
8682,4462,4220,884,203700,98310
9979,7267,2712,1203,224400,98311
12609,7621,4988,1007,213300,98312
9,0,9,-,-,98314
1264,0,1264,1367,-,98315
544,447,97,713,214900,98320
5082,4175,907,1164,255900,98321
267,214,53,1164,192500,98323
702,563,139,585,171300,98325
258,133,125,660,155200,98326
3193,1612,1581,1736,312000,98327
3728,2993,735,873,237700,98328
3818,3261,557,1144,243700,98329
26,26,0,-,-,98330
2439,1583,856,602,126100,98331
6354,5201,1153,1384,378600,98332
1404,1313,91,1105,468900,98333
9781,7094,2687,1230,383100,98335
397,313,84,527,141400,98336
2999,1092,1907,819,151200,98337
9117,7935,1182,1262,222600,98338
1360,849,511,741,178800,98339
1409,1246,163,866,278900,98340
590,435,155,1267,366800,98342
189,124,65,1204,306900,98345
3778,2892,886,1127,297200,98346
1783,1384,399,876,204600,98349
125,67,58,467,69400,98350
414,362,52,-,390100,98351
15,0,15,-,-,98353
2861,1710,1151,1142,236300,98354
276,276,0,-,115300,98355
920,726,194,768,152300,98356
505,343,162,470,100300,98357
478,417,61,1069,428100,98358
1645,1459,186,1318,294500,98359
4392,3594,798,1431,233200,98360
514,403,111,816,146200,98361
10010,6588,3422,775,211700,98362
5553,3887,1666,914,203000,98363
54,0,54,-,-,98364
2103,1810,293,1363,340200,98365
12186,7724,4462,1056,225600,98366
10366,8565,1801,1245,253400,98367
7159,4955,2204,915,305400,98368
11448,8874,2574,1154,317400,98370
8312,5686,2626,985,259900,98371
9302,5340,3962,1121,259400,98372
8550,4741,3809,1114,248000,98373
13473,9412,4061,1329,248900,98374
9595,6931,2664,1391,226000,98375
786,664,122,845,253200,98376
748,545,203,544,145600,98377
1794,1494,300,1086,268600,98380
188,122,66,726,158700,98381
12640,9414,3226,945,254400,98382
8301,4531,3770,1170,293100,98383
112,97,15,1375,193800,98385
15221,11326,3895,1186,191500,98387
2520,1539,981,1047,295300,98388
4278,2254,2024,991,237200,98390
16231,13482,2749,1373,275700,98391
1278,927,351,1023,199900,98392
475,433,42,1250,259300,98394
231,189,42,1375,196700,98396
3355,439,2916,964,338100,98402
4299,1571,2728,874,364900,98403
10950,6139,4811,944,157800,98404
9569,4221,5348,849,187400,98405
9553,5861,3692,961,274300,98406
9014,5146,3868,1187,291700,98407
7072,4089,2983,1084,170700,98408
9466,3561,5905,1011,157600,98409
0,0,0,-,-,98416
3685,2150,1535,962,165900,98418
10,0,10,-,-,98421
7510,5728,1782,1355,314900,98422
3874,1561,2313,1042,241700,98424
5,5,0,-,-,98430
3958,18,3940,1468,-,98433
0,0,0,-,-,98438
2030,335,1695,1057,18400,98439
2239,1851,388,1098,245100,98443
12772,4415,8357,896,169400,98444
10809,7113,3696,1140,193500,98445
3912,2695,1217,949,251100,98446
0,0,0,-,-,98447
3035,1432,1603,870,292300,98465
11174,5762,5412,1047,281400,98466
6183,3177,3006,934,307500,98467
11137,6709,4428,957,232700,98498
12635,4262,8373,847,196800,98499
16957,9847,7110,996,272100,98501
13045,7408,5637,1029,307300,98502
14930,7577,7353,1089,213600,98503
7932,4839,3093,956,255000,98506
11600,7870,3730,1058,242100,98512
12379,8940,3439,1357,235100,98513
8714,6148,2566,1187,273200,98516
8102,4947,3155,723,139900,98520
1465,1272,193,1000,297300,98524
97,58,39,583,73300,98526
129,120,9,-,-,98527
3202,2528,674,908,235500,98528
216,131,85,850,107900,98530
9649,5640,4009,837,160100,98531
8951,6252,2699,858,213500,98532
255,218,37,-,180800,98533
216,99,117,871,-,98535
111,66,45,-,259100,98536
797,617,180,1022,179400,98537
97,63,34,775,251400,98538
3586,2527,1059,636,177700,98541
204,155,49,813,189200,98542
0,0,0,-,-,98544
1134,960,174,997,251500,98546
529,459,70,484,154600,98547
1115,1002,113,1217,169800,98548
4737,3000,1737,723,123500,98550
218,173,45,564,122000,98552
119,94,25,-,318500,98555
1244,857,387,1070,149800,98557
97,55,42,-,-,98558
24,0,24,-,-,98559
73,73,0,-,198800,98560
0,0,0,-,-,98562
3023,2349,674,895,196100,98563
908,704,204,659,181200,98564
229,180,49,739,170700,98565
992,718,274,861,180600,98568
3011,2194,817,798,181100,98569
1554,1135,419,823,188500,98570
146,146,0,-,-,98571
289,239,50,578,136100,98572
73,60,13,-,141700,98575
1855,1428,427,918,208700,98576
2713,2037,676,664,141400,98577
4678,3807,871,1176,204100,98579
3974,3220,754,940,244300,98580
181,161,20,-,107800,98581
185,128,57,-,211500,98582
54,41,13,-,110200,98583
13332,9616,3716,884,184600,98584
339,243,96,1017,173000,98585
733,471,262,604,114500,98586
226,163,63,413,92400,98587
756,668,88,1292,243500,98588
2649,2048,601,1026,222800,98589
210,137,73,651,134200,98590
1448,1133,315,770,179800,98591
567,567,0,-,303800,98592
389,294,95,903,130000,98593
1231,652,579,651,162200,98595
2522,1756,766,866,184100,98596
7957,5550,2407,1191,197300,98597
1042,747,295,1238,258100,98601
62,52,10,-,225000,98602
483,416,67,674,259600,98603
11566,9164,2402,981,276400,98604
417,236,181,829,187500,98605
3060,2757,303,905,346700,98606
10543,7995,2548,1206,344100,98607
1179,805,374,830,197500,98610
3878,3178,700,738,195100,98611
1129,878,251,904,214100,98612
151,100,51,1051,181300,98613
99,99,0,-,159800,98614
77,70,7,-,227400,98616
468,390,78,-,156900,98617
196,124,72,722,234600,98619
2792,1826,966,733,146200,98620
225,185,40,409,176900,98621
718,443,275,856,212500,98624
2485,1961,524,793,215200,98625
9098,5907,3191,787,172500,98626
169,91,78,525,88600,98628
2835,2461,374,1331,286300,98629
1725,1200,525,710,162100,98631
19585,11532,8053,776,169200,98632
770,569,201,776,226800,98635
493,404,89,870,183500,98638
492,272,220,696,228300,98639
1877,1550,327,840,169100,98640
0,0,0,-,-,98641
6291,5133,1158,1346,330900,98642
204,192,12,-,173600,98643
123,60,63,1031,137500,98644
465,377,88,981,151200,98645
151,120,31,-,168200,98647
1230,763,467,644,254800,98648
398,322,76,-,181300,98649
332,242,90,967,368600,98650
323,216,107,1088,337200,98651
5341,2337,3004,791,212000,98660
17838,7455,10383,884,205500,98661
12007,7627,4380,1089,210100,98662
5810,3341,2469,922,209100,98663
8823,4868,3955,1024,217900,98664
9713,6008,3705,943,228600,98665
38,32,6,-,210700,98670
8134,6095,2039,988,275800,98671
2428,1653,775,939,296700,98672
222,127,95,675,93200,98673
4093,3059,1034,855,251200,98674
2015,1692,323,1022,256000,98675
18565,12891,5674,1122,211700,98682
13351,7372,5979,1151,260100,98683
10136,5353,4783,1108,226600,98684
10107,7883,2224,1222,285700,98685
7237,5205,2032,1214,292100,98686
14958,9204,5754,814,225200,98801
10788,7922,2866,851,229000,98802
25,19,6,-,132500,98811
1545,872,673,589,156800,98812
865,446,419,673,100000,98813
217,186,31,-,291700,98814
2537,1653,884,730,266200,98815
2616,1842,774,774,283600,98816
117,85,32,-,195800,98817
116,84,32,529,175000,98819
170,118,52,-,359000,98821
801,651,150,858,238600,98822
3745,2371,1374,671,154800,98823
120,45,75,616,115300,98824
2923,2101,822,1002,312200,98826
85,67,18,-,-,98827
873,702,171,815,255500,98828
226,99,127,-,338300,98829
239,184,55,289,115800,98830
1293,847,446,574,268800,98831
88,75,13,-,225000,98832
51,51,0,-,407100,98833
67,57,10,-,209000,98834
274,194,80,-,268100,98836
14339,8891,5448,788,165900,98837
1894,1283,611,609,130800,98840
3439,2063,1376,658,162600,98841
590,286,304,768,278800,98843
2077,1358,719,613,157500,98844
81,64,17,763,264300,98845
443,254,189,616,231400,98846
626,481,145,521,250500,98847
3562,2112,1450,703,145600,98848
479,354,125,629,127800,98849
540,413,127,927,154000,98850
1752,1250,502,670,136200,98851
11,5,6,-,241700,98852
8,8,0,-,-,98853
2802,2107,695,627,150800,98855
1224,869,355,598,287100,98856
1173,813,360,665,102800,98857
824,572,252,677,154700,98858
125,78,47,-,169400,98859
157,102,55,773,83700,98860
1001,803,198,748,330500,98862
9918,5357,4561,682,149800,98901
16322,8485,7837,763,139200,98902
5123,3753,1370,819,140400,98903
14286,10127,4159,925,206600,98908
239,51,188,911,-,98921
2637,1895,742,871,263100,98922
380,205,175,637,106300,98923
242,160,82,698,315400,98925
12473,6384,6089,833,250500,98926
0,0,0,-,-,98929
4591,3136,1455,747,139500,98930
1269,818,451,934,107000,98932
347,240,107,769,119300,98933
402,207,195,919,151800,98934
942,685,257,791,111000,98935
1828,1352,476,877,180200,98936
1484,1083,401,926,176600,98937
764,535,229,1182,203400,98938
43,34,9,-,-,98939
200,185,15,-,179700,98940
313,204,109,908,196400,98941
6188,4411,1777,867,209000,98942
469,233,236,1145,173700,98943
6181,3589,2592,653,149400,98944
230,150,80,833,288100,98946
919,622,297,833,178000,98947
3505,2063,1442,660,117000,98948
103,15,88,-,-,98950
3598,2090,1508,685,119300,98951
539,310,229,561,100000,98952
2033,1552,481,934,180600,98953
1363,687,676,855,150800,99001
1977,1773,204,832,258800,99003
6980,3929,3051,803,190800,99004
2804,2440,364,1535,290900,99005
4354,3767,587,653,200600,99006
274,212,62,546,176500,99008
1375,1023,352,784,230100,99009
701,6,695,1174,-,99011
333,222,111,792,172900,99012
579,412,167,389,175000,99013
5092,3955,1137,925,209200,99016
65,40,25,785,60000,99017
111,71,40,668,158900,99018
4149,2851,1298,971,288400,99019
0,0,0,-,-,99020
3472,3000,472,929,215200,99021
3320,2457,863,646,199700,99022
247,206,41,-,327600,99023
1892,1581,311,633,248100,99025
3684,3214,470,943,240600,99026
2390,2037,353,1065,179500,99027
478,355,123,838,149800,99029
397,329,68,950,163500,99030
452,316,136,622,206000,99031
303,253,50,920,101400,99032
399,262,137,596,114300,99033
0,0,0,-,-,99034
583,499,84,812,292900,99036
5285,3551,1734,792,220600,99037
35,31,4,-,122500,99039
260,185,75,383,91400,99040
585,441,144,726,158200,99101
249,186,63,640,82900,99102
223,178,45,755,152400,99103
24,17,7,-,83800,99105
2251,1540,711,610,167000,99109
510,298,212,630,181000,99110
1809,1081,728,592,163600,99111
328,276,52,912,207900,99113
5011,3693,1318,664,172200,99114
477,320,157,578,170800,99115
687,502,185,731,142600,99116
203,160,43,567,119300,99117
323,218,105,618,181300,99118
501,436,65,918,164800,99119
44,42,2,-,119700,99121
1492,1233,259,663,168000,99122
420,317,103,762,169100,99123
145,104,41,950,105700,99124
224,163,61,450,89000,99125
394,242,152,824,224200,99126
82,63,19,831,157500,99128
309,233,76,615,121500,99129
346,246,100,653,152900,99130
88,81,7,563,227500,99131
754,452,302,613,118800,99133
197,133,64,753,107600,99134
132,86,46,670,150000,99135
14,14,0,-,83300,99136
152,108,44,615,151500,99137
478,292,186,438,88700,99138
567,421,146,596,196600,99139
152,92,60,285,98000,99140
2143,1550,593,716,170100,99141
295,220,75,558,97500,99143
10,6,4,-,-,99144
20,20,0,-,175000,99146
81,75,6,-,267500,99147
833,711,122,712,214800,99148
88,80,8,463,72500,99149
123,107,16,825,-,99150
58,58,0,-,126300,99151
74,53,21,628,147500,99152
232,124,108,525,182000,99153
12,12,0,-,75000,99154
401,254,147,417,82900,99155
3416,2602,814,828,174600,99156
309,213,96,628,134700,99157
234,167,67,811,119900,99158
643,482,161,672,122200,99159
84,73,11,639,57500,99160
620,499,121,529,168200,99161
11300,3546,7754,737,231200,99163
0,0,0,-,-,99164
1375,901,474,663,165400,99166
259,245,14,857,162700,99167
1010,689,321,676,134700,99169
417,329,88,418,116600,99170
475,306,169,635,127100,99171
621,497,124,738,150900,99173
23,17,6,450,104700,99174
73,47,26,675,166100,99176
215,183,32,635,227300,99179
368,307,61,603,165400,99180
744,570,174,533,136100,99181
525,403,122,606,125400,99185
6536,1720,4816,602,146400,99201
6850,2885,3965,726,138400,99202
9068,6537,2531,992,238400,99203
3374,1016,2358,594,167300,99204
17769,11556,6213,892,140000,99205
14611,9167,5444,810,181700,99206
11700,5877,5823,827,109800,99207
20204,13202,7002,764,210700,99208
8169,5558,2611,831,146000,99212
10390,5187,5203,844,172900,99216
7075,4551,2524,790,163500,99217
5956,3160,2796,769,218300,99218
12975,8066,4909,873,239200,99223
8329,5450,2879,898,235700,99224
22467,15564,6903,850,172200,99301
3487,2770,717,741,160100,99320
134,89,45,-,-,99321
80,60,20,546,165000,99322
1305,1104,201,1021,170800,99323
3684,2122,1562,801,178400,99324
1349,796,553,654,136700,99326
1545,1093,452,747,163300,99328
90,78,12,-,151700,99329
326,183,143,425,163500,99330
7,5,2,-,-,99333
117,76,41,520,120500,99335
18174,8880,9294,818,152000,99336
10763,9170,1593,958,182500,99337
4843,4483,360,966,271900,99338
283,193,90,695,111200,99341
780,413,367,598,158400,99343
4780,3135,1645,694,152100,99344
62,34,28,392,264300,99345
182,152,30,673,176900,99346
986,713,273,586,135900,99347
413,178,235,697,124200,99348
1823,849,974,637,164000,99349
4704,3138,1566,688,169300,99350
11782,7964,3818,951,240600,99352
5106,4286,820,962,210500,99353
9095,5777,3318,849,183300,99354
93,41,52,571,131300,99356
900,374,526,669,122500,99357
68,52,16,-,107100,99359
444,326,118,759,276600,99360
728,558,170,697,165800,99361
15165,9804,5361,771,202400,99362
55,16,39,-,-,99363
191,153,38,758,82100,99371
99,88,11,-,-,99401
737,568,169,757,257100,99402
8474,5574,2900,706,174300,99403
7514,2340,5174,1027,325800,99501
8808,5667,3141,1231,297600,99502
5912,1863,4049,1017,235600,99503
14260,9205,5055,1290,259200,99504
1068,0,1068,2197,-,99505
2098,19,2079,2027,-,99506
13965,9638,4327,1325,287100,99507
12232,6239,5993,1071,255400,99508
0,0,0,-,-,99510
0,0,0,-,-,99513
7769,5650,2119,1392,314800,99515
7075,6547,528,1443,445100,99516
6777,3704,3073,1257,298300,99517
4010,2540,1470,1389,255300,99518
0,0,0,-,-,99519
157,142,15,-,262900,99540
36,20,16,1125,21700,99546
18,12,6,950,116700,99547
31,28,3,-,100000,99548
23,16,7,700,100000,99549
96,84,12,650,154500,99550
135,100,35,650,89300,99551
93,72,21,775,83300,99552
54,30,24,338,95700,99553
154,122,32,728,103800,99554
58,49,9,-,198800,99555
1079,911,168,885,172000,99556
220,147,73,1083,176100,99557
39,30,9,-,66700,99558
2233,1165,1068,1350,232400,99559
98,76,22,600,106300,99561
241,184,57,757,89200,99563
14,8,6,-,-,99564
25,23,2,-,262500,99565
55,46,9,458,-,99566
3256,2497,759,1207,329000,99567
143,134,9,-,185400,99568
15,11,4,-,62500,99569
52,17,35,900,143800,99571
182,139,43,-,375500,99572
226,192,34,688,150900,99573
996,774,222,866,299300,99574
23,17,6,-,220800,99575
817,442,375,1185,252200,99576
9127,6795,2332,1889,331600,99577
110,81,29,413,57700,99578
22,15,7,-,115600,99579
28,22,6,-,117900,99580
191,145,46,675,104900,99581
31,7,24,-,112500,99583
80,57,23,375,117200,99585
86,56,30,-,211500,99586
856,410,446,1108,447100,99587
206,141,65,705,114200,99588
59,50,9,-,68600,99589
47,26,21,363,133300,99590
24,14,10,-,76700,99591
64,49,15,688,87500,99602
3948,2718,1230,932,264700,99603
224,150,74,450,101300,99604
43,37,6,-,302600,99605
117,77,40,750,123900,99606
76,60,16,975,169400,99607
112,89,23,650,63800,99609
831,719,112,768,235900,99610
5995,3960,2035,953,218100,99611
246,149,97,937,128500,99612
154,70,84,1167,200000,99613
168,138,30,531,95000,99614
4292,2554,1738,1270,276200,99615
145,106,39,608,72200,99620
168,133,35,525,93100,99621
65,48,17,-,184400,99622
21,15,6,525,78800,99624
30,20,10,-,162500,99625
75,67,8,-,189100,99626
152,96,56,917,88600,99627
139,99,40,550,87500,99628
75,59,16,675,78300,99630
138,122,16,-,215400,99631
174,117,57,625,74600,99632
205,128,77,850,205000,99633
109,77,32,400,71700,99634
113,80,33,464,121600,99636
110,76,34,850,80000,99637
16,6,10,850,-,99638
455,355,100,904,168800,99639
69,46,23,719,137500,99640
111,81,30,613,56300,99641
98,78,20,725,76300,99643
78,54,24,800,103600,99644
8510,6553,1957,1019,239200,99645
7,5,2,-,137500,99647
30,23,7,675,91000,99648
27,23,4,725,154200,99649
129,103,26,450,105400,99650
8,6,2,-,175000,99651
1348,1044,304,1023,190600,99652
47,16,31,975,333300,99653
18005,13425,4580,1122,234300,99654
161,137,24,633,112500,99655
14,14,0,-,116700,99656
74,61,13,-,117200,99657
175,136,39,-,120500,99658
99,52,47,917,66000,99659
154,85,69,892,86800,99660
405,240,165,976,136700,99661
114,78,36,488,92900,99662
201,150,51,608,208300,99663
1513,931,582,764,173000,99664
25,16,9,-,66000,99665
33,25,8,765,115600,99666
48,48,0,-,-,99667
26,16,10,-,125000,99668
5532,4074,1458,1127,231700,99669
27,17,10,-,121900,99670
129,87,42,444,131700,99671
1337,1075,262,1021,283900,99672
529,411,118,775,163100,99674
634,461,173,1000,144500,99676
35,21,14,658,-,99677
205,129,76,592,119100,99678
81,53,28,463,65000,99679
105,70,35,444,57500,99680
76,54,22,750,75000,99681
84,57,27,767,28500,99682
184,141,43,1055,127100,99683
218,145,73,979,144800,99684
862,199,663,1419,339900,99685
1158,798,360,1085,188500,99686
1005,855,150,968,168600,99688
247,149,98,975,165800,99689
43,35,8,-,73800,99690
39,25,14,575,47500,99691
76,0,76,600,-,99692
121,55,66,815,66100,99693
559,427,132,986,179800,99694
0,0,0,-,-,99695
7175,3089,4086,1109,186300,99701
833,0,833,2102,-,99702
1719,11,1708,2108,-,99703
0,0,0,-,-,99704
8176,5806,2370,1426,218300,99705
2,2,0,-,-,99706
12059,7702,4357,1104,239300,99709
4795,4027,768,1009,243500,99712
471,374,97,1151,198700,99714
62,38,24,558,75000,99720
73,45,28,900,112500,99721
48,35,13,-,-,99722
1370,603,767,1097,177800,99723
26,21,5,-,101800,99724
13,9,4,-,154200,99726
133,77,56,758,87500,99727
98,78,20,850,152500,99729
34,23,11,-,140600,99730
0,0,0,-,-,99732
38,19,19,621,237500,99733
0,0,0,-,-,99734
40,25,15,1125,63800,99736
1392,985,407,1226,230600,99737
52,36,16,-,91700,99738
91,58,33,742,80000,99739
220,145,75,656,88300,99740
197,156,41,1313,117400,99741
162,135,27,575,68100,99742
428,306,122,950,242600,99743
64,57,7,933,121600,99744
25,10,15,-,65000,99745
116,92,24,625,107400,99746
57,46,11,867,100000,99747
59,46,13,638,-,99748
98,63,35,800,88100,99749
129,85,44,833,91300,99750
29,17,12,650,97500,99751
957,431,526,1430,194900,99752
64,48,16,733,80000,99753
39,19,20,463,65000,99754
105,80,25,1104,330000,99755
42,34,8,-,98300,99756
18,15,3,-,86300,99757
69,47,22,-,91000,99758
77,31,46,900,85000,99759
245,181,64,700,112500,99760
85,69,16,850,120800,99761
1429,733,696,1510,208300,99762
125,74,51,820,115000,99763
81,61,20,-,96900,99764
84,66,18,550,65000,99765
171,110,61,731,89500,99766
4,2,2,-,-,99767
69,57,12,375,129200,99768
197,160,37,900,61800,99769
165,115,50,683,93100,99770
72,58,14,538,100000,99771
147,108,39,757,76100,99772
54,38,16,694,96000,99773
6,5,1,-,-,99774
79,0,79,-,-,99775
56,42,14,775,96000,99776
108,74,34,488,52500,99777
51,31,20,475,103100,99778
569,403,166,813,154500,99780
63,49,14,475,-,99781
127,77,50,900,97900,99782
59,31,28,575,-,99783
70,34,36,817,100000,99784
91,52,39,875,83300,99785
82,50,32,775,100000,99786
38,27,11,-,54400,99788
93,61,32,950,85000,99789
3,3,0,-,-,99790
50,37,13,860,122500,99791
11174,7372,3802,1195,329800,99801
122,57,65,713,157500,99820
964,444,520,1125,324100,99824
33,33,0,-,391700,99825
237,194,43,694,269200,99826
1199,825,374,879,197800,99827
284,165,119,940,167900,99829
197,129,68,850,144600,99830
44,39,5,-,174000,99832
1237,840,397,912,213400,99833
3504,1960,1544,1019,341600,99835
12,12,0,-,80000,99836
428,233,195,1028,305700,99840
87,87,0,-,237500,99841
5209,3100,2109,1078,257100,99901
8,8,0,-,-,99903
98,77,21,-,258300,99918
338,252,86,837,212800,99919
682,485,197,922,220900,99921
96,80,16,350,88600,99922
0,0,0,-,-,99923
337,226,111,681,164600,99925
449,306,143,697,141700,99926
58,58,0,-,187500,99927
1037,708,329,759,185300,99929
