housing_units_occ,homeowner_units_occ,renters_units_occ,med_rent,med_household_price,zip
5509,3283,2226,383,83900,601
12740,9528,3212,400,85300,602
19228,11118,8110,433,118400,603
1946,1470,476,275,80800,606
8795,6758,2037,427,87600,610
22809,14324,8485,401,96700,612
3449,2618,831,370,93100,616
7910,5673,2237,487,104500,617
2067,1428,639,344,118800,622
13406,8579,4827,471,106600,623
7411,5494,1917,431,76500,624
11394,8254,3140,455,94400,627
629,300,329,214,87500,631
7033,5336,1697,467,95800,637
5899,4171,1728,378,89600,638
8945,5409,3536,396,90200,641
11652,9001,2651,653,135100,646
1919,1421,498,713,85900,647
5136,3640,1496,535,92400,650
1319,1097,222,620,93400,652
3596,2495,1101,338,89800,653
6502,4668,1834,349,79800,656
14160,10516,3644,456,93000,659
6255,4580,1675,424,98700,660
13849,8976,4873,453,103800,662
4878,2798,2080,376,94100,664
7781,4718,3063,452,87200,667
9597,6135,3462,439,85800,669
2680,1935,745,280,85000,670
14858,10872,3986,526,105000,674
13425,8542,4883,421,93800,676
5029,3573,1456,450,121700,677
8811,5912,2899,463,101400,678
18364,10579,7785,422,87400,680
11868,6712,5156,412,112600,682
11067,7847,3220,407,82300,683
13383,8633,4750,401,98000,685
9645,6679,2966,503,105700,687
4237,3029,1208,443,90900,688
2407,1815,592,625,117400,690
11330,7745,3585,527,115700,692
19035,15178,3857,494,106200,693
30,30,0,-,-,694
10926,8253,2673,365,91000,698
8475,5620,2855,453,114100,703
2724,2320,404,487,77600,704
8527,6645,1882,470,112500,705
3815,2833,982,398,87600,707
5899,4640,1259,471,89400,714
1032,752,280,316,82200,715
11060,6896,4164,374,112600,716
6759,3234,3525,288,102600,717
7979,6195,1784,458,92700,718
8598,6452,2146,477,88200,719
6626,4405,2221,394,85500,720
6162,4043,2119,309,90300,723
30256,20071,10185,497,121200,725
19252,13896,5356,738,137700,727
13139,9909,3230,410,98500,728
16481,12314,4167,539,108100,729
11558,7203,4355,391,92400,730
4361,3063,1298,419,77300,731
4303,3078,1225,484,91600,735
17238,10963,6275,483,116700,736
11558,7765,3793,520,103500,738
11793,7829,3964,495,117200,739
740,315,425,425,67600,740
1324,1057,267,614,85800,741
15867,12004,3863,527,114600,745
7609,6004,1605,413,84400,751
13650,10273,3377,498,109800,754
7367,5714,1653,488,93500,757
2210,1531,679,639,103800,765
8071,5597,2474,399,92100,766
11541,8306,3235,454,87200,767
13040,10057,2983,493,90900,769
12199,9500,2699,560,114000,771
6438,4246,2192,368,91100,772
6582,4684,1898,461,111200,773
474,291,183,578,148800,775
12782,9185,3597,443,104300,777
14498,11921,2577,622,141900,778
3982,3353,629,773,96000,780
5207,2879,2328,453,94800,782
10375,7885,2490,514,91600,783
13708,9931,3777,376,86400,784
99,99,0,-,103000,786
16291,11652,4639,429,97400,791
8741,6432,2309,409,99100,794
14782,10464,4318,508,91300,795
2760,1051,1709,522,288700,901
115,101,14,-,357700,906
8043,4718,3325,803,231900,907
2243,1011,1232,510,129000,909
3591,1928,1663,726,260700,911
2578,1438,1140,537,124200,912
3310,496,2814,214,370500,913
10615,4555,6060,408,87800,915
8326,3904,4422,459,115600,917
8055,3901,4154,332,171800,918
6821,3928,2893,665,146500,920
13545,6419,7126,537,134300,921
10039,4316,5723,371,108400,923
19230,10456,8774,392,128600,924
3189,755,2434,444,128700,925
36114,25871,10243,582,170400,926
5963,3047,2916,528,193000,927
29,0,29,-,-,934
0,0,0,-,-,936
25628,19425,6203,599,127100,949
0,0,0,-,-,950
0,0,0,-,-,951
2796,1740,1056,518,98200,952
21729,18015,3714,664,133900,953
24607,17473,7134,563,121200,956
14300,10151,4149,539,130400,957
17685,11415,6270,602,137000,959
0,0,0,-,-,960
11278,7279,3999,579,149900,961
6829,3802,3027,466,106800,962
2514,1502,1012,421,84800,965
5841,4249,1592,797,224700,966
1797,1198,599,865,217300,968
14343,11048,3295,889,222400,969
8657,5782,2875,621,122000,971
21424,14454,6970,519,146200,976
8197,5358,2839,870,170600,979
5910,3994,1916,604,136800,982
13284,8956,4328,551,134700,983
12166,8538,3628,561,131100,985
20567,15351,5216,716,142100,987
7413,5408,2005,1148,215700,1001
9798,4802,4996,1380,355500,1002
42,4,38,-,-,1003
1944,1674,270,965,236400,1005
5563,4531,1032,975,276900,1007
490,466,24,-,243700,1008
114,84,30,-,205300,1009
1447,1274,173,703,272200,1010
564,453,111,1040,206800,1011
272,239,33,1257,249700,1012
9140,4492,4648,878,183000,1013
12798,8287,4511,956,187400,1020
1154,756,398,1517,120900,1022
448,350,98,855,259800,1026
7928,5044,2884,1000,262400,1027
5958,4924,1034,945,268400,1028
238,181,57,-,242200,1029
4416,3555,861,869,253400,1030
537,269,268,901,198500,1031
234,212,22,1196,249000,1032
2603,2267,336,843,255800,1033
855,792,63,1350,278700,1034
2294,1798,496,1252,340000,1035
2000,1827,173,1121,283100,1036
238,205,33,-,272100,1037
1220,885,335,1088,305000,1038
543,398,145,1151,293900,1039
15278,6214,9064,838,195800,1040
1067,883,184,959,212300,1050
565,428,137,976,283500,1053
766,679,87,1393,335300,1054
7925,5778,2147,1027,232300,1056
3526,2907,619,865,247700,1057
6556,2699,3857,1231,354500,1060
4171,3140,1031,940,320700,1062
0,0,0,-,-,1063
31,31,0,-,-,1066
688,654,34,1153,294800,1068
3508,2702,806,889,206400,1069
296,242,54,800,238200,1070
526,477,49,950,229400,1071
630,569,61,1417,274500,1072
2406,2187,219,903,336600,1073
95,21,74,-,-,1074
6616,4810,1806,1013,243500,1075
3804,3094,710,1105,277500,1077
342,223,119,1609,190600,1079
918,481,437,957,169200,1080
756,621,135,827,196600,1081
4587,3150,1437,955,204700,1082
1066,804,262,682,220000,1083
75,62,13,1208,236700,1084
15551,10517,5034,969,236000,1085
0,0,0,-,-,1086
242,161,81,987,307300,1088
12605,7406,5199,878,225100,1089
461,339,122,958,215200,1092
117,110,7,-,360800,1093
205,113,92,522,182000,1094
5253,4631,622,666,301700,1095
1060,838,222,1130,293000,1096
20,6,14,-,-,1097
584,512,72,824,274200,1098
1481,189,1292,876,119600,1103
8910,4189,4721,827,141400,1104
4991,419,4572,695,132200,1105
5769,5142,627,1393,345500,1106
3849,979,2870,711,160800,1107
9690,3891,5799,965,163500,1108
9304,4064,5240,946,134600,1109
5692,4363,1329,1021,169200,1118
4900,3450,1450,731,157000,1119
1085,1046,39,1713,184500,1128
2864,2080,784,1072,171700,1129
3430,1531,1899,983,136000,1151
0,0,0,-,-,1199
20020,12569,7451,893,176400,1201
3774,2277,1497,761,163900,1220
343,296,47,1525,256300,1222
1067,986,81,1188,261900,1223
64,47,17,-,201000,1224
1448,1193,255,1073,208800,1225
3088,2340,748,933,219800,1226
48,38,10,-,345800,1229
3511,2614,897,947,363400,1230
1116,912,204,742,199700,1235
538,371,167,1272,326300,1236
1036,860,176,1173,293000,1237
2308,1648,660,953,278300,1238
2098,1374,724,856,331500,1240
160,99,61,-,261700,1242
144,139,5,-,229600,1243
58,45,13,-,411500,1244
397,343,54,1217,424300,1245
6562,4103,2459,759,147900,1247
406,375,31,-,284300,1253
443,425,18,1375,445200,1254
353,348,5,-,265700,1255
293,269,24,728,172600,1256
918,778,140,919,327000,1257
214,180,34,871,443500,1258
286,257,29,1067,367900,1259
140,66,74,-,630400,1260
490,262,228,765,510900,1262
80,62,18,850,366700,1264
572,497,75,1818,386800,1266
2372,1749,623,953,320800,1267
343,343,0,-,279800,1270
8164,4641,3523,926,195400,1301
574,466,108,835,279300,1330
5271,3918,1353,889,165400,1331
1073,865,208,890,246500,1337
61,61,0,-,234700,1338
547,469,78,833,234700,1339
756,628,128,953,217700,1340
778,665,113,1162,320700,1341
365,234,131,1773,276100,1342
29,21,8,-,242500,1343
546,432,114,785,203900,1344
183,179,4,-,249100,1346
78,56,22,-,117700,1347
500,409,91,1026,191800,1349
49,36,13,921,111400,1350
974,672,302,962,263200,1351
579,473,106,1110,248300,1354
398,347,51,1118,248000,1355
1225,1025,200,775,226700,1360
3151,2194,957,900,163800,1364
473,406,67,960,287400,1366
237,219,18,1333,211800,1367
581,476,105,871,241900,1368
1811,1234,577,890,267100,1370
2046,1646,400,1041,306700,1373
1677,675,1002,1456,299800,1375
2389,1211,1178,906,199300,1376
345,322,23,1042,228600,1378
370,297,73,982,213400,1379
14965,8010,6955,1016,196600,1420
2047,1874,173,1636,265000,1430
1167,1077,90,1101,267900,1431
3442,2191,1251,1113,327000,1432
239,183,56,-,330000,1434
1295,1007,288,613,180800,1436
198,184,14,-,171900,1438
8228,4282,3946,838,185700,1440
4071,3491,580,1296,473000,1450
1624,1535,89,1242,597300,1451
1697,1475,222,1095,281700,1452
16848,9740,7108,973,242000,1453
3657,3230,427,1292,459000,1460
4310,3610,700,1580,308800,1462
4444,3548,896,1113,343400,1463
2449,1785,664,810,314200,1464
111,111,0,-,376100,1467
1824,1540,284,1160,203800,1468
2813,2367,446,945,287400,1469
2870,2609,261,1104,287300,1473
707,667,40,1250,309500,1474
3765,2697,1068,732,206100,1475
6634,5629,1005,935,264400,1501
1179,973,206,756,422600,1503
3526,2739,787,978,291100,1504
1799,1499,300,947,385900,1505
1404,1219,185,947,218900,1506
5064,4006,1058,1007,297700,1507
5594,2979,2615,1167,248200,1510
795,671,124,982,249200,1515
3234,2614,620,974,320600,1516
1427,962,465,1082,339100,1518
2504,1988,516,1366,363100,1519
5786,5160,626,1172,324300,1520
1006,880,126,1278,250600,1521
1260,1104,156,941,296400,1522
2430,1895,535,-,364300,1523
2453,1860,593,862,262000,1524
217,42,175,1073,277100,1525
5275,3864,1411,1168,290300,1527
1241,962,279,1103,307500,1529
460,397,63,983,295300,1531
5399,4365,1034,1440,447100,1532
2351,1831,520,780,350800,1534
1841,1346,495,878,244400,1535
2780,2230,550,1033,349100,1536
941,658,283,1006,222700,1537
4199,3145,1054,892,263800,1540
1271,1215,56,1028,373600,1541
889,709,180,981,275300,1542
2885,2369,516,1044,295500,1543
13542,9967,3575,1375,416000,1545
6813,3012,3801,895,198400,1550
1750,1166,584,1138,363200,1560
82,37,45,-,-,1561
4883,3447,1436,890,255900,1562
2777,2512,265,1304,360000,1564
2192,1980,212,1407,268300,1566
2716,2317,399,984,486300,1568
5056,4038,1018,1165,315400,1569
6946,3795,3151,927,233500,1570
3905,2647,1258,945,263900,1571
7069,4450,2619,1663,458100,1581
2300,1910,390,1070,298000,1583
1842,1321,521,994,253000,1585
3575,2057,1518,1026,284900,1588
3417,3078,339,1104,351900,1590
9498,5828,3670,1261,237100,1602
7327,3327,4000,1079,194800,1603
14825,6654,8171,1149,227800,1604
10673,3096,7577,1042,216800,1605
8159,5057,3102,1137,230400,1606
3702,1193,2509,1034,184300,1607
1916,190,1726,996,174400,1608
7859,3010,4849,1078,325300,1609
7729,1258,6471,1075,181800,1610
788,569,219,1141,233500,1611
1499,1430,69,955,316800,1612
13054,9838,3216,1581,433400,1701
15212,5389,9823,1394,355600,1702
242,164,78,-,267000,1718
2266,1558,708,1166,546500,1719
8530,6336,2194,1435,588100,1720
6796,5611,1185,1455,401900,1721
5312,3926,1386,1859,655300,1730
560,6,554,3143,-,1731
1739,1626,113,-,547700,1740
1876,1774,102,1125,845100,1741
6638,4981,1657,2130,871300,1742
230,175,55,1500,405900,1745
5270,4816,454,897,448600,1746
2181,1836,345,1342,341100,1747
6304,5232,1072,1889,577600,1748
7877,5713,2164,1244,353700,1749
15730,9151,6579,1482,348500,1752
4262,3360,902,1176,350200,1754
2059,1838,221,1566,473900,1756
11046,7624,3422,1230,314800,1757
14430,9949,4481,1586,565000,1760
1525,1464,61,1173,783800,1770
3312,3012,300,1210,618500,1772
2169,1622,547,1745,926400,1773
2558,2262,296,1466,507800,1775
6386,5849,537,1169,720800,1776
4849,4436,413,1051,714300,1778
15951,9761,6190,1630,453900,1801
10001,7363,2638,1960,533800,1803
12801,10412,2389,1611,620500,1810
11561,9138,2423,1569,408600,1821
9714,8206,1508,1544,427200,1824
11470,9024,2446,1340,332900,1826
1178,1117,61,1750,470900,1827
10096,5401,4695,1197,310700,1830
8901,4818,4083,1216,295100,1832
3295,2663,632,1487,460400,1833
2448,2133,315,1337,406700,1834
5259,3631,1628,1212,293600,1835
2265,109,2156,953,151900,1840
15149,4630,10519,1128,283500,1841
8545,3311,5234,1229,265400,1843
17907,12859,5048,1233,333200,1844
11112,7929,3183,1577,505400,1845
5460,2202,3258,1185,241400,1850
10208,4232,5976,1257,277700,1851
14255,6822,7433,1131,280700,1852
9498,3424,6074,1030,254300,1854
2710,2360,350,1102,362600,1860
3512,2993,519,1394,386200,1862
3850,3229,621,1336,334800,1863
5543,4860,683,1465,536700,1864
9175,7733,1442,1352,562800,1867
11684,9952,1732,1925,389300,1876
4439,3675,764,1254,388400,1879
10529,7991,2538,1340,505800,1880
8571,7384,1187,1974,531300,1886
7957,6826,1131,1981,473800,1887
7884,6813,1071,1900,943800,1890
1017,118,899,927,315600,1901
17085,6164,10921,1181,298400,1902
6205,4500,1705,1369,366100,1904
8247,3833,4414,1155,294700,1905
10431,8408,2023,919,395000,1906
5875,4458,1417,1886,475500,1907
1602,1129,473,1473,625400,1908
7215,5062,2153,1195,336200,1913
16443,9952,6491,1282,437300,1915
2839,2773,66,870,678700,1921
1223,1094,129,-,511800,1922
10689,7626,3063,1398,427400,1923
1457,1197,260,1134,574600,1929
13110,8395,4715,1185,425400,1930
0,0,0,-,-,1937
5761,4131,1630,1145,485600,1938
4965,4086,879,1746,659800,1940
2075,1581,494,1356,852400,1944
8122,6318,1804,1578,675400,1945
2999,2650,349,1720,555600,1949
7836,6049,1787,1338,548400,1950
1354,1132,222,1116,522600,1951
3889,3174,715,1463,363200,1952
21541,14118,7423,1366,387600,1960
3324,2292,1032,1360,536400,1966
2210,1796,414,1361,486100,1969
18371,9501,8870,1284,367200,1970
2719,2200,519,1207,569100,1982
2206,1992,214,-,598700,1983
1418,1276,142,-,605100,1984
1678,1541,137,1671,570400,1985
6526,5338,1188,1266,316200,2019
9064,6928,2136,1757,510500,2021
3087,2391,696,1455,872100,2025
10026,7230,2796,1669,460900,2026
2031,1898,133,2181,1008600,2030
1425,1229,196,1356,488800,2032
6805,4326,2479,1470,427500,2035
11941,9631,2310,1378,432700,2038
8873,7179,1694,2160,771600,2043
4765,3418,1347,1423,406600,2045
75,43,32,-,744300,2047
8650,6271,2379,1266,412300,2048
9886,8028,1858,1419,461800,2050
4245,3689,556,1347,667500,2052
4735,4256,479,1188,413600,2053
3161,2602,559,1776,400200,2054
3186,3047,139,1174,506300,2056
3666,3426,240,947,608300,2061
11971,6881,5090,1563,439300,2062
6922,6091,831,1200,591300,2066
6326,5590,736,1641,559100,2067
196,178,18,-,387500,2071
10900,7830,3070,1516,348300,2072
7143,5777,1366,1369,486000,2081
5541,4717,824,1807,713400,2090
4258,3617,641,1068,443900,2093
2091,860,1231,2557,1214500,2108
1976,707,1269,2974,851100,2109
1291,747,544,2960,1147600,2110
3452,905,2547,1530,873700,2111
4117,811,3306,1885,617800,2113
7499,1821,5678,2361,707400,2114
9136,1108,8028,1690,860900,2115
12223,4502,7721,1965,1159700,2116
13193,4528,8665,1286,843500,2118
11570,2733,8837,911,440800,2119
4926,355,4571,1167,444200,2120
10666,2413,8253,982,500100,2121
8591,3609,4982,1448,476900,2122
19143,7695,11448,1507,423600,2124
12705,4275,8430,1409,468200,2125
10088,4152,5936,1543,377700,2126
17135,6983,10152,1581,644200,2127
16565,4601,11964,1545,449000,2128
9162,4300,4862,1339,734200,2129
16824,7658,9166,1688,573400,2130
12692,7002,5690,1538,466300,2131
11448,8238,3210,1668,527800,2132
8582,1243,7339,1811,502600,2134
19568,4577,14991,1815,512100,2135
12000,6168,5832,1306,404100,2136
14188,5513,8675,2246,881200,2138
14641,5184,9457,2192,727200,2139
9474,3142,6332,2099,776800,2140
6925,2262,4663,2047,684200,2141
1761,223,1538,3301,921400,2142
11084,3264,7820,1835,681900,2143
10686,3828,6858,2019,731500,2144
10915,3923,6992,1810,591400,2145
23025,9436,13589,1577,401900,2148
16021,6179,9842,1454,405800,2149
13259,3439,9820,1420,350800,2150
19232,9588,9644,1418,373800,2151
7831,4378,3453,1415,439800,2152
22887,12872,10015,1820,500800,2155
506,0,506,2385,-,2163
25468,10390,15078,1517,399100,2169
7870,4348,3522,1381,454200,2170
7849,4275,3574,1657,457200,2171
11329,7456,3873,1516,570300,2176
9666,6318,3348,1483,494600,2180
14016,10229,3787,1522,456500,2184
8875,7484,1391,1330,618800,2186
6495,3913,2582,1485,374800,2188
6169,4024,2145,1388,366400,2189
7389,5006,2383,1500,393800,2190
3670,2957,713,1446,363400,2191
813,39,774,2848,-,2199
30,14,16,-,-,2203
2324,720,1604,3174,860900,2210
7845,792,7053,1991,544100,2215
21086,9952,11134,1109,274200,2301
10731,7555,3176,1120,252000,2302
1574,1163,411,1226,331500,2322
8133,5823,2310,1597,358900,2324
4489,4093,396,1450,291500,2330
5714,5069,645,1758,651000,2332
4828,3905,923,1210,352300,2333
2904,2637,267,1094,299300,2338
4913,4327,586,1338,512000,2339
3907,3558,349,950,363700,2341
4094,3319,775,986,323400,2343
9271,7449,1822,1271,308200,2346
4095,3472,623,1540,371000,2347
6396,4690,1706,1219,357300,2351
4575,3477,1098,1509,451300,2356
24,11,13,-,-,2357
6563,5566,997,1585,398400,2359
23345,18611,4734,1403,370100,2360
4949,4050,899,1218,378500,2364
0,0,0,-,-,2366
1010,872,138,1075,383600,2367
11912,8117,3795,1507,331700,2368
6959,5221,1738,1267,310800,2370
3878,3063,815,1628,359800,2375
2499,2165,334,1181,351900,2379
5466,3856,1610,1240,327100,2382
5036,4472,564,2264,891700,2420
6775,5176,1599,2568,887800,2421
8407,4707,3700,2314,937100,2445
13116,5369,7747,2221,881100,2446
7305,4505,2800,1889,525400,2451
4724,2929,1795,1835,564300,2452
11597,4806,6791,1630,528500,2453
8,8,0,-,-,2457
4890,3096,1794,1863,824600,2458
6388,5150,1238,1962,1092700,2459
3657,2239,1418,1950,843100,2460
2657,2024,633,1993,880700,2461
556,351,205,1599,933400,2462
1231,856,375,1955,666400,2464
4167,3303,864,2048,790300,2465
2959,1625,1334,1823,844000,2466
6402,4253,2149,2279,917000,2467
2008,1905,103,1921,1217400,2468
15684,8092,7592,1857,559700,2472
11583,6421,5162,1779,631900,2474
7482,4635,2847,1623,657600,2476
9812,6336,3476,2000,859600,2478
4552,3833,719,2331,1243000,2481
3889,2998,891,1476,1018400,2482
7193,6457,736,966,873900,2492
3787,3248,539,1698,1312300,2493
3608,2610,998,1657,805400,2494
5751,4406,1345,1279,338800,2532
291,202,89,1274,779800,2534
632,504,128,1413,1115100,2535
8235,6732,1503,1438,356100,2536
2421,2323,98,1333,428800,2537
1684,1037,647,1293,263300,2538
1453,1127,326,1849,773400,2539
4053,2750,1303,1015,599200,2540
313,16,297,1708,-,2542
360,287,73,1323,896600,2543
111,111,0,-,-,2553
3647,2553,1094,1764,1071900,2554
1173,995,178,1416,553100,2556
1750,1299,451,1427,583800,2557
738,518,220,1383,256000,2558
1813,1330,483,1563,373000,2559
137,108,29,-,315400,2561
1292,1014,278,1368,412400,2562
3998,3544,454,1381,380600,2563
66,66,0,-,"2,000,000+",2564
1836,1007,829,1350,649300,2568
4185,2702,1483,1104,314400,2571
1068,934,134,1368,719100,2575
1798,1688,110,1228,259500,2576
0,0,0,-,-,2584
6362,3150,3212,1244,281100,2601
773,692,81,1688,584600,2630
4142,3491,651,1097,441600,2631
4410,3881,529,1572,375500,2632
2054,1721,333,995,619500,2633
1395,1255,140,-,443500,2635
77,64,13,-,577600,2637
1573,1293,280,1413,478200,2638
1511,894,617,1454,322700,2639
117,117,0,-,447900,2641
2388,2165,223,1311,463600,2642
0,0,0,-,-,2643
1434,1275,159,1232,349500,2644
3950,3288,662,1367,383100,2645
1017,894,123,1339,546000,2646
52,52,0,-,1984400,2647
2834,2585,249,1863,364600,2648
6360,5508,852,1434,363100,2649
373,279,94,1600,819600,2650
8,8,0,-,-,2651
338,274,64,1131,584700,2652
2749,2280,469,850,643200,2653
1422,1207,215,1324,478600,2655
1702,1337,365,1248,601900,2657
448,422,26,-,609600,2659
2932,2222,710,1256,362100,2660
64,55,9,-,1004500,2663
3986,2823,1163,1335,350900,2664
263,221,42,-,360300,2666
1534,1303,231,1177,510400,2667
1158,930,228,1405,448000,2668
19,19,0,-,-,2669
710,502,208,1025,433300,2670
510,463,47,1110,432900,2671
136,96,40,-,895500,2672
3610,2835,775,1424,284700,2673
3096,2854,242,1623,382900,2675
1526,1411,115,1605,360300,2702
17632,12166,5466,1081,292900,2703
26,22,4,-,666700,2713
1432,1287,145,1023,363500,2715
1736,1552,184,1199,352500,2717
2371,2036,335,858,286600,2718
6392,4830,1562,935,281000,2719
12813,5145,7668,853,240900,2720
10677,3854,6823,787,248000,2721
6933,2209,4724,800,232200,2723
7889,2612,5277,772,241800,2724
931,682,249,967,274100,2725
6025,4886,1139,1169,279900,2726
1942,1559,383,1279,483500,2738
2648,2085,563,1312,469900,2739
17996,7037,10959,848,220200,2740
4094,3554,540,822,296000,2743
4598,1608,2990,812,227200,2744
10067,5908,4159,898,235200,2745
6135,1040,5095,830,214800,2746
6924,5339,1585,957,347800,2747
4778,3824,954,868,383500,2748
10480,6897,3583,1037,347900,2760
3666,2609,1057,1554,337700,2762
591,538,53,-,413600,2763
1403,1274,129,639,343400,2764
6570,5596,974,1260,351600,2766
5303,4308,995,1483,353100,2767
4160,3765,395,1192,400800,2769
1888,1755,133,985,411300,2770
6052,5069,983,1065,339300,2771
6361,5613,748,892,288700,2777
2384,2309,75,-,347500,2779
19910,11837,8073,1021,268600,2780
6388,5315,1073,1110,358800,2790
234,185,49,-,684100,2791
253,74,179,736,191700,2802
699,665,34,-,230100,2804
6051,5365,686,1323,432800,2806
440,294,146,860,1037000,2807
764,540,224,1090,240000,2808
8331,5616,2715,1066,338600,2809
403,374,29,-,323400,2812
3282,2746,536,1232,330700,2813
2978,2542,436,1102,282300,2814
123,98,25,-,312500,2815
13338,10157,3181,1015,236300,2816
2256,1853,403,2114,343700,2817
7599,5611,1988,1083,395100,2818
2301,1851,450,991,335000,2822
2031,1734,297,1025,298400,2825
178,155,23,-,309900,2826
857,838,19,1088,287000,2827
3020,2479,541,1035,285100,2828
2273,1796,477,790,286200,2830
1168,1006,162,1436,292600,2831
1919,1563,356,1003,284100,2832
443,362,81,477,243000,2833
2301,1908,393,1660,656800,2835
56,56,0,-,-,2836
1561,1269,292,1424,517900,2837
1351,621,730,1001,251700,2838
816,537,279,1294,216200,2839
10267,4372,5895,1242,448800,2840
0,0,0,-,-,2841
6868,3761,3107,1368,379100,2842
9005,6587,2418,1008,329600,2852
3159,2828,331,1121,333200,2857
233,143,90,1098,231600,2858
2487,1826,661,931,237100,2859
18543,6745,11798,885,191300,2860
10095,6171,3924,1007,197800,2861
6103,1221,4882,852,160100,2863
13238,10183,3055,951,288200,2864
6497,4878,1619,1241,330200,2865
7079,5462,1617,1462,387400,2871
132,116,16,-,289700,2872
106,106,0,-,345700,2873
2156,1937,219,1568,457600,2874
162,143,19,-,288500,2875
219,84,135,1404,-,2876
6569,5105,1464,971,277500,2878
8380,6224,2156,1245,371500,2879
1044,651,393,1246,353000,2881
5870,4035,1835,1361,455400,2882
4857,2619,2238,953,295900,2885
12498,8294,4204,1170,235600,2886
8193,6314,1879,1073,215400,2888
11450,8717,2733,1161,214200,2889
9333,5932,3401,1040,310900,2891
1917,1639,278,1503,327500,2892
13231,6908,6323,1007,205900,2893
241,223,18,-,205700,2894
16663,6058,10605,912,173300,2895
4588,3685,903,1012,292600,2896
581,390,191,1037,266200,2898
4701,770,3931,1044,325500,2903
12591,5964,6627,904,207600,2904
8880,4168,4712,1009,207500,2905
10687,5115,5572,1302,412100,2906
9362,2730,6632,971,180300,2907
12079,5355,6724,1008,184100,2908
14167,4571,9596,939,173900,2909
8135,5709,2426,1073,200700,2910
6621,3522,3099,1019,212800,2911
0,0,0,-,-,2912
8802,4554,4248,969,212500,2914
7356,4861,2495,1012,221600,2915
3707,2705,1002,942,243900,2916
4687,3624,1063,904,291200,2917
11597,7771,3826,1004,231400,2919
14101,8773,5328,1033,243700,2920
4460,3833,627,1246,361200,2921
4199,3898,301,1340,354000,3031
1973,1819,154,1929,332000,3032
1736,1638,98,1447,329100,3033
1565,1482,83,1714,283400,3034
1687,1642,45,-,352400,3036
1625,1425,200,1167,304000,3037
12868,8341,4527,1198,244900,3038
2680,2288,392,1280,283900,3042
629,578,51,1321,289400,3043
1755,1605,150,1450,275500,3044
5040,4078,962,1141,266900,3045
938,878,60,1261,317600,3046
699,558,141,793,231300,3047
1444,1184,260,1051,220100,3048
2968,2733,235,1565,474900,3049
9232,7773,1459,1256,291500,3051
3042,2736,306,1211,320800,3052
9211,7939,1272,1544,322000,3053
9951,8629,1322,1447,282600,3054
6288,3948,2340,1194,251400,3055
925,830,95,1375,336800,3057
12252,4220,8032,1133,234400,3060
11421,8052,3369,1506,282200,3062
6977,4373,2604,1419,272400,3063
5884,3383,2501,1174,277600,3064
1950,1778,172,1163,315300,3070
1866,1649,217,1276,224800,3071
4832,4371,461,1177,349000,3076
4099,3211,888,1333,229300,3077
11536,9006,2530,1148,325600,3079
667,616,51,1125,262200,3082
487,442,45,1281,270600,3084
1609,1391,218,976,252600,3086
5009,4805,204,2153,450300,3087
1787,114,1673,1042,236800,3101
13491,4888,8603,1201,217300,3102
14239,6212,8027,1087,212400,3103
13654,6815,6839,1106,257600,3104
5244,3960,1284,1332,253800,3106
4100,3089,1011,1266,230600,3109
7813,6697,1116,1750,407300,3110
92,85,7,-,342600,3215
918,778,140,917,225000,3216
842,460,382,883,175700,3217
409,325,84,-,219600,3218
3037,2567,470,1009,192000,3220
863,761,102,994,229300,3221
2334,1842,492,857,195100,3222
1385,1081,304,780,169200,3223
952,874,78,682,267100,3224
1322,1193,129,1078,190600,3225
419,375,44,1091,336500,3226
466,402,64,1742,296600,3227
2193,1950,243,1138,272400,3229
515,473,42,1125,170000,3230
136,122,14,-,303500,3231
53,47,6,-,362000,3233
1787,1505,282,1009,234000,3234
3959,2519,1440,849,165200,3235
919,830,89,1467,242800,3237
39,38,1,-,65400,3238
540,495,45,920,168800,3240
351,320,31,961,293600,3241
1805,1356,449,753,241000,3242
373,343,30,1075,184000,3243
3061,2687,374,1062,195200,3244
781,614,167,962,293800,3245
6917,4004,2913,962,192800,3246
3048,2579,469,1045,256500,3249
448,298,150,867,218200,3251
2844,2074,770,1063,286200,3253
1774,1540,234,1331,319600,3254
930,866,64,908,287600,3255
921,774,147,965,236200,3256
1596,1307,289,1252,373200,3257
974,882,92,1129,255000,3258
170,152,18,-,296600,3259
313,261,52,1523,272600,3260
1631,1463,168,1042,255600,3261
413,289,124,741,210500,3262
1670,1076,594,831,196200,3263
2312,1504,808,662,185000,3264
851,726,125,869,178300,3266
500,472,28,1083,218400,3268
1087,895,192,792,278300,3269
110,101,9,-,192300,3273
4478,3487,991,896,200100,3275
3300,2297,1003,878,178800,3276
1165,778,387,1092,257500,3278
309,257,52,717,147200,3279
537,499,38,985,212900,3280
3129,2914,215,1426,249600,3281
355,304,51,1104,196900,3282
341,302,39,-,237100,3284
961,815,146,1198,224500,3285
670,521,149,1252,290200,3287
1856,1740,116,1049,295500,3290
37,37,0,-,-,3291
86,78,8,-,184100,3293
13406,6829,6577,1082,242400,3301
6250,4202,2048,1062,210300,3303
2723,2435,288,1167,318800,3304
2050,1759,291,1126,240500,3307
10165,5439,4726,989,187600,3431
1088,805,283,1024,204200,3440
69,25,44,917,134700,3441
646,441,205,978,165700,3442
153,96,57,-,247100,3443
576,490,86,985,280400,3444
291,241,50,1219,180100,3445
2531,1986,545,1006,183600,3446
1026,895,131,1007,194500,3447
294,269,25,1292,191400,3448
785,687,98,1161,321300,3449
419,384,35,1250,251500,3450
1643,1333,310,905,136400,3451
2107,1385,722,835,190100,3452
928,590,338,858,203600,3455
327,285,42,925,191400,3456
304,262,42,1000,282400,3457
3208,2203,1005,910,261200,3458
1762,1464,298,978,245700,3461
529,424,105,759,250600,3462
414,377,37,1321,214300,3464
837,608,229,895,148000,3465
679,579,100,-,232700,3466
663,599,64,1018,251200,3467
1993,1433,560,942,158000,3470
2894,1513,1381,709,170300,3561
3977,2228,1749,750,92100,3570
1082,813,269,692,167700,3574
7,7,0,-,-,3575
1408,1124,284,682,143500,3576
165,139,26,688,215300,3579
582,458,124,874,331500,3580
1443,1123,320,625,153700,3581
1045,750,295,701,79800,3582
396,346,50,825,198300,3583
1538,1127,411,773,133300,3584
1112,868,244,794,157100,3585
272,246,26,646,321100,3586
716,613,103,907,161300,3588
404,310,94,581,99000,3590
564,466,98,495,159300,3592
196,161,35,925,251900,3593
317,245,72,877,200500,3595
153,107,46,580,76900,3597
1470,1007,463,852,134100,3598
184,169,15,1063,184500,3601
1012,735,277,873,194500,3602
2196,1690,506,969,114400,3603
58,40,18,-,339400,3604
396,370,26,950,174100,3605
154,146,8,-,162900,3607
1294,983,311,971,251800,3608
325,221,104,856,144300,3609
305,256,49,691,187500,3740
1561,1255,306,1105,205600,3741
5408,3098,2310,982,135200,3743
641,593,48,1008,273500,3745
100,93,7,-,272100,3746
2146,1452,694,1219,278800,3748
299,256,43,-,454500,3750
233,145,88,979,283700,3751
277,223,54,1031,188800,3752
1186,1046,140,1218,294900,3753
14,0,14,-,-,3754
2619,1641,978,1455,577300,3755
245,230,15,-,211500,3765
4224,2190,2034,1068,246100,3766
684,613,71,1400,479400,3768
126,116,10,-,429200,3770
344,305,39,763,188700,3771
3177,2265,912,899,155700,3773
753,597,156,1201,132000,3774
484,386,98,1184,303300,3777
332,290,42,908,209500,3779
155,128,27,-,143600,3780
789,687,102,1568,311700,3781
1213,947,266,1307,314900,3782
1790,880,910,1208,238600,3784
838,591,247,893,122700,3785
10370,5496,4874,1308,432200,3801
1271,1092,179,-,236000,3809
804,786,18,-,385800,3810
2745,2551,194,-,367300,3811
393,260,133,925,335600,3812
1372,1126,246,1065,165800,3813
1172,803,369,818,160400,3814
564,518,46,967,238400,3816
447,346,101,1293,167900,3817
1745,1206,539,930,182800,3818
1675,1420,255,1277,282100,3819
13508,6968,6540,1156,265000,3820
596,514,82,1412,374900,3823
3187,1854,1333,1044,380000,3824
3237,2958,279,1679,291000,3825
1026,680,346,851,319500,3826
1174,1097,77,1500,362300,3827
907,852,55,-,257300,3830
147,114,33,933,341700,3832
8969,6688,2281,1188,326400,3833
2868,1931,937,1003,196600,3835
611,577,34,1531,265900,3836
618,521,97,1301,242200,3837
504,386,118,789,247900,3838
1476,904,572,1018,185500,3839
1508,1248,260,2047,434600,3840
2630,2179,451,1066,330100,3841
7037,5367,1670,1168,372300,3842
905,824,81,1638,483700,3844
613,467,146,1008,205100,3845
412,314,98,1266,388900,3846
219,170,49,-,348700,3847
2411,2031,380,1199,286000,3848
535,439,96,1157,222900,3849
121,102,19,-,376000,3850
1626,1417,209,1023,205600,3851
188,188,0,-,199000,3852
235,235,0,-,320200,3853
436,391,45,2567,1079300,3854
953,893,60,1156,237900,3855
600,560,40,1420,453100,3856
4035,2121,1914,1235,279300,3857
1853,1487,366,1089,317800,3858
1841,1113,728,1035,268600,3860
1876,1619,257,1050,332600,3861
1828,1620,208,1743,424300,3862
786,695,91,871,179900,3864
3119,2548,571,1365,295200,3865
9020,6071,2949,1014,173700,3867
2284,1626,658,1132,160600,3868
1021,785,236,1063,244700,3869
2260,1837,423,1500,690700,3870
104,104,0,-,1013900,3871
1403,1228,175,759,234300,3872
2156,1965,191,1276,314600,3873
3877,2629,1248,1143,276000,3874
429,327,102,790,278600,3875
5146,2808,2338,1070,184800,3878
594,488,106,1163,171500,3882
101,60,41,-,173100,3883
1341,1217,124,1041,278200,3884
2797,2467,330,1607,428700,3885
738,530,208,750,164200,3886
765,692,73,1184,180200,3887
53,42,11,-,-,3890
3003,2432,571,861,289600,3894
3185,2781,404,933,227000,3901
960,882,78,1450,373300,3902
2676,2297,379,930,361600,3903
3587,2172,1415,1249,295000,3904
929,814,115,-,412900,3905
1868,1603,265,768,262600,3906
576,455,121,1050,526800,3907
2785,2096,689,1003,268200,3908
4551,3640,911,1108,422600,3909
175,131,44,-,377300,3910
28,28,0,-,-,3911
1041,947,94,799,222900,4001
2889,2544,345,867,235500,4002
149,114,35,-,357900,4003
9716,5032,4684,928,246700,4005
94,26,68,1115,845200,4006
1243,1029,214,1255,197100,4008
2411,1914,497,938,158900,4009
596,521,75,1083,201400,4010
8455,5764,2691,1002,243500,4011
1609,1202,407,808,226200,4015
232,196,36,1036,419400,4017
18,18,0,-,-,4019
619,459,160,642,189500,4020
2320,1830,490,1207,343600,4021
445,423,22,1038,219600,4022
211,171,40,960,178500,4024
2142,1798,344,1036,202600,4027
699,557,142,896,180300,4029
763,678,85,1098,235900,4030
3447,2789,658,1329,294100,4032
1195,962,233,555,187200,4037
6012,4997,1015,1073,268700,4038
3254,2550,704,1122,236700,4039
1418,1229,189,856,180800,4040
618,521,97,867,151300,4041
2082,1739,343,919,213100,4042
4983,3714,1269,964,331400,4043
3337,2934,403,1153,312500,4046
820,692,128,625,187500,4047
1212,985,227,941,184600,4048
1330,1224,106,1095,186100,4049
140,117,23,825,364100,4050
414,347,67,682,224600,4051
1716,1517,199,1200,188500,4055
119,108,11,-,190000,4056
38,38,0,-,-,4057
1108,1024,84,-,167300,4061
6854,5983,871,1067,249400,4062
298,172,126,343,245800,4063
4490,3069,1421,954,216200,4064
349,195,154,1091,541700,4066
559,438,121,931,161200,4068
590,500,90,1086,304500,4069
2132,1861,271,1075,280000,4071
7953,5211,2742,1173,258900,4072
6873,3890,2983,908,179300,4073
7984,6616,1368,1232,369600,4074
1078,993,85,1125,212900,4076
1755,1454,301,1066,337700,4079
2027,1374,653,886,194800,4083
2634,2325,309,940,235500,4084
768,695,73,-,232400,4085
3870,2970,900,919,232000,4086
816,731,85,1348,216100,4087
572,492,80,809,161900,4088
4593,3853,740,830,287800,4090
340,310,30,1148,169900,4091
8073,4887,3186,1030,232900,4092
3131,2506,625,929,234800,4093
480,424,56,868,192100,4095
3409,2480,929,1227,374600,4096
1397,1253,144,1210,331800,4097
9086,1830,7256,1084,342400,4101
7863,3919,3944,1117,286300,4102
12986,7552,5434,1181,277400,4103
4671,3981,690,1701,441600,4105
11009,6983,4026,1297,256500,4106
3714,3291,423,1199,439000,4107
426,377,49,940,380400,4108
43,28,15,-,452600,4109
558,516,42,-,618900,4110
10442,5836,4606,789,165200,4210
211,193,18,617,130800,4216
1388,1132,256,508,192600,4217
553,482,71,991,173500,4219
1161,1021,140,890,141600,4220
308,254,54,643,140600,4221
1647,1446,201,795,228000,4222
915,681,234,646,89800,4224
65,57,8,-,139200,4226
55,38,17,-,64000,4227
0,0,0,-,-,4228
111,100,11,1063,159600,4231
27,27,0,-,-,4234
1592,1402,190,1025,181700,4236
89,83,6,625,160400,4237
476,411,65,920,182700,4238
1880,1637,243,571,129800,4239
15617,7839,7778,748,140600,4240
1866,1340,526,831,151700,4250
1862,1466,396,743,149900,4252
837,711,126,572,159300,4253
1500,756,744,599,83600,4254
237,213,24,1031,182100,4255
1213,915,298,933,134900,4256
1051,889,162,658,71600,4257
932,861,71,893,198600,4258
1371,1135,236,864,169800,4259
2049,1707,342,1110,230700,4260
154,135,19,833,214500,4261
835,745,90,-,160200,4263
420,345,75,1099,167100,4265
33,33,0,-,195800,4267
1734,1294,440,721,123700,4268
2217,1785,432,923,145200,4270
0,0,0,-,-,4271
2234,1953,281,840,188200,4274
187,169,18,825,104800,4275
2389,1744,645,600,92500,4276
2745,2254,491,934,159800,4280
1932,1417,515,631,141000,4281
2308,1835,473,863,203400,4282
433,377,56,708,240100,4284
179,153,26,725,154700,4285
15,0,15,-,-,4286
1414,1296,118,850,210300,4287
708,533,175,770,152000,4289
560,505,55,675,118100,4290
358,323,35,-,154600,4292
1601,1226,375,545,127600,4294
11719,7076,4643,730,152500,4330
717,619,98,963,173200,4342
0,0,0,-,-,4343
1342,881,461,761,159600,4344
4578,3343,1235,743,150500,4345
858,629,229,648,127700,4346
1104,559,545,863,192000,4347
1248,1097,151,1031,176200,4348
480,438,42,1188,172500,4349
1517,1335,182,779,197000,4350
1065,862,203,843,245300,4351
627,573,54,773,157600,4352
959,826,133,898,154000,4353
620,568,52,1107,168000,4354
1010,843,167,968,201000,4355
1628,1158,470,887,162300,4357
1738,1511,227,760,170500,4358
179,117,62,634,117900,4359
203,191,12,700,162100,4360
1052,834,218,741,156000,4363
2617,1793,824,794,224300,4364
18786,10483,8303,821,164700,4401
307,291,16,710,127700,4406
81,75,6,-,143800,4408
461,411,50,608,117200,4410
678,567,111,928,160500,4411
3770,2306,1464,865,162100,4412
95,95,0,-,73600,4413
520,435,85,664,88200,4414
124,83,41,696,67700,4415
2342,1823,519,-,158800,4416
175,167,8,-,82700,4417
670,532,138,728,76400,4418
1080,934,146,967,166300,4419
225,130,95,1073,335500,4421
482,456,26,517,133600,4422
354,286,68,477,83800,4424
1912,1310,602,578,121800,4426
1013,867,146,588,135100,4427
1205,1016,189,881,152400,4428
2004,1711,293,807,197600,4429
813,598,215,563,56700,4430
23,23,0,-,-,4431
402,362,40,873,139700,4434
428,405,23,-,122100,4435
466,363,103,647,127800,4438
721,564,157,585,164000,4441
9,9,0,-,-,4442
921,682,239,528,116200,4443
3599,3003,596,961,216900,4444
569,440,129,728,84300,4448
539,467,72,818,122400,4449
506,444,62,842,119200,4450
116,108,8,-,57300,4451
338,247,91,644,86800,4453
12,12,0,-,76700,4454
266,224,42,673,110100,4455
1074,872,202,971,157900,4456
2437,1577,860,670,107200,4457
419,331,88,385,70500,4459
576,525,51,579,58700,4460
1277,966,311,929,119900,4461
2464,1753,711,512,64300,4462
1267,935,332,777,69500,4463
245,174,71,482,106300,4464
3919,2590,1329,735,133800,4468
0,0,0,-,-,4469
309,286,23,-,76400,4471
912,837,75,875,176400,4472
3149,1588,1561,921,176100,4473
1466,1287,179,950,181200,4474
233,195,38,345,82500,4475
575,499,76,778,207400,4476
190,146,44,-,227300,4478
585,469,116,685,101900,4479
204,188,16,-,145500,4481
81,71,10,-,146900,4485
380,351,29,638,67700,4487
555,475,80,535,150200,4488
94,53,41,1606,144800,4489
112,110,2,-,84200,4490
72,68,4,-,50000,4491
50,44,6,-,84000,4492
778,663,115,620,106700,4493
185,167,18,640,74100,4495
1626,1376,250,568,168900,4496
159,138,21,-,59300,4497
5086,3136,1950,855,196800,4530
348,294,54,1101,241400,4535
989,905,84,975,286800,4537
951,651,300,732,245300,4538
503,451,52,1290,214400,4539
23,23,0,-,471900,4541
895,553,342,834,263800,4543
327,302,25,-,527800,4544
436,373,63,885,189700,4547
458,392,66,713,338000,4548
324,295,29,1036,262100,4551
796,562,234,871,278800,4553
368,303,65,947,383300,4554
761,645,116,850,220300,4555
561,460,101,900,247800,4556
95,95,0,-,314400,4558
990,883,107,838,240400,4562
627,496,131,1074,203600,4563
252,252,0,-,281500,4564
229,167,62,1160,410000,4568
0,0,0,-,-,4570
167,135,32,-,190600,4571
2401,1783,618,454,170200,4572
207,183,24,950,293800,4573
593,546,47,1273,151700,4574
39,39,0,-,825000,4575
278,253,25,775,435000,4576
1869,1233,636,738,186000,4578
1279,1033,246,993,228500,4579
6179,4355,1824,831,186000,4605
494,408,86,722,160200,4606
505,418,87,640,206600,4607
2336,1451,885,864,315700,4609
180,146,34,850,179500,4611
237,210,27,-,303600,4612
33,33,0,-,-,4613
1173,867,306,760,252900,4614
319,300,19,944,209300,4616
342,291,51,775,278100,4617
1539,1074,465,582,97600,4619
535,409,126,492,100700,4622
368,295,73,825,111800,4623
74,68,6,-,340600,4624
39,32,7,-,420000,4625
214,185,29,519,170500,4626
650,496,154,-,250000,4627
256,212,44,288,132000,4628
0,0,0,-,-,4629
581,472,109,856,119800,4630
629,460,169,525,116500,4631
779,619,160,948,153000,4634
6,4,2,-,-,4635
90,78,12,617,210000,4637
1020,811,209,817,180400,4640
58,52,6,-,239300,4642
396,317,79,1000,122500,4643
0,0,0,-,-,4644
14,5,9,-,-,4645
38,27,11,-,304200,4646
277,214,63,767,96700,4648
578,412,166,-,132000,4649
152,146,6,-,-,4650
836,680,156,328,119500,4652
292,163,129,787,269600,4653
1389,890,499,630,117900,4654
339,248,91,950,147200,4655
163,134,29,631,189300,4657
607,462,145,754,114900,4658
532,494,38,1295,441100,4660
203,127,76,1029,387500,4662
489,405,84,965,164100,4664
560,483,77,755,103100,4666
573,409,164,461,98800,4667
627,432,195,273,86400,4668
72,72,0,-,187500,4669
237,212,25,1125,169400,4671
63,60,3,-,308700,4673
182,160,22,939,263300,4674
64,53,11,-,599000,4675
462,425,37,1183,190900,4676
112,93,19,825,202800,4677
673,455,218,525,292100,4679
558,477,81,850,157200,4680
481,351,130,806,250600,4681
51,40,11,-,-,4683
771,650,121,907,219800,4684
189,154,35,725,265000,4685
62,53,9,-,78300,4686
140,115,25,1167,161200,4691
210,148,62,725,175800,4693
970,761,209,673,91200,4694
4050,2567,1483,532,105300,4730
745,568,177,475,89600,4732
126,89,37,-,98800,4733
316,266,50,686,99000,4734
263,230,33,417,86300,4735
4044,2796,1248,593,91000,4736
324,276,48,425,96700,4739
571,426,145,586,95100,4740
4,4,0,-,-,4741
1452,1097,355,-,95900,4742
1863,1425,438,633,115900,4743
418,358,60,873,105800,4745
203,154,49,428,55400,4746
585,492,93,511,100000,4747
761,452,309,684,77000,4750
1614,1036,578,494,102300,4756
1210,1046,164,584,133700,4757
551,404,147,589,101200,4758
317,246,71,505,107200,4760
214,190,24,764,151700,4761
225,179,46,-,110300,4762
305,226,79,396,76200,4763
18,16,2,-,114300,4764
468,373,95,563,85400,4765
163,126,37,738,95800,4766
193,179,14,910,127200,4768
4058,2477,1581,592,115400,4769
362,268,94,442,121600,4772
300,205,95,638,127400,4773
295,240,55,339,73600,4774
390,359,31,879,91100,4776
172,155,17,492,84000,4777
157,147,10,-,191000,4779
335,299,36,630,77100,4780
242,210,32,-,111500,4781
207,181,26,492,115100,4783
964,625,339,542,78600,4785
818,602,216,410,83500,4786
215,193,22,537,82900,4787
3486,1949,1537,782,172800,4841
2431,1816,615,930,356000,4843
634,562,72,884,236300,4847
293,273,20,775,325000,4848
1723,1492,231,900,253000,4849
42,42,0,-,254500,4851
29,22,7,830,422200,4852
209,177,32,936,259600,4853
700,590,110,1049,251800,4854
129,129,0,-,438500,4855
1356,1048,308,879,273600,4856
548,484,64,1044,231100,4858
338,301,37,1055,255300,4859
734,684,50,988,206300,4860
1252,897,355,744,172300,4861
1562,1354,208,966,186300,4862
438,325,113,863,260900,4863
1491,1368,123,860,166800,4864
11252,6645,4607,761,136800,4901
838,703,135,833,140200,4910
949,723,226,680,69100,4911
376,324,52,425,100900,4912
3937,2617,1320,894,172300,4915
1080,1023,57,640,214600,4917
152,100,52,-,208800,4918
754,629,125,508,80600,4920
659,555,104,778,130300,4921
498,423,75,775,114700,4922
216,209,7,-,101300,4923
873,657,216,799,123200,4924
31,29,2,-,169600,4925
43,43,0,-,-,4926
1471,1126,345,840,113100,4927
878,709,169,792,131000,4928
327,205,122,792,120500,4929
1818,1294,524,828,117800,4930
530,469,61,771,144300,4932
29,23,6,-,-,4933
102,97,5,-,192000,4936
2759,1764,995,686,121600,4937
3583,2514,1069,687,151600,4938
464,424,40,943,104500,4939
0,0,0,-,-,4940
725,635,90,813,151200,4941
570,523,47,825,109600,4942
747,575,172,672,102100,4943
20,20,0,-,-,4944
481,381,100,568,117100,4945
650,576,74,744,193400,4947
387,338,49,750,143300,4949
1900,1494,406,737,111600,4950
475,405,70,780,131500,4951
851,708,143,872,156900,4952
1395,1025,370,702,160400,4953
621,555,66,827,135300,4955
344,314,30,638,124500,4956
1666,1371,295,783,123900,4957
688,598,90,636,118800,4958
406,380,26,620,113400,4961
55,23,32,783,-,4962
3083,2750,333,769,163300,4963
56,50,6,-,240900,4964
877,739,138,971,89100,4965
799,670,129,384,105400,4966
1621,1093,528,-,123500,4967
483,399,84,917,121400,4969
671,495,176,632,210400,4970
766,678,88,525,125700,4971
532,446,86,725,162900,4973
1324,914,410,532,127300,4974
14,14,0,-,-,4975
4270,2979,1291,782,124100,4976
331,287,44,635,153600,4978
378,320,58,692,117100,4979
1231,1080,151,815,164200,4981
252,171,81,457,154900,4982
647,552,95,668,114600,4983
233,197,36,733,117900,4984
31,24,7,-,90000,4985
643,529,114,740,121900,4986
404,354,50,865,138400,4987
861,592,269,644,165300,4988
1811,1490,321,815,165100,4989
29,29,0,-,-,4992
4537,3200,1337,988,232500,5001
36,36,0,-,554300,5031
995,777,218,821,210000,5032
1115,779,336,970,173600,5033
143,87,56,769,225800,5034
328,254,74,1029,237500,5035
426,361,65,911,248600,5036
260,248,12,-,269400,5037
557,437,120,722,154200,5038
520,435,85,1024,179000,5039
240,221,19,598,161300,5040
101,75,26,-,161600,5041
231,180,51,850,161400,5042
465,376,89,1011,271600,5043
871,704,167,900,204400,5045
452,366,86,558,157700,5046
1283,1063,220,940,226700,5048
64,33,31,843,158000,5050
713,563,150,976,160700,5051
107,72,35,-,219000,5052
166,156,10,-,414800,5053
1238,895,343,935,465800,5055
235,204,31,621,296900,5056
160,129,31,1625,234100,5058
181,152,29,-,357600,5059
1896,1383,513,793,190000,5060
497,451,46,876,219100,5061
231,204,27,983,234400,5062
423,316,107,1071,232700,5065
87,77,10,-,282000,5067
1389,824,565,1111,191300,5068
176,153,23,1672,152700,5069
247,223,24,888,346800,5070
92,92,0,-,354100,5071
189,164,25,1659,248700,5072
433,379,54,871,221900,5075
167,130,37,963,163600,5076
530,438,92,967,235500,5077
286,257,29,1078,170400,5079
206,110,96,670,165000,5081
115,84,31,580,130600,5083
47,47,0,-,-,5084
295,263,32,813,164200,5086
1907,1256,651,970,186500,5089
1446,1057,389,961,426800,5091
1939,1009,930,802,143400,5101
108,81,27,-,165900,5141
281,229,52,1273,204900,5142
1807,1399,408,786,216800,5143
280,241,39,925,240200,5146
433,366,67,1120,197500,5148
896,647,249,850,239500,5149
325,216,109,960,133300,5150
623,590,33,1025,221100,5151
149,131,18,994,330900,5152
244,194,50,796,191700,5153
183,115,68,789,219400,5154
395,244,151,796,257600,5155
4031,2815,1216,848,150300,5156
497,402,95,920,158700,5158
263,229,34,-,362800,5161
5766,3679,2087,823,163300,5201
1514,1234,280,1024,236900,5250
532,461,71,791,352400,5251
120,117,3,-,168800,5252
263,204,59,640,281300,5253
73,73,0,-,386400,5254
1909,1243,666,656,299800,5255
931,650,281,946,207900,5257
179,179,0,-,173400,5260
930,875,55,-,159500,5261
861,774,87,796,269600,5262
7461,4322,3139,871,230500,5301
347,318,29,-,271300,5340
203,163,40,1688,262500,5341
264,231,33,938,187100,5342
329,279,50,964,233200,5343
971,817,154,1038,229100,5345
2060,1626,434,961,205600,5346
274,219,55,-,148300,5350
373,347,26,917,196800,5352
372,276,96,1056,205700,5353
852,641,211,804,221800,5354
302,260,42,929,204200,5355
328,230,98,1016,288600,5356
62,54,8,1063,189300,5358
258,218,40,1070,233300,5359
83,59,24,534,360700,5360
451,371,80,1125,204200,5361
33,31,2,-,325000,5362
933,594,339,1020,232800,5363
12605,3362,9243,1242,328100,5401
8628,5135,3493,1399,306600,5403
3189,1175,2014,1144,225200,5404
0,0,0,-,-,5405
4083,2692,1391,973,254100,5408
0,0,0,-,-,5439
753,587,166,954,187500,5440
329,293,36,743,208300,5441
177,162,15,-,154300,5442
2793,2166,627,1032,246200,5443
669,570,99,946,244100,5444
1462,1330,132,1794,538100,5445
6849,4708,2141,1166,265000,5446
30,22,8,-,181300,5447
338,324,14,-,216700,5448
1909,1490,419,758,198400,5450
8871,6272,2599,1252,301200,5452
1956,1548,408,1393,254400,5454
405,298,107,639,258600,5455
486,412,74,749,274100,5456
623,554,69,786,195000,5457
899,753,146,996,292000,5458
861,665,196,1122,183900,5459
1922,1436,486,1125,339600,5461
805,742,63,1341,279400,5462
187,177,10,883,197300,5463
1295,862,433,1038,243700,5464
2069,1868,201,973,314500,5465
5281,4370,911,1183,252400,5468
248,200,48,900,155500,5471
713,587,126,1083,261200,5472
624,488,136,1289,332700,5473
405,363,42,1138,298600,5474
1267,839,428,953,148000,5476
1813,1424,389,1153,323700,5477
5809,3831,1978,1041,219700,5478
0,0,0,-,-,5481
3182,2342,840,1736,386200,5482
540,471,69,1269,231300,5483
30,30,0,-,120000,5485
706,598,108,1188,371100,5486
618,542,76,1326,223000,5487
2817,2092,725,965,216800,5488
1327,1205,122,1313,330900,5489
2357,1743,614,1007,242500,5491
278,245,33,970,169100,5492
722,669,53,1259,295700,5494
4153,3329,824,1352,347200,5495
5353,3472,1881,1021,255700,5602
68,51,17,1614,286500,5640
7272,4717,2555,814,179100,5641
472,391,81,918,210900,5647
209,167,42,1115,300700,5648
185,185,0,-,136700,5649
515,433,82,961,281100,5650
676,611,65,1030,240900,5651
290,262,28,1188,148700,5652
252,208,44,-,190500,5653
465,225,240,921,119500,5654
1276,1145,131,836,190100,5655
1349,766,583,886,161100,5656
32,32,0,-,218200,5657
580,542,38,787,172900,5658
747,655,92,944,289200,5660
2387,1659,728,951,195800,5661
2106,1423,683,887,184200,5663
68,68,0,-,-,5664
888,653,235,987,226400,5667
296,253,43,769,204400,5669
2105,1459,646,1081,395500,5672
1125,823,302,1042,355000,5673
678,548,130,746,365200,5674
497,460,37,936,161900,5675
1999,1392,607,975,264100,5676
1012,795,217,829,311000,5677
47,47,0,-,-,5678
1396,1112,284,883,180000,5679
898,767,131,933,207500,5680
151,145,6,-,189400,5681
542,465,77,994,243000,5682
9117,5419,3698,798,169700,5701
117,105,12,975,171600,5730
330,217,113,743,216800,5732
2475,1859,616,779,188600,5733
568,429,139,988,261200,5734
1722,1278,444,865,177100,5735
246,150,96,943,171500,5736
376,331,45,783,198800,5737
482,418,64,1125,241300,5738
522,407,115,866,198600,5739
27,27,0,-,-,5740
273,226,47,922,226400,5742
1574,1201,373,858,158800,5743
251,159,92,1169,211300,5744
120,84,36,963,209100,5747
150,116,34,863,156800,5748
314,265,49,1260,314200,5751
3684,2392,1292,1027,279600,5753
337,277,60,969,222200,5757
303,292,11,796,203300,5758
701,565,136,755,203900,5759
488,445,43,818,215700,5760
428,385,43,783,206300,5761
189,152,37,964,177800,5762
1071,917,154,935,179700,5763
1264,900,364,812,170900,5764
721,582,139,948,163500,5765
273,222,51,1281,239200,5766
527,441,86,755,189500,5767
455,368,87,914,253600,5769
445,340,105,1045,235200,5770
307,275,32,742,209900,5772
921,730,191,975,193300,5773
437,374,63,845,162800,5774
195,142,53,773,186500,5775
277,216,61,733,276800,5776
1432,1192,240,822,158300,5777
269,225,44,1136,219800,5778
3839,2476,1363,765,167000,5819
254,234,20,542,167800,5820
463,430,33,879,195500,5821
700,560,140,671,137500,5822
491,411,80,759,172400,5824
37,30,7,-,168800,5825
385,324,61,907,168900,5826
115,90,25,745,181300,5827
872,711,161,856,207500,5828
725,576,149,825,191100,5829
619,473,146,774,145700,5830
400,371,29,841,239600,5832
108,94,14,-,180800,5833
483,417,66,779,167100,5836
126,114,12,1500,123600,5837
296,267,29,458,165100,5839
182,154,28,439,288900,5841
215,184,31,964,141100,5842
1164,863,301,795,109200,5843
529,465,64,583,148500,5845
532,346,186,721,136600,5846
365,250,115,946,171400,5847
59,38,21,-,-,5850
2437,1584,853,803,168600,5851
226,212,14,1406,164400,5853
3084,1981,1103,821,157200,5855
1139,1014,125,1013,189900,5857
195,184,11,-,102900,5858
745,570,175,736,158900,5859
1194,999,195,771,127400,5860
126,103,23,778,229700,5862
269,239,30,625,136400,5866
311,253,58,941,213000,5867
128,128,0,-,182000,5868
577,468,109,807,162800,5871
398,320,78,764,136000,5872
290,211,79,1287,175300,5873
244,207,37,821,179900,5874
178,156,22,725,211300,5875
7,7,0,-,-,5901
96,70,26,-,113500,5902
365,293,72,721,123500,5903
105,63,42,846,70600,5904
349,318,31,675,170000,5905
556,488,68,755,124200,5906
67,58,9,-,169400,5907
7133,5898,1235,1463,379100,6001
8727,6241,2486,1353,214600,6002
24638,15679,8959,1027,197800,6010
3462,3231,231,1095,335500,6013
2638,1800,838,1345,237200,6016
1186,729,457,1036,183100,6018
3983,3157,826,1123,320700,6019
0,0,0,-,-,6020
136,119,17,-,277600,6021
63,63,0,-,-,6022
617,474,143,1179,255200,6023
221,182,39,-,253200,6024
2027,1637,390,943,284300,6026
551,504,47,1125,271600,6027
6982,4367,2615,1226,282800,6029
567,492,75,1137,363800,6031
7276,5177,2099,1479,341400,6032
11247,8702,2545,1356,336700,6033
2948,2640,308,1045,287000,6035
7564,6432,1132,1204,285600,6037
957,550,407,1140,366700,6039
14013,7624,6389,1143,197100,6040
9632,5388,4244,1472,174000,6042
1821,1656,165,959,275900,6043
11857,3256,8601,961,155800,6051
3169,1821,1348,1113,208300,6052
13232,6257,6975,1070,157300,6053
2359,2244,115,1127,295600,6057
711,533,178,913,325800,6058
0,0,0,-,-,6059
847,792,55,-,389900,6060
132,83,49,-,159800,6061
7637,5421,2216,1027,219700,6062
1182,1084,98,1422,256000,6063
262,262,0,-,242400,6065
13057,6836,6221,1097,203300,6066
8621,5474,3147,1409,268700,6067
698,519,179,1958,707500,6068
1102,784,318,932,358600,6069
6138,4914,1224,1428,335900,6070
3632,3155,477,1261,323300,6071
2156,1995,161,1393,430900,6073
9783,8200,1583,1290,287100,6074
5057,3794,1263,1012,196500,6076
3888,3315,573,1216,309600,6078
639,373,266,1062,202000,6081
16744,12636,4108,1159,190400,6082
5252,4872,380,1404,287100,6084
2917,2260,657,966,319000,6085
2217,1512,705,1104,182400,6088
1317,958,359,1394,319000,6089
367,327,40,1750,399300,6090
39,33,6,-,320600,6091
1506,1359,147,2265,363700,6092
1270,1195,75,1447,312400,6093
10786,8916,1870,1279,225500,6095
5307,4191,1116,1189,188200,6096
5072,3340,1732,985,172600,6098
1287,129,1158,1536,-,6103
9755,1646,8109,905,250800,6105
14050,3301,10749,1001,162300,6106
7434,6415,1019,1606,383600,6107
8874,4223,4651,991,160600,6108
10917,8655,2262,1052,255300,6109
5023,3358,1665,1204,224000,6110
12366,9678,2688,1263,230500,6111
7500,2795,4705,1050,160400,6112
9894,2611,7283,1029,170100,6114
5487,4472,1015,1525,374500,6117
10180,6929,3251,1094,166300,6118
6551,3219,3332,1286,304500,6119
4490,876,3614,903,151600,6120
0,0,0,-,-,6160
6544,2335,4209,883,148400,6226
1409,1364,45,1055,312400,6231
1216,1075,141,821,273900,6232
2922,2146,776,1007,230500,6234
975,873,102,938,208900,6235
2169,2050,119,1151,254600,6237
4635,4078,557,1140,253100,6238
4629,2941,1688,999,190500,6239
2555,1919,636,1089,190700,6241
502,426,76,950,258000,6242
72,72,0,-,-,6243
1121,1002,119,1101,231000,6247
2119,1973,146,1000,289400,6248
2818,2453,365,1119,256100,6249
1746,1270,476,1334,230700,6250
717,624,93,698,246900,6254
1727,1153,574,1027,211600,6255
898,809,89,1269,165000,6256
1772,1481,291,914,287700,6259
4088,2372,1716,882,194700,6260
368,272,96,624,199200,6262
109,37,72,905,198900,6263
43,29,14,-,-,6264
258,147,111,891,158800,6266
3769,1765,2004,1355,256800,6268
9,9,0,-,-,6269
1445,1333,112,1530,224400,6277
1838,1346,492,964,232400,6278
2577,1665,912,1123,225200,6279
1232,840,392,1290,206500,6280
2862,2453,409,1096,273000,6281
424,371,53,-,202300,6282
10740,3961,6779,987,181900,6320
1247,828,419,1161,234300,6330
1916,1698,218,954,228200,6331
188,130,58,783,189300,6332
2619,2096,523,1565,354600,6333
981,813,168,1004,224700,6334
2470,2139,331,1225,242100,6335
29,25,4,-,340500,6336
3211,2582,629,1147,232100,6339
12321,4743,7578,1269,210500,6340
24,24,0,-,-,6350
6616,5001,1615,1029,199700,6351
91,73,18,-,-,6353
2233,1328,905,985,180200,6354
5521,4476,1045,1312,328200,6355
4726,3497,1229,1272,292800,6357
2070,1738,332,1098,286800,6359
14853,7933,6920,1080,165200,6360
1830,1560,270,1338,247600,6365
2783,2366,417,1052,229500,6370
4165,3342,823,1367,411400,6371
71,47,24,-,335400,6373
2846,2207,639,900,186900,6374
1378,1257,121,1143,239700,6375
88,64,24,-,510000,6376
1159,1022,137,1049,202200,6377
2530,1949,581,1393,428700,6378
3796,2553,1243,963,271700,6379
1244,366,878,920,149300,6380
4112,3182,930,1184,190100,6382
1092,939,153,1089,224300,6384
6340,5090,1250,1336,257200,6385
158,31,127,1232,182400,6387
0,0,0,-,-,6389
40,15,25,1369,-,6390
7754,4595,3159,1101,213600,6401
2447,2147,300,1364,257200,6403
12302,8366,3936,1368,292300,6405
422,323,99,813,280800,6409
10145,8909,1236,1298,334800,6410
1772,1355,417,1219,348700,6412
5388,4295,1093,1234,282200,6413
42,42,0,-,257100,6414
6244,4823,1421,1270,256800,6415
5897,4492,1405,1200,236300,6416
1883,1350,533,1273,287500,6417
5198,2992,2206,1087,207500,6418
2304,2161,143,1161,358300,6419
1679,1527,152,1347,287400,6420
2768,2617,151,1358,309700,6422
2169,1962,207,944,299800,6423
4802,4203,599,1303,265000,6424
1656,1120,536,1511,486000,6426
8397,7269,1128,1474,399600,6437
1079,822,257,828,328200,6438
1874,1610,264,1268,313300,6441
996,805,191,1186,337700,6442
6912,5919,993,1478,428600,6443
109,93,16,-,265400,6444
2331,2036,295,1072,316900,6447
15390,9396,5994,1048,169800,6450
10235,5482,4753,997,176300,6451
1201,1089,112,1375,285200,6455
135,105,30,-,346900,6456
19294,10170,9124,1133,231300,6457
16656,11512,5144,1583,304500,6460
5795,5208,587,1481,330700,6461
124,124,0,-,231400,6467
6673,6049,624,1364,370200,6468
1194,902,292,1035,277200,6469
5909,5087,822,1318,409100,6470
3006,2497,509,1362,276700,6471
2400,2140,260,1454,306200,6472
9164,7506,1658,1325,297900,6473
4343,3506,837,1519,382700,6475
4974,4372,602,1648,389900,6477
4694,4415,279,-,354100,6478
4029,3349,680,1134,266700,6479
3741,3086,655,1115,252600,6480
557,390,167,1056,275600,6481
3976,3655,321,1756,385300,6482
6203,4409,1794,1152,253300,6483
16185,13039,3146,1466,349300,6484
7966,6807,1159,1587,325000,6488
12870,10698,2172,1108,282200,6489
18688,13494,5194,1094,268000,6492
3177,2587,590,1215,367300,6498
1582,122,1460,1551,335500,6510
20905,4453,16452,1259,225300,6511
11304,7519,3785,1228,211800,6512
14792,5835,8957,1084,183200,6513
9995,6142,3853,1337,198100,6514
6519,2525,3994,1192,223100,6515
19886,10867,9019,1164,193800,6516
5909,3836,2073,1073,243500,6517
6655,4454,2201,1692,246800,6518
5140,1305,3835,1129,171700,6519
2018,1832,186,1142,381500,6524
2897,2552,345,1375,464400,6525
9871,2855,7016,1130,192000,6604
8842,2416,6426,1170,227400,6605
15984,9873,6111,1231,176900,6606
2791,869,1922,1182,128500,6607
4499,1102,3397,1168,150600,6608
8651,4073,4578,1102,154900,6610
12197,10534,1663,2028,399200,6611
2792,2596,196,1833,641500,6612
12549,11033,1516,1404,267900,6614
7308,4686,2622,1204,229100,6615
1676,47,1629,493,98800,6702
9169,3564,5605,954,127300,6704
10207,3836,6371,1052,124500,6705
5037,2394,2643,926,117700,6706
11201,5984,5217,1027,141000,6708
3636,1098,2538,1005,145800,6710
3336,2979,357,1274,290600,6712
6052,5136,916,1362,247500,6716
507,291,216,730,261100,6750
1204,1008,196,1391,328500,6751
704,604,100,1870,476100,6752
724,595,129,1583,386000,6754
322,292,30,-,277300,6755
1074,1015,59,1810,329700,6756
858,685,173,1433,341600,6757
127,117,10,-,322400,6758
2456,1933,523,1159,356600,6759
2725,2515,210,1179,341600,6762
727,610,117,936,325900,6763
11665,8051,3614,1066,183600,6770
10165,7865,2300,1248,303600,6776
614,562,52,1429,376700,6777
530,490,40,-,259600,6778
3347,2385,962,1124,195900,6779
911,826,85,994,223100,6782
887,747,140,1194,599900,6783
1495,1289,206,2026,459900,6784
275,228,47,-,483300,6785
3947,3038,909,1015,192900,6786
3193,2406,787,1010,221400,6787
14472,9714,4758,949,153700,6790
1943,1860,83,944,310300,6791
580,404,176,1704,718300,6793
334,259,75,1424,335700,6794
5136,4350,786,987,257700,6795
488,424,64,1030,439200,6796
4129,3211,918,1190,350100,6798
7150,5628,1522,1252,342400,6801
6272,5209,1063,1640,377200,6804
2679,1856,823,1980,1082200,6807
19018,8893,10125,1466,266200,6810
10924,8507,2417,1458,333500,6811
4971,4641,330,2067,348800,6812
6895,5973,922,2469,1471700,6820
11712,9925,1787,2014,689900,6824
7267,5646,1621,1690,467700,6825
9510,4888,4622,1853,1505200,6830
5048,3800,1248,1987,1120500,6831
7116,5610,1506,2228,1355800,6840
7531,4296,3235,1809,436800,6850
10570,7295,3275,1747,443200,6851
1525,1177,348,2117,996300,6853
11042,5385,5657,1574,377200,6854
3420,1620,1800,1695,477100,6855
0,0,0,-,-,6856
2539,2110,429,2170,1448700,6870
9023,7734,1289,1777,653400,6877
2584,2113,471,2067,1529300,6878
10065,8574,1491,1952,1137400,6880
3447,3321,126,2724,868200,6883
1612,1397,215,2234,852800,6890
3430,2865,565,1490,578400,6896
6090,5255,835,2335,793200,6897
4082,648,3434,1743,323400,6901
26218,10363,15855,1804,431300,6902
4752,4478,274,3375,744800,6903
7417,5443,1974,2043,565200,6905
3358,2109,1249,1751,460900,6906
3225,2221,1004,1632,473700,6907
5022,2531,2491,1494,263700,7001
24967,9604,15363,1255,333700,7002
18577,9564,9013,1379,329900,7003
2621,2387,234,1916,517500,7004
5489,4011,1478,1409,466700,7005
9576,7356,2220,1593,556500,7006
7925,4574,3351,1492,272200,7008
4530,3626,904,1540,473100,7009
10512,4777,5735,1468,447900,7010
12649,5959,6690,1409,312800,7011
4578,2532,2046,1462,355000,7012
10011,6988,3023,1343,365200,7013
1844,1331,513,1446,326600,7014
8894,7030,1864,1705,486600,7016
13167,3772,9395,1069,222900,7017
10377,2247,8130,1163,212400,7018
5751,2026,3725,2506,600600,7020
765,718,47,2250,848500,7021
5236,1672,3564,1467,364900,7022
2506,2217,289,2710,467800,7023
17479,10375,7104,1923,324600,7024
11563,4673,6890,1327,338400,7026
1725,1016,709,1551,380800,7027
2495,2279,216,1702,649500,7028
7266,1987,5279,1468,328600,7029
25182,8263,16919,2315,720700,7030
6384,3350,3034,1375,363400,7031
13351,6248,7103,1305,333100,7032
2733,1909,824,1521,345500,7033
3318,2073,1245,1203,326300,7034
3726,2937,789,1643,333400,7035
15406,8671,6735,1273,280300,7036
10225,8854,1371,2811,627000,7039
7945,6148,1797,1679,529400,7040
2513,1647,866,1691,789200,7041
10436,5286,5150,1668,516500,7042
4132,3405,727,2007,750800,7043
5310,4278,1032,1685,454500,7044
3883,3734,149,2976,590700,7045
1357,1295,62,1454,862400,7046
21794,8756,13038,1437,350600,7047
11682,2391,9291,1160,236400,7050
16414,11413,5001,1486,385200,7052
11164,5613,5551,1377,461700,7054
19854,4444,15410,1183,332600,7055
4683,1961,2722,1237,375800,7057
1825,1036,789,1850,643100,7058
5192,4788,404,1652,789600,7059
14971,6018,8953,1229,275200,7060
4029,2397,1632,1308,243200,7062
3988,2479,1509,1352,257700,7063
1316,1109,207,1365,293200,7064
11304,6748,4556,1310,272700,7065
5932,4625,1307,1433,446700,7066
6197,5461,736,1637,364600,7067
2349,1820,529,2579,485100,7068
2099,1744,355,2021,660400,7069
6977,4457,2520,1440,473500,7070
8738,4928,3810,1420,375600,7071
2414,1524,890,1290,408600,7072
3966,1356,2610,1586,381100,7073
937,669,268,1199,360100,7074
3315,2340,975,1779,411800,7075
8747,7168,1579,1584,497400,7076
970,667,303,1353,285900,7077
4143,3736,407,2667,1391900,7078
5162,3522,1640,1697,604300,7079
7924,6694,1230,1702,340200,7080
6901,4239,2662,1814,436900,7081
1579,1468,111,2375,577200,7082
19094,14341,4753,1542,332300,7083
6633,1999,4634,1531,650400,7086
24512,5102,19410,1225,340900,7087
1246,762,484,1602,237900,7088
10280,8465,1815,1608,743800,7090
2528,2302,226,1739,627300,7092
24117,5553,18564,1323,325900,7093
7557,4395,3162,1689,460800,7094
7438,4179,3259,1697,279800,7095
5501,445,5056,821,244800,7102
11835,2711,9124,1053,186200,7103
18934,4319,14615,1083,276700,7104
17320,3773,13547,1218,326500,7105
11575,3650,7925,1073,218300,7106
13207,2848,10359,1047,235500,7107
8928,1446,7482,956,203400,7108
12189,6311,5878,1346,295600,7109
11033,7215,3818,1349,387700,7110
20024,5590,14434,1048,182400,7111
9695,2590,7105,1125,239000,7112
3375,538,2837,753,256900,7114
8651,1992,6659,1181,266900,7201
13097,3073,10024,1162,278100,7202
7402,4226,3176,1183,225100,7203
4948,2860,2088,1275,284000,7204
7342,4935,2407,1395,259300,7205
7894,1996,5898,1191,253900,7206
11123,2801,8322,1130,324200,7208
22355,5840,16515,2384,695600,7302
16075,4649,11426,1161,304300,7304
22652,9121,13531,1210,311300,7305
20107,4571,15536,1209,358800,7306
15721,4956,10765,1337,406000,7307
6097,890,5207,2915,765900,7310
205,0,205,2904,-,7311
2210,1848,362,1919,757000,7401
2953,1954,999,1645,303700,7403
6394,4916,1478,1413,451400,7405
6738,3807,2931,1660,362700,7407
11387,9030,2357,1560,424000,7410
2232,1650,582,1098,194400,7416
3845,3435,410,2642,945900,7417
762,744,18,-,271900,7418
3592,2794,798,1400,222500,7419
1716,1334,382,1620,269200,7420
2653,2384,269,1770,258600,7421
2334,2224,110,1530,222500,7422
1438,1322,116,2453,756800,7423
9756,6610,3146,1453,367400,7424
9778,7580,2198,2004,498400,7430
2669,1790,879,1781,513400,7432
852,751,101,1057,381300,7435
4237,3836,401,1642,468700,7436
4386,4078,308,1484,350000,7438
827,694,133,1440,223900,7439
1513,1245,268,1307,432500,7440
4004,2950,1054,1536,302700,7442
4658,3665,993,2095,422700,7444
5512,4787,725,1646,598200,7446
8310,6494,1816,2026,762600,7450
3776,3569,207,1840,646600,7452
4092,3899,193,1842,366200,7456
1817,1284,533,2098,347400,7457
3859,3365,494,2506,1013900,7458
1269,1187,82,2100,279800,7460
6583,5587,996,1197,273400,7461
2553,1858,695,1381,213800,7462
3566,3123,443,2006,448900,7463
2553,2166,387,1528,343100,7465
18350,14588,3762,1672,468500,7470
6026,5357,669,1531,291700,7480
5833,5260,573,1730,742900,7481
0,0,0,-,-,7495
10745,1486,9259,1125,247400,7501
4504,2246,2258,1290,235800,7502
5399,1653,3746,1249,252500,7503
3682,1244,2438,1268,286700,7504
1034,45,989,913,-,7505
7118,4208,2910,1485,381000,7506
7541,4810,2731,1444,356000,7508
3595,2955,640,1569,371200,7512
3324,1008,2316,1318,251600,7513
6099,1704,4395,1195,219700,7514
6078,1303,4775,1172,219500,7522
4181,1069,3112,1172,259900,7524
19080,6328,12752,1440,296300,7601
2792,2017,775,1394,336000,7603
4224,2768,1456,1445,429100,7604
3355,2127,1228,1444,506100,7605
794,368,426,1534,414400,7606
3511,2306,1205,1601,389300,7607
40,0,40,1575,-,7608
564,477,87,-,"2,000,000+",7620
8946,6192,2754,1420,358200,7621
2778,2291,487,2188,674000,7624
2812,2394,418,2686,677500,7626
1680,1474,206,2773,681500,7627
6370,4672,1698,1306,376100,7628
2541,2178,363,1847,492000,7630
11087,6056,5031,1469,387400,7631
1843,1659,184,3337,991000,7632
1626,1514,112,2514,601200,7640
1113,1059,54,"3,500+",691500,7641
3475,2958,517,1405,565200,7642
4096,1750,2346,1349,329300,7643
8805,3878,4927,1348,373000,7644
2975,2627,348,1833,619400,7645
5859,3650,2209,1438,426800,7646
1713,1426,287,1600,467700,7647
2160,1767,393,1851,626700,7648
2788,2470,318,1651,615500,7649
7403,2719,4684,1520,558400,7650
8232,7069,1163,2011,600200,7652
3259,2650,609,1474,589800,7656
3827,1728,2099,1584,442500,7657
4720,2584,2136,1368,349100,7660
3867,2935,932,1676,520800,7661
2001,1487,514,1709,380800,7662
5328,3665,1663,1700,379000,7663
13072,9502,3570,1483,408500,7666
4690,3659,1031,2271,829600,7670
10034,7568,2466,1754,589200,7675
3320,3118,202,-,509400,7676
1963,1746,217,2069,812300,7677
9950,6670,3280,1598,404900,7701
1434,1299,135,2735,589400,7702
52,36,16,-,-,7703
1822,1701,121,2288,731900,7704
605,517,88,1323,734000,7711
16726,7792,8934,1208,415100,7712
3572,2546,1026,1248,455700,7716
897,598,299,1484,884300,7717
2355,2072,283,1734,355900,7718
8395,5981,2414,1482,459800,7719
2152,1024,1128,1348,567400,7720
1247,747,500,1423,267800,7721
3282,2932,350,1945,801500,7722
279,156,123,1125,1078100,7723
8740,5750,2990,1279,374300,7724
15482,13138,2344,1560,460300,7726
2532,1777,755,1059,458900,7727
19954,14679,5275,1672,379500,7728
5821,5094,727,1053,345400,7730
12792,11388,1404,1488,337200,7731
2658,1681,977,1217,293300,7732
5831,5085,746,1563,659500,7733
4861,2897,1964,1320,223800,7734
7104,5242,1862,1209,265700,7735
1435,1253,182,1239,341700,7737
2089,1871,218,420,577900,7738
2043,1935,108,2469,642500,7739
12130,5111,7019,1311,364900,7740
5874,5652,222,2582,564000,7746
11892,9087,2805,1658,370300,7747
9645,7956,1689,1418,452800,7748
1414,1170,244,2534,757300,7750
6222,5590,632,2239,552000,7751
15730,10238,5492,1468,295900,7753
2222,1982,240,1712,400900,7755
1937,749,1188,1281,498700,7756
2238,1835,403,-,513800,7757
1572,1357,215,1480,309200,7758
3128,2709,419,1875,1024400,7760
4038,2634,1404,1496,639600,7762
2485,1884,601,1807,448800,7764
8123,3991,4132,1490,285300,7801
1257,1117,140,1706,300800,7803
0,0,0,-,-,7820
3352,2945,407,1279,318700,7821
279,269,10,-,364000,7822
3331,2257,1074,939,244500,7823
3489,3033,456,1438,341800,7825
2261,1857,404,1488,287100,7826
1668,1363,305,1069,215400,7827
5854,2864,2990,1225,337700,7828
2338,2207,131,1042,480400,7830
1273,1132,141,1214,320400,7832
56,41,15,-,174200,7833
6803,5725,1078,1460,420300,7834
4536,3052,1484,1478,405600,7836
1139,942,197,1460,327100,7838
11754,7722,4032,1235,297700,7840
45,45,0,-,-,7842
4556,3712,844,1453,234900,7843
15,15,0,-,228800,7846
746,652,94,1588,313100,7847
1724,1482,242,1165,335200,7848
3670,3084,586,1461,323200,7849
2238,1665,573,1311,288800,7850
29,26,3,-,343800,7851
1495,1305,190,1548,340900,7852
4181,4006,175,2271,482100,7853
1748,1218,530,2069,297000,7856
1430,678,752,1166,271700,7857
9568,7245,2323,1216,264100,7860
1465,1226,239,858,250000,7863
665,612,53,-,313400,7865
8623,7341,1282,1394,354600,7866
9169,6895,2274,1454,534600,7869
16,7,9,-,-,7870
7188,6478,710,1466,376900,7871
3055,2698,357,1671,259400,7874
3548,3291,257,1676,388800,7876
240,214,26,-,312800,7878
60,60,0,-,130300,7880
4,4,0,-,-,7881
5676,4081,1595,1143,254400,7882
3837,2401,1436,1672,297700,7885
8376,5702,2674,1856,868800,7901
9802,8118,1684,1955,662100,7920
3794,2896,898,2031,378100,7921
4144,3932,212,2555,606100,7922
2581,2219,362,1787,680700,7924
9,0,9,-,-,7926
1590,1065,525,2477,479400,7927
6482,5527,955,2037,806800,7928
3027,2779,248,1393,648900,7930
1031,908,123,2417,922600,7931
3992,2726,1266,2441,643800,7932
1116,992,124,1674,531800,7933
516,461,55,1770,702600,7934
141,118,23,-,-,7935
3771,3586,185,2309,608700,7936
43,13,30,-,-,7939
5589,3779,1810,1807,724000,7940
3109,2853,256,1520,731500,7945
1110,1021,89,3080,630600,7946
7147,5579,1568,2185,480600,7950
18047,11040,7007,1761,597500,7960
0,0,0,-,-,7961
57,57,0,-,341800,7970
4134,3407,727,1754,610800,7974
302,228,74,1408,"2,000,000+",7976
231,128,103,1338,506600,7977
205,205,0,-,629900,7979
905,641,264,1436,588300,7980
3558,3041,517,1879,509600,7981
326,261,65,1042,181000,8001
8956,5770,3186,1422,237600,8002
10870,9587,1283,1688,330300,8003
4029,3627,402,1596,191800,8004
9357,8205,1152,1580,255200,8005
177,161,16,-,697600,8006
2120,1248,872,924,181600,8007
3510,3213,297,1342,808800,8008
4988,4248,740,1251,221900,8009
4343,2572,1771,1284,170400,8010
0,0,0,-,-,8011
14658,9767,4891,1153,204600,8012
187,113,74,-,164900,8014
7161,5643,1518,1175,166600,8015
12145,8923,3222,1094,232200,8016
370,304,66,2104,284200,8019
953,926,27,-,278800,8020
18316,9705,8611,1015,146500,8021
3711,3524,187,1054,319600,8022
143,34,109,1301,116300,8023
760,727,33,2167,214900,8026
1926,1547,379,1067,174200,8027
6479,4247,2232,1239,204500,8028
1972,1416,556,640,170300,8029
4623,3165,1458,1188,127300,8030
4392,2761,1631,898,167700,8031
6054,4617,1437,1140,449700,8033
6893,5482,1411,1347,245500,8034
3004,2426,578,996,285900,8035
2240,2065,175,1083,300100,8036
8325,6448,1877,1193,235100,8037
45,40,5,-,175000,8038
45,21,24,-,312500,8039
330,297,33,-,373800,8041
67,53,14,-,-,8042
11017,7353,3664,1420,324200,8043
1129,709,420,783,166500,8045
10693,8476,2217,1651,166000,8046
4687,3399,1288,1314,319700,8048
2033,1431,602,1044,165300,8049
9935,8395,1540,1692,277800,8050
4176,3314,862,1396,181400,8051
8285,3887,4398,1203,187500,8052
17624,13381,4243,1520,290300,8053
17302,13141,4161,1617,272800,8054
10013,8709,1304,1369,353400,8055
1509,1445,64,1395,367600,8056
7227,5910,1317,1280,514600,8057
2127,1557,570,966,169100,8059
8885,6631,2254,1239,231900,8060
946,847,99,2098,301300,8061
5344,4922,422,1148,357100,8062
1117,914,203,1143,150500,8063
30,30,0,-,-,8064
2825,1963,862,1356,175200,8065
3635,2200,1435,1015,116800,8066
587,521,66,1458,229900,8067
2812,1678,1134,1055,197700,8068
4720,2459,2261,998,143500,8069
5000,3703,1297,971,155200,8070
3544,2608,936,1200,187300,8071
100,100,0,-,158300,8072
46,46,0,-,-,8073
0,0,0,-,-,8074
10947,7802,3145,1224,223700,8075
6898,6068,830,1641,274700,8077
3149,2157,992,1010,163700,8078
3870,2348,1522,910,172600,8079
13396,11878,1518,1503,259000,8080
16791,13745,3046,1329,206300,8081
3718,2806,912,975,193200,8083
2551,1969,582,991,179100,8084
6755,5713,1042,1666,293600,8085
3158,2206,952,1412,215300,8086
10917,9166,1751,1388,229200,8087
9269,8633,636,1480,267800,8088
1502,1270,232,955,190300,8089
2775,2524,251,1384,195900,8090
1957,1333,624,1124,182800,8091
1377,1067,310,1576,282200,8092
3663,2329,1334,1030,153900,8093
14659,12639,2020,1105,204800,8094
17,17,0,-,-,8095
13717,9673,4044,1201,196100,8096
1148,1013,135,971,200300,8097
3269,2327,942,1062,279200,8098
2415,569,1846,680,83400,8102
4726,1921,2805,968,83300,8103
8350,2923,5427,874,69500,8104
8741,3939,4802,969,92300,8105
3793,2434,1359,972,210500,8106
5335,2852,2483,1055,187400,8107
7631,5108,2523,1278,269000,8108
8422,6120,2302,1032,173200,8109
5687,4404,1283,1127,135800,8110
3900,2573,1327,1411,188600,8201
809,758,51,1333,1108100,8202
4052,3003,1049,1344,354200,8203
7735,6021,1714,1119,293800,8204
10210,7908,2302,1235,201400,8205
6381,5199,1182,1346,260200,8210
92,89,3,-,776500,8212
5310,3711,1599,1079,213100,8215
0,0,0,-,-,8217
2509,2142,367,1583,290000,8221
1806,1574,232,1352,277300,8223
185,158,27,1125,243100,8224
2863,2624,239,1720,223100,8225
5253,3746,1507,1264,574100,8226
2085,1892,193,1138,313700,8230
6250,3158,3092,1014,136100,8232
13914,12128,1786,1106,211600,8234
0,0,0,-,-,8240
404,381,23,1600,264300,8241
1274,962,312,1111,258400,8242
1111,1008,103,1444,671700,8243
4425,2556,1869,1148,222100,8244
52,52,0,-,-,8246
498,451,47,1216,1247800,8247
55,55,0,-,472400,8248
4134,3355,779,1168,190600,8251
6103,3953,2150,1058,336600,8260
3014,2268,746,1096,261600,8270
13927,8342,5585,1108,164400,8302
577,413,164,1131,107600,8310
647,472,175,1258,167700,8311
2967,2307,660,1033,199400,8312
174,165,9,-,152300,8314
99,99,0,-,131500,8316
525,457,68,-,251200,8317
4545,4084,461,1227,217200,8318
414,411,3,-,258800,8319
0,0,0,-,-,8320
83,49,34,969,179700,8321
3688,3353,335,1193,206900,8322
231,179,52,1208,203100,8323
108,108,0,-,206900,8324
474,363,111,1552,147500,8326
175,146,29,-,150000,8327
526,503,23,-,165700,8328
152,114,38,-,283800,8329
10566,7757,2809,1450,205100,8330
13741,9223,4518,1056,153900,8332
453,371,82,1388,252700,8340
1032,444,588,807,183500,8341
1718,1529,189,1598,260800,8343
1812,1584,228,1402,174900,8344
231,192,39,946,144700,8345
292,261,31,-,151700,8346
62,45,17,-,125800,8348
697,617,80,1338,127700,8349
232,218,14,-,263900,8350
164,146,18,-,122500,8352
152,105,47,880,159100,8353
14631,8672,5959,1045,156000,8360
6489,5271,1218,1097,207600,8361
15504,4223,11281,904,156700,8401
2933,2379,554,1315,483700,8402
464,401,63,1765,886000,8403
4366,2856,1510,1163,273500,8406
2355,2179,176,1262,415700,8501
3612,2845,767,2028,637900,8502
6880,5176,1704,1234,288100,8505
1812,1674,138,1857,581800,8510
383,318,65,939,233700,8511
4078,2451,1627,1284,483700,8512
1894,1714,180,1325,368400,8514
1702,1560,142,1517,459500,8515
2255,1500,755,1049,205800,8518
9281,6436,2845,1381,295700,8520
1864,1515,349,1541,426700,8525
20389,17332,3057,1439,361700,8527
64,48,16,-,277300,8528
3084,2081,1003,1343,430900,8530
2440,2096,344,1230,340000,8533
4739,4132,607,1649,476100,8534
1583,1476,107,1712,587500,8535
7805,3470,4335,1654,483400,8536
17485,11748,5737,1761,651000,8540
1733,506,1227,1639,484100,8542
6657,5655,1002,2209,626800,8550
1797,1659,138,2029,475900,8551
243,199,44,1833,521500,8553
1494,1205,289,1342,171700,8554
294,262,32,-,316300,8555
2578,2303,275,1520,681800,8558
2118,1696,422,1653,472700,8559
1367,1245,122,1855,404000,8560
102,86,16,-,387500,8561
1768,1036,732,980,220800,8562
539,11,528,716,-,8608
4163,1008,3155,1071,83500,8609
11145,7067,4078,1175,199900,8610
8306,2603,5703,1068,92600,8611
13061,5719,7342,1010,172100,8618
8709,6043,2666,1377,252300,8619
4055,3289,766,1093,266100,8620
3786,2384,1402,1416,271100,8628
4077,2611,1466,1177,112900,8629
8031,4745,3286,1135,172300,8638
903,5,898,2078,-,8640
1162,0,1162,1994,-,8641
11588,7819,3769,1683,317100,8648
6909,5998,911,1471,294200,8690
6281,5451,830,1727,405700,8691
23781,11962,11819,1427,335600,8701
252,200,52,1705,583300,8720
7382,6053,1329,1492,283500,8721
3740,3217,523,1641,231500,8722
13021,10134,2887,1365,289300,8723
16510,14270,2240,1522,289700,8724
1755,1612,143,2205,639700,8730
7618,6842,776,1542,260200,8731
598,484,114,1651,391900,8732
927,604,323,1710,190300,8733
3373,3004,369,812,322000,8734
2026,1817,209,1224,642800,8735
4904,4314,590,1338,637400,8736
618,576,42,1420,1191700,8738
691,498,193,1651,240800,8740
995,904,91,1292,330000,8741
9807,7762,2045,1578,423800,8742
1295,1250,45,-,943900,8750
2059,1116,943,1173,452700,8751
1185,888,297,1316,642400,8752
23261,17945,5316,1471,292700,8753
10273,8622,1651,1283,282000,8755
16599,14344,2255,1473,169700,8757
3537,2872,665,1573,327700,8758
19376,16670,2706,1149,131500,8759
2564,2168,396,1721,414000,8801
1399,1279,120,1577,392600,8802
972,878,94,1125,337900,8804
4161,2300,1861,1456,290700,8805
13183,10854,2329,1616,484200,8807
85,66,19,-,83400,8808
2202,1630,572,1580,364700,8809
3096,2558,538,1738,405300,8810
4563,3589,974,1307,360300,8812
16435,13305,3130,1436,398800,8816
15564,8608,6956,1611,323000,8817
12891,9499,3392,1578,495500,8820
145,136,9,-,375700,8821
11159,8746,2413,1497,429700,8822
3662,2516,1146,1937,268000,8823
4055,3672,383,1388,441200,8824
1705,1239,466,1284,418800,8825
2087,1703,384,1305,349900,8826
1689,1491,198,550,373600,8827
956,724,232,1770,253300,8828
1502,1136,366,1339,265600,8829
6431,4591,1840,1769,303200,8830
21111,18706,2405,1389,357700,8831
1052,249,803,1408,249000,8832
3151,2759,392,1837,494400,8833
3761,2484,1277,1355,262000,8835
1327,1230,97,1445,618800,8836
6100,3179,2921,1370,331500,8837
6073,4782,1291,1564,404200,8840
13803,11722,2081,1814,438200,8844
4868,3374,1494,1416,307000,8846
3172,2903,269,1380,325000,8848
2827,2317,510,1693,350800,8850
6736,4674,2062,1664,404300,8852
1769,1564,205,1325,570000,8853
16176,10908,5268,1646,334300,8854
14872,9985,4887,1261,360100,8857
35,35,0,-,-,8858
8446,5318,3128,1325,316800,8859
16684,5214,11470,1339,261900,8861
4268,2974,1294,1458,306700,8863
11755,7712,4043,1027,197600,8865
1819,1560,259,1497,474300,8867
2995,1648,1347,1672,343600,8869
7262,4230,3032,1289,294300,8872
20419,14344,6075,1583,340100,8873
8282,5580,2702,1408,383700,8876
8645,4835,3810,1338,288300,8879
1590,904,686,1422,248800,8880
5752,3595,2157,1288,299000,8882
3207,2481,726,938,305100,8884
2555,2096,459,1371,316000,8886
501,397,104,1603,195500,8887
4233,3846,387,1533,469300,8889
8,0,8,-,-,8890
15328,2864,12464,1470,251100,8901
14488,8073,6415,1619,342700,8902
5735,2394,3341,1467,373700,8904
12997,3285,9712,2128,386800,10001
33459,4526,28933,980,689700,10002
26043,8445,17598,2331,1028900,10003
1777,673,1104,3324,1783600,10004
4363,919,3444,3356,1298900,10005
1729,399,1330,3183,980300,10006
2802,1010,1792,3394,"2,000,000+",10007
29764,1837,27927,1723,553000,10009
16815,5185,11630,2509,878500,10010
29089,11207,17882,2226,1030400,10011
12181,2252,9929,2267,1481000,10012
12026,3198,8828,1692,"2,000,000+",10013
18013,5705,12308,2480,1120100,10014
29200,8573,20627,2630,839700,10016
9663,4087,5576,2485,657900,10017
4727,525,4202,3371,738100,10018
26158,5626,20532,2096,912800,10019
0,0,0,-,-,10020
23935,10308,13627,2250,1448000,10021
17953,8844,9109,2562,976600,10022
34289,13367,20922,2346,1218900,10023
28165,11429,16736,2281,1634200,10024
41355,11743,29612,1605,1038600,10025
15479,2700,12779,1230,861200,10026
23956,3232,20724,1249,739900,10027
24640,8374,16266,2346,1326400,10028
31470,2184,29286,914,647600,10029
12688,1488,11200,1023,646500,10030
21744,2921,18823,1425,498800,10031
21226,1950,19276,1239,465200,10032
19833,2215,17618,1460,531600,10033
16156,1523,14633,1347,359000,10034
14524,1113,13411,863,628700,10035
17260,1429,15831,2163,1104300,10036
9581,549,9032,1216,373200,10037
10461,2714,7747,2539,850100,10038
11368,1607,9761,965,496600,10039
16410,1721,14689,1389,394900,10040
4774,1099,3675,2641,783000,10044
15255,5319,9936,2480,1627800,10065
3230,908,2322,-,"2,000,000+",10069
11388,4865,6523,2211,1078100,10075
0,0,0,-,-,10103
0,0,0,-,-,10110
0,0,0,-,-,10111
0,0,0,-,-,10112
0,0,0,-,-,10115
0,0,0,-,-,10119
30069,9982,20087,2312,1082000,10128
0,0,0,-,-,10152
0,0,0,-,-,10153
0,0,0,-,-,10154
673,0,673,2292,-,10162
0,0,0,-,-,10165
0,0,0,-,-,10167
0,0,0,-,-,10168
0,0,0,-,-,10169
0,0,0,-,-,10170
0,0,0,-,-,10171
0,0,0,-,-,10172
0,0,0,-,-,10173
0,0,0,-,-,10174
0,0,0,-,-,10177
0,0,0,-,-,10199
0,0,0,-,-,10271
0,0,0,-,-,10278
18,0,18,-,-,10279
4558,1410,3148,3389,835000,10280
2291,214,2077,3435,"2,000,000+",10282
14467,6630,7837,1328,474100,10301
6090,3420,2670,1375,393400,10302
8268,5043,3225,1094,340800,10303
14603,7141,7462,1054,499700,10304
14565,9657,4908,1329,469100,10305
20189,14172,6017,1374,512600,10306
5271,4018,1253,1216,683300,10307
10544,8648,1896,1753,532900,10308
11523,10037,1486,1422,583400,10309
8526,5009,3517,1296,482000,10310
0,0,0,-,-,10311
21318,18098,3220,1280,543300,10312
30882,23392,7490,1429,522600,10314
19522,2116,17406,1077,165400,10451
26437,788,25649,1166,322500,10452
27774,1074,26700,1166,440000,10453
13429,844,12585,787,457400,10454
14427,1181,13246,1005,348800,10455
30860,1727,29133,1054,359000,10456
24777,1477,23300,1184,378100,10457
27581,1085,26496,1265,432900,10458
16868,1951,14917,1040,406900,10459
20778,2258,18520,1094,421900,10460
18862,6332,12530,1413,471600,10461
29536,6557,22979,1382,332400,10462
28752,9031,19721,1364,293800,10463
1851,1126,725,1426,568300,10464
15831,8916,6915,1417,478000,10465
24216,9560,14656,1348,452200,10466
37042,5141,31901,1316,336000,10467
26328,2057,24271,1286,202400,10468
22299,11491,10808,1413,454900,10469
6198,2303,3895,1386,443300,10470
8817,4325,4492,1600,365200,10471
21835,3163,18672,1204,478700,10472
21189,6102,15087,941,415000,10473
3623,271,3352,1121,415300,10474
18902,8472,10430,1017,28200,10475
423,386,37,-,698000,10501
1962,1653,309,1655,664300,10502
111,111,0,-,397400,10503
2748,2500,248,2870,981800,10504
368,195,173,1549,706700,10505
1850,1719,131,2648,992300,10506
2209,1239,970,1660,594900,10507
6863,5294,1569,1501,353500,10509
3722,3073,649,1593,743300,10510
746,573,173,1535,373800,10511
9350,7589,1761,1383,318600,10512
4072,3913,159,3361,942600,10514
2122,1652,470,1485,534100,10516
152,92,60,2531,379500,10517
396,374,22,-,660100,10518
107,76,31,-,694400,10519
5133,3280,1853,1424,535700,10520
3670,2273,1397,1918,671700,10522
2950,1435,1515,2215,433700,10523
1435,1290,145,1419,474700,10524
685,615,70,-,522300,10526
316,290,26,-,635000,10527
4783,2794,1989,2133,763300,10528
5694,4626,1068,1841,412900,10530
1739,1459,280,2050,591200,10532
2619,2128,491,1633,774200,10533
122,50,72,-,428600,10535
3593,3252,341,1842,720400,10536
826,633,193,2062,245800,10537
5812,4794,1018,1924,969800,10538
9060,7609,1451,1437,377300,10541
7593,4644,2949,1932,634600,10543
0,0,0,-,-,10545
410,372,38,3333,738200,10546
2520,1774,746,1702,369300,10547
1321,958,363,1340,368200,10548
5791,4022,1769,1664,581600,10549
13744,3186,10558,1312,358100,10550
8572,4589,3983,1514,359800,10552
3352,1874,1478,1401,367700,10553
1683,1335,348,1785,572000,10560
11286,6830,4456,1644,397100,10562
9367,4286,5081,1407,293000,10566
6767,6072,695,1830,412000,10567
4049,3437,612,1555,709700,10570
12483,6740,5743,1620,540400,10573
1808,1637,171,3250,893800,10576
829,735,94,"3,500+",1159600,10577
267,228,39,-,471400,10578
3033,2737,296,1745,370800,10579
5984,4464,1520,2183,1512100,10580
13923,11958,1965,1884,959500,10583
1182,714,468,1784,354700,10588
3820,3522,298,2792,466200,10589
2704,2468,236,2053,565100,10590
8908,4511,4397,1673,616000,10591
1552,1284,268,1739,628600,10594
2354,1642,712,1854,621300,10595
454,262,192,1746,382100,10596
330,330,0,-,833300,10597
10530,9370,1160,1436,439500,10598
5268,1924,3344,1685,374600,10601
7040,4283,2757,1650,438900,10603
3808,2292,1516,1826,674500,10604
7255,5262,1993,1681,651100,10605
5632,2361,3271,1785,564700,10606
2416,1845,571,1690,511900,10607
23565,7384,16181,1315,355200,10701
7301,3738,3563,1225,362900,10703
12222,6761,5461,1579,420500,10704
14041,4232,9809,1372,422500,10705
3128,2497,631,1902,676400,10706
3964,2675,1289,1564,584800,10707
8868,6800,2068,1673,460600,10708
3652,2714,938,1730,647500,10709
9631,6430,3201,1431,450600,10710
14758,5647,9111,1470,484800,10801
4006,3106,900,1869,786300,10803
5124,4852,272,2289,751500,10804
7602,3066,4536,1612,368500,10805
8609,6437,2172,1534,390800,10901
0,0,0,-,-,10910
0,0,0,-,-,10911
1488,1437,51,1641,510400,10913
115,115,0,-,353000,10914
30,30,0,-,-,10915
1268,1247,21,-,339400,10916
527,425,102,1660,362100,10917
4167,3335,832,1326,316000,10918
339,306,33,-,243700,10919
2995,2534,461,1304,445000,10920
1391,1027,364,1509,290700,10921
623,462,161,1537,264600,10922
2759,1671,1088,1551,354000,10923
4334,3021,1313,1279,338300,10924
1713,1276,437,1189,242800,10925
1335,746,589,1604,234700,10926
3733,1557,2176,1377,255200,10927
1719,918,801,1296,228000,10928
2919,2646,273,1488,313900,10930
303,199,104,1741,319200,10931
50,50,0,-,155300,10932
177,123,54,-,263900,10933
18075,10354,7721,1272,211200,10940
4993,3208,1785,1330,257700,10941
12363,7784,4579,1370,333100,10950
9282,4086,5196,1481,636500,10952
58,58,0,-,-,10953
8303,6288,2015,1989,389900,10954
10402,9326,1076,1603,505800,10956
937,838,99,1282,299700,10958
6175,3083,3092,1784,522600,10960
1861,1558,303,1182,491900,10962
971,709,262,1242,203800,10963
479,418,61,-,698100,10964
5332,4157,1175,1446,447500,10965
1154,769,385,1963,595800,10968
456,404,52,-,304100,10969
3564,2696,868,1648,313100,10970
795,610,185,1642,284500,10973
1127,903,224,1709,345800,10974
101,46,55,-,146300,10975
712,412,300,665,427700,10976
16269,7389,8880,1353,426900,10977
76,76,0,-,-,10979
4798,4108,690,1570,373300,10980
1961,1844,117,2256,476600,10983
961,868,93,1831,402900,10984
49,49,0,-,269400,10985
551,463,88,2093,484000,10986
1336,1106,230,1491,483900,10987
235,188,47,1299,252900,10988
3407,2895,512,2085,411100,10989
7469,5627,1842,1112,357400,10990
3244,2615,629,964,283200,10992
1583,983,600,1065,247200,10993
2630,2510,120,-,499900,10994
875,9,866,3142,410000,10996
967,835,132,1199,334500,10998
9113,7361,1752,1714,580500,11001
12208,9759,2449,1792,404300,11003
5248,3676,1572,1613,531300,11004
1315,1225,90,-,696400,11005
7832,6400,1432,1770,490600,11010
1845,1586,259,1470,987900,11020
7800,5474,2326,1859,672500,11021
2926,2449,477,3123,915200,11023
1999,1767,232,2036,1588900,11024
6291,5515,776,1570,1384000,11030
12958,11584,1374,1868,634300,11040
0,0,0,-,-,11042
10949,7334,3615,2097,833200,11050
2555,1190,1365,1473,413400,11096
13896,2202,11694,1831,962000,11101
12945,1882,11063,1768,690600,11102
15512,2507,13005,1751,809600,11103
11552,2399,9153,1636,498000,11104
15225,4252,10973,1799,870300,11105
16917,3128,13789,1666,621600,11106
2907,297,2610,3267,714800,11109
28593,10422,18171,2523,943100,11201
28276,11468,16808,1342,468500,11203
23397,8809,14588,1420,881800,11204
16459,4125,12334,1454,744600,11205
31163,3000,28163,1142,740800,11206
33619,9000,24619,1219,510400,11207
33316,8928,24388,1287,489600,11208
29352,11376,17976,1604,800600,11209
21893,9664,12229,1400,651000,11210
40435,6853,33582,1931,1060500,11211
31802,4557,27245,942,442800,11212
25504,4056,21448,1257,837500,11213
31823,10698,21125,1430,742800,11214
28445,11758,16687,2270,1222400,11215
24871,5537,19334,1520,1129800,11216
18074,5214,12860,2129,1250000,11217
24848,9378,15470,1593,786300,11218
24225,6631,17594,1433,899300,11219
27637,7434,20203,1399,873200,11220
31497,7028,24469,1473,924600,11221
17446,3041,14405,2052,960500,11222
27951,10060,17891,1349,808400,11223
18930,4871,14059,847,385800,11224
24136,3881,20255,1444,867700,11225
37191,4814,32377,1425,622300,11226
15124,8354,6770,1469,907300,11228
30774,14442,16332,1374,644700,11229
30147,9301,20846,1397,804800,11230
15658,5043,10615,1805,1384100,11231
8760,2192,6568,1561,757700,11232
30567,6940,23627,1260,849700,11233
31743,21381,10362,1508,588700,11234
32338,12579,19759,1356,566000,11235
33752,16491,17261,1422,554700,11236
17056,1567,15489,1578,755000,11237
25060,7572,17488,1876,976300,11238
6705,167,6538,718,499300,11239
0,0,0,-,-,11351
19925,7413,12512,1495,529200,11354
27771,8408,19363,1444,606900,11355
7501,3386,4115,1712,663400,11356
14477,11006,3471,1793,722600,11357
13029,7250,5779,1704,800900,11358
0,0,0,-,-,11359
8541,6205,2336,2064,564000,11360
9908,5679,4229,1843,717600,11361
6988,5550,1438,1944,513900,11362
2804,2128,676,2188,814000,11363
13470,9750,3720,1801,568800,11364
15705,7455,8250,1581,711600,11365
4534,3010,1524,1770,786700,11366
14348,6674,7674,1403,521800,11367
28633,5918,22715,1622,606200,11368
9655,5383,4272,1583,598400,11369
7850,4074,3776,1691,719200,11370
0,0,0,-,-,11371
23786,7844,15942,1516,346000,11372
30286,9066,21220,1544,582400,11373
19549,7786,11763,1664,396500,11374
32549,16579,15970,1763,438100,11375
31331,9972,21359,1511,553300,11377
12701,6548,6153,1647,644600,11378
13373,7958,5415,1585,682600,11379
35501,11137,24364,1573,624100,11385
6226,5379,847,1575,447400,11411
11095,8425,2670,1470,451200,11412
12297,8795,3502,1690,462200,11413
10741,7815,2926,1636,513500,11414
8381,2977,5404,1578,350800,11415
7185,3207,3978,1561,557100,11416
8898,5444,3454,1604,533500,11417
10907,4753,6154,1516,560700,11418
12167,7506,4661,1628,512000,11419
13121,9013,4108,1628,510500,11420
11549,6234,5315,1662,505900,11421
9964,6569,3395,1775,458500,11422
9602,5583,4019,1427,494500,11423
0,0,0,-,-,11424
0,0,0,-,-,11425
6278,4838,1440,1896,568100,11426
7596,4520,3076,1426,518400,11427
5553,3942,1611,1476,494100,11428
7356,5221,2135,1452,453900,11429
0,0,0,-,-,11430
18697,7266,11431,1541,616600,11432
10599,4694,5905,1297,437300,11433
21706,10648,11058,1154,426600,11434
18893,6983,11910,1530,421400,11435
5410,3769,1641,1605,434300,11436
0,0,0,-,-,11451
7734,4891,2843,1759,515800,11501
2435,2370,65,2306,702100,11507
827,759,68,2517,793800,11509
10728,9434,1294,1795,405500,11510
1671,1143,528,1850,523000,11514
2320,1669,651,1782,559100,11516
4000,2905,1095,1847,436000,11518
14259,9703,4556,1488,340000,11520
9500,8535,965,3273,801700,11530
9998,5340,4658,1802,497300,11542
4359,3873,486,1891,897500,11545
250,221,29,-,554600,11547
544,345,199,2616,653800,11548
0,0,0,-,-,11549
16650,7165,9485,1454,329800,11550
7084,6301,783,1999,450300,11552
6492,4707,1785,1643,341700,11553
12304,10604,1700,2144,454500,11554
0,0,0,-,-,11556
2764,2412,352,1580,576900,11557
2890,1963,927,1645,444200,11558
2549,2020,529,1757,838000,11559
2357,1866,491,1934,788700,11560
15660,9419,6241,1926,532800,11561
8050,5812,2238,1774,455200,11563
3110,2979,131,1877,464700,11565
11185,10633,552,2240,547700,11566
1042,971,71,1469,1939100,11568
487,386,101,1987,732700,11569
10286,7428,2858,1628,633200,11570
10019,8749,1270,1586,473500,11572
4526,3290,1236,1800,312300,11575
4513,4003,510,2383,1006400,11576
4244,3697,547,2291,816700,11577
1966,1518,448,2263,713400,11579
13172,11312,1860,1702,424700,11580
6765,5581,1184,1693,477600,11581
14301,10828,3473,1915,465500,11590
3498,2995,503,1921,623200,11596
4068,3507,561,2042,741400,11598
20712,4698,16014,1235,521000,11691
7306,2591,4715,1106,411400,11692
4817,2397,2420,1059,358200,11693
8497,4603,3894,1377,665000,11694
1456,1395,61,741,588700,11697
8539,5477,3062,1618,360400,11701
5101,4194,907,2055,460500,11702
5288,4328,960,1870,353900,11703
12712,9186,3526,1766,356400,11704
2698,2233,465,1779,450100,11705
18413,13569,4844,1563,335100,11706
2551,2056,495,1712,559800,11709
11434,10165,1269,1621,488800,11710
3102,2079,1023,2098,333900,11713
7943,7127,816,1911,452900,11714
1575,1404,171,1795,438600,11715
3593,2765,828,1900,384900,11716
13785,10465,3320,1474,312100,11717
1082,1024,58,2542,515800,11718
1175,864,311,1523,410800,11719
8888,7448,1440,2087,347800,11720
2349,2241,108,1848,602400,11721
9330,6456,2874,1691,277600,11722
977,880,97,2665,1173900,11724
9694,8853,841,1809,485200,11725
5693,4375,1318,1574,320200,11726
11087,7017,4070,2010,311700,11727
8616,7031,1585,1565,369100,11729
4536,3859,677,2046,418600,11730
10063,9133,930,1924,487100,11731
1453,1037,416,2273,628900,11732
5456,5092,364,2237,516100,11733
11726,9353,2373,1641,422000,11735
5422,4848,574,1816,359100,11738
293,293,0,-,664100,11739
3294,2690,604,623,566800,11740
9000,7151,1849,1906,379000,11741
4358,3525,833,1724,354800,11742
15197,13431,1766,1875,623800,11743
21005,17636,3369,1787,487000,11746
7003,6055,948,2351,653200,11747
1019,927,92,1836,321100,11749
5018,4415,603,1537,379500,11751
2981,2424,557,2199,361500,11752
4394,3879,515,1903,824300,11753
6684,5420,1264,1533,451000,11754
4227,3666,561,1885,426700,11755
13571,12723,848,2042,400800,11756
14534,11701,2833,1645,357600,11757
18565,17245,1320,2021,474100,11758
7554,7394,160,2357,472200,11762
9444,7615,1829,1907,326100,11763
4127,3804,323,1820,445500,11764
250,223,27,2750,"2,000,000+",11765
4114,3984,130,-,453500,11766
4989,4394,595,1879,451500,11767
7834,7007,827,1861,647500,11768
3298,2783,515,1476,414500,11769
26,26,0,-,625000,11770
3600,2781,819,1791,794500,11771
17303,11004,6299,1497,325800,11772
7958,6140,1818,1886,371600,11776
3393,2403,990,1877,538800,11777
4246,3623,623,1499,297200,11778
12354,9535,2819,1669,346000,11779
5515,5033,482,1932,524700,11780
5157,3984,1173,1873,457200,11782
7067,6564,503,2225,467800,11783
7858,6582,1276,1779,319900,11784
1900,1783,117,2303,419900,11786
12000,10505,1495,1767,498900,11787
5532,4384,1148,2199,484800,11788
2875,2558,317,1429,304700,11789
4405,4012,393,2201,464400,11790
8223,7622,601,2750,707800,11791
2621,2415,206,2732,448900,11792
10240,9671,569,1492,473700,11793
0,0,0,-,-,11794
7812,7536,276,1952,433400,11795
1299,1049,250,1642,394200,11796
3097,2695,402,2846,846100,11797
3579,2630,949,1514,303400,11798
12887,10902,1985,2050,449700,11801
9731,8787,944,1587,591600,11803
1625,1489,136,-,596200,11804
9696,6578,3118,1468,322500,11901
415,323,92,1764,1534700,11930
10,0,10,-,-,11931
476,412,64,1261,1062500,11932
3060,2662,398,2116,351700,11933
2566,2210,356,1459,382400,11934
1285,1148,137,1569,580300,11935
6795,5735,1060,2080,828100,11937
457,381,76,1500,640900,11939
1888,1559,329,1777,438600,11940
661,549,112,1361,481700,11941
1993,1842,151,2129,584300,11942
1959,1371,588,1482,487000,11944
5962,4183,1779,1800,490900,11946
178,178,0,-,646200,11947
274,274,0,-,513800,11948
4937,3908,1029,1699,414700,11949
4632,3670,962,1902,244300,11950
4420,3317,1103,1799,223000,11951
2129,1931,198,1325,613600,11952
5322,3747,1575,1787,286800,11953
1458,1254,204,2362,885000,11954
1816,931,885,1772,399200,11955
127,97,30,1583,789100,11956
392,339,53,1768,813700,11957
355,283,72,-,669300,11958
240,189,51,1510,1222800,11959
332,332,0,-,900700,11960
5496,4686,810,1560,294400,11961
138,126,12,-,"2,000,000+",11962
2827,2342,485,2096,895900,11963
981,780,201,-,810300,11964
255,195,60,-,834800,11965
8062,6650,1412,1894,267600,11967
4339,3527,812,1892,906100,11968
117,98,19,-,-,11970
2568,2172,396,1822,589800,11971
458,292,166,1595,532900,11972
0,0,0,-,-,11973
101,93,8,-,"2,000,000+",11975
670,615,55,2629,1618300,11976
809,686,123,1917,782400,11977
1315,959,356,2000,674300,11978
2038,1485,553,2231,322000,11980
9,9,0,-,-,12007
217,208,9,-,221500,12008
3019,2436,583,1101,258000,12009
11672,7497,4175,823,122400,12010
1143,831,312,887,187700,12015
187,153,34,1000,196500,12017
3060,2656,404,1116,226700,12018
5903,4818,1085,1111,289000,12019
13748,10196,3552,1203,234800,12020
298,256,42,692,128000,12022
824,713,111,833,193100,12023
0,0,0,-,-,12024
2285,1888,397,813,158500,12025
1482,1267,215,1342,269500,12027
322,296,26,1125,155900,12028
469,407,62,1344,273400,12029
88,58,30,550,113600,12031
406,391,15,-,118600,12032
3188,2409,779,1076,221100,12033
267,206,61,844,89300,12035
104,101,3,-,125900,12036
1841,1319,522,1038,222200,12037
55,51,4,-,-,12040
173,163,10,-,166800,12041
114,106,8,-,158300,12042
2898,1817,1081,795,145900,12043
232,130,102,1036,147200,12045
423,396,27,1025,213600,12046
9030,4247,4783,955,181200,12047
1500,1026,474,753,170100,12051
681,585,96,1032,188600,12052
1384,1174,210,1341,225400,12053
6933,4949,1984,1132,275800,12054
809,704,105,1016,213100,12056
774,701,73,-,177700,12057
549,456,93,744,173000,12058
682,623,59,900,239300,12059
637,588,49,917,256400,12060
3871,2827,1044,1292,253200,12061
604,473,131,1011,179900,12062
199,132,67,-,164400,12063
170,140,30,740,85400,12064
17654,12319,5335,1199,275100,12065
757,678,79,994,150700,12066
607,537,70,900,252300,12067
1239,1029,210,668,128600,12068
103,86,17,-,126100,12069
723,595,128,431,137200,12070
127,88,39,-,106700,12071
971,795,176,921,131300,12072
1195,1100,95,1047,224400,12074
1130,926,204,1089,231300,12075
630,570,60,782,151500,12076
2694,2014,680,1307,285800,12077
10018,6313,3705,761,91600,12078
1415,1162,253,847,177200,12083
2128,528,1600,1279,293800,12084
189,28,161,1029,-,12085
726,640,86,904,148000,12086
335,288,47,-,143500,12087
35,28,7,-,-,12089
2520,1636,884,878,141700,12090
396,235,161,918,110400,12092
624,538,86,654,153000,12093
853,711,142,1074,171500,12094
4859,3441,1418,831,105700,12095
1036,854,182,996,239500,12106
46,39,7,-,162500,12108
7245,4892,2353,1243,252700,12110
34,34,0,-,450000,12115
753,575,178,923,120200,12116
1376,1083,293,909,143000,12117
6669,4526,2143,883,263000,12118
265,221,44,950,215800,12120
684,654,30,-,191900,12121
1983,1493,490,726,134200,12122
2213,1801,412,771,203400,12123
192,192,0,-,212300,12124
622,409,213,951,193900,12125
271,194,77,1096,220400,12130
35,27,8,-,151800,12131
134,110,24,-,284700,12132
1510,1116,394,741,160300,12134
309,290,19,-,326800,12136
704,609,95,848,206800,12137
1348,1099,249,803,150100,12138
55,50,5,-,195800,12139
686,573,113,696,191300,12140
1973,1281,692,899,176700,12143
9144,5272,3872,1038,181500,12144
216,189,27,1275,253100,12147
1735,1418,317,2623,351200,12148
938,671,267,727,125500,12149
323,295,28,-,158500,12150
406,344,62,1294,224700,12151
348,343,5,-,308800,12153
1179,1008,171,877,207700,12154
829,643,186,818,114600,12155
346,291,55,726,275000,12156
1685,1436,249,826,160900,12157
2646,2021,625,1064,223200,12158
3527,2564,963,1162,343500,12159
358,282,76,962,122500,12160
77,77,0,-,-,12161
95,79,16,725,148600,12164
68,55,13,1536,297900,12165
484,436,48,817,126400,12166
1128,745,383,643,148300,12167
907,699,208,728,151800,12168
92,92,0,-,177100,12169
1962,1640,322,1177,230000,12170
84,47,37,-,152700,12172
772,591,181,1034,170800,12173
141,104,37,1243,170300,12174
197,170,27,988,176600,12175
134,129,5,-,185600,12176
163,88,75,677,132500,12177
21328,9751,11577,992,177600,12180
6013,3168,2845,855,151700,12182
1261,456,805,824,134800,12183
2586,2017,569,867,230200,12184
762,630,132,-,200300,12185
2457,2219,238,1032,250400,12186
234,169,65,672,177500,12187
4823,3234,1589,979,230200,12188
8303,3102,5201,888,169100,12189
160,136,24,-,164700,12190
722,649,73,1048,161100,12192
791,713,78,864,186200,12193
58,58,0,-,84000,12194
65,45,20,-,201600,12195
1279,1128,151,887,223500,12196
778,639,139,877,129300,12197
3088,2395,693,874,197000,12198
4114,983,3131,820,92800,12202
13199,6435,6764,1088,208400,12203
3946,925,3021,1101,191100,12204
11061,7755,3306,1173,209800,12205
6228,1688,4540,988,117800,12206
1179,80,1099,554,150000,12207
9901,4942,4959,1005,204400,12208
4154,2571,1583,1060,159600,12209
5273,935,4338,941,148800,12210
4153,3793,360,1223,306000,12211
15,0,15,-,-,12222
9915,7373,2542,1045,185700,12302
10373,7669,2704,924,181500,12303
8137,4730,3407,931,125800,12304
2296,422,1874,844,120700,12305
9271,6766,2505,955,166300,12306
2099,507,1592,764,84600,12307
4955,2347,2608,935,123600,12308
10709,8837,1872,1164,250900,12309
14313,7700,6613,1071,188900,12401
1315,946,369,912,239800,12404
183,139,44,725,197500,12405
452,193,259,827,196900,12406
85,85,0,-,233000,12407
317,250,67,1220,358300,12409
206,172,34,776,206800,12410
128,128,0,-,222100,12411
193,155,38,-,217200,12412
1034,565,469,911,143800,12413
4083,2656,1427,926,171200,12414
144,97,47,-,278300,12416
144,122,22,-,-,12417
146,121,25,-,182600,12418
228,124,104,1131,285700,12419
106,106,0,-,-,12420
127,127,0,-,251900,12421
115,112,3,-,166700,12422
416,308,108,918,182100,12423
122,103,19,927,227400,12424
117,117,0,-,-,12427
2579,1490,1089,1017,137700,12428
123,89,34,-,267300,12429
492,421,71,720,197400,12430
402,346,56,1206,190600,12431
106,45,61,1131,164900,12432
277,264,13,-,246600,12433
376,297,79,577,95300,12434
89,58,31,-,261300,12435
94,0,94,-,-,12436
8,8,0,-,-,12438
143,139,4,-,194000,12439
801,662,139,1323,333800,12440
42,42,0,-,169400,12441
380,249,131,950,226900,12442
1404,1303,101,1417,225600,12443
218,208,10,850,231900,12444
2036,1584,452,698,239500,12446
197,157,40,-,475800,12448
1233,753,480,1084,181900,12449
83,83,0,-,262900,12450
480,345,135,980,157300,12451
101,91,10,-,144800,12452
91,37,54,-,-,12453
115,105,10,1083,256400,12454
815,638,177,803,198200,12455
342,296,46,-,132100,12456
478,247,231,1047,301500,12457
917,625,292,583,119000,12458
135,135,0,-,203900,12459
136,87,49,742,130900,12460
744,591,153,825,246300,12461
687,550,137,910,189200,12463
519,377,142,1125,231000,12464
108,100,8,-,213500,12465
998,840,158,1273,216900,12466
369,327,42,459,198700,12468
286,280,6,-,155800,12469
183,152,31,-,187500,12470
123,38,85,1557,442900,12471
610,377,233,952,187900,12472
287,287,0,-,170600,12473
448,387,61,642,160300,12474
104,71,33,1566,219400,12475
7813,5329,2484,1069,225300,12477
263,259,4,-,187500,12480
589,509,80,1545,243100,12481
139,93,46,-,42500,12482
141,80,61,-,96100,12483
1165,970,195,987,282800,12484
554,353,201,738,260000,12485
600,538,62,1372,229900,12486
1273,876,397,1242,215400,12487
192,169,23,-,126800,12489
14,14,0,-,-,12490
612,531,81,1536,227300,12491
72,72,0,-,168300,12492
76,44,32,-,-,12493
310,293,17,-,261500,12494
78,68,10,-,673100,12495
561,480,81,713,232900,12496
2383,1797,586,975,299000,12498
972,472,500,1044,292700,12501
437,359,78,1519,296300,12502
243,185,58,1473,330600,12503
41,11,30,1469,-,12504
83,53,30,1500,454300,12507
7283,4118,3165,1393,276100,12508
58,58,0,-,317100,12512
136,116,20,-,222100,12513
1138,1080,58,1384,352800,12514
513,317,196,1034,258500,12515
639,549,90,978,254300,12516
215,105,110,927,231400,12517
2298,1456,842,1435,309200,12518
1038,699,339,1378,318000,12520
660,634,26,-,258500,12521
1899,1441,458,848,207900,12522
750,628,122,928,251500,12523
5938,4130,1808,1446,289000,12524
1092,800,292,1069,309000,12525
1522,1232,290,1276,306300,12526
0,0,0,-,-,12527
5169,3404,1765,1305,249800,12528
941,745,196,913,266300,12529
40,40,0,-,-,12530
1113,903,210,1528,307900,12531
8612,7643,969,1169,349400,12533
7594,4653,2941,884,195800,12534
5084,3683,1401,1066,224000,12538
2759,2548,211,1629,352300,12540
2267,1607,660,964,250300,12542
1362,795,567,1124,182700,12543
2028,1183,845,1179,375100,12545
1221,804,417,1133,258000,12546
1072,823,249,1381,241400,12547
521,424,97,1087,270000,12548
3788,2826,962,1357,281800,12549
19684,10968,8716,1179,228300,12550
9695,6912,2783,1294,259300,12553
6442,4161,2281,1359,293400,12561
2441,2048,393,1236,320600,12563
2784,2098,686,1128,315300,12564
523,252,271,842,149000,12565
3999,2964,1035,1231,246600,12566
1109,814,295,1155,250800,12567
3996,2698,1298,1346,269400,12569
2437,2183,254,1504,321100,12570
3887,2936,951,1146,299300,12571
3740,2533,1207,1327,378100,12572
102,84,18,-,-,12574
823,730,93,-,355900,12575
544,492,52,-,297000,12577
828,724,104,1012,304800,12578
1669,1300,369,979,250500,12580
1007,789,218,1071,291800,12581
1424,1274,150,1343,366200,12582
885,595,290,1244,309100,12583
322,244,78,1096,373500,12585
4047,2826,1221,1344,236400,12586
4762,3818,944,1125,253000,12589
12975,9307,3668,1381,288500,12590
503,338,165,682,260800,12592
1667,1262,405,921,268800,12594
16099,6057,10042,1135,213800,12601
15708,11979,3729,1259,251400,12603
7,7,0,-,-,12604
4119,1970,2149,925,125800,12701
454,377,77,1125,228200,12719
62,30,32,-,-,12720
2070,1511,559,1158,251800,12721
58,58,0,-,-,12722
680,539,141,812,174300,12723
114,114,0,-,332100,12724
51,47,4,-,171300,12725
479,409,70,1031,189400,12726
708,491,217,1142,114200,12729
286,259,27,-,172000,12732
262,97,165,777,102100,12733
380,241,139,-,156100,12734
36,26,10,-,-,12736
717,626,91,956,219100,12737
114,77,37,877,232500,12738
742,552,190,1253,222000,12740
116,88,28,714,106300,12741
61,45,16,550,-,12742
142,82,60,1402,216700,12743
76,50,26,-,182800,12745
354,295,59,1085,185100,12746
656,449,207,950,164700,12747
898,704,194,875,204100,12748
128,36,92,787,-,12749
73,52,21,1138,278900,12750
355,164,191,840,151600,12751
139,66,73,766,167900,12752
2535,1300,1235,812,118100,12754
1651,1176,475,1054,162900,12758
623,441,182,776,68300,12759
251,219,32,-,130100,12760
185,91,94,-,-,12762
262,216,46,830,210900,12763
743,594,149,695,186900,12764
317,293,24,-,232300,12765
183,145,38,-,158100,12766
66,60,6,-,159100,12767
294,226,68,991,125000,12768
183,154,29,-,151200,12769
77,77,0,-,197100,12770
5720,3533,2187,1052,178600,12771
713,628,85,1453,247000,12775
873,793,80,1080,170500,12776
436,401,35,1654,242100,12777
245,200,45,-,209300,12778
853,326,527,681,226200,12779
844,730,114,1079,195000,12780
118,118,0,-,160000,12781
627,495,132,1061,163600,12783
17,9,8,-,-,12784
377,351,26,-,174200,12785
215,160,55,-,174400,12786
107,101,6,-,142800,12787
914,677,237,847,139700,12788
862,439,423,809,99000,12789
1602,1253,349,1152,173600,12790
222,173,49,-,171000,12791
104,85,19,-,208800,12792
6434,3237,3197,867,155800,12801
3586,2273,1313,941,180700,12803
11048,8043,3005,1047,224500,12804
147,147,0,-,290300,12808
1414,1200,214,1006,155300,12809
270,254,16,956,134700,12810
33,27,6,-,122500,12811
50,44,6,-,156700,12812
635,497,138,934,292500,12814
483,424,59,822,196900,12815
1990,1492,498,808,168100,12816
942,778,164,747,197300,12817
108,86,22,-,139600,12819
118,118,0,-,143300,12821
2309,1786,523,861,155100,12822
111,100,11,-,-,12823
455,385,70,835,288300,12824
1392,1115,277,837,160000,12827
3840,3116,724,904,151300,12828
6169,4913,1256,1152,243200,12831
2761,1960,801,697,119700,12832
1639,1390,249,844,238200,12833
2589,2115,474,861,195900,12834
1110,948,162,859,188900,12835
271,241,30,813,290800,12836
405,350,55,857,107400,12837
262,230,32,875,175000,12838
5285,2949,2336,914,135300,12839
112,102,10,-,300000,12841
267,229,38,538,158500,12842
246,199,47,-,130800,12843
114,91,23,-,1024000,12844
1960,1549,411,996,302500,12845
1483,1308,175,1103,159800,12846
142,136,6,775,218400,12847
166,166,0,-,178900,12849
1121,859,262,1114,244300,12850
180,164,16,625,120300,12851
207,196,11,608,156300,12852
751,597,154,920,161600,12853
116,98,18,1275,128100,12855
105,83,22,-,170600,12856
255,206,49,945,163500,12857
66,66,0,-,500000,12858
918,768,150,1385,230700,12859
258,258,0,-,145000,12860
273,246,27,869,170500,12861
0,0,0,-,-,12862
263,229,34,1080,306500,12863
19,17,2,-,-,12864
1437,1143,294,869,142200,12865
17628,10807,6821,1340,345700,12866
755,600,155,734,212700,12870
1728,1283,445,956,184000,12871
16,12,4,-,-,12872
363,333,30,925,187900,12873
88,86,2,-,535700,12874
260,232,28,730,147900,12878
2152,1605,547,735,121100,12883
196,151,45,993,129600,12884
1939,1326,613,865,154700,12885
126,97,29,-,176600,12886
1776,1256,520,814,112900,12887
13257,7189,6068,813,142000,12901
697,342,355,1213,142500,12903
621,477,144,795,91500,12910
0,0,0,-,-,12911
890,663,227,718,118900,12912
510,411,99,706,153500,12913
349,298,51,661,74300,12914
895,601,294,702,105500,12916
532,397,135,681,104500,12917
896,804,92,740,136800,12918
1134,764,370,739,109300,12919
976,791,185,809,93400,12920
986,745,241,847,140900,12921
16,13,3,-,156300,12922
243,196,47,375,83600,12923
37,15,22,-,-,12924
978,704,274,673,90000,12926
132,113,19,-,118800,12927
832,645,187,840,132700,12928
314,210,104,832,102800,12929
279,226,53,800,91300,12930
509,395,114,772,174700,12932
26,26,0,-,-,12933
415,290,125,688,96000,12934
649,501,148,581,118000,12935
215,181,34,738,198200,12936
658,486,172,801,80200,12937
97,55,42,1188,104800,12939
527,481,46,882,167800,12941
392,366,26,1300,314900,12942
200,101,99,1063,206900,12943
1670,1220,450,894,112500,12944
202,193,9,-,149700,12945
1761,1053,708,1015,297100,12946
277,247,30,721,108900,12950
129,85,44,871,-,12952
4727,3118,1609,736,102800,12953
158,136,22,735,105200,12955
595,409,186,715,102700,12956
682,483,199,497,93000,12957
851,744,107,-,97500,12958
619,502,117,-,104400,12959
333,244,89,-,99600,12960
174,119,55,-,-,12961
2236,1869,367,690,146900,12962
36,20,16,1600,258300,12964
164,148,16,1050,72400,12965
1132,848,284,709,81300,12966
463,362,101,569,81200,12967
200,200,0,-,94300,12969
146,98,48,-,189600,12970
2285,1825,460,831,167400,12972
50,50,0,-,110700,12973
681,533,148,631,100100,12974
136,98,38,772,186400,12975
120,97,23,896,236500,12976
37,37,0,-,-,12977
143,83,60,-,130400,12978
1121,622,499,604,140100,12979
535,466,69,688,69100,12980
1078,899,179,803,110600,12981
3348,1872,1476,742,171500,12983
506,366,140,1091,124200,12985
2568,1781,787,532,115500,12986
106,96,10,-,171700,12987
463,408,55,765,189200,12989
1739,1336,403,805,139100,12992
711,523,188,695,169900,12993
927,786,141,930,156300,12996
513,399,114,862,189500,12997
223,223,0,-,-,12998
37,37,0,-,118300,13020
16708,10184,6524,761,132000,13021
0,0,0,-,-,13024
582,463,119,752,167300,13026
13911,10166,3745,931,163000,13027
486,396,90,922,122300,13028
2774,2057,717,879,180800,13029
1435,1254,181,742,145400,13030
6103,4707,1396,963,159400,13031
4638,3358,1280,808,120700,13032
1382,1212,170,772,118200,13033
810,697,113,752,138300,13034
2980,2463,517,984,221200,13035
3739,2937,802,777,118100,13036
3562,2906,656,757,156300,13037
6609,5617,992,940,175100,13039
980,802,178,771,100500,13040
4333,3934,399,1202,150900,13041
894,720,174,961,127700,13042
1093,922,171,740,133800,13044
10495,6169,4326,776,125200,13045
88,71,17,-,-,13051
571,456,115,704,106000,13052
1821,1266,555,757,180300,13053
643,483,160,866,157100,13054
6121,4473,1648,827,123100,13057
1207,1029,178,829,132400,13060
420,354,66,775,191400,13061
16,16,0,-,-,13062
739,661,78,1020,170400,13063
80,65,15,739,166100,13064
5159,3970,1189,1053,230600,13066
2179,1548,631,884,169400,13068
9348,6408,2940,775,85000,13069
365,287,78,738,115600,13071
343,269,74,764,79100,13072
2621,2055,566,828,142600,13073
1588,1238,350,733,95800,13074
897,848,49,968,113100,13076
2721,2041,680,807,141300,13077
3884,3044,840,1146,221100,13078
1277,1054,223,640,118000,13080
438,385,53,583,172600,13081
1685,1499,186,775,139500,13082
764,592,172,738,117300,13083
1576,1299,277,755,159400,13084
52,49,3,-,220500,13087
10151,6174,3977,907,131100,13088
12184,8473,3711,980,156300,13090
1036,905,131,797,121400,13092
890,634,256,685,102900,13101
29,29,0,-,77600,13102
119,91,28,1364,"10,000-",13103
6101,4803,1298,908,256400,13104
2472,1996,476,829,178900,13108
884,787,97,677,179400,13110
636,563,73,838,101600,13111
636,546,90,950,140600,13112
99,79,20,683,102200,13113
2347,1847,500,738,110100,13114
110,74,36,817,98200,13115
1392,937,455,853,139900,13116
115,83,32,844,75900,13117
2165,1727,438,724,127600,13118
798,727,71,-,87700,13120
415,303,112,818,244000,13122
80,80,0,-,-,13123
36,36,0,-,78800,13124
13634,9237,4397,777,111100,13126
1410,1163,247,833,99500,13131
1339,1210,129,860,131600,13132
65,51,14,639,82700,13134
2630,1795,835,720,123400,13135
192,153,39,588,69200,13136
19,19,0,-,-,13138
1800,1457,343,705,94400,13140
267,221,46,879,120800,13141
2567,1986,581,774,114200,13142
1043,845,198,692,93900,13143
562,406,156,597,83800,13144
690,565,125,739,109500,13145
830,677,153,905,84100,13146
426,326,100,1036,111500,13147
4545,3149,1396,771,111000,13148
3411,2872,539,1053,301300,13152
173,117,56,848,198400,13153
210,170,40,513,75200,13155
749,634,115,735,105200,13156
315,253,62,950,84500,13157
611,435,176,643,119000,13158
2092,1725,367,943,170600,13159
724,557,167,833,131700,13160
132,63,69,-,101800,13162
139,123,16,829,131500,13163
878,810,68,802,202900,13164
4301,3173,1128,793,92200,13165
2285,1807,478,854,136900,13166
1241,976,265,986,140200,13167
2683,106,2577,790,91400,13202
7109,2028,5081,786,105900,13203
7903,2293,5610,801,77000,13204
6937,3165,3772,795,80000,13205
7793,3824,3969,819,94500,13206
5179,3258,1921,870,88100,13207
8564,3735,4829,781,86700,13208
5452,3793,1659,837,121600,13209
7639,2035,5604,917,138200,13210
2374,1572,802,1009,89300,13211
8915,6597,2318,880,121300,13212
2880,2171,709,850,164000,13214
5432,4470,962,973,200400,13215
6224,5010,1214,999,133600,13219
3547,2324,1223,867,162800,13224
0,0,0,-,-,13290
53,53,0,-,302500,13301
669,586,83,908,87700,13302
435,388,47,647,149500,13303
697,569,128,981,171600,13304
96,72,24,-,120900,13305
1231,1032,199,857,114400,13308
2236,1656,580,657,122200,13309
238,225,13,-,96300,13310
199,163,36,823,233600,13312
156,119,37,813,65300,13313
124,121,3,-,76900,13314
544,469,75,890,125300,13315
2715,2013,702,680,118900,13316
1531,1083,448,738,95500,13317
536,495,41,644,139700,13318
275,140,135,730,105200,13319
801,658,143,814,170600,13320
441,305,136,802,85100,13321
385,264,121,771,157700,13322
4128,3005,1123,982,185200,13323
898,779,119,679,92500,13324
395,364,31,983,88800,13325
2324,1670,654,890,262800,13326
777,633,144,653,120400,13327
635,534,101,538,141700,13328
1630,1189,441,664,86100,13329
66,66,0,-,433300,13331
1041,856,185,805,95000,13332
21,11,10,-,152100,13333
384,331,53,490,91000,13334
499,419,80,679,152700,13335
327,186,141,778,297600,13337
563,516,47,572,126800,13338
2215,1693,522,719,85800,13339
3121,2432,689,704,108900,13340
63,63,0,-,126800,13341
80,71,9,-,126800,13342
732,616,116,644,112100,13343
54,43,11,-,158900,13345
1767,1281,486,885,197000,13346
603,471,132,817,178800,13348
4152,2452,1700,740,93700,13350
11,11,0,-,-,13352
9,7,2,-,-,13353
1455,1329,126,691,145700,13354
318,276,42,722,89600,13355
4184,2874,1310,635,84000,13357
29,25,4,-,236100,13360
245,212,33,692,100000,13361
50,45,5,-,83300,13362
985,879,106,1144,123900,13363
52,38,14,-,74000,13364
3131,2291,840,623,95400,13365
3222,2567,655,771,143300,13367
447,367,80,705,93800,13368
752,591,161,574,97900,13402
1783,1400,383,820,172600,13403
58,55,3,-,76300,13404
313,288,25,906,96900,13406
2040,1542,498,701,96500,13407
972,850,122,763,134000,13408
865,736,129,824,97000,13409
98,74,24,726,80000,13410
1266,1040,226,648,89200,13411
6393,4780,1613,1062,172300,13413
27,16,11,-,-,13415
856,690,166,603,117200,13416
1667,834,833,753,119700,13417
111,81,30,1309,88800,13418
439,396,43,-,234500,13420
5404,3492,1912,759,116600,13421
873,645,228,834,123900,13424
889,712,177,725,100800,13425
608,391,217,441,99400,13428
661,587,74,780,145200,13431
652,533,119,775,88200,13433
105,91,14,-,102400,13435
30,27,3,-,196900,13436
145,132,13,538,101100,13437
1406,1169,237,829,139600,13438
1477,1157,320,720,140500,13439
16261,10068,6193,760,110900,13440
103,0,103,783,-,13441
28,28,0,-,139700,13450
1797,1312,485,654,83600,13452
288,241,47,733,78200,13454
1655,1380,275,958,161400,13456
1009,795,214,781,152400,13459
1835,1346,489,706,104100,13460
1237,954,283,742,158200,13461
588,471,117,739,77500,13464
188,143,45,565,153800,13468
468,468,0,-,165300,13469
277,263,14,563,96200,13470
1244,1009,235,830,98600,13471
43,43,0,-,-,13472
268,249,19,875,120700,13473
5,2,3,-,-,13475
1491,1082,409,809,154200,13476
436,377,59,580,98600,13477
1160,1025,135,810,144100,13478
1429,1077,352,691,115200,13480
136,122,14,1306,134400,13483
85,85,0,-,115200,13484
446,397,49,717,103500,13485
395,336,59,1034,119800,13486
56,38,18,-,-,13488
273,246,27,1656,113200,13489
654,568,86,-,180700,13490
1364,1100,264,704,113400,13491
4818,3771,1047,724,151000,13492
735,608,127,708,88200,13493
125,114,11,-,150000,13494
847,558,289,767,108000,13495
13775,6788,6987,706,108900,13501
12936,7634,5302,767,104900,13502
15076,7615,7461,844,145900,13601
83,0,83,1704,-,13602
3222,25,3197,1385,-,13603
1940,1460,480,780,145900,13605
1043,742,301,-,151700,13606
684,411,273,705,125300,13607
572,426,146,730,123300,13608
1000,687,313,788,170300,13612
1119,844,275,678,94700,13613
119,67,52,575,60500,13614
385,274,111,819,157900,13615
705,254,451,1011,101200,13616
3566,2453,1113,898,122600,13617
747,635,112,667,142300,13618
4080,2294,1786,872,131200,13619
762,592,170,844,117500,13620
229,190,39,-,95200,13621
952,792,160,995,155600,13622
15,11,4,-,-,13623
1897,1435,462,848,167400,13624
760,647,113,674,140700,13625
897,657,240,867,118100,13626
92,67,25,1125,127500,13628
533,436,97,513,75300,13630
124,119,5,-,76800,13633
1507,1237,270,672,164800,13634
445,344,101,549,73700,13635
74,53,21,925,142500,13636
1745,537,1208,1209,177800,13637
130,107,23,-,73600,13638
110,96,14,-,59100,13639
165,158,7,-,379400,13640
23,23,0,-,79600,13641
3855,2836,1019,716,94800,13642
13,0,13,-,-,13643
873,702,171,759,95700,13646
34,21,13,-,-,13647
896,725,171,816,87500,13648
627,483,144,673,186900,13650
58,58,0,-,258300,13651
619,489,130,580,76900,13652
872,705,167,806,96200,13654
1440,1200,240,497,217800,13655
964,812,152,389,129500,13656
908,769,139,629,112500,13658
171,147,24,779,97000,13659
618,461,157,663,112000,13660
558,515,43,850,115800,13661
7209,4989,2220,758,84400,13662
133,113,20,933,98500,13664
331,289,42,836,101200,13665
82,65,17,-,33300,13666
1263,874,389,757,90700,13667
1384,1119,265,789,84200,13668
6100,4381,1719,638,80400,13669
197,170,27,688,84600,13670
239,122,117,1088,-,13672
891,511,380,681,151900,13673
32,8,24,-,-,13674
36,36,0,-,-,13675
5402,3409,1993,833,119400,13676
8,8,0,-,-,13677
192,92,100,655,64600,13678
655,586,69,1015,160900,13679
522,468,54,704,98300,13680
381,350,31,711,99700,13681
282,251,31,1411,145500,13682
408,375,33,-,84000,13684
1118,547,571,1280,262800,13685
197,164,33,667,104300,13687
321,220,101,534,61900,13690
1228,889,339,964,132100,13691
22,22,0,-,300000,13692
191,172,19,-,161800,13693
591,429,162,790,142900,13694
39,36,3,-,223100,13695
37,20,17,-,-,13696
843,754,89,648,88800,13697
1260,986,274,637,110100,13730
459,401,58,1214,218100,13731
3103,2605,498,806,139000,13732
2073,1611,462,716,98500,13733
736,636,100,-,102700,13734
856,665,191,935,108800,13736
352,273,79,657,156600,13739
239,206,33,763,226400,13740
1379,1195,184,694,102400,13743
454,420,34,640,117600,13744
836,772,64,900,121900,13746
1610,1317,293,984,118700,13748
411,293,118,-,133300,13750
73,45,28,737,84800,13751
301,252,49,794,168200,13752
1823,1270,553,771,170900,13753
1361,977,384,710,115700,13754
490,415,75,656,108500,13755
193,153,40,737,155600,13756
524,456,68,982,135900,13757
18753,12179,6574,759,126400,13760
66,37,29,-,74700,13774
765,621,144,719,165700,13775
256,199,57,675,127400,13776
137,124,13,656,121400,13777
2380,1866,514,591,134100,13778
381,381,0,-,131400,13780
326,260,66,718,176000,13782
1121,830,291,679,115600,13783
39,19,20,1406,77500,13784
187,167,20,-,153100,13786
1460,1014,446,556,102700,13787
381,270,111,756,144800,13788
7619,4465,3154,872,96200,13790
16,16,0,-,-,13794
1309,929,380,852,98700,13795
571,455,116,838,161300,13796
836,727,109,734,89800,13797
633,524,109,710,83300,13801
254,231,23,-,77200,13802
1474,1207,267,768,108100,13803
140,100,40,738,112500,13804
115,92,23,579,142300,13806
514,370,144,611,135000,13807
565,448,117,718,117500,13808
684,552,132,839,88200,13809
515,405,110,775,132400,13810
1601,1299,302,682,111200,13811
926,783,143,719,105700,13812
304,304,0,-,125000,13813
5615,3547,2068,689,92500,13815
7698,4496,3202,866,151100,13820
1244,942,302,783,143500,13825
15,15,0,-,-,13826
5083,3637,1446,747,114000,13827
2258,1698,560,646,93200,13830
241,222,19,525,91300,13832
1496,1257,239,947,100800,13833
86,17,69,1579,-,13834
454,377,77,808,97900,13835
1692,1011,681,618,82900,13838
507,449,58,705,115700,13839
254,197,57,736,92600,13841
212,180,32,825,228600,13842
845,747,98,586,111400,13843
284,232,52,789,90000,13844
63,63,0,-,-,13845
145,138,7,-,128600,13846
28,18,10,-,74500,13847
1852,1567,285,753,95600,13849
8936,6902,2034,929,149200,13850
2727,1870,857,593,118100,13856
82,65,17,-,138000,13859
7,7,0,-,-,13860
127,127,0,-,155700,13861
1699,1348,351,702,107700,13862
238,151,87,717,83500,13863
447,302,145,818,163700,13864
2512,2275,237,598,111400,13865
8108,4618,3490,681,125200,13901
8,8,0,-,-,13902
7649,4761,2888,764,113500,13903
3887,2635,1252,684,98000,13904
11194,5574,5620,800,110900,13905
4064,3021,1043,741,158300,14001
4219,3601,618,753,174000,14004
661,558,103,715,128900,14005
4162,3296,866,816,117000,14006
581,421,160,794,143300,14008
2381,1872,509,629,116600,14009
2783,2139,644,644,129600,14011
886,728,158,590,128700,14012
709,575,134,859,106600,14013
9658,6022,3636,745,107200,14020
604,562,42,692,115500,14024
1539,1286,253,830,197100,14025
320,164,156,-,168200,14026
743,614,129,870,127100,14028
738,646,92,741,127300,14030
4187,3427,760,780,251000,14031
3132,2813,319,1519,345400,14032
752,610,142,970,256800,14033
726,663,63,596,110600,14034
30,11,19,-,-,14035
2080,1671,409,672,149600,14036
437,416,21,-,163900,14037
35,26,9,575,86300,14039
712,597,115,869,149700,14040
75,63,12,-,58600,14041
1630,1181,449,688,93200,14042
10981,7622,3359,871,129200,14043
2523,2084,439,816,137900,14047
6311,3862,2449,677,73700,14048
7991,6555,1436,1558,288800,14051
6816,5607,1209,799,235700,14052
622,465,157,867,124500,14054
593,509,84,604,184900,14055
3197,2677,520,713,173600,14057
753,614,139,817,121900,14058
4155,3374,781,1120,261100,14059
188,145,43,-,82300,14060
119,86,33,1054,100000,14061
1310,1119,191,646,89300,14062
5130,3418,1712,806,130300,14063
635,556,79,644,97800,14065
534,436,98,701,89700,14066
1951,1613,338,839,132700,14067
2663,1850,813,1034,255600,14068
313,284,29,-,168200,14069
2235,1539,696,664,88700,14070
8501,6903,1598,1030,207100,14072
18463,13697,4766,907,171800,14075
1800,1520,280,754,187700,14080
1328,1012,316,649,99700,14081
219,177,42,733,160700,14082
2628,2567,61,1045,196900,14085
13231,11015,2216,840,199600,14086
405,348,57,760,137000,14091
4804,3746,1058,904,185000,14092
20291,14524,5767,672,128700,14094
1298,1019,279,732,101400,14098
715,639,76,747,113000,14101
455,410,45,-,255800,14102
4618,3516,1102,771,87500,14103
1827,1426,401,621,110600,14105
2227,1943,284,690,108600,14108
0,0,0,-,-,14109
1314,1054,260,668,138000,14111
44,29,15,-,-,14112
230,165,65,690,144900,14113
18671,13626,5045,715,144700,14120
1435,1135,300,778,97800,14125
223,194,29,-,128900,14126
12158,8998,3160,983,242300,14127
548,452,96,663,96500,14129
67,57,10,-,81400,14130
2086,1855,231,1006,154300,14131
2271,1835,436,792,158200,14132
47,38,9,-,160000,14134
43,38,5,-,-,14135
1955,1587,368,822,93800,14136
729,600,129,725,76400,14138
865,784,81,615,205300,14139
3173,2255,918,629,149100,14141
433,356,77,913,115900,14143
746,606,140,845,163400,14145
18818,13478,5340,854,130300,14150
693,572,121,663,135300,14167
6,6,0,-,-,14168
63,63,0,-,-,14169
1211,977,234,695,182000,14170
768,690,78,760,113900,14171
1290,1090,200,785,142700,14172
101,28,73,-,-,14173
2285,1945,340,815,174400,14174
5592,1272,4320,704,206900,14201
1769,495,1274,596,422200,14202
1104,13,1091,928,-,14203
4146,1245,2901,564,91300,14204
8957,5482,3475,729,74900,14206
9326,3270,6056,710,68800,14207
4178,1933,2245,798,67700,14208
3837,961,2876,802,251500,14209
6088,2818,3270,748,75300,14210
9420,3797,5623,747,51500,14211
4617,2102,2515,676,69100,14212
9148,3118,6030,773,111000,14213
7928,3482,4446,856,182600,14214
16710,7363,9347,793,62800,14215
10378,5208,5170,914,183400,14216
10921,7184,3737,776,133700,14217
7965,4284,3681,673,98500,14218
5546,3526,2020,766,127400,14219
9564,6102,3462,750,113300,14220
23245,17365,5880,1233,225200,14221
6556,2354,4202,908,314800,14222
9798,8256,1542,824,137200,14223
17826,13673,4153,867,154900,14224
15260,10595,4665,790,106700,14225
12826,9354,3472,941,162300,14226
10201,6622,3579,908,134100,14227
9334,4862,4472,1048,181500,14228
4,0,4,-,-,14261
5574,2228,3346,636,57200,14301
30,0,30,-,-,14302
2503,946,1557,643,61300,14303
13019,9641,3378,732,99900,14304
7155,4104,3051,654,79200,14305
4994,3307,1687,732,89100,14411
3056,2287,769,825,145200,14414
77,61,16,-,103100,14415
1423,1132,291,736,118600,14416
507,478,29,-,152900,14418
7245,4433,2812,844,143800,14420
923,801,122,844,115900,14422
1831,1409,422,764,124400,14423
12118,8448,3670,928,194400,14424
4905,3356,1549,1151,156400,14425
821,680,141,662,91200,14427
2854,2387,467,978,165300,14428
2263,1824,439,625,112200,14432
1527,1191,336,821,78200,14433
1208,1075,133,926,149600,14435
3984,3138,846,727,93600,14437
115,89,26,842,98400,14441
3386,1974,1412,940,108200,14445
17245,13575,3670,1066,202800,14450
3180,1544,1636,899,171800,14454
7496,4583,2913,826,116800,14456
185,164,21,613,133100,14462
2807,2399,408,822,115000,14464
655,605,50,572,132900,14466
4031,2612,1419,997,145600,14467
6781,5780,1001,975,154400,14468
2544,2136,408,788,154200,14469
3177,2581,596,665,105400,14470
993,749,244,980,187300,14471
3301,2532,769,979,253600,14472
163,158,5,-,339800,14475
951,824,127,815,122700,14476
585,497,88,789,123300,14477
257,213,44,-,187700,14478
68,68,0,-,-,14479
329,188,141,808,120700,14480
735,552,183,874,112200,14481
3406,2516,890,728,122800,14482
1603,1256,347,706,155800,14485
152,144,8,-,119500,14486
2380,1977,403,916,162900,14487
2735,1976,759,837,84500,14489
4233,3419,814,812,165800,14502
774,562,212,888,95900,14504
2033,1728,305,799,117800,14505
556,556,0,-,235700,14506
420,370,50,775,141500,14507
2159,1542,617,768,93100,14510
168,92,76,441,107600,14511
1896,1616,280,675,152100,14512
5749,3712,2037,792,98800,14513
2676,1883,793,1201,164800,14514
955,774,181,954,95700,14516
1232,919,313,600,91200,14517
4998,4082,916,832,167700,14519
1008,764,244,711,102900,14521
3911,2755,1156,760,123900,14522
985,817,168,760,117400,14525
8276,6816,1460,928,206400,14526
4668,3503,1165,797,148200,14527
36,36,0,-,-,14529
2183,1534,649,704,89700,14530
1686,1312,374,767,131200,14532
879,644,235,783,123600,14533
11817,10624,1193,1708,262900,14534
270,189,81,754,84700,14536
59,42,17,-,82000,14537
38,38,0,-,158300,14539
927,670,257,967,137000,14541
34,24,10,-,-,14542
1234,1153,81,894,191600,14543
729,588,141,728,147800,14544
69,69,0,-,86300,14545
1991,1437,554,1095,143500,14546
1579,1292,287,930,114100,14548
51,38,13,531,204800,14549
629,456,173,599,84000,14550
2039,1678,361,705,95100,14551
548,466,82,792,132600,14555
7112,5683,1429,1040,169000,14559
827,772,55,797,128600,14560
1150,1005,145,978,140700,14561
6027,4927,1100,1315,283900,14564
2266,2108,158,716,153100,14568
2638,1730,908,605,118100,14569
565,491,74,1338,133500,14571
2035,1641,394,654,93200,14572
21825,16495,5330,1094,195200,14580
54,49,5,-,50300,14585
4316,3092,1224,1149,181200,14586
69,60,9,-,103400,14588
2988,2219,769,705,137100,14589
2221,1702,519,548,89800,14590
616,541,75,729,109400,14591
27,27,0,-,162500,14592
1687,9,1678,840,-,14604
4208,909,3299,717,51500,14605
11555,6488,5067,863,110200,14606
9564,1602,7962,865,195100,14607
5135,1073,4062,797,96300,14608
17371,10310,7061,903,99300,14609
6898,4011,2887,918,165500,14610
6521,2057,4464,893,56700,14611
15006,10499,4507,905,141500,14612
5229,1915,3314,839,70400,14613
76,0,76,1672,-,14614
7080,3507,3573,878,87500,14615
11622,8093,3529,976,105100,14616
9558,8176,1382,882,134400,14617
8277,6206,2071,1151,206000,14618
5318,2681,2637,972,78200,14619
11174,3373,7801,927,151500,14620
12513,4422,8091,810,58300,14621
5577,4411,1166,909,113600,14622
8670,4634,4036,1024,127900,14623
14303,11442,2861,1038,135300,14624
4383,3922,461,933,181700,14625
12737,8562,4175,1027,143900,14626
0,0,0,-,-,14627
16913,9946,6967,624,73600,14701
2647,1982,665,674,102800,14706
62,55,7,-,-,14707
69,69,0,-,59500,14708
572,486,86,617,85200,14709
1347,1191,156,1022,94500,14710
674,503,171,601,73600,14711
1316,1072,244,814,162300,14712
214,184,30,1000,88800,14714
1115,797,318,724,63900,14715
847,573,274,533,81800,14716
282,244,38,650,119100,14717
781,633,148,733,108900,14718
1431,1152,279,551,85800,14719
306,172,134,638,45800,14720
75,58,17,625,-,14721
21,21,0,-,-,14722
414,349,65,764,82100,14723
837,723,114,593,111300,14724
599,477,122,668,81800,14726
2269,1858,411,718,85500,14727
462,398,64,-,102900,14728
416,325,91,709,94300,14729
537,447,90,759,226900,14731
71,71,0,-,87500,14732
1512,1023,489,621,79800,14733
1122,890,232,584,82700,14735
84,73,11,731,77700,14736
1759,1485,274,647,75800,14737
1473,1227,246,867,87600,14738
1175,991,184,631,58100,14739
470,397,73,1225,93800,14740
772,679,93,752,115500,14741
103,86,17,-,97000,14742
767,647,120,733,74500,14743
434,317,117,633,112800,14744
873,759,114,501,83400,14747
275,177,98,577,93000,14748
2059,1416,643,748,128300,14750
160,122,38,-,132400,14752
504,445,59,650,63500,14753
287,223,64,619,75600,14754
1207,958,249,588,86800,14755
28,10,18,-,-,14756
1339,1063,276,562,123400,14757
8072,4587,3485,643,83400,14760
717,570,147,694,95900,14767
430,381,49,777,101000,14769
1208,900,308,545,86300,14770
1610,1155,455,601,85600,14772
16,14,2,-,86700,14774
1051,873,178,564,84500,14775
259,201,58,738,60800,14777
0,0,0,-,-,14778
2693,1528,1165,655,70300,14779
820,659,161,643,86000,14781
908,715,193,681,80300,14782
104,90,14,-,82000,14783
390,332,58,763,90600,14784
2132,1538,594,647,88100,14787
13,13,0,-,-,14788
2008,1532,476,665,86900,14801
358,128,230,728,112500,14802
373,263,110,775,113500,14803
590,490,100,733,86300,14804
439,342,97,931,151000,14805
870,673,197,688,74900,14806
1238,1030,208,738,91700,14807
232,213,19,728,68300,14808
901,713,188,751,87600,14809
5127,3171,1956,607,94500,14810
1304,1063,241,813,94000,14812
996,728,268,622,72200,14813
740,535,205,1068,181800,14814
357,314,43,705,119200,14815
204,201,3,-,89900,14816
995,592,403,1048,161200,14817
953,809,144,835,170400,14818
226,192,34,993,78000,14819
302,261,41,788,88700,14820
1367,1187,180,788,112400,14821
415,371,44,706,69800,14822
1519,1144,375,569,75800,14823
263,216,47,893,79400,14824
289,261,28,1063,106800,14825
784,671,113,757,86400,14826
100,100,0,-,86800,14827
8522,5751,2771,831,118800,14830
337,321,16,-,85900,14836
2175,1773,402,654,110900,14837
774,719,55,922,105300,14838
317,257,60,614,83500,14839
1284,1093,191,739,149500,14840
368,313,55,1059,159700,14841
309,298,11,-,168800,14842
5196,3241,1955,672,81100,14843
8503,6242,2261,1009,144500,14845
330,292,38,667,85300,14846
1073,804,269,635,120600,14847
25217,10983,14234,1213,248000,14850
0,0,0,-,-,14853
12,12,0,-,-,14854
284,254,30,-,92400,14855
137,92,45,-,-,14856
512,434,78,604,111300,14858
371,320,51,761,108100,14859
547,455,92,788,124400,14860
522,442,80,895,95200,14861
481,441,40,906,99700,14864
1128,767,361,660,118200,14865
2340,1765,575,906,144100,14867
497,386,111,675,129200,14869
4111,2881,1230,920,135600,14870
1931,1640,291,1003,141900,14871
266,228,38,578,118500,14872
977,867,110,630,102700,14873
118,107,11,-,130400,14874
191,149,42,658,107500,14877
260,250,10,875,147800,14878
853,745,108,719,89300,14879
667,562,105,703,69200,14880
89,56,33,-,246200,14881
1621,1247,374,1460,196400,14882
1903,1301,602,848,151000,14883
131,106,25,713,89200,14884
274,206,68,810,126100,14885
2872,2301,571,1104,210300,14886
571,476,95,833,103300,14889
1738,1142,596,701,124800,14891
3171,2051,1120,719,111000,14892
0,0,0,-,-,14893
463,412,51,993,96200,14894
4297,2899,1398,636,72400,14895
314,276,38,575,66200,14897
626,511,115,564,89000,14898
5158,2608,2550,713,78000,14901
3375,2153,1222,775,110800,14903
6242,3703,2539,777,73200,14904
3706,2557,1149,891,119800,14905
13643,10181,3462,758,139200,15001
5021,3180,1841,711,88500,15003
166,128,38,-,110000,15004
3959,3318,641,615,159700,15005
170,149,21,-,82800,15006
165,165,0,-,178500,15007
6539,4904,1635,668,188200,15009
11272,7776,3496,706,149900,15010
6643,5249,1394,769,147400,15012
1358,865,493,743,70800,15014
486,463,23,-,351300,15015
7144,4956,2188,875,182100,15017
365,300,65,712,82000,15018
641,432,209,699,125900,15019
54,23,31,-,-,15020
3007,2431,576,765,142200,15021
4299,3187,1112,690,90600,15022
3680,2877,803,911,150100,15024
6957,4939,2018,914,146200,15025
1362,1150,212,883,182500,15026
1060,797,263,544,129700,15027
86,79,7,663,67100,15028
544,266,278,846,59800,15030
267,149,118,978,-,15031
2001,1020,981,574,57800,15033
896,523,373,512,64600,15034
989,608,381,693,73200,15035
4519,3854,665,793,123000,15037
125,96,29,-,81400,15038
3737,3193,544,795,167300,15042
792,727,65,731,166900,15043
10333,9433,900,1330,278400,15044
2033,1428,605,752,65000,15045
1045,868,177,907,141900,15046
46,46,0,-,-,15047
524,424,100,826,97600,15049
1018,952,66,931,182500,15050
245,172,73,1064,101700,15051
1334,1134,200,755,135200,15052
50,43,7,-,86200,15053
123,91,32,838,75400,15054
591,511,80,861,185500,15055
551,343,208,827,85500,15056
6111,5329,782,818,221800,15057
1743,947,796,566,79100,15059
295,248,47,670,114600,15060
5300,3693,1607,673,143500,15061
3435,2516,919,674,76300,15062
4962,3797,1165,728,125400,15063
107,74,33,875,191700,15064
4978,3601,1377,674,108800,15065
5534,3509,2025,706,100100,15066
1047,728,319,683,85100,15067
16327,11131,5196,717,134400,15068
4854,3285,1569,1090,180800,15071
11,11,0,-,-,15072
3508,2280,1228,650,89600,15074
79,50,29,-,179200,15075
384,286,98,-,105100,15076
69,43,26,778,104200,15077
184,129,55,-,79700,15078
165,110,55,629,95400,15081
106,58,48,-,128100,15082
372,322,50,810,89800,15083
4762,2983,1779,652,90300,15084
3225,2610,615,698,155400,15085
207,113,94,-,227000,15086
51,51,0,-,105700,15087
172,110,62,716,66000,15088
2884,2106,778,652,130900,15089
8841,7022,1819,1382,336500,15090
10236,7926,2310,1042,230700,15101
12418,10180,2238,1017,189800,15102
4059,1844,2215,621,41100,15104
9572,6140,3432,845,133700,15106
16843,12249,4594,937,198400,15108
2247,877,1370,609,42600,15110
1450,642,808,641,62800,15112
6109,5442,667,957,185500,15116
8521,4853,3668,727,91800,15120
8796,6780,2016,772,98500,15122
3148,2391,757,852,205500,15126
4410,3335,1075,1019,163500,15129
3699,2654,1045,807,111100,15131
9903,5017,4886,646,49700,15132
2949,2306,643,794,75100,15133
2136,1543,593,794,132200,15135
10024,6169,3855,803,152500,15136
4689,3027,1662,759,83700,15137
3140,1867,1273,879,206200,15139
1458,625,833,687,68100,15140
550,458,92,-,667800,15142
8621,6829,1792,1269,337100,15143
1929,1271,658,707,109800,15144
3153,1420,1733,670,66800,15145
12206,8283,3923,1053,150300,15146
8400,5557,2843,764,101600,15147
1132,412,720,713,51600,15148
6481,3523,2958,1113,169800,15201
10122,5196,4926,786,137800,15202
5641,2147,3494,1188,205700,15203
3653,2273,1380,853,79100,15204
10143,5981,4162,873,125100,15205
14610,5904,8706,1003,192100,15206
4764,3076,1688,776,98000,15207
4516,2181,2335,749,184500,15208
5601,4025,1576,828,156800,15209
10940,6235,4705,821,64900,15210
5556,2743,2813,971,132700,15211
13470,6787,6683,852,106400,15212
10177,2518,7659,996,170600,15213
6202,3762,2440,807,118000,15214
5454,3956,1498,864,226300,15215
10574,6542,4032,898,136200,15216
11917,6070,5847,1101,301400,15217
6735,3842,2893,845,152000,15218
5421,1389,4032,733,102300,15219
8011,4628,3383,1033,161600,15220
16068,7387,8681,824,105400,15221
2751,501,2250,1634,378600,15222
3102,2071,1031,754,107800,15223
5599,2020,3579,934,165100,15224
565,295,270,778,88500,15225
6288,4519,1769,889,117800,15226
11603,8228,3375,737,122500,15227
7195,5197,1998,952,280900,15228
5855,4262,1593,918,153300,15229
6357,1744,4613,1161,372600,15232
1502,628,874,773,204600,15233
6298,4295,2003,870,133700,15234
15088,11449,3639,907,100200,15235
12574,9493,3081,889,159600,15236
18286,14214,4072,1032,223000,15237
5417,4231,1186,965,344500,15238
8552,6974,1578,1016,150000,15239
7751,6663,1088,1304,295200,15241
5551,4838,713,938,207000,15243
0,0,0,-,-,15260
0,0,0,-,-,15290
20464,13903,6561,767,165300,15301
119,93,26,825,168100,15310
610,538,72,731,218500,15311
1493,1290,203,799,160100,15312
136,117,19,938,107200,15313
1605,1193,412,509,129500,15314
223,186,37,795,59100,15315
48,35,13,-,63100,15316
15711,12405,3306,1002,261100,15317
2452,1815,637,425,129600,15320
616,530,86,796,244800,15321
770,690,80,586,77800,15322
1776,1400,376,708,155400,15323
279,176,103,838,69100,15324
186,124,62,-,40600,15325
644,497,147,824,100700,15327
554,405,149,771,182000,15329
1993,1804,189,905,251600,15330
327,203,124,943,58000,15331
3536,2994,542,672,153300,15332
827,530,297,620,131300,15333
45,41,4,-,101400,15334
201,157,44,714,121300,15337
660,545,115,675,91300,15338
457,402,55,700,211800,15340
309,238,71,768,162100,15341
2173,1704,469,903,183700,15342
525,437,88,840,121300,15344
580,446,134,834,97400,15345
208,197,11,-,75400,15346
301,218,83,-,158800,15347
97,59,38,1024,-,15348
679,503,176,839,163800,15349
170,111,59,879,56900,15350
366,177,189,704,-,15351
395,332,63,550,116100,15352
52,39,13,-,193800,15353
608,539,69,716,125400,15357
272,201,71,-,98800,15358
69,44,25,823,89400,15359
695,604,91,863,171300,15360
98,57,41,-,-,15361
329,290,39,675,133900,15362
257,185,72,732,125500,15363
286,246,40,778,168400,15364
86,77,9,-,-,15366
3082,2859,223,1269,392000,15367
195,139,56,587,46400,15368
4893,3368,1525,651,151900,15370
680,546,134,759,163400,15376
233,186,47,831,210400,15377
21,12,9,-,-,15378
45,34,11,-,125000,15379
247,159,88,662,119900,15380
13289,9303,3986,671,113700,15401
466,421,45,-,57700,15410
255,200,55,782,151000,15411
233,199,34,717,78200,15412
177,138,39,-,39200,15413
3533,2400,1133,654,84900,15417
1605,743,862,583,98900,15419
101,61,40,-,37400,15420
27,27,0,-,-,15421
97,47,50,-,38600,15422
802,703,99,836,155000,15423
902,679,223,616,99200,15424
8432,6118,2314,575,106700,15425
459,360,99,773,107900,15427
744,640,104,775,96500,15428
169,131,38,-,-,15429
152,143,9,-,66700,15430
1783,1485,298,624,81800,15431
216,158,58,625,84300,15432
355,266,89,-,159500,15433
109,84,25,485,72400,15434
166,129,37,855,108000,15435
1218,851,367,755,89900,15436
876,593,283,903,152700,15437
898,799,99,691,102900,15438
79,72,7,-,131000,15440
857,638,219,724,90500,15442
66,10,56,-,-,15443
147,147,0,-,73800,15444
1153,923,230,713,101200,15445
114,95,19,-,102200,15446
33,33,0,-,-,15447
69,52,17,-,108800,15448
116,116,0,-,54500,15449
96,96,0,-,157100,15450
449,388,61,-,116400,15451
65,49,16,-,46800,15454
172,128,44,-,-,15455
1255,972,283,757,89400,15456
944,815,129,1032,76500,15458
624,507,117,695,115600,15459
51,51,0,-,74200,15460
1783,1152,631,717,86700,15461
163,163,0,-,-,15462
61,61,0,-,-,15463
596,532,64,744,86400,15464
187,170,17,1139,70000,15466
58,51,7,-,38100,15467
926,621,305,771,85200,15468
980,701,279,649,88400,15469
308,253,55,638,206600,15470
61,22,39,-,-,15472
1639,1318,321,673,153800,15473
794,560,234,838,72100,15474
531,316,215,662,63500,15475
41,41,0,-,-,15476
378,288,90,648,85800,15477
2445,1939,506,684,125000,15478
852,723,129,798,127100,15479
782,683,99,720,115600,15480
161,130,31,654,82900,15482
199,150,49,625,83800,15483
43,43,0,-,-,15484
967,846,121,505,152500,15486
177,169,8,-,66500,15489
171,155,16,-,125300,15490
43,43,0,-,72500,15492
6425,4567,1858,577,121900,15501
61,61,0,-,173600,15502
11,11,0,-,-,15510
108,101,7,-,64200,15520
679,567,112,766,140100,15521
4885,3737,1148,700,159100,15522
2061,1612,449,567,121900,15530
1585,1190,395,526,98800,15531
65,43,22,759,81900,15532
620,423,197,713,129200,15533
366,301,65,708,143800,15534
879,766,113,638,154400,15535
174,149,25,900,173800,15536
3346,2413,933,672,135100,15537
302,268,34,442,121600,15538
153,133,20,-,142200,15539
81,65,16,-,109700,15540
1343,1218,125,544,129900,15541
449,358,91,711,80000,15542
57,57,0,-,68700,15544
1117,911,206,661,102900,15545
131,131,0,-,57600,15546
210,157,53,868,111300,15547
718,599,119,575,124100,15550
312,268,44,618,108100,15551
2300,1741,559,570,102100,15552
1086,932,154,592,132600,15554
45,40,5,-,102600,15555
1454,1124,330,609,112900,15557
785,602,183,615,121700,15558
792,662,130,700,146400,15559
73,62,11,775,88000,15560
83,54,29,664,119000,15561
61,47,14,-,133600,15562
1243,1055,188,585,103100,15563
19,14,5,563,112500,15564
24983,17795,7188,719,167900,15601
1579,1442,137,643,154200,15610
340,247,93,1268,-,15611
178,156,22,-,133800,15612
5796,4829,967,762,149900,15613
155,148,7,-,162800,15615
0,0,0,-,-,15616
141,123,18,811,84100,15617
1032,842,190,607,93800,15618
306,236,70,778,82300,15620
35,35,0,-,-,15621
613,490,123,323,142700,15622
257,200,57,802,147200,15623
148,137,11,-,-,15624
45,45,0,-,-,15625
2503,2068,435,862,171300,15626
2710,2245,465,648,109300,15627
254,187,67,642,82500,15628
312,150,162,736,53500,15629
468,292,176,690,83600,15631
4140,3132,1008,773,228600,15632
249,134,115,841,108800,15633
205,115,90,643,55000,15634
92,52,40,-,-,15635
1385,1255,130,564,290400,15636
594,436,158,934,128300,15637
104,104,0,-,-,15638
905,670,235,578,169300,15639
207,202,5,-,95100,15640
231,190,41,638,85400,15641
18353,15377,2976,770,176000,15642
8585,6432,2153,751,116800,15644
66,46,20,-,103600,15646
109,82,27,-,180600,15647
11116,8181,2935,700,149800,15650
99,62,37,713,121700,15655
4299,3462,837,634,122400,15656
4033,3280,753,734,183500,15658
196,196,0,-,150000,15660
204,165,39,825,106400,15661
112,112,0,-,-,15662
227,181,46,600,132000,15663
567,453,114,1043,125500,15665
6780,5253,1527,711,124700,15666
5107,4689,418,1267,252900,15668
1400,1134,266,641,152700,15670
270,270,0,-,106200,15671
1413,999,414,828,184900,15672
584,455,129,619,102200,15673
319,250,69,906,75000,15675
284,192,92,1302,202400,15676
170,160,10,-,132800,15677
282,183,99,830,112500,15678
1167,999,168,732,142000,15679
62,52,10,-,79000,15680
1846,1465,381,777,123000,15681
3420,2670,750,570,127800,15683
345,305,40,-,93800,15684
319,292,27,775,167000,15686
480,438,42,475,183900,15687
456,427,29,-,89700,15688
83,72,11,-,96500,15689
3933,2687,1246,648,82500,15690
40,40,0,-,-,15691
519,414,105,601,140400,15692
69,53,16,-,-,15693
183,154,29,-,80000,15695
195,170,25,681,77600,15696
1397,863,534,673,112500,15697
318,273,45,841,117600,15698
12697,7508,5189,742,153500,15701
116,81,35,675,110500,15710
188,154,34,775,81400,15711
74,54,20,689,79000,15712
149,149,0,-,-,15713
2048,1535,513,614,71000,15714
188,143,45,678,98100,15715
329,184,145,619,93000,15716
4220,3133,1087,701,134700,15717
83,66,17,-,46500,15721
923,794,129,564,94200,15722
15,15,0,-,-,15723
886,733,153,665,88800,15724
665,547,118,542,123400,15725
84,65,19,829,65600,15727
1415,970,445,492,96000,15728
600,490,110,569,87300,15729
36,31,5,-,-,15730
101,89,12,-,-,15731
624,562,62,711,119300,15732
65,60,5,-,66700,15733
192,176,16,-,91000,15734
344,216,128,838,121700,15736
30,30,0,-,31700,15737
99,77,22,794,64200,15738
201,145,56,863,68100,15739
28,26,2,-,75600,15741
354,305,49,639,77400,15742
54,49,5,-,71900,15744
89,80,9,-,37500,15745
57,37,20,-,66300,15746
792,654,138,686,136700,15747
2838,2202,636,685,108900,15748
128,63,65,782,-,15750
17,0,17,-,-,15752
177,159,18,663,74600,15753
258,199,59,-,72300,15754
95,78,17,1038,61300,15756
633,527,106,728,80700,15757
1143,933,210,718,126200,15759
65,48,17,-,51300,15760
57,31,26,-,89500,15761
333,304,29,654,156000,15762
92,88,4,-,153100,15764
632,532,100,637,156800,15765
5928,4173,1755,662,110100,15767
90,86,4,-,138900,15770
380,327,53,-,118800,15771
565,470,95,679,90900,15772
182,173,9,-,65400,15773
1112,982,130,613,134500,15774
335,261,74,-,88500,15775
25,22,3,-,90000,15776
48,48,0,-,74300,15777
55,50,5,-,53300,15778
202,165,37,542,90700,15779
69,66,3,-,67700,15780
48,46,2,-,95000,15781
47,32,15,-,66700,15783
29,27,2,-,81500,15784
7656,5453,2203,649,119000,15801
61,51,10,-,95800,15821
558,459,99,585,106700,15823
2161,1678,483,687,111800,15824
3659,2648,1011,671,116900,15825
106,86,20,-,62200,15827
117,110,7,-,87500,15828
543,431,112,646,114600,15829
126,119,7,-,59600,15832
1957,1362,595,597,79200,15834
842,664,178,749,90200,15840
152,133,19,-,107500,15841
1436,1105,331,611,63200,15845
1518,1443,75,-,111900,15846
146,121,25,658,69500,15847
400,322,78,753,104000,15848
473,383,90,845,83700,15849
2821,2086,735,598,96000,15851
2902,2061,841,582,90900,15853
381,346,35,690,153100,15856
5848,4462,1386,584,123300,15857
491,428,63,657,123300,15860
85,75,10,738,73900,15861
102,86,16,820,55000,15863
669,575,94,583,95100,15864
630,399,231,593,82400,15865
92,83,9,788,84400,15866
651,545,106,603,144800,15868
557,489,68,538,79900,15870
2035,523,1512,471,27200,15901
5169,3257,1912,595,47800,15902
6465,4442,2023,773,138400,15904
8895,6670,2225,704,97100,15905
4879,3281,1598,516,48200,15906
2188,1932,256,531,83800,15909
319,281,38,850,103400,15920
34,29,5,-,54200,15921
69,61,8,-,153200,15922
669,561,108,613,94700,15923
447,415,32,890,74200,15924
71,49,22,1025,64200,15925
1070,937,133,693,77100,15926
500,448,52,-,67100,15927
870,678,192,888,155800,15928
24,8,16,-,-,15929
85,85,0,-,31600,15930
3722,2715,1007,716,159300,15931
12,12,0,-,-,15934
1400,1189,211,653,103400,15935
574,502,72,622,86100,15936
299,259,40,-,73200,15937
956,832,124,610,93200,15938
682,555,127,713,173400,15940
819,786,33,628,123900,15942
1568,1241,327,636,70200,15943
1244,1040,204,504,116600,15944
35,35,0,-,63500,15945
2851,2376,475,463,93100,15946
204,160,44,-,85900,15948
211,185,26,832,57800,15949
221,208,13,-,66000,15951
604,420,184,623,142200,15952
39,20,19,-,-,15953
968,774,194,605,94200,15954
868,792,76,684,99300,15955
1186,1015,171,628,67000,15956
254,220,34,654,131100,15957
863,731,132,632,120300,15958
177,150,27,548,64500,15960
304,247,57,546,70700,15961
70,62,8,-,84400,15962
4783,3549,1234,619,101800,15963
17698,11746,5952,746,155800,16001
6152,5310,842,643,191700,16002
462,390,72,792,145600,16020
153,101,52,850,88800,16022
1966,1235,731,1032,197400,16023
90,67,23,1069,130500,16024
2065,1815,250,644,162700,16025
95,70,25,950,176800,16027
773,550,223,483,108200,16028
302,232,70,812,117800,16029
117,79,38,725,89300,16030
2613,1932,681,844,207200,16033
726,649,77,890,166400,16034
47,27,20,744,206300,16035
90,73,17,800,86800,16036
1841,1536,305,1105,263600,16037
1370,1107,263,733,143700,16038
407,343,64,494,119300,16040
839,700,139,632,110800,16041
425,263,162,877,99000,16045
6229,4994,1235,1467,362600,16046
53,45,8,-,-,16048
1278,979,299,624,112600,16049
549,442,107,675,124100,16050
1207,1057,150,586,144600,16051
1044,917,127,892,171700,16052
1785,1597,188,672,228200,16053
181,152,29,725,88400,16054
3177,2823,354,900,225000,16055
2159,1630,529,695,214700,16056
4764,2840,1924,734,175100,16057
3379,2904,475,1962,281000,16059
1046,925,121,681,167100,16061
3228,2110,1118,1049,211600,16063
12090,9508,2582,1227,303300,16066
14108,9920,4188,642,89400,16101
2325,1680,645,741,94700,16102
6692,5146,1546,788,136500,16105
145,138,7,-,109300,16110
485,414,71,677,118900,16111
650,582,68,679,97900,16112
191,160,31,921,167000,16113
238,201,37,733,124600,16114
1281,1037,244,667,138000,16115
1108,944,164,620,95900,16116
7516,5647,1869,713,111300,16117
939,769,170,604,124200,16120
2205,1225,980,722,55600,16121
801,729,72,982,179600,16123
803,715,88,515,118400,16124
6875,5061,1814,644,109300,16125
5389,4067,1322,718,144600,16127
893,717,176,588,113300,16130
356,268,88,630,128100,16131
146,111,35,-,110400,16132
617,566,51,531,127000,16133
1680,1447,233,708,102200,16134
370,258,112,593,80400,16136
4361,3509,852,635,144500,16137
67,60,7,-,-,16140
672,546,126,714,83700,16141
2185,1620,565,668,179900,16142
1062,920,142,729,152900,16143
1211,980,231,656,139300,16145
6001,2991,3010,585,65300,16146
7427,5394,2033,801,149400,16148
3177,2359,818,732,106400,16150
52,38,14,675,76700,16151
1033,810,223,763,134500,16153
1031,919,112,754,146400,16154
46,7,39,798,-,16155
1179,1025,154,721,156700,16156
1423,1186,237,567,106700,16157
2145,1676,469,715,125800,16159
380,287,93,581,73400,16160
343,229,114,682,56500,16161
7300,5160,2140,672,132000,16201
340,291,49,755,112000,16210
47,43,4,-,66900,16211
155,126,29,765,72500,16212
52,33,19,565,60700,16213
4332,1971,2361,663,141900,16214
54,43,11,-,157500,16217
408,372,36,450,136900,16218
967,826,141,559,123100,16222
97,74,23,-,84700,16223
466,358,108,705,98900,16224
3389,2541,848,636,92300,16226
192,162,30,732,78600,16228
2244,1670,574,733,162800,16229
173,126,47,672,77900,16230
1702,1332,370,578,109100,16232
512,440,72,834,145100,16233
486,436,50,756,135500,16235
103,103,0,-,92800,16236
180,129,51,617,86300,16238
573,461,112,881,90200,16239
619,473,146,564,130800,16240
1826,1291,535,596,97900,16242
127,113,14,-,84700,16244
97,52,45,625,61700,16245
101,80,21,1000,70000,16246
1240,888,352,600,90700,16248
863,684,179,634,119400,16249
187,173,14,-,81900,16250
44,27,17,-,-,16253
1321,1097,224,760,121500,16254
609,498,111,669,110200,16255
496,449,47,513,112700,16256
818,510,308,705,143800,16258
812,668,144,523,90800,16259
184,153,31,-,255600,16260
1182,962,220,779,125000,16262
116,103,13,-,95500,16263
6542,4699,1843,615,71100,16301
213,181,32,595,135600,16311
0,0,0,-,-,16312
781,632,149,683,75200,16313
2181,1850,331,697,119400,16314
2424,1922,502,682,144800,16316
544,491,53,667,99200,16317
592,557,35,567,127700,16319
31,18,13,-,67100,16321
29,27,2,-,65000,16322
6829,4726,2103,606,90100,16323
151,130,21,663,125000,16326
1156,1009,147,672,119000,16327
99,30,69,641,85000,16328
188,159,29,675,80200,16329
29,26,3,-,-,16331
19,7,12,-,-,16332
142,131,11,-,54100,16333
127,122,5,-,129200,16334
11602,6986,4616,699,113000,16335
735,661,74,648,92800,16340
780,697,83,625,84900,16341
766,657,109,609,101200,16342
291,218,73,-,80500,16343
178,103,75,662,46300,16344
1496,1372,124,670,154600,16345
1467,1051,416,667,111700,16346
923,727,196,437,100800,16347
940,717,223,576,108800,16350
688,539,149,496,84500,16351
82,73,9,-,72900,16352
1212,1047,165,507,102000,16353
4525,3092,1433,545,85500,16354
522,423,99,531,124300,16360
8,8,0,-,-,16361
405,354,51,483,110900,16362
484,425,59,827,132900,16364
8012,5703,2309,627,95500,16365
127,104,23,372,96500,16370
1360,955,405,580,86300,16371
206,141,65,495,64100,16372
1336,1100,236,750,109700,16373
786,660,126,717,103800,16374
1736,1304,432,603,114000,16401
344,317,27,766,113400,16402
2436,1892,544,609,117900,16403
1279,1022,257,644,102000,16404
322,264,58,796,91000,16405
1239,1012,227,662,115000,16406
4648,3102,1546,669,99900,16407
646,593,53,690,118200,16410
635,499,136,885,130200,16411
4421,2910,1511,828,182800,16412
3307,2945,362,915,219800,16415
69,57,12,-,63800,16416
3071,2337,734,593,140200,16417
237,216,21,575,84200,16420
988,801,187,498,154300,16421
154,134,20,-,95800,16422
1761,1422,339,685,115900,16423
2005,1709,296,703,106900,16424
1485,1232,253,829,157300,16426
65,46,19,933,80000,16427
4841,3514,1327,686,159100,16428
2069,1686,383,606,129400,16433
927,786,141,629,120100,16434
704,543,161,742,115400,16435
275,208,67,608,139300,16436
3144,2391,753,651,108000,16438
383,334,49,804,132600,16440
3977,3351,626,735,174600,16441
1108,961,147,598,149600,16442
504,464,40,495,108900,16443
0,0,0,-,-,16444
1333,19,1314,373,-,16501
6689,2421,4268,732,75600,16502
5627,1954,3673,715,44100,16503
6384,4396,1988,820,88500,16504
7492,5652,1840,825,151500,16505
10170,7080,3090,936,175500,16506
3725,1170,2555,733,52800,16507
6887,4475,2412,730,98100,16508
12107,8278,3829,865,158700,16509
10107,7723,2384,738,125300,16510
4916,3054,1862,696,131300,16511
0,0,0,-,-,16546
0,0,0,-,-,16563
13430,9262,4168,674,106100,16601
12576,8099,4477,737,95000,16602
1025,908,117,614,135000,16611
563,511,52,600,120600,16613
62,50,12,-,74300,16616
1238,896,342,688,115900,16617
134,113,21,573,79600,16619
139,117,22,800,92800,16620
282,219,63,661,148400,16621
72,72,0,-,143800,16622
212,178,34,825,152100,16623
78,59,19,575,114200,16624
1593,1014,579,756,113300,16625
860,727,133,575,70400,16627
1917,1338,579,662,114000,16630
32,27,5,-,143800,16631
94,68,26,780,92200,16633
146,129,17,-,91000,16634
5347,4056,1291,863,159100,16635
336,311,25,1077,174500,16636
943,723,220,790,131500,16637
14,11,3,-,106300,16638
624,546,78,782,98800,16639
307,282,25,763,122300,16640
1051,855,196,667,89900,16641
61,59,2,-,73000,16645
902,747,155,559,86000,16646
312,253,59,580,175300,16647
6251,4617,1634,746,187200,16648
732,610,122,641,125500,16650
1349,1068,281,534,85800,16651
5632,3875,1757,665,148700,16652
597,529,68,642,126800,16655
486,430,56,715,81000,16656
542,459,83,648,177600,16657
96,50,46,717,92000,16659
352,300,52,659,74700,16661
2256,1538,718,710,159200,16662
716,638,78,631,151300,16664
127,89,38,725,145800,16665
1219,1082,137,688,86100,16666
532,363,169,761,116900,16667
1469,1196,273,431,86000,16668
901,697,204,686,160000,16669
26,21,5,-,101600,16670
186,143,43,689,87500,16671
73,60,13,-,64400,16672
2146,1612,534,837,139000,16673
244,193,51,842,78400,16674
162,125,37,-,89600,16677
1099,866,233,626,98200,16678
326,286,40,521,69700,16679
139,126,13,-,90000,16680
28,17,11,-,-,16682
151,124,27,625,159600,16683
69,69,0,-,176000,16685
5553,3913,1640,685,119900,16686
190,183,7,-,160500,16689
146,127,19,836,161500,16691
276,219,57,641,71100,16692
1509,1195,314,626,127600,16693
57,57,0,-,67500,16694
427,350,77,658,152500,16695
0,0,0,-,-,16699
7269,4991,2278,642,79100,16701
507,432,75,665,80300,16720
58,52,6,675,102800,16724
88,68,20,-,-,16725
279,234,45,597,96900,16726
66,18,48,-,-,16727
22,22,0,-,-,16728
380,285,95,637,79800,16729
57,50,7,-,80700,16730
995,821,174,620,79900,16731
136,118,18,-,80000,16732
84,66,18,625,64000,16733
117,98,19,-,58000,16734
2630,1923,707,621,74400,16735
608,532,76,694,89700,16738
446,320,126,650,57900,16740
1617,1184,433,706,90300,16743
81,81,0,-,77700,16744
230,225,5,-,77900,16745
461,368,93,800,79700,16746
1028,786,242,525,90100,16748
1631,1310,321,706,89000,16749
203,169,34,588,59100,16750
18039,7444,10595,1051,284500,16801
12,0,12,-,-,16802
10407,4787,5620,1133,304300,16803
403,342,61,785,162900,16820
126,126,0,-,159600,16821
811,631,180,633,124700,16822
10906,8047,2859,837,189900,16823
114,114,0,-,85100,16825
214,203,11,-,176100,16826
1856,1533,323,1170,322900,16827
1843,1524,319,964,235300,16828
284,252,32,677,128300,16829
5866,3782,2084,665,93200,16830
162,146,16,786,154500,16832
2208,1684,524,635,103800,16833
145,125,20,-,157100,16834
70,60,10,800,150000,16835
447,397,50,867,88600,16836
71,71,0,-,-,16837
704,599,105,802,93700,16838
236,213,23,-,81100,16839
177,151,26,-,67100,16840
2226,1930,296,712,182500,16841
346,273,73,1003,45400,16843
1040,905,135,856,171700,16844
324,292,32,658,90000,16845
148,140,8,-,87300,16847
159,116,43,652,129800,16848
138,127,11,-,156700,16849
264,214,50,886,248100,16851
139,109,30,633,160400,16852
96,29,67,677,-,16853
272,201,71,749,153500,16854
103,103,0,-,-,16855
1409,1241,168,956,115700,16858
240,201,39,785,112500,16859
110,110,0,-,130600,16860
104,100,4,-,78700,16861
261,173,88,877,118500,16863
739,703,36,1313,225000,16865
3647,2429,1218,614,115800,16866
256,256,0,-,196500,16868
2650,2307,343,805,325000,16870
18,16,2,-,53300,16871
464,351,113,733,178500,16872
518,461,57,677,127800,16874
1545,1265,280,904,261500,16875
113,85,28,796,75000,16876
781,696,85,-,211400,16877
740,691,49,633,99900,16878
175,129,46,929,54600,16879
1022,881,141,821,85900,16881
137,116,21,863,146700,16882
4133,3164,969,731,161500,16901
174,158,16,675,88900,16911
845,582,263,641,120800,16912
876,718,158,766,168400,16914
2355,1682,673,700,124200,16915
477,400,77,679,164900,16917
785,496,289,705,85900,16920
195,152,43,638,113400,16921
794,622,172,618,105000,16922
566,454,112,730,117100,16923
1299,1111,188,858,157800,16925
349,291,58,820,169500,16926
203,165,38,725,98800,16927
522,376,146,679,113700,16928
945,746,199,759,141800,16929
492,388,104,824,164400,16930
331,239,92,-,168900,16932
2733,1651,1082,751,154300,16933
506,391,115,825,186600,16935
789,621,168,698,134500,16936
71,69,2,-,187500,16937
291,252,39,825,167600,16938
118,75,43,990,79000,16939
89,58,31,504,100000,16940
24,21,3,-,78800,16941
303,245,58,900,107100,16942
219,152,67,629,139300,16943
1010,757,253,804,117200,16946
1758,1258,500,653,150900,16947
566,418,148,488,119900,16948
1271,954,317,620,110100,16950
241,190,51,386,183000,17002
4255,3223,1032,865,192000,17003
1715,1220,495,556,164700,17004
135,103,32,771,112800,17005
358,299,59,722,154300,17006
2380,1990,390,696,261700,17007
861,572,289,721,86500,17009
77,0,77,-,-,17010
13752,9408,4344,1068,196800,17011
14000,8237,5763,903,180200,17013
8279,7342,937,942,228200,17015
355,144,211,2521,122700,17016
703,574,129,657,150500,17017
1734,1453,281,778,195200,17018
6981,5713,1268,918,222000,17019
3610,2763,847,794,173700,17020
386,296,90,806,152000,17021
11473,7696,3777,1058,212500,17022
1338,972,366,600,134300,17023
705,594,111,871,202000,17024
7291,5200,2091,935,193000,17025
1543,1314,229,563,208100,17026
113,98,15,-,192900,17027
1550,1408,142,959,186800,17028
59,59,0,-,-,17029
310,228,82,575,113000,17030
3240,2662,578,696,167900,17032
6492,3661,2831,1044,253300,17033
1104,579,525,875,95200,17034
377,278,99,675,116200,17035
9339,6733,2606,1098,248900,17036
350,253,97,906,129900,17037
3121,2511,610,769,191900,17038
38,38,0,-,-,17039
978,799,179,760,173900,17040
120,120,0,-,243800,17041
15028,10088,4940,897,165200,17042
2948,1523,1425,934,161300,17043
9102,5898,3204,691,99800,17044
1265,989,276,718,167400,17045
11602,7043,4559,821,139300,17046
910,678,232,667,190000,17047
1559,1187,372,712,100900,17048
1089,877,212,758,147300,17049
15361,11688,3673,1211,272000,17050
1908,1545,363,666,132100,17051
641,560,81,731,119600,17052
2176,1709,467,904,170700,17053
15947,11088,4859,1068,208900,17055
23,23,0,-,42100,17056
9725,6946,2779,942,138200,17057
679,403,276,593,121800,17058
3143,2300,843,660,151900,17059
460,359,101,598,114100,17060
3021,2151,870,656,148600,17061
1599,1388,211,763,176000,17062
1268,988,280,629,112100,17063
363,303,60,1135,252800,17064
1654,1241,413,874,174600,17065
2335,1518,817,603,82600,17066
5782,4590,1192,903,171100,17067
1556,1220,336,820,170500,17068
64,27,37,638,126400,17069
6987,5191,1796,851,178500,17070
52,46,6,675,81400,17071
151,96,55,-,88300,17072
1940,1634,306,794,188800,17073
3002,2199,803,738,157400,17074
46,42,4,950,90000,17075
13,13,0,-,-,17076
37,20,17,-,-,17077
8919,6117,2802,986,195900,17078
118,101,17,725,100500,17080
243,199,44,-,111200,17081
1239,907,332,702,160100,17082
24,18,6,-,161100,17083
1818,1508,310,675,161300,17084
854,624,230,783,145700,17086
946,828,118,867,178700,17087
350,243,107,849,170900,17088
2408,2099,309,847,164300,17090
398,268,130,1325,153700,17093
1034,778,256,583,135200,17094
337,299,38,725,68200,17097
980,692,288,691,84600,17098
511,298,213,771,94800,17099
1450,87,1363,847,160900,17101
4074,1386,2688,828,138000,17102
4742,1619,3123,830,78500,17103
7611,2976,4635,848,74300,17104
10671,5629,5042,988,154400,17109
10146,6196,3950,1052,158200,17110
12856,8248,4608,1090,173800,17111
14259,11907,2352,1130,220900,17112
3902,2418,1484,888,104700,17113
0,0,0,-,-,17120
10980,5618,5362,841,162400,17201
11034,8643,2391,950,208800,17202
85,62,23,-,118500,17210
199,179,20,767,138200,17211
261,247,14,-,164200,17212
241,194,47,622,153900,17213
391,244,147,648,205900,17214
87,66,21,729,164100,17215
84,73,11,-,158700,17217
131,120,11,-,130000,17219
190,111,79,471,186900,17220
242,172,70,738,129500,17221
4872,3923,949,972,177400,17222
118,71,47,647,78800,17223
628,559,69,740,146800,17224
7433,5676,1757,1013,195700,17225
422,347,75,695,167700,17228
544,463,81,526,142800,17229
2237,1545,692,625,150500,17233
306,135,171,1113,181500,17235
3257,2548,709,869,174400,17236
663,528,135,1020,141100,17237
641,510,131,683,166400,17238
86,78,8,575,166700,17239
1261,1009,252,931,199000,17240
4686,3790,896,912,174700,17241
547,384,163,613,125600,17243
829,685,144,1034,177800,17244
94,84,10,-,193800,17246
233,26,207,1345,-,17247
157,148,9,-,86500,17249
34,0,34,-,-,17250
42,31,11,-,137500,17251
1700,1344,356,718,152200,17252
112,92,20,742,97500,17253
39,39,0,-,-,17254
447,368,79,719,151400,17255
49,49,0,-,137500,17256
11090,7234,3856,871,173700,17257
426,354,72,571,111300,17260
0,0,0,-,-,17261
502,331,171,693,192000,17262
213,182,31,-,203600,17263
975,801,174,622,141400,17264
270,233,37,918,145100,17265
185,128,57,721,165700,17266
1134,917,217,823,185300,17267
11939,8142,3797,885,173600,17268
43,43,0,-,-,17270
99,88,11,-,171700,17271
213,177,36,-,16500,17272
1668,1508,160,1000,188200,17301
1023,773,250,1039,195800,17302
1064,836,228,865,200600,17304
98,76,22,1350,164600,17306
2202,1694,508,890,198500,17307
839,602,237,749,194400,17309
103,68,35,832,152900,17311
4510,2989,1521,925,159000,17313
2063,1690,373,1003,201900,17314
10676,8998,1678,985,156500,17315
3072,2711,361,941,213800,17316
231,190,41,871,137700,17317
188,95,93,1152,116000,17318
4413,3735,678,1095,176900,17319
3061,2768,293,900,233800,17320
877,746,131,946,233000,17321
2194,1989,205,1072,183300,17322
1770,1565,205,767,175900,17324
10688,7634,3054,889,227900,17325
2832,2273,559,797,224400,17327
923,814,109,895,268100,17329
20859,15368,5491,932,181700,17331
2871,2310,561,927,244400,17339
4276,3495,781,907,217800,17340
21,21,0,-,-,17343
1552,932,620,908,164800,17344
3474,2377,1097,901,145700,17345
2334,2045,289,1173,174500,17347
2676,2487,189,1131,265700,17349
5086,3833,1253,1039,170200,17350
507,429,78,883,233100,17352
1368,1171,197,948,203600,17353
125,83,42,938,172300,17355
8239,6405,1834,922,180700,17356
2596,2273,323,1100,222300,17360
2593,1874,719,854,236900,17361
5070,4187,883,934,192900,17362
3639,3183,456,777,237400,17363
1355,1248,107,878,173000,17364
1081,976,105,827,207100,17365
2110,1759,351,891,151000,17366
3043,2432,611,816,155100,17368
2216,1967,249,967,156400,17370
89,71,18,-,138800,17371
1490,1145,345,913,203500,17372
6284,1593,4691,818,63800,17401
13771,9738,4033,1041,189500,17402
14891,9519,5372,939,159100,17403
13996,9736,4260,970,137800,17404
9170,7301,1869,1137,165800,17406
815,747,68,985,198100,17407
9639,7282,2357,1114,171200,17408
1797,908,889,986,191300,17501
1037,892,145,1290,177200,17502
501,325,176,1031,352900,17505
65,14,51,-,-,17507
198,181,17,-,245700,17508
1304,971,333,988,231000,17509
7334,4478,2856,818,155300,17512
1885,1642,243,971,222500,17516
5782,4620,1162,892,208700,17517
477,334,143,1091,250600,17518
2117,1623,494,1003,251700,17519
1938,1556,382,1196,184400,17520
12918,8725,4193,888,192200,17522
1845,1476,369,883,253900,17527
1424,998,426,1003,331000,17529
1117,953,164,939,224300,17532
740,436,304,1035,274700,17535
866,693,173,641,320900,17536
2468,2035,433,782,231800,17538
3608,2256,1352,1044,224900,17540
17618,12801,4817,1114,241900,17543
8163,6487,1676,986,196100,17545
2753,1999,754,950,161200,17547
307,181,126,1180,197800,17550
4324,2515,1809,1189,190800,17551
8367,5791,2576,1049,201000,17552
3036,1884,1152,888,213000,17554
2153,1719,434,1073,272900,17555
5228,3554,1674,1027,237000,17557
1856,1463,393,868,154000,17560
1399,1013,386,933,275800,17562
1204,952,252,889,229400,17563
926,872,54,825,237000,17565
4127,3052,1075,1078,234000,17566
1952,1700,252,1047,215900,17569
50,41,9,-,-,17570
1457,925,532,843,279100,17572
68,68,0,-,-,17576
2718,2246,472,830,194200,17578
2189,1724,465,1098,232900,17579
265,209,56,800,184200,17581
829,738,91,788,217100,17582
3970,2733,1237,1275,235900,17584
20998,15082,5916,1163,232600,17601
19009,10219,8790,964,174200,17602
25254,14354,10900,977,161300,17603
221,0,221,1604,-,17606
17695,9851,7844,772,134100,17701
4368,3211,1157,872,151700,17702
670,532,138,728,121600,17721
23,16,7,-,118800,17723
1906,1247,659,638,133900,17724
43,43,0,-,334600,17727
2069,1681,388,836,173100,17728
32,28,4,-,95000,17729
104,0,104,-,-,17730
121,111,10,-,408300,17731
2611,2015,596,768,163300,17737
17,14,3,-,275000,17739
4935,3636,1299,760,148200,17740
18,8,10,-,-,17742
1238,970,268,734,158000,17744
7088,4204,2884,761,142500,17745
1080,891,189,756,163100,17747
104,98,6,-,54700,17748
117,88,29,738,130800,17749
68,59,9,-,122100,17750
2577,2158,419,748,152300,17751
1678,1271,407,793,147600,17752
4867,3977,890,956,207400,17754
4297,3396,901,829,157500,17756
424,390,34,929,167500,17758
256,243,13,-,101400,17760
176,136,40,800,124000,17762
86,74,12,-,81800,17763
930,654,276,582,54100,17764
431,318,113,835,148200,17765
60,40,20,720,90700,17767
149,136,13,-,165600,17768
1284,1144,140,783,165500,17771
905,775,130,635,168800,17772
534,446,88,727,173100,17774
141,125,16,-,162500,17776
2964,2183,781,688,148700,17777
53,47,6,525,115600,17778
111,25,86,-,-,17779
6917,4105,2812,662,126500,17801
725,587,138,763,175200,17810
509,330,179,700,153700,17812
767,590,177,785,150000,17813
1920,1620,300,745,158400,17814
11234,6831,4403,766,164000,17815
2296,1787,509,793,163600,17820
7585,5142,2443,726,186600,17821
0,0,0,-,-,17822
487,378,109,789,180600,17823
1750,1575,175,380,217700,17824
265,214,51,721,134200,17827
79,67,12,744,145300,17829
794,655,139,658,148900,17830
318,293,25,507,80300,17832
1537,1038,499,691,85300,17834
120,66,54,843,158300,17835
79,55,24,629,168800,17836
6592,4511,2081,733,219400,17837
288,269,19,-,39400,17840
1784,1459,325,724,133100,17841
3305,2586,719,696,157600,17842
3809,3006,803,756,183200,17844
685,526,159,800,165400,17845
1546,1243,303,733,171800,17846
4712,3313,1399,684,146200,17847
297,231,66,706,45800,17850
3612,2312,1300,660,44500,17851
1181,927,254,660,170900,17853
368,300,68,967,149100,17855
1178,885,293,805,169500,17856
3082,2299,783,809,142400,17857
1147,987,160,800,160000,17859
995,960,35,515,198600,17860
64,55,9,-,118400,17861
171,65,106,707,120300,17862
707,536,171,703,189400,17864
37,33,4,-,-,17865
3424,2517,907,599,69900,17866
60,51,9,1406,201900,17867
537,474,63,808,163900,17868
5588,3849,1739,744,177100,17870
4448,2715,1733,601,64600,17872
845,478,367,647,164900,17876
526,460,66,744,174200,17878
45,15,30,833,79400,17880
621,510,111,620,72400,17881
87,51,36,763,-,17884
85,79,6,-,155600,17885
579,183,396,990,132700,17886
139,139,0,-,68600,17887
129,116,13,850,75200,17888
918,760,158,831,224400,17889
9829,7033,2796,677,88900,17901
158,142,16,1075,85900,17920
2691,1998,693,704,98500,17921
1876,1743,133,877,179600,17922
179,127,52,497,94500,17923
135,122,13,1094,81800,17925
638,463,175,766,114300,17929
180,117,63,855,82800,17930
2091,1596,495,816,79900,17931
46,33,13,-,-,17933
175,165,10,-,26200,17934
693,542,151,708,32000,17935
304,257,47,617,97500,17936
923,762,161,726,136400,17938
301,249,52,639,172000,17941
72,59,13,-,122700,17943
47,42,5,-,94300,17944
91,84,7,-,153100,17945
57,26,31,-,-,17946
1901,1250,651,779,30600,17948
85,76,9,-,36700,17949
104,104,0,-,106000,17951
130,123,7,-,69800,17952
194,153,41,695,64700,17953
2003,1410,593,581,56800,17954
132,132,0,-,88300,17957
597,452,145,613,61100,17959
1711,1539,172,775,182900,17960
2846,2243,603,709,169800,17961
3628,2944,684,702,157900,17963
316,252,64,481,156300,17964
895,707,188,745,80300,17965
1042,889,153,604,124500,17967
91,70,21,792,143800,17968
1401,1003,398,719,68100,17970
4734,3694,1040,635,132400,17972
116,92,24,-,129200,17974
2703,1845,858,588,40700,17976
115,66,49,679,103600,17978
109,109,0,-,132200,17979
1271,1040,231,728,89800,17980
1114,854,260,656,74300,17981
222,197,25,-,91700,17982
644,400,244,742,123500,17983
545,468,77,992,155000,17985
2048,1766,282,1313,209500,18011
6792,4858,1934,969,204200,18013
4453,3759,694,1119,203100,18014
11060,5714,5346,1001,163400,18015
0,0,0,-,-,18016
15844,10964,4880,1190,234200,18017
13233,7018,6215,1011,167800,18018
7563,6552,1011,1357,254900,18020
293,153,140,731,136100,18030
4047,2610,1437,1543,310800,18031
3773,2529,1244,939,159400,18032
3149,2617,532,1357,319800,18034
15,15,0,-,-,18035
5300,4629,671,898,295000,18036
3038,2459,579,937,197200,18037
1183,1123,60,1612,192900,18038
6171,5632,539,1132,268400,18040
1900,1423,477,969,234900,18041
15003,8147,6856,1015,144000,18042
10503,8494,2009,1327,243600,18045
0,0,0,-,-,18046
7362,5331,2031,1089,220200,18049
1394,1220,174,1722,296300,18051
11140,6890,4250,1143,188000,18052
846,679,167,1138,242500,18053
1666,1309,357,965,274000,18054
4708,3499,1209,1115,225200,18055
422,422,0,-,29500,18056
3392,2833,559,1120,168800,18058
372,360,12,-,291700,18059
10237,8489,1748,1371,266100,18062
223,168,55,-,179300,18063
9577,7420,2157,994,269700,18064
2355,2084,271,1125,257600,18066
7382,5478,1904,1050,201400,18067
0,0,0,-,-,18068
2973,2587,386,1145,301300,18069
355,330,25,-,168500,18070
3996,2931,1065,835,160900,18071
2543,1831,712,1134,173700,18072
3898,3475,423,1138,254600,18073
2220,2131,89,1350,282100,18074
1202,758,444,1205,181300,18076
947,758,189,1194,312000,18077
2965,2374,591,1092,293200,18078
226,216,10,-,131400,18079
4495,3427,1068,874,199100,18080
134,94,40,-,324200,18081
157,120,37,1069,195700,18083
449,346,103,880,184000,18085
271,206,65,1148,172700,18086
292,93,199,1310,158100,18087
3260,2891,369,1069,191700,18088
2273,1679,594,878,223000,18091
1300,1145,155,1125,303400,18092
1705,166,1539,746,123600,18101
16216,4824,11392,962,97100,18102
17817,11156,6661,1088,165600,18103
16435,11506,4929,1295,231700,18104
0,0,0,-,-,18105
3104,2289,815,1433,269500,18106
6749,3077,3672,1017,132900,18109
0,0,0,-,-,18195
10054,5287,4767,820,99200,18201
4720,2781,1939,813,119300,18202
2806,2187,619,1249,156600,18210
493,403,90,929,205200,18211
60,45,15,-,160200,18212
801,754,47,639,152600,18214
559,419,140,889,86600,18216
1006,739,267,692,48500,18218
658,470,188,815,151900,18219
123,114,9,-,43500,18220
106,40,66,-,91400,18221
3647,3418,229,827,180300,18222
93,93,0,-,-,18223
2627,1989,638,685,84500,18224
31,31,0,-,-,18225
3659,2990,669,766,170800,18229
42,39,3,-,86300,18230
199,135,64,855,91200,18231
1652,963,689,765,45900,18232
95,95,0,-,102500,18234
7809,6180,1629,831,156400,18235
1449,985,464,754,81200,18237
216,139,77,-,-,18239
1610,1164,446,718,108100,18240
394,224,170,878,92400,18241
81,68,13,-,-,18242
111,83,28,775,89200,18244
152,123,29,-,102400,18245
94,64,30,-,102800,18246
214,137,77,784,102200,18248
1467,1278,189,855,203900,18249
1219,856,363,916,92800,18250
17,0,17,-,-,18251
4757,3119,1638,731,87000,18252
439,334,105,838,87500,18254
1725,1337,388,745,123500,18255
156,116,40,847,81500,18256
9694,6452,3242,1160,172600,18301
6014,5202,812,1169,152100,18302
558,430,128,1244,173700,18321
925,694,231,992,182600,18322
53,53,0,-,-,18323
3525,2924,601,1367,133200,18324
800,650,150,1092,227100,18325
1488,1121,367,709,172500,18326
275,150,125,1138,189200,18327
2720,2358,362,1166,155400,18328
2792,2448,344,1051,163000,18330
196,149,47,936,117400,18331
814,637,177,1245,180000,18332
131,131,0,-,214100,18333
1525,1336,189,1332,157000,18334
203,154,49,1546,171100,18335
1687,1151,536,1019,197600,18336
5461,4599,862,1166,230500,18337
49,49,0,-,335500,18340
309,176,133,741,118900,18342
1615,1282,333,1259,237600,18343
1591,977,614,856,139700,18344
854,710,144,1052,138600,18346
1323,1150,173,1108,145700,18347
159,159,0,-,-,18349
686,627,59,860,174300,18350
225,86,139,1085,180700,18351
294,294,0,-,200000,18352
4271,3744,527,899,206900,18353
340,269,71,1423,173900,18354
427,321,106,1785,212100,18355
51,51,0,-,207500,18356
55,36,19,-,-,18357
9352,6405,2947,978,208400,18360
379,263,116,-,145200,18370
263,232,31,-,186000,18371
1044,875,169,957,177900,18372
2798,2165,633,788,183300,18403
977,867,110,713,170900,18405
5757,3660,2097,724,112000,18407
8778,7205,1573,985,236400,18411
106,50,56,588,208300,18413
2120,1834,286,948,207300,18414
581,507,74,863,279700,18415
397,346,51,525,187500,18417
1764,1437,327,742,170700,18419
17,12,5,-,-,18420
2001,1508,493,651,135000,18421
1989,1805,184,1005,152800,18424
548,479,69,1118,151700,18425
1877,1522,355,895,165000,18426
29,29,0,-,-,18427
4878,4006,872,1153,187300,18428
3,3,0,-,-,18430
4707,3384,1323,820,183100,18431
2617,2075,542,762,161400,18433
1631,1178,453,841,136300,18434
352,333,19,-,233400,18435
4887,4122,765,1024,185800,18436
89,67,22,763,198600,18437
603,589,14,-,255900,18438
188,163,25,1054,184000,18439
116,95,21,636,138800,18441
178,143,35,1007,170000,18443
5367,4474,893,856,218800,18444
920,755,165,808,221000,18445
1307,1050,257,717,168800,18446
4506,3073,1433,826,149900,18447
286,261,25,-,258900,18451
2323,1670,653,864,165900,18452
410,366,44,1000,181800,18453
10,4,6,-,-,18454
41,29,12,-,157800,18455
168,120,48,870,176800,18456
64,64,0,-,225000,18457
1051,910,141,1320,235400,18458
3,3,0,-,-,18459
87,79,8,-,161300,18460
149,143,6,750,137100,18461
130,114,16,675,142300,18462
73,70,3,-,167700,18463
589,502,87,1278,227000,18464
553,463,90,873,164900,18465
5476,4031,1445,1336,121900,18466
97,74,23,-,195500,18469
924,823,101,779,220900,18470
241,241,0,-,345500,18471
1583,1164,419,735,190700,18472
242,188,54,757,94500,18473
602,89,513,697,95900,18503
8899,4925,3974,776,103500,18504
8941,4601,4340,772,103100,18505
2156,1550,606,809,166200,18507
5325,2605,2720,838,94400,18508
4943,2439,2504,800,129200,18509
4698,1735,2963,790,121200,18510
5270,3629,1641,770,144800,18512
2193,1367,826,792,125900,18517
3617,2282,1335,835,148500,18518
2043,1173,870,764,126700,18519
99,89,10,-,302300,18602
8391,6016,2375,718,123900,18603
1665,1486,179,1006,159800,18610
6186,4797,1389,956,196900,18612
1085,823,262,563,155900,18614
759,640,119,841,193400,18615
249,201,48,717,160100,18616
757,463,294,700,76900,18617
1605,1335,270,1054,175400,18618
117,99,18,-,128900,18619
2060,1839,221,918,155800,18621
64,61,3,-,-,18622
1059,807,252,770,146200,18623
149,140,9,-,231100,18624
177,127,50,656,218000,18625
184,167,17,705,199400,18626
107,96,11,-,100000,18628
695,558,137,934,161000,18629
1208,881,327,794,175200,18630
544,375,169,889,134000,18631
230,157,73,814,79700,18632
5626,3532,2094,677,85900,18634
1504,1168,336,820,148600,18635
489,392,97,778,144800,18636
7399,4706,2693,853,123300,18640
2902,2202,700,739,106000,18641
1842,1396,446,755,128400,18642
5229,3607,1622,731,126800,18643
3259,2479,780,758,159200,18644
3672,2178,1494,735,83600,18651
64,64,0,-,168200,18653
2409,1981,428,779,171600,18655
904,807,97,807,154900,18656
4786,3632,1154,813,168800,18657
1525,1354,171,735,157900,18660
2165,1870,295,907,149500,18661
970,105,865,606,164600,18701
15806,8658,7148,811,87900,18702
13607,8067,5540,808,123100,18704
6321,4201,2120,765,92800,18705
6972,4709,2263,685,86800,18706
5751,5315,436,768,207000,18707
3326,2821,505,835,181900,18708
1543,849,694,569,87700,18709
3444,2556,888,723,191800,18801
2495,1837,658,629,135300,18810
696,619,77,935,200400,18812
79,70,9,682,115000,18814
55,42,13,-,151700,18816
106,75,31,943,172600,18817
560,445,115,573,174000,18818
576,349,227,795,138500,18821
1439,1036,403,732,124600,18822
92,64,28,470,121900,18823
593,469,124,775,168600,18824
38,35,3,-,275000,18825
598,502,96,685,213400,18826
155,124,31,-,169600,18828
299,256,43,755,156800,18829
278,213,65,786,154700,18830
500,399,101,618,134400,18831
732,563,169,780,130900,18832
831,670,161,761,162400,18833
1403,1076,327,831,181000,18834
1213,976,237,871,162900,18837
4564,2914,1650,723,139600,18840
103,95,8,-,123000,18842
93,76,17,-,108800,18843
748,611,137,813,196800,18844
133,113,20,1375,175700,18845
400,367,33,988,197600,18846
2299,1795,504,712,124100,18847
3705,2646,1059,776,157500,18848
926,730,196,714,131700,18850
289,247,42,1023,127000,18851
1701,1375,326,763,171900,18853
612,469,143,1044,158400,18854
10549,7535,3014,1457,427200,18901
7735,7047,688,1708,487900,18902
50,50,0,-,-,18912
17,17,0,-,-,18913
7746,6803,943,1404,365500,18914
284,199,85,-,332200,18915
884,409,475,1128,325000,18917
123,93,30,-,506000,18920
361,345,16,-,395500,18923
2340,2157,183,1153,474700,18925
3212,3061,151,1765,452900,18929
1177,977,200,1242,421800,18930
180,166,14,-,414300,18932
20,20,0,-,-,18935
0,0,0,-,-,18936
6209,5226,983,1502,579900,18938
11377,9521,1856,1706,486500,18940
1239,1030,209,1087,391700,18942
9182,7378,1804,1215,322200,18944
2376,2191,185,1384,451500,18947
85,85,0,-,485000,18950
13405,10667,2738,1111,261700,18951
3212,3144,68,1500,443500,18954
603,436,167,872,236100,18955
4695,3678,1017,1133,296300,18960
143,110,33,1125,303600,18962
5351,4018,1333,1074,279500,18964
14395,12278,2117,1542,359500,18966
5859,4456,1403,1102,281000,18969
286,206,80,931,230600,18970
1587,1386,201,1576,395600,18972
16494,12103,4391,1408,316800,18974
7345,6136,1209,1341,402700,18976
1616,1518,98,-,614200,18977
218,160,58,1132,500000,18980
6208,5160,1048,1145,264800,19001
12182,9378,2804,1336,428400,19002
5623,3472,2151,1422,347900,19003
3901,3031,870,1590,512500,19004
7870,6160,1710,1190,402200,19006
8212,4761,3451,950,189200,19007
7269,6377,892,1303,361100,19008
239,132,107,1323,468300,19009
7349,4711,2638,1549,658000,19010
2279,1965,314,1159,236800,19012
12216,4316,7900,855,72900,19013
7707,6620,1087,1081,236600,19014
6496,4865,1631,1048,163200,19015
70,53,17,-,363900,19017
9650,5841,3809,1041,155800,19018
21799,12372,9427,1201,268400,19020
3853,2674,1179,1061,196400,19021
1250,567,683,983,99300,19022
7367,4045,3322,1023,88300,19023
2140,1763,377,2237,449400,19025
11861,7745,4116,1097,185400,19026
8503,5020,3483,1122,277600,19027
1422,946,476,1077,134800,19029
4679,3389,1290,1104,252000,19030
1658,1351,307,1325,365300,19031
2345,1648,697,1228,114100,19032
3156,2336,820,1302,212400,19033
2020,1627,393,1176,499900,19034
1439,1193,246,1743,927100,19035
5327,3790,1537,1033,135600,19036
11247,9497,1750,1188,292900,19038
7786,5515,2271,1254,290900,19040
2612,1626,986,1758,701600,19041
985,733,252,1151,171400,19043
6708,4045,2663,1312,280500,19044
7274,5014,2260,1278,359200,19046
12826,9243,3583,1336,353400,19047
11174,6570,4604,951,149100,19050
9926,8019,1907,1169,291800,19053
5953,4508,1445,1126,236300,19054
4908,4060,848,1156,209600,19055
5508,3920,1588,1190,256000,19056
6227,4518,1709,1151,219300,19057
3724,3580,144,1984,432500,19060
7782,4716,3066,1056,188500,19061
15017,10619,4398,1334,384700,19063
8495,7828,667,1221,315300,19064
1720,1609,111,2781,664500,19066
20314,16070,4244,1248,384200,19067
2866,2076,790,997,237600,19070
4076,3048,1028,1479,586700,19072
8018,6190,1828,1549,426700,19073
2079,1551,528,982,167900,19074
2778,2355,423,1078,336400,19075
2688,1780,908,1043,190200,19076
4576,3326,1250,961,183200,19078
3496,2326,1170,1048,109300,19079
3376,2768,608,1033,286800,19081
14604,6810,7794,954,111600,19082
12853,11430,1423,1143,327200,19083
1824,1695,129,2625,833000,19085
4220,3737,483,1261,346200,19086
11843,9076,2767,1573,575700,19087
7049,5085,1964,1324,258400,19090
1607,1118,489,912,178100,19094
2977,1621,1356,1467,325600,19095
5642,4198,1444,1572,531100,19096
3055,845,2210,2058,467600,19102
15177,5030,10147,1758,506800,19103
16340,3502,12838,997,138300,19104
6736,3307,3429,1788,516900,19106
7675,1575,6100,1346,382300,19107
0,0,0,-,-,19109
24251,13936,10315,1002,177300,19111
0,0,0,-,-,19112
50,46,4,-,171600,19113
12964,8093,4871,1137,196700,19114
13533,7866,5667,986,246600,19115
12643,7640,5003,1042,240100,19116
4503,2022,2481,1485,537200,19118
11785,7600,4185,1005,269200,19119
23445,14049,9396,997,99700,19120
12408,3933,8475,844,106500,19121
6663,2868,3795,880,199100,19122
8021,2656,5365,1407,387100,19123
22609,12223,10386,894,104100,19124
10556,6709,3847,1273,244800,19125
5827,3274,2553,961,155600,19126
2642,1142,1500,1554,238400,19127
16336,9518,6818,1354,249100,19128
4671,2249,2422,1361,230100,19129
13676,5727,7949,1533,379700,19130
17524,8544,8980,1015,117000,19131
14087,6857,7230,853,54600,19132
8957,3975,4982,705,55800,19133
20398,10809,9589,919,88400,19134
12070,7794,4276,971,120700,19135
12332,7363,4969,885,147400,19136
3091,2454,637,1022,148100,19137
11838,8451,3387,972,124800,19138
17328,6994,10334,880,83300,19139
18811,9443,9368,865,64400,19140
12523,6545,5978,853,107800,19141
9829,5136,4693,974,82600,19142
25102,11948,13154,942,94300,19143
18530,7185,11345,927,149200,19144
18379,11010,7369,1054,193300,19145
17200,9168,8032,1258,335500,19146
17390,9584,7806,1328,381300,19147
19261,12430,6831,1119,194900,19148
18846,11590,7256,1149,133800,19149
9834,7152,2682,1080,164000,19150
11780,7802,3978,995,137600,19151
13034,8187,4847,960,193900,19152
5348,3053,2295,1121,143200,19153
12394,9699,2695,1233,204200,19154
2591,2078,513,1456,396500,19301
960,696,264,1063,236400,19310
2910,2393,517,1216,371100,19311
4330,3663,667,1607,630600,19312
121,97,24,-,225000,19316
3735,2926,809,1663,513000,19317
95,95,0,-,381900,19319
20181,14210,5971,1226,246000,19320
1906,1642,264,1100,311900,19330
2831,1786,1045,1537,626100,19333
17975,14579,3396,1266,346800,19335
7003,4200,2803,1604,389600,19341
7494,5272,2222,1998,442900,19342
2625,2226,399,1503,419400,19343
4287,3107,1180,1136,254100,19344
0,0,0,-,-,19345
8685,6192,2493,1157,395000,19348
4121,3796,325,1285,393800,19350
2878,2584,294,1025,351400,19352
10089,7561,2528,1629,508200,19355
225,41,184,1181,195300,19358
2083,1745,338,926,218100,19362
5755,4132,1623,1044,268600,19363
2584,1932,652,1000,212400,19365
17,17,0,-,-,19367
669,449,220,1658,262800,19372
879,778,101,-,603200,19373
380,282,98,742,305000,19374
0,0,0,-,-,19375
20649,14752,5897,1448,394400,19380
20211,14200,6011,1398,433700,19382
0,0,0,-,-,19383
5060,3856,1204,886,314000,19390
16409,7150,9259,1108,174500,19401
17990,12976,5014,1357,280500,19403
2368,1112,1256,1125,209300,19405
10998,6467,4531,1461,319400,19406
7302,5699,1603,1765,451000,19422
5281,4855,426,1796,473700,19425
12428,11103,1325,1387,363000,19426
8070,4338,3732,1490,333500,19428
47,47,0,-,194000,19435
407,127,280,1625,-,19436
390,390,0,-,884600,19437
9432,7195,2237,1421,339000,19438
7432,5314,2118,1084,297700,19440
0,0,0,-,-,19442
4313,3092,1221,1718,399600,19444
22212,14473,7739,1322,332600,19446
816,605,211,1099,219900,19453
11422,8921,2501,1369,329400,19454
250,203,47,-,292300,19456
45,45,0,-,-,19457
16459,11897,4562,1233,318700,19460
6076,4555,1521,1498,352200,19462
18198,11805,6393,999,173500,19464
6623,5120,1503,1122,285300,19465
10117,7409,2708,1378,263000,19468
5,0,5,-,-,19472
5901,5236,665,1166,320600,19473
303,269,34,-,221600,19474
4256,3230,1026,917,290600,19475
0,0,0,-,-,19477
244,23,221,2250,-,19492
471,292,179,879,186000,19501
605,399,206,958,173600,19503
1979,1750,229,930,276900,19504
1469,1198,271,1046,226500,19505
2771,2332,439,880,222000,19506
1092,956,136,739,207200,19507
6179,5317,862,899,187300,19508
3275,2774,501,1215,195500,19510
43,43,0,-,193400,19511
6871,5415,1456,926,198500,19512
5603,4833,770,1197,246000,19518
67,67,0,-,-,19519
2315,1948,367,803,295400,19520
5343,4689,654,890,182200,19522
140,108,32,-,136900,19523
5662,5136,526,1048,313700,19525
4605,3415,1190,948,159700,19526
1213,1045,168,957,255400,19529
4881,3202,1679,954,202800,19530
2391,1932,459,946,199200,19533
806,681,125,1028,213400,19534
5,5,0,-,-,19535
202,132,70,900,122900,19536
23,15,8,-,-,19538
1816,1510,306,1291,214100,19539
4459,3749,710,906,239200,19540
1698,1462,236,939,233600,19541
25,25,0,-,-,19542
2157,1693,464,1068,268500,19543
45,45,0,-,147500,19544
272,158,114,854,155400,19545
1812,1554,258,1128,236100,19547
134,83,51,1048,93800,19549
118,69,49,-,121100,19550
1863,1510,353,915,188200,19551
172,118,54,850,158100,19554
1431,1107,324,894,167200,19555
143,101,42,800,129600,19559
3260,2550,710,1166,146400,19560
1013,505,508,757,155500,19562
61,20,41,-,-,19564
3528,2619,909,895,185100,19565
2039,1499,540,895,174100,19567
11333,4104,7229,801,72900,19601
6257,2066,4191,732,50800,19602
8238,3845,4393,891,78000,19604
7427,6459,968,944,157700,19605
13380,10353,3027,1110,171700,19606
9654,6203,3451,1065,157500,19607
8238,6562,1676,1241,239200,19608
4016,3378,638,1254,159300,19609
6332,4367,1965,1269,245500,19610
3742,1896,1846,773,113000,19611
14410,11309,3101,1476,274000,19701
19580,11991,7589,1311,254400,19702
6047,3097,2950,1076,213800,19703
663,475,188,1068,189400,19706
5969,5150,819,1792,430100,19707
14550,12709,1841,1237,336100,19709
0,0,0,-,-,19710
19683,12474,7209,1239,296700,19711
11629,7451,4178,1106,211000,19713
0,0,0,-,-,19716
0,0,0,-,-,19717
21447,14648,6799,1123,189800,19720
301,271,30,1232,323000,19730
71,62,9,-,-,19731
26,26,0,-,-,19732
72,72,0,-,214000,19733
4210,3904,306,1478,336900,19734
9,0,9,-,-,19735
26,0,26,-,-,19736
6393,1685,4708,886,142500,19801
10399,5103,5296,973,152400,19802
8542,7386,1156,1308,367000,19803
6871,4916,1955,1179,196400,19804
14856,7776,7080,1058,173600,19805
5192,2714,2478,1141,320800,19806
3152,2327,825,1379,755500,19807
15152,11629,3523,1218,259400,19808
6030,3822,2208,1168,243000,19809
9780,8032,1748,1173,340100,19810
14154,7711,6443,1174,187000,19901
0,0,0,-,-,19902
13646,8854,4792,1108,215400,19904
1250,1234,16,-,589100,19930
125,114,11,-,185900,19931
3730,2840,890,732,213000,19933
5049,4047,1002,1200,238300,19934
125,63,62,929,-,19936
3123,2623,500,1203,248400,19938
2757,2504,253,1106,294500,19939
2206,1687,519,815,200900,19940
1060,681,379,986,185900,19941
5007,4153,854,1122,211900,19943
364,342,22,1063,776500,19944
2839,2396,443,1198,255500,19945
1952,1387,565,1082,174000,19946
6779,4603,2176,899,228500,19947
2598,2033,565,1063,214300,19950
842,742,100,1576,309100,19951
3893,2678,1215,897,204300,19952
1658,1462,196,1078,220800,19953
550,403,147,1005,240300,19954
15,11,4,-,-,19955
5693,3981,1712,848,182300,19956
12128,10182,1946,1339,356900,19958
2516,2096,420,1014,198700,19960
4172,3291,881,980,255400,19962
8149,5433,2716,998,220800,19963
351,301,50,730,279900,19964
12311,10205,2106,1040,210400,19966
531,441,90,1531,322700,19967
4927,4103,824,1071,293300,19968
3896,3372,524,1344,339700,19970
7009,6197,812,1348,408000,19971
9536,7024,2512,902,192900,19973
4398,3529,869,1124,336500,19975
8624,6766,1858,1091,239100,19977
299,262,37,945,194800,19979
20147,7476,12671,2094,692900,20001
28549,10771,17778,1668,637300,20002
13539,6144,7395,2180,806500,20003
1264,510,754,2625,594600,20004
7587,1792,5795,1865,536700,20005
568,40,528,1751,232300,20006
11804,6539,5265,1894,1009000,20007
15809,6081,9728,1933,737100,20008
27708,10056,17652,1848,644000,20009
12592,4517,8075,1541,668600,20010
23929,12481,11448,1256,574600,20011
6270,3742,2528,1401,633200,20012
6383,4555,1828,1678,1001700,20015
13020,9156,3864,1871,963900,20016
7710,4513,3197,1563,522000,20017
8072,4776,3296,1028,514700,20018
24118,8632,15486,1008,301600,20019
21480,6906,14574,1113,319700,20020
8274,3036,5238,1629,427800,20024
15151,2904,12247,1130,286800,20032
3942,1364,2578,1964,372300,20036
6144,2369,3775,2091,686800,20037
0,0,0,-,-,20045
0,0,0,-,-,20052
0,0,0,-,-,20053
0,0,0,-,-,20057
0,0,0,-,-,20064
7513,6646,867,2322,545900,20105
1988,1741,247,1291,370400,20106
13463,5740,7723,1651,293400,20109
14437,9884,4553,1527,334800,20110
10204,6996,3208,1659,354100,20111
8209,7749,460,2303,473100,20112
2506,1777,729,1380,468100,20115
1063,708,355,930,639400,20117
1,0,1,-,-,20118
1404,1140,264,1398,420200,20119
13494,10029,3465,1899,481200,20120
9561,6004,3557,1840,378200,20121
4896,4439,457,2257,676900,20124
179,156,23,-,1144200,20129
138,111,27,1855,-,20130
5645,4961,684,1383,537800,20132
1251,1020,231,1439,391200,20135
8407,7623,784,2382,440900,20136
522,491,31,2100,505300,20137
100,80,20,-,320000,20139
2386,2134,252,1211,470500,20141
287,275,12,-,706700,20143
462,379,83,1193,497900,20144
22273,15875,6398,1902,506900,20147
15852,12510,3342,2124,605100,20148
6822,5538,1284,1824,523200,20151
10889,9351,1538,2263,550000,20152
11580,9867,1713,2193,472500,20155
1456,1339,117,1638,571300,20158
12319,9081,3238,1880,376000,20164
11168,9127,2041,1945,511500,20165
4309,2353,1956,1849,421200,20166
7912,7210,702,2406,541400,20169
13398,9179,4219,1840,481700,20170
17410,10228,7182,1940,627800,20171
12034,9320,2714,1677,491800,20175
17371,13284,4087,1718,516000,20176
2533,2186,347,1801,474500,20180
2773,2482,291,1605,480800,20181
316,170,146,-,509300,20184
5551,3756,1795,1326,390000,20186
6026,5411,615,1853,448000,20187
9182,4350,4832,1888,471100,20190
11607,8070,3537,1773,486900,20191
5446,3915,1531,1935,632300,20194
748,719,29,-,782900,20197
875,650,225,-,439700,20198
0,0,0,-,-,20202
0,0,0,-,-,20204
0,0,0,-,-,20228
0,0,0,-,-,20230
0,0,0,-,-,20240
0,0,0,-,-,20245
0,0,0,-,-,20260
0,0,0,-,-,20307
326,7,319,1843,-,20317
0,0,0,-,-,20319
0,0,0,-,-,20373
0,0,0,-,-,20390
0,0,0,-,-,20405
0,0,0,-,-,20418
0,0,0,-,-,20427
0,0,0,-,-,20506
0,0,0,-,-,20510
0,0,0,-,-,20520
0,0,0,-,-,20535
0,0,0,-,-,20540
0,0,0,-,-,20551
0,0,0,-,-,20553
0,0,0,-,-,20560
0,0,0,-,-,20565
0,0,0,-,-,20566
0,0,0,-,-,20593
8924,7016,1908,1782,293900,20601
10166,6187,3979,1608,244500,20602
11260,8552,2708,1789,332000,20603
137,129,8,-,289800,20606
3882,3771,111,1750,391200,20607
279,256,23,1691,311500,20608
427,349,78,1536,265500,20609
551,412,139,-,325300,20611
138,138,0,-,236300,20612
4657,4183,474,1588,370200,20613
198,198,0,-,531300,20615
2345,1937,408,1887,274200,20616
296,286,10,-,422400,20617
191,125,66,1337,360500,20618
5486,3355,2131,1580,283900,20619
548,400,148,1410,236900,20620
380,356,24,-,443200,20621
1797,1526,271,1076,329600,20622
895,889,6,-,318400,20623
519,418,101,1430,336900,20624
240,221,19,-,331100,20625
184,155,29,-,464800,20626
188,170,18,-,-,20628
139,83,56,-,394300,20629
117,97,20,-,-,20630
109,83,26,711,295800,20632
2448,1463,985,1417,243000,20634
3796,3201,595,1315,375300,20636
1894,1663,231,2544,399700,20637
4865,4466,399,1690,446200,20639
3688,2836,852,1504,239400,20640
300,274,26,-,350600,20645
7541,6219,1322,1413,360700,20646
5333,3964,1369,1104,371400,20650
9691,5361,4330,1391,269600,20653
6959,5939,1020,1356,239500,20657
297,203,94,1473,265600,20658
7931,7058,873,1217,298100,20659
0,0,0,-,-,20660
1074,991,83,1212,291900,20662
1240,863,377,1525,353700,20664
221,185,36,-,220300,20667
345,0,345,1837,-,20670
308,201,107,1348,450000,20674
760,724,36,-,337600,20675
1271,1120,151,1979,341600,20676
791,728,63,1375,402200,20677
4281,3349,932,828,348500,20678
323,204,119,1191,349300,20680
416,331,85,-,302800,20684
2384,2149,235,1646,339000,20685
109,40,69,-,-,20686
219,162,57,-,335000,20687
838,413,425,2313,389600,20688
644,630,14,-,393300,20689
359,296,63,1343,393100,20690
322,322,0,-,408100,20692
317,277,40,-,391900,20693
2906,2324,582,2020,317100,20695
62,0,62,2250,-,20701
9266,5602,3664,1669,341500,20705
13179,8599,4580,1627,295800,20706
12201,7146,5055,1548,308000,20707
9872,3596,6276,1500,333300,20708
3828,848,2980,1353,248000,20710
2439,2221,218,1289,347100,20711
3977,957,3020,1256,354500,20712
1983,1369,614,1677,293000,20714
9080,8304,776,2258,338300,20715
8783,6142,2641,1780,300000,20716
7557,6904,653,2412,406200,20720
9583,8330,1253,2199,403800,20721
1804,1237,567,1387,269200,20722
11633,8052,3581,1746,406800,20723
6748,4589,2159,1824,315500,20724
3693,2897,796,1650,345100,20732
1035,922,113,1579,328500,20733
12273,10986,1287,1935,301500,20735
2999,2870,129,1329,447400,20736
6048,2980,3068,1316,273900,20737
9632,4366,5266,1477,323200,20740
0,0,0,-,-,20742
14449,9891,4558,1316,227200,20743
18350,14413,3937,1597,322900,20744
10676,4215,6461,1324,242300,20745
11348,4310,7038,1485,220400,20746
15067,7669,7398,1364,239600,20747
14748,7939,6809,1351,266700,20748
850,773,77,1281,351400,20751
2471,2243,228,1198,460800,20754
2875,26,2849,2177,-,20755
173,161,12,-,561400,20758
1689,1534,155,"3,500+",673000,20759
829,0,829,2453,-,20762
743,404,339,1359,355500,20763
1449,1286,163,1853,295300,20764
161,76,85,1263,450000,20765
1941,1807,134,2331,443500,20769
9817,4507,5310,1613,217700,20770
16248,13868,2380,1846,318200,20772
18350,14703,3647,1798,329900,20774
1211,1013,198,1777,449300,20776
1172,1158,14,-,717100,20777
751,668,83,2268,531100,20778
432,421,11,-,481800,20779
3882,2158,1724,1389,327800,20781
11192,4745,6447,1513,327400,20782
11916,5183,6733,1397,307000,20783
9482,5653,3829,1400,258200,20784
13900,6876,7024,1494,257100,20785
4311,3203,1108,1607,316600,20794
101,91,10,2750,920100,20812
13393,7212,6181,1950,770800,20814
12944,8164,4780,2087,1004300,20815
6052,4901,1151,2407,950200,20816
13240,11248,1992,2122,911900,20817
797,738,59,-,920700,20818
8803,7551,1252,1900,477400,20832
2355,2238,117,1964,599200,20833
1951,1652,299,1898,511300,20837
97,97,0,-,599100,20838
23,23,0,-,-,20839
3094,2884,210,2588,607200,20841
678,539,139,1279,630200,20842
20636,11365,9271,2033,604200,20850
4989,2913,2076,1757,380700,20851
20621,9169,11452,1892,504400,20852
9633,8135,1498,1564,459700,20853
16655,15266,1389,2620,906200,20854
5244,4353,891,1899,504100,20855
888,630,258,1188,832700,20860
538,538,0,-,611900,20861
118,118,0,-,776500,20862
4865,3409,1456,1800,339500,20866
211,191,20,-,757400,20868
5755,4892,863,2151,456600,20871
4224,3619,605,1500,388200,20872
21669,13483,8186,1714,324200,20874
9573,6343,3230,1817,413400,20876
12800,5727,7073,1584,350800,20877
22404,15871,6533,1830,568900,20878
8212,5679,2533,1728,320900,20879
238,210,28,1750,445600,20880
4522,4347,175,2179,567000,20882
11843,8091,3752,1619,305200,20886
6890,5610,1280,1627,637400,20895
292,286,6,-,838100,20896
190,13,177,887,-,20899
12366,8595,3771,1565,445400,20901
16730,10705,6025,1820,406500,20902
7511,2854,4657,1594,364700,20903
19774,10998,8776,1717,404900,20904
5901,5359,542,1578,488200,20905
25138,16638,8500,1707,344200,20906
20516,6710,13806,1749,576900,20910
9361,3894,5467,1216,545400,20912
9762,6223,3539,1076,226100,21001
750,0,750,1856,-,21005
11663,9306,2357,1331,250700,21009
129,0,129,-,-,21010
7724,6743,981,1922,447500,21012
1682,1627,55,-,449100,21013
14177,10921,3256,1237,322200,21014
10369,8991,1378,1460,339100,21015
2777,1738,1039,1446,193500,21017
1049,974,75,1357,380900,21028
3412,3113,299,2356,704700,21029
10041,4581,5460,1249,384900,21030
0,0,0,-,-,21031
3066,2696,370,1544,465700,21032
1298,1114,184,895,269200,21034
2653,2517,136,2793,654400,21035
709,664,45,-,703300,21036
7958,6726,1232,1737,413900,21037
8492,6083,2409,1229,173900,21040
14062,12160,1902,1750,600500,21042
16881,11733,5148,1652,479000,21043
17957,10705,7252,1732,408200,21044
15126,10732,4394,1604,351900,21045
6210,3910,2300,1728,376400,21046
4360,4141,219,2021,391000,21047
3682,3390,292,1203,356800,21048
6487,5818,669,1437,360000,21050
107,107,0,-,380600,21051
76,69,7,-,287500,21052
1108,997,111,1674,421700,21053
4185,3501,684,1724,409900,21054
89,89,0,-,1108900,21056
1616,1387,229,-,491700,21057
13438,9811,3627,1296,269200,21060
20948,11825,9123,1342,254900,21061
189,169,20,-,381000,21071
5527,4589,938,897,284700,21074
12305,8219,4086,1774,360800,21075
6939,4654,2285,1951,381100,21076
127,116,11,-,343800,21077
7552,5486,2066,973,292700,21078
245,225,20,-,370100,21082
2646,2394,252,1211,385900,21084
6136,4956,1180,1148,272800,21085
1904,1796,108,1893,414900,21087
3751,3063,688,1507,313800,21090
15400,12342,3058,1279,376900,21093
4100,3628,472,950,321700,21102
1908,1815,93,2194,544800,21104
0,0,0,-,-,21105
6528,5408,1120,1611,444600,21108
1834,1690,144,1667,518800,21111
13844,8925,4919,1843,318400,21113
9812,7715,2097,1920,378600,21114
22797,12365,10432,1509,290100,21117
2450,2220,230,1599,456600,21120
21965,18736,3229,1728,338600,21122
5172,4302,870,1422,328300,21128
52,9,43,640,-,21130
2531,2422,109,1840,552900,21131
934,912,22,1344,390600,21132
11536,7974,3562,1214,241400,21133
12920,9605,3315,1283,291000,21136
1332,1225,107,1685,472000,21140
11818,9132,2686,1580,372300,21144
9458,8599,859,1753,534400,21146
2242,1688,554,1362,400400,21152
169,141,28,-,825000,21153
2113,1958,155,1258,344900,21154
964,721,243,1281,373300,21155
128,128,0,-,339000,21156
13999,10092,3907,1024,319200,21157
7592,6175,1417,1489,326200,21158
960,755,205,1038,303600,21160
1921,1783,138,1413,363100,21161
1334,1265,69,-,386500,21162
2526,2187,339,1731,463900,21163
9394,1203,8191,1126,224800,21201
9376,2072,7304,1086,237700,21202
7742,3893,3849,1601,456000,21204
5344,1770,3574,893,53600,21205
19461,11340,8121,999,158000,21206
18736,11668,7068,1140,193100,21207
14817,10049,4768,1417,250100,21208
11504,7101,4403,1336,320800,21209
5154,3177,1977,1329,439900,21210
7648,4076,3572,1318,225000,21211
12393,8418,3975,1158,288700,21212
11084,5993,5091,1112,99900,21213
7857,5992,1865,1020,185600,21214
22076,11008,11068,975,127600,21215
10609,5105,5504,999,96900,21216
13615,4489,9126,905,121300,21217
18359,8899,9460,1065,162000,21218
3576,2778,798,1330,304200,21219
15231,9995,5236,1248,218300,21220
16127,9129,6998,1075,201100,21221
20737,13068,7669,1130,150800,21222
8212,2828,5384,927,69500,21223
19047,11042,8005,1484,210600,21224
12211,6070,6141,888,169800,21225
2317,1885,432,1230,242000,21226
12246,7875,4371,1117,213400,21227
18378,13794,4584,1439,308300,21228
17575,9472,8103,1039,131800,21229
14807,7798,7009,1490,276100,21230
7508,2774,4734,1294,294700,21231
28325,17493,10832,1284,222300,21234
15538,10519,5019,1338,245700,21236
11426,7120,4306,1200,215200,21237
11965,6326,5639,1140,153400,21239
0,0,0,-,-,21240
13446,6387,7059,1346,212600,21244
0,0,0,-,-,21250
0,0,0,-,-,21251
0,0,0,-,-,21252
8026,4913,3113,1313,356200,21286
16456,10094,6362,1719,468500,21401
290,0,290,2102,-,21402
13229,8423,4806,1655,472600,21403
160,160,0,-,1043100,21405
7428,6598,830,1775,433400,21409
16123,10527,5596,683,126700,21502
923,770,153,673,241700,21520
551,419,132,741,95100,21521
93,70,23,-,139500,21522
92,85,7,-,100600,21523
282,202,80,-,135500,21524
206,192,14,-,116700,21529
767,677,90,1137,164100,21530
887,727,160,526,146500,21531
5240,3522,1718,755,129800,21532
1609,1272,337,576,171500,21536
192,153,39,683,81300,21538
972,723,249,544,86500,21539
38,26,12,581,25000,21540
744,463,281,593,219600,21541
256,150,106,775,79600,21542
118,107,11,-,130100,21543
774,656,118,789,111000,21545
5954,4624,1330,628,170400,21550
619,525,94,816,134800,21555
654,603,51,1073,115500,21557
1103,909,194,521,223100,21561
1360,1028,332,605,86400,21562
10621,6829,3792,1098,311300,21601
216,152,64,977,295600,21607
185,136,49,930,178100,21610
169,160,9,-,476200,21612
7199,3989,3210,869,203200,21613
3559,3095,464,1051,365300,21617
2582,1791,791,1707,363100,21619
5086,3311,1775,916,260100,21620
316,217,99,1146,233700,21622
642,529,113,1250,273100,21623
64,46,18,-,360000,21624
1006,849,157,1386,317900,21625
45,45,0,-,-,21626
0,0,0,-,-,21627
178,145,33,-,-,21628
3417,2743,674,925,222700,21629
1041,884,157,1054,254900,21631
2351,1444,907,802,157200,21632
118,118,0,-,354800,21634
853,689,164,898,272800,21635
421,332,89,983,200000,21636
2010,1605,405,1743,428600,21638
1691,1144,547,858,167000,21639
578,507,71,875,206300,21640
33,19,14,817,181300,21641
2339,1867,472,724,153300,21643
31,31,0,-,248400,21644
463,405,58,1179,335300,21645
128,93,35,-,401800,21647
81,64,17,-,123600,21648
542,421,121,1235,165600,21649
88,72,16,-,-,21650
1171,886,285,1058,222500,21651
68,48,20,-,515600,21652
66,66,0,-,304000,21653
556,394,162,1221,699400,21654
1865,1480,385,1007,215800,21655
320,275,45,1775,297600,21657
1509,1310,199,1547,421300,21658
512,456,56,850,184700,21659
1572,1049,523,788,232900,21660
1093,736,357,1069,197800,21661
220,201,19,-,851600,21662
1681,1358,323,996,480800,21663
190,137,53,1217,142900,21664
83,83,0,-,479400,21665
4887,3933,954,1539,375500,21666
108,101,7,-,200900,21667
705,553,152,561,234700,21668
98,98,0,-,465800,21669
411,366,45,-,337600,21671
101,95,6,-,-,21672
1412,1036,376,1123,343400,21673
46,46,0,-,90000,21675
182,160,22,1422,-,21676
197,178,19,1896,430800,21677
797,739,58,-,263200,21678
134,123,11,-,279300,21679
15432,10142,5290,1362,301600,21701
16041,10022,6019,1420,287900,21702
13595,8983,4612,1525,270300,21703
5321,4536,785,1998,493500,21704
0,0,0,-,-,21705
1866,1398,468,1778,423900,21710
434,377,57,855,200900,21711
3972,3256,716,1398,272800,21713
62,25,37,-,461100,21714
1864,1408,456,865,224800,21716
30,0,30,-,-,21717
69,54,15,1281,408000,21718
414,351,63,1052,211600,21719
2052,1588,464,929,242400,21722
277,265,12,-,663200,21723
1892,1368,524,848,265200,21727
356,356,0,-,324300,21733
434,200,234,674,152600,21734
676,676,0,-,830800,21737
1204,1173,31,-,708100,21738
22893,12534,10359,855,173600,21740
13132,8679,4453,1036,218300,21742
0,0,0,-,-,21746
1506,1098,408,725,156400,21750
2378,2062,316,1765,477300,21754
2020,1845,175,1125,365200,21755
1174,1080,94,872,300600,21756
1087,868,219,1161,287300,21757
1974,1727,247,1344,280500,21758
81,81,0,-,290400,21762
267,200,67,635,214800,21766
348,223,125,704,172200,21767
4130,3634,496,1393,389500,21769
1852,1771,81,-,419100,21770
9957,9172,785,1508,411000,21771
1934,1828,106,1031,347800,21773
4644,4329,315,2014,385500,21774
1970,1474,496,1166,317000,21776
599,563,36,-,358200,21777
382,301,81,1280,294900,21778
340,290,50,-,326800,21779
571,515,56,1486,296800,21780
16,16,0,-,-,21781
1759,1582,177,1024,252000,21782
3172,2574,598,1014,244200,21783
13399,11702,1697,1228,386900,21784
4031,3287,744,1065,276000,21787
4727,3687,1040,1109,256900,21788
92,86,6,-,535000,21790
1984,1472,512,1069,324900,21791
3757,3039,718,1476,293600,21793
807,780,27,-,705700,21794
3728,2428,1300,942,205100,21795
2940,2614,326,1236,581000,21797
806,641,165,796,344700,21798
10727,5792,4935,865,210800,21801
0,0,0,-,-,21802
15255,7417,7838,1133,168800,21804
237,237,0,-,189300,21810
10228,8195,2033,1223,268800,21811
1050,987,63,1050,363800,21813
112,112,0,-,189300,21814
2019,1281,738,568,114500,21817
419,389,30,860,160200,21821
734,593,141,811,203200,21822
47,42,5,-,111400,21824
1966,1112,854,1282,167900,21826
201,165,36,-,170800,21829
1389,1143,246,810,159700,21830
157,136,21,-,-,21835
1110,895,215,1128,171700,21837
751,699,52,1028,136400,21838
172,129,43,-,153500,21840
487,330,157,1113,296600,21841
5184,3625,1559,1078,308400,21842
1390,1090,300,956,171100,21849
1047,830,217,1031,156300,21850
2852,1760,1092,836,146600,21851
3780,1915,1865,732,146000,21853
270,200,70,-,116400,21856
253,189,64,870,154500,21861
15,15,0,-,-,21862
1787,1328,459,846,172800,21863
227,168,59,-,180400,21864
201,171,30,-,289900,21865
19,19,0,-,-,21866
23,14,9,-,-,21867
441,384,57,810,150000,21869
839,718,121,682,168000,21871
174,87,87,716,308300,21872
754,480,274,1180,143800,21874
2737,1821,916,1067,166500,21875
0,0,0,-,-,21890
6011,4301,1710,1139,252900,21901
21,0,21,-,-,21902
2297,1473,824,1027,225900,21903
2414,2074,340,977,245700,21904
3928,3024,904,1136,238200,21911
423,280,143,845,395500,21912
386,202,184,742,173800,21913
357,203,154,1164,235100,21914
1175,857,318,1100,282300,21915
0,0,0,-,-,21916
768,651,117,1107,236000,21917
1319,1239,80,813,247900,21918
1184,1110,74,1000,345800,21919
104,79,25,-,-,21920
16607,11556,5051,1160,234300,21921
64,16,48,-,-,21930
18917,12996,5921,1699,550000,22003
14614,12076,2538,2155,505400,22015
6407,5406,1001,2167,397500,22025
4999,3256,1743,1616,299300,22026
597,515,82,3115,924600,22027
19480,11833,7647,1946,596100,22030
13029,6154,6875,1976,568200,22031
9905,8413,1492,2288,594900,22032
15075,9394,5681,1929,494600,22033
0,0,0,-,-,22035
5880,5590,290,"3,500+",818900,22039
10929,4811,6118,1623,392400,22041
12858,7640,5218,1833,524800,22042
8894,5311,3583,1877,654700,22043
5352,2607,2745,1502,572600,22044
6807,4738,2069,1926,758300,22046
2570,277,2293,2702,592100,22060
5786,5547,239,3102,1084200,22066
11620,8396,3224,1975,482700,22079
10441,8786,1655,3085,995800,22101
11184,5405,5779,1993,922100,22102
6652,5693,959,2044,761100,22124
421,298,123,1634,400000,22125
1294,61,1233,1771,208800,22134
9115,5407,3708,2122,471500,22150
5537,4662,875,2150,484200,22151
10404,8443,1961,2231,468800,22152
10176,8980,1196,2182,533900,22153
3268,1656,1612,1172,434400,22172
8257,6189,2068,1992,713200,22180
5275,4508,767,1913,781700,22181
8914,6924,1990,2306,871200,22182
0,0,0,-,-,22185
22838,14014,8824,1704,317700,22191
19676,14665,5011,1788,350700,22192
23489,18563,4926,1670,332500,22193
19814,6101,13713,2170,717900,22201
14074,3262,10812,2171,669400,22202
12259,4039,8220,2067,631500,22203
22739,9017,13722,1641,492700,22204
6707,5304,1403,1772,858800,22205
10312,4710,5602,1945,437200,22206
11913,9705,2208,1988,947500,22207
7971,2730,5241,1987,666300,22209
45,0,45,3053,-,22211
1389,1004,385,2429,820800,22213
0,0,0,-,-,22214
5713,3753,1960,2060,809400,22301
8013,4337,3676,1767,472300,22302
6924,3016,3908,1747,406100,22303
21440,8671,12769,1671,356100,22304
7193,2665,4528,1727,630700,22305
11816,5678,6138,1541,447800,22306
4401,3502,899,1668,552700,22307
4612,4219,393,3068,673900,22308
11655,7684,3971,1606,431200,22309
11416,8824,2592,1964,464800,22310
7839,1405,6434,1596,526700,22311
11402,5871,5531,1764,460600,22312
18104,8840,9264,2034,679300,22314
10726,7999,2727,2157,477800,22315
10762,3817,6945,1258,367200,22401
10534,8437,2097,1291,310500,22405
9196,6743,2453,1376,365700,22406
19800,14971,4829,1477,280000,22407
10310,7596,2714,1512,282600,22408
1321,888,433,973,194900,22427
106,106,0,-,275000,22432
131,99,32,-,-,22433
1025,884,141,1095,172300,22435
272,219,53,795,177400,22436
294,188,106,-,250000,22437
171,150,21,-,89000,22438
3863,2777,1086,1039,221500,22443
166,0,166,1747,-,22448
643,480,163,772,194900,22454
577,438,139,1140,147200,22460
822,655,167,813,173800,22469
2287,1976,311,825,253200,22473
119,104,15,-,150700,22476
346,198,148,766,293600,22480
1433,999,434,792,249000,22482
9048,7259,1789,1163,307600,22485
406,350,56,-,235700,22488
1646,1383,263,432,277300,22503
126,115,11,-,237500,22504
5413,5149,264,1405,262100,22508
33,33,0,-,-,22509
487,454,33,1125,322700,22511
892,690,202,962,196000,22514
2508,1916,592,1004,184500,22520
89,61,28,-,-,22529
91,80,11,-,-,22530
1025,910,115,1475,241200,22534
214,158,56,1094,184800,22535
62,62,0,-,220000,22538
1040,1005,35,-,364700,22539
747,713,34,-,205700,22542
6152,5095,1057,1274,211100,22546
103,63,40,-,-,22548
6475,5659,816,1192,289200,22551
5018,3914,1104,1552,315100,22553
18148,13826,4322,1685,357300,22554
9197,7421,1776,1571,342500,22556
2838,1734,1104,892,216200,22560
1252,1038,214,1108,224900,22567
2528,1586,942,791,185000,22572
968,777,191,788,185900,22576
1272,1014,258,919,302700,22578
29,29,0,-,-,22579
1952,1469,483,1042,204300,22580
10955,4987,5968,1062,238300,22601
10811,8313,2498,1130,265100,22602
5765,4220,1545,1097,237700,22603
741,689,52,-,300300,22610
3321,2435,886,1126,353300,22611
1031,781,250,977,352100,22620
299,225,74,1122,186800,22623
1053,814,239,1130,246000,22624
1332,1169,163,1174,237600,22625
294,217,77,1155,721600,22627
11980,8801,3179,1001,245600,22630
866,777,89,474,254500,22637
251,183,68,1402,650300,22639
199,117,82,985,450000,22640
156,146,10,-,224400,22641
1844,1662,182,1250,235800,22642
106,106,0,-,306300,22643
961,780,181,938,224900,22644
1607,1277,330,806,263500,22645
36,36,0,-,-,22646
279,251,28,-,211500,22650
635,553,82,780,281900,22652
394,360,34,-,232000,22654
7805,5895,1910,1159,250100,22655
1247,1131,116,1220,246000,22656
4296,3053,1243,970,215300,22657
724,478,246,792,182500,22660
530,416,114,1610,257500,22663
3726,2336,1390,981,224400,22664
12133,8103,4030,1139,278400,22701
467,336,131,-,232800,22709
12,12,0,-,-,22711
3023,2247,776,1179,283900,22712
568,470,98,1597,308000,22713
319,292,27,1363,341600,22714
419,317,102,-,278700,22715
265,224,41,-,428100,22716
157,137,20,-,281000,22718
78,64,14,-,237500,22719
336,321,15,-,445900,22720
119,119,0,-,-,22722
71,71,0,-,277600,22723
733,669,64,-,417500,22724
306,207,99,961,263300,22726
2414,1766,648,639,255600,22727
1034,818,216,1156,368900,22728
103,72,31,-,285000,22729
75,21,54,-,-,22730
11,11,0,-,-,22731
73,73,0,-,291500,22732
341,263,78,441,354200,22733
1153,813,340,1125,271900,22734
809,676,133,1145,304700,22735
284,284,0,-,244800,22736
1031,808,223,1378,261300,22737
470,335,135,882,281100,22738
427,264,163,994,315400,22740
51,35,16,-,277100,22741
624,544,80,1643,317700,22742
70,59,11,-,-,22743
564,432,132,882,395800,22747
93,53,40,1250,684500,22749
13738,6424,7314,973,265900,22801
10800,5570,5230,837,188600,22802
0,0,0,-,-,22807
280,236,44,-,214800,22810
279,218,61,-,170900,22811
3308,2328,980,887,223500,22812
3613,2604,1009,802,188200,22815
117,86,31,-,120000,22820
2003,1630,373,783,218900,22821
2504,1914,590,875,196200,22824
4157,3185,972,834,172300,22827
683,538,145,879,145600,22830
384,313,71,818,157400,22831
449,368,81,1332,225800,22832
367,348,19,-,258600,22834
4476,3081,1395,783,184300,22835
1854,1450,404,1245,263800,22840
1079,877,202,950,231100,22841
2082,1532,550,867,174400,22842
971,808,163,977,190800,22843
2015,1277,738,757,231100,22844
9,9,0,-,-,22845
774,655,119,-,322900,22846
362,281,81,829,235400,22847
2054,1606,448,862,151300,22849
355,301,54,1150,191300,22850
2415,1625,790,747,161200,22851
1667,1115,552,818,156300,22853
15203,8380,6823,1241,353300,22901
10650,5210,5440,1161,290500,22902
14611,6122,8489,1228,382800,22903
24,0,24,-,-,22904
7291,4665,2626,1338,305700,22911
1674,1308,366,1139,288800,22920
794,675,119,907,158500,22922
2367,1653,714,1379,299500,22923
135,83,52,1087,327400,22931
3228,2431,797,1345,373000,22932
400,330,70,-,230300,22935
1898,1782,116,1306,379200,22936
786,660,126,967,186100,22937
555,453,102,1074,241100,22938
2329,1740,589,1316,276400,22939
515,433,82,1893,403400,22940
3912,3096,816,872,231100,22942
167,106,61,-,296900,22943
44,44,0,-,-,22946
1790,1463,327,1012,532500,22947
84,84,0,-,-,22948
547,269,278,670,192500,22949
700,561,139,1121,182700,22952
1050,948,102,604,380800,22958
628,521,107,728,330000,22959
3626,2121,1505,921,216700,22960
6492,5654,838,1266,237700,22963
99,85,14,-,352500,22964
822,564,258,729,257100,22967
3976,3276,700,1011,233900,22968
597,445,152,880,197400,22969
710,515,195,676,139800,22971
108,68,40,-,-,22972
2349,1787,562,935,216400,22973
1469,1284,185,1292,280700,22974
163,110,53,-,235700,22976
13419,8867,4552,826,191900,22980
17,0,17,-,-,22989
4035,3411,624,846,196200,23002
353,266,87,819,84300,23004
6378,4436,1942,1050,279200,23005
2362,2141,221,1348,208100,23009
394,361,33,-,241900,23011
1396,1273,123,1011,289500,23015
131,131,0,-,-,23021
414,358,56,-,141000,23022
239,223,16,-,251500,23023
3364,2970,394,1074,247500,23024
86,64,22,-,-,23025
560,439,121,1098,191400,23027
2021,1651,370,772,166500,23030
179,115,64,-,206900,23032
564,518,46,1091,272700,23035
545,409,136,1208,193000,23038
420,407,13,-,341900,23039
1808,1464,344,845,130900,23040
880,697,183,1037,333100,23043
70,70,0,-,-,23045
737,654,83,1334,369200,23047
300,300,0,-,284300,23050
280,217,63,-,139900,23055
192,177,15,-,-,23056
13053,9777,3276,1516,427000,23059
13720,10425,3295,1230,292900,23060
8223,6768,1455,1093,230700,23061
1098,717,381,1012,238500,23062
1632,1350,282,1032,193700,23063
125,125,0,-,-,23064
656,571,85,1253,227500,23065
85,85,0,-,318800,23066
101,101,0,-,-,23068
1087,985,102,1321,238800,23069
168,152,16,-,358300,23070
692,614,78,873,265300,23071
4816,3728,1088,1094,231000,23072
3646,2025,1621,1110,136400,23075
357,264,93,-,292700,23076
151,112,39,-,234800,23079
823,649,174,725,211600,23083
703,596,107,1167,255000,23084
183,165,18,-,211400,23085
1256,1087,169,924,195900,23086
2168,1791,377,1090,297900,23089
121,69,52,-,222100,23091
276,232,44,844,240900,23092
5256,3814,1442,892,200100,23093
1187,1021,166,1230,312400,23102
2181,1945,236,889,488900,23103
413,380,33,-,182100,23106
46,41,5,-,158900,23108
943,688,255,794,253800,23109
189,140,49,-,171900,23110
14365,11456,2909,1188,243800,23111
19536,15355,4181,1345,263700,23112
9591,7922,1669,1357,449500,23113
7197,5903,1294,1531,309300,23114
21,21,0,-,-,23115
10640,9449,1191,1294,313500,23116
3661,3009,652,978,265000,23117
151,151,0,-,-,23119
3364,3200,164,1653,414200,23120
813,584,229,556,133100,23123
1715,1475,240,899,277100,23124
134,134,0,-,176700,23125
170,160,10,-,198600,23126
350,212,138,1127,146400,23128
243,234,9,-,467000,23129
118,95,23,-,-,23130
353,287,66,1542,253800,23138
9433,8397,1036,975,270300,23139
2247,2016,231,1188,250300,23140
2683,2384,299,1072,263800,23141
1206,1048,158,1222,366500,23146
731,637,94,1007,179600,23148
1175,746,429,942,220200,23149
5112,3711,1401,1025,176400,23150
511,458,53,775,327200,23153
646,562,84,-,143000,23156
0,0,0,-,-,23160
64,32,32,-,269400,23161
19,7,12,-,-,23163
2623,2115,508,1190,282200,23168
429,361,68,773,186100,23169
0,0,0,-,-,23173
854,589,265,409,264800,23175
183,183,0,-,256300,23176
271,205,66,-,203000,23177
228,174,54,1231,163200,23180
1969,1583,386,786,232100,23181
17684,12704,4980,1249,331800,23185
0,0,0,-,-,23187
17530,12735,4795,1334,331300,23188
2670,2428,242,958,296800,23192
2880,207,2673,1048,195600,23219
13062,4408,8654,1092,297900,23220
7203,3804,3399,1221,401100,23221
10163,5279,4884,985,147700,23222
21385,9067,12318,967,158100,23223
13934,4694,9240,971,127300,23224
18200,8239,9961,1013,210100,23225
7075,5413,1662,1459,360700,23226
11777,6221,5556,954,237500,23227
14864,7163,7701,1135,183600,23228
12972,9035,3937,1144,332400,23229
3235,1481,1754,1160,207100,23230
13928,9392,4536,1033,189900,23231
12633,8025,4608,1404,349500,23233
15672,8698,6974,1093,168900,23234
13157,9400,3757,1375,238600,23235
9497,8286,1211,1359,225000,23236
8620,5792,2828,1135,167400,23237
10845,6892,3953,1165,308200,23238
0,0,0,-,-,23250
7695,2733,4962,1195,217500,23294
530,255,275,677,164400,23301
81,42,39,-,-,23302
284,234,50,-,135100,23303
18,18,0,-,-,23304
358,269,89,913,214100,23306
259,96,163,708,-,23307
853,560,293,918,146600,23308
1880,1218,662,872,212400,23310
98,47,51,-,156500,23313
3529,2468,1061,1266,304200,23314
537,487,50,856,201400,23315
200,118,82,888,138200,23316
23020,14062,8958,1370,256600,23320
12834,9694,3140,1239,265200,23321
20563,17729,2834,1595,352400,23322
13682,10571,3111,1290,254800,23323
8368,4264,4104,988,172800,23324
6397,4235,2162,1193,218800,23325
1539,1134,405,940,279700,23336
284,128,156,-,219800,23337
315,180,135,602,231700,23347
1511,962,549,588,139400,23350
90,90,0,-,450000,23354
488,426,62,1100,175400,23356
330,251,79,-,224000,23357
50,21,29,-,-,23358
286,226,60,763,165600,23359
57,57,0,-,-,23389
182,182,0,-,114500,23395
25,16,9,-,-,23398
67,42,25,830,114300,23401
445,431,14,-,258100,23405
235,135,100,-,77100,23407
49,22,27,-,-,23408
56,56,0,-,227500,23409
586,448,138,847,151200,23410
253,153,100,743,75000,23413
95,34,61,-,-,23414
632,369,263,1020,116600,23415
126,81,45,-,-,23416
1749,1351,398,854,234700,23417
388,257,131,830,192100,23418
1061,531,530,684,120800,23420
1602,755,847,807,151400,23421
53,22,31,-,-,23422
186,155,31,874,219600,23423
46,32,14,-,207900,23426
111,91,20,831,123400,23427
6995,5457,1538,1000,280700,23430
610,595,15,-,330500,23432
538,487,51,843,358800,23433
18518,11828,6690,1062,228000,23434
11383,7925,3458,1471,286200,23435
373,354,19,-,289200,23436
1690,1487,203,762,222400,23437
662,542,120,-,247600,23438
214,196,18,-,95000,23440
50,19,31,-,-,23441
463,307,156,837,121000,23442
20217,10164,10053,1343,446600,23451
22481,14031,8450,1278,250600,23452
12201,8490,3711,1335,237600,23453
22775,14729,8046,1338,306500,23454
19913,11698,8215,1420,299900,23455
17870,15336,2534,1767,349900,23456
1596,1317,279,1210,381400,23457
291,0,291,1754,-,23459
0,0,0,-,-,23460
0,0,0,-,-,23461
25916,13789,12127,1359,212900,23462
27523,19246,8277,1379,263800,23464
211,188,23,950,-,23480
23,23,0,-,-,23486
2203,1679,524,861,188400,23487
185,123,62,-,220200,23488
8125,4521,3604,1184,193200,23502
13622,5768,7854,1067,198300,23503
7757,2425,5332,788,181800,23504
11645,3969,7676,1012,238500,23505
3330,1421,1909,1256,381500,23507
6189,2791,3398,1166,315000,23508
5177,3015,2162,1139,189400,23509
4074,962,3112,1296,303200,23510
143,0,143,1800,-,23511
11316,5432,5884,1060,164100,23513
2375,588,1787,1076,249400,23517
11996,6503,5493,1057,221100,23518
2604,944,1660,829,166800,23523
0,0,0,-,-,23551
10682,5511,5171,980,193900,23601
16309,9005,7304,1109,211500,23602
1275,556,719,1239,174400,23603
834,20,814,1584,-,23604
6076,2671,3405,988,140300,23605
11356,5087,6269,1096,244800,23606
8735,3032,5703,881,116800,23607
15945,8702,7243,1103,193300,23608
219,0,219,2393,-,23651
5284,3539,1745,1054,160900,23661
4581,3728,853,1222,322600,23662
5090,2797,2293,1128,155700,23663
4018,2780,1238,1161,203100,23664
1407,38,1369,1725,132400,23665
21919,11051,10868,1170,193800,23666
15816,9428,6388,996,194700,23669
1361,803,558,1019,265500,23690
35,6,29,2017,-,23691
7469,6034,1435,1434,325400,23692
8861,6232,2629,1425,357700,23693
1389,1142,247,1687,375100,23696
9095,6127,2968,1130,162900,23701
4253,1824,2429,976,139900,23702
9665,6538,3127,1159,218100,23703
7457,2758,4699,937,141900,23704
5894,2752,3142,945,165700,23707
6,0,6,-,-,23708
0,0,0,-,-,23709
1339,19,1320,1697,225000,23801
15123,7839,7284,952,143800,23803
7502,4207,3295,990,160500,23805
0,0,0,-,-,23806
721,593,128,644,112100,23821
2461,1468,993,763,152900,23824
536,402,134,779,130400,23827
127,103,24,775,146900,23828
392,336,56,499,171300,23829
592,535,57,536,210900,23830
13528,9596,3932,1297,232000,23831
12411,10470,1941,1432,226300,23832
877,741,136,941,185500,23833
10251,6890,3361,1057,174300,23834
4963,3622,1341,1293,237300,23836
1776,1341,435,743,183100,23837
5932,5638,294,1584,339600,23838
327,250,77,1018,154800,23839
845,772,73,1144,154600,23840
1347,1059,288,1024,197200,23841
2397,2113,284,842,215700,23842
206,125,81,511,99000,23843
240,107,133,-,86400,23844
270,208,62,-,224600,23845
352,273,79,688,160700,23846
5148,3026,2122,740,120800,23847
418,396,22,-,151000,23850
5597,3300,2297,864,177400,23851
433,265,168,767,102400,23856
344,180,164,576,196700,23857
10792,5612,5180,889,140400,23860
823,589,234,819,198700,23866
966,689,277,787,120200,23867
1907,1226,681,549,111900,23868
1084,803,281,928,148600,23872
436,329,107,969,162100,23874
4369,2817,1552,1141,206000,23875
140,124,16,-,89400,23876
485,361,124,-,208000,23878
219,143,76,-,85700,23879
845,599,246,-,225300,23881
854,657,197,921,113900,23882
838,660,178,1021,229900,23883
0,0,0,-,-,23884
880,754,126,966,199100,23885
115,34,81,-,-,23887
1002,666,336,929,117700,23888
330,248,82,880,84000,23889
1600,1072,528,880,144300,23890
0,0,0,-,-,23891
169,169,0,-,133800,23893
196,158,38,-,142000,23894
290,206,84,-,84000,23897
828,738,90,1051,226500,23898
154,127,27,1018,158600,23899
5899,3476,2423,820,170500,23901
0,0,0,-,-,23909
254,226,28,-,141700,23915
1043,839,204,485,158000,23917
1032,834,198,839,223900,23919
1271,1041,230,818,131200,23920
629,491,138,736,124800,23921
970,617,353,774,162100,23922
1217,1072,145,576,150700,23923
2254,1705,549,621,105100,23924
1752,1372,380,688,188600,23927
2199,1574,625,807,139100,23930
169,80,89,-,123600,23934
2267,1731,536,807,137600,23936
620,369,251,631,96300,23937
118,104,14,-,97000,23938
577,472,105,643,122800,23942
13,13,0,-,-,23943
1302,877,425,749,133600,23944
1420,908,512,545,125800,23947
1394,943,451,745,116300,23950
109,102,7,-,153800,23952
608,500,108,849,96400,23954
1070,744,326,817,149600,23958
490,387,103,684,107400,23959
637,488,149,685,119800,23960
294,255,39,-,119100,23962
64,64,0,-,-,23963
560,426,134,646,86300,23964
785,537,248,774,187900,23966
453,382,71,604,82200,23967
240,181,59,921,107300,23968
3305,1848,1457,721,144400,23970
1612,1049,563,619,118800,23974
34,18,16,-,-,23976
391,23,368,962,932700,24011
11996,6868,5128,814,134300,24012
2992,1344,1648,832,86500,24013
7428,4932,2496,821,178400,24014
6569,3561,3008,791,178000,24015
4167,1047,3120,769,121100,24016
9304,4935,4369,812,110300,24017
16287,11311,4976,984,229600,24018
11257,8885,2372,990,184300,24019
32,0,32,-,-,24020
1234,1021,213,733,124700,24053
2517,2094,423,588,96800,24054
5070,3816,1254,536,88900,24055
90,74,16,-,132700,24058
393,381,12,-,226600,24059
18275,7817,10458,1077,305300,24060
1873,1673,200,767,186700,24064
2755,2412,343,716,196800,24065
2187,1693,494,738,158400,24066
934,768,166,755,162300,24067
806,701,105,719,107800,24069
689,625,64,823,223700,24070
413,343,70,573,166800,24072
12767,8320,4447,876,192500,24073
533,409,124,640,163500,24076
354,252,102,909,204900,24077
3072,1683,1389,654,104300,24078
797,612,185,614,110800,24079
235,190,45,767,112500,24082
1246,938,308,1087,296300,24083
4524,3327,1197,702,150700,24084
998,889,109,545,152800,24085
88,50,38,-,-,24086
1314,1057,257,727,133300,24087
1719,1440,279,700,117700,24088
1120,852,268,650,80900,24089
1869,1619,250,1023,259100,24090
3339,2573,766,753,199000,24091
1157,957,200,725,137000,24092
42,29,13,558,126800,24093
1851,1542,309,1015,189400,24095
2572,2301,271,718,209000,24101
593,525,68,602,156000,24102
1509,1349,160,649,272700,24104
214,201,13,-,139800,24105
12651,8311,4340,649,97000,24112
657,581,76,523,126300,24120
4603,4091,512,925,266200,24121
671,639,32,-,137800,24122
1802,1318,484,716,98900,24124
1806,1326,480,547,153300,24127
889,780,109,828,183000,24128
8,8,0,-,-,24130
7,0,7,-,-,24131
151,42,109,-,-,24132
1026,858,168,480,104000,24133
2092,1608,484,684,126300,24134
1408,1077,331,756,125600,24136
1181,1006,175,736,256500,24137
649,558,91,963,175000,24138
199,199,0,-,159700,24139
9057,5372,3685,702,177100,24141
0,0,0,-,-,24142
512,302,210,584,118100,24147
3402,2663,739,632,111000,24148
1328,1210,118,1196,186400,24149
377,298,79,667,122100,24150
8299,5987,2312,764,147400,24151
14590,10427,4163,927,190500,24153
192,122,70,783,114800,24161
1046,638,408,671,160600,24162
557,336,221,561,114800,24165
102,64,38,-,99000,24167
146,98,48,-,85900,24168
3573,2708,865,564,117900,24171
1187,1071,116,530,93300,24174
3220,2879,341,767,247300,24175
587,547,40,1139,499300,24176
7746,5508,2238,766,170200,24179
1834,1683,151,711,243700,24184
218,205,13,-,147700,24185
7044,4212,2832,682,108100,24201
4910,4001,909,755,147400,24202
7113,4652,2461,720,150500,24210
4292,3645,647,738,211200,24211
1109,732,377,384,50500,24216
136,89,47,-,63900,24217
4115,2813,1302,663,117300,24219
329,329,0,-,84900,24220
239,224,15,-,121300,24221
2428,1880,548,589,87700,24224
681,575,106,523,80900,24225
590,462,128,599,90900,24226
2495,1906,589,640,87900,24228
3176,2034,1142,633,77100,24230
1239,838,401,573,113500,24236
388,329,59,1028,81900,24237
93,88,5,-,82700,24239
703,565,138,761,104100,24243
2034,1515,519,433,86600,24244
349,219,130,474,62700,24245
242,51,191,519,-,24246
1054,858,196,449,94000,24248
588,505,83,-,89600,24250
3332,2595,737,556,93900,24251
1392,922,470,400,59600,24256
703,546,157,485,115100,24258
2230,1610,620,554,84200,24260
2443,1591,852,537,89100,24263
284,218,66,531,33000,24265
3602,2611,991,614,119500,24266
111,78,33,622,129700,24269
297,199,98,-,-,24270
1006,832,174,640,106300,24271
272,190,82,-,83500,24272
2494,1466,1028,596,73900,24273
2360,1394,966,552,80500,24277
1824,1392,432,689,76500,24279
314,274,40,-,156500,24280
973,735,238,620,89500,24281
307,244,63,-,-,24282
987,714,273,444,87500,24283
768,483,285,603,108700,24290
201,180,21,-,78500,24292
3844,2641,1203,700,108200,24293
6025,4002,2023,756,116800,24301
762,534,228,703,73700,24311
761,639,122,689,97800,24312
311,273,38,-,68800,24313
623,492,131,375,85500,24314
1147,903,244,649,125700,24315
0,0,0,-,-,24316
1612,1417,195,556,99500,24317
261,242,19,-,75700,24318
2855,2025,830,625,121100,24319
49,26,23,-,-,24322
331,229,102,-,156300,24323
739,654,85,776,167800,24324
434,337,97,-,116800,24325
500,473,27,-,115300,24326
854,803,51,-,130100,24328
1220,967,253,576,89800,24330
7195,5587,1608,615,101200,24333
2235,1771,464,723,150500,24340
3787,2730,1057,537,126900,24343
714,487,227,659,187700,24347
1775,1233,542,472,108200,24348
466,401,65,-,68300,24350
255,184,71,-,68800,24351
414,322,92,-,120700,24352
5838,3895,1943,618,97300,24354
2276,2053,223,700,107000,24360
1969,1564,405,736,124300,24361
596,503,93,193,116000,24363
219,197,22,-,157500,24366
2130,1689,441,687,132400,24368
2713,2119,594,526,73100,24370
345,271,74,823,82300,24374
721,579,142,494,90300,24375
157,148,9,-,133100,24377
511,467,44,783,109900,24378
1076,934,142,712,160200,24380
1584,1122,462,563,116700,24381
6043,4286,1757,655,150400,24382
15470,9712,5758,831,189700,24401
27,27,0,-,-,24411
13,13,0,-,-,24412
103,98,5,-,152800,24413
0,0,0,-,-,24415
3435,2539,896,793,129500,24416
1724,1624,100,982,202400,24421
2592,1730,862,596,99500,24422
5766,4538,1228,632,105900,24426
584,357,227,530,137200,24430
1039,882,157,717,95900,24431
126,69,57,-,232700,24432
27,25,2,-,116100,24433
841,731,110,699,225300,24435
335,259,76,-,251900,24437
560,377,183,633,160400,24439
1097,858,239,1273,164000,24440
2677,2107,570,838,177800,24441
54,44,10,-,-,24442
1165,794,371,529,154800,24445
109,92,17,838,68600,24448
6187,3998,2189,854,259100,24450
128,72,56,-,48300,24457
247,192,55,645,154100,24458
281,222,59,-,222700,24459
476,403,73,-,205600,24460
79,38,41,-,-,24464
605,493,112,582,200800,24465
852,785,67,528,241200,24467
743,602,141,818,172200,24471
800,489,311,687,247800,24472
370,294,76,-,347800,24473
246,232,14,-,76300,24474
110,96,14,-,211300,24476
4454,3318,1136,1009,203300,24477
681,605,76,913,277400,24479
1931,1518,413,849,179600,24482
271,223,48,841,173200,24483
250,250,0,-,109800,24484
161,161,0,-,173100,24485
1232,958,274,1050,254600,24486
158,158,0,-,307100,24487
10186,4648,5538,764,117900,24501
16393,8863,7530,939,166100,24502
7708,5528,2180,852,233400,24503
3863,2003,1860,844,153500,24504
2096,1496,600,637,121400,24517
1085,895,190,587,88000,24520
3971,3244,727,741,175900,24521
3832,2952,880,687,153800,24522
7993,5867,2126,788,170100,24523
566,526,40,-,152100,24526
1213,998,215,730,135400,24527
1308,828,480,725,103300,24528
766,559,207,833,147900,24529
426,277,149,586,102400,24530
3410,2657,753,758,134100,24531
515,418,97,730,112500,24534
88,88,0,-,209300,24536
2139,1852,287,639,151800,24538
61,43,18,-,-,24539
13766,8005,5761,716,107600,24540
12129,6822,5307,676,108600,24541
1556,1155,401,740,133000,24549
3000,2401,599,780,144600,24550
9514,7507,2007,949,256400,24551
652,468,184,740,114500,24553
1618,1302,316,740,114300,24554
866,583,283,686,130000,24555
1231,1102,129,749,254700,24556
3526,2704,822,601,106200,24557
2645,1987,658,654,124800,24558
185,158,27,-,163300,24562
2447,1684,763,640,110400,24563
402,312,90,532,92600,24565
574,475,99,1344,84000,24566
370,327,43,-,102300,24569
0,0,0,-,-,24570
942,813,129,667,141600,24571
6512,4848,1664,705,143500,24572
1434,1197,237,809,162200,24574
2032,1550,482,661,90400,24577
419,336,83,661,178800,24578
463,410,53,1276,125600,24579
236,208,28,-,100900,24580
27,27,0,-,-,24581
2288,1753,535,909,115400,24586
3900,3026,874,666,147700,24588
1074,907,167,431,123400,24589
3104,2151,953,1050,179500,24590
5244,3444,1800,689,127800,24592
715,552,163,812,161800,24593
672,439,233,757,125700,24594
58,32,26,-,-,24595
501,435,66,890,135200,24597
647,521,126,617,121700,24598
377,304,73,-,115700,24599
0,0,0,-,-,24601
306,269,37,-,85900,24602
375,359,16,-,56300,24603
114,101,13,-,40300,24604
3285,2584,701,676,107300,24605
80,72,8,-,54500,24606
112,102,10,-,125000,24607
2981,2216,765,657,113400,24609
77,31,46,544,-,24612
268,228,40,-,85000,24613
2874,2161,713,648,85100,24614
1110,983,127,589,45100,24620
367,276,91,570,71700,24622
96,61,35,478,62300,24628
2683,2029,654,633,104500,24630
798,524,274,656,69000,24631
215,181,34,-,87700,24634
237,160,77,368,46300,24635
1473,1159,314,777,117800,24637
1259,941,318,697,69800,24639
2338,1484,854,666,85400,24641
273,219,54,-,61800,24646
1072,781,291,623,76600,24649
2117,1581,536,585,118900,24651
1159,933,226,709,77700,24656
171,110,61,594,76500,24657
8523,5637,2886,679,83100,24701
628,459,169,682,109200,24712
100,100,0,-,68800,24714
176,161,15,539,55000,24715
168,168,0,-,17600,24716
15,15,0,-,-,24719
31,29,2,-,109200,24724
278,172,106,-,34700,24726
104,65,39,-,32800,24729
80,69,11,-,58400,24731
280,223,57,-,108300,24733
274,232,42,635,52900,24736
53,14,39,-,-,24737
113,86,27,-,133800,24738
12963,8991,3972,683,112900,24740
1030,709,321,480,67800,24747
1273,991,282,588,54300,24801
219,197,22,494,23700,24808
291,247,44,-,23500,24811
64,28,36,-,-,24813
322,228,94,582,53200,24815
65,65,0,-,-,24816
340,283,57,675,38000,24817
453,400,53,-,71900,24818
315,209,106,-,92800,24822
202,166,36,-,-,24823
41,41,0,-,-,24826
497,456,41,923,72700,24827
326,285,41,437,20900,24828
74,46,28,-,28800,24830
80,74,6,-,53300,24831
224,224,0,-,75300,24834
254,237,17,-,53400,24836
675,588,87,783,52000,24839
49,35,14,-,-,24843
591,475,116,401,50500,24844
134,118,16,-,84000,24845
15,15,0,-,-,24846
115,115,0,-,-,24847
78,62,16,-,27700,24848
92,92,0,-,162500,24849
290,209,81,-,51300,24850
261,233,28,-,69100,24851
171,126,45,-,-,24853
87,53,34,-,-,24854
298,237,61,689,70800,24857
113,113,0,-,95200,24860
50,10,40,-,-,24861
307,252,55,-,-,24862
115,109,6,-,-,24866
166,113,53,-,46900,24867
481,353,128,545,29700,24868
184,130,54,-,-,24869
1166,959,207,817,61700,24870
67,49,18,-,36400,24871
351,273,78,-,-,24872
226,159,67,-,57500,24873
1259,1011,248,640,97900,24874
220,154,66,488,-,24878
250,216,34,-,-,24879
145,91,54,-,135700,24880
162,141,21,-,44800,24881
128,128,0,-,53300,24882
112,95,17,-,22500,24884
10,10,0,-,-,24887
27,27,0,-,46300,24888
628,435,193,618,37400,24892
60,60,0,-,52700,24894
27,27,0,-,-,24898
4487,2807,1680,732,188400,24901
1986,1468,518,657,89500,24910
276,241,35,608,126400,24915
238,223,15,-,144300,24916
793,626,167,667,103200,24918
130,114,16,-,81700,24920
180,163,17,-,132700,24924
269,197,72,842,182500,24925
104,81,23,-,87600,24927
577,504,73,-,119100,24931
176,151,25,-,169900,24934
223,223,0,-,100400,24935
619,520,99,-,157600,24938
348,257,91,773,63500,24941
189,143,46,484,157200,24944
184,184,0,-,-,24945
473,376,97,547,115100,24946
613,488,125,571,116500,24951
1613,1312,301,654,117500,24954
73,73,0,-,231500,24957
40,40,0,-,-,24962
1660,1268,392,630,113800,24963
612,527,85,340,118600,24966
1969,1475,494,755,107200,24970
159,139,20,-,86600,24974
547,454,93,575,143200,24976
212,146,66,-,185200,24977
161,128,33,-,86900,24981
1040,858,182,463,111100,24983
120,106,14,-,322000,24984
2214,1545,669,670,111700,24986
275,249,26,-,150600,24991
0,0,0,-,-,25002
1168,967,201,633,116100,25003
76,76,0,-,-,25005
181,170,11,-,58400,25007
81,59,22,-,73600,25008
407,358,49,702,52700,25009
254,172,82,634,78800,25011
1586,1284,302,640,95500,25015
207,154,53,-,55200,25019
108,45,63,657,-,25021
158,140,18,-,-,25022
237,121,116,557,85700,25024
53,53,0,-,-,25025
160,139,21,-,47700,25028
136,136,0,-,55300,25030
314,178,136,749,84000,25031
755,633,122,449,78300,25033
369,273,96,648,47200,25035
80,33,47,-,-,25036
360,310,50,738,54600,25039
252,230,22,-,83800,25040
552,424,128,579,102200,25043
102,77,25,-,-,25044
1928,1527,401,695,103300,25045
86,68,18,-,52000,25047
32,32,0,-,-,25048
146,109,37,-,-,25049
95,95,0,-,72600,25051
1719,1225,494,698,82100,25053
131,107,24,-,-,25054
113,113,0,-,47400,25057
190,178,12,-,58100,25059
167,102,65,-,33100,25060
276,244,32,-,74500,25061
85,85,0,-,45900,25062
802,707,95,-,83200,25063
4300,2364,1936,837,97000,25064
441,391,50,717,86200,25067
663,507,156,824,144200,25070
4867,3780,1087,809,127500,25071
308,198,110,-,53500,25075
114,74,40,-,-,25076
397,385,12,-,103100,25081
745,630,115,672,229800,25082
225,197,28,-,86000,25083
430,228,202,665,65300,25085
276,254,22,742,85200,25086
110,102,8,-,-,25088
58,58,0,-,70900,25090
109,76,33,-,36700,25093
62,46,16,-,44000,25102
107,72,35,-,54700,25103
277,174,103,-,64200,25106
285,238,47,-,51300,25107
147,99,48,-,64600,25108
246,229,17,-,133400,25109
181,133,48,835,58600,25110
257,200,57,-,65800,25111
0,0,0,-,-,25112
265,224,41,-,128900,25113
136,58,78,824,77200,25114
52,52,0,-,48200,25115
331,313,18,-,79800,25118
62,52,10,-,56400,25119
273,127,146,-,-,25121
1388,1161,227,715,97300,25123
516,431,85,-,73700,25124
375,302,73,-,68600,25125
36,36,0,-,-,25126
1316,986,330,733,108900,25130
29,29,0,-,-,25132
394,261,133,409,78000,25133
173,173,0,-,47800,25134
721,306,415,474,75900,25136
133,113,20,-,140300,25139
497,440,57,-,28900,25140
64,53,11,-,155200,25141
214,176,38,-,63800,25142
3408,2391,1017,697,100100,25143
170,148,22,-,52300,25148
92,82,10,-,-,25149
139,113,26,-,55000,25152
274,205,69,-,69900,25154
107,94,13,-,-,25156
2012,1704,308,1036,113200,25159
63,59,4,-,-,25160
154,132,22,-,52600,25161
142,125,17,742,129600,25162
417,341,76,-,89600,25164
326,295,31,-,128600,25165
1074,947,127,808,130300,25168
207,155,52,-,-,25169
172,93,79,-,48900,25173
208,201,7,-,-,25174
9323,6774,2549,716,106500,25177
38,38,0,-,-,25180
410,357,53,609,51300,25181
17,17,0,-,-,25183
0,0,0,-,-,25185
434,241,193,577,113400,25186
374,355,19,-,-,25187
283,222,61,823,33300,25193
18,0,18,-,-,25201
513,469,44,-,112700,25202
8,8,0,-,-,25203
51,29,22,-,16500,25204
173,160,13,-,72100,25205
154,106,48,-,53500,25206
301,231,70,-,50900,25208
457,383,74,468,56800,25209
40,40,0,-,-,25211
2379,2145,234,844,182100,25213
210,161,49,-,67300,25214
372,289,83,618,88900,25234
460,330,130,666,65200,25235
690,575,115,928,131400,25239
614,549,65,-,137900,25241
223,167,56,-,108600,25243
190,190,0,-,159100,25244
294,266,28,-,-,25245
239,157,82,648,74000,25247
1256,1174,82,-,162700,25248
119,92,27,-,147400,25251
534,506,28,-,138600,25252
989,766,223,461,134400,25253
215,191,24,-,130400,25259
685,558,127,662,73500,25260
68,68,0,-,65000,25261
424,400,24,-,115000,25262
115,86,29,-,163600,25264
721,545,176,625,79200,25265
232,213,19,-,89800,25266
239,205,34,-,50500,25267
354,308,46,-,69500,25268
306,273,33,541,103200,25270
4051,2539,1512,631,126000,25271
715,684,31,-,131800,25275
3160,2285,875,493,85000,25276
153,139,14,-,-,25285
613,518,95,456,129600,25286
242,226,16,-,71600,25287
1561,336,1225,539,141600,25301
6550,3890,2660,740,111300,25302
2970,2005,965,758,140900,25303
3497,2235,1262,760,184800,25304
0,0,0,-,-,25305
3141,1971,1170,946,76500,25306
5609,4234,1375,676,121200,25309
5088,2592,2496,647,98700,25311
6297,4503,1794,816,99600,25312
5036,3825,1211,805,136800,25313
6137,4926,1211,868,197900,25314
1456,1011,445,736,68100,25315
2491,1892,599,689,90300,25320
6165,2957,3208,948,153900,25401
5180,4239,941,1142,249500,25403
8382,5982,2400,1009,168900,25404
4826,3804,1022,880,172900,25405
5258,4270,988,726,195300,25411
3374,2596,778,1103,168700,25413
6951,5307,1644,950,268900,25414
4188,3330,858,961,192000,25419
1562,1236,326,996,198200,25420
749,653,96,857,124000,25422
5019,4216,803,1130,236900,25425
5750,5002,748,975,196400,25427
4855,4028,827,1178,179700,25428
3109,2419,690,961,248600,25430
96,72,24,-,-,25431
64,41,23,-,-,25432
952,736,216,759,127800,25434
100,71,29,-,169900,25437
2428,1443,985,1035,182000,25438
748,609,139,912,242500,25442
2757,2108,649,1052,295400,25443
87,87,0,-,289000,25444
507,414,93,-,340900,25446
489,396,93,-,106400,25501
354,241,113,-,77600,25502
512,365,147,689,105800,25503
5306,3744,1562,784,148800,25504
93,82,11,-,-,25505
2130,1582,548,623,61300,25506
322,233,89,851,119100,25507
4071,3242,829,632,117800,25508
1892,1495,397,896,151500,25510
343,278,65,-,62300,25511
379,324,55,-,104300,25512
1389,1086,303,656,81200,25514
863,695,168,567,83400,25515
618,416,202,532,27900,25517
514,444,70,-,-,25520
363,347,16,-,107000,25521
1118,689,429,541,87700,25523
1024,845,179,661,67800,25524
8394,6620,1774,830,191800,25526
365,255,110,604,72800,25529
2190,1422,768,649,91800,25530
120,79,41,424,-,25534
847,765,82,-,116700,25535
697,559,138,595,117200,25537
128,118,10,-,31900,25540
4182,2923,1259,745,143500,25541
1643,1488,155,847,156900,25545
431,346,85,-,100500,25547
3550,2809,741,567,95700,25550
653,446,207,607,100900,25555
651,466,185,470,43600,25557
584,565,19,-,109700,25559
3056,2399,657,1081,217100,25560
436,390,46,-,151200,25564
273,236,37,-,69200,25565
245,183,62,-,110500,25567
2295,1560,735,592,97500,25570
913,741,172,637,136500,25571
304,255,49,781,112500,25573
2340,1436,904,814,87500,25601
542,433,109,765,88700,25606
439,284,155,-,59500,25607
483,396,87,582,65000,25608
261,178,83,803,50400,25611
311,267,44,-,128300,25617
745,548,197,548,55700,25621
91,91,0,-,102300,25624
428,307,121,619,77100,25625
114,97,17,-,-,25628
239,196,43,-,55200,25630
219,166,53,-,-,25632
169,65,104,596,-,25634
644,430,214,595,112800,25635
420,293,127,614,71800,25637
372,284,88,-,66300,25638
203,171,32,-,87900,25639
113,66,47,-,-,25644
419,331,88,-,77700,25646
303,198,105,576,70700,25647
438,324,114,-,93500,25649
111,111,0,-,80500,25650
350,276,74,-,76500,25651
589,427,162,698,74200,25652
127,88,39,-,84100,25653
59,49,10,-,84400,25654
2481,1586,895,649,84500,25661
223,185,38,-,-,25666
477,408,69,-,32400,25669
2393,1884,509,620,89700,25670
545,424,121,688,68500,25671
170,121,49,-,-,25672
1119,678,441,547,97900,25674
483,406,77,443,76000,25676
743,522,221,255,71700,25678
123,95,28,-,82800,25688
101,101,0,-,73800,25690
435,282,153,606,65800,25692
95,74,21,-,65800,25696
41,41,0,-,-,25699
9407,5008,4399,720,123800,25701
3054,1803,1251,615,76800,25702
2128,465,1663,743,69000,25703
6522,4338,2184,704,99800,25704
9214,6021,3193,790,126700,25705
13785,9468,4317,685,114300,25801
48,48,0,-,-,25810
15,15,0,-,-,25811
639,464,175,644,77100,25812
2713,1965,748,737,119700,25813
264,191,73,-,58700,25817
238,31,207,714,-,25818
186,150,36,-,110400,25820
954,731,223,607,77900,25823
862,840,22,-,128000,25825
79,79,0,-,50800,25826
876,738,138,718,88900,25827
714,595,119,680,93900,25831
1650,1322,328,920,170000,25832
133,55,78,-,-,25836
134,134,0,-,122200,25837
201,87,114,-,-,25839
3111,2629,482,818,104300,25840
180,171,9,-,-,25841
429,347,82,-,146800,25843
600,373,227,673,87700,25844
232,186,46,-,42300,25845
137,117,20,-,-,25846
119,119,0,-,-,25848
109,109,0,-,-,25849
14,0,14,-,-,25853
492,406,86,874,143500,25854
49,49,0,-,-,25855
47,32,15,-,-,25857
93,93,0,-,-,25862
128,128,0,-,-,25864
533,458,75,1064,73200,25865
172,163,9,-,83500,25868
13,13,0,-,-,25870
365,233,132,697,66800,25871
259,259,0,-,114000,25873
249,235,14,-,-,25875
37,37,0,-,-,25876
328,316,12,-,123000,25878
100,86,14,-,-,25879
2814,1991,823,554,87500,25880
814,667,147,523,71600,25882
4762,3306,1456,665,98900,25901
80,80,0,-,93800,25902
170,139,31,-,93800,25904
170,131,39,-,93900,25906
21,21,0,-,-,25907
49,49,0,-,-,25908
22,12,10,-,-,25911
113,113,0,-,103200,25913
70,49,21,-,-,25915
72,42,30,-,-,25916
855,751,104,823,88400,25917
1928,1631,297,720,154900,25918
54,54,0,-,-,25920
959,564,395,719,59200,25921
102,75,27,-,-,25922
223,223,0,-,55600,25928
142,120,22,-,90700,25932
13,4,9,-,-,25936
541,474,67,-,157600,25938
61,61,0,-,-,25942
2862,2058,804,685,105100,25951
326,237,89,863,62200,25958
1439,1029,410,500,83800,25962
457,407,50,-,72700,25969
406,371,35,-,161100,25971
95,69,26,-,63100,25972
1106,987,119,441,82500,25976
62,62,0,-,-,25977
238,177,61,-,164800,25978
393,317,76,631,85300,25979
253,191,62,604,38100,25981
512,343,169,531,82000,25984
191,120,71,769,100900,25985
35,35,0,-,-,25989
16956,11891,5065,669,124900,26003
225,170,55,763,51700,26030
678,429,249,548,64100,26031
197,153,44,595,89500,26032
944,854,90,757,105500,26033
2118,1565,553,608,86600,26034
752,713,39,-,108300,26035
87,67,20,-,135600,26036
2833,2171,662,657,84900,26037
1249,1089,160,683,179500,26038
214,162,52,-,-,26039
775,555,220,670,70200,26040
6407,5025,1382,622,101600,26041
2594,2084,510,566,98900,26047
780,411,369,622,50400,26050
448,382,66,-,133100,26055
49,49,0,-,-,26056
1039,848,191,941,122800,26059
722,611,111,676,154400,26060
8848,6093,2755,695,96300,26062
3842,3045,797,563,102400,26070
213,151,62,529,109400,26074
169,155,14,675,63800,26075
12164,7434,4730,687,88300,26101
7063,4776,2287,702,122700,26104
5096,3769,1327,690,139400,26105
558,512,46,-,122200,26133
376,292,84,-,91400,26134
249,229,20,-,127100,26136
273,251,22,-,86400,26137
58,47,11,-,51600,26138
129,121,8,-,65900,26141
992,827,165,713,89200,26142
1872,1506,366,458,93200,26143
335,312,23,440,86400,26146
833,590,243,642,91900,26147
114,114,0,-,65700,26148
765,637,128,652,89800,26149
2459,1884,575,866,154600,26150
256,214,42,-,75400,26151
36,3,33,-,-,26152
2920,2334,586,695,109300,26155
1223,973,250,813,85900,26159
413,399,14,-,119600,26160
242,242,0,-,-,26161
3015,2257,758,784,108700,26164
355,340,15,-,105700,26167
244,211,33,-,124300,26169
2299,1854,445,609,110200,26170
1292,997,295,631,105400,26175
105,96,9,-,58300,26178
957,790,167,806,152700,26180
2481,2136,345,747,166100,26181
929,816,113,772,150500,26184
2685,2374,311,790,156300,26187
7774,5415,2359,700,130400,26201
242,242,0,-,82100,26202
69,69,0,-,-,26203
1267,1034,233,602,88800,26205
1401,907,494,478,61000,26206
371,317,54,-,66200,26208
100,47,53,950,-,26209
14,14,0,-,-,26215
136,71,65,-,-,26217
1099,982,117,773,88500,26218
204,154,50,-,70200,26222
121,107,14,-,101300,26224
15,15,0,-,-,26228
66,57,9,-,-,26230
709,659,50,-,79400,26234
18,18,0,-,-,26236
208,158,50,-,65500,26237
304,247,57,-,116500,26238
5627,3573,2054,617,132800,26241
1865,1489,376,617,96800,26250
1483,992,491,741,142200,26253
105,67,38,-,67300,26254
486,441,45,762,88500,26257
13,13,0,-,-,26259
722,594,128,738,210800,26260
1121,840,281,549,43000,26261
123,123,0,-,253400,26263
234,198,36,577,-,26264
43,43,0,-,-,26266
91,65,26,-,203600,26267
17,17,0,-,-,26268
388,316,72,475,121300,26269
229,180,49,715,89200,26270
170,148,22,671,120300,26271
324,246,78,636,75000,26273
232,154,78,530,65900,26275
130,130,0,-,55100,26276
262,233,29,-,66500,26278
641,502,139,656,76300,26280
35,35,0,-,-,26282
726,601,125,692,124600,26283
169,169,0,-,81500,26285
1399,1074,325,535,93600,26287
1485,1111,374,598,76900,26288
55,55,0,-,-,26291
271,188,83,500,97700,26292
246,177,69,741,74600,26293
440,391,49,-,87100,26294
54,54,0,-,-,26296
54,54,0,-,76700,26298
11751,7683,4068,710,89700,26301
281,254,27,-,106900,26320
160,139,21,535,-,26321
158,99,59,739,69300,26323
157,144,13,517,164400,26325
17,17,0,-,-,26327
5862,4359,1503,966,211900,26330
650,439,211,610,83800,26335
477,404,73,496,86800,26337
310,243,67,425,85000,26338
85,72,13,-,179500,26339
108,70,38,-,138000,26342
112,69,43,-,103500,26343
347,286,61,521,118800,26346
820,656,164,687,124600,26347
58,28,30,-,45900,26348
28,12,16,-,-,26349
1347,728,619,581,98300,26351
4178,3311,867,566,99900,26354
86,86,0,-,31900,26361
1404,988,416,634,106100,26362
15,15,0,-,-,26366
278,203,75,731,87300,26369
361,291,70,1142,236100,26372
509,472,37,736,119500,26374
220,171,49,-,61800,26376
204,161,43,-,106400,26377
1617,1312,305,736,163800,26378
286,286,0,-,81000,26384
1509,1351,158,720,136300,26385
976,791,185,801,85100,26386
203,155,48,-,-,26404
417,364,53,-,150000,26405
1135,1025,110,1053,176800,26408
394,320,74,900,99000,26410
276,201,75,-,160300,26411
170,149,21,-,53800,26412
1200,995,205,508,88700,26415
3192,2110,1082,494,111900,26416
418,316,102,833,100400,26419
53,46,7,-,-,26421
229,149,80,953,-,26422
98,98,0,-,55700,26424
452,379,73,595,80600,26425
2564,2196,368,763,103300,26426
137,93,44,-,-,26430
2340,1845,495,693,113700,26431
64,49,15,-,57200,26435
63,63,0,-,83500,26436
159,133,26,243,-,26437
65,54,11,-,61000,26438
524,370,154,759,99600,26440
110,110,0,-,95800,26443
1407,1275,132,681,81600,26444
536,394,142,622,59800,26447
538,498,40,-,108400,26448
272,232,40,806,116700,26451
3663,2459,1204,646,93700,26452
1422,1200,222,455,112900,26456
8602,5340,3262,766,171800,26501
15184,5180,10004,851,215100,26505
12269,9233,3036,876,239800,26508
773,614,159,687,69700,26519
344,344,0,-,137900,26520
102,88,14,623,97300,26521
2025,1699,326,748,159700,26525
820,429,391,729,74000,26534
2188,1586,602,650,127600,26537
996,841,155,564,127600,26541
998,883,115,656,116100,26542
108,51,57,-,-,26543
1055,843,212,686,120200,26547
17028,12186,4842,791,131500,26554
502,423,79,680,146200,26559
66,49,17,-,-,26560
178,150,28,-,-,26562
202,131,71,-,53700,26563
289,204,85,821,82800,26568
1297,1168,129,608,112800,26570
843,680,163,642,71300,26571
72,59,13,-,43400,26572
272,202,70,775,68500,26574
305,204,101,519,112800,26575
270,258,12,-,86800,26576
312,235,77,-,105200,26581
1715,1402,313,556,85600,26582
183,173,10,-,145100,26585
94,94,0,-,89700,26586
158,119,39,-,77300,26587
1097,872,225,713,123100,26588
262,229,33,877,115700,26590
552,519,33,-,115100,26591
1749,1389,360,590,91400,26601
397,327,70,593,108300,26610
102,74,28,-,-,26611
23,23,0,-,-,26615
15,15,0,-,-,26617
128,111,17,-,155300,26619
323,272,51,635,82400,26621
470,373,97,-,156900,26623
1237,1042,195,523,93700,26624
151,87,64,-,-,26627
146,129,17,-,42500,26629
108,108,0,-,85000,26631
191,157,34,-,96800,26636
51,33,18,-,-,26638
4019,2939,1080,596,114800,26651
117,111,6,-,60600,26656
161,125,36,-,91100,26660
443,401,42,-,108800,26662
138,138,0,-,79000,26676
348,291,57,-,172100,26678
779,670,109,1134,150300,26679
106,89,17,-,85500,26680
405,376,29,-,87000,26681
70,58,12,-,86100,26684
249,240,9,-,47800,26690
132,116,16,-,-,26691
2080,1756,324,492,153800,26704
223,176,47,-,112500,26705
107,79,28,638,88100,26707
812,656,156,632,157200,26710
1141,883,258,942,183100,26711
176,140,36,-,162500,26714
281,273,8,-,118400,26716
319,247,72,605,76000,26717
1265,1043,222,756,174200,26719
36,36,0,-,-,26720
259,242,17,-,132500,26722
5073,3827,1246,659,131500,26726
174,174,0,-,156800,26731
380,309,71,-,114400,26739
602,567,35,-,179100,26743
330,162,168,457,47700,26750
2426,1748,678,738,163000,26753
361,348,13,-,164700,26755
2759,1880,879,622,140800,26757
177,177,0,-,145500,26761
596,432,164,590,106700,26763
1700,1391,309,514,99200,26764
266,198,68,916,77300,26767
366,307,59,-,206900,26801
472,311,161,499,122600,26802
265,241,24,463,86900,26804
1270,1024,246,579,145400,26807
379,232,147,664,248100,26808
150,123,27,-,164300,26810
667,547,120,593,153600,26812
167,136,31,523,112900,26814
324,292,32,525,139900,26815
148,123,25,-,-,26817
372,296,76,731,79000,26818
127,98,29,-,178100,26823
746,668,78,577,177200,26833
3001,1909,1092,776,126300,26836
335,324,11,-,162800,26845
2653,2040,613,550,127400,26847
637,516,121,690,150800,26851
310,228,82,619,131600,26852
289,244,45,-,153700,26855
104,78,26,-,-,26865
298,244,54,-,112000,26866
349,278,71,472,109100,26884
5809,5262,547,824,233600,27006
896,816,80,566,117300,27007
1030,954,76,944,171300,27009
2389,1801,588,639,131000,27011
10792,8934,1858,815,227200,27012
2254,1716,538,668,117300,27013
334,187,147,953,85400,27014
559,439,120,583,110200,27016
3428,2350,1078,635,121600,27017
3150,2602,548,772,160500,27018
1594,1431,163,653,144500,27019
2534,1750,784,667,137400,27020
7396,5644,1752,738,143800,27021
469,342,127,657,184500,27022
5159,4322,837,861,212900,27023
1136,918,218,731,132100,27024
4519,3764,755,606,116300,27025
1864,1164,700,532,97600,27027
10163,7590,2573,720,140600,27028
15179,10878,4301,609,117500,27030
4646,4175,471,1038,186000,27040
3196,2330,866,625,153600,27041
290,205,85,-,-,27042
2756,2107,649,640,143600,27043
3781,2859,922,821,142100,27045
883,728,155,441,104100,27046
524,437,87,1043,121400,27047
3194,2686,508,593,122700,27048
1624,1435,189,704,147500,27050
3064,2217,847,767,137400,27051
4476,3269,1207,670,138900,27052
1430,1241,189,766,119900,27053
995,847,148,774,133000,27054
5416,4165,1251,632,135300,27055
8631,2899,5732,714,133300,27101
15605,8192,7413,873,160500,27103
12779,7700,5079,878,254700,27104
14663,7255,7408,723,98800,27105
19745,10453,9292,810,186800,27106
17403,11805,5598,769,129100,27107
0,0,0,-,-,27109
0,0,0,-,-,27110
15463,9935,5528,852,136300,27127
30,30,0,-,83300,27201
8862,3929,4933,656,107800,27203
13126,10397,2729,778,130200,27205
1342,1109,233,529,142600,27207
641,560,81,1011,140800,27208
1430,1036,394,729,107500,27209
609,545,64,910,168100,27212
4001,3310,691,762,170300,27214
18409,10348,8061,850,172400,27215
13704,8682,5022,779,112000,27217
1111,730,381,561,87400,27229
802,620,182,1234,201100,27231
1579,1340,239,735,153000,27233
1814,1461,353,1127,263800,27235
3894,3090,804,651,116900,27239
592,437,155,508,87600,27242
1753,1415,338,728,187000,27243
5071,3630,1441,1053,178300,27244
1329,972,357,917,134200,27248
4607,3761,846,829,155400,27249
679,487,192,754,160800,27252
12606,8703,3903,741,151600,27253
2767,2182,585,706,140700,27258
8949,3185,5764,743,82600,27260
8649,4814,3835,856,156500,27262
8717,5714,3003,715,120500,27263
20195,13151,7044,953,175900,27265
10496,8241,2255,1024,257000,27278
1429,1093,336,763,166000,27281
6748,4942,1806,1067,188500,27282
1205,1064,141,882,167900,27283
22113,15721,6392,831,172000,27284
9941,6155,3786,664,93400,27288
592,499,93,793,118700,27291
15766,9941,5825,704,125400,27292
15331,11106,4225,701,145700,27295
4255,3130,1125,717,141500,27298
2097,1517,580,738,114000,27299
3334,2930,404,1056,147900,27301
11885,8392,3493,888,180700,27302
669,490,179,1004,97300,27305
2646,2233,413,636,119600,27306
2402,2286,116,-,363900,27310
1479,1110,369,593,90300,27311
8938,6926,2012,860,310900,27312
2644,2318,326,823,172200,27313
369,334,35,-,125300,27314
841,678,163,631,112400,27315
2868,1823,1045,738,114100,27316
6588,4858,1730,660,123000,27317
16034,10834,5200,707,117300,27320
2814,2220,594,521,92800,27325
1349,947,402,561,113900,27326
14554,9285,5269,781,146500,27330
10663,7640,3023,895,157200,27332
37,0,37,-,-,27340
1970,1725,245,637,107500,27341
641,577,64,-,154300,27343
6808,4430,2378,707,145800,27344
2320,1919,401,650,145700,27349
2576,2116,460,749,132100,27350
911,727,184,589,149900,27355
1043,819,224,581,110500,27356
3110,2558,552,813,168100,27357
5252,4504,748,942,315000,27358
18747,12166,6581,688,124800,27360
5677,4629,1048,758,126400,27370
3167,2143,1024,527,118400,27371
3919,3435,484,764,239700,27376
3460,2391,1069,897,182100,27377
2116,1320,796,467,115800,27379
7396,2710,4686,760,104000,27401
7662,3969,3693,881,176700,27403
18935,8788,10147,760,107900,27405
24235,13234,11001,822,127400,27406
20264,9757,10507,899,140700,27407
8114,5733,2381,933,218300,27408
8013,2433,5580,877,140500,27409
24560,14965,9595,987,219500,27410
12018,8673,3345,920,238600,27455
7306,5385,1921,864,166900,27501
14517,11856,2661,1431,329800,27502
1405,1267,138,2143,277200,27503
5432,3978,1454,766,127000,27504
2611,1855,756,799,137800,27505
714,491,223,758,114100,27507
493,320,173,686,108000,27508
1600,910,690,904,140700,27509
7087,2269,4818,1065,319900,27510
13654,9191,4463,1099,250500,27511
18111,11398,6713,1185,321900,27513
9965,4951,5014,1158,444000,27514
15797,10873,4924,1169,366500,27516
11656,7557,4099,1247,403200,27517
8267,5581,2686,1290,411000,27518
19707,14579,5128,1464,415400,27519
15037,11054,3983,989,169800,27520
2319,1426,893,849,133100,27521
5055,3849,1206,1040,158600,27522
4426,2980,1446,1309,368100,27523
4728,3106,1622,841,140900,27524
5870,4286,1584,814,148300,27525
16775,13044,3731,1077,246600,27526
8287,7011,1276,1179,232500,27527
18499,12994,5505,1090,196600,27529
15722,9379,6343,690,133100,27530
0,0,0,-,-,27531
13287,7126,6161,920,144700,27534
6308,2289,4019,670,94700,27536
8743,6129,2614,709,106100,27537
8150,6882,1268,1293,331200,27539
12846,10735,2111,1423,310300,27540
1533,1210,323,1075,230600,27541
3462,2201,1261,750,110500,27542
1955,1303,652,788,117500,27544
10340,7600,2740,1120,175300,27545
6636,4474,2162,809,145300,27546
10233,7164,3069,813,132200,27549
695,571,124,1054,151500,27551
960,718,242,681,84500,27553
257,87,170,769,85400,27555
114,86,28,672,-,27556
2707,1891,816,641,99300,27557
1033,815,218,1030,240400,27559
13779,6199,7580,1386,329400,27560
874,683,191,873,269100,27562
1973,1242,731,563,81600,27563
9700,6505,3195,742,129900,27565
260,146,114,608,129500,27568
3079,1941,1138,825,101600,27569
2188,1830,358,788,312900,27571
2955,2746,209,738,196300,27572
4646,2449,2197,646,106600,27573
5777,4852,925,677,115500,27574
6457,4107,2350,841,128700,27576
9595,6007,3588,800,151100,27577
1199,1031,168,883,158000,27581
171,31,140,485,85400,27582
2795,2589,206,850,140500,27583
24222,18923,5299,1122,309200,27587
2842,2027,815,612,78300,27589
7539,5522,2017,868,188600,27591
5642,4805,837,843,185700,27592
6773,5665,1108,857,198500,27596
8945,6680,2265,894,167000,27597
4127,1052,3075,1036,331600,27601
20457,12406,8051,1120,221300,27603
18822,10612,8210,1071,177600,27604
3539,1235,2304,1236,323800,27605
18447,6630,11817,1063,278800,27606
8689,4409,4280,1149,413600,27607
4919,3601,1318,1128,574000,27608
15738,8070,7668,1084,312500,27609
25875,14823,11052,1038,160800,27610
18257,9698,8559,1165,337500,27612
17188,12010,5178,1114,340900,27613
12484,9283,3201,1234,385000,27614
18585,12810,5775,1161,315100,27615
19414,11851,7563,1126,202900,27616
9312,4203,5109,1290,268700,27617
9698,2863,6835,855,276600,27701
20836,12817,8019,1059,195100,27703
15301,8567,6734,961,156200,27704
19962,9555,10407,1047,268800,27705
20317,9293,11024,1056,246200,27707
422,283,139,-,177500,27709
8327,7649,678,1268,225600,27712
23235,13004,10231,1144,243500,27713
7967,3770,4197,700,86900,27801
7661,4991,2670,755,139300,27803
11823,6933,4890,844,133800,27804
1649,1249,400,675,84300,27805
1066,862,204,679,64100,27806
2507,1607,900,730,124500,27807
925,825,100,1045,190100,27808
1974,1587,387,734,105000,27809
1970,1343,627,696,172600,27810
1072,702,370,661,93100,27812
270,196,74,692,84000,27813
786,749,37,-,123600,27814
828,724,104,650,86300,27816
3029,2167,862,809,149800,27817
607,445,162,694,69300,27818
106,75,31,715,63000,27819
972,718,254,572,98900,27820
133,90,43,-,-,27821
3214,2611,603,708,109800,27822
3117,1965,1152,782,59400,27823
646,427,219,785,90500,27824
28,10,18,900,85000,27825
190,122,68,-,101700,27826
24,22,2,-,85700,27827
3616,2491,1125,722,119700,27828
765,464,301,583,85900,27829
1947,1355,592,659,97300,27830
1528,1082,446,749,67200,27831
1265,831,434,782,71600,27832
23272,9154,14118,768,115400,27834
2476,1983,493,741,157000,27837
1197,881,316,789,69900,27839
169,120,49,477,58600,27840
11,4,7,-,-,27841
719,593,126,-,330100,27842
408,284,124,729,81100,27843
1159,832,327,663,80900,27844
1042,685,357,679,106800,27845
1221,882,339,605,88500,27846
317,254,63,760,47100,27847
723,527,196,720,86400,27849
3302,2651,651,670,167100,27850
2054,1613,441,732,102100,27851
1182,987,195,669,92500,27852
190,132,58,-,72100,27853
2357,1400,957,765,80500,27855
6349,4569,1780,828,138300,27856
460,373,87,775,83000,27857
22426,10148,12278,846,174500,27858
638,520,118,651,73800,27860
17,17,0,-,43800,27861
351,264,87,844,153100,27862
4665,3560,1105,1005,123200,27863
1943,1203,740,647,80300,27864
753,692,61,973,115900,27865
330,169,161,955,106300,27866
856,604,252,756,64400,27869
10639,6198,4441,727,100700,27870
1764,1192,572,659,72900,27871
231,131,100,-,42300,27872
161,127,34,1063,112700,27873
1744,1237,507,703,73700,27874
224,117,107,-,175600,27875
543,382,161,768,88200,27876
887,426,461,753,84300,27878
128,103,25,1038,135300,27879
1313,986,327,617,171000,27880
34,16,18,735,95000,27881
2914,1993,921,687,99600,27882
1157,805,352,647,86200,27883
479,462,17,-,82100,27884
412,289,123,637,58300,27885
8314,5154,3160,681,88700,27886
872,663,209,758,84600,27888
11155,7119,4036,726,136000,27889
1042,414,628,647,79700,27890
1964,1422,542,822,87000,27891
5774,3859,1915,674,102500,27892
15431,6741,8690,720,101900,27893
8322,6017,2305,899,167800,27896
709,400,309,511,84600,27897
14716,8783,5933,909,163000,27909
4538,2885,1653,733,93800,27910
328,231,97,-,204100,27915
366,245,121,1113,214700,27916
218,136,82,1110,-,27917
444,363,81,-,156900,27919
596,346,250,935,265400,27920
1762,1367,395,1069,204300,27921
303,217,86,732,84800,27922
321,249,72,867,240300,27923
1528,1373,155,668,80500,27924
1518,1057,461,725,118500,27925
646,505,141,1013,156400,27926
467,362,105,871,454300,27927
799,615,184,639,149000,27928
758,688,70,-,283300,27929
5201,3396,1805,822,128900,27932
712,522,190,550,162200,27935
426,320,106,796,221700,27936
1675,1285,390,949,150300,27937
577,394,183,846,125000,27938
1143,854,289,988,186800,27939
192,181,11,-,250600,27941
286,275,11,615,58300,27942
207,160,47,887,370000,27943
5242,3941,1301,946,183000,27944
491,460,31,-,133700,27946
467,431,36,-,258700,27947
4945,3671,1274,1060,252700,27948
3329,2917,412,1345,430900,27949
865,781,84,1090,204000,27950
376,270,106,996,152900,27953
3098,2145,953,1099,248400,27954
177,164,13,-,-,27956
483,404,79,-,77800,27957
4235,3597,638,1469,271400,27958
1312,930,382,1310,326100,27959
317,219,98,725,444300,27960
3121,1824,1297,616,84800,27962
324,239,85,1318,278900,27964
192,147,45,-,209100,27965
352,197,155,743,289700,27966
93,73,20,625,77500,27967
81,40,41,-,-,27968
1079,853,226,467,74800,27970
43,43,0,-,369400,27972
617,443,174,1014,255200,27973
485,429,56,862,182200,27974
1495,1318,177,635,219500,27976
81,47,34,875,159400,27978
617,495,122,678,147300,27979
922,701,221,-,135700,27980
683,418,265,1099,218500,27981
24,13,11,-,-,27982
3287,2239,1048,626,90900,27983
180,99,81,865,120200,27985
494,318,176,693,93800,27986
10393,7122,3271,695,128200,28001
500,435,65,803,154900,28006
261,215,46,822,80200,28007
506,330,176,705,84100,28009
9039,6314,2725,913,204200,28012
4992,2960,2032,739,115500,28016
0,0,0,-,-,28017
2122,1670,452,711,114500,28018
0,0,0,-,-,28019
792,639,153,935,78700,28020
5574,4031,1543,738,134000,28021
6062,4558,1504,790,144200,28023
19946,13459,6487,857,172000,28025
23794,17053,6741,1055,225500,28027
11745,8328,3417,1239,314600,28031
1206,797,409,859,149500,28032
1179,969,210,649,132000,28033
6403,4584,1819,719,129800,28034
6113,4958,1155,1177,398500,28036
8413,6872,1541,850,320500,28037
32,17,15,-,87500,28039
3107,2430,677,696,98000,28040
8287,4968,3319,600,110100,28043
12710,6943,5767,853,102400,28052
15450,7288,8162,869,139100,28054
12970,10235,2735,875,172200,28056
1067,880,187,639,156300,28071
554,343,211,398,155200,28072
2278,1353,925,704,101300,28073
6147,5426,721,1625,292600,28075
153,110,43,-,-,28076
215,111,104,622,67500,28077
21999,16163,5836,1276,302300,28078
12948,11082,1866,1411,220300,28079
2943,2361,582,727,148400,28080
10121,6285,3836,799,143700,28081
9234,5397,3837,880,127200,28083
9511,6693,2818,694,124400,28086
855,703,152,1138,131200,28088
31,23,8,-,157800,28089
3062,2397,665,678,106600,28090
857,596,261,570,79600,28091
16116,11164,4952,682,139300,28092
2462,1940,522,819,168100,28097
1321,890,431,842,118800,28098
372,263,109,958,285900,28101
39,35,4,-,75500,28102
3952,3003,949,865,179900,28103
10556,9647,909,1346,321700,28104
17527,12400,5127,1281,260300,28105
2686,2324,362,844,234000,28107
47,21,26,-,-,28108
45,28,17,-,114100,28109
18207,12942,5265,1010,183100,28110
9441,7034,2407,883,167600,28112
2715,2055,660,618,90900,28114
13637,9675,3962,900,214400,28115
15671,11240,4431,1186,418100,28117
1094,654,440,849,65200,28119
8282,6174,2108,833,162100,28120
2249,1898,351,845,187900,28124
920,696,224,811,211900,28125
2712,2220,492,715,165300,28127
2921,2241,680,709,115900,28128
2155,1778,377,720,154600,28129
967,717,250,827,130200,28133
4274,2387,1887,1165,213400,28134
1885,1386,499,754,114100,28135
1112,1007,105,733,157200,28137
3875,3057,818,810,126200,28138
8200,6254,1946,740,141400,28139
9276,5127,4149,772,132300,28144
10996,8533,2463,749,149200,28146
8814,5690,3124,787,148600,28147
10564,6982,3582,672,121000,28150
8597,5676,2921,705,121900,28152
1066,579,487,926,89100,28159
1407,834,573,586,88400,28160
1887,1486,401,691,164000,28163
6172,5060,1112,784,177800,28164
3686,2969,717,1026,183100,28166
986,895,91,-,143200,28167
3954,3313,641,671,125400,28168
71,40,31,643,117900,28169
4486,2718,1768,756,90800,28170
18239,16276,1963,1192,391100,28173
2775,1903,872,874,144500,28174
7258,2276,4982,1511,319100,28202
8706,2796,5910,1398,536500,28203
3926,958,2968,1302,430700,28204
20094,8647,11447,1004,248100,28205
5011,1687,3324,870,114300,28206
3860,2913,947,1206,989600,28207
14771,4854,9917,908,106900,28208
10847,5892,4955,1167,385100,28209
20330,11005,9325,1133,325200,28210
12681,7498,5183,1169,467900,28211
16343,5678,10665,982,143700,28212
16396,8117,8279,1004,169200,28213
14259,10399,3860,1102,153600,28214
20955,12415,8540,1068,154800,28215
19939,10540,9399,1094,146100,28216
10673,3223,7450,1108,127200,28217
16111,11648,4463,1197,371600,28226
20043,13622,6421,1081,182500,28227
0,0,0,-,-,28244
16426,5648,10778,1143,182400,28262
30082,19091,10991,1232,185900,28269
13349,9145,4204,1373,355200,28270
14792,7425,7367,1211,183800,28273
27201,18817,8384,1478,361200,28277
9748,7067,2681,1408,279300,28278
0,0,0,-,-,28280
0,0,0,-,-,28282
6774,2543,4231,670,89700,28301
13547,5973,7574,876,135900,28303
14439,7827,6612,990,115700,28304
2814,1490,1324,867,185300,28305
15474,9474,6000,927,159800,28306
4699,44,4655,1235,162500,28307
26,0,26,-,-,28308
0,0,0,-,-,28310
14572,6862,7710,866,150000,28311
7424,4857,2567,818,148400,28312
23354,10202,13152,971,130500,28314
4958,3226,1732,770,161500,28315
1700,1348,352,650,82800,28318
3860,2581,1279,629,86600,28320
1428,1019,409,769,176400,28323
251,166,85,732,80900,28325
7460,4219,3241,1325,166300,28326
6756,5697,1059,1045,179900,28327
9939,6096,3843,643,98600,28328
194,108,86,-,-,28330
150,86,64,657,157500,28332
4006,2630,1376,692,76700,28333
9392,6131,3261,720,118100,28334
4238,2970,1268,699,103200,28337
1980,1552,428,654,82000,28338
2839,2019,820,822,92300,28339
3748,2435,1313,528,68500,28340
1495,949,546,756,87200,28341
65,49,16,870,117700,28342
546,365,181,608,64400,28343
1084,822,262,742,88000,28344
5045,3147,1898,618,76300,28345
466,300,166,586,70900,28347
12462,8696,3766,928,146500,28348
1119,787,332,680,109200,28349
75,75,0,-,-,28350
1833,1333,500,677,67700,28351
9125,5139,3986,685,90600,28352
1851,1535,316,669,158100,28356
1062,742,320,682,97800,28357
13437,7602,5835,690,93600,28358
4777,3247,1530,628,88400,28360
467,300,167,614,58800,28363
5139,3713,1426,612,68300,28364
5958,4064,1894,695,92300,28365
2244,1623,621,619,84600,28366
55,13,42,538,131900,28367
943,746,197,615,69200,28369
2454,1713,741,823,89800,28371
4553,2985,1568,607,79700,28372
1089,740,349,919,149200,28373
7862,6602,1260,1401,301300,28374
90,74,16,613,"10,000-",28375
14859,9884,4975,1009,148000,28376
4135,2601,1534,592,65800,28377
10345,6844,3501,683,88200,28379
2927,2103,824,634,88500,28382
3059,2353,706,568,66000,28383
3935,2873,1062,638,69500,28384
937,763,174,544,89900,28385
2008,1523,485,632,59800,28386
6848,3922,2926,913,278800,28387
8678,4116,4562,947,134500,28390
2167,1615,552,729,138000,28391
593,487,106,907,72800,28392
775,524,251,599,68300,28393
2159,1491,668,1020,201400,28394
778,605,173,860,122600,28395
986,676,310,621,82100,28396
2957,1592,1365,658,80300,28398
858,733,125,664,113400,28399
10674,3882,6792,884,157400,28401
17929,5880,12049,967,238400,28403
14041,8508,5533,1060,215000,28405
13312,10711,2601,1330,286100,28409
14974,11355,3619,1192,271700,28411
17539,10166,7373,1059,222100,28412
1524,1027,497,712,156300,28420
482,427,55,776,93800,28421
3185,2584,601,736,214800,28422
919,702,217,766,100000,28423
28,11,17,667,-,28424
3979,2699,1280,801,143700,28425
3032,1959,1073,1157,354300,28428
2858,2253,605,831,157000,28429
809,676,133,492,76700,28430
2951,2104,847,599,75900,28431
580,442,138,732,86000,28432
1901,1416,485,636,107500,28433
459,328,131,1035,125000,28434
868,765,103,705,98500,28435
736,558,178,786,122200,28436
645,556,89,588,76700,28438
497,381,116,265,56500,28439
1105,615,490,588,69200,28441
638,511,127,655,113600,28442
8458,7296,1162,1159,250800,28443
1005,873,132,943,113600,28444
2931,2037,894,1166,230900,28445
565,468,97,577,131000,28447
463,309,154,-,-,28448
795,612,183,1483,455700,28449
1005,766,239,862,193600,28450
14696,11444,3252,1099,186000,28451
324,217,107,-,74500,28452
1154,851,303,586,67500,28453
853,710,143,1343,125700,28454
963,817,146,826,108700,28455
1547,1199,348,755,111100,28456
3891,3286,605,792,183300,28457
2431,1652,779,743,88700,28458
4464,2922,1542,1174,217900,28460
8894,7284,1610,1002,284200,28461
5493,4422,1071,807,149000,28462
3035,2206,829,589,78800,28463
1191,784,407,832,78700,28464
3511,2902,609,1078,276800,28465
3872,2898,974,651,107700,28466
4923,4607,316,1138,195600,28467
2519,2071,448,1103,252900,28468
2967,2644,323,925,324500,28469
5179,3828,1351,866,185500,28470
7365,4775,2590,644,101500,28472
1754,1378,376,628,103000,28478
2663,2044,619,954,183300,28479
1176,820,356,1655,805300,28480
7731,3444,4287,668,83900,28501
8897,5779,3118,807,109700,28504
966,865,101,491,76500,28508
735,539,196,811,198300,28510
285,205,80,1032,153800,28511
1613,1225,388,985,387900,28512
4118,2771,1347,592,121900,28513
929,674,255,612,91800,28515
5102,3417,1685,820,192300,28516
3237,2454,783,675,125900,28518
173,105,68,764,149000,28519
161,109,52,-,157300,28520
978,822,156,793,134300,28521
906,787,119,755,116800,28523
124,105,19,-,145800,28524
1152,878,274,593,76100,28525
1193,677,516,766,68000,28526
432,352,80,628,140400,28527
214,160,54,-,87100,28528
833,630,203,764,105400,28529
2856,1820,1036,700,87200,28530
550,457,93,1066,234000,28531
8533,4105,4428,1013,140600,28532
18,0,18,-,-,28533
30,23,7,-,-,28537
824,466,358,749,72100,28538
5920,3520,2400,980,137600,28539
17784,9418,8366,886,148800,28540
1924,42,1882,1254,167500,28543
2234,542,1692,989,112100,28544
17126,8547,8579,930,159400,28546
1985,10,1975,1322,-,28547
5636,3949,1687,718,106200,28551
49,49,0,-,58800,28552
187,140,47,-,245500,28553
130,101,29,-,-,28554
1845,1387,458,822,134200,28555
445,387,58,-,265500,28556
6924,4576,2348,878,240800,28557
11581,7410,4171,863,152200,28560
16354,11203,5151,887,189200,28562
8632,6312,2320,879,161700,28570
1245,1032,213,885,278900,28571
2503,1803,700,624,94300,28572
812,587,225,700,129800,28573
6304,4452,1852,1100,140600,28574
224,196,28,1413,326200,28575
110,80,30,"3,500+",185000,28577
2254,1613,641,598,80100,28578
256,188,68,848,247600,28579
4116,2880,1236,694,91800,28580
144,144,0,-,-,28581
831,680,151,1258,216400,28582
151,106,45,-,73100,28583
5173,3815,1358,1087,226800,28584
1564,1240,324,516,85100,28585
3052,2147,905,819,105200,28586
118,102,16,828,142900,28587
59,34,25,-,-,28589
9688,6888,2800,942,171700,28590
1768,1471,297,1408,378400,28594
20864,13553,7311,738,165100,28601
11583,7673,3910,694,132100,28602
3040,2222,818,851,229000,28604
1582,1133,449,856,358900,28605
604,531,73,607,92300,28606
13068,6467,6601,882,256600,28607
2227,1889,338,724,149200,28609
3981,3074,907,816,117300,28610
481,385,96,-,61300,28611
4828,3822,1006,587,104200,28612
8895,6503,2392,720,140000,28613
853,660,193,597,134200,28615
33,31,2,-,-,28616
888,596,292,522,142300,28617
1095,867,228,885,182800,28618
667,481,186,689,108200,28619
4143,2934,1209,638,129300,28621
1061,874,187,977,104900,28622
673,583,90,743,135700,28623
759,645,114,-,94900,28624
15007,11388,3619,784,146800,28625
1183,1091,92,947,228200,28626
521,390,131,592,117500,28627
158,92,66,783,96700,28628
0,0,0,-,-,28629
7948,5952,1996,692,122700,28630
359,307,52,-,181100,28631
1692,1379,313,783,113800,28634
1313,1131,182,597,101600,28635
1869,1357,512,654,117000,28636
769,544,225,630,130300,28637
4935,3482,1453,617,124800,28638
2090,1358,732,562,154300,28640
2373,1675,698,548,102800,28642
1533,1268,265,733,119300,28643
549,485,64,-,128800,28644
18593,13142,5451,641,111300,28645
141,60,81,817,531300,28646
9,9,0,-,-,28647
353,266,87,-,167500,28649
4396,3320,1076,751,124300,28650
2939,2355,584,597,120500,28651
0,0,0,-,-,28652
1657,1398,259,845,142600,28654
21547,15624,5923,669,125400,28655
3965,3042,923,674,141100,28657
10440,6956,3484,748,121200,28658
8956,6037,2919,659,114800,28659
829,720,109,826,159900,28660
114,83,31,-,-,28662
254,227,27,-,205000,28663
1016,865,151,567,139600,28665
73,25,48,-,-,28666
167,109,58,900,75600,28667
189,171,18,-,415000,28668
1219,995,224,682,116300,28669
1226,967,259,537,133900,28670
213,161,52,703,172100,28671
15,15,0,-,-,28672
2586,2168,418,1196,303200,28673
2962,2108,854,596,133200,28675
1576,1321,255,546,139800,28676
13602,8834,4768,722,133100,28677
2128,1766,362,708,157500,28678
692,534,158,691,224200,28679
9927,7632,2295,627,136800,28681
589,450,139,637,477400,28682
581,474,107,811,100000,28683
916,648,268,822,158700,28684
815,700,115,595,109400,28685
832,726,106,584,107800,28689
3566,2695,871,618,124500,28690
1595,1291,304,894,205600,28692
830,641,189,842,146700,28693
3452,2554,898,677,146300,28694
5699,4219,1480,629,166400,28697
982,837,145,794,160400,28698
1349,1121,228,933,227400,28701
179,163,16,-,216100,28702
7898,4919,2979,1115,235400,28704
2839,2233,606,676,151300,28705
90,59,31,-,159700,28707
132,108,24,-,136400,28708
876,689,187,748,159200,28709
5724,3889,1835,816,240300,28711
8840,6298,2542,755,228700,28712
3597,2599,998,644,159800,28713
7116,5167,1949,636,156500,28714
10338,7544,2794,784,211700,28715
7331,5355,1976,740,161100,28716
883,713,170,900,350700,28717
167,140,27,-,187000,28718
2892,1995,897,586,110100,28719
81,50,31,704,220000,28720
4420,3076,1344,742,178100,28721
2881,1832,1049,843,226300,28722
3237,1289,1948,702,247600,28723
10,5,5,-,-,28725
1375,707,668,800,149200,28726
1453,1305,148,239,218200,28729
3573,2977,596,777,255100,28730
3489,2790,699,912,251300,28731
7466,6128,1338,1027,229000,28732
15,0,15,-,-,28733
12498,9147,3351,743,152300,28734
172,108,64,574,218200,28735
359,286,73,962,287500,28736
9755,7376,2379,820,247200,28739
415,360,55,621,152300,28740
1915,1302,613,877,525800,28741
1213,1051,162,810,220800,28742
870,564,306,602,156800,28743
218,186,32,-,319800,28745
1123,925,198,788,287200,28746
937,765,172,693,181900,28747
4938,3608,1330,722,180300,28748
58,58,0,-,-,28749
1757,1550,207,825,196300,28751
12090,8519,3571,648,117300,28752
4017,3047,970,722,170000,28753
3671,2810,861,693,219000,28754
1716,1307,409,763,191700,28756
43,43,0,-,427800,28757
3176,2580,596,956,252900,28759
3110,2401,709,646,134000,28761
2995,2233,762,622,106900,28762
1094,853,241,764,183100,28763
476,413,63,-,200900,28766
3124,2543,581,788,235000,28768
3221,2676,545,465,119100,28771
470,439,31,968,165200,28772
1296,1070,226,944,256100,28773
466,363,103,1385,404700,28774
110,50,60,-,151200,28775
3575,2776,799,570,162000,28777
3753,2769,984,828,165500,28778
7815,5553,2262,735,198300,28779
422,333,89,658,219300,28781
3247,2542,705,1054,253100,28782
714,345,369,642,146600,28783
3224,2535,689,830,245700,28785
9685,6745,2940,797,172200,28786
8654,7040,1614,850,238800,28787
2414,1679,735,855,161400,28789
1309,1115,194,1129,190700,28790
6740,5002,1738,818,228000,28791
14763,9356,5407,835,172400,28792
6606,2376,4230,860,320400,28801
15720,7642,8078,1146,276800,28803
8887,5914,2973,1151,366200,28804
9271,5720,3551,898,264100,28805
17958,10256,7702,996,210500,28806
2099,1574,525,575,118000,28901
566,439,127,728,170600,28902
4122,3180,942,734,190900,28904
1274,1072,202,643,140000,28905
8920,7084,1836,756,166700,28906
478,394,84,-,138300,28909
764,643,121,561,77500,29001
2492,1828,664,830,78000,29003
3855,2664,1191,746,117300,29006
832,721,111,710,100600,29009
4361,2973,1388,663,78900,29010
685,580,105,503,104700,29014
612,471,141,581,83800,29015
7427,6427,1000,1194,259800,29016
1263,1043,220,576,88000,29018
8629,6749,1880,722,130500,29020
742,632,110,532,161300,29030
468,364,104,738,83400,29031
1832,1403,429,788,71800,29032
5606,3125,2481,973,126900,29033
8963,8400,563,1258,290200,29036
389,303,86,-,96400,29037
788,664,124,746,73400,29038
1517,1084,433,895,76100,29039
3828,2848,980,686,128200,29040
1630,935,695,773,71500,29042
2120,1668,452,634,90100,29044
9705,7768,1937,1054,157400,29045
76,76,0,-,-,29046
1629,1323,306,600,84700,29047
2011,1509,502,837,117100,29048
194,166,28,-,108500,29051
668,492,176,788,47800,29052
6942,4832,2110,842,81800,29053
3495,3029,466,788,171500,29054
1644,1355,289,712,71700,29055
917,732,185,554,66700,29056
1618,1289,329,671,110600,29058
2180,1527,653,692,87000,29059
5034,3568,1466,1202,119800,29061
54,18,36,-,-,29062
14412,11563,2849,1234,170500,29063
255,199,56,-,86600,29065
3446,2501,945,750,90000,29067
1919,1471,448,626,77000,29069
5930,4826,1104,744,138600,29070
22057,18087,3970,1058,223600,29072
17549,14159,3390,905,141800,29073
95,86,9,-,341200,29074
971,891,80,1101,194300,29075
6260,5317,943,716,143100,29078
14,9,5,-,-,29079
1080,829,251,444,71300,29080
479,388,91,604,66000,29081
216,208,8,-,63100,29082
1080,949,131,693,73000,29101
6967,5249,1718,642,122000,29102
507,380,127,749,77000,29104
445,309,136,713,55200,29105
1149,971,178,681,60100,29107
8066,5212,2854,755,92400,29108
540,443,97,594,110900,29111
1712,1358,354,731,66500,29112
519,403,116,651,57200,29113
653,524,129,842,63500,29114
10477,5356,5121,683,88600,29115
0,0,0,-,-,29117
6460,4403,2057,683,137400,29118
21,15,6,-,-,29122
2979,2421,558,766,89200,29123
1068,811,257,900,72300,29125
792,703,89,933,135500,29126
3523,2918,605,758,192800,29127
1934,1663,271,709,90700,29128
1297,950,347,635,88200,29129
2561,2162,399,812,171000,29130
244,221,23,629,100600,29133
3263,2540,723,667,103700,29135
759,619,140,544,89000,29137
3618,2469,1149,583,79400,29138
1978,1541,437,683,104000,29142
256,180,76,991,85600,29145
596,499,97,653,73600,29146
0,0,0,-,-,29147
2883,2231,652,444,94500,29148
15202,8371,6831,770,114500,29150
680,0,680,1145,-,29152
6062,4252,1810,848,95200,29153
11979,8435,3544,848,133100,29154
3256,2490,766,741,80100,29160
4273,3033,1240,775,82400,29161
1095,818,277,527,106200,29162
591,433,158,685,73200,29163
2058,1507,551,633,100300,29164
292,234,58,717,103400,29166
1448,1145,303,791,74400,29168
11178,5675,5503,873,143900,29169
8560,6518,2042,908,135700,29170
3967,2610,1357,835,123200,29172
188,152,36,-,84000,29175
1282,977,305,765,62700,29178
5666,3994,1672,702,94000,29180
8132,2141,5991,1021,167900,29201
183,99,84,1436,260200,29202
15348,7370,7978,848,94900,29203
7103,3920,3183,831,136400,29204
10850,5737,5113,866,252800,29205
8236,5469,2767,1113,259200,29206
4,4,0,-,-,29207
0,0,0,-,-,29208
13487,8404,5083,1010,146100,29209
16362,5923,10439,883,128600,29210
12202,8519,3683,1072,171500,29212
20654,11348,9306,1001,152200,29223
0,0,0,-,-,29225
17840,12916,4924,1252,168700,29229
13473,7390,6083,871,133300,29301
6911,5167,1744,845,156000,29302
8742,4236,4506,707,101400,29303
6819,3052,3767,749,104800,29306
7969,4894,3075,843,151000,29307
10109,7651,2458,823,155100,29316
243,166,77,-,65300,29320
1115,849,266,725,69500,29321
3356,2922,434,792,162800,29322
5332,4423,909,652,123800,29323
114,65,49,-,-,29324
5562,3572,1990,697,90500,29325
93,51,42,-,33800,29329
3319,2343,976,701,101100,29330
38,38,0,-,-,29331
1029,819,210,699,95800,29332
224,141,83,775,59400,29333
5216,3728,1488,978,168900,29334
1843,1617,226,688,78500,29335
13,13,0,-,-,29338
7357,5205,2152,641,88000,29340
7499,4890,2609,760,135400,29341
131,101,30,733,76200,29346
12115,10290,1825,831,151100,29349
484,365,119,541,67500,29351
1629,1294,335,663,83700,29353
328,300,28,-,55600,29355
3541,2846,695,599,162000,29356
8236,5164,3072,735,106900,29360
217,150,67,644,41100,29364
4160,3643,517,918,158200,29365
55,55,0,-,-,29368
5600,5006,594,895,174600,29369
313,261,52,-,96900,29370
1613,1284,329,674,86200,29372
160,128,32,1300,29400,29373
1300,1053,247,739,135200,29374
25,10,15,779,150000,29375
2695,2224,471,850,152300,29376
448,190,258,576,58600,29377
40,0,40,-,-,29378
7536,4740,2796,679,80700,29379
1865,1674,191,644,97400,29384
2796,2018,778,764,123300,29385
6275,4671,1604,630,110300,29388
3634,1906,1728,1413,1079000,29401
8537,3174,5363,1272,421700,29403
503,0,503,1556,-,29404
10329,4404,5925,945,153100,29405
12698,4907,7791,963,155100,29406
15191,8498,6693,1095,296100,29407
10,5,5,-,-,29409
8891,5900,2991,1084,228800,29410
16373,11251,5122,1379,325300,29412
17850,11194,6656,1285,259700,29414
9881,5016,4865,1001,152000,29418
8349,5487,2862,1198,194000,29420
0,0,0,-,-,29423
0,0,0,-,-,29424
589,525,64,892,140700,29426
1432,1350,82,959,351600,29429
2380,1968,412,744,137000,29431
1293,990,303,316,66700,29432
240,224,16,-,-,29434
1726,1488,238,792,87600,29435
1733,1262,471,764,105000,29436
1080,853,227,904,121300,29437
1097,963,134,990,355100,29438
1231,794,437,974,579700,29439
10748,7984,2764,792,131800,29440
20402,13796,6606,1161,171200,29445
352,332,20,-,65300,29446
823,495,328,835,132600,29448
3127,2571,556,714,207400,29449
1320,1129,191,682,121600,29450
1868,1615,253,1994,843400,29451
171,167,4,-,75800,29452
422,342,80,935,89900,29453
9525,7806,1719,1269,359600,29455
11110,7197,3913,1180,168600,29456
1109,897,212,988,160100,29458
13690,10469,3221,916,188500,29461
21693,14026,7667,1576,463300,29464
13821,11922,1899,1758,451200,29466
930,623,307,571,75100,29468
454,432,22,-,278200,29469
1706,1144,562,902,226800,29470
574,453,121,812,110600,29471
2750,2267,483,958,133900,29472
872,692,180,663,96700,29474
827,679,148,-,91300,29475
2477,1876,601,769,114500,29477
2604,1960,644,637,94700,29479
665,549,116,683,60200,29481
821,679,142,2167,1773100,29482
31407,23388,8019,1031,207300,29483
20748,13998,6750,1184,209700,29485
1085,925,160,1025,230300,29487
8436,5670,2766,747,96800,29488
5423,3711,1712,1628,532100,29492
59,49,10,-,78300,29493
18675,11321,7354,794,167900,29501
9756,7032,2724,916,151700,29505
7034,4055,2979,687,92300,29506
3869,3027,842,609,75100,29510
1989,1410,579,801,168100,29511
6101,3696,2405,620,69700,29512
336,263,73,747,52500,29516
488,320,168,630,64300,29518
166,134,32,-,-,29519
5537,3662,1875,669,92500,29520
768,478,290,549,70300,29525
16588,12174,4414,884,165600,29526
9424,6685,2739,795,139500,29527
928,712,216,527,119400,29530
8071,5253,2818,669,89700,29532
5998,3255,2743,604,81000,29536
1746,1339,407,634,66100,29540
3315,2808,507,877,124200,29541
206,151,55,-,137000,29543
2019,1520,499,685,153200,29544
603,356,247,623,98600,29545
1002,672,330,579,78200,29546
1073,638,435,663,69300,29547
12516,8715,3801,687,110900,29550
3561,2781,780,733,75800,29554
2030,1503,527,527,91900,29555
5025,3328,1697,614,67200,29556
5114,3083,2031,637,84400,29560
867,501,366,470,88000,29563
373,281,92,742,55900,29564
2616,1774,842,531,67100,29565
8048,6197,1851,930,181600,29566
145,120,25,596,44100,29567
6431,5157,1274,1007,165900,29568
6472,4739,1733,769,103000,29569
1386,845,541,446,62800,29570
5573,3421,2152,592,84000,29571
4642,3376,1266,925,276100,29572
3967,2784,1183,573,72200,29574
8274,6197,2077,964,215500,29575
14577,12352,2225,1153,222100,29576
13394,7337,6057,931,180900,29577
16639,10703,5936,1131,211900,29579
535,457,78,673,58900,29580
1741,1345,396,656,107900,29581
7759,5848,1911,1092,263400,29582
2033,1678,355,737,89200,29583
969,716,253,723,56700,29584
6971,5898,1073,1126,332500,29585
17498,12743,4755,978,177500,29588
920,578,342,668,58000,29590
1888,1339,549,630,58200,29591
301,213,88,516,46100,29592
740,472,268,718,56600,29593
78,25,53,-,81700,29594
936,727,209,1118,60800,29596
5701,1933,3768,949,320800,29601
14207,9311,4896,852,158900,29605
17651,8862,8789,1035,215300,29607
12101,7366,4735,817,199900,29609
11443,5973,5470,790,96100,29611
0,0,0,-,-,29613
91,0,91,504,-,29614
17208,9054,8154,993,233900,29615
11035,6460,4575,780,133900,29617
5195,3943,1252,682,99600,29620
16158,11363,4795,878,175900,29621
6261,3082,3179,655,72100,29624
12041,7795,4246,805,139000,29625
4969,3874,1095,815,124900,29626
7195,5457,1738,674,111100,29627
976,629,347,538,56100,29628
7080,3241,3839,708,139400,29630
6167,2758,3409,954,238500,29631
26,0,26,640,-,29634
543,511,32,-,172200,29635
1181,892,289,736,94600,29638
377,260,117,723,113200,29639
12268,8305,3963,780,130700,29640
12542,10441,2101,851,189600,29642
993,879,114,767,284200,29643
7692,5610,2082,828,154200,29644
3742,2866,876,733,105400,29645
11100,6350,4750,715,109800,29646
10486,6702,3784,772,154200,29649
13416,9427,3989,1097,235800,29650
17789,13749,4040,805,172100,29651
1751,1539,212,718,107800,29653
3648,2813,835,733,98200,29654
2764,2245,519,588,86000,29655
5953,4839,1114,777,118800,29657
189,189,0,-,88300,29658
47,25,22,575,107500,29659
2030,1639,391,691,105100,29661
6212,4379,1833,943,157000,29662
805,700,105,541,164500,29664
101,33,68,-,38300,29665
2557,2047,510,750,118900,29666
108,83,25,940,110600,29667
4724,3720,1004,727,115800,29669
3793,2739,1054,827,150700,29670
6730,5316,1414,706,133200,29671
5400,4132,1268,833,251400,29672
10346,7538,2808,801,157500,29673
2478,2217,261,-,290800,29676
9336,6094,3242,785,141000,29678
11982,9644,2338,1148,193100,29680
20703,18005,2698,1090,233000,29681
1513,1253,260,626,147500,29682
127,114,13,-,71600,29683
1603,1288,315,659,93400,29684
813,779,34,-,231800,29685
412,300,112,652,169600,29686
15968,11895,4073,904,166400,29687
1654,1393,261,760,202600,29689
7853,6257,1596,795,159700,29690
4490,3159,1331,656,115000,29691
1864,1213,651,696,68100,29692
5856,4055,1801,693,112700,29693
1987,1568,419,879,217200,29696
5112,3629,1483,769,134100,29697
3897,2765,1132,674,85300,29702
1429,1259,170,-,154700,29704
7612,5418,2194,623,94000,29706
12479,11739,740,1412,308400,29707
13321,10639,2682,1257,329100,29708
2624,2143,481,600,77300,29709
13817,10825,2992,1020,219700,29710
913,797,116,943,120200,29712
1192,973,219,830,104700,29714
12337,9693,2644,1119,260100,29715
543,515,28,1115,115500,29717
1541,1191,350,534,72500,29718
17458,12403,5055,733,128500,29720
7,0,7,-,-,29724
692,500,192,816,158800,29726
676,435,241,544,68900,29727
3691,2184,1507,705,99400,29728
789,617,172,657,98200,29729
22424,12704,9720,930,144200,29730
23500,16531,6969,988,189100,29732
0,0,0,-,-,29733
962,893,69,720,75100,29741
1024,892,132,833,110900,29742
373,205,168,705,159400,29743
11820,9181,2639,737,166900,29745
10810,6625,4185,818,127300,29801
16216,12702,3514,952,199100,29803
2398,2139,259,525,162700,29805
1131,802,329,751,92300,29809
1823,1160,663,598,39600,29810
4417,3140,1277,662,86100,29812
390,167,223,756,56500,29816
1643,1290,353,630,68400,29817
697,475,222,555,53700,29819
636,475,161,-,121800,29821
2612,1897,715,582,120300,29824
101,82,19,404,57100,29826
1225,865,360,623,62600,29827
373,226,147,344,70300,29828
4483,3395,1088,863,149500,29829
1779,1531,248,730,89600,29831
2004,1269,735,637,100900,29832
825,468,357,831,54800,29834
2933,2154,779,741,132200,29835
185,168,17,-,46600,29836
155,144,11,-,195000,29838
115,115,0,-,66700,29840
13511,8768,4743,799,141200,29841
2932,2054,878,729,91700,29842
438,360,78,733,102800,29843
72,66,6,-,-,29844
461,378,83,665,69600,29845
1818,1401,417,686,87900,29847
315,273,42,475,108500,29848
141,75,66,570,46300,29849
92,71,21,-,-,29850
2824,2040,784,779,97000,29851
2529,1666,863,608,94600,29853
1128,995,133,670,104300,29856
6068,5195,873,876,182200,29860
0,0,0,-,-,29899
5910,3651,2259,1038,198000,29902
0,0,0,-,-,29904
16,0,16,2136,-,29905
8930,4377,4553,1095,150000,29906
5068,4036,1032,1338,267800,29907
9156,8322,834,1602,289400,29909
15464,11256,4208,1412,304700,29910
539,421,118,684,68800,29911
0,0,0,-,-,29912
201,193,8,-,657300,29915
669,595,74,-,108200,29916
1549,1194,355,550,56800,29918
4414,3722,692,1227,199200,29920
75,61,14,500,55000,29921
355,330,25,-,53200,29922
150,117,33,689,45400,29923
1735,1181,554,658,108800,29924
11051,8704,2347,1263,455900,29926
3304,1970,1334,1100,164000,29927
7818,6437,1381,1314,581700,29928
391,306,85,904,73000,29929
59,45,14,-,49000,29932
401,286,115,821,115700,29934
1848,597,1251,1168,229100,29935
4930,3621,1309,840,156800,29936
167,157,10,-,-,29939
1455,1178,277,633,101300,29940
212,158,54,-,98100,29941
194,162,32,-,190400,29943
1666,1258,408,624,70500,29944
2298,1807,491,793,48400,29945
2817,1612,1205,831,329900,30002
23005,18024,4981,1389,420300,30004
13526,9145,4381,1483,441800,30005
11220,6000,5220,1032,169800,30008
6929,4308,2621,1537,345700,30009
4943,3923,1020,1127,162000,30011
9932,5453,4479,948,123900,30012
9584,6035,3549,1103,184100,30013
13389,8054,5335,894,172700,30014
18563,13007,5556,1142,139900,30016
7035,6257,778,1338,279600,30017
14282,12059,2223,1671,257800,30019
7030,1595,5435,961,149100,30021
23872,17203,6669,1499,409300,30022
24338,20697,3641,1653,346100,30024
3415,2742,673,980,213400,30025
8989,7850,1139,1154,275600,30028
12164,7488,4676,1113,459000,30030
17431,8178,9253,961,122000,30032
13128,8105,5023,1255,304800,30033
17061,10582,6479,1015,130800,30034
8398,4072,4326,1066,120000,30035
14871,7558,7313,1130,142100,30038
14983,11629,3354,1415,177500,30039
24891,20473,4418,1303,316000,30040
23257,19731,3526,1308,356400,30041
28525,19875,8650,1336,220300,30043
26988,17324,9664,1260,174400,30044
12434,10627,1807,1559,207200,30045
12870,6871,5999,1032,168700,30046
20739,15712,5027,1246,212400,30047
22536,18048,4488,1276,191900,30052
4085,3214,871,1067,164400,30054
1192,1021,171,957,169100,30055
800,686,114,825,138600,30056
20785,11553,9232,1152,133000,30058
13830,5763,8067,1020,167800,30060
23561,18441,5120,1294,331300,30062
18278,15097,3181,1153,285600,30064
20409,15964,4445,1319,257800,30066
20041,7858,12183,1172,337900,30067
12195,10396,1799,1238,405000,30068
184,59,125,659,68100,30070
7527,3713,3814,1183,176500,30071
377,252,125,1026,172100,30072
19555,16139,3416,1384,406500,30075
16815,10362,6453,1255,332800,30076
11213,8666,2547,1352,195400,30078
1504,499,1005,999,150400,30079
25614,12023,13591,1201,287600,30080
11575,7235,4340,1312,257700,30082
19725,9081,10644,1026,130700,30083
14119,9320,4799,1183,223600,30084
14162,11313,2849,1310,195500,30087
10318,5383,4935,1114,121100,30088
14793,6972,7821,1181,350600,30092
18201,5281,12920,1138,138900,30093
11350,8866,2484,1186,166500,30094
25825,10713,15112,1314,213000,30096
16369,11679,4690,1544,423800,30097
20003,15568,4435,1350,253800,30101
14672,10707,3965,1101,187100,30102
5804,4147,1657,920,141500,30103
1652,1121,531,805,114300,30104
769,633,136,700,144400,30105
8179,4533,3646,1113,154000,30106
4859,4325,534,1140,231600,30107
3115,2211,904,686,101200,30108
5119,3506,1613,683,132900,30110
2300,1796,504,681,127200,30113
19573,12953,6620,1103,267900,30114
13953,11858,2095,1285,288900,30115
8811,6789,2022,788,134200,30116
13332,6704,6628,846,146300,30117
0,0,0,-,-,30118
14544,9301,5243,926,167800,30120
8797,5018,3779,985,161800,30121
9339,4309,5030,1118,141600,30122
1197,823,374,747,142500,30124
8895,5568,3327,712,108600,30125
15544,11144,4400,1184,221900,30126
22629,18450,4179,1348,195100,30127
14235,10263,3972,1052,203200,30132
14797,9205,5592,990,149400,30134
22412,17027,5385,1172,171100,30135
692,470,222,811,150000,30137
1482,1033,449,810,118800,30139
8472,6110,2362,1150,173900,30141
8949,6859,2090,844,233800,30143
20568,11525,9043,1236,205300,30144
2754,2365,389,882,167000,30145
1804,1217,587,755,98800,30147
213,195,18,-,140500,30148
59,0,59,1042,-,30149
15093,11448,3645,1251,276100,30152
6476,4078,2398,813,116700,30153
16443,13086,3357,1151,157700,30157
13433,7959,5474,702,130100,30161
0,0,0,-,-,30164
15003,8846,6157,783,142500,30165
9182,3881,5301,1014,133100,30168
1154,998,156,761,113100,30170
1194,1025,169,990,182300,30171
2050,1227,823,762,103100,30173
2027,1520,507,859,181700,30175
2837,1748,1089,689,107700,30176
494,414,80,734,152600,30177
1140,956,184,732,171000,30178
6281,5137,1144,919,130800,30179
13007,9214,3793,1100,161500,30180
1080,801,279,561,114700,30182
2126,1794,332,1415,257200,30183
2461,1993,468,869,173600,30184
1509,1178,331,947,98500,30185
2874,2503,371,1085,179500,30187
24273,18677,5596,1361,246600,30188
14116,11147,2969,1408,244200,30189
4508,2995,1513,685,141500,30204
1112,1006,106,729,266700,30205
1154,1065,89,933,172900,30206
11420,6223,5197,1207,166500,30213
10939,8958,1981,1238,218600,30214
12402,10897,1505,1306,273200,30215
843,553,290,837,82600,30216
3651,2528,1123,628,113100,30217
746,723,23,775,113100,30218
1896,1345,551,1042,138600,30220
1567,895,672,511,88200,30222
13717,8332,5385,856,112000,30223
9777,6381,3396,918,140600,30224
13867,10369,3498,1145,162600,30228
3420,2181,1239,848,113500,30230
8132,5893,2239,844,143500,30233
729,496,233,1022,98300,30234
16302,8564,7738,973,138100,30236
12120,7035,5085,1088,104000,30238
10713,6608,4105,781,157500,30240
8769,4153,4616,887,126500,30241
8780,6839,1941,1268,168100,30248
0,0,0,-,-,30250
880,564,316,790,124000,30251
14932,12577,2355,1366,208000,30252
18997,11159,7838,1127,178300,30253
990,813,177,619,133900,30256
1750,1330,420,778,146900,30257
1032,855,177,967,137800,30258
1191,994,197,1086,193900,30259
7991,3777,4214,1023,97600,30260
22337,13990,8347,1001,185800,30263
12810,9569,3241,1356,222900,30265
3773,2497,1276,1015,162900,30268
13699,10267,3432,1402,338700,30269
5069,3570,1499,1164,105900,30273
12815,5241,7574,959,86700,30274
21,21,0,-,-,30275
5549,4860,689,1118,237800,30276
8110,7188,922,1360,243800,30277
24533,14580,9953,1157,156400,30281
28,16,12,-,118800,30284
268,213,55,-,73600,30285
8669,5645,3024,634,94000,30286
3205,2177,1028,868,109800,30288
16,7,9,-,225000,30289
3053,2652,401,999,278700,30290
8226,2967,5259,957,126000,30291
1774,1551,223,815,192700,30292
1111,833,278,708,78400,30293
14021,10601,3420,1216,151900,30294
1528,1113,415,740,151200,30295
9101,5814,3287,1153,110400,30296
9279,3433,5846,893,67000,30297
1314,361,953,1108,161900,30303
12706,7051,5655,1431,588900,30305
10886,6248,4638,1427,652600,30306
9027,5323,3704,1266,527400,30307
11617,3369,8248,1373,310200,30308
15565,7161,8404,1455,345500,30309
11356,4600,6756,951,152500,30310
14485,5559,8926,827,130000,30311
12402,4281,8121,1230,302700,30312
2249,842,1407,1083,231100,30313
7590,2312,5278,883,96900,30314
12564,4293,8271,842,155400,30315
13399,8433,4966,1173,258400,30316
5584,3776,1808,1044,354700,30317
22170,7926,14244,1154,238700,30318
20118,11052,9066,1505,519000,30319
0,0,0,-,-,30322
14944,5823,9121,1398,385100,30324
4056,1260,2796,1794,347600,30326
9470,7305,2165,1587,877400,30327
17176,9991,7185,1436,420700,30328
11584,2935,8649,1361,333900,30329
24463,12134,12329,997,166500,30331
0,0,0,-,-,30332
0,0,0,-,-,30334
131,9,122,1133,-,30336
5481,1668,3813,880,176800,30337
14640,9456,5184,1456,454800,30338
12761,4116,8645,1398,346400,30339
9524,4278,5246,1076,205000,30340
13049,6185,6864,1258,322200,30341
12977,6516,6461,1366,633800,30342
13205,5256,7949,1045,135300,30344
10427,5175,5252,1335,393600,30345
3103,162,2941,1553,342900,30346
27010,14218,12792,985,147500,30349
17106,6218,10888,1225,464300,30350
6390,2073,4317,927,90700,30354
5286,3073,2213,1148,298400,30360
2110,763,1347,1764,221900,30363
5129,2962,2167,627,67700,30401
714,492,222,666,105100,30410
1166,718,448,419,56600,30411
29,28,1,-,112500,30412
642,487,155,645,78800,30413
2722,2012,710,764,144900,30415
4071,2745,1326,660,88200,30417
475,332,143,348,75300,30420
1257,885,372,538,83400,30421
67,23,44,627,-,30423
599,514,85,802,87500,30425
271,177,94,761,75000,30426
4215,2947,1268,602,108300,30427
743,534,209,575,55800,30428
45,26,19,758,-,30429
1843,1091,752,524,72400,30434
4417,2960,1457,597,85300,30436
17,11,6,-,-,30438
4003,2297,1706,597,95900,30439
695,487,208,698,76500,30441
3008,2068,940,579,75200,30442
1149,660,489,661,76500,30445
360,294,66,757,85300,30446
24,19,5,-,61300,30448
42,20,22,725,66000,30449
847,636,211,894,80900,30450
18,15,3,-,-,30451
625,514,111,868,90000,30452
2747,1692,1055,528,73300,30453
256,245,11,-,81900,30454
225,181,44,540,55400,30455
804,620,184,575,75000,30456
2169,1412,757,588,68400,30457
15873,6488,9385,792,143500,30458
0,0,0,-,-,30460
5467,3609,1858,831,157600,30461
28,12,16,-,77500,30464
4470,3277,1193,657,82700,30467
147,105,42,337,159300,30470
1708,1205,503,554,74200,30471
955,762,193,626,71900,30473
6290,3690,2600,596,109000,30474
0,0,0,-,-,30475
1039,649,390,546,71100,30477
9914,4029,5885,862,190500,30501
8509,4651,3858,980,199800,30504
15373,12267,3106,1090,235300,30506
7957,5750,2207,960,153900,30507
2267,1762,505,729,115200,30510
1279,993,286,672,132700,30511
8955,6848,2107,770,200700,30512
4986,3724,1262,681,202800,30513
874,644,230,726,71300,30516
5213,4617,596,1187,258600,30517
16974,12815,4159,1160,244500,30518
14477,10859,3618,1604,242500,30519
1835,1324,511,675,127700,30520
1781,1271,510,534,106800,30521
449,421,28,-,172200,30522
5017,4096,921,768,171100,30523
3212,2138,1074,720,174500,30525
1562,1210,352,1092,209200,30527
9598,7155,2443,817,169100,30528
4208,2560,1648,757,129300,30529
2487,1917,570,826,124500,30530
3702,2719,983,768,143000,30531
9634,6624,3010,913,189900,30533
10677,8679,1998,911,223300,30534
2901,2187,714,818,158300,30535
3466,2637,829,815,202800,30536
617,517,100,768,194500,30537
1191,941,250,770,109300,30538
7632,5501,2131,759,165500,30540
598,503,95,-,199600,30541
12449,9926,2523,1181,221600,30542
1357,1192,165,1095,146600,30543
419,305,114,720,200800,30545
3291,2651,640,684,241600,30546
1151,906,245,695,173800,30547
6877,6207,670,1008,298100,30548
8535,6533,2002,798,205900,30549
680,521,159,1073,255400,30552
3326,2253,1073,673,150100,30553
2872,2245,627,875,152900,30554
964,726,238,613,131000,30555
2000,1616,384,824,100600,30557
1829,1321,508,836,125200,30558
1985,1631,354,1090,230600,30559
1991,1727,264,1173,182900,30560
491,345,146,691,81500,30562
1949,1692,257,823,140500,30563
1465,1122,343,742,171600,30564
1705,1362,343,828,131500,30565
2655,1760,895,1010,148700,30566
1241,1016,225,1188,207100,30567
594,503,91,348,159000,30568
1767,1489,278,1141,216500,30571
449,367,82,837,169600,30572
24,15,9,-,231300,30573
556,444,112,817,155200,30575
915,808,107,733,187500,30576
7639,5164,2475,726,106200,30577
33,24,9,-,-,30581
1846,1421,425,736,200100,30582
9637,3334,6303,824,101700,30601
0,0,0,-,-,30602
16649,5348,11301,826,171900,30605
18389,8319,10070,895,230000,30606
3657,2279,1378,827,157300,30607
0,0,0,-,-,30609
533,433,100,943,164000,30619
4767,4095,672,1211,167500,30620
1816,1630,186,827,303900,30621
4720,3235,1485,1160,268900,30622
29,18,11,-,-,30623
1082,802,280,641,77300,30624
929,729,200,796,229300,30625
973,776,197,697,101100,30627
2399,2102,297,691,137200,30628
1820,1292,528,729,117900,30629
953,627,326,575,116300,30630
584,399,185,625,84300,30631
3145,2415,730,677,111100,30633
771,666,105,807,91500,30634
6054,4333,1721,706,86100,30635
812,740,72,1045,169700,30641
5228,3976,1252,723,329200,30642
5810,4225,1585,724,136400,30643
2777,1768,1009,741,157500,30646
1151,923,228,570,88100,30648
4542,3336,1206,858,229900,30650
9255,5619,3636,950,171100,30655
5428,4240,1188,1008,204900,30656
374,259,115,665,83900,30660
3350,2111,1239,617,116400,30662
1171,768,403,656,202600,30663
15,15,0,-,-,30664
27,16,11,-,26700,30665
3439,2695,744,1005,167300,30666
318,245,73,838,121100,30667
766,621,145,441,80600,30668
1284,851,433,777,74000,30669
2989,1986,1003,785,89900,30673
6783,5675,1108,942,258500,30677
531,450,81,475,134500,30678
14828,10593,4235,978,159200,30680
2713,1952,761,853,141800,30683
14378,8585,5793,713,141700,30701
12081,8291,3790,693,116600,30705
6323,4808,1515,770,119900,30707
95,62,33,-,152200,30708
2406,1958,448,759,168700,30710
1381,1133,248,677,88200,30711
9286,5083,4203,739,162700,30720
18082,11119,6963,708,117100,30721
1557,1273,284,775,152300,30725
0,0,0,-,-,30726
7582,5193,2389,667,116500,30728
701,585,116,698,70300,30730
991,760,231,586,118800,30731
752,532,220,883,91300,30733
1339,997,342,857,155400,30734
2389,1920,469,639,122300,30735
15497,12518,2979,787,163800,30736
1589,1379,210,1289,143800,30738
2304,1720,584,914,161600,30739
3275,2752,523,764,150600,30740
11545,7559,3986,780,95500,30741
2987,1556,1431,757,116200,30742
465,311,154,862,128700,30746
5745,3942,1803,551,74700,30747
1268,1040,228,867,269200,30750
20,20,0,-,-,30751
3517,2326,1191,680,122600,30752
2496,1690,806,645,71700,30753
3501,2547,954,700,125500,30755
71,26,45,-,80700,30756
891,632,259,962,113000,30757
1814,1557,257,883,197200,30802
298,237,61,406,80400,30803
896,710,186,750,88200,30805
38,32,6,-,58600,30807
1473,1145,328,776,88900,30808
14686,12416,2270,1442,258500,30809
746,521,225,620,82000,30810
0,0,0,-,-,30812
13524,10007,3517,1176,186200,30813
2692,2101,591,695,134000,30814
14163,9875,4288,1002,112400,30815
794,576,218,620,126500,30816
3384,2476,908,718,132200,30817
241,148,93,-,59400,30818
415,326,89,765,72500,30820
376,324,52,480,56400,30821
287,216,71,-,-,30822
479,371,108,614,55000,30823
6642,3841,2801,694,115100,30824
1717,1060,657,634,67800,30828
4903,3383,1520,599,97500,30830
1465,786,679,568,79300,30833
6220,1864,4356,661,66700,30901
302,302,0,-,202400,30903
10041,4484,5557,809,103500,30904
935,3,932,1385,-,30905
19588,10902,8686,889,87300,30906
18140,13180,4960,1046,162200,30907
16787,8645,8142,885,159400,30909
0,0,0,-,-,30912
900,624,276,386,56200,31001
1014,720,294,507,58800,31002
37,37,0,-,69300,31003
6150,4667,1483,1155,171700,31005
1952,1275,677,618,84000,31006
430,348,82,236,66500,31007
7119,5300,1819,916,139700,31008
483,377,106,516,69400,31009
383,323,60,613,131300,31011
495,379,116,373,54200,31012
4316,3172,1144,616,97700,31014
8044,4290,3754,654,84400,31015
607,487,120,775,92500,31016
696,546,150,568,77000,31017
463,371,92,744,55000,31018
819,629,190,670,90500,31019
726,551,175,837,67800,31020
9980,5804,4176,606,118300,31021
624,463,161,652,128800,31022
5531,3523,2008,630,81300,31023
8406,6441,1965,792,156600,31024
372,372,0,-,189700,31025
3364,2167,1197,621,75100,31027
2398,1842,556,1032,142400,31028
5613,4264,1349,702,158400,31029
6322,3893,2429,647,101400,31030
2446,1859,587,673,80400,31031
5542,4307,1235,822,150200,31032
721,620,101,586,77600,31033
408,329,79,775,102200,31035
3965,2530,1435,721,126300,31036
1074,742,332,709,63800,31037
198,177,21,-,161600,31038
0,0,0,-,-,31039
273,205,68,500,56400,31041
501,416,85,858,58200,31042
1054,809,245,498,69900,31044
13,13,0,-,-,31045
1355,1272,83,398,167300,31046
5118,4139,979,1089,194500,31047
694,497,197,653,79800,31049
326,239,87,-,-,31050
57,44,13,442,46700,31051
3201,2820,381,821,165300,31052
529,386,143,633,60000,31054
2204,1332,872,580,76500,31055
838,558,280,561,67200,31057
758,631,127,636,81100,31058
731,584,147,634,72200,31060
15758,9065,6693,704,125600,31061
0,0,0,-,-,31062
1919,1195,724,610,74500,31063
3613,2674,939,781,136300,31064
491,443,48,392,90800,31065
414,319,95,595,124500,31066
104,97,7,-,150500,31067
1507,935,572,556,45700,31068
7532,4922,2610,852,147900,31069
438,345,93,430,76600,31070
490,395,95,550,64400,31071
514,430,84,449,79000,31072
1026,802,224,832,77200,31075
1302,987,315,613,64800,31076
576,436,140,571,72300,31077
1115,782,333,576,71400,31078
903,703,200,715,73800,31079
16,16,0,-,-,31081
3890,2552,1338,613,87900,31082
126,91,35,493,60900,31083
36,36,0,-,46300,31084
384,308,76,926,151600,31085
3011,2175,836,653,84700,31087
21364,13442,7922,963,137900,31088
1801,1044,757,694,77600,31089
376,268,108,481,77800,31090
1401,989,412,502,84300,31091
2686,1761,925,586,88500,31092
11139,5511,5628,817,91400,31093
458,369,89,623,97100,31094
2500,1665,835,523,62900,31096
472,397,75,683,106900,31097
1000,5,995,1207,-,31098
3368,692,2676,648,76300,31201
11766,5632,6134,731,90600,31204
9251,3828,5423,741,66900,31206
0,0,0,-,-,31207
13794,7402,6392,938,183200,31210
6352,3686,2666,734,96200,31211
0,0,0,-,-,31213
5976,4846,1130,895,134100,31216
5942,3760,2182,713,67400,31217
5668,3634,2034,978,162100,31220
1670,596,1074,678,111900,31301
3224,2320,904,854,138900,31302
892,721,171,872,180800,31303
35,35,0,-,-,31304
2343,1647,696,772,121200,31305
328,279,49,-,191600,31307
2819,2218,601,956,122200,31308
396,315,81,747,90400,31309
6932,5999,933,1014,164800,31312
16031,7458,8573,1021,126700,31313
0,0,0,-,-,31314
2563,0,2563,1275,-,31315
4169,3133,1036,912,134400,31316
109,98,11,-,-,31318
3100,2251,849,1073,145200,31320
2646,1913,733,775,129700,31321
9655,5501,4154,1273,199500,31322
587,499,88,647,83200,31323
9212,6360,2852,1582,269200,31324
7770,5362,2408,1081,177500,31326
153,153,0,-,384300,31327
1459,1058,401,1208,501800,31328
3575,2364,1211,877,130300,31329
3486,2959,527,919,132100,31331
7878,2521,5357,981,310900,31401
11665,4980,6685,982,121700,31404
13917,7366,6551,1128,198400,31405
13450,7786,5664,1063,184800,31406
5152,3223,1929,1263,176600,31407
3104,1143,1961,887,122000,31408
43,0,43,-,-,31409
10042,7515,2527,1282,271200,31410
4319,3948,371,1362,498500,31411
4294,1703,2591,826,83200,31415
21900,11558,10342,1082,164400,31419
6282,3226,3056,637,84400,31501
7669,5509,2160,680,82700,31503
3369,2457,912,521,81400,31510
816,620,196,496,103900,31512
5819,4407,1412,525,78500,31513
5418,4266,1152,683,102000,31516
325,244,81,509,85700,31518
1387,975,412,551,76800,31519
9070,3925,5145,764,105700,31520
7622,5751,1871,1430,389600,31522
5412,4491,921,871,166100,31523
0,0,0,-,-,31524
11487,6795,4692,1000,151000,31525
469,319,150,1127,372200,31527
232,192,40,-,49000,31532
6206,3198,3008,622,106800,31533
3950,2865,1085,682,117300,31535
3004,2060,944,555,85300,31537
5108,3284,1824,586,80700,31539
891,774,117,705,92300,31542
1634,1228,406,593,75300,31543
355,301,54,1038,63900,31544
5758,3291,2467,643,109300,31545
2641,1774,867,709,98300,31546
67,0,67,1535,-,31547
7796,4753,3043,865,159800,31548
744,548,196,602,39700,31549
307,259,48,-,81400,31550
303,210,93,507,156800,31551
380,355,25,-,-,31552
1827,1398,429,625,68900,31553
1816,1330,486,669,77100,31554
975,825,150,816,85400,31555
32,23,9,-,-,31556
1279,936,343,666,83800,31557
8120,4574,3546,1033,180900,31558
964,712,252,596,123600,31560
30,30,0,-,-,31561
759,650,109,569,78100,31562
519,422,97,626,106500,31563
898,762,136,826,155000,31565
1557,1410,147,488,74100,31566
298,137,161,619,114600,31567
306,257,49,-,156600,31568
2063,1661,402,810,154600,31569
11517,5069,6448,680,80900,31601
13462,5691,7771,831,138800,31602
8213,5141,3072,1005,161000,31605
1251,963,288,717,97900,31606
3882,2547,1335,731,97700,31620
797,573,224,655,68600,31622
35,30,5,-,75000,31623
476,412,64,507,56900,31624
398,239,159,-,99000,31625
1509,1090,419,777,109100,31626
114,74,40,633,100000,31627
294,224,70,1571,95600,31629
157,120,37,722,46900,31630
182,164,18,510,42200,31631
4625,3564,1061,1140,167200,31632
2100,1537,563,438,64200,31634
2360,1298,1062,665,103800,31635
4088,2641,1447,726,133100,31636
1097,809,288,683,78000,31637
464,369,95,720,-,31638
3997,2595,1402,591,94700,31639
691,595,96,788,118000,31641
1580,1130,450,532,62700,31642
3350,2325,1025,670,134900,31643
1918,1126,792,711,115900,31645
1322,797,525,814,58600,31647
373,233,140,684,61000,31648
454,387,67,-,108900,31649
1363,1021,342,367,80300,31650
0,0,0,-,-,31698
0,0,0,-,-,31699
7349,2615,4734,651,79000,31701
10859,4892,5967,702,71400,31705
10431,4442,5989,804,109800,31707
6099,2933,3166,751,115600,31709
279,179,100,673,78600,31711
453,306,147,619,66000,31712
2263,1575,688,517,83700,31714
1073,892,181,717,78900,31716
3385,1969,1416,656,76500,31719
127,91,36,760,66900,31720
7842,5645,2197,933,171000,31721
164,117,47,557,55000,31722
3311,2023,1288,660,84100,31730
519,426,93,710,112100,31733
370,284,86,1334,-,31735
836,585,251,645,88600,31738
101,30,71,852,-,31743
1215,755,460,574,86900,31744
78,57,21,377,38800,31747
981,605,376,697,79300,31749
6815,4082,2733,658,84800,31750
355,345,10,-,125800,31756
4100,2996,1104,931,155100,31757
8403,5898,2505,888,146400,31763
477,417,60,950,95900,31764
1109,732,377,489,95700,31765
7843,4398,3445,683,88100,31768
2015,1223,792,547,67300,31771
179,159,20,-,160900,31772
1471,1111,360,853,137200,31773
2400,1668,732,530,69800,31774
1142,979,163,554,61700,31775
949,788,161,560,86400,31778
3171,1831,1340,632,95300,31779
794,581,213,778,61400,31780
760,458,302,779,76900,31781
414,360,54,564,100800,31783
293,214,79,644,87900,31784
613,414,199,560,94400,31787
3379,2341,1038,625,123000,31788
467,339,128,904,130200,31789
753,507,246,634,67900,31790
4644,2851,1793,697,102200,31791
9434,4916,4518,869,159100,31792
3276,2502,774,657,157300,31793
10502,5552,4950,689,106500,31794
730,577,153,788,67100,31795
477,328,149,643,137500,31796
274,201,73,-,69100,31798
1349,1202,147,794,119000,31801
2130,1564,566,482,89400,31803
2118,1979,139,1094,237500,31804
1110,662,448,609,67800,31805
1851,1320,531,626,125000,31806
1067,926,141,641,205500,31807
2659,2519,140,1188,230300,31808
104,77,27,492,56300,31810
2123,1853,270,1061,222600,31811
263,223,40,-,102500,31812
117,83,34,-,-,31814
767,567,200,516,44800,31815
2081,1312,769,645,96600,31816
4119,3559,560,1311,267900,31820
79,79,0,-,-,31821
2183,1631,552,826,157700,31822
343,325,18,-,135200,31823
668,547,121,351,37800,31824
1027,779,248,564,74700,31825
850,582,268,797,112300,31826
887,636,251,610,81200,31827
314,300,14,-,281100,31829
780,479,301,857,126600,31830
1258,1123,135,660,163400,31831
139,121,18,-,89300,31832
2755,1876,879,649,123000,31833
474,404,70,491,90000,31836
2856,642,2214,647,140000,31901
6943,2304,4639,706,63000,31903
12744,6123,6621,870,165300,31904
3538,6,3532,1512,-,31905
8475,3633,4842,747,122100,31906
20352,11226,9126,930,110300,31907
15091,7337,7754,1065,160200,31909
10428,8503,1925,1488,269600,32003
1949,1646,303,665,93500,32008
1238,1123,115,1308,157000,32009
5374,4452,922,794,172900,32011
6996,5837,1159,894,135400,32024
7756,4435,3321,867,118100,32025
0,0,0,-,-,32026
1803,1489,314,1435,180300,32033
15707,12384,3323,1112,334200,32034
3944,3235,709,776,107700,32038
2495,2076,419,827,117900,32040
9305,7057,2248,1057,200900,32043
747,577,170,597,-,32044
3410,2593,817,913,150900,32046
2467,1562,905,598,83600,32052
1235,944,291,737,80000,32053
3504,2403,1101,617,120400,32054
5960,3991,1969,797,122700,32055
1218,968,250,798,101100,32058
1003,842,161,743,82800,32059
7856,5911,1945,741,113600,32060
122,87,35,-,190100,32061
625,599,26,-,69600,32062
4404,3054,1350,814,163500,32063
2441,1410,1031,717,110600,32064
12585,9433,3152,1222,199000,32065
1770,1490,280,518,105000,32066
19670,15393,4277,1165,161900,32068
1359,1007,352,641,104400,32071
109,109,0,-,67800,32072
15384,9885,5499,1098,173600,32073
233,19,214,1404,91900,32079
9736,7587,2149,1201,374500,32080
4925,4241,684,1924,389900,32081
12631,10219,2412,1420,527400,32082
540,321,219,749,113700,32083
13015,8797,4218,1021,195400,32084
11607,8948,2659,1144,228400,32086
1624,1244,380,677,75000,32087
5645,3521,2124,842,94600,32091
12477,10925,1552,1753,280400,32092
958,850,108,882,76500,32094
4099,3283,816,1219,317200,32095
1062,775,287,492,85500,32096
6837,5492,1345,1198,201900,32097
1062,894,168,1152,135600,32102
3013,2008,1005,769,126800,32110
2947,2070,877,602,100500,32112
1805,1459,346,845,84700,32113
13466,4402,9064,879,107400,32114
10674,5727,4947,971,104300,32117
9052,5588,3464,969,234800,32118
10041,5907,4134,1062,145800,32119
1781,1380,401,1770,225700,32124
12814,9675,3139,1128,191900,32127
8421,6993,1428,1465,264100,32128
9829,6652,3177,1122,139600,32129
1990,1609,381,1038,175600,32130
1653,1232,421,836,130600,32131
3365,2688,677,879,149000,32132
8,8,0,-,-,32133
3117,2583,534,728,79100,32134
3949,3255,694,1153,265100,32136
17198,13855,3343,1338,242400,32137
430,359,71,959,71000,32139
560,475,85,915,61400,32140
7605,6072,1533,1116,161100,32141
1951,1593,358,847,88800,32145
214,167,47,-,21800,32147
4212,2991,1221,707,59900,32148
158,90,68,838,145800,32157
15318,12422,2896,1040,186600,32159
30155,28752,1403,1454,271400,32162
16964,11972,4992,1281,199400,32164
11689,9089,2600,1076,217400,32168
5415,4267,1148,1335,367600,32169
22481,17392,5089,1080,215300,32174
7084,5424,1660,1204,222900,32176
10389,6514,3875,731,96300,32177
3254,2563,691,799,77300,32179
1415,1211,204,825,123000,32180
997,732,265,778,92400,32181
724,541,183,790,124200,32187
2631,2058,573,822,70200,32189
422,326,96,628,119600,32190
307,233,74,707,115000,32193
1215,1034,181,1439,129700,32195
1986,219,1767,612,117400,32202
3815,1035,2780,987,202400,32204
13020,6045,6975,930,162800,32205
6550,2812,3738,783,81900,32206
14599,7387,7212,936,164500,32207
12334,6687,5647,945,78400,32208
13167,5981,7186,779,59800,32209
23643,12387,11256,969,128000,32210
13312,6045,7267,903,127600,32211
231,4,227,1685,-,32212
15623,7298,8325,1049,158200,32216
8671,4335,4336,889,195800,32217
22199,13623,8576,1100,169400,32218
4335,3590,745,916,140900,32219
4703,3907,796,972,144200,32220
10274,7667,2607,1264,165300,32221
3945,2810,1135,1119,193100,32222
9785,8165,1620,1187,269100,32223
16089,9691,6398,1291,299000,32224
20210,13793,6417,1341,225500,32225
5577,4842,735,1684,223100,32226
413,5,408,1644,-,32227
0,0,0,-,-,32228
9655,5619,4036,1191,270400,32233
2253,1726,527,799,110700,32234
21504,12565,8939,1083,133000,32244
20318,10688,9630,1201,182100,32246
12380,8581,3799,1426,366600,32250
4763,2383,2380,900,62000,32254
21443,8090,13353,1217,272200,32256
15541,9678,5863,1092,209800,32257
12802,8776,4026,1428,236700,32258
16519,14246,2273,1846,349400,32259
3048,2044,1004,1372,401000,32266
12084,6155,5929,986,166800,32277
12813,3897,8916,995,155200,32301
20680,10548,10132,1041,152000,32303
17635,2177,15458,944,91800,32304
7723,4724,2999,862,101600,32305
10321,5661,4660,1112,229900,32308
12438,10002,2436,1104,261400,32309
5621,2479,3142,890,98700,32310
8401,5299,3102,1194,209700,32311
12544,10531,2013,1329,302100,32312
5474,4874,600,1268,260300,32317
1519,1024,495,697,154800,32320
1630,1209,421,627,63800,32321
1142,900,242,757,150600,32322
91,67,24,-,-,32323
1757,1166,591,756,67900,32324
9578,7808,1770,903,149600,32327
1423,1111,312,855,180400,32328
229,131,98,840,75200,32330
1593,1280,313,684,73100,32331
473,293,180,612,72900,32332
4828,3818,1010,455,117700,32333
829,646,183,581,117900,32334
462,399,63,-,111100,32336
3885,2660,1225,658,98200,32340
1237,942,295,959,147700,32343
5047,3817,1230,782,148400,32344
924,748,176,1579,116400,32346
2950,2400,550,626,97500,32347
3755,2789,966,739,71100,32348
629,515,114,695,107500,32350
6245,4290,1955,656,84300,32351
2380,1869,511,681,107500,32352
124,86,38,933,170800,32355
0,0,0,-,-,32356
851,758,93,840,115200,32358
704,480,224,-,108800,32359
161,148,13,-,84100,32361
0,0,0,-,-,32399
9333,4668,4665,883,126900,32401
641,0,641,1639,-,32403
14263,9810,4453,975,157400,32404
12846,7526,5320,1000,177100,32405
4760,2526,2234,1363,222000,32407
7970,5239,2731,1127,238600,32408
3743,3156,587,685,163300,32409
499,371,128,1356,248700,32410
6554,4881,1673,1111,256000,32413
896,787,109,689,82300,32420
1605,1332,273,604,77800,32421
430,372,58,-,94200,32423
2177,1725,452,594,91800,32424
4692,3425,1267,695,91800,32425
319,275,44,813,81700,32426
464,345,119,625,89800,32427
5872,4559,1313,773,120100,32428
440,360,80,-,75400,32430
1733,1287,446,673,102500,32431
0,0,0,-,-,32432
6395,4510,1885,808,100800,32433
2971,2166,805,725,136900,32435
330,216,114,550,92700,32437
1517,1383,134,467,76100,32438
3995,2872,1123,1023,208100,32439
2102,1444,658,655,105400,32440
1486,1040,446,608,143600,32442
1229,981,248,675,88400,32443
8033,5882,2151,1196,213400,32444
501,316,185,675,96700,32445
4016,2604,1412,743,137000,32446
0,0,0,-,-,32447
3871,2445,1426,461,85400,32448
161,153,8,-,73100,32449
1641,1324,317,690,86500,32455
3339,2402,937,1150,208900,32456
7224,5663,1561,1605,378200,32459
1483,1094,389,659,89400,32460
25,25,0,-,-,32461
1423,1111,312,667,98800,32462
88,34,54,637,81100,32463
1857,1682,175,675,103000,32464
2599,1983,616,775,90900,32465
1940,1665,275,940,117200,32466
4324,2105,2219,728,135200,32501
1535,837,698,1004,160500,32502
12086,7475,4611,913,171200,32503
8950,5312,3638,982,172600,32504
11027,5199,5828,898,66000,32505
14210,8062,6148,1052,123600,32506
12914,7514,5400,959,155600,32507
545,0,545,1328,-,32508
0,0,0,-,-,32509
0,0,0,-,-,32511
16570,8131,8439,1021,145400,32514
14638,11258,3380,1076,134500,32526
7,7,0,-,-,32530
2206,1870,336,991,178100,32531
10755,9228,1527,1058,171000,32533
6437,4479,1958,1067,119600,32534
1837,1238,599,722,79200,32535
8466,5391,3075,1084,198500,32536
9495,6747,2748,986,168300,32539
8174,5254,2920,1554,368000,32541
738,0,738,1472,-,32542
304,0,304,1440,-,32544
14819,7134,7685,1051,182700,32547
9643,5585,4058,1022,182000,32548
3628,2594,1034,1201,396500,32550
4203,3465,738,1500,419100,32561
10208,7732,2476,1282,243000,32563
1012,846,166,1191,169000,32564
2072,1604,468,948,120600,32565
14632,11684,2948,1360,237100,32566
1289,1038,251,732,120700,32567
1115,956,159,682,156400,32568
4873,3346,1527,1091,191700,32569
11949,7981,3968,965,144500,32570
12753,10017,2736,1009,186700,32571
1762,1511,251,644,139200,32577
12384,9429,2955,1275,283800,32578
4349,2967,1382,1193,287000,32579
1533,953,580,1154,224800,32580
8843,6772,2071,1033,141800,32583
7907,2036,5871,881,159600,32601
1732,244,1488,851,290000,32603
10248,7263,2985,1251,193200,32605
9456,4822,4634,1210,214000,32606
11802,3979,7823,950,216700,32607
19118,8112,11006,1036,240300,32608
7153,3993,3160,868,101100,32609
5,0,5,-,-,32612
5244,4103,1141,1001,189300,32615
378,214,164,747,87400,32616
1707,1345,362,622,157500,32617
2832,2343,489,762,161600,32618
1979,1676,303,760,93300,32619
1976,1464,512,643,81000,32621
422,321,101,1014,116300,32622
629,458,171,770,179000,32625
3613,2784,829,727,97100,32626
1537,1137,400,706,72800,32628
102,102,0,-,271200,32631
97,86,11,-,-,32639
4393,3611,782,728,109900,32640
4749,2841,1908,863,95800,32641
4558,3862,696,728,168900,32643
169,166,3,-,-,32648
5974,4625,1349,935,199100,32653
5533,4359,1174,863,125300,32656
98,85,13,-,98500,32658
181,132,49,893,156300,32664
2745,2289,456,826,141000,32666
1811,1314,497,774,262500,32667
2031,1755,276,1039,149200,32668
4967,4193,774,980,215200,32669
4424,3501,923,591,74500,32680
16,16,0,-,-,32681
65,59,6,-,-,32683
2011,1422,589,668,169400,32686
68,68,0,-,91900,32692
4323,3386,937,689,94200,32693
738,519,219,559,127700,32694
4620,3576,1044,731,128500,32696
99,15,84,825,-,32697
9910,4960,4950,1144,175800,32701
1160,768,392,2463,58900,32702
18259,11676,6583,1129,189900,32703
14857,9539,5318,1178,181900,32707
17697,13156,4541,1309,249500,32708
727,660,67,-,191500,32709
15790,12613,3177,1415,243500,32712
8324,6722,1602,1131,208000,32713
15450,7092,8358,1211,200300,32714
12493,8476,4017,928,191800,32720
14711,10361,4350,1006,175000,32724
16949,13099,3850,1185,160000,32725
8489,5313,3176,872,155700,32726
2639,941,1698,1135,156700,32730
1757,1703,54,-,317700,32732
2106,1792,314,1157,137000,32735
3649,3331,318,1032,272100,32736
14781,11415,3366,1174,154000,32738
1494,1225,269,1014,164900,32744
17365,11169,6196,1449,306600,32746
9262,6402,2860,1260,239600,32750
8352,5622,2730,1359,307800,32751
4161,3696,465,850,172900,32754
11369,8159,3210,1072,216600,32757
1218,891,327,895,187800,32759
9296,5818,3478,1113,133500,32763
1151,1082,69,883,245700,32764
21821,15254,6567,1494,285400,32765
5247,4622,625,1801,339400,32766
1109,900,209,916,96800,32767
20450,12227,8223,1165,198700,32771
11574,6552,5022,1084,152000,32773
4001,3176,825,1285,229100,32776
9561,7187,2374,990,151300,32778
10962,8860,2102,1418,335100,32779
15226,10569,4657,947,158200,32780
4320,3248,1072,749,143500,32784
11195,7585,3610,1289,491500,32789
20801,9619,11182,1190,227800,32792
8043,6267,1776,971,142500,32796
1435,1344,91,1023,95300,32798
7524,1799,5725,1331,310200,32801
9600,5022,4578,1314,284600,32803
7775,5115,2660,1216,332300,32804
7344,2536,4808,791,139300,32805
10985,6478,4507,1176,275000,32806
11720,5453,6267,1113,153800,32807
18544,7408,11136,995,121400,32808
9377,4682,4695,1001,159700,32809
13454,6984,6470,1168,156000,32810
14954,3786,11168,1132,97200,32811
14009,7886,6123,1128,239600,32812
3542,1591,1951,1834,474000,32814
11593,6620,4973,1258,220400,32817
17421,9681,7740,1072,170300,32818
10131,6222,3909,1355,335400,32819
2983,2468,515,1438,278000,32820
7231,2804,4427,1380,207100,32821
22323,8941,13382,1158,126300,32822
12894,9001,3893,1475,227100,32824
20184,12782,7402,1250,219500,32825
7644,4256,3388,1142,171700,32826
3414,2240,1174,1840,289500,32827
22160,13827,8333,1549,274000,32828
6113,4799,1314,1458,224100,32829
6,0,6,-,-,32830
27,27,0,-,12800,32831
9406,6012,3394,1582,335900,32832
3357,2706,651,1214,263900,32833
17491,6782,10709,1327,249100,32835
7108,4828,2280,1436,460900,32836
15791,9365,6426,1413,238300,32837
17483,3850,13633,1083,152800,32839
10508,5117,5391,963,146400,32901
6015,5019,996,1351,340000,32903
11938,9269,2669,1332,215500,32904
9432,5188,4244,973,121500,32905
14834,11885,2949,1123,158100,32907
3955,3188,767,1370,156400,32908
10617,8695,1922,1030,168700,32909
5372,3350,2022,893,247200,32920
6293,2564,3729,805,104500,32922
460,0,460,1494,-,32925
8279,6645,1634,962,153600,32926
10032,8666,1366,1059,150000,32927
7216,4997,2219,1159,323100,32931
7269,6320,949,1414,244600,32934
16764,9821,6943,1026,157500,32935
11088,8700,2388,1271,298200,32937
17013,13994,3019,1460,278000,32940
1849,1311,538,758,140200,32948
844,805,39,-,326900,32949
1766,1589,177,1294,281100,32950
5369,4530,839,1640,344900,32951
8266,6992,1274,1132,287700,32952
9657,7076,2581,1021,278100,32953
15317,12116,3201,1270,228800,32955
11493,9488,2005,992,191200,32958
8657,5007,3650,877,166800,32960
9021,7483,1538,993,144700,32962
7276,6784,492,1336,652400,32963
7955,6160,1795,1092,144700,32966
7886,6091,1795,922,235400,32967
4383,4040,343,1281,266400,32968
110,94,16,-,-,32970
4872,4386,486,794,93300,32976
185,128,57,2015,316000,33001
6588,3222,3366,1258,207400,33004
18467,9598,8869,1247,207900,33009
15294,4560,10734,1021,241600,33010
24396,11163,13233,1160,227000,33012
9698,5633,4065,1156,246500,33013
14568,6401,8167,1306,266400,33014
21223,10783,10440,1434,262400,33015
15348,8200,7148,1389,221000,33016
14637,10868,3769,1658,278800,33018
6560,4868,1692,1539,465100,33019
18578,6271,12307,1113,216800,33020
18335,11753,6582,1359,267400,33021
20576,13670,6906,1277,214400,33023
23605,15661,7944,1381,242100,33024
25464,11671,13793,1410,239600,33025
11230,9172,2058,1665,269400,33026
21520,16934,4586,1484,321600,33027
8133,6277,1856,2050,390000,33028
13124,11607,1517,2735,403700,33029
8950,3302,5648,1045,251600,33030
1853,1550,303,1982,396900,33031
13194,7535,5659,1270,251800,33032
15638,8741,6897,1316,229300,33033
4744,1566,3178,1107,132400,33034
4563,2157,2406,1514,195900,33035
1529,1212,317,1379,705500,33036
4708,3686,1022,1473,460700,33037
100,100,0,-,341200,33039
13968,6226,7742,1742,557100,33040
3070,2351,719,1927,487700,33042
2088,1517,571,1645,365600,33043
4115,2320,1795,1332,451600,33050
320,227,93,1211,603000,33051
9569,4255,5314,981,165200,33054
11129,8395,2734,1315,202300,33055
9791,6152,3639,1277,181200,33056
13295,5921,7374,1160,261200,33060
12158,8806,3352,1416,351300,33062
22907,15508,7399,1432,173500,33063
20761,12795,7966,1343,188900,33064
17857,9053,8804,1407,274100,33065
8319,6751,1568,1254,130400,33066
8753,6095,2658,1698,446500,33067
16841,9794,7047,1447,182400,33068
10494,5263,5231,1310,162100,33069
2070,1407,663,1654,508400,33070
12851,8366,4485,1625,368200,33071
11552,6701,4851,1742,325900,33073
12006,9811,2195,2338,521900,33076
0,0,0,-,-,33101
210,185,25,-,"2,000,000+",33109
94,0,94,2133,-,33122
21349,5453,15896,1053,246400,33125
18242,6045,12197,1290,206800,33126
10207,2889,7318,1027,206200,33127
3213,185,3028,837,221000,33128
6545,3013,3532,2050,506800,33129
14007,1863,12144,1171,328600,33130
10349,3413,6936,2279,468700,33131
6936,1968,4968,2041,485300,33132
13913,6865,7048,1490,678800,33133
16167,8373,7794,1467,493800,33134
14623,2867,11756,1041,288400,33135
6268,788,5480,879,207200,33136
10134,2695,7439,1755,364600,33137
12587,5730,6857,1048,471700,33138
20840,7041,13799,1469,430800,33139
8674,5028,3646,1653,703500,33140
17569,5181,12388,1358,344800,33141
19715,5341,14374,909,171900,33142
12414,6408,6006,1386,599600,33143
9262,5368,3894,1386,300000,33144
11640,5644,5996,1478,365800,33145
4332,3169,1163,2190,903300,33146
14311,6720,7591,1025,154700,33147
4428,3081,1347,2548,1208300,33149
9779,3046,6733,886,209300,33150
6185,3546,2639,1831,634700,33154
14471,10137,4334,1606,358500,33155
11107,7850,3257,1738,857500,33156
19697,13042,6655,1205,312700,33157
1997,1892,105,2122,683400,33158
19164,10242,8922,1549,294100,33160
16634,6373,10261,1138,242200,33161
13093,7316,5777,1154,207900,33162
16288,11129,5159,1408,321700,33165
7923,3733,4190,1330,368700,33166
5786,2976,2810,1149,191300,33167
6737,4829,1908,1325,207600,33168
12163,6488,5675,1198,210100,33169
3893,2418,1475,1054,282800,33170
14017,6356,7661,1590,171100,33172
10987,7309,3678,1596,328800,33173
9965,5615,4350,1340,272900,33174
15643,11668,3975,1640,302600,33175
17228,11559,5669,1417,417600,33176
14827,10520,4307,1586,262700,33177
15272,7631,7641,2100,390800,33178
16181,9495,6686,1278,181100,33179
14485,9457,5028,1945,393500,33180
7627,2991,4636,1238,257800,33181
3771,3258,513,1853,342500,33182
11794,7415,4379,1538,261400,33183
6065,4609,1456,1579,256400,33184
8187,6943,1244,2328,367900,33185
21439,14235,7204,1712,299000,33186
5323,4612,711,2108,360500,33187
7897,4801,3096,1214,263200,33189
4675,2043,2632,1368,266200,33190
14427,8920,5507,1544,293600,33193
1428,1157,271,1825,374100,33194
14504,9647,4857,1878,331000,33196
7768,3547,4221,2049,559300,33301
9549,3396,6153,1299,422700,33304
6313,4052,2261,1372,402600,33305
1708,1041,667,1119,477200,33306
15194,10352,4842,1442,410100,33308
13402,8071,5331,1320,190000,33309
23494,9716,13778,1109,157700,33311
17943,10258,7685,1356,256800,33312
19959,8514,11445,1186,131900,33313
9244,3814,5430,1483,171400,33314
6068,3376,2692,1457,315000,33315
5061,3120,1941,1208,595100,33316
12668,9514,3154,1396,311600,33317
18315,11797,6518,1289,139100,33319
19526,14337,5189,1443,173800,33321
16678,13709,2969,1701,169700,33322
7338,5205,2133,1939,320900,33323
19037,10614,8423,1655,244200,33324
9137,7126,2011,1703,314800,33325
10794,7473,3321,1872,379200,33326
6501,4880,1621,2649,538000,33327
10151,7817,2334,1599,363500,33328
4615,4236,379,2739,539800,33330
7417,6446,971,2401,492600,33331
3173,2875,298,2611,634900,33332
12169,6541,5628,1163,290400,33334
11948,6410,5538,1494,229500,33351
11406,4419,6987,1364,250900,33401
4208,2042,2166,1219,198100,33403
9981,5289,4692,1150,154400,33404
6992,4222,2770,1178,276600,33405
8776,5774,3002,1281,218800,33406
10733,4422,6311,1181,173300,33407
9118,7134,1984,1424,367900,33408
10947,4856,6091,1259,167300,33409
14383,9863,4520,1618,326700,33410
24555,18042,6513,1433,284400,33411
5390,4776,614,2016,375700,33412
5038,3313,1725,1540,254800,33413
19749,14348,5401,1860,364300,33414
16586,9131,7455,1185,135800,33415
14347,7886,6461,1170,82100,33417
16963,13538,3425,1766,399200,33418
9967,5906,4061,1586,206900,33426
13836,9756,4080,1663,291200,33428
7498,2259,5239,601,111500,33430
7974,5423,2551,1758,400800,33431
10547,6636,3911,1701,620600,33432
18298,12978,5320,1816,294100,33433
9849,8114,1735,1149,246800,33434
13696,8032,5664,1428,172300,33435
17333,12548,4785,1528,236500,33436
18312,15962,2350,1536,289500,33437
105,96,9,-,107800,33438
6496,4221,2275,804,86500,33440
11104,5630,5474,1228,233300,33441
13802,9247,4555,1588,151700,33442
8705,4528,4177,1392,291000,33444
14077,9257,4820,1643,204400,33445
13456,11406,2050,1199,281500,33446
3970,3628,342,1840,453800,33449
9613,7895,1718,1036,271600,33455
21646,15513,6133,1581,365300,33458
11004,4691,6313,1098,211000,33460
15080,7146,7934,1207,152700,33461
12410,7718,4692,1247,216700,33462
18511,12776,5735,1360,200600,33463
20087,17364,2723,1257,303700,33467
6593,5721,872,1443,389100,33469
8159,7283,876,1886,342200,33470
2208,1691,517,762,69000,33471
7967,7243,724,2068,299800,33472
3969,3411,558,3003,590000,33473
2665,921,1744,581,98200,33476
6990,5806,1184,1742,423800,33477
4623,4487,136,2191,412700,33478
5701,4901,800,1692,975900,33480
6235,4351,1884,1797,572900,33483
14177,10910,3267,1375,149200,33484
9061,7108,1953,1576,427800,33486
9332,7298,2034,1827,406400,33487
483,255,228,803,82200,33493
9986,8681,1305,1809,377800,33496
5250,4906,344,2633,421600,33498
57,52,5,-,356300,33503
10454,6411,4043,1150,171800,33510
22101,11189,10912,1260,201900,33511
3660,2858,802,760,114000,33513
717,474,243,911,102200,33514
218,151,67,-,89400,33521
6612,4438,2174,780,119400,33523
7203,5394,1809,861,154700,33525
4738,3530,1208,831,229600,33527
5117,3343,1774,1015,188000,33534
1983,1579,404,822,85100,33538
3803,2826,977,744,82300,33540
9319,7292,2027,1008,76900,33541
10010,6807,3203,839,72200,33542
9387,7674,1713,1445,226800,33543
9582,6827,2755,1555,254800,33544
6124,4521,1603,1514,221100,33545
7995,6742,1253,1788,326200,33547
2605,2352,253,1588,362700,33548
6816,5290,1526,1159,230500,33549
8085,7173,912,1307,375600,33556
9047,6288,2759,1099,342700,33558
6743,4023,2720,1211,206200,33559
9939,5282,4657,952,140000,33563
6158,4795,1363,924,161300,33565
7369,5307,2062,1064,207200,33566
3741,2846,895,858,194500,33567
9801,7914,1887,1373,215800,33569
9868,7023,2845,904,165200,33570
7887,6663,1224,1548,276300,33572
12916,10395,2521,1776,174400,33573
2132,1904,228,908,199900,33576
19848,11022,8826,1283,197500,33578
11096,8611,2485,1708,227000,33579
9217,6970,2247,1151,171900,33584
471,340,131,786,165700,33585
3980,2519,1461,859,112300,33592
12690,10155,2535,1396,188500,33594
10019,8733,1286,1673,274800,33596
2633,2109,524,802,105800,33597
6138,4734,1404,832,230600,33598
8552,3230,5322,1597,348500,33602
8544,4469,4075,1003,192600,33603
15220,8094,7126,979,164800,33604
7092,2507,4585,996,108100,33605
8406,3510,4896,1455,538700,33606
10785,4356,6429,1302,172800,33607
8311,4627,3684,1169,359700,33609
16240,6895,9345,1019,115800,33610
14850,8679,6171,1146,281700,33611
18866,6494,12372,931,146200,33612
14554,4403,10151,886,162800,33613
18397,7323,11074,999,175100,33614
17455,9204,8251,1135,166500,33615
6797,3156,3641,1313,197200,33616
18212,7071,11141,999,172500,33617
11512,7572,3940,1125,278100,33618
13208,6006,7202,1160,112200,33619
11,0,11,-,-,33620
570,0,570,2197,-,33621
15190,9667,5523,1261,235400,33624
10374,6832,3542,1317,234600,33625
11519,7716,3803,1537,360800,33626
10694,8639,2055,1361,544200,33629
7438,4248,3190,1313,171500,33634
7111,4444,2667,1383,197400,33635
6429,2622,3807,1140,152300,33637
24854,14110,10744,1383,295900,33647
8878,3104,5774,925,376100,33701
13452,8516,4936,1037,169500,33702
10843,8398,2445,1290,248900,33703
7614,5550,2064,1018,384400,33704
10919,6154,4765,1111,182500,33705
8536,6475,2061,1166,423300,33706
12127,8395,3732,1098,210100,33707
8168,6131,2037,1230,299700,33708
10615,7770,2845,949,121900,33709
13711,10540,3171,1127,194200,33710
6969,4212,2757,1151,161600,33711
9196,4885,4311,1047,191000,33712
12999,8948,4051,1099,164200,33713
7939,5121,2818,996,103700,33714
3690,3340,350,1731,384200,33715
9309,1666,7643,1274,216800,33716
0,0,0,-,-,33744
9736,5260,4476,954,194300,33755
13584,7909,5675,962,195200,33756
7933,4409,3524,1283,175600,33759
6651,3076,3575,1104,147100,33760
8758,7081,1677,1196,171200,33761
2693,1999,694,1340,233400,33762
9298,6606,2692,1094,128400,33763
11787,8488,3299,1189,193000,33764
6154,2939,3215,1052,158300,33765
3976,3255,721,1776,468300,33767
11621,6692,4929,1053,168200,33770
13404,7753,5651,1064,79300,33771
9848,7342,2506,1144,209400,33772
7115,5243,1872,1014,185800,33773
7745,5549,2196,1015,222900,33774
4964,4534,430,1566,292100,33776
6803,5582,1221,1270,184100,33777
5981,4681,1300,1074,160500,33778
9772,6070,3702,906,152600,33781
9314,6849,2465,1230,152400,33782
2878,2034,844,1254,474500,33785
742,646,96,2396,612400,33786
11788,5920,5868,834,85000,33801
11722,7122,4600,1034,152800,33803
9041,4444,4597,981,92100,33805
11147,7750,3397,1078,164500,33809
17545,13229,4316,1089,154800,33810
7975,5762,2213,1095,179400,33811
4328,3504,824,1240,185500,33812
13055,10469,2586,1199,224200,33813
5690,3272,2418,764,27900,33815
11194,7902,3292,862,149400,33823
9110,6429,2681,802,89900,33825
953,832,121,1238,157100,33827
9687,6287,3400,833,134900,33830
1736,1074,662,780,72300,33834
9677,7466,2211,1348,190000,33837
1193,686,507,898,115600,33838
1119,731,388,823,129700,33839
3017,2300,717,759,96800,33841
3503,2781,722,731,71300,33843
12153,7866,4287,937,124300,33844
47,39,8,-,-,33847
169,98,71,-,57000,33848
300,256,44,-,96100,33849
3177,2322,855,882,120500,33850
350,323,27,1063,144100,33851
8568,7060,1508,778,137600,33852
4082,2051,2031,751,149900,33853
188,95,93,617,41000,33854
0,0,0,-,-,33855
191,0,191,541,-,33856
991,632,359,438,-,33857
4332,3097,1235,911,118600,33859
8141,6269,1872,988,132200,33860
224,176,48,-,-,33865
166,166,0,-,144200,33867
3637,2999,638,867,109000,33868
8696,5365,3331,744,84600,33870
7211,5801,1410,900,105100,33872
4489,2724,1765,702,86100,33873
4701,3948,753,992,150500,33875
2033,1717,316,1036,104800,33876
106,36,70,-,-,33877
13686,8904,4782,907,117100,33880
13059,8958,4101,897,93200,33881
11973,8554,3419,1150,180900,33884
1483,1167,316,719,83800,33890
3610,2128,1482,1546,205400,33896
7009,4897,2112,1559,168600,33897
6318,4937,1381,899,118800,33898
8701,3596,5105,933,194900,33901
10711,8457,2254,923,101200,33903
13395,10295,3100,1161,236800,33904
11778,7890,3888,1059,164000,33905
9536,4119,5417,1137,155700,33907
17577,12628,4949,1414,270600,33908
10215,6602,3613,1245,187500,33909
7979,6681,1298,1413,278800,33912
8959,7744,1215,1639,307000,33913
14916,11526,3390,1189,282900,33914
8553,3038,5515,988,111600,33916
12570,10329,2241,854,107700,33917
13933,10329,3604,1192,202600,33919
2098,1893,205,926,265100,33920
331,276,55,-,1198700,33921
1704,1442,262,972,196500,33922
45,34,11,-,-,33924
11090,9566,1524,1681,313500,33928
357,302,55,-,136800,33930
5467,4873,594,1128,362000,33931
6911,4664,2247,765,96100,33935
8254,5088,3166,919,131300,33936
70,70,0,-,-,33944
0,0,0,-,-,33945
1083,978,105,1707,482700,33946
4179,3541,638,1161,248200,33947
7005,5663,1342,1047,178900,33948
11663,9556,2107,995,283900,33950
13437,9380,4057,972,148200,33952
2929,2672,257,1330,223800,33953
3944,3112,832,1259,209200,33954
4444,4045,399,1196,242700,33955
1680,1452,228,1176,230800,33956
3684,3151,533,1545,721200,33957
291,273,18,-,109500,33960
0,0,0,-,-,33965
4249,3107,1142,1158,265800,33966
8190,6143,2047,1335,224700,33967
7396,5322,2074,1184,168300,33971
4506,3355,1151,1158,179100,33972
4097,962,3135,1051,217600,33973
4692,2986,1706,1241,162600,33974
4555,3172,1383,1212,150000,33976
5775,4326,1449,862,151300,33980
4656,3941,715,1247,256300,33981
4067,3323,744,960,124800,33982
5897,4868,1029,1061,221300,33983
11417,8208,3209,1167,215500,33990
7722,5964,1758,1501,240800,33991
8588,6865,1723,1461,219100,33993
0,0,0,-,-,34101
5598,3993,1605,1262,1016900,34102
6115,4860,1255,1433,768400,34103
10494,7193,3301,1229,249700,34104
7901,5210,2691,1614,459700,34105
7928,6452,1476,1459,735800,34108
11064,6990,4074,1447,405100,34109
11018,8314,2704,1583,402100,34110
11865,9100,2765,1118,227900,34112
8546,6048,2498,1333,321000,34113
7882,6505,1377,1274,255000,34114
9640,5088,4552,1242,249700,34116
4769,4314,455,1526,297900,34117
13103,10314,2789,1621,456200,34119
10702,9313,1389,1687,330200,34120
7622,6529,1093,1238,501000,34134
19166,15321,3845,1290,280100,34135
159,84,75,-,-,34137
155,108,47,-,-,34138
115,94,21,863,234600,34139
98,52,46,-,-,34140
18,4,14,-,-,34141
7088,3188,3900,805,166000,34142
8379,7335,1044,1638,678900,34145
1846,1715,131,1888,453500,34201
9529,7429,2100,1842,445600,34202
14278,10646,3632,1045,202800,34203
12313,7126,5187,993,144900,34205
14608,8342,6266,978,79200,34207
12747,7347,5400,1065,172100,34208
14668,11202,3466,1232,227200,34209
7084,4209,2875,1139,201500,34210
3730,3336,394,1698,383100,34211
7549,6051,1498,1634,355000,34212
271,228,43,-,900000,34215
384,356,28,-,888000,34216
2743,2077,666,1304,590000,34217
8617,7652,965,1758,277300,34219
15269,11972,3297,1108,169600,34221
5236,4205,1031,989,101700,34222
9209,7520,1689,1041,235700,34223
7441,5812,1629,979,163100,34224
3838,3607,231,1625,740500,34228
3377,2833,544,1211,449500,34229
14505,9141,5364,1182,255300,34231
13767,9659,4108,1403,223100,34232
7891,5832,2059,1472,258300,34233
8784,4692,4092,1015,139300,34234
6661,5008,1653,1395,234500,34235
7251,4418,2833,1176,685100,34236
6916,3461,3455,1152,148600,34237
10091,7895,2196,1632,366600,34238
6869,4897,1972,1355,279600,34239
3946,3740,206,1469,393500,34240
5963,5125,838,1727,363900,34241
3852,3288,564,1713,719700,34242
13292,10226,3066,1559,275000,34243
2028,1890,138,895,352200,34251
9972,6673,3299,688,83500,34266
88,40,48,-,-,34268
2012,1705,307,802,149900,34269
9339,7692,1647,1153,304900,34275
9900,7650,2250,1231,222400,34285
6494,5593,901,1538,184500,34286
11278,8377,2901,1118,148900,34287
4239,3518,721,1314,196900,34288
1337,515,822,1240,193500,34289
1893,1580,313,1423,199100,34291
7789,6238,1551,1723,315300,34292
18096,15606,2490,1331,242100,34293
6755,4729,2026,841,109700,34420
3993,2975,1018,696,132600,34428
3835,3225,610,962,126500,34429
3561,2907,654,790,119600,34431
5542,4790,752,889,139900,34432
2829,2499,330,907,134400,34433
3111,2492,619,1103,140800,34434
3572,2945,627,706,104500,34436
6831,5984,847,821,163500,34442
0,0,0,-,-,34445
7975,7060,915,884,146000,34446
4723,3778,945,871,90500,34448
1416,1020,396,491,81400,34449
5059,3700,1359,761,119800,34450
4852,4018,834,892,114000,34452
4337,3428,909,858,102100,34453
4469,3542,927,797,182500,34461
7948,6392,1556,859,159000,34465
7721,4285,3436,867,108500,34470
10038,6137,3901,927,195500,34471
10503,7412,3091,968,116200,34472
6729,5351,1378,1068,157000,34473
7042,3263,3779,1057,133000,34474
4446,2130,2316,728,90400,34475
10047,8934,1113,989,154200,34476
5068,3468,1600,872,104900,34479
6826,4941,1885,845,164100,34480
10473,9491,982,968,123900,34481
7332,5580,1752,781,151400,34482
1504,1043,461,959,232500,34484
4162,3153,1009,825,58100,34488
12236,10728,1508,883,168400,34491
272,207,65,1018,164400,34498
10017,6940,3077,779,94400,34601
2735,2306,429,937,152100,34602
4104,3464,640,941,155100,34604
11749,8897,2852,955,132100,34606
3810,3179,631,1053,214800,34607
13479,9790,3689,1051,136000,34608
15884,12483,3401,1147,167800,34609
5017,3963,1054,1004,158000,34610
8511,7302,1209,947,101200,34613
2628,2495,133,1158,160700,34614
2174,1916,258,-,236300,34637
9117,7376,1741,1506,259900,34638
10030,8227,1803,1348,250500,34639
10721,6334,4387,926,109800,34652
14829,9030,5799,1013,105400,34653
8880,6860,2020,1032,162000,34654
17114,13536,3578,1240,229400,34655
52,52,0,-,159900,34661
15529,11260,4269,934,138800,34667
19709,12170,7539,983,94700,34668
5186,4145,1041,1022,152000,34669
8729,6279,2450,1158,243500,34677
33,16,17,-,-,34679
334,334,0,-,384800,34681
13358,10122,3236,1234,275400,34683
12958,8897,4061,1344,192600,34684
7025,5316,1709,1337,354600,34685
3096,2666,430,1603,363400,34688
10814,7801,3013,858,206000,34689
5387,3411,1976,1034,76500,34690
8725,5699,3026,1039,89800,34691
7374,6091,1283,1301,263800,34695
18136,12420,5716,1081,199000,34698
964,766,198,903,115900,34705
21883,17117,4766,1408,237300,34711
7830,3817,4013,1241,193100,34714
5648,3965,1683,1485,253800,34715
6452,5214,1238,944,177700,34731
1414,1199,215,1355,304000,34734
6324,5091,1233,1208,198500,34736
1133,915,218,1338,244400,34737
150,125,25,-,95400,34739
15729,4580,11149,1126,162300,34741
12099,8116,3983,1294,179200,34743
16163,10005,6158,1203,219500,34744
13137,8681,4456,1412,201800,34746
8024,3708,4316,1505,325500,34747
17890,12883,5007,911,156900,34748
1709,1341,368,897,155900,34753
1208,993,215,1125,287400,34756
10680,7276,3404,1243,172400,34758
11982,8878,3104,1291,184000,34759
299,225,74,1563,215100,34760
14645,9898,4747,1363,237100,34761
249,249,0,-,-,34762
8092,5230,2862,1015,156600,34769
6171,5555,616,1144,297800,34771
8953,7679,1274,1372,223500,34772
1023,760,263,1527,209600,34773
15270,13649,1621,929,296800,34785
14778,10595,4183,1814,450700,34786
23543,17221,6322,1236,321200,34787
8324,6927,1397,1037,90800,34788
418,404,14,-,197100,34797
1432,1217,215,1006,178500,34945
2397,1684,713,808,88300,34946
4294,1574,2720,998,110100,34947
4254,3312,942,1162,280200,34949
5867,2187,3680,827,100900,34950
7073,5898,1175,972,114100,34951
17026,11517,5509,1242,146700,34952
21839,17866,3973,1449,211700,34953
2298,1496,802,818,91900,34956
11013,8139,2874,1107,257900,34957
5757,3748,2009,748,105700,34972
9784,7673,2111,786,105900,34974
1754,1067,687,1018,232900,34981
10000,7109,2891,1055,115600,34982
13908,10486,3422,1434,176600,34983
5563,4673,890,1429,198800,34984
11838,9440,2398,1562,262100,34986
3725,2757,968,1813,276400,34987
11806,10290,1516,1585,367300,34990
7438,4568,2870,1125,186100,34994
5468,4580,888,1089,284900,34996
17875,14071,3804,1121,253500,34997
4624,3733,891,886,158900,35004
2697,2057,640,859,97200,35005
1018,919,99,788,104300,35006
9292,7639,1653,1036,168200,35007
7987,5669,2318,659,99900,35010
17,9,8,-,-,35013
1655,1477,178,968,88500,35014
6496,4761,1735,591,138400,35016
907,750,157,638,136100,35019
10088,5066,5022,732,68800,35020
8580,6921,1659,869,181500,35022
8357,6143,2214,879,117900,35023
2806,1993,813,590,133600,35031
15,13,2,-,77500,35032
1130,969,161,628,121300,35033
1197,830,367,770,46800,35034
334,321,13,-,89300,35035
88,26,62,293,83800,35036
6185,5057,1128,1059,148700,35040
2330,1808,522,394,115700,35042
4002,3808,194,1257,238600,35043
3091,1834,1257,501,97600,35044
5915,4126,1789,697,127700,35045
2060,1573,487,768,127100,35046
1376,1089,287,623,117500,35049
3452,2693,759,635,156000,35051
23,0,23,-,-,35052
892,834,58,825,165600,35053
1931,1762,169,750,162600,35054
7838,4887,2951,681,130900,35055
4977,4079,898,751,146300,35057
3446,2615,831,756,133900,35058
132,108,24,-,-,35060
417,218,199,980,89500,35061
3049,2575,474,755,125000,35062
1264,1123,141,790,81100,35063
4581,2535,2046,756,98400,35064
3379,2341,1038,1001,153200,35068
103,81,22,563,103700,35070
6328,4979,1349,933,172700,35071
1700,1339,361,456,71400,35072
826,705,121,842,91200,35073
53,0,53,-,-,35074
5262,3890,1372,647,115000,35077
733,607,126,1000,159500,35078
3058,2896,162,833,139800,35079
6374,5869,505,1331,188500,35080
0,0,0,-,-,35082
1273,967,306,736,110100,35083
3191,2465,726,741,92400,35085
980,600,380,738,115900,35087
803,653,150,625,95500,35089
1074,984,90,896,193600,35091
5646,4533,1113,824,165000,35094
3111,2528,583,858,114000,35096
631,571,60,919,118400,35097
428,407,21,-,88600,35098
5765,5225,540,799,199300,35111
124,109,15,-,-,35112
2982,2576,406,1086,193600,35114
5459,3555,1904,801,127600,35115
1689,1415,274,880,167700,35116
2157,1929,228,729,159000,35117
1192,976,216,780,134700,35118
89,61,28,-,-,35119
4824,4017,807,698,147900,35120
6014,4027,1987,682,123300,35121
9582,8219,1363,1115,193500,35124
4095,2595,1500,818,138100,35125
7562,6395,1167,914,149400,35126
3610,3118,492,1134,157400,35127
4294,3136,1158,863,172400,35128
1291,1040,251,469,85200,35130
1503,1104,399,606,124700,35131
1221,1128,93,860,122500,35133
894,576,318,923,190500,35135
784,644,140,417,131000,35136
108,65,43,-,16100,35139
1199,1139,60,542,155100,35143
3340,3048,292,767,197800,35146
2198,1960,238,1350,193300,35147
907,595,312,531,105100,35148
132,93,39,-,105300,35149
6953,4310,2643,623,106300,35150
2956,2570,386,811,110100,35151
9948,6627,3321,563,92300,35160
1242,1056,186,776,106800,35171
1240,843,397,684,83600,35172
9320,8357,963,1193,241000,35173
2003,1666,337,648,141800,35175
341,201,140,688,77000,35176
1248,1045,203,636,99000,35178
3296,2792,504,709,132100,35179
5668,4806,862,582,142000,35180
304,254,50,-,79600,35183
1641,1151,490,787,81300,35184
2008,1667,341,929,184400,35186
3,3,0,-,-,35187
894,745,149,-,128100,35188
1688,317,1371,551,214500,35203
4321,1488,2833,609,63900,35204
9797,2566,7231,802,179900,35205
6860,3456,3404,856,76900,35206
3544,1993,1551,546,63300,35207
5439,2943,2496,852,73900,35208
11992,5853,6139,997,344000,35209
6101,4108,1993,988,146900,35210
11441,4996,6445,836,77900,35211
4766,2123,2643,591,133200,35212
5693,4310,1383,1479,541400,35213
7308,5127,2181,789,107700,35214
18173,10006,8167,850,103700,35215
14819,8079,6740,1045,275400,35216
4932,2703,2229,699,79900,35217
2842,1187,1655,793,64700,35218
1771,1127,644,844,67300,35221
4147,2370,1777,767,242900,35222
4197,3600,597,1669,506500,35223
2033,1208,825,772,68400,35224
13117,10351,2766,1264,279600,35226
3781,2272,1509,866,66100,35228
0,0,0,-,-,35229
921,87,834,1284,188400,35233
1905,873,1032,597,59500,35234
8139,5613,2526,994,119100,35235
22156,15804,6352,1140,355700,35242
7702,4544,3158,1272,358000,35243
12261,8593,3668,1130,295900,35244
155,63,92,675,-,35254
11371,4106,7265,784,118700,35401
7757,3983,3774,882,130000,35404
16962,9528,7434,861,172800,35405
6905,5363,1542,998,353000,35406
392,356,36,595,55500,35441
2007,1416,591,540,77800,35442
534,289,245,574,34200,35443
1428,1202,226,870,117000,35444
721,609,112,860,117200,35446
1164,873,291,432,89700,35447
1189,958,231,864,167500,35452
3672,3135,537,794,140800,35453
1300,1034,266,854,138000,35456
0,0,0,-,-,35457
161,126,35,-,161100,35458
397,306,91,636,48800,35459
401,334,67,525,99200,35460
895,832,63,625,155400,35461
1777,1206,571,621,84000,35462
761,680,81,-,132700,35463
306,150,156,335,-,35464
2122,1687,435,507,103100,35466
88,61,27,-,83700,35469
1850,919,931,554,108700,35470
6220,4305,1915,859,182000,35473
2276,1853,423,804,136700,35474
5557,4975,582,741,192800,35475
2732,1278,1454,778,140400,35476
62,62,0,-,-,35477
329,293,36,-,189300,35480
1450,941,509,430,81500,35481
1272,919,353,936,120300,35490
3780,2202,1578,593,95800,35501
3499,2780,719,733,120900,35503
4949,3971,978,641,158400,35504
1123,880,243,331,87400,35540
1514,1391,123,438,154300,35541
417,405,12,-,78400,35542
411,288,123,593,49300,35543
252,177,75,572,45200,35544
50,46,4,-,-,35545
1465,1280,185,359,104900,35546
694,555,139,407,83900,35548
1516,1105,411,589,64300,35549
2304,1837,467,624,71800,35550
355,328,27,315,66500,35552
1724,1355,369,479,66000,35553
455,395,60,603,60200,35554
3947,2760,1187,533,99500,35555
6,6,0,-,-,35559
1896,1353,543,556,106800,35563
894,712,182,542,104400,35564
5114,3999,1115,538,71900,35565
4529,3202,1327,517,100500,35570
324,282,42,656,79300,35571
508,466,42,-,180600,35572
681,593,88,279,108300,35574
431,308,123,634,85500,35575
1334,1073,261,468,92500,35576
13,13,0,-,-,35577
2293,2039,254,818,91000,35578
1367,1101,266,345,85700,35579
1343,1159,184,627,80800,35580
1979,1436,543,692,92100,35581
1770,1269,501,466,85300,35582
137,113,24,-,47800,35584
558,459,99,-,151000,35585
1706,1329,377,425,83400,35586
281,250,31,-,42500,35587
1910,1298,612,404,78600,35592
592,482,110,476,86500,35593
2685,2015,670,515,113500,35594
12290,7661,4629,662,99900,35601
13273,9330,3943,660,168900,35603
803,652,151,477,160900,35610
9839,6054,3785,640,126300,35611
7937,7122,815,847,183600,35613
2611,2027,584,756,120000,35614
17,0,17,-,-,35615
1635,1242,393,719,85600,35616
852,582,270,456,78500,35618
1847,1561,286,617,116600,35619
3345,2744,601,830,127200,35620
1124,989,135,745,118400,35621
2535,2008,527,765,90500,35622
14946,6624,8322,641,119800,35630
8349,7042,1307,710,143700,35633
3934,3288,646,867,186300,35634
9455,7581,1874,668,146100,35640
1505,1351,154,532,104200,35643
5223,4451,772,653,175800,35645
1828,1408,420,482,105900,35646
368,297,71,372,111300,35647
1298,1058,240,522,115800,35648
30,30,0,-,500000,35649
5153,3832,1321,541,128100,35650
461,343,118,726,88300,35651
3479,2793,686,768,133000,35652
3611,2455,1156,596,83500,35653
2778,1849,929,550,111800,35654
4046,2335,1711,645,90000,35660
6624,5290,1334,836,148000,35661
2527,2141,386,590,119000,35670
872,574,298,634,74100,35671
2211,1717,494,553,104100,35672
2620,2180,440,594,129500,35673
7305,5211,2094,681,115600,35674
667,517,150,850,88300,35677
1975,1420,555,789,133700,35739
1419,950,469,416,86400,35740
1350,904,446,1005,268700,35741
737,596,141,413,117700,35744
81,74,7,-,155900,35745
213,181,32,-,-,35746
2076,1610,466,663,160300,35747
2738,2281,457,582,198800,35748
8286,7316,970,1096,186500,35749
5266,4116,1150,847,134900,35750
86,86,0,-,215200,35751
1019,901,118,775,68600,35752
1980,1473,507,613,150600,35754
218,174,44,-,150000,35755
4500,3901,599,1366,239500,35756
6021,5139,882,1147,201300,35757
18566,12489,6077,968,240800,35758
3089,2853,236,1297,192500,35759
1831,1446,385,785,130100,35760
4834,4175,659,844,153600,35761
6867,6291,576,2000,280700,35763
248,182,66,589,77600,35764
1406,1195,211,448,93200,35765
67,54,13,-,-,35766
4483,3002,1481,588,96000,35768
4041,3054,987,664,143500,35769
1422,1048,374,677,106000,35771
1878,1399,479,475,83700,35772
4706,3723,983,842,123200,35773
67,67,0,-,73000,35774
380,290,90,-,82500,35775
1450,1205,245,600,93700,35776
10020,6659,3361,861,274300,35801
10292,5790,4502,831,240800,35802
11299,9003,2296,905,183800,35803
9146,2587,6559,642,74200,35805
11056,5134,5922,965,233900,35806
351,5,346,1377,-,35808
11497,7345,4152,868,86100,35810
10947,8749,2198,808,164300,35811
6622,1648,4974,680,89000,35816
3828,1966,1862,952,229200,35824
0,0,0,-,-,35896
7553,4789,2764,619,117200,35901
6674,4197,2477,677,97500,35903
5333,4242,1091,640,69900,35904
2349,1907,442,605,135200,35905
3917,2379,1538,797,167700,35906
3245,2877,368,942,154200,35907
7303,4557,2746,693,111000,35950
4266,2983,1283,634,108400,35951
2876,2211,665,611,90900,35952
2743,2220,523,814,110700,35953
4477,3621,856,578,86600,35954
3270,2682,588,676,114000,35956
5655,3334,2321,682,97400,35957
1450,1088,362,544,137500,35958
1928,1501,427,520,105700,35959
4276,3146,1130,623,144600,35960
2497,1651,846,579,84400,35961
3083,2252,831,706,88300,35962
514,358,156,-,116700,35963
1642,1288,354,744,121400,35966
6017,4245,1772,650,115500,35967
1655,1150,505,593,111200,35968
1953,1406,547,693,93500,35971
437,361,76,-,105400,35972
1127,990,137,814,97300,35973
708,408,300,641,122600,35974
224,174,50,-,81000,35975
6882,5180,1702,633,172700,35976
1887,1546,341,553,98100,35978
590,445,145,-,127100,35979
1800,1470,330,627,93300,35980
653,482,171,277,117600,35981
1426,1083,343,639,160700,35983
756,607,149,807,185500,35984
3055,2133,922,595,114100,35986
912,745,167,808,92300,35987
789,583,206,623,90200,35988
1372,1046,326,587,94600,35989
23,6,17,975,-,35990
912,713,199,445,91800,36003
498,432,66,530,97700,36005
483,402,81,471,179300,36006
960,678,282,477,89200,36009
1624,1176,448,557,80000,36010
210,210,0,-,387800,36013
1495,962,533,552,73700,36016
701,442,259,429,60700,36017
413,306,107,797,163600,36020
4707,3971,736,775,176600,36022
2175,1707,468,811,172700,36024
1318,842,476,980,141200,36025
477,347,130,-,287500,36026
6111,3489,2622,587,104800,36027
587,495,92,613,97500,36028
344,305,39,-,-,36029
177,136,41,613,106800,36030
92,89,3,-,82000,36031
979,634,345,389,64500,36032
1367,1025,342,609,79500,36033
358,327,31,567,55100,36034
572,497,75,670,91800,36035
672,571,101,655,102100,36036
4265,2822,1443,631,96900,36037
13,13,0,-,-,36038
87,68,19,-,88300,36039
1414,956,458,592,66600,36040
497,441,56,-,68400,36041
632,562,70,643,103800,36042
1318,1037,281,1041,186300,36043
547,507,40,727,105700,36046
447,369,78,-,81300,36047
565,405,160,594,71100,36048
2045,1441,604,549,78400,36049
853,666,187,886,87200,36051
191,172,19,-,582400,36052
694,455,239,591,76600,36053
5864,4049,1815,875,143600,36054
3613,3369,244,1250,314400,36064
8381,4785,3596,1124,173300,36066
10015,7628,2387,875,140400,36067
864,770,94,786,122000,36069
207,168,39,518,80000,36071
929,637,292,748,83400,36075
4912,3443,1469,707,136100,36078
3359,2668,691,815,132200,36079
855,780,75,-,183800,36080
6074,2812,3262,639,132300,36081
0,0,0,-,-,36082
3315,2110,1205,565,77200,36083
1204,549,655,705,83800,36088
2662,1850,812,666,72100,36089
1538,1191,347,654,84800,36091
7501,5458,2043,810,141600,36092
3905,3507,398,1295,250400,36093
2932,906,2026,687,67100,36104
3840,2455,1385,826,67100,36105
6333,3524,2809,973,160000,36106
3084,1278,1806,756,67700,36107
7243,4070,3173,634,63100,36108
10150,7344,2806,957,116600,36109
4237,2236,2001,839,57700,36110
4909,2918,1991,825,144200,36111
0,0,0,-,-,36112
263,0,263,1515,-,36113
295,0,295,1388,-,36115
17049,8412,8637,881,109500,36116
22552,13122,9430,1003,180300,36117
7104,4181,2923,593,64400,36201
6980,4850,2130,862,152600,36203
331,170,161,733,215900,36205
4433,3362,1071,703,96600,36206
8117,5564,2553,817,150100,36207
1834,1557,277,927,128800,36250
1818,1307,511,390,83900,36251
382,338,44,-,125000,36255
665,566,99,692,104700,36256
594,516,78,540,128800,36258
1604,1322,282,625,121500,36260
458,363,95,639,93300,36262
182,102,80,715,95000,36263
3246,2333,913,575,123000,36264
7531,4667,2864,667,143700,36265
2154,1500,654,578,118800,36266
7,7,0,-,-,36267
2216,1863,353,765,107700,36268
513,393,120,599,82400,36269
2200,1878,322,746,117300,36271
5336,4261,1075,607,82900,36272
1280,1076,204,658,123100,36273
4361,3279,1082,594,85400,36274
860,677,183,494,72000,36276
2011,1660,351,851,106000,36277
1774,1422,352,651,154700,36278
1028,944,84,1020,141700,36279
1624,1256,368,784,100000,36280
14144,8605,5539,736,119800,36301
11667,6965,4702,702,144300,36303
6076,4265,1811,965,186300,36305
2621,2051,570,554,92300,36310
993,827,166,505,76300,36311
2276,1684,592,676,113500,36312
98,63,35,-,135800,36313
197,167,30,522,108700,36314
811,705,106,725,154100,36316
227,185,42,-,67900,36317
517,450,67,575,69400,36318
905,712,193,777,79700,36319
1366,1100,266,613,89800,36320
622,493,129,750,102400,36321
3392,1984,1408,668,97100,36322
3007,2135,872,639,83800,36323
14161,8797,5364,856,167400,36330
2281,1567,714,444,105700,36340
501,436,65,555,70400,36343
2074,1405,669,619,118600,36344
3157,2655,502,648,141700,36345
545,465,80,598,94400,36346
2646,1578,1068,679,137100,36350
1466,1052,414,739,111700,36351
1936,1591,345,678,168200,36352
701,621,80,538,104000,36353
7792,5101,2691,636,115400,36360
1296,8,1288,1165,-,36362
357,284,73,725,89500,36370
320,226,94,763,127300,36371
191,149,42,-,101300,36373
341,285,56,1272,83800,36374
2761,1975,786,764,84900,36375
787,621,166,733,86200,36376
2919,2105,814,533,86500,36401
4250,2964,1286,635,119900,36420
3818,2977,841,596,97700,36421
413,331,82,546,39500,36425
5884,4008,1876,621,96900,36426
648,528,120,-,84000,36432
131,125,6,-,69400,36435
122,115,7,-,96100,36436
192,110,82,881,138800,36439
1471,1125,346,651,89500,36441
1252,950,302,525,92900,36442
301,201,100,-,63800,36444
1868,1412,456,662,101000,36445
155,116,39,-,85000,36446
1720,1322,398,548,116100,36451
941,679,262,613,78200,36453
5,5,0,-,-,36454
117,84,33,617,68300,36455
545,428,117,525,50900,36456
3776,2185,1591,536,124000,36460
3995,2812,1183,602,91100,36467
51,0,51,-,-,36470
413,282,131,-,55400,36471
39,39,0,-,116500,36473
1114,1009,105,549,74100,36474
878,660,218,651,81100,36475
7,7,0,-,-,36476
1587,1153,434,519,76400,36477
601,371,230,678,87800,36480
135,56,79,-,-,36481
386,341,45,-,79900,36482
176,166,10,-,106400,36483
5837,3857,1980,614,105800,36502
493,353,140,1133,123000,36505
7307,5231,2076,655,132200,36507
683,438,245,725,74900,36509
200,200,0,-,111500,36511
20,20,0,-,-,36512
149,85,64,-,126900,36513
1046,764,282,751,96800,36518
2162,1853,309,788,118300,36521
2609,1933,676,766,101600,36522
957,707,250,847,118900,36523
488,422,66,580,84400,36524
628,463,165,742,129600,36525
12305,9336,2969,1189,211600,36526
5724,3996,1728,1248,278500,36527
585,518,67,1111,257600,36528
77,77,0,-,-,36529
2627,2144,483,853,167600,36530
12929,10393,2536,1173,268700,36532
13221,9544,3677,836,171200,36535
182,182,0,-,23500,36538
262,200,62,-,-,36539
246,203,43,-,156000,36540
5086,4592,494,1074,116100,36541
6711,3951,2760,1078,246100,36542
41,41,0,-,-,36543
4071,3114,957,852,106300,36544
3413,2343,1070,572,112000,36545
434,376,58,-,141100,36548
2268,2055,213,1109,141700,36549
109,72,37,-,-,36550
3135,2672,463,980,152100,36551
826,787,39,638,104800,36553
347,314,33,832,261900,36555
229,136,93,-,47500,36556
1485,1321,164,499,83000,36558
107,89,18,-,629500,36559
1263,898,365,673,60100,36560
3221,2514,707,1188,337300,36561
464,425,39,822,119200,36562
61,61,0,-,"2,000,000+",36564
4976,3579,1397,833,145300,36567
68,55,13,-,-,36568
225,181,44,-,-,36569
5558,4096,1462,881,147200,36571
2205,1882,323,885,155800,36572
352,319,33,-,201800,36574
7372,6028,1344,779,148900,36575
1753,1363,390,871,171700,36576
533,489,44,740,240900,36578
522,444,78,588,127200,36579
1900,1561,339,793,163300,36580
106,89,17,-,-,36581
8548,6364,2184,735,125200,36582
297,244,53,-,165000,36583
324,260,64,-,83500,36584
338,275,63,762,91500,36585
3252,2813,439,811,105700,36587
0,0,0,-,-,36590
638,134,504,446,203100,36602
2847,1079,1768,640,82500,36603
4069,2193,1876,814,167000,36604
10375,5711,4664,843,79900,36605
7937,4226,3711,843,100100,36606
2739,1439,1300,799,104100,36607
14959,7889,7070,903,156800,36608
11311,4952,6359,824,151200,36609
4001,2074,1927,669,47800,36610
2134,1101,1033,816,75500,36611
1618,832,786,671,61500,36612
4173,3170,1003,862,107400,36613
0,0,0,-,-,36615
8,0,8,-,-,36616
4941,2739,2202,917,74200,36617
6653,5188,1465,858,107100,36618
5831,4428,1403,869,133600,36619
0,0,0,-,-,36688
7682,5158,2524,924,149500,36693
18981,12583,6398,1040,186900,36695
8526,4983,3543,681,89900,36701
5067,2747,2320,602,78300,36703
342,266,76,533,56300,36720
172,109,63,-,90200,36722
127,65,62,-,-,36723
1707,1057,650,451,84500,36726
12,12,0,-,-,36727
104,73,31,-,53500,36728
3018,1772,1246,529,117500,36732
459,378,81,943,75800,36736
245,202,43,-,107400,36738
472,334,138,590,91300,36740
743,606,137,583,57000,36742
2537,1684,853,474,81000,36744
993,728,265,658,84000,36748
399,250,149,-,96700,36749
982,769,213,398,110900,36750
236,191,45,659,32600,36751
611,568,43,-,106600,36752
8,0,8,-,-,36753
188,116,72,-,194400,36754
1866,1302,564,506,80800,36756
519,460,59,-,75000,36758
673,579,94,-,70400,36759
374,290,84,832,45800,36761
66,49,17,806,-,36763
568,508,60,1005,59000,36765
16,12,4,-,135000,36766
651,444,207,504,42400,36767
344,290,54,733,59200,36768
914,623,291,526,75000,36769
185,98,87,664,109800,36773
402,313,89,672,60800,36775
576,484,92,-,76200,36776
948,873,75,339,75700,36782
362,295,67,461,73900,36783
2863,1752,1111,536,152400,36784
528,399,129,756,93200,36785
921,647,274,492,59100,36786
59,59,0,-,49300,36790
492,410,82,-,113800,36792
90,72,18,-,154100,36793
9854,6132,3722,734,158300,36801
6927,5431,1496,805,101900,36804
15437,7933,7504,887,268900,36830
10234,4140,6094,862,119900,36832
0,0,0,-,-,36849
1015,810,205,355,64900,36850
956,685,271,784,89900,36852
3314,2726,588,705,166500,36853
5811,3612,2199,795,117400,36854
649,495,154,730,139900,36855
2631,2198,433,1433,198000,36856
152,125,27,632,96300,36858
8,8,0,-,-,36859
668,470,198,671,67500,36860
1351,1149,202,665,144200,36861
2326,1610,716,595,94800,36862
4899,3461,1438,722,98900,36863
12,9,3,-,112500,36865
1616,1256,360,605,79800,36866
9428,4694,4734,835,141500,36867
8162,4828,3334,802,105200,36869
7284,5326,1958,798,137600,36870
496,429,67,393,84700,36871
3425,2971,454,1058,161500,36874
1638,1226,412,797,130900,36875
4851,3314,1537,893,154700,36877
903,819,84,930,250100,36879
181,110,71,-,50000,36901
1512,1093,419,493,84600,36904
736,641,95,684,76600,36907
839,755,84,444,78100,36908
31,0,31,-,-,36910
829,659,170,703,69500,36912
17,17,0,-,-,36913
241,165,76,-,52700,36915
334,265,69,438,49400,36916
722,590,132,558,71200,36919
416,400,16,675,74600,36921
230,199,31,-,62100,36922
1246,804,442,498,45700,36925
1673,1511,162,1553,251800,37010
941,728,213,675,122900,37012
35597,19668,15929,1120,186000,37013
1019,968,51,831,548400,37014
6673,4848,1825,966,169900,37015
395,333,62,784,162500,37016
898,671,227,1035,86500,37018
227,151,76,648,159500,37019
2053,1826,227,921,176000,37020
2109,1777,332,974,168600,37022
559,481,78,717,122900,37023
2059,1806,253,709,135000,37025
855,669,186,660,158000,37026
19950,16992,2958,1509,592800,37027
288,227,61,-,140600,37028
2519,2270,249,811,235500,37029
2853,1898,955,573,146100,37030
1723,1600,123,889,189300,37031
1716,1283,433,931,203600,37032
2946,2161,785,631,120900,37033
2795,2356,439,1020,176100,37034
1253,1057,196,737,164700,37035
2136,1678,458,668,136300,37036
2760,2426,334,1196,223900,37037
18625,10509,8116,890,163200,37040
28582,15281,13301,975,140000,37042
18543,12745,5798,935,213100,37043
1956,1745,211,1207,498400,37046
867,725,142,903,126900,37047
2339,1984,355,938,249600,37048
1343,1043,300,851,217400,37049
596,466,130,529,121600,37050
1459,1271,188,1010,159900,37051
870,830,40,-,191100,37052
10258,7045,3213,787,161400,37055
337,227,110,752,124500,37057
2894,2106,788,616,130800,37058
563,447,116,807,124900,37059
977,850,127,1205,202000,37060
1586,1171,415,639,102900,37061
4040,3315,725,1017,232800,37062
21640,16882,4758,1340,426100,37064
19663,13562,6101,967,250100,37066
11643,6935,4708,1587,448300,37067
7017,6239,778,2098,470900,37069
12533,8468,4065,1053,217600,37072
5425,4205,1220,946,208700,37073
2847,2147,700,740,143800,37074
24275,17624,6651,1171,272500,37075
17389,9994,7395,1137,215000,37076
163,142,21,-,132100,37078
1023,681,342,699,118900,37079
3012,2218,794,910,198800,37080
2326,1952,374,978,230000,37082
5801,4326,1475,692,114800,37083
1988,1682,306,784,242800,37085
10545,7257,3288,1216,156200,37086
17633,12108,5525,902,237100,37087
5747,4481,1266,1084,237200,37090
8442,5701,2741,747,121900,37091
966,603,363,602,159700,37095
2186,1822,364,579,89300,37096
868,692,176,645,86900,37097
2171,1815,356,1032,114200,37098
2339,1872,467,615,117200,37101
13148,8805,4343,640,113500,37110
16510,6985,9525,939,164900,37115
380,285,95,728,299200,37118
20912,17217,3695,1360,291500,37122
6690,5186,1504,949,226100,37127
19643,13552,6091,1211,238000,37128
21365,14955,6410,1127,225400,37129
21953,9639,12314,958,205700,37130
0,0,0,-,-,37132
1040,845,195,807,107700,37134
4476,4112,364,1760,419100,37135
1105,956,149,577,97800,37137
9264,7118,2146,1130,220100,37138
27,27,0,-,-,37140
431,364,67,1042,174400,37141
679,554,125,638,137000,37142
1552,1334,218,961,217900,37143
1064,889,175,696,135000,37144
840,655,185,567,121000,37145
2630,2109,521,1122,193900,37146
8625,6425,2200,841,155300,37148
1054,895,159,743,189200,37149
1875,1455,420,573,109300,37150
242,184,58,-,159700,37151
2204,1981,223,918,268900,37153
12070,7528,4542,768,142600,37160
22,15,7,-,-,37165
5295,3371,1924,635,145700,37166
21388,13449,7939,1028,196700,37167
271,271,0,-,-,37171
11143,7481,3662,856,176300,37172
12468,9609,2859,1382,283100,37174
372,313,59,726,120600,37175
802,652,150,680,85600,37178
4811,4154,657,1769,337900,37179
1405,1097,308,595,146500,37180
576,448,128,756,123000,37181
1167,926,241,643,182600,37183
2307,1759,548,1006,193400,37184
3322,2485,837,668,112500,37185
3550,2440,1110,800,130700,37186
2745,2109,636,774,156800,37187
5681,4776,905,1005,206800,37188
1509,1306,203,1167,214300,37189
3378,2498,880,640,170100,37190
1598,1412,186,744,168600,37191
526,308,218,1610,336400,37201
8726,1690,7036,1465,366900,37203
5962,3368,2594,1392,528600,37204
10778,7605,3173,1351,566500,37205
11550,5857,5693,950,340900,37206
14909,8711,6198,944,162500,37207
7974,2648,5326,941,258200,37208
15884,7216,8668,1143,318900,37209
6967,1981,4986,800,182300,37210
29450,13997,15453,1075,230300,37211
6957,2759,4198,1229,563000,37212
22,0,22,-,-,37213
13894,8402,5492,1155,181100,37214
9998,7662,2336,1577,645200,37215
7923,5455,2468,1113,272100,37216
12470,5370,7100,982,170600,37217
5854,4121,1733,865,174600,37218
829,283,546,1568,276600,37219
2316,2106,210,1776,475300,37220
17959,12545,5414,1350,282600,37221
1051,0,1051,898,-,37228
0,0,0,-,-,37240
0,0,0,-,-,37243
0,0,0,-,-,37246
395,338,57,560,90800,37301
1715,1385,330,848,307800,37302
9701,6648,3053,711,149000,37303
325,291,34,-,73500,37305
885,811,74,761,163800,37306
2073,1608,465,674,109000,37307
1095,928,167,650,184100,37308
881,620,261,892,115000,37309
1584,1366,218,571,172500,37310
10605,4739,5866,723,136600,37311
13403,9026,4377,856,189900,37312
610,504,106,-,84700,37313
0,0,0,-,-,37315
1226,803,423,548,114300,37317
704,462,242,555,84100,37318
7026,4767,2259,669,123500,37321
3420,2644,776,679,123900,37322
12094,9187,2907,817,138100,37323
2282,1349,933,700,122600,37324
757,638,119,670,142100,37325
163,100,63,545,99200,37326
4399,3188,1211,694,145500,37327
682,512,170,630,98900,37328
2273,1859,414,622,122000,37329
2826,2313,513,854,131000,37330
3007,2113,894,616,103900,37331
995,854,141,647,107800,37332
265,219,46,-,66300,37333
9273,6683,2590,710,138300,37334
966,785,181,1012,96600,37335
1793,1597,196,805,171000,37336
586,419,167,419,89300,37337
1265,906,359,716,94200,37338
784,665,119,629,93000,37339
234,174,60,827,150000,37340
4478,3810,668,848,161600,37341
1507,1185,322,717,122900,37342
17280,13292,3988,880,188500,37343
946,757,189,720,111200,37345
3311,2666,645,639,121600,37347
398,295,103,611,176900,37348
737,674,63,1205,520300,37350
130,63,67,1158,108100,37351
1346,1076,270,659,207700,37352
1980,1506,474,826,165500,37353
6921,5300,1621,628,133900,37354
10218,7064,3154,725,149600,37355
895,595,300,659,167800,37356
1859,1587,272,680,127000,37357
394,327,67,564,139800,37359
657,604,53,929,143900,37360
717,520,197,713,120100,37361
1408,1046,362,690,106000,37362
14898,11387,3511,1046,237300,37363
425,380,45,604,70700,37365
395,319,76,1060,152600,37366
3932,2889,1043,632,133400,37367
275,244,31,-,114500,37369
2049,1666,383,591,152500,37370
1099,976,123,745,160400,37373
731,618,113,905,165900,37374
1096,862,234,976,218300,37375
139,112,27,-,103700,37376
5812,4972,840,1148,350100,37377
11168,9242,1926,769,175800,37379
2560,1686,874,602,121100,37380
3713,2917,796,628,149400,37381
3172,2781,391,680,131900,37385
1225,883,342,561,83100,37387
10469,6992,3477,751,143800,37388
659,513,146,817,161300,37391
36,23,13,-,69200,37394
79,66,13,-,105500,37396
3783,2799,984,708,115200,37397
5968,4330,1638,622,151500,37398
2311,95,2216,332,462800,37402
1531,463,1068,902,338700,37403
4948,2386,2562,728,123100,37404
7911,4239,3672,1048,275300,37405
6095,2740,3355,720,116500,37406
3559,1033,2526,729,75700,37407
879,308,571,767,289300,37408
1184,829,355,736,176600,37409
1531,487,1044,668,67000,37410
7321,4398,2923,779,125500,37411
9021,5070,3951,848,130900,37412
11298,6495,4803,884,165300,37415
6476,4003,2473,921,140000,37416
2789,2075,714,754,206300,37419
20760,12013,8747,1059,190200,37421
15490,8546,6944,721,146700,37601
16506,8136,8370,748,155500,37604
0,0,0,-,-,37614
9208,6541,2667,780,192500,37615
1961,1637,324,719,119300,37616
5547,4654,893,629,163300,37617
5546,4190,1356,676,148300,37618
16321,11650,4671,674,127100,37620
1469,1077,392,712,107000,37640
3908,3215,693,724,122200,37641
6184,4708,1476,656,134500,37642
14099,9853,4246,627,120000,37643
2096,1541,555,682,151500,37645
5364,3918,1446,636,119400,37650
1602,1311,291,574,159700,37656
384,287,97,613,134900,37657
1753,1413,340,549,125400,37658
11231,9221,2010,835,166200,37659
17463,10772,6691,639,128000,37660
5962,4764,1198,684,175800,37663
11654,8549,3105,671,153900,37664
2478,1522,956,669,91800,37665
218,144,74,-,126800,37680
2403,1877,526,617,152200,37681
110,70,40,-,-,37682
4929,3794,1135,528,144700,37683
3220,2561,659,761,174400,37686
1922,1725,197,541,113200,37687
469,402,67,525,118400,37688
1709,1534,175,494,127300,37690
233,131,102,533,117500,37691
2002,1402,600,626,170800,37692
787,565,222,666,118800,37694
3103,2095,1008,811,139400,37701
1620,1294,326,826,169700,37705
2496,1989,507,598,116100,37708
1527,1163,364,762,155700,37709
368,340,28,625,64500,37710
1999,1463,536,553,94300,37711
546,314,232,707,117300,37713
1729,1158,571,699,116500,37714
306,261,45,418,55400,37715
10789,7427,3362,725,158000,37716
75,26,49,-,-,37719
5105,4284,821,973,154200,37721
2405,1914,491,538,114700,37722
408,351,57,676,102800,37723
1219,694,525,692,115400,37724
6588,5256,1332,896,167400,37725
805,699,106,544,88300,37726
877,763,114,528,112300,37727
608,523,85,339,65000,37729
0,0,0,-,-,37730
166,153,13,-,52300,37731
99,69,30,-,90700,37732
28,28,0,-,-,37733
2358,2071,287,819,216300,37737
2380,1500,880,797,207700,37738
2400,2076,324,806,192900,37742
9971,7331,2640,594,124700,37743
7343,4904,2439,615,143800,37745
6701,4904,1797,636,116500,37748
2516,1939,577,704,129800,37752
366,243,123,473,-,37753
1917,1618,299,925,105000,37754
1199,723,476,485,88000,37755
1115,829,286,519,82300,37756
3834,2713,1121,654,129500,37757
4757,2882,1875,670,155000,37760
1260,672,588,479,88500,37762
6110,4920,1190,774,192900,37763
3677,2774,903,769,157700,37764
228,216,12,-,113800,37765
7471,4987,2484,601,89700,37766
2283,1537,746,542,101700,37769
1159,991,168,751,115300,37770
6141,4048,2093,790,152700,37771
5135,4285,850,984,262800,37772
8090,6773,1317,748,247200,37774
5039,3207,1832,680,209900,37777
1384,1071,313,607,110800,37779
10767,7189,3578,771,177800,37801
12673,10387,2286,839,202400,37803
9371,7149,2222,869,167100,37804
1135,833,302,723,134800,37806
3912,2869,1043,724,122400,37807
1047,779,268,764,96500,37809
674,572,102,-,111100,37810
1536,1339,197,629,131800,37811
6821,4417,2404,652,117700,37813
13023,8098,4925,762,146400,37814
1993,1441,552,597,94700,37818
304,181,123,656,-,37819
3116,2560,556,642,128500,37820
8685,5275,3410,649,108300,37821
3704,2583,1121,586,105300,37825
1991,1623,368,729,144900,37826
531,385,146,921,207200,37828
688,588,100,653,94900,37829
12209,7705,4504,807,157300,37830
3935,2968,967,713,131800,37840
3984,2750,1234,587,106300,37841
1653,1346,307,772,146600,37843
212,146,66,-,66800,37845
1695,1362,333,581,116600,37846
1050,827,223,628,92100,37847
74,61,13,-,-,37848
10086,7952,2134,889,176100,37849
12,12,0,-,-,37851
947,754,193,598,120800,37852
1555,1033,522,728,157100,37853
5004,3742,1262,621,107200,37854
7789,5669,2120,596,112000,37857
1494,1179,315,658,136600,37860
3387,2608,779,600,114600,37861
8540,4760,3780,773,194700,37862
2564,1405,1159,775,162800,37863
8424,6880,1544,875,174800,37865
647,536,111,603,215700,37866
2036,1560,476,389,98900,37869
1994,1476,518,681,109800,37870
3397,2625,772,836,138500,37871
633,549,84,643,99300,37872
1972,1457,515,656,94300,37873
5545,3777,1768,692,119900,37874
12732,9702,3030,806,174400,37876
3407,2880,527,734,146900,37877
165,165,0,-,104900,37878
4477,3203,1274,628,103600,37879
1392,1156,236,762,171900,37880
851,727,124,709,102400,37881
1179,999,180,795,224100,37882
2643,2174,469,710,181000,37885
1738,1404,334,729,170900,37886
1990,1505,485,663,93500,37887
1116,976,140,716,117800,37888
2871,2233,638,607,144800,37890
1415,1174,241,682,131100,37891
820,548,272,595,87500,37892
1560,375,1185,910,353200,37902
7350,2836,4514,908,185800,37909
10380,4968,5412,827,125300,37912
8550,5640,2910,818,130300,37914
2592,412,2180,388,85700,37915
2855,90,2765,849,302200,37916
11388,5627,5761,776,109900,37917
17732,12158,5574,855,159700,37918
13182,7286,5896,911,292600,37919
17170,10434,6736,802,135800,37920
10777,6675,4102,885,130400,37921
13458,11153,2305,1232,333500,37922
13425,7672,5753,1002,201400,37923
5119,3750,1369,764,142300,37924
11221,8412,2809,1036,223800,37931
7427,5114,2313,1213,241700,37932
10234,8964,1270,1221,341000,37934
6528,5652,876,897,189000,37938
1801,1253,548,651,96600,38001
13137,11159,1978,1449,238500,38002
3526,2914,612,1174,198400,38004
1889,1216,673,755,110600,38006
36,36,0,-,111100,38007
3591,2328,1263,640,93300,38008
3290,2696,594,1013,152700,38011
5548,3014,2534,644,99700,38012
865,621,244,627,125800,38015
18677,10246,8431,1145,176200,38016
19011,14726,4285,1331,319500,38017
13673,8725,4948,1274,170600,38018
6150,3567,2583,718,123400,38019
11,11,0,-,-,38021
1928,1380,548,925,142800,38023
11207,6531,4676,672,110200,38024
2578,2359,219,1159,331500,38028
12,12,0,-,-,38029
169,80,89,825,104900,38030
1091,836,255,618,87300,38034
205,15,190,481,-,38036
590,415,175,672,77300,38037
605,494,111,767,91800,38039
1965,1091,874,650,77700,38040
1024,577,447,578,78800,38041
308,193,115,698,109900,38042
291,266,25,706,125000,38044
25,21,4,-,-,38046
26,26,0,-,-,38047
1467,1106,361,788,110100,38049
213,143,70,768,98800,38050
1706,1271,435,611,91700,38052
9761,6606,3155,939,145700,38053
33,0,33,-,-,38054
1335,966,369,714,133000,38057
3714,2689,1025,1013,146100,38058
2998,2165,833,733,98900,38059
4066,3660,406,1288,189000,38060
272,243,29,-,119300,38061
6625,3690,2935,669,87300,38063
1130,985,145,519,266900,38066
545,480,65,490,90000,38067
4151,2823,1328,663,165500,38068
936,658,278,592,100000,38069
65,56,9,-,-,38070
1240,973,267,759,99700,38075
405,337,68,880,242000,38076
39,23,16,-,-,38077
1306,714,592,521,81700,38079
1077,617,460,562,87300,38080
7635,2353,5282,1266,270200,38103
12571,4295,8276,781,225500,38104
3132,310,2822,737,77900,38105
9132,4332,4800,737,51600,38106
6600,2949,3651,791,87900,38107
6378,2669,3709,778,49000,38108
16385,9551,6834,863,69700,38109
17242,7900,9342,819,94100,38111
6502,3170,3332,793,134700,38112
9779,4070,5709,770,56700,38114
16941,3673,13268,874,92300,38115
14740,7211,7529,842,95200,38116
11081,8801,2280,1108,198800,38117
12909,5870,7039,913,73200,38118
10187,5299,4888,1051,188300,38119
6344,4647,1697,1125,312200,38120
8820,4535,4285,933,71400,38122
13876,8529,5347,1142,162900,38125
2098,312,1786,627,36100,38126
13965,6348,7617,882,59300,38127
15805,6433,9372,937,84000,38128
0,0,0,-,-,38131
0,0,0,-,-,38132
7606,5816,1790,1198,154500,38133
15480,7453,8027,967,124600,38134
10590,8768,1822,1249,169600,38135
9899,7899,2000,1267,288400,38138
5476,5216,260,2101,397500,38139
7650,4854,2796,1187,99200,38141
0,0,0,-,-,38152
4052,2862,1190,666,97300,38201
763,621,142,731,74800,38220
1386,1225,161,629,76000,38221
991,820,171,717,103800,38222
299,244,55,492,133300,38224
2298,1623,675,626,91900,38225
130,130,0,-,70000,38226
1276,939,337,588,85600,38229
1633,1176,457,624,78300,38230
702,558,144,653,83800,38231
814,663,151,542,79700,38232
1122,849,273,622,85300,38233
178,116,62,578,110000,38235
172,148,24,820,-,38236
6174,3504,2670,650,129900,38237
983,658,325,666,75100,38240
387,352,35,478,102400,38241
8390,5958,2432,632,104900,38242
1147,902,245,628,92100,38251
409,317,92,727,76300,38253
25,13,12,-,-,38254
1015,608,407,543,77800,38255
1522,1413,109,804,110300,38256
1890,1294,596,588,91000,38257
653,463,190,620,80900,38258
264,161,103,588,67500,38259
1501,1114,387,638,97800,38260
6611,3849,2762,618,103700,38261
13265,6713,6552,751,88300,38301
20083,12903,7180,990,153700,38305
2356,1752,604,599,93000,38310
415,376,39,-,137500,38311
1173,1092,81,824,128800,38313
1345,1090,255,630,70600,38315
1063,852,211,610,96900,38316
914,676,238,644,70000,38317
164,89,75,921,61000,38318
4467,3230,1237,703,87800,38320
925,732,193,543,77500,38321
1233,970,263,752,140700,38326
203,161,42,614,85800,38327
260,230,30,556,76900,38328
1245,1035,210,549,106700,38329
1788,1284,504,648,74600,38330
493,468,25,525,116600,38332
81,72,9,-,85000,38333
826,765,61,700,86200,38334
580,479,101,755,109100,38337
295,189,106,593,143100,38339
4497,3265,1232,675,115300,38340
901,768,133,574,85100,38341
567,416,151,568,69200,38342
6425,4269,2156,706,101000,38343
3060,2302,758,543,95200,38344
674,602,72,-,97700,38345
145,61,84,913,129400,38347
400,316,84,768,89100,38348
7007,4769,2238,648,111200,38351
244,195,49,-,113800,38352
2290,1726,564,983,183800,38355
1000,855,145,600,113300,38356
1050,821,229,646,114500,38357
4655,3367,1288,683,109200,38358
128,98,30,596,88300,38359
391,330,61,497,120700,38361
482,342,140,1148,102100,38362
2050,1584,466,508,91500,38363
0,0,0,-,-,38365
712,652,60,766,159500,38366
1167,899,268,668,106700,38367
792,621,171,683,100900,38368
655,526,129,625,81000,38369
301,241,60,512,74700,38370
392,322,70,631,89400,38371
6623,4507,2116,588,126500,38372
814,645,169,557,101300,38374
3465,2246,1219,617,103200,38375
53,53,0,-,111600,38376
519,340,179,660,99700,38379
237,191,46,622,90300,38380
632,367,265,703,99800,38381
3468,2188,1280,652,90800,38382
114,100,14,-,83800,38387
654,557,97,656,87700,38388
396,331,65,586,88200,38390
424,297,127,739,109900,38391
222,222,0,-,87300,38392
23325,15713,7612,846,173500,38401
731,559,172,494,113100,38425
1093,855,238,694,130700,38449
1139,854,285,456,90800,38450
1591,1364,227,763,168600,38451
419,366,53,438,95800,38452
112,112,0,-,178600,38453
364,290,74,-,92800,38454
67,58,9,725,154800,38455
1475,1217,258,673,119500,38456
232,179,53,496,79200,38457
108,89,19,-,70700,38459
503,410,93,732,84800,38460
500,405,95,824,175300,38461
3980,3067,913,585,96000,38462
988,859,129,329,89600,38463
8825,6275,2550,652,118400,38464
1968,1604,364,689,109000,38468
1590,1301,289,648,100200,38469
134,119,15,-,126600,38471
1189,998,191,630,118700,38472
437,336,101,657,115600,38473
3069,2287,782,578,116700,38474
206,191,15,-,156000,38475
408,348,60,-,227900,38476
1174,1030,144,489,118500,38477
7194,4433,2761,653,138300,38478
415,340,75,536,71800,38481
620,543,77,1182,186800,38482
2111,1564,547,708,117700,38483
2523,1888,635,574,83800,38485
339,260,79,-,84500,38486
379,333,46,855,150800,38487
917,780,137,514,150500,38488
16990,8573,8417,706,159600,38501
329,329,0,-,69300,38504
0,0,0,-,-,38505
11694,8947,2747,821,165500,38506
728,651,77,558,83400,38541
9,0,9,-,-,38542
234,180,54,625,141200,38543
2782,2240,542,659,142600,38544
680,492,188,537,139500,38545
793,706,87,633,154600,38547
327,263,64,930,137100,38548
1529,1190,339,444,152400,38549
1629,1127,502,430,115400,38551
70,61,9,-,179000,38552
1033,766,267,777,108900,38553
431,358,73,-,123100,38554
8442,5053,3389,686,143300,38555
5122,3640,1482,511,110800,38556
4643,4145,498,861,217700,38558
545,469,76,688,124300,38559
526,431,95,593,119500,38560
2452,1949,503,500,104700,38562
1259,884,375,664,155700,38563
233,156,77,584,80800,38564
391,391,0,-,91800,38565
261,221,40,-,175300,38567
772,640,132,533,99500,38568
37,37,0,-,-,38569
4002,2886,1116,528,117400,38570
5786,4735,1051,682,144400,38571
4815,4194,621,731,133200,38572
851,812,39,481,153200,38573
3286,2417,869,581,146100,38574
482,405,77,-,82800,38575
683,511,172,778,83400,38577
61,44,17,625,150000,38578
371,295,76,841,155200,38579
661,554,107,447,148900,38580
1510,1296,214,604,97700,38581
631,572,59,790,146500,38582
8987,7189,1798,680,118700,38583
1440,1080,360,508,92900,38585
639,542,97,632,106900,38587
310,247,63,671,117700,38588
84,56,28,-,53200,38589
746,693,53,839,105100,38601
1291,1058,233,580,80600,38603
5530,3939,1591,699,102900,38606
1066,834,232,473,89300,38610
5832,4671,1161,794,137900,38611
6617,3236,3381,599,71800,38614
262,151,111,358,77200,38617
4760,3673,1087,772,98900,38618
1984,1022,962,677,71700,38619
1297,1069,228,865,68300,38620
563,323,240,542,51100,38621
326,158,168,578,45200,38622
117,104,13,-,33200,38623
522,425,97,532,78300,38625
513,341,172,539,-,38626
353,296,57,578,84000,38627
695,520,175,493,113800,38629
68,68,0,-,-,38630
544,256,288,484,62800,38631
9533,8280,1253,993,200700,38632
784,609,175,525,92800,38633
5486,3647,1839,658,99400,38635
9665,5528,4137,1033,106800,38637
399,188,211,413,42600,38639
764,680,84,-,176800,38641
830,685,145,437,79700,38642
859,362,497,450,51300,38643
67,33,34,-,57500,38644
535,259,276,647,74100,38645
1193,824,369,588,57400,38646
284,284,0,-,70500,38647
1368,950,418,676,83400,38650
2897,2569,328,1165,187700,38651
6022,4277,1745,752,113100,38652
18186,14937,3249,1157,195100,38654
16527,9738,6789,964,215500,38655
730,674,56,590,92700,38658
966,740,226,709,84700,38659
742,711,31,-,103200,38661
4407,3043,1364,596,88400,38663
1379,178,1201,849,146000,38664
820,587,233,670,84200,38665
2735,1951,784,638,69100,38666
4860,3498,1362,729,137400,38668
396,271,125,772,42600,38670
14059,8114,5945,1048,124400,38671
4830,4350,480,1654,212700,38672
347,315,32,713,164600,38673
353,274,79,-,66400,38674
2141,1144,997,712,104600,38676
0,0,0,-,-,38677
2145,1396,749,901,140600,38680
1941,1462,479,384,67000,38683
396,386,10,-,123300,38685
9083,4689,4394,665,84000,38701
13,0,13,-,-,38702
4561,2360,2201,786,68900,38703
2,2,0,-,-,38704
293,208,85,658,58800,38720
417,305,112,588,64200,38721
120,78,42,558,52500,38722
30,30,0,-,-,38723
276,137,139,588,45500,38725
195,130,65,654,30900,38726
872,653,219,686,-,38730
54,20,34,-,-,38731
6260,3262,2998,718,131400,38732
156,131,25,640,-,38736
1098,527,571,475,66100,38737
45,0,45,-,-,38738
98,75,23,-,62600,38740
255,173,82,-,85300,38744
59,12,47,-,-,38745
198,90,108,583,60800,38746
1191,725,466,545,76300,38748
34,5,29,-,-,38749
3803,2049,1754,696,77500,38751
523,341,182,686,97300,38753
578,354,224,561,81200,38754
2501,1379,1122,646,65900,38756
369,254,115,546,101100,38759
313,145,168,597,74400,38760
739,395,344,623,73900,38761
936,370,566,489,69000,38762
140,110,30,425,59600,38764
55,32,23,-,-,38765
29,14,15,-,-,38767
75,43,32,-,-,38768
720,316,404,415,58300,38769
1096,538,558,529,90400,38771
21,21,0,-,-,38772
1350,833,517,571,82100,38773
700,395,305,488,65600,38774
550,267,283,487,61000,38778
107,27,80,280,76100,38781
11462,6903,4559,796,132200,38801
6666,4118,2548,723,154700,38804
5070,3602,1468,663,113300,38821
2768,2008,760,568,98800,38824
1864,1340,524,1065,169200,38826
1222,892,330,596,116900,38827
1487,1072,415,588,115300,38828
6820,5023,1797,593,90100,38829
1014,694,320,602,60900,38833
11584,7649,3935,625,110100,38834
486,420,66,-,63800,38838
1151,869,282,569,70100,38841
4244,3105,1139,674,99100,38843
82,80,2,-,56900,38844
899,765,134,579,89300,38846
1219,1005,214,588,71800,38847
252,239,13,-,52500,38848
2274,1824,450,824,116000,38849
950,706,244,543,70200,38850
3136,2170,966,658,63900,38851
3661,2746,915,554,104100,38852
1701,1379,322,673,84500,38855
689,582,107,-,97400,38856
1489,1281,208,618,142300,38857
2585,1968,617,661,85700,38858
311,267,44,-,109800,38859
2232,1634,598,571,69500,38860
1046,853,193,709,82500,38862
6962,4680,2282,725,109500,38863
662,536,126,764,87600,38864
1645,1304,341,549,80100,38865
4264,3313,951,674,145800,38866
2187,1595,592,631,81600,38868
184,110,74,780,96000,38869
1048,850,198,668,91400,38870
688,561,127,842,121800,38871
1086,883,203,608,67700,38873
535,404,131,624,87100,38876
1142,866,276,603,68700,38878
317,85,232,647,-,38879
7353,4599,2754,682,105200,38901
174,174,0,-,69400,38913
254,215,39,825,59500,38914
1563,1112,451,553,78900,38915
2018,1403,615,582,63700,38916
1069,869,200,493,104700,38917
315,207,108,523,58600,38920
1560,1120,440,496,70000,38921
1180,889,291,542,78900,38922
434,331,103,-,95000,38923
220,108,112,502,32000,38924
1232,921,311,513,77600,38925
497,408,89,676,47900,38927
137,55,82,638,-,38928
574,383,191,749,69800,38929
8270,4382,3888,577,87000,38930
585,530,55,-,102400,38940
1360,557,803,602,64400,38941
105,95,10,-,-,38943
137,94,43,609,-,38944
12,0,12,-,-,38945
78,52,26,667,53300,38946
215,185,30,480,107000,38947
1052,809,243,507,58100,38948
143,118,25,-,134800,38949
191,141,50,-,74300,38950
426,353,73,527,68900,38951
174,99,75,471,115800,38952
240,240,0,-,89800,38953
346,241,105,615,73000,38954
265,107,158,488,86300,38957
0,0,0,-,-,38958
337,189,148,-,-,38961
42,23,19,-,-,38962
487,371,116,538,68400,38963
31,21,10,-,-,38964
3545,2556,989,674,89300,38965
314,166,148,728,63900,38966
2923,1913,1010,571,103500,38967
2119,1290,829,642,65700,39038
790,618,172,679,85600,39039
1189,964,225,746,101000,39040
1493,1154,339,467,136700,39041
14013,11739,2274,953,169200,39042
1344,1181,163,-,108900,39044
547,484,63,-,72500,39045
10612,6218,4394,788,163700,39046
14440,12084,2356,1334,198600,39047
5789,4124,1665,682,85100,39051
154,131,23,-,"10,000-",39054
9226,6231,2995,981,172400,39056
820,665,155,764,76900,39057
3830,2991,839,718,99900,39059
0,0,0,-,-,39061
205,146,59,633,84500,39062
1308,783,525,587,59900,39063
1670,1308,362,615,95800,39066
514,435,79,804,54300,39067
1707,1063,644,411,64600,39069
2050,1633,417,750,178500,39071
7519,6148,1371,769,138000,39073
5543,4007,1536,707,68100,39074
284,242,42,244,81400,39078
443,240,203,506,66800,39079
349,277,72,-,85700,39082
3387,2445,942,711,90500,39083
573,464,109,-,37800,39086
32,27,5,-,-,39088
4921,3117,1804,506,96200,39090
1018,865,153,532,89700,39092
1438,1177,261,560,97200,39094
2474,1604,870,625,64800,39095
563,357,206,591,-,39096
247,153,94,563,56600,39097
650,569,81,774,74800,39108
15417,14499,918,1416,261100,39110
3032,2204,828,626,97300,39111
161,34,127,244,-,39113
3708,3085,623,678,90000,39114
20,14,6,-,-,39115
876,713,163,1006,118100,39116
3668,2816,852,745,76900,39117
1912,1524,388,614,102900,39119
11168,7026,4142,600,92500,39120
953,682,271,846,83400,39140
190,161,29,-,67200,39144
2041,1615,426,785,122200,39145
836,581,255,654,65200,39146
561,527,34,-,84300,39149
1872,1238,634,638,72400,39150
416,366,50,666,64400,39152
1193,954,239,669,83500,39153
3290,2767,523,919,177000,39154
81,81,0,-,-,39156
10707,5375,5332,1043,188300,39157
1227,713,514,517,73900,39159
1033,941,92,774,56700,39160
22,20,2,-,-,39162
209,116,93,346,77500,39166
0,0,0,-,-,39167
2555,1942,613,546,105700,39168
961,445,516,332,57200,39169
3759,3482,277,741,188300,39170
115,53,62,-,-,39174
1741,1445,296,643,80600,39175
967,744,223,342,80000,39176
50,23,27,-,136300,39177
397,305,92,-,117200,39179
12577,8273,4304,730,121900,39180
5577,3699,1878,703,141400,39183
1369,1004,365,604,68500,39189
2655,2256,399,814,104400,39191
482,420,62,-,54900,39192
0,0,0,-,-,39193
6131,3527,2604,624,86800,39194
280,15,265,1238,-,39201
3565,972,2593,795,180100,39202
1898,845,1053,695,46700,39203
5964,2080,3884,748,62700,39204
9958,4926,5032,867,96000,39206
11628,7393,4235,871,122300,39208
9534,4361,5173,807,62000,39209
10299,6597,3702,1069,159600,39211
11228,6822,4406,915,88400,39212
8199,4202,3997,671,62300,39213
1741,799,942,902,210300,39216
0,0,0,-,-,39217
2618,1627,991,961,132400,39218
3185,1657,1528,1157,189200,39232
0,0,0,-,-,39269
4922,3548,1374,1126,141400,39272
10403,6352,4051,703,82000,39301
8548,5487,3061,865,155300,39305
6278,3635,2643,643,68400,39307
0,0,0,-,-,39309
435,345,90,938,-,39320
609,532,77,-,55400,39322
671,576,95,671,59900,39323
2345,2068,277,592,161400,39325
174,174,0,-,79300,39326
1503,1127,376,544,106900,39327
1828,1196,632,355,65600,39328
1039,957,82,720,116600,39330
560,476,84,655,142700,39332
1104,990,114,-,109300,39335
485,369,116,-,70100,39336
726,666,60,467,97900,39337
1411,1176,235,592,75000,39338
5870,4299,1571,694,85400,39339
2443,1644,799,528,60600,39341
583,205,378,854,129500,39342
2348,1685,663,680,82700,39345
896,664,232,623,87200,39346
623,503,120,345,99700,39347
285,285,0,-,45800,39348
8856,6267,2589,681,80300,39350
308,296,12,-,77600,39352
958,750,208,774,71200,39354
2733,2210,523,712,80500,39355
159,105,54,-,-,39356
483,276,207,354,90000,39358
126,89,37,640,86800,39359
1201,1017,184,562,53700,39360
621,557,64,355,59500,39361
1297,1036,261,861,56500,39362
514,347,167,613,68300,39363
981,875,106,-,80300,39364
2842,2116,726,567,81600,39365
451,451,0,-,63500,39366
5729,4741,988,519,90600,39367
16390,6662,9728,750,97700,39401
15577,9915,5662,981,192000,39402
0,0,0,-,-,39406
1139,955,184,544,83600,39421
1864,1532,332,579,81000,39422
1102,896,206,625,62100,39423
913,689,224,628,110500,39425
6399,5390,1009,917,157100,39426
546,450,96,515,110300,39427
3391,2599,792,695,68200,39428
6170,4972,1198,598,92500,39429
4473,3535,938,760,126100,39437
1695,1490,205,583,72400,39439
7835,4378,3457,692,88200,39440
8118,6417,1701,652,97200,39443
1268,945,323,578,71200,39451
9038,7293,1745,724,112500,39452
3430,2625,805,542,100500,39455
306,247,59,642,142500,39456
1411,1096,315,-,85300,39459
276,276,0,-,77500,39461
428,295,133,527,109800,39462
1104,1019,85,649,114500,39464
7533,5761,1772,883,146000,39465
10138,7105,3033,751,121300,39466
4845,4185,660,637,121100,39470
2241,1589,652,626,93200,39474
4998,3574,1424,861,157200,39475
2770,2377,393,584,98000,39476
257,218,39,836,95500,39477
750,620,130,-,125000,39478
2208,1838,370,621,111000,39479
1234,1052,182,779,116500,39480
586,507,79,-,122400,39481
3702,3131,571,774,161400,39482
2489,2126,363,627,81500,39483
9142,3324,5818,819,86900,39501
19737,12847,6890,919,144200,39503
7220,3460,3760,880,166300,39507
8142,5550,2592,872,149400,39520
3767,3214,553,1039,173200,39525
3279,1370,1909,779,114000,39530
7707,2460,5247,857,152600,39531
14033,8599,5434,971,172400,39532
0,0,0,-,-,39534
3426,1195,2231,957,113300,39540
6295,4010,2285,894,133300,39553
3299,2867,432,876,122300,39556
7139,4657,2482,961,149400,39560
976,778,198,-,99300,39561
6129,5138,991,830,122500,39562
5102,3680,1422,867,90800,39563
14942,10845,4097,995,161400,39564
6852,5665,1187,910,157700,39565
4073,2535,1538,767,118900,39567
5266,4163,1103,887,166800,39571
467,463,4,-,114500,39572
2850,2309,541,768,110700,39573
4952,4184,768,877,146400,39574
2394,1458,936,804,142900,39576
3565,2370,1195,666,110800,39577
4362,2082,2280,742,104300,39581
8345,5922,2423,729,98900,39601
2811,2306,505,679,119800,39629
359,187,172,411,57200,39630
1360,1002,358,415,86800,39631
487,405,82,-,46600,39633
130,86,44,-,69800,39635
1257,1021,236,468,64900,39638
1430,1271,159,-,88700,39641
393,286,107,1004,107200,39643
2210,1857,353,722,79800,39645
319,308,11,-,73700,39647
7319,4165,3154,705,95000,39648
2910,2422,488,740,92100,39652
911,673,238,738,82400,39653
2019,1453,566,697,101200,39654
228,189,39,-,53800,39656
802,650,152,657,86600,39657
1061,789,272,524,70200,39661
506,506,0,-,81100,39662
1220,836,384,803,99600,39663
857,680,177,816,119900,39664
577,512,65,769,78200,39665
3846,3104,742,723,116600,39666
4700,4178,522,581,99000,39667
326,251,75,-,78600,39668
1782,1547,235,640,69700,39669
5140,2851,2289,658,123300,39701
8352,5566,2786,768,121800,39702
5266,2878,2388,923,168300,39705
4411,3123,1288,602,80700,39730
1398,1034,364,392,107900,39735
98,52,46,450,78000,39736
99,99,0,-,104900,39737
866,650,216,569,58400,39739
2034,1605,429,750,147600,39740
678,605,73,-,86500,39741
700,641,59,-,73900,39743
2105,1462,643,516,79000,39744
308,263,45,-,-,39745
1204,1004,200,625,115300,39746
744,599,145,519,62900,39747
918,649,269,689,87500,39750
622,531,91,556,85400,39751
1113,997,116,509,86300,39752
340,306,34,769,85300,39755
675,590,85,-,64200,39756
16583,8256,8327,790,169400,39759
12,12,0,-,-,39760
21,0,21,-,-,39762
1179,935,244,942,104600,39766
421,368,53,-,66900,39767
683,552,131,-,106600,39769
47,41,6,-,84200,39771
619,458,161,654,62800,39772
6007,3982,2025,728,92300,39773
615,459,156,715,60200,39776
787,463,324,445,76500,39813
664,438,226,802,65100,39815
3841,2062,1779,664,104900,39817
4032,2141,1891,684,146900,39819
2963,1867,1096,727,93800,39823
245,176,69,538,98900,39824
530,347,183,594,110200,39825
203,125,78,600,110200,39826
1489,1081,408,807,122400,39827
5301,2986,2315,779,122600,39828
872,693,179,721,81100,39834
88,47,41,-,158500,39836
2591,1726,865,624,88100,39837
1918,1033,885,611,68400,39840
339,296,43,550,61300,39841
2951,1549,1402,638,88900,39842
3016,1937,1079,727,81600,39845
790,548,242,547,50800,39846
870,579,291,333,48900,39851
869,647,222,702,63600,39854
414,316,98,442,87500,39859
514,294,220,700,83600,39861
496,326,170,584,96000,39862
138,105,33,467,77300,39866
182,153,29,-,98000,39867
863,559,304,506,91200,39870
193,156,37,821,68700,39877
34,26,8,1000,125000,39885
611,384,227,491,66900,39886
1350,1069,281,772,67700,39897
733,598,135,1056,169200,40003
11945,8779,3166,769,152800,40004
1916,1434,482,678,117000,40006
38,38,0,-,-,40007
1232,999,233,757,153700,40008
379,307,72,696,73400,40009
195,145,50,-,337900,40010
1065,867,198,765,103600,40011
251,201,50,773,102400,40012
2027,1837,190,773,183000,40013
6940,5929,1011,946,298000,40014
1519,941,578,757,119100,40019
52,42,10,-,139300,40020
341,310,31,-,346900,40022
1957,1839,118,1245,328300,40023
32,32,0,-,900000,40025
1922,1771,151,1188,300200,40026
7615,5752,1863,834,227100,40031
5069,3521,1548,632,106700,40033
104,82,22,-,81800,40036
1016,916,100,650,117100,40037
121,92,29,1102,66800,40040
304,76,228,1156,-,40041
1466,1114,352,772,133800,40045
691,683,8,-,162200,40046
7701,6643,1058,803,180900,40047
0,0,0,-,-,40048
0,0,0,-,-,40049
539,302,237,764,123200,40050
1841,1387,454,672,130700,40051
208,165,43,-,89600,40052
715,590,125,844,206200,40055
1325,1263,62,1098,208900,40056
1418,1030,388,794,124300,40057
32,32,0,-,92300,40058
7295,6618,677,1560,446900,40059
460,338,122,564,123300,40060
103,69,34,1014,106600,40062
0,0,0,-,-,40063
11282,7290,3992,838,183700,40065
2022,1567,455,900,268200,40067
822,674,148,677,172100,40068
3219,2322,897,607,131900,40069
251,219,32,-,145700,40070
5635,4705,930,634,215100,40071
388,277,111,1048,169300,40075
902,831,71,1068,174400,40076
156,142,14,-,163600,40077
923,749,174,588,114300,40078
429,345,84,795,123200,40104
863,635,228,804,170000,40107
4544,3704,840,721,166500,40108
767,688,79,948,169400,40109
38,27,11,-,-,40110
644,466,178,268,74700,40111
178,164,14,-,107300,40115
952,704,248,809,139600,40117
3432,2282,1150,913,106400,40118
786,701,85,922,143500,40119
2473,20,2453,1090,-,40121
249,171,78,841,63200,40140
894,696,198,872,119100,40142
2320,1761,559,615,108000,40143
544,478,66,522,114000,40144
205,178,27,-,89100,40145
1480,1088,392,644,91400,40146
1536,1071,465,736,142100,40150
408,408,0,-,145800,40152
427,157,270,637,61100,40155
346,278,68,1059,106500,40157
9423,5071,4352,762,129100,40160
68,23,45,-,-,40161
2292,1998,294,663,192500,40162
13658,10502,3156,779,174400,40165
148,148,0,-,-,40170
90,76,14,-,75600,40171
5176,3910,1266,925,153600,40175
382,353,29,-,88100,40176
639,465,174,705,106300,40177
155,155,0,-,133100,40178
2703,198,2505,339,290600,40202
8671,1446,7225,554,86100,40203
7329,3418,3911,930,201500,40204
10427,7588,2839,949,287000,40205
9624,5017,4607,854,220200,40206
13863,9715,4148,1036,307100,40207
5824,1539,4285,767,86300,40208
130,38,92,-,47600,40209
5424,2259,3165,584,61300,40210
8835,3414,5421,770,69600,40211
6337,2783,3554,710,64200,40212
6937,4299,2638,816,115200,40213
17703,9484,8219,788,133700,40214
7948,3275,4673,800,78600,40215
17345,11129,6216,736,115200,40216
6059,3703,2356,897,154100,40217
13402,6663,6739,835,135100,40218
15675,8607,7068,781,133600,40219
14576,9274,5302,972,181300,40220
10169,5985,4184,995,264000,40222
9471,6960,2511,1140,261900,40223
6398,5466,932,996,161600,40228
14206,10505,3701,1039,137800,40229
0,0,0,-,-,40231
12789,8815,3974,1183,274000,40241
4573,3162,1411,1058,208600,40242
4682,3106,1576,1111,222700,40243
12300,10303,1997,1194,341300,40245
10303,7573,2730,822,127200,40258
14305,10670,3635,1004,131500,40272
115,42,73,872,580600,40280
14978,11782,3196,969,176200,40291
16127,12373,3754,1029,212700,40299
134,101,33,752,76300,40310
2803,1936,867,605,91600,40311
2244,1495,749,668,85200,40312
1084,552,532,687,83300,40313
198,178,20,-,110800,40316
1338,1065,273,569,73500,40322
18046,12296,5750,909,186800,40324
383,323,60,713,72800,40328
7934,5618,2316,622,140600,40330
11,11,0,-,-,40334
4894,3489,1405,574,79200,40336
2063,1712,351,725,81700,40337
0,0,0,-,-,40339
8566,6484,2082,708,149800,40342
259,224,35,650,77400,40346
1151,843,308,831,235800,40347
255,152,103,606,104700,40348
65,65,0,-,-,40350
7640,4692,2948,635,130200,40351
8433,5422,3011,709,131200,40353
16176,10600,5576,798,170600,40356
442,405,37,-,106100,40358
2532,1769,763,601,115400,40359
2625,1749,876,633,90900,40360
7440,4663,2777,735,149900,40361
15,15,0,-,-,40363
1067,926,141,679,203600,40370
1192,967,225,643,72000,40371
798,719,79,728,203900,40372
689,456,233,702,98800,40374
36,36,0,-,-,40376
1440,1142,298,794,157400,40379
2432,1704,728,674,102900,40380
9211,6558,2653,765,206900,40383
1009,790,219,848,86600,40385
861,658,203,708,77700,40387
2415,1335,1080,708,174400,40390
14324,9636,4688,728,145100,40391
1101,775,326,662,102500,40402
9081,6120,2961,720,138700,40403
0,0,0,-,-,40404
1366,918,448,603,86300,40409
1606,1336,270,437,79800,40419
9214,5882,3332,728,161500,40422
0,0,0,-,-,40434
2085,1674,411,631,111600,40437
925,723,202,660,90000,40440
363,279,84,493,125300,40442
5605,4605,1000,692,146100,40444
300,271,29,475,80500,40445
3311,2393,918,463,84300,40447
26,12,14,-,-,40448
3951,2944,1007,553,84900,40456
451,369,82,-,92500,40460
1383,989,394,719,148400,40461
512,497,15,-,75500,40464
679,462,217,832,100000,40468
643,500,143,582,61900,40472
23220,12950,10270,705,170200,40475
29,17,12,-,-,40481
4524,3341,1183,673,114900,40484
1055,945,110,-,86000,40486
1775,1646,129,637,100900,40489
12323,7106,5217,925,351700,40502
12242,8311,3931,949,193800,40503
11556,3726,7830,735,152900,40504
10916,6248,4668,773,121800,40505
0,0,0,-,-,40506
1321,265,1056,639,314100,40507
9448,2287,7161,770,126800,40508
16874,10463,6411,1051,242100,40509
345,258,87,948,411100,40510
12509,7946,4563,983,155800,40511
4255,3422,833,1149,359400,40513
6138,4721,1417,1208,209100,40514
14638,9345,5293,1039,227300,40515
1261,927,334,963,167200,40516
16481,6034,10447,881,134100,40517
21410,13440,7970,761,143600,40601
0,0,0,-,-,40604
11443,7607,3836,609,118400,40701
2011,1552,459,699,102100,40729
1385,989,396,518,84500,40734
283,268,15,-,90000,40737
1108,820,288,700,97800,40740
9006,6039,2967,652,118800,40741
66,40,26,-,233300,40743
6872,5019,1853,651,117200,40744
881,793,88,595,56200,40759
212,163,49,-,57500,40763
6094,3916,2178,586,72500,40769
482,285,197,580,54800,40771
159,151,8,-,51300,40801
1097,714,383,637,90400,40806
162,127,35,579,56800,40807
19,19,0,-,81000,40808
511,400,111,525,54500,40810
184,149,35,538,48900,40813
499,352,147,903,51000,40815
9,0,9,-,-,40816
15,15,0,-,-,40818
231,209,22,-,72300,40819
235,210,25,-,31100,40820
1600,954,646,434,49600,40823
134,48,86,574,40800,40824
287,250,37,-,62900,40826
335,235,100,-,48000,40827
1415,1096,319,556,51200,40828
78,23,55,-,-,40829
67,58,9,-,41900,40830
2070,1145,925,389,78400,40831
93,93,0,-,-,40840
138,130,8,-,107400,40843
46,18,28,-,-,40844
226,194,32,-,44700,40845
136,136,0,-,60300,40847
125,103,22,-,74000,40849
458,230,228,568,62400,40854
320,234,86,565,57400,40855
283,243,40,-,50300,40856
177,121,56,-,67200,40858
141,132,9,-,31100,40862
259,189,70,-,46300,40863
173,134,39,-,75200,40865
451,309,142,-,81900,40868
140,117,23,-,36300,40870
942,744,198,675,70100,40873
172,131,41,-,30100,40874
496,386,110,530,34500,40902
263,198,65,672,58800,40903
4344,2787,1557,622,82600,40906
135,73,62,525,-,40913
165,64,101,540,70800,40914
313,202,111,575,113700,40915
78,61,17,-,-,40921
190,155,35,-,59900,40923
156,156,0,-,58500,40927
1031,674,357,504,72300,40935
120,120,0,-,52900,40939
133,84,49,413,50800,40940
141,43,98,572,-,40941
232,176,56,-,85400,40943
98,73,25,-,-,40946
307,213,94,-,93100,40949
273,159,114,501,90500,40953
91,76,15,-,37500,40958
6439,4455,1984,533,53600,40962
35,17,18,-,-,40964
4906,2848,2058,558,88900,40965
536,404,132,-,46300,40972
4049,2830,1219,463,53400,40977
12,12,0,-,-,40979
136,118,18,-,59500,40982
168,111,57,-,67900,40983
208,110,98,-,63700,40988
40,40,0,-,-,40995
139,82,57,-,-,40997
6221,5425,796,859,198600,41001
1003,725,278,573,119100,41002
900,637,263,698,101900,41003
1633,1188,445,615,101000,41004
8523,6646,1877,995,183100,41005
1584,1186,398,734,147400,41006
1621,1451,170,729,226600,41007
2857,1675,1182,628,127600,41008
1347,1100,247,588,140200,41010
12167,5311,6856,735,179000,41011
2786,1258,1528,767,86900,41014
8007,5365,2642,716,127500,41015
2389,1569,820,809,107600,41016
15292,11305,3987,838,205600,41017
10650,6589,4061,922,124900,41018
2363,1591,772,790,142100,41030
6227,4280,1947,592,142100,41031
596,546,50,-,160800,41033
303,267,36,577,109200,41034
4195,2901,1294,698,133200,41035
1159,934,225,594,95900,41039
2774,1948,826,748,88600,41040
2856,1861,995,566,90500,41041
20678,13427,7251,957,156700,41042
626,522,104,718,121100,41043
384,296,88,729,127100,41044
469,362,107,829,112200,41045
452,359,93,735,79400,41046
4910,4204,706,1160,214700,41048
857,666,191,721,95100,41049
10206,8531,1675,1053,174100,41051
47,32,15,-,-,41052
705,608,97,685,152000,41055
5608,3608,2000,655,132500,41056
1099,959,140,815,192400,41059
12,12,0,-,-,41062
1156,1050,106,770,153700,41063
731,532,199,573,106900,41064
8941,4469,4472,802,132400,41071
2518,1759,759,794,136400,41073
2151,1297,854,855,107000,41074
6709,4675,2034,888,226400,41075
7144,5389,1755,941,163000,41076
712,645,67,1075,260900,41080
497,384,113,425,125600,41083
332,200,132,667,92200,41085
998,846,152,768,154200,41086
6892,6347,545,1745,264400,41091
1260,1129,131,841,177400,41092
1211,973,238,611,82200,41093
5443,4009,1434,981,202500,41094
1359,783,576,707,118900,41095
2349,1637,712,713,118100,41097
700,511,189,708,81700,41098
0,0,0,-,-,41099
7323,4501,2822,695,102200,41101
7622,5425,2197,750,122900,41102
650,631,19,-,126600,41121
368,249,119,458,71600,41124
3706,2927,779,602,119100,41129
129,109,20,-,65700,41132
53,48,5,-,-,41135
3263,2357,906,793,95200,41139
740,648,92,483,51000,41141
26,26,0,-,-,41142
5016,3797,1219,568,114300,41143
3721,3003,718,610,103900,41144
151,88,63,-,-,41146
188,167,21,-,50200,41149
246,169,77,318,44800,41159
4482,3585,897,608,77300,41164
471,392,79,-,77000,41166
934,819,115,1015,98600,41168
2207,1621,586,719,150100,41169
1672,1238,434,624,94300,41171
485,278,207,474,86500,41174
1994,1456,538,766,100700,41175
3062,2232,830,461,68000,41179
465,372,93,568,54200,41180
622,523,99,795,99500,41183
795,498,297,687,68300,41189
50,50,0,-,153300,41201
302,247,55,-,69400,41203
229,161,68,-,-,41204
192,83,109,-,93400,41214
569,470,99,634,113200,41216
781,658,123,579,72100,41219
951,896,55,623,97000,41222
2003,1467,536,580,106100,41224
68,68,0,-,64200,41226
4268,3301,967,563,83100,41230
415,225,190,689,68500,41231
261,170,91,719,118200,41232
296,273,23,-,150700,41234
246,170,76,-,114500,41238
2430,1312,1118,599,137300,41240
487,381,106,351,71100,41250
164,120,44,-,38300,41254
337,289,48,541,90300,41255
1062,799,263,752,115400,41256
219,138,81,637,68900,41257
264,121,143,-,107600,41260
419,344,75,-,70500,41262
164,77,87,619,-,41263
142,78,64,813,107500,41264
532,480,52,-,91300,41265
300,156,144,346,72500,41267
265,212,53,-,47100,41268
66,57,9,-,127000,41271
197,100,97,-,61300,41274
2508,1577,931,514,65800,41301
2739,1872,867,548,63800,41311
1850,1279,571,314,64000,41314
84,66,18,-,55600,41317
400,318,82,533,59700,41332
4312,3024,1288,496,57700,41339
457,324,133,411,40300,41348
270,237,33,-,53800,41352
200,177,23,-,51300,41360
169,90,79,349,46200,41365
19,19,0,-,-,41366
80,53,27,-,-,41367
171,144,27,-,62400,41385
12,0,12,-,-,41390
4,4,0,-,-,41397
198,167,31,673,50700,41408
211,121,90,-,43100,41421
444,377,67,795,66300,41425
255,173,82,-,39700,41464
4582,3300,1282,536,66000,41465
3561,2536,1025,526,77800,41472
9451,5816,3635,699,96700,41501
279,147,132,-,220600,41503
299,243,56,700,100800,41512
225,188,37,-,53700,41513
1344,807,537,702,74300,41514
76,76,0,-,-,41517
518,410,108,722,88800,41519
2306,1889,417,540,71100,41522
65,65,0,-,-,41524
76,50,26,-,-,41526
325,264,61,-,139100,41527
351,325,26,-,102000,41528
427,355,72,545,83100,41531
112,112,0,-,47300,41534
220,152,68,-,106100,41535
1974,1445,529,437,72100,41537
31,31,0,-,94700,41538
621,522,99,679,75400,41539
58,58,0,-,-,41540
94,83,11,-,51000,41543
297,267,30,-,71000,41544
375,283,92,-,68300,41547
465,348,117,620,55400,41548
764,720,44,-,86300,41553
428,354,74,579,61800,41554
272,210,62,-,57200,41555
765,622,143,662,55000,41557
334,260,74,564,66400,41558
80,50,30,-,37700,41559
111,91,20,-,112100,41560
1133,744,389,630,76800,41562
146,102,44,-,-,41563
307,299,8,-,89800,41564
308,195,113,-,72300,41566
51,51,0,-,-,41567
445,429,16,-,-,41568
286,234,52,-,35200,41571
1558,1301,257,769,88400,41572
304,198,106,668,73700,41601
404,353,51,-,70600,41602
618,389,229,802,64000,41603
235,210,25,-,82300,41604
181,166,15,-,126200,41605
454,350,104,562,44600,41606
170,120,50,485,33600,41607
46,11,35,-,-,41612
218,195,23,-,55800,41615
243,160,83,804,66200,41616
92,84,8,-,76700,41619
53,53,0,-,67000,41621
59,48,11,-,75400,41622
612,457,155,526,73800,41630
474,356,118,-,88300,41631
183,168,15,-,103700,41632
1227,801,426,683,67000,41635
390,229,161,705,77900,41636
467,326,141,685,60000,41640
266,153,113,623,87800,41642
32,8,24,-,-,41643
432,380,52,357,76900,41645
659,463,196,596,71900,41647
1061,645,416,478,64100,41649
144,121,23,-,38200,41650
4357,2777,1580,599,102400,41653
330,273,57,-,65900,41655
171,156,15,-,122900,41659
231,183,48,-,85000,41660
211,177,34,-,-,41663
326,219,107,826,61800,41666
220,171,49,-,48900,41667
246,153,93,535,42200,41669
6532,4860,1672,649,85300,41701
157,157,0,-,181700,41712
70,70,0,-,-,41713
157,157,0,-,48400,41714
595,497,98,667,45800,41719
248,160,88,443,38300,41721
504,368,136,683,53000,41722
708,530,178,-,77000,41723
45,31,14,-,-,41725
325,263,62,-,82700,41727
0,0,0,-,-,41729
449,401,48,475,53600,41731
71,31,40,-,48100,41735
49,42,7,-,-,41739
405,337,68,633,62500,41740
159,159,0,-,-,41745
215,156,59,-,"10,000-",41746
1144,1003,141,483,86900,41749
115,104,11,-,-,41751
103,86,17,-,169600,41754
101,56,45,-,73300,41759
5,5,0,-,-,41760
0,0,0,-,-,41762
236,172,64,579,37500,41763
291,253,38,-,49200,41764
89,89,0,-,54000,41766
114,92,22,-,-,41772
592,467,125,614,42400,41773
1010,785,225,629,52700,41774
22,22,0,-,-,41775
522,445,77,565,60400,41776
359,318,41,-,66800,41777
210,199,11,-,119800,41804
163,95,68,-,-,41810
125,105,20,-,-,41812
409,292,117,-,54300,41815
93,66,27,-,83100,41817
165,165,0,-,53400,41819
134,134,0,-,24000,41821
958,676,282,442,56500,41822
582,365,217,444,52200,41824
250,117,133,-,70800,41825
289,246,43,-,59000,41826
306,238,68,427,81300,41828
397,256,141,531,55400,41831
139,121,18,-,80100,41832
177,85,92,-,-,41833
144,101,43,-,75600,41834
361,325,36,-,53600,41835
361,307,54,629,34800,41836
433,344,89,653,70400,41837
246,246,0,-,58500,41838
572,404,168,663,53200,41839
316,214,102,606,39800,41840
354,265,89,-,42800,41843
527,216,311,326,43900,41844
142,120,22,-,13100,41845
247,231,16,-,28000,41847
0,0,0,-,-,41848
43,43,0,-,45900,41849
311,278,33,-,74000,41855
3393,2355,1038,554,75700,41858
167,143,24,444,65500,41859
66,48,18,-,26200,41861
402,375,27,-,63400,41862
12874,7867,5007,762,161700,42001
11915,7743,4172,643,116600,42003
713,691,22,-,131300,42020
658,509,149,661,75000,42021
81,81,0,-,-,42022
901,730,171,614,94800,42023
472,328,144,596,111700,42024
8046,6440,1606,649,133600,42025
634,574,60,616,138200,42027
240,222,18,-,105600,42028
2569,2081,488,744,122300,42029
1091,891,200,468,74000,42031
77,57,20,588,56900,42032
376,330,46,683,95500,42035
467,402,65,-,153300,42036
30,30,0,-,-,42037
1882,1330,552,590,155200,42038
697,531,166,454,114100,42039
367,292,75,824,131000,42040
1906,1231,675,544,76500,42041
1634,1378,256,730,157500,42044
931,670,261,689,92000,42045
143,61,82,-,-,42047
774,626,148,775,108500,42048
582,487,95,756,109900,42049
1032,688,344,548,60900,42050
1220,1097,123,670,85000,42051
2063,1730,333,847,124400,42053
323,320,3,-,131900,42054
1323,1235,88,663,92400,42055
617,501,116,844,114500,42056
940,887,53,-,125900,42058
0,0,0,-,-,42060
55,55,0,-,64500,42061
3200,2615,585,605,89100,42064
9145,6340,2805,642,108300,42066
217,202,15,-,113200,42069
12328,6962,5366,705,140700,42071
523,453,70,662,111000,42076
776,625,151,438,77700,42078
589,562,27,520,114900,42079
857,643,214,538,112300,42081
632,521,111,753,125200,42082
102,71,31,-,-,42083
23,9,14,-,-,42084
370,346,24,425,88300,42085
1757,1373,384,901,152500,42086
908,742,166,643,66300,42087
958,832,126,613,82000,42088
21407,10297,11110,758,124400,42101
106,55,51,372,"10,000-",42102
8793,5558,3235,834,235500,42103
13926,8893,5033,819,193200,42104
915,634,281,683,95700,42120
1901,1768,133,742,189400,42122
279,262,17,-,157700,42123
14,14,0,-,-,42124
2534,1626,908,602,113600,42127
2781,2116,665,504,78500,42129
103,76,27,-,161400,42130
628,446,182,604,122600,42133
6780,4326,2454,806,137200,42134
419,309,110,610,75200,42140
12274,8013,4261,703,128300,42141
51,51,0,-,-,42151
151,115,36,760,-,42153
208,201,7,-,72800,42154
144,122,22,-,137500,42156
196,143,53,573,93000,42157
600,466,134,632,165800,42159
624,454,170,698,85300,42160
49,0,49,-,-,42163
6201,4651,1550,672,123300,42164
949,786,163,588,75600,42166
3488,2448,1040,503,81000,42167
594,540,54,644,119700,42170
2689,2150,539,689,120800,42171
930,665,265,620,104700,42202
215,170,45,-,-,42204
2079,1469,610,687,102600,42206
590,481,109,590,87700,42207
1839,1491,348,582,86000,42210
5477,4378,1099,564,130300,42211
278,227,51,638,136800,42214
440,389,51,-,115900,42215
1317,1060,257,721,82000,42217
2547,1847,700,627,107400,42220
4520,0,4520,1329,-,42223
347,330,17,-,127000,42232
1030,531,499,574,116600,42234
263,190,73,822,114600,42236
16581,9123,7458,737,120000,42240
66,37,29,775,81300,42254
1865,1526,339,652,103900,42256
413,361,52,494,88200,42259
4161,2964,1197,547,90500,42261
3267,891,2376,922,115800,42262
330,240,90,577,-,42265
775,605,170,610,153500,42266
188,132,56,484,117200,42273
891,695,196,547,138700,42274
281,192,89,941,85500,42275
5706,3801,1905,649,115200,42276
141,111,30,-,115700,42280
146,116,30,-,85000,42285
443,269,174,733,144500,42286
18430,11745,6685,766,128900,42301
16009,10497,5512,783,129700,42303
3380,2390,990,648,91500,42320
47,47,0,-,-,42321
36,36,0,-,-,42322
274,236,38,775,81600,42323
478,443,35,370,71300,42324
852,654,198,552,82100,42325
141,141,0,-,109500,42326
1523,1251,272,500,116100,42327
530,444,86,822,83900,42328
3220,2393,827,621,127200,42330
103,76,27,-,-,42332
455,293,162,604,68100,42333
787,700,87,463,63000,42337
14,14,0,-,-,42338
321,303,18,-,86600,42339
633,492,141,604,96500,42343
272,247,25,-,80300,42344
4201,3230,971,590,108900,42345
2378,1791,587,568,104100,42347
1809,1471,338,608,130800,42348
463,377,86,572,88000,42349
609,506,103,608,95700,42350
1647,1258,389,669,93600,42351
864,626,238,407,87100,42352
68,59,9,844,73800,42354
812,721,91,624,118600,42355
0,0,0,-,-,42356
191,151,40,-,120100,42361
2032,1813,219,834,172200,42366
290,220,70,669,84900,42367
458,413,45,-,84100,42368
102,86,16,600,67100,42369
6,6,0,-,-,42370
154,146,8,-,128300,42371
710,588,122,580,90700,42372
131,115,16,-,-,42374
2254,1943,311,688,130200,42376
1207,1032,175,703,145000,42378
915,675,240,455,70400,42404
1360,1029,331,668,135700,42406
2851,2060,791,558,66000,42408
912,693,219,537,94700,42409
542,294,248,747,53000,42410
669,540,129,644,89800,42411
1203,1074,129,1090,163200,42413
15436,8838,6598,688,129000,42420
10643,6791,3852,742,122200,42431
439,328,111,-,124200,42436
2808,1860,948,605,113000,42437
379,251,128,676,46900,42440
641,475,166,616,124400,42441
1251,1041,210,638,97800,42442
4357,3315,1042,573,89100,42445
1565,1132,433,568,56000,42450
355,279,76,-,76200,42451
873,769,104,834,145100,42452
232,191,41,806,66900,42453
1166,722,444,752,90500,42455
660,538,122,488,92900,42456
526,437,89,-,123400,42458
1765,1305,460,526,82400,42459
500,344,156,696,50800,42461
434,383,51,575,97900,42462
36,36,0,-,42700,42463
685,601,84,493,91600,42464
6940,4069,2871,627,90300,42501
9298,6628,2670,726,150400,42503
201,182,19,-,58900,42516
1122,880,242,697,95700,42518
1336,977,359,649,73000,42519
602,471,131,394,88300,42528
307,185,122,809,87300,42533
3706,2727,979,497,84800,42539
242,235,7,-,74100,42541
2376,1851,525,645,108300,42544
2176,1677,499,636,115900,42553
276,226,50,-,63300,42565
164,135,29,-,115800,42566
2393,1723,670,900,98300,42567
3983,2777,1206,475,72700,42602
13,4,9,-,-,42603
2207,1677,530,543,111700,42629
76,0,76,-,-,42631
7812,5683,2129,537,87900,42633
529,451,78,422,66800,42634
1315,903,412,536,85800,42635
25,25,0,-,-,42638
4703,3442,1261,560,89100,42642
1382,937,445,624,58100,42647
859,673,186,574,74000,42649
1816,1206,610,534,71300,42653
20424,12534,7890,814,175500,42701
577,410,167,615,120400,42712
799,563,236,536,91100,42713
116,116,0,-,95200,42715
661,490,171,719,139000,42716
2577,1868,709,465,89700,42717
9862,6040,3822,639,122200,42718
1323,1058,265,599,114100,42721
212,179,33,793,155100,42722
1853,1592,261,809,143400,42724
1829,1396,433,673,112300,42726
6000,4483,1517,553,98800,42728
630,455,175,773,105300,42729
61,61,0,-,72900,42731
689,499,190,818,93600,42732
512,363,149,914,93400,42733
823,592,231,820,149200,42740
197,149,48,752,113200,42741
3517,2526,991,542,79400,42743
728,598,130,448,86700,42746
3452,2508,944,709,113600,42748
2225,1530,695,477,96900,42749
316,265,51,633,75200,42753
6051,4190,1861,575,112000,42754
1158,968,190,690,89700,42757
34,22,12,-,-,42758
44,37,7,-,-,42762
312,247,65,-,109500,42764
2252,1721,531,507,96100,42765
889,740,149,772,125300,42776
417,336,81,612,51300,42782
949,745,204,718,101500,42784
134,112,22,-,168100,42788
993,886,107,1413,206500,43001
2474,1564,910,1404,180500,43002
1047,749,298,776,136300,43003
10215,7628,2587,987,192200,43004
67,67,0,-,199200,43005
194,158,36,869,133300,43006
1094,671,423,696,107400,43008
868,688,180,1023,197300,43009
94,69,25,864,117300,43010
2942,2381,561,709,199800,43011
277,246,31,875,168000,43013
1333,942,391,668,162300,43014
19984,13869,6115,940,211800,43015
15340,8314,7026,1180,296200,43016
15739,10936,4803,1236,354700,43017
3087,2574,513,750,151700,43019
4114,3898,216,1163,388200,43021
1103,770,333,854,220100,43022
4291,3653,638,922,307800,43023
2087,1610,477,667,185400,43025
23919,16696,7223,1117,224900,43026
3039,2620,419,1053,157500,43028
139,119,20,-,187500,43029
52,52,0,-,-,43030
5007,4044,963,935,224100,43031
10,10,0,-,-,43032
120,85,35,548,109000,43033
9005,7427,1578,1181,322900,43035
138,69,69,698,83800,43036
107,68,39,663,90000,43037
12422,9041,3381,1007,197200,43040
1841,1394,447,796,136700,43044
827,716,111,1030,170000,43045
1491,1199,292,911,205100,43046
11729,7785,3944,730,137000,43050
10408,7051,3357,1344,351500,43054
24315,14848,9467,783,132800,43055
7026,5362,1664,908,155800,43056
996,773,223,811,138500,43060
1677,1549,128,907,289100,43061
10275,8272,2003,1093,194800,43062
4779,4100,679,933,269000,43064
14942,13692,1250,1117,338800,43065
521,497,24,-,213500,43066
517,465,52,788,185100,43067
21006,12728,8278,971,151700,43068
67,67,0,-,62800,43070
744,617,127,828,186800,43071
2214,1765,449,688,134000,43072
4761,3827,934,1155,271500,43074
3466,2912,554,806,171800,43076
88,70,18,942,116700,43077
8293,5582,2711,672,127400,43078
1914,1364,550,706,158100,43080
24953,15954,8999,1128,210500,43081
11948,10565,1383,1333,324300,43082
246,220,26,790,159000,43084
10207,7357,2850,1132,256900,43085
135,89,46,733,84500,43101
1670,1263,407,823,171100,43102
3968,3136,832,781,170400,43103
2900,2440,460,838,197000,43105
622,450,172,828,87400,43106
1169,944,225,840,152200,43107
29,25,4,-,104200,43109
14991,8673,6318,1038,177900,43110
125,125,0,-,76500,43111
1771,1536,235,831,243800,43112
9353,6333,3020,809,151100,43113
545,381,164,933,160200,43115
562,513,49,963,213500,43116
61,35,26,-,-,43117
10115,7142,2973,993,156700,43119
25159,18333,6826,1012,171400,43123
5275,3199,2076,980,162500,43125
191,129,62,1025,118400,43126
109,74,35,-,75000,43127
1017,671,346,715,90500,43128
23657,15804,7853,805,150100,43130
1631,1301,330,525,132100,43135
334,242,92,892,216300,43136
956,763,193,817,134500,43137
7291,5111,2180,610,130100,43138
7608,5231,2377,833,162500,43140
57,25,32,675,58100,43142
2150,1491,659,828,154300,43143
157,113,44,531,63300,43144
845,637,208,824,127900,43145
3182,2773,409,801,203700,43146
14044,11878,2166,1171,223000,43147
832,607,225,758,158700,43148
936,873,63,789,165600,43149
813,661,152,730,147500,43150
119,77,42,862,90500,43151
361,245,116,680,101900,43152
337,234,103,835,158000,43153
1203,912,291,888,166200,43154
990,882,108,870,162900,43155
69,54,15,-,104500,43156
235,136,99,890,108000,43157
158,124,34,-,66500,43158
9055,5582,3473,710,112600,43160
2767,2082,685,888,148700,43162
785,572,213,814,131900,43164
12633,2164,10469,1007,251500,43201
9096,2727,6369,979,229600,43202
3413,1041,2372,720,172900,43203
16517,8179,8338,885,110900,43204
5477,1964,3513,733,151700,43205
10417,4876,5541,971,171800,43206
17856,10623,7233,889,93100,43207
11743,6675,5068,885,256000,43209
236,0,236,656,-,43210
8377,3282,5095,845,54600,43211
11646,4054,7592,1108,351500,43212
13827,4891,8936,864,120600,43213
12428,7684,4744,964,265600,43214
9666,1748,7918,1215,292300,43215
727,46,681,879,30700,43217
11841,5460,6381,915,104600,43219
11771,6514,5257,1035,317400,43220
13726,9895,3831,1236,290600,43221
1411,313,1098,753,68000,43222
8833,3982,4851,814,75500,43223
17350,7995,9355,793,91300,43224
9621,4402,5219,868,83400,43227
22127,10331,11796,895,127200,43228
20961,8385,12576,851,133700,43229
23746,14951,8795,1109,194200,43230
8116,4011,4105,940,141400,43231
18944,7373,11571,816,99600,43232
18400,10611,7789,1131,241600,43235
2048,615,1433,1209,203200,43240
20425,12863,7562,735,92200,43302
1091,922,169,831,129100,43310
7605,5074,2531,731,121800,43311
1233,973,260,636,140100,43314
2826,2071,755,811,152100,43315
2405,1778,627,622,118500,43316
52,37,15,843,-,43317
1405,1191,214,815,130300,43318
385,385,0,-,187200,43319
541,489,52,796,112300,43320
117,98,19,731,116700,43321
133,98,35,729,91100,43322
324,292,32,638,119300,43323
1311,1127,184,783,173200,43324
5489,3874,1615,611,98400,43326
41,22,19,614,70000,43330
2175,1726,449,744,108900,43331
626,499,127,661,103200,43332
324,262,62,-,87500,43333
2298,1940,358,877,166500,43334
0,0,0,-,-,43336
486,438,48,1125,116100,43337
3747,3022,725,578,156400,43338
689,536,153,722,136800,43340
387,329,58,635,105500,43341
1087,952,135,938,138000,43342
492,401,91,492,132600,43343
2296,1891,405,817,152400,43344
347,302,45,768,135800,43345
552,475,77,811,130500,43347
913,580,333,701,102800,43348
4256,2967,1289,619,129600,43351
475,344,131,775,141400,43356
1597,1205,392,652,160500,43357
1119,894,225,767,136900,43358
292,208,84,629,117400,43359
643,490,153,807,188200,43360
13691,6214,7477,731,178900,43402
5,0,5,-,-,43403
668,516,152,835,115700,43406
209,204,5,638,118800,43407
110,96,14,940,89400,43408
4061,3037,1024,749,114900,43410
1582,1357,225,879,173800,43412
472,410,62,895,100000,43413
1341,1016,325,645,143000,43416
12140,8329,3811,687,111400,43420
1734,1395,339,713,121400,43430
1786,1417,369,729,125100,43431
522,522,0,-,161200,43432
41,41,0,-,104500,43433
24,22,2,-,62000,43434
454,401,53,1053,136300,43435
205,138,67,825,112500,43437
120,114,6,-,293500,43438
40,40,0,-,66100,43439
2520,2035,485,818,191200,43440
410,307,103,858,110600,43442
725,606,119,768,156100,43443
539,522,17,-,176500,43445
39,38,1,-,237500,43446
1260,1144,116,830,141300,43447
3473,2586,887,776,145800,43449
1446,1084,362,795,176500,43450
443,337,106,687,144100,43451
6337,4706,1631,671,154500,43452
169,146,23,1021,378800,43456
564,463,101,800,112900,43457
161,133,28,618,86900,43458
2681,1931,750,706,143000,43460
405,321,84,877,121100,43462
35,0,35,-,-,43463
507,399,108,-,126800,43464
2476,1785,691,704,115400,43465
851,702,149,769,143500,43466
36,32,4,-,55600,43467
135,101,34,-,90400,43468
1270,992,278,756,140400,43469
331,243,88,680,109400,43501
2529,1962,567,637,152600,43502
437,415,22,983,164400,43504
41,29,12,520,117200,43505
6183,4585,1598,718,111800,43506
505,463,42,1303,142300,43511
11527,8383,3144,751,122800,43512
3178,2712,466,689,134700,43515
1151,796,355,834,115600,43516
1547,1279,268,701,114000,43517
1028,901,127,721,124500,43518
95,78,17,-,88900,43519
1166,844,322,664,94700,43521
1356,1196,160,831,155600,43522
10,10,0,-,-,43523
515,413,102,625,110600,43524
400,348,52,919,181900,43525
2268,1872,396,802,109400,43526
769,641,128,632,97000,43527
6364,4773,1591,967,186400,43528
88,59,29,859,65000,43529
127,67,60,-,106000,43531
1528,1286,242,776,145300,43532
649,505,144,562,142800,43533
667,557,110,649,102700,43534
261,221,40,796,115800,43535
40,40,0,-,-,43536
11490,8344,3146,813,173800,43537
573,446,127,716,142000,43540
51,47,4,-,86400,43541
1342,1300,42,-,262300,43542
3210,2714,496,656,91600,43543
5770,4239,1531,719,134200,43545
132,116,16,-,169900,43547
298,264,34,583,102300,43548
525,482,43,631,120100,43549
15796,10529,5267,986,212100,43551
91,70,21,-,125000,43553
1009,683,326,793,98400,43554
63,45,18,-,143500,43555
653,541,112,596,103300,43556
993,816,177,751,115900,43557
5333,4693,640,761,144800,43558
12277,9951,2326,902,201200,43560
162,97,65,943,122300,43565
3161,2724,437,1096,203900,43566
5000,3691,1309,812,132700,43567
1078,863,215,842,122800,43569
1257,912,345,650,106100,43570
2764,2281,483,852,216300,43571
4423,648,3775,412,50000,43604
10464,4521,5943,703,38600,43605
9931,5295,4636,777,124000,43606
9029,4241,4788,706,58800,43607
5169,2606,2563,738,34300,43608
8736,3994,4742,721,45500,43609
1805,871,934,697,55100,43610
7894,5149,2745,759,84700,43611
12089,6335,5754,818,68600,43612
13973,8649,5324,795,93500,43613
14303,7752,6551,737,119500,43614
17974,9400,8574,775,96600,43615
8612,6141,2471,670,146200,43616
2751,2483,268,856,218500,43617
2899,2371,528,798,142900,43619
2476,744,1732,513,106300,43620
8964,5609,3355,698,134700,43623
22844,14656,8188,718,114700,43701
25,8,17,-,-,43711
2617,2214,403,481,104500,43713
824,686,138,586,123100,43716
76,67,9,425,65500,43717
1198,988,210,622,123800,43718
1085,868,217,639,111300,43719
521,463,58,791,108300,43720
47,18,29,-,-,43721
120,98,22,-,64700,43722
2058,1328,730,574,84400,43723
2897,2193,704,646,97600,43724
8413,5554,2859,661,115300,43725
489,439,50,-,120000,43727
560,450,110,712,107800,43728
773,691,82,661,101500,43730
2048,1504,544,627,83800,43731
636,560,76,681,104600,43732
8,8,0,-,-,43733
584,421,163,576,140100,43734
147,61,86,546,27400,43735
29,24,5,-,77500,43736
56,44,12,620,84700,43738
724,635,89,735,154700,43739
92,77,15,961,109400,43740
596,501,95,-,127500,43746
357,266,91,817,104900,43747
1048,813,235,691,100400,43748
1014,851,163,-,117200,43749
40,40,0,-,48200,43750
480,364,116,638,116000,43754
654,506,148,1070,142400,43755
2168,1458,710,662,97300,43756
1237,982,255,714,102900,43758
24,14,10,617,37500,43759
561,359,202,799,123100,43760
24,24,0,-,-,43761
1633,1233,400,817,165400,43762
3182,1988,1194,644,96900,43764
635,468,167,672,72300,43766
332,305,27,-,142400,43767
154,80,74,1058,103600,43768
714,571,143,663,104400,43771
810,652,158,758,101500,43772
1266,1031,235,765,125700,43773
1852,1385,467,517,75000,43777
479,417,62,677,148800,43778
384,323,61,632,106100,43779
877,809,68,665,157300,43780
201,165,36,748,66600,43782
1961,1648,313,806,147100,43783
12,8,4,-,-,43786
1285,1076,209,597,99600,43787
214,189,25,725,151100,43788
2081,1508,573,576,100200,43793
328,301,27,544,129400,43802
957,648,309,690,196300,43804
42,0,42,-,-,43805
327,259,68,710,88100,43811
7873,5276,2597,586,88400,43812
1648,1381,267,637,130400,43821
1945,1694,251,733,140000,43822
1249,1100,149,739,153800,43824
2239,1705,534,657,169900,43830
3062,2350,712,714,90400,43832
51,43,8,-,79500,43836
676,592,84,789,106600,43837
465,397,68,820,159200,43840
192,125,67,565,-,43842
422,345,77,581,186800,43843
1479,1277,202,717,108700,43844
1870,1488,382,642,90200,43845
780,646,134,691,99300,43901
28,11,17,-,-,43902
851,658,193,758,112400,43903
59,25,34,-,-,43905
3358,2244,1114,594,86200,43906
2282,1726,556,600,91900,43907
578,445,133,732,102800,43908
1292,1216,76,848,142900,43910
2792,1952,840,544,84500,43912
642,377,265,618,68600,43913
67,58,9,-,100800,43914
536,467,69,583,111800,43915
1437,1288,149,631,84900,43917
9074,6043,3031,656,81900,43920
54,0,54,-,-,43925
94,66,28,-,57700,43926
87,87,0,-,66400,43927
47,37,10,-,-,43928
344,235,109,642,109400,43930
117,117,0,-,144500,43931
327,283,44,616,109200,43932
753,696,57,-,91300,43933
181,172,9,-,62400,43934
3572,2471,1101,609,75400,43935
2235,1820,415,672,81400,43938
182,160,22,645,96400,43939
108,79,29,-,114400,43940
1096,852,244,442,97300,43942
1334,1120,214,580,87000,43943
998,829,169,851,106000,43944
1257,953,304,595,111400,43945
936,753,183,731,117200,43946
2163,1699,464,681,101400,43947
190,156,34,663,75500,43948
5089,4104,985,753,165600,43950
19,19,0,-,-,43951
7143,3610,3533,651,87200,43952
5027,3433,1594,762,114000,43953
171,111,60,667,61400,43961
33,29,4,-,85000,43962
628,342,286,631,90200,43963
3766,2759,1007,580,93100,43964
0,0,0,-,-,43967
2759,1962,797,539,75300,43968
12,12,0,-,-,43970
484,262,222,603,81100,43971
25,25,0,-,-,43972
958,825,133,629,99500,43973
37,35,2,-,72500,43974
613,494,119,679,94100,43976
860,656,204,782,75600,43977
229,143,86,-,116100,43983
30,22,8,-,75000,43985
866,680,186,685,94000,43986
1022,785,237,739,113000,43988
8428,7149,1279,815,160300,44001
1546,1071,475,663,89900,44003
13376,8370,5006,676,92000,44004
570,365,205,1281,162600,44010
8108,6832,1276,1235,296900,44011
9539,7775,1764,1136,256400,44012
7202,4963,2239,847,138300,44017
2296,1762,534,871,185800,44021
6740,5957,783,1473,368000,44022
6704,6087,617,1277,315200,44023
9349,7770,1579,766,238400,44024
4379,4233,146,1151,242100,44026
3304,3076,228,1162,206600,44028
5989,4492,1497,673,99800,44030
461,427,34,-,105600,44032
26998,16757,10241,757,106300,44035
12935,11294,1641,962,182300,44039
1147,1097,50,1571,438500,44040
5994,3987,2007,698,119000,44041
4375,3782,593,791,179400,44044
199,145,54,950,129600,44045
838,648,190,734,175000,44046
3384,2770,614,738,136300,44047
903,677,226,667,120200,44048
89,76,13,756,110000,44049
2347,1982,365,899,163700,44050
11480,6117,5363,694,76600,44052
8162,5424,2738,671,135500,44053
4895,3994,901,907,129300,44054
7427,3621,3806,727,64700,44055
4610,4286,324,979,223400,44056
7511,5822,1689,896,142300,44057
25225,20871,4354,944,170600,44060
3853,2887,966,665,175500,44062
681,625,56,1132,206800,44064
1789,1597,192,748,206800,44065
8179,6934,1245,1024,194400,44067
13081,9705,3376,911,156200,44070
1873,1549,324,1038,276300,44072
3843,2469,1374,847,179800,44074
1715,1193,522,713,147100,44076
22303,15943,6360,813,163600,44077
101,69,32,-,114400,44080
2613,2365,248,790,184200,44081
657,512,145,628,149300,44082
1145,979,166,822,131900,44084
1263,1081,182,936,147900,44085
932,845,87,1065,174500,44086
8666,6303,2363,1102,219600,44087
6608,5140,1468,918,148800,44089
4894,3703,1191,669,169400,44090
7830,5373,2457,866,128100,44092
423,359,64,-,154600,44093
16211,10379,5832,967,185700,44094
14372,10522,3850,868,125800,44095
726,682,44,-,170800,44099
0,0,0,-,-,44101
19433,6230,13203,733,76300,44102
7175,2455,4720,583,49200,44103
8977,2468,6509,519,49200,44104
15427,7184,8243,746,49500,44105
11154,3192,7962,789,167900,44106
24781,10680,14101,796,158100,44107
9316,4346,4970,712,54700,44108
17279,8125,9154,719,76400,44109
9005,3341,5664,681,53600,44110
17814,9808,8006,772,89700,44111
9789,3586,6203,660,61300,44112
9760,2646,7114,945,189500,44113
3838,254,3584,923,64700,44114
4051,373,3678,634,109800,44115
9098,6542,2556,921,245400,44116
5023,2045,2978,680,98200,44117
15645,9264,6381,961,150000,44118
5773,2914,2859,789,82700,44119
16096,7154,8942,777,93800,44120
13823,9018,4805,929,96500,44121
13608,8917,4691,1224,242700,44122
7921,3904,4017,826,77000,44123
17289,11552,5737,962,153700,44124
11489,7471,4018,953,77100,44125
7099,5088,2011,786,161100,44126
1811,717,1094,655,35100,44127
12865,6709,6156,827,64400,44128
11895,8281,3614,850,111400,44129
22252,14217,8035,856,132000,44130
8309,7681,628,1215,187300,44131
6350,2772,3578,832,81300,44132
12859,9343,3516,896,207800,44133
15614,11835,3779,890,113600,44134
11893,7395,4498,727,81200,44135
10399,7697,2702,982,202500,44136
9411,5527,3884,926,68200,44137
9267,7327,1940,1049,165000,44138
8834,7336,1498,1260,285600,44139
6021,5560,461,1040,247900,44140
5617,4797,820,1582,282900,44141
7574,5872,1702,863,118300,44142
10754,7645,3109,811,192800,44143
9596,5495,4101,735,92400,44144
13809,9975,3834,1174,258600,44145
13980,7452,6528,834,106400,44146
7675,6299,1376,885,229700,44147
7496,6883,613,1151,213000,44149
2467,1971,496,998,169000,44201
7720,6561,1159,1471,249900,44202
16604,11358,5246,799,105700,44203
17253,13514,3739,914,176800,44212
853,750,103,569,165600,44214
891,699,192,940,146300,44215
3493,3207,286,800,161300,44216
1362,1161,201,789,136700,44217
13326,7656,5670,844,115800,44221
7626,5799,1827,787,156800,44223
16232,10875,5357,1005,186200,44224
3518,3024,494,836,144700,44230
3386,2744,642,717,154400,44231
3008,2951,57,866,318400,44233
1356,1165,191,764,187800,44234
598,494,104,-,211400,44235
9167,8080,1087,1708,338100,44236
16334,8326,8008,821,158900,44240
6519,4661,1858,1088,147200,44241
0,0,0,-,-,44243
489,375,114,934,96200,44250
398,372,26,469,228400,44251
1084,1006,78,818,205700,44253
2137,1472,665,658,145600,44254
3109,2379,730,747,152000,44255
24485,19421,5064,880,214800,44256
4965,3990,975,868,149900,44260
2051,1598,453,769,161100,44262
1166,941,225,923,264500,44264
0,0,0,-,-,44265
13598,9646,3952,812,119900,44266
3493,2382,1111,732,134500,44270
2010,1571,439,931,169700,44272
2952,2491,461,748,177500,44273
46,46,0,-,-,44274
1273,1066,207,775,166700,44275
649,559,90,643,151000,44276
7223,5924,1299,789,171800,44278
1728,1511,217,1585,282900,44280
12761,9727,3034,869,187000,44281
10,10,0,-,-,44285
2309,2146,163,970,282500,44286
2973,2514,459,706,125500,44287
1367,864,503,805,110300,44288
6169,3749,2420,840,78100,44301
2382,799,1583,656,89300,44302
3604,2032,1572,761,164100,44303
1386,137,1249,812,82100,44304
9588,5444,4144,806,72000,44305
9133,4003,5130,763,64600,44306
2973,899,2074,672,59300,44307
274,7,267,363,-,44308
10287,4143,6144,729,68200,44310
2870,554,2316,639,47800,44311
13508,9945,3563,801,102500,44312
12388,6876,5512,799,158800,44313
8262,4409,3853,736,64700,44314
9726,7122,2604,860,148900,44319
8754,4806,3948,720,77600,44320
6131,4764,1367,1067,236300,44321
7391,5949,1442,1154,244400,44333
1180,1057,123,1003,173800,44401
1325,1120,205,634,141200,44402
1763,1534,229,629,112900,44403
620,544,76,611,113000,44404
3305,2040,1265,681,60000,44405
8662,7602,1060,686,200800,44406
4176,3085,1091,596,152500,44408
7565,6077,1488,732,141500,44410
707,616,91,960,149400,44411
1000,831,169,763,170400,44412
2875,2299,576,813,94600,44413
699,579,120,713,108900,44417
458,416,42,513,127900,44418
6682,4591,2091,637,88500,44420
992,777,215,821,141100,44423
6198,4858,1340,647,105600,44425
484,416,68,725,105500,44427
1345,1098,247,621,119300,44428
1224,868,356,771,121400,44429
1472,1078,394,666,88800,44430
1841,1558,283,813,103400,44431
4322,3153,1169,683,112200,44432
1494,1262,232,631,108900,44436
1789,1504,285,741,94800,44437
1943,1411,532,649,63400,44438
89,49,40,909,-,44439
1954,1558,396,624,132500,44440
658,627,31,-,128100,44441
1661,1444,217,555,146100,44442
644,598,46,687,170100,44443
4272,3059,1213,677,112700,44444
1496,1182,314,672,132300,44445
9074,5198,3876,700,85900,44446
560,477,83,618,152700,44449
649,522,127,726,128500,44450
1212,943,269,613,168800,44451
1311,1000,311,714,135300,44452
412,349,63,-,99000,44454
737,691,46,808,119400,44455
10409,7608,2801,675,122800,44460
1467,1321,146,694,133100,44470
4388,3191,1197,712,72600,44471
1451,1099,352,933,137000,44473
3939,3321,618,637,120100,44481
10821,6724,4097,694,85900,44483
9288,6556,2732,702,127400,44484
6961,3538,3423,671,55100,44485
373,225,148,675,78600,44490
1014,947,67,688,145400,44491
29,13,16,-,-,44493
3779,2182,1597,757,31100,44502
448,0,448,243,-,44503
2048,934,1114,689,66600,44504
7484,4152,3332,592,66000,44505
1057,729,328,655,21600,44506
2047,798,1249,638,22200,44507
5462,3136,2326,659,47300,44509
938,339,599,589,-,44510
9140,6288,2852,673,78800,44511
14658,9687,4971,702,118700,44512
9647,7857,1790,871,146500,44514
12069,7470,4599,695,104000,44515
14141,8607,5534,725,106700,44601
2162,1690,472,727,192200,44606
48,48,0,-,-,44607
786,608,178,770,100500,44608
1502,1301,201,590,131600,44609
62,62,0,-,212500,44610
729,654,75,525,125900,44611
2122,1594,528,768,165100,44612
798,551,247,734,100500,44613
5051,3995,1056,846,160400,44614
3873,2947,926,662,124300,44615
2314,1757,557,685,173300,44618
697,634,63,769,158300,44620
1761,1161,600,717,94500,44621
7188,5066,2122,852,147000,44622
1347,1186,161,540,221200,44624
595,458,137,774,174000,44625
1108,933,175,758,119500,44626
1637,1346,291,438,274400,44627
343,292,51,675,114500,44628
972,756,216,741,124200,44629
3647,2872,775,747,182300,44632
759,601,158,669,227800,44633
821,629,192,647,144400,44634
1037,741,296,684,143000,44637
484,335,149,632,160500,44638
80,59,21,864,76100,44640
8064,6086,1978,735,150600,44641
1480,1147,333,729,133400,44643
2134,1682,452,725,137000,44644
948,767,181,844,159100,44645
19386,13421,5965,740,135900,44646
7648,5640,2008,760,110700,44647
302,258,44,-,115700,44651
0,0,0,-,-,44652
243,169,74,828,80900,44653
5942,4306,1636,651,210100,44654
1130,914,216,658,131800,44656
3967,2878,1089,684,119100,44657
55,46,9,-,109600,44659
60,41,19,677,89400,44661
3597,2912,685,700,125800,44662
10678,6884,3794,788,136400,44663
1003,885,118,821,166600,44666
5096,3579,1517,754,134700,44667
553,485,68,1049,136500,44669
61,61,0,-,85400,44670
79,59,20,-,-,44671
1946,1196,750,689,81700,44672
936,767,169,1056,127900,44675
1757,1314,443,628,135900,44676
1059,790,269,818,143800,44677
142,81,61,-,109700,44678
1755,1320,435,768,163000,44680
2565,1882,683,676,229000,44681
419,298,121,650,89500,44682
3155,2152,1003,725,80800,44683
10392,8614,1778,879,188800,44685
27,4,23,-,-,44687
1309,951,358,635,126900,44688
247,191,56,717,112500,44689
49,41,8,-,162000,44690
18299,12366,5933,733,152700,44691
20,18,2,-,59000,44693
625,500,125,493,105200,44695
87,79,8,-,242500,44697
381,284,97,564,121800,44699
518,8,510,280,-,44702
3818,1388,2430,701,60800,44703
1548,751,797,665,59300,44704
7338,4195,3143,698,67000,44705
7076,5358,1718,776,101200,44706
3807,1829,1978,407,77100,44707
11000,7447,3553,815,120000,44708
8401,4878,3523,686,115100,44709
3866,2069,1797,746,76100,44710
4084,2328,1756,719,104300,44714
5424,3696,1728,777,220400,44718
16200,11345,4855,850,174600,44720
5584,4739,845,755,165200,44721
2298,1900,398,803,115200,44730
405,363,42,646,130800,44802
397,354,43,959,116300,44804
12661,8668,3993,725,125700,44805
886,721,165,721,92200,44807
136,73,63,785,112100,44809
5028,3580,1448,700,115800,44811
3263,2581,682,653,161500,44813
994,820,174,933,167600,44814
285,216,69,656,80900,44815
24,24,0,-,-,44816
548,488,60,843,128600,44817
918,742,176,593,88800,44818
7506,5180,2326,643,93300,44820
1143,933,210,650,143200,44822
1589,1364,225,671,156800,44824
40,37,3,-,74200,44825
637,596,41,-,134600,44826
2941,2132,809,655,91000,44827
34,12,22,857,-,44828
7751,5471,2280,665,83700,44830
6947,4824,2123,624,86400,44833
893,733,160,827,109600,44836
1616,1297,319,684,116900,44837
97,83,14,700,100900,44838
5239,4035,1204,784,172600,44839
951,784,167,822,151000,44840
294,254,40,758,99300,44841
2042,1475,567,692,122900,44842
917,800,117,730,147600,44843
197,175,22,-,114600,44844
1127,976,151,753,162700,44846
1432,1151,281,750,126000,44847
958,750,208,747,112500,44849
26,19,7,-,-,44850
1867,1403,464,716,107100,44851
559,444,115,552,160100,44853
684,498,186,774,100000,44854
465,387,78,635,131500,44855
125,112,13,900,104200,44856
9476,6347,3129,698,139000,44857
598,577,21,-,129900,44859
36,23,13,-,-,44861
1265,992,273,567,109900,44864
1062,735,327,744,98700,44865
805,677,128,942,156100,44866
910,762,148,843,118400,44867
16737,10066,6671,741,109400,44870
117,89,28,593,81900,44874
5887,3979,1908,668,107700,44875
1003,754,249,817,154300,44878
1002,972,30,-,156900,44880
12,0,12,-,-,44881
1177,984,193,702,106800,44882
11234,7806,3428,684,115500,44883
336,287,49,664,113200,44887
2818,2418,400,604,176300,44889
4254,2962,1292,669,108000,44890
0,0,0,-,-,44901
1952,835,1117,540,46600,44902
9497,6579,2918,720,121900,44903
5734,4179,1555,690,148800,44904
4780,3613,1167,731,81200,44905
7338,4684,2654,702,89500,44906
6846,3584,3262,644,92400,44907
250,104,146,761,65000,45001
5151,3786,1365,797,222000,45002
238,171,67,798,105100,45003
12500,8715,3785,815,140300,45005
24575,17508,7067,867,192100,45011
21089,15063,6026,822,152400,45013
17301,10595,6706,942,158800,45014
4682,2696,1986,871,92600,45015
7880,6307,1573,832,153600,45030
137,73,64,838,105800,45032
84,84,0,-,56700,45033
531,435,96,1488,233100,45034
12200,8434,3766,864,219600,45036
9501,8058,1443,1223,219800,45039
20189,15762,4427,1391,275500,45040
0,0,0,-,-,45041
10756,7546,3210,886,143400,45042
19923,12006,7917,793,170500,45044
3311,2510,801,1175,170600,45050
0,0,0,-,-,45051
1585,1395,190,675,237000,45052
1120,1109,11,-,259600,45053
1063,962,101,-,252200,45054
8657,4039,4618,789,217400,45056
254,204,50,1008,113700,45062
1142,1006,136,843,143800,45064
1831,1491,340,1111,242900,45065
8607,7548,1059,1172,240000,45066
5186,3585,1601,1006,141600,45067
4280,3676,604,865,242500,45068
18959,15036,3923,1271,231800,45069
80,52,28,886,65000,45070
1021,565,456,549,90100,45101
8491,6127,2364,789,157600,45102
12634,8894,3740,844,169600,45103
4645,3556,1089,681,138300,45106
3703,2653,1050,760,141200,45107
148,144,4,-,222700,45111
20,17,3,-,112500,45112
1657,1402,255,924,195400,45113
38,31,7,-,-,45115
1480,1228,252,1023,153300,45118
1236,942,294,716,138100,45120
3648,2341,1307,609,121400,45121
3977,3286,691,916,128300,45122
3439,2133,1306,608,106700,45123
1558,1260,298,820,111600,45130
109,79,30,900,82300,45131
144,79,65,569,62500,45132
9447,6352,3095,696,125000,45133
1855,1410,445,709,132400,45135
20684,16297,4387,1112,244800,45140
1499,1139,360,782,116000,45142
1718,1237,481,558,89600,45144
10,10,0,-,-,45145
485,321,164,749,89300,45146
83,58,25,-,77800,45147
537,397,140,1045,119600,45148
13097,9711,3386,830,182500,45150
4028,3403,625,1098,215400,45152
756,699,57,-,144000,45153
3458,2536,922,776,141900,45154
124,89,35,658,67200,45155
22,22,0,-,-,45156
3539,2849,690,749,169200,45157
137,86,51,900,87700,45158
1434,1064,370,752,121800,45159
387,144,243,443,112900,45160
987,873,114,919,192400,45162
109,75,34,775,69300,45164
46,10,36,-,-,45166
1489,979,510,660,136900,45167
616,424,192,656,103800,45168
1832,1284,548,659,99400,45169
2408,1896,512,806,155300,45171
58,46,12,-,82500,45172
772,731,41,1679,527500,45174
3655,2661,994,791,145100,45176
9002,5453,3549,771,142600,45177
7993,2143,5850,1102,369500,45202
1378,320,1058,340,223900,45203
2519,963,1556,687,72200,45204
7350,2443,4907,719,68500,45205
5938,2006,3932,686,206400,45206
2281,891,1390,705,87100,45207
8718,5597,3121,992,381800,45208
5970,2412,3558,924,265200,45209
15379,7455,7924,733,108500,45211
10143,4421,5722,745,138100,45212
5457,3171,2286,692,173700,45213
3559,761,2798,636,71300,45214
12586,6968,5618,825,149900,45215
3863,1803,2060,802,78400,45216
3002,1794,1208,655,105900,45217
1521,1061,460,880,123600,45218
6469,1152,5317,902,114700,45219
6659,1744,4915,766,264800,45220
5555,2197,3358,689,138100,45223
9401,5689,3712,697,116900,45224
3984,624,3360,476,63600,45225
2597,1457,1140,954,330400,45226
8645,4113,4532,921,148400,45227
6097,1395,4702,613,144300,45229
11846,8442,3404,765,170400,45230
16622,11418,5204,857,108300,45231
2706,518,2188,467,88500,45232
5849,4775,1074,715,212500,45233
10996,6939,4057,932,149700,45236
9419,4354,5065,758,106000,45237
19058,11166,7892,692,123300,45238
11939,7342,4597,809,118200,45239
9974,6132,3842,969,123300,45240
10070,7477,2593,1032,214200,45241
8836,7009,1827,1218,321800,45242
5384,4866,518,1367,434100,45243
10405,8272,2133,850,253700,45244
8765,5790,2975,895,179600,45245
6186,3230,2956,1009,136000,45246
9488,7497,1991,895,201200,45247
9974,8455,1519,912,148500,45248
5541,3585,1956,1207,338000,45249
8935,6558,2377,1001,121400,45251
1922,1858,64,956,196800,45252
8878,6279,2599,1041,207300,45255
18,18,0,-,-,45301
1457,1207,250,862,191500,45302
929,687,242,651,89800,45303
2789,2159,630,709,143000,45304
4466,3469,997,989,216500,45305
928,742,186,677,150500,45306
141,104,37,788,81800,45307
1716,1401,315,785,113300,45308
5195,3952,1243,753,154300,45309
104,100,4,-,112500,45310
2350,1921,429,712,140800,45311
429,393,36,663,164900,45312
1344,1002,342,627,201600,45314
1575,1224,351,781,162900,45315
39,31,8,750,181300,45316
347,267,80,820,158800,45317
2045,1643,402,751,149900,45318
130,95,35,685,121900,45319
6058,4526,1532,709,123100,45320
353,279,74,875,94300,45321
8800,6928,1872,887,121400,45322
2165,1757,408,696,138900,45323
16989,8014,8975,834,121900,45324
1029,929,100,870,180700,45325
355,312,43,936,119100,45326
3618,2978,640,858,153200,45327
225,139,86,785,80300,45328
340,243,97,916,87200,45330
9762,6574,3188,648,119000,45331
267,223,44,775,119000,45332
420,302,118,720,196700,45333
841,563,278,762,112900,45334
2717,2131,586,738,146000,45335
61,51,10,-,96300,45336
605,519,86,825,163800,45337
2038,1689,349,772,142100,45338
497,423,74,802,144600,45339
253,246,7,-,146400,45340
1608,1235,373,783,84500,45341
15821,9911,5910,949,147700,45342
6451,4849,1602,753,112500,45344
2530,1648,882,827,111900,45345
836,618,218,838,93900,45346
1745,1327,418,724,102300,45347
321,265,56,748,167000,45348
158,99,59,889,101200,45349
23,23,0,-,95000,45350
104,84,20,675,158300,45351
98,61,37,665,60500,45352
64,64,0,-,-,45353
250,186,64,804,88400,45354
9883,6281,3602,741,95000,45356
120,99,21,750,111900,45358
710,588,122,586,134100,45359
172,134,38,695,60000,45360
111,85,26,811,100600,45361
401,329,72,638,105600,45362
641,550,91,763,204400,45363
11621,7600,4021,732,128500,45365
1926,1416,510,624,128000,45368
1372,1161,211,844,160000,45369
965,856,109,565,276700,45370
8003,6221,1782,805,186100,45371
141,91,50,725,89500,45372
13982,9315,4667,784,163300,45373
6866,4250,2616,714,147500,45377
137,122,15,742,71500,45378
1989,1601,388,704,157900,45380
2091,1683,408,747,134500,45381
453,344,109,780,115100,45382
2900,2116,784,679,133800,45383
111,93,18,-,123400,45384
15680,10856,4824,761,140600,45385
2555,1823,732,873,224600,45387
287,261,26,583,180600,45388
180,137,43,672,85900,45389
1291,797,494,631,75400,45390
4466,1467,2999,684,57400,45402
5719,2437,3282,709,52300,45403
4367,1970,2397,707,60100,45404
8097,2854,5243,675,59000,45405
9329,4320,5009,717,62000,45406
2992,1867,1125,989,162000,45409
7102,3120,3982,754,69900,45410
8979,5682,3297,714,114100,45414
5683,3719,1964,781,122900,45415
2230,1491,739,969,68000,45416
12028,6499,5529,708,49600,45417
617,497,120,663,116000,45418
6600,4515,2085,747,165700,45419
11811,6609,5202,711,85000,45420
19294,14188,5106,918,122300,45424
6805,3068,3737,741,79300,45426
0,0,0,-,-,45428
11508,7890,3618,870,148700,45429
3053,2569,484,958,174700,45430
12129,6180,5949,1103,145700,45431
6488,4638,1850,816,126900,45432
582,7,575,1327,-,45433
4680,4313,367,1101,216400,45434
4090,2185,1905,818,84300,45439
8979,5899,3080,879,175900,45440
7853,4597,3256,832,106400,45449
12904,9935,2969,945,236500,45458
12507,8759,3748,939,205500,45459
6361,5478,883,829,164100,45502
14302,8726,5576,779,115700,45503
6620,4398,2222,805,123900,45504
7917,3826,4091,682,72800,45505
5221,2852,2369,710,73000,45506
20966,14389,6577,750,124900,45601
1715,1331,384,623,104800,45612
1063,797,266,565,135800,45613
1799,1417,382,670,104200,45614
676,534,142,542,89100,45616
106,0,106,-,-,45617
5,5,0,-,-,45618
3067,2266,801,795,119600,45619
325,249,76,646,105100,45620
123,67,56,575,49600,45621
57,57,0,-,-,45622
1140,993,147,681,100500,45623
0,0,0,-,-,45624
2005,1651,354,714,124300,45628
954,763,191,586,99000,45629
45,33,12,-,-,45630
6149,4375,1774,675,117200,45631
734,549,185,644,101700,45634
50,50,0,-,-,45636
8343,5670,2673,684,90500,45638
6312,4120,2192,799,107400,45640
0,0,0,-,-,45642
1883,1533,350,744,148400,45644
896,706,190,794,80900,45645
191,191,0,-,93300,45646
1024,845,179,494,106600,45647
4614,3607,1007,679,119600,45648
164,142,22,-,57100,45650
2162,1523,639,579,88000,45651
1271,1066,205,654,90700,45652
1540,1172,368,763,140200,45653
520,409,111,1002,97600,45654
2580,1883,697,668,95100,45656
708,466,242,588,68500,45657
916,727,189,576,109500,45658
977,820,157,849,84300,45659
2896,2112,784,592,113700,45660
2744,1762,982,590,98900,45661
12330,6420,5910,602,82000,45662
2464,1929,535,639,76700,45663
3801,3082,719,795,140500,45669
94,74,20,653,80000,45671
490,458,32,-,108300,45672
204,54,150,636,-,45673
92,40,52,725,158300,45674
398,275,123,-,94900,45678
1025,676,349,690,118000,45679
4811,3265,1546,707,117900,45680
637,584,53,769,129200,45681
1015,800,215,786,86700,45682
818,654,164,720,113700,45684
469,332,137,575,114200,45685
1267,963,304,689,101500,45686
211,102,109,790,66700,45688
5808,3575,2233,764,123900,45690
3406,2512,894,606,89400,45692
3453,2269,1184,557,102900,45693
4666,3539,1127,691,145800,45694
279,205,74,770,81900,45695
762,595,167,-,-,45696
1817,1503,314,576,134800,45697
160,123,37,626,78000,45698
10717,5295,5422,860,172300,45701
2244,1676,568,649,130800,45710
429,350,79,748,147500,45711
4023,3112,911,710,128900,45714
1029,722,307,635,113300,45715
187,144,43,596,85700,45716
448,242,206,631,62100,45719
20,20,0,-,-,45721
1481,1240,241,586,93400,45723
984,881,103,620,142500,45724
183,168,15,-,52700,45727
601,583,18,-,154300,45729
1718,1215,503,628,74700,45732
183,131,52,757,63900,45734
607,518,89,697,135600,45735
174,107,67,696,61600,45740
207,135,72,559,78500,45741
1233,1088,145,908,146500,45742
622,564,58,629,116600,45743
1115,880,235,598,127400,45744
488,400,88,841,88000,45745
152,125,27,763,82200,45746
11225,7206,4019,671,136500,45750
1587,1171,416,584,68700,45760
818,545,273,775,88800,45761
3120,1834,1286,726,85800,45764
494,353,141,490,102000,45766
1073,873,200,385,109700,45767
660,468,192,563,153700,45768
2602,1933,669,605,107000,45769
279,251,28,-,65300,45770
1320,998,322,654,96400,45771
747,697,50,782,102600,45772
22,22,0,-,-,45773
425,364,61,947,103200,45775
233,205,28,613,167400,45776
365,229,136,1063,93300,45778
320,258,62,595,102800,45779
1427,662,765,759,132800,45780
162,113,49,700,59200,45782
1359,1055,304,558,153400,45784
1279,1151,128,811,115400,45786
32,32,0,-,136300,45787
442,422,20,680,122000,45788
99,99,0,-,36700,45789
8679,5029,3650,683,78800,45801
6203,3259,2944,647,61500,45804
9552,5886,3666,753,116000,45805
4455,3568,887,735,130200,45806
4807,3818,989,775,150500,45807
128,85,43,788,75300,45808
56,52,4,-,85000,45809
2571,1604,967,748,123600,45810
723,470,253,644,78400,45812
1502,1216,286,627,103000,45813
1216,944,272,777,153200,45814
139,118,21,543,93200,45816
2551,2101,450,743,165400,45817
126,80,46,969,84400,45819
198,167,31,668,95400,45820
477,455,22,1105,94000,45821
8147,5795,2352,699,146500,45822
167,127,40,564,223600,45826
795,748,47,688,167000,45827
2344,1968,376,610,154000,45828
2350,1969,381,794,125800,45830
1327,1089,238,675,112400,45831
1167,1005,162,866,108600,45832
4257,3229,1028,747,127000,45833
214,194,20,625,117600,45835
547,464,83,598,102600,45836
17,17,0,-,21900,45838
23792,15178,8614,775,154300,45840
368,314,54,516,158700,45841
1445,1224,221,671,97200,45843
1230,1107,123,705,169900,45844
1115,1007,108,626,214300,45845
1507,1320,187,480,169300,45846
378,308,70,925,103600,45849
1263,1114,149,617,161100,45850
301,215,86,617,129900,45851
524,371,153,719,181100,45853
166,116,50,875,88300,45854
66,53,13,1021,101100,45855
1905,1471,434,760,135900,45856
1170,887,283,721,148700,45858
191,149,42,625,57100,45859
820,619,201,658,218600,45860
96,81,15,595,58300,45861
548,456,92,820,96200,45862
516,422,94,766,98200,45863
74,70,4,-,97700,45864
1909,1559,350,692,190100,45865
61,40,21,764,111400,45866
389,348,41,714,129600,45867
230,209,21,850,171300,45868
1903,1613,290,638,174400,45869
72,72,0,-,75900,45870
790,548,242,757,165700,45871
1539,1070,469,711,92200,45872
745,597,148,760,97000,45873
902,791,111,753,89800,45874
4368,3481,887,605,180700,45875
348,272,76,719,162500,45876
866,703,163,682,131900,45877
2497,1879,618,701,93000,45879
1099,892,207,652,88900,45880
539,445,94,898,144900,45881
1134,919,215,672,116900,45882
1346,1128,218,642,221800,45883
22,9,13,-,-,45884
5263,3870,1393,764,147300,45885
229,167,62,722,74400,45886
1600,1177,423,636,116700,45887
120,83,37,-,81500,45888
584,568,16,958,183100,45889
236,203,33,747,92000,45890
6258,4595,1663,681,108600,45891
312,268,44,535,111000,45894
7575,5697,1878,702,133800,45895
693,577,116,869,123100,45896
0,0,0,-,-,45897
402,356,46,686,77600,45898
56,46,10,-,61400,45899
4121,3180,941,783,93300,46001
6797,5341,1456,860,102700,46011
8219,5581,2638,797,101400,46012
7927,5196,2731,741,83600,46013
6996,3096,3900,717,48500,46016
2311,1720,591,840,100200,46017
1205,1006,199,802,133200,46030
957,788,169,868,158300,46031
20213,13668,6545,1184,324300,46032
13908,12165,1743,1315,346600,46033
2868,2340,528,937,175100,46034
434,361,73,816,98300,46035
4737,3296,1441,707,79200,46036
14665,12078,2587,1320,304400,46037
16909,11701,5208,1232,211800,46038
220,202,18,-,112500,46039
4568,4028,540,917,241700,46040
8371,5624,2747,718,104600,46041
1183,930,253,729,109100,46044
20,20,0,-,-,46045
18,0,18,-,-,46047
751,596,155,956,104700,46048
478,389,89,-,96900,46049
764,575,189,738,110500,46050
1159,916,243,825,116100,46051
9528,6819,2709,798,145100,46052
4407,4051,356,1241,235100,46055
838,722,116,765,147000,46056
517,331,186,681,124000,46057
888,733,155,913,129300,46058
14688,10428,4260,1075,199300,46060
13210,10718,2492,967,226200,46062
200,143,57,743,56900,46063
5070,4244,826,921,166900,46064
1180,943,237,784,158400,46065
1141,1030,111,817,121900,46068
2836,2155,681,808,170600,46069
822,672,150,704,116800,46070
1339,1155,184,827,169200,46071
3679,2953,726,791,113900,46072
11975,9894,2081,1179,276800,46074
2399,1845,554,1233,207200,46075
633,452,181,749,85800,46076
10396,8797,1599,1317,385400,46077
48,30,18,1107,95000,46103
419,378,41,708,135000,46104
675,531,144,763,151700,46105
2389,1924,465,1032,219900,46106
5040,3149,1891,810,100500,46107
205,202,3,-,211900,46110
86,63,23,675,80500,46111
13359,10678,2681,1127,204400,46112
5427,4056,1371,1160,152500,46113
778,569,209,678,121800,46115
244,173,71,-,140600,46117
1972,1532,440,950,161500,46118
2181,1677,504,718,140300,46120
2006,1712,294,948,162700,46121
5783,4290,1493,885,190200,46122
12803,10885,1918,1187,198400,46123
3229,2169,1060,729,118300,46124
25,18,7,-,-,46125
1892,1573,319,732,163300,46126
118,113,5,-,57200,46127
820,701,119,900,122300,46128
1059,943,116,570,172200,46130
11978,8628,3350,885,141200,46131
337,279,58,913,107100,46133
7008,4413,2595,780,123600,46135
15975,11564,4411,879,160500,46140
11455,8556,2899,873,175300,46142
21235,14137,7098,1028,186300,46143
82,72,10,-,67700,46144
117,30,87,929,-,46146
1261,1030,231,938,177900,46147
2065,1505,560,781,117900,46148
719,600,119,819,174300,46149
476,386,90,719,136800,46150
11533,8662,2871,784,161800,46151
63,24,39,-,-,46155
471,413,58,1033,92800,46156
1387,1196,191,841,164300,46157
8798,6770,2028,865,165000,46158
2541,2199,342,844,165100,46160
1028,757,271,790,132600,46161
179,179,0,-,156800,46162
4502,4155,347,928,213600,46163
1640,1525,115,1120,182900,46164
604,504,100,975,196700,46165
763,492,271,1063,133900,46166
2558,2358,200,919,229200,46167
13395,9013,4382,994,191300,46168
639,618,21,-,116500,46171
1010,834,176,1055,109700,46172
4037,2716,1321,688,105400,46173
236,174,62,776,68200,46175
11215,7421,3794,810,117300,46176
429,376,53,-,158800,46180
1918,1685,233,930,226200,46181
657,512,145,761,119100,46182
15,15,0,-,-,46183
4895,4187,708,1167,127800,46184
696,638,58,875,144900,46186
13048,5465,7583,838,72500,46201
9808,2739,7069,969,275700,46202
14090,7922,6168,842,88000,46203
4096,774,3322,1309,329200,46204
11597,5624,5973,866,170300,46205
8372,3873,4499,806,141000,46208
10059,4773,5286,884,122000,46214
1387,400,987,1097,215100,46216
12279,9128,3151,1062,145900,46217
12459,4908,7551,868,60900,46218
15885,8871,7014,829,109700,46219
16883,10462,6421,1022,222400,46220
9326,5768,3558,911,109400,46221
12110,4765,7345,878,65000,46222
13639,4734,8905,793,108300,46224
2128,1012,1116,823,75000,46225
18275,8684,9591,834,87500,46226
22198,10187,12011,805,131600,46227
5721,4470,1251,972,158100,46228
10984,6762,4222,890,117900,46229
3284,2766,518,1377,131900,46231
9642,7846,1796,1215,157700,46234
12130,5665,6465,740,112900,46235
10557,8987,1570,1257,187500,46236
15059,10398,4661,978,147700,46237
10028,8477,1551,1105,162000,46239
9796,4353,5443,1002,224200,46240
10638,5990,4648,844,78100,46241
9132,3908,5224,997,191700,46250
15771,6879,8892,854,118300,46254
10384,7339,3045,882,199800,46256
3640,3525,115,1224,210000,46259
13810,6465,7345,911,186000,46260
10972,5055,5917,950,141800,46268
3058,2693,365,1190,316600,46278
3274,1988,1286,1264,171000,46280
112,112,0,-,365000,46290
275,252,23,979,464700,46301
5429,4246,1183,916,196100,46303
9826,7412,2414,998,192800,46304
22826,19199,3627,1031,213100,46307
5234,4310,924,834,167100,46310
8144,7360,784,1342,226000,46311
10365,4793,5572,686,74500,46312
7093,4967,2126,921,139800,46319
4992,2027,2965,705,70300,46320
8635,7601,1034,1149,228400,46321
9374,7397,1977,1106,161100,46322
8088,5485,2603,956,94500,46323
8368,5494,2874,953,94200,46324
3996,2303,1693,890,80300,46327
318,305,13,-,124600,46340
3721,3148,573,770,171000,46341
11587,9261,2326,950,136100,46342
76,72,4,933,89200,46345
441,289,152,729,63600,46346
1790,1563,227,979,171000,46347
412,340,72,942,123900,46348
1244,1111,133,860,141900,46349
17589,13106,4483,716,145400,46350
6451,5565,886,1065,191600,46356
17953,11631,6322,758,112900,46360
339,290,49,-,178900,46365
2131,1729,402,671,109900,46366
15569,10769,4800,908,154200,46368
1203,953,250,780,178600,46371
5706,5516,190,935,292100,46373
302,265,37,856,156800,46374
9303,7739,1564,987,232900,46375
80,57,23,825,85000,46376
154,121,33,-,98500,46377
69,69,0,-,131300,46379
104,85,19,-,192000,46381
681,681,0,-,166100,46382
16306,10447,5859,914,199900,46383
14495,12364,2131,993,219800,46385
1258,1147,111,992,148900,46390
1985,1721,264,816,199200,46391
2915,2401,514,815,168000,46392
120,68,52,-,168200,46393
4916,3072,1844,836,121300,46394
2690,1075,1615,565,62700,46402
5908,3068,2840,791,98400,46403
7061,3884,3177,797,69200,46404
3829,2667,1162,941,84500,46405
3722,2017,1705,808,53100,46406
4499,1943,2556,716,50600,46407
6436,3825,2611,814,69500,46408
2834,1365,1469,953,58600,46409
15477,9374,6103,1048,135100,46410
1288,913,375,788,97200,46501
29,29,0,-,-,46502
1332,1095,237,614,125700,46504
3625,2545,1080,741,159000,46506
3343,2631,712,828,179900,46507
52,50,2,-,69000,46508
1520,1167,353,668,129700,46510
1735,1329,406,778,164700,46511
16481,11660,4821,858,132600,46514
11356,6765,4591,742,113300,46516
9011,5868,3143,724,136600,46517
863,755,108,713,154300,46524
11837,7919,3918,788,139200,46526
8164,5893,2271,821,171300,46528
10853,9938,915,1198,228000,46530
560,493,67,941,122800,46531
612,522,90,755,107500,46532
4173,3187,986,664,119300,46534
1218,951,267,850,156600,46536
173,162,11,708,77800,46537
1598,1395,203,796,229600,46538
1089,889,200,675,99100,46539
3800,3361,439,927,224000,46540
1500,1173,327,599,124400,46542
933,821,112,902,249800,46543
12850,8767,4083,756,111100,46544
11421,5139,6282,780,120900,46545
4194,3066,1128,823,165400,46550
2583,2121,462,533,154200,46552
1063,970,93,770,165200,46553
1989,1732,257,602,141100,46554
1187,884,303,788,163400,46555
223,6,217,778,-,46556
4528,3953,575,885,156000,46561
1970,1592,378,835,141000,46562
8757,6433,2324,755,131700,46563
2401,2035,366,655,270400,46565
3814,2956,858,833,181700,46567
325,286,39,-,141400,46570
1401,1187,214,767,291300,46571
1329,1026,303,765,166900,46573
3577,3008,569,730,118800,46574
8538,6099,2439,726,140900,46580
5153,3744,1409,890,161100,46582
1781,1093,688,900,171600,46590
45,45,0,-,84600,46595
2232,543,1689,527,82500,46601
3641,2223,1418,809,55300,46613
12380,9214,3166,715,127500,46614
5733,3351,2382,803,85400,46615
2114,1125,989,853,79900,46616
3820,2476,1344,1045,144300,46617
7486,5154,2332,757,77800,46619
10067,6662,3405,811,112300,46628
2628,2121,507,628,132900,46635
6419,4227,2192,939,132100,46637
3221,2537,684,737,133700,46701
944,833,111,613,92800,46702
7500,5418,2082,773,161100,46703
17,17,0,-,-,46704
704,527,177,497,93700,46705
7706,5655,2051,710,144900,46706
1671,1391,280,579,150100,46710
2713,1959,754,552,146900,46711
5875,4292,1583,656,128900,46714
1753,1394,359,812,102400,46721
3142,2617,525,742,140000,46723
9732,7925,1807,723,151200,46725
456,406,50,-,137900,46730
259,194,65,-,-,46731
1101,745,356,918,106300,46732
7676,5871,1805,651,118000,46733
3264,2735,529,858,150500,46737
3331,2475,856,690,103800,46738
1177,928,249,637,157100,46740
1397,1240,157,683,174000,46741
1307,1101,206,768,159500,46742
763,703,60,877,155000,46743
837,734,103,749,151800,46745
1618,1098,520,824,137600,46746
1021,943,78,691,140400,46747
1670,1576,94,1098,183200,46748
10651,7728,2923,698,102000,46750
6028,4206,1822,667,119700,46755
208,208,0,-,92900,46759
557,393,164,732,109700,46760
4015,3179,836,639,149600,46761
771,746,25,-,184300,46763
510,476,34,843,135000,46764
1910,1755,155,862,203900,46765
293,237,56,778,147800,46766
2755,2192,563,784,98500,46767
1157,951,206,688,124600,46770
34,0,34,-,-,46771
789,734,55,744,161700,46772
1237,1108,129,668,117000,46773
6329,5002,1327,838,117800,46774
698,560,138,754,88000,46776
2451,2057,394,723,129800,46777
799,671,128,783,109000,46779
289,264,25,775,99400,46781
2445,2258,187,679,187800,46783
896,729,167,724,144700,46784
550,462,88,826,149100,46785
26,26,0,-,-,46786
1412,1194,218,683,112800,46787
1101,1031,70,596,186200,46788
329,311,18,850,136000,46791
1521,1203,318,871,111600,46792
1779,1420,359,684,127300,46793
699,565,134,725,113600,46794
2515,2124,391,822,190600,46795
1397,1183,214,787,127500,46797
587,511,76,894,114400,46798
97,77,20,850,41700,46799
4714,1550,3164,669,80300,46802
3521,1416,2105,683,45500,46803
11989,8566,3423,878,166500,46804
9386,5249,4137,677,89900,46805
8563,4865,3698,785,53500,46806
6641,4040,2601,802,86600,46807
8379,4897,3482,708,83300,46808
4119,2499,1620,623,88600,46809
4258,3848,410,967,298100,46814
10829,7852,2977,760,128300,46815
7311,3840,3471,670,83600,46816
7640,6378,1262,947,147000,46818
4253,2937,1316,783,107600,46819
12400,7621,4779,851,126300,46825
14435,10249,4186,861,133000,46835
8297,7489,808,1118,218500,46845
16443,11387,5056,656,95400,46901
15623,10618,5005,726,109500,46902
1163,911,252,696,105800,46910
548,493,55,952,110700,46911
452,418,34,-,148100,46913
625,517,108,530,116300,46914
324,248,76,610,100000,46915
736,641,95,570,110100,46917
986,811,175,665,108900,46919
388,374,14,-,148800,46920
10,10,0,-,-,46922
3211,2443,768,691,126100,46923
562,486,76,790,92600,46926
1748,1378,370,565,96200,46928
1119,842,277,624,99700,46929
43,33,10,700,66800,46930
89,57,32,725,63200,46931
1313,1118,195,802,117900,46932
2559,1673,886,825,88200,46933
2178,1800,378,780,145100,46936
1242,1021,221,804,87200,46938
827,685,142,603,85000,46939
1057,922,135,690,88900,46940
364,322,42,669,114200,46941
74,45,29,-,115200,46943
26,19,7,-,-,46946
10668,7467,3201,647,84400,46947
235,201,34,685,90400,46950
735,653,82,647,116400,46951
8280,5562,2718,671,102400,46952
8506,5242,3264,711,78600,46953
257,194,63,564,64000,46957
223,209,14,-,83400,46958
404,198,206,704,-,46959
460,340,120,771,105600,46960
95,64,31,-,-,46961
3478,2463,1015,767,102600,46962
45,19,26,433,-,46967
36,36,0,-,78000,46968
8904,5940,2964,723,80100,46970
780,572,208,748,106600,46974
5519,4094,1425,684,111100,46975
789,656,133,655,106500,46978
1741,1549,192,811,160300,46979
1038,753,285,738,106800,46982
106,70,36,-,133600,46984
575,441,134,751,137800,46985
702,557,145,620,103400,46986
375,301,74,686,101900,46987
372,270,102,-,83300,46988
1424,1085,339,620,141600,46989
261,255,6,-,114300,46990
682,551,131,798,70100,46991
6997,5131,1866,671,100600,46992
1039,915,124,808,99700,46994
2683,2062,621,668,101400,46996
101,93,8,-,47400,46998
4171,3270,901,773,157600,47001
427,231,196,678,80300,47003
4535,3546,989,661,174600,47006
104,59,45,-,-,47010
287,250,37,-,132600,47011
3847,3088,759,690,161800,47012
344,299,45,813,161400,47016
242,211,31,781,148800,47017
1576,1090,486,841,158800,47018
498,297,201,943,151900,47020
1142,1085,57,-,246500,47022
587,441,146,982,99900,47023
1274,997,277,671,104800,47024
8552,6518,2034,720,169900,47025
673,595,78,-,148900,47030
2020,1572,448,783,153400,47031
1114,1038,76,-,136900,47032
55,40,15,890,76000,47034
130,130,0,-,178300,47035
312,285,27,675,183500,47036
1709,1214,495,693,121900,47037
591,442,149,755,139800,47038
2275,1754,521,609,132700,47040
2511,2180,331,740,170600,47041
1669,1297,372,571,136600,47042
2390,1755,635,644,116600,47043
2315,2000,315,754,192700,47060
2556,1925,631,799,86100,47102
0,0,0,-,-,47104
1812,1505,307,889,165900,47106
915,695,220,539,108900,47108
115,115,0,-,89500,47110
6026,4706,1320,758,176600,47111
5890,4523,1367,724,165900,47112
118,84,34,1146,163200,47114
1049,911,138,424,132600,47115
265,256,9,-,65100,47116
1530,1390,140,1567,136400,47117
1249,1035,214,629,96300,47118
4168,3914,254,1048,252500,47119
284,253,31,-,104400,47120
3801,3381,420,788,199800,47122
42,37,5,-,58100,47123
1699,1588,111,857,208600,47124
589,472,117,927,115700,47125
1660,1435,225,841,160200,47126
8237,4590,3647,823,110800,47129
18173,12056,6117,855,134500,47130
327,321,6,588,174500,47135
1586,1469,117,788,175100,47136
581,488,93,671,77700,47137
1692,1481,211,485,122900,47138
1018,741,277,700,103900,47140
534,534,0,-,122900,47141
422,418,4,-,118900,47142
1034,930,104,699,191800,47143
655,585,70,697,110000,47145
391,312,79,880,149300,47147
18897,11815,7082,795,139600,47150
31,23,8,-,101400,47160
1195,923,272,890,159700,47161
313,234,79,-,115600,47162
527,503,24,-,141800,47163
1773,1416,357,614,128400,47164
2369,1879,490,706,132000,47165
608,552,56,-,117800,47166
6012,4551,1461,665,112200,47167
5675,3892,1783,808,112000,47170
6150,5297,853,1020,174300,47172
356,344,12,-,84900,47175
488,418,70,-,146400,47177
17263,11503,5760,979,148900,47201
10342,7951,2391,823,171600,47203
1980,1498,482,694,132200,47220
449,364,85,1019,81900,47223
207,207,0,-,82500,47224
83,67,16,-,74500,47226
877,762,115,642,120200,47227
1185,911,274,778,97200,47229
609,570,39,766,101800,47230
336,308,28,913,128200,47231
1183,983,200,963,117800,47232
580,544,36,-,153800,47234
478,427,51,-,100200,47235
8584,5938,2646,787,140500,47240
1949,1326,623,780,121000,47243
266,243,23,675,115700,47244
1633,1380,253,759,127000,47246
74,56,18,1028,108700,47247
9149,6294,2855,731,135300,47250
703,573,130,804,81400,47260
106,79,27,763,97100,47263
517,428,89,715,119000,47264
7855,5882,1973,708,106400,47265
231,188,43,-,86100,47270
788,623,165,863,105900,47272
802,762,40,867,150500,47273
12105,8349,3756,774,134900,47274
271,220,51,-,99500,47280
532,437,95,448,128900,47281
128,102,26,675,76700,47282
1227,883,344,816,128700,47283
10925,6943,3982,702,58700,47302
10488,4987,5501,687,79600,47303
13375,8888,4487,821,119000,47304
1725,627,1098,609,55500,47305
4,0,4,-,-,47306
1608,1254,354,658,88200,47320
66,44,22,958,80000,47324
218,181,37,1049,96300,47325
626,474,152,679,119700,47326
1818,1356,462,680,85500,47327
2034,1634,400,892,117900,47330
9262,6370,2892,704,82000,47331
1311,1070,241,789,120800,47334
323,235,88,643,70500,47335
1318,1038,280,700,69800,47336
57,42,15,875,66700,47337
1118,901,217,695,81300,47338
203,184,19,781,79400,47339
1174,935,239,665,87700,47340
907,680,227,739,109100,47341
1115,864,251,735,79900,47342
40,36,4,633,104500,47344
511,383,128,703,99200,47345
1524,1299,225,652,104900,47346
3949,2994,955,638,71800,47348
155,121,34,893,74200,47351
303,262,41,845,94200,47352
2185,1642,543,823,124600,47353
431,383,48,613,93300,47354
1154,862,292,773,85100,47355
2219,1801,418,700,120900,47356
324,281,43,813,89900,47357
386,360,26,747,111100,47358
1314,916,398,648,74100,47359
474,398,76,668,134500,47360
81,59,22,777,85000,47361
11129,7784,3345,709,95300,47362
44,44,0,-,80000,47367
1180,976,204,665,97500,47368
603,437,166,673,101400,47369
4796,3450,1346,691,101700,47371
1039,796,243,632,67300,47373
18636,11451,7185,682,100000,47374
635,487,148,549,69500,47380
58,34,24,625,57500,47381
98,50,48,645,46000,47382
1144,983,161,788,141400,47383
725,616,109,745,103900,47384
580,468,112,783,96600,47385
499,459,40,909,130300,47386
274,219,55,753,108000,47387
125,95,30,682,88300,47388
2182,1599,583,609,71000,47390
506,445,61,-,136200,47393
3338,2471,867,752,85500,47394
2792,2288,504,756,139800,47396
17746,10207,7539,996,243800,47401
14122,8154,5968,889,149100,47403
10067,5152,4915,835,160000,47404
0,0,0,-,-,47405
0,0,0,-,-,47406
8848,3422,5426,918,207100,47408
153,63,90,904,-,47420
11370,8615,2755,707,118600,47421
3571,2984,587,625,115400,47424
275,188,87,573,87700,47427
3569,3010,559,699,146600,47429
622,541,81,-,106000,47431
1936,1424,512,738,92500,47432
1622,1236,386,627,132500,47433
0,0,0,-,-,47434
583,472,111,-,111200,47436
87,87,0,-,150800,47437
1729,1317,412,682,77700,47438
3884,2974,910,582,85200,47441
422,299,123,675,77000,47443
4262,3308,954,603,107200,47446
3301,2595,706,846,199900,47448
136,117,19,673,81800,47449
473,308,165,594,93800,47451
1993,1467,526,592,120800,47452
267,207,60,1036,77800,47453
2880,2107,773,633,85000,47454
29,29,0,-,-,47455
517,418,99,763,99100,47456
60,49,11,-,71800,47457
19,19,0,-,-,47458
1398,1213,185,814,144100,47459
4748,3737,1011,685,126500,47460
1766,1528,238,784,154200,47462
87,49,38,290,74500,47464
203,158,45,556,92000,47465
46,46,0,-,-,47467
610,528,82,-,229300,47468
724,527,197,569,112000,47469
671,544,127,684,121400,47470
1077,884,193,610,91900,47471
6820,4681,2139,717,103700,47501
1680,1033,647,659,63800,47512
824,739,85,560,112800,47513
71,71,0,-,131500,47514
350,338,12,-,98700,47515
432,343,89,431,122800,47516
224,221,3,-,250300,47519
1268,885,383,558,88600,47520
235,235,0,-,193100,47521
104,67,37,725,56900,47522
1292,974,318,493,117700,47523
249,192,57,710,-,47524
154,130,24,-,211600,47525
771,664,107,675,118800,47527
210,119,91,-,44000,47528
416,303,113,602,77200,47529
405,348,57,-,140100,47531
1719,1437,282,732,154600,47532
240,207,33,-,58500,47535
0,0,0,-,-,47536
350,329,21,810,125700,47537
465,342,123,811,113600,47541
3825,2745,1080,598,128300,47542
8838,6824,2014,683,166800,47546
239,232,7,-,138800,47550
326,312,14,-,141700,47551
94,94,0,-,-,47552
3093,2414,679,573,143100,47553
648,463,185,802,151000,47557
1108,964,144,836,182200,47558
698,528,170,550,111500,47561
1601,1192,409,579,174300,47562
585,533,52,-,145800,47564
2513,2022,491,538,100000,47567
289,205,84,612,104200,47568
75,75,0,-,-,47574
418,389,29,-,190400,47575
139,131,8,-,107700,47576
478,430,48,-,172900,47577
308,279,29,763,104900,47578
996,881,115,835,168300,47579
135,135,0,-,-,47580
1580,1345,235,502,107500,47581
76,73,3,-,69500,47584
235,173,62,672,81500,47585
4758,3559,1199,567,112500,47586
267,229,38,750,106800,47588
264,243,21,-,80700,47590
10291,6362,3929,668,106600,47591
35,28,7,-,-,47596
358,265,93,646,68900,47597
1185,956,229,704,76700,47598
5744,4632,1112,693,129200,47601
2190,1560,630,861,127100,47610
533,445,88,448,94600,47611
309,227,82,810,82700,47612
1122,1032,90,638,146800,47613
802,564,238,817,90700,47615
86,50,36,380,61000,47616
725,626,99,719,130000,47619
5315,3936,1379,686,138900,47620
14036,10857,3179,932,189700,47630
866,740,126,850,156800,47631
1105,955,150,786,113100,47633
909,804,105,850,105100,47634
2173,1662,511,735,115500,47635
526,411,115,671,167300,47637
1363,1306,57,528,173500,47638
1507,1335,172,692,224700,47639
420,387,33,590,82900,47640
1699,1269,430,673,143000,47648
677,584,93,879,80000,47649
38,18,20,938,66700,47654
1906,1440,466,678,89700,47660
1403,1229,174,603,136600,47665
716,586,130,739,60000,47666
4921,3205,1716,630,103700,47670
89,77,12,683,100800,47683
188,102,86,817,235000,47708
8257,4564,3693,670,95700,47710
13090,10073,3017,830,126800,47711
10339,6549,3790,817,133800,47712
4290,2063,2227,684,61600,47713
14023,8058,5965,771,89000,47714
13053,6638,6415,829,144400,47715
6966,5868,1098,864,165500,47720
6521,6104,417,1253,203000,47725
13460,7741,5719,738,124500,47802
8839,5821,3018,863,113100,47803
4730,2764,1966,703,66600,47804
5140,4085,1055,721,110900,47805
4794,1513,3281,708,53000,47807
0,0,0,-,-,47809
417,361,56,875,80800,47832
344,326,18,-,101100,47833
7758,5893,1865,698,109000,47834
0,0,0,-,-,47836
463,324,139,393,88500,47837
747,569,178,661,94400,47838
663,570,93,633,112300,47840
988,716,272,607,80700,47841
4295,2900,1395,662,82200,47842
207,181,26,-,117500,47846
448,379,69,674,60500,47847
601,547,54,731,67500,47848
196,177,19,-,124100,47849
952,817,135,581,93200,47850
53,21,32,800,75800,47853
254,254,0,-,118900,47854
215,165,50,714,59800,47855
135,122,13,-,67500,47857
252,234,18,-,104800,47858
320,294,26,1054,79100,47859
174,156,18,631,38100,47860
234,207,27,-,89800,47861
579,402,177,593,71300,47862
125,86,39,-,-,47863
18,18,0,-,-,47865
233,233,0,-,88800,47866
1293,1035,258,895,112400,47868
77,43,34,-,-,47869
125,93,32,1063,83500,47871
2899,2195,704,623,98900,47872
1216,1026,190,580,85800,47874
0,0,0,-,-,47876
1349,1045,304,707,85100,47879
40,40,0,-,85000,47880
137,118,19,800,61600,47881
3342,2189,1153,687,86900,47882
86,77,9,-,48200,47884
3596,2791,805,657,88400,47885
2130,323,1807,722,157900,47901
7048,3336,3712,784,85800,47904
17010,10612,6398,851,155300,47905
24305,11108,13197,909,207200,47906
0,0,0,-,-,47907
16958,10904,6054,842,136300,47909
12,7,5,-,28800,47916
162,135,27,790,106300,47917
2537,1882,655,656,109500,47918
848,793,55,935,169500,47920
379,287,92,740,69500,47921
585,398,187,728,83200,47922
1366,1045,321,791,118100,47923
95,95,0,-,-,47924
61,61,0,-,74400,47925
541,506,35,744,115400,47926
784,622,162,773,74700,47928
281,242,39,775,103600,47929
494,373,121,683,116200,47930
2180,1671,509,783,123500,47932
11291,7557,3734,664,134400,47933
655,578,77,781,130900,47940
557,417,140,847,129000,47941
317,255,62,625,88500,47942
316,162,154,1105,166700,47943
1492,1037,455,684,94000,47944
862,664,198,525,117800,47946
597,424,173,632,86100,47948
468,397,71,920,100200,47949
299,220,79,803,96800,47950
936,597,339,695,96900,47951
1149,936,213,714,93200,47952
929,757,172,797,122000,47954
427,340,87,717,79600,47955
732,571,161,645,82500,47957
60,49,11,585,77500,47958
1065,774,291,714,90000,47959
6420,4952,1468,710,127100,47960
839,606,233,764,101400,47963
46,37,9,438,75800,47964
237,179,58,867,92300,47965
164,161,3,-,52800,47966
284,229,55,1075,90300,47967
404,365,39,850,131000,47968
39,26,13,1188,78600,47969
743,563,180,788,120900,47970
738,644,94,703,93800,47971
520,380,140,590,83800,47974
319,246,73,764,99500,47975
923,649,274,722,119100,47977
4243,3035,1208,755,135100,47978
447,388,59,692,104700,47980
375,330,45,773,222900,47981
72,62,10,850,76700,47982
116,64,52,-,77500,47983
1722,1383,339,647,101200,47987
476,402,74,522,104300,47989
728,646,82,810,112600,47990
386,309,77,773,82000,47991
528,504,24,-,170400,47992
1460,1148,312,693,107600,47993
143,103,40,513,63400,47994
588,471,117,692,118300,47995
52,42,10,717,87500,47997
5339,4374,965,913,154900,48001
1236,1151,85,1055,197000,48002
2294,2038,256,903,191900,48003
2057,1890,167,827,207300,48005
1459,1339,120,841,173600,48006
9131,6768,2363,1513,541500,48009
1594,1245,349,795,157900,48014
3462,1658,1804,681,87700,48015
5687,4099,1588,933,178200,48017
12635,8131,4504,1095,77200,48021
961,925,36,690,167400,48022
1994,1748,246,1013,200200,48023
5813,5311,502,1275,412400,48025
6018,4456,1562,775,149100,48026
1232,1147,85,1326,170700,48027
552,533,19,-,289200,48028
7088,3509,3579,978,73600,48030
765,708,57,936,183200,48032
7604,3167,4437,1159,141400,48033
7353,1496,5857,1112,186000,48034
14478,8340,6138,922,138400,48035
9173,6547,2626,813,143200,48036
20234,12084,8150,993,178800,48038
3248,2623,625,841,148400,48039
4236,3431,805,834,133600,48040
1756,1434,322,738,181300,48041
10862,10631,231,1463,278400,48042
6870,3833,3037,748,103100,48043
19348,17531,1817,1175,266200,48044
11631,7836,3795,871,193200,48045
15950,12669,3281,886,215600,48047
2719,2143,576,1069,124400,48048
2204,2060,144,825,170600,48049
506,474,32,1346,238400,48050
6471,5471,1000,986,173600,48051
2966,2575,391,763,207900,48054
6049,4587,1462,852,155600,48059
16414,8999,7415,795,98300,48060
3390,2839,551,725,196700,48062
1557,1354,203,1059,228100,48063
1481,1382,99,697,214300,48064
4292,3643,649,891,263100,48065
20176,12754,7422,978,86400,48066
12312,8534,3778,1190,234200,48067
1071,1018,53,1445,346100,48069
2351,2304,47,2014,362900,48070
13186,7745,5441,967,124000,48071
6683,5461,1222,1115,199200,48072
16468,10886,5582,1019,217500,48073
3494,3176,318,813,133100,48074
9223,5197,4026,1060,148800,48075
9691,7050,2641,1177,171300,48076
4855,4190,665,790,179700,48079
10715,7963,2752,970,129900,48080
9004,7649,1355,956,142100,48081
7247,6210,1037,1056,134200,48082
9237,5644,3593,1109,223800,48083
6660,3151,3509,1235,340900,48084
8828,8164,664,1473,293900,48085
9092,7379,1713,893,146400,48088
12290,6495,5795,952,69400,48089
11784,7558,4226,971,86600,48091
10242,7778,2464,948,143500,48092
10244,7879,2365,887,134100,48093
7802,6509,1293,1187,301100,48094
2114,1912,202,821,335000,48095
1642,1480,162,914,271900,48096
2044,1565,479,719,129900,48097
7035,6470,565,1389,401700,48098
10964,9209,1755,980,123800,48101
23452,15585,7867,1324,353500,48103
16386,6189,10197,1300,375000,48104
14668,7148,7520,1291,366900,48105
11150,5861,5289,1024,273000,48108
5,0,5,-,-,48109
17091,11893,5198,938,167700,48111
7813,7296,517,1055,279500,48114
11060,9179,1881,1036,264600,48116
3852,3468,384,717,172700,48117
4996,4066,930,1150,270400,48118
2189,838,1351,1070,156600,48120
3724,1900,1824,856,64300,48122
11632,9104,2528,1041,137000,48124
7624,5511,2113,1092,78300,48125
12939,7112,5827,990,137200,48126
12581,9070,3511,1000,143400,48127
3836,3248,588,1351,163600,48128
5786,5204,582,1105,334800,48130
2979,2305,674,844,175900,48131
2156,1917,239,1059,128700,48133
8189,6684,1505,825,186200,48134
10749,8673,2076,1035,111000,48135
2072,1945,127,1346,233700,48137
4146,3859,287,1121,286200,48138
59,59,0,-,148400,48139
1275,1194,81,684,192900,48140
9002,3888,5114,887,48700,48141
0,0,0,-,-,48143
3844,3422,422,995,193000,48144
1261,1177,84,990,167800,48145
14244,9898,4346,842,73700,48146
10391,8940,1451,1115,164100,48150
12552,10082,2470,1050,211500,48152
14328,13038,1290,1075,211400,48154
603,435,168,383,136000,48157
3079,2655,424,721,235100,48158
936,789,147,1005,165100,48159
4650,3824,826,908,190400,48160
10722,7651,3071,776,128600,48161
11549,7911,3638,777,147900,48162
3099,2947,152,1101,221300,48164
2852,2158,694,1312,281300,48165
4399,3737,662,1053,133800,48166
9007,6562,2445,1246,319700,48167
8339,7691,648,1495,434200,48168
8653,7886,767,1041,244100,48169
17025,12849,4176,899,315300,48170
4692,3847,845,904,166400,48173
11833,8373,3460,926,97500,48174
8319,7098,1221,969,305700,48176
76,67,9,-,153000,48177
12985,11586,1399,1053,291500,48178
1481,1127,354,1104,183600,48179
24030,15397,8633,880,96300,48180
8856,7459,1397,846,171300,48182
17573,12758,4815,814,158100,48183
6633,3908,2725,759,85500,48184
21736,12039,9697,882,130500,48185
13447,9053,4394,933,111200,48186
18393,13122,5271,1086,247500,48187
15278,12541,2737,1311,258600,48188
5657,4728,929,973,213200,48189
78,78,0,-,144500,48190
1586,1337,249,1321,198000,48191
11070,7957,3113,763,109300,48192
6238,3965,2273,836,148600,48193
12696,8345,4351,876,112300,48195
25517,13078,12439,975,197400,48197
16013,9125,6888,917,113600,48198
8417,718,7699,598,300000,48201
7613,2005,5608,672,117500,48202
9872,4011,5861,655,45300,48203
9479,4896,4583,772,33300,48204
13164,4528,8636,957,31800,48205
6643,2977,3666,716,51800,48206
11554,2849,8705,878,108900,48207
4183,1354,2829,628,74500,48208
9813,4808,5005,678,47400,48209
8758,4760,3998,786,34300,48210
2056,697,1359,745,39200,48211
10805,6272,4533,759,59800,48212
7868,4150,3718,693,31300,48213
9989,3917,6072,708,56500,48214
5026,2125,2901,786,70500,48215
2462,903,1559,668,108000,48216
2900,1744,1156,783,49700,48217
3055,1678,1377,585,36300,48218
19371,10056,9315,863,49900,48219
11297,7277,4020,960,159100,48220
15733,9892,5841,900,77100,48221
10099,5606,4493,845,67400,48223
14218,8025,6193,954,46400,48224
5462,3075,2387,1073,81900,48225
4262,534,3728,1380,256300,48226
15813,8324,7489,888,50000,48227
19933,9664,10269,862,34700,48228
3703,2179,1524,821,42100,48229
6477,4912,1565,1123,355200,48230
0,0,0,-,-,48233
12952,7000,5952,847,37600,48234
18199,10562,7637,946,53900,48235
11286,10127,1159,1286,280500,48236
12107,6750,5357,1120,117700,48237
9994,5014,4980,796,42100,48238
13729,10131,3598,1142,86500,48239
6776,4903,1873,1184,81000,48240
0,0,0,-,-,48242
0,0,0,-,-,48243
5501,4834,667,1660,489600,48301
6212,5485,727,990,490500,48302
6372,5929,443,1513,375800,48304
9557,8929,628,1022,400600,48306
18000,11945,6055,1230,270300,48307
11174,9072,2102,1295,306500,48309
14845,10578,4267,1138,192400,48310
13657,9969,3688,904,176100,48312
13284,9752,3532,958,182700,48313
8296,6241,2055,1157,229000,48314
10875,9520,1355,1176,278600,48315
10870,8634,2236,1095,260900,48316
11602,7183,4419,1008,176600,48317
2300,1630,670,984,201600,48320
12334,9002,3332,1811,288600,48322
6402,5881,521,1639,353200,48323
6386,5750,636,1198,316300,48324
9649,4308,5341,1117,160600,48326
9531,6381,3150,854,170200,48327
11261,7157,4104,849,146700,48328
9929,8637,1292,1291,172700,48329
8397,6683,1714,1489,309000,48331
7944,4898,3046,1238,241200,48334
10718,4163,6555,1132,279400,48335
10787,7491,3296,946,180600,48336
9662,3881,5781,843,59400,48340
6800,3076,3724,830,84100,48341
6561,2390,4171,732,62400,48342
9158,6711,2447,1090,220000,48346
8712,8244,468,1329,330000,48348
2730,2444,286,897,256300,48350
2548,2162,386,1042,246600,48353
3316,3033,283,728,226400,48356
3147,2879,268,844,241400,48357
3741,2566,1175,1072,266500,48359
4659,3845,814,1131,287700,48360
5986,4922,1064,897,247600,48362
2238,2189,49,1094,391700,48363
1703,1566,137,1058,315700,48367
607,546,61,-,354300,48370
9094,7770,1324,913,253700,48371
5254,4651,603,1945,432100,48374
8530,5829,2701,1455,279400,48375
7783,3830,3953,1124,275500,48377
2593,2484,109,1632,317500,48380
5481,4244,1237,1114,294300,48381
8415,7798,617,1449,297900,48382
4656,4226,430,1177,244100,48383
7053,6200,853,1088,240100,48386
10423,7529,2894,1142,212800,48390
7256,3996,3260,748,227500,48393
0,0,0,-,-,48397
577,490,87,754,116300,48401
33,33,0,-,-,48411
1987,1838,149,738,180000,48412
2928,2134,794,631,107700,48413
968,868,100,911,139600,48414
3701,3114,587,852,139600,48415
1889,1525,364,718,129800,48416
1084,987,97,978,130700,48417
1462,1339,123,938,180200,48418
964,808,156,833,112300,48419
8828,6955,1873,667,117900,48420
2427,2236,191,957,141500,48421
2696,2062,634,710,106000,48422
13996,9381,4615,736,142800,48423
399,302,97,656,107000,48426
1158,897,261,649,93400,48427
1984,1747,237,988,250700,48428
3833,2974,859,728,113000,48429
14371,11409,2962,1061,220800,48430
278,255,23,806,113700,48432
10046,8630,1416,792,135700,48433
46,40,6,-,75700,48434
735,664,71,618,118500,48435
1444,1362,82,781,173000,48436
310,214,96,586,100300,48437
2452,2355,97,1212,220200,48438
19756,14497,5259,807,169300,48439
52,13,39,-,-,48440
1744,1387,357,549,107500,48441
8252,6626,1626,937,191000,48442
3599,2581,1018,733,167200,48444
501,412,89,622,86000,48445
12040,9658,2382,773,154000,48446
1096,922,174,775,96200,48449
2346,1997,349,677,138000,48450
5455,5033,422,786,205400,48451
2083,1501,582,669,101000,48453
499,450,49,783,129100,48454
3077,2785,292,828,266800,48455
322,300,22,617,117500,48456
3008,2622,386,739,114500,48457
7855,5151,2704,759,59600,48458
933,771,162,730,147300,48460
3176,2610,566,823,150900,48461
4874,4578,296,975,252500,48462
1735,1558,177,783,131900,48463
800,734,66,1000,127600,48464
270,217,53,715,140800,48465
627,518,109,650,90400,48466
1133,988,145,595,138700,48467
543,493,50,613,99300,48468
573,477,96,721,134100,48469
312,251,61,660,113400,48470
2331,1629,702,618,101600,48471
662,553,109,770,104600,48472
8983,7549,1434,917,139900,48473
1091,934,157,650,116900,48475
192,186,6,-,93800,48476
127,14,113,775,-,48502
11559,6376,5183,719,45300,48503
11116,6805,4311,777,32600,48504
8310,4518,3792,684,22500,48505
11653,7848,3805,722,49100,48506
13220,7804,5416,730,60300,48507
3785,3264,521,939,95400,48509
2939,2009,930,889,87500,48519
3657,2146,1511,690,47800,48529
8382,4872,3510,771,85700,48532
0,0,0,-,-,48551
0,0,0,-,-,48553
0,0,0,-,-,48554
14301,8830,5471,743,41300,48601
12292,7213,5079,722,50900,48602
11826,7531,4295,863,130800,48603
4115,2913,1202,853,81200,48604
722,256,466,807,59200,48607
5213,4566,647,728,136300,48609
1383,1262,121,731,96800,48610
2625,2094,531,745,129600,48611
3930,3246,684,645,107200,48612
426,370,56,830,107800,48613
557,457,100,917,97800,48614
1166,920,246,628,87700,48615
3020,2455,565,677,115000,48616
3413,2678,735,658,128900,48617
2060,1715,345,643,96100,48618
257,230,27,825,109700,48619
507,420,87,670,123500,48621
2295,1962,333,793,107200,48622
4792,4039,753,1021,165800,48623
6719,5740,979,590,110900,48624
5337,4420,917,585,75200,48625
2373,2210,163,722,143900,48626
47,45,2,-,-,48627
911,837,74,860,126300,48628
3489,2738,751,643,115600,48629
20,20,0,-,-,48630
1714,1536,178,643,130300,48631
2141,1897,244,805,94400,48632
68,64,4,-,139800,48633
1917,1790,127,584,126700,48634
720,651,69,730,104900,48635
416,391,25,-,81400,48636
1253,1107,146,820,106200,48637
5691,3890,1801,752,121100,48638
13192,9678,3514,727,150700,48640
13584,10025,3559,847,148500,48642
1905,1518,387,725,88700,48647
512,459,53,807,105900,48649
3046,2789,257,774,101100,48650
2330,1802,528,761,117800,48651
659,601,58,1018,106800,48652
4689,4123,566,703,114700,48653
1008,864,144,558,98300,48654
2394,2041,353,697,114500,48655
1792,1540,252,653,66600,48656
3357,2956,401,745,125200,48657
2058,1545,513,553,84600,48658
1051,888,163,721,91000,48659
4471,3481,990,704,115200,48661
650,599,51,1050,89200,48662
0,0,0,-,-,48667
568,471,97,785,74400,48701
1485,1256,229,533,113500,48703
273,249,24,575,105100,48705
16709,12956,3753,704,108700,48706
11077,7674,3403,617,73200,48708
0,0,0,-,-,48710
466,403,63,640,85600,48720
244,240,4,-,115000,48721
1287,1156,131,734,97200,48722
4965,3861,1104,702,93800,48723
230,192,38,-,70000,48724
1053,852,201,555,126600,48725
2282,1870,412,638,103800,48726
433,385,48,856,119700,48727
144,127,17,-,139100,48728
599,549,50,850,92200,48729
2228,1624,604,596,105000,48730
671,520,151,602,85100,48731
5010,3325,1685,657,109000,48732
694,581,113,803,85900,48733
3320,2540,780,677,196900,48734
458,379,79,820,84600,48735
600,520,80,720,81100,48737
561,501,60,539,117200,48738
1964,1786,178,663,106400,48739
1102,956,146,675,115100,48740
797,679,118,690,103200,48741
759,664,95,567,118300,48742
37,32,5,-,72700,48743
1765,1483,282,855,110900,48744
566,493,73,600,93100,48745
3181,2715,466,752,130500,48746
545,506,39,671,115400,48747
812,717,95,608,90600,48748
461,421,40,722,92800,48749
4082,2979,1103,679,84500,48750
361,319,42,580,75300,48754
1402,1132,270,689,122400,48755
1956,1528,428,708,68100,48756
1559,1351,208,656,118900,48757
1448,1185,263,613,80200,48759
585,522,63,761,92200,48760
428,381,47,418,75000,48761
508,492,16,1089,139700,48762
2028,1778,250,734,114700,48763
311,279,32,825,80900,48765
524,476,48,746,82400,48766
847,760,87,817,99600,48767
3943,3135,808,666,107600,48768
761,674,87,485,84200,48770
5092,3362,1730,661,89400,48801
646,528,118,692,98100,48806
343,295,48,733,89100,48807
2471,1945,526,957,200400,48808
4074,2960,1114,702,120600,48809
1237,937,300,661,103000,48811
7882,6103,1779,795,143000,48813
903,807,96,646,171500,48815
12,6,6,-,-,48816
2401,1676,725,835,116100,48817
1022,823,199,732,110400,48818
1004,913,91,938,159000,48819
6726,5480,1246,901,216100,48820
2483,2277,206,1059,175600,48821
1046,1015,31,853,177500,48822
19946,8540,11406,950,197400,48823
0,0,0,-,-,48825
6291,5174,1117,827,157100,48827
1326,883,443,679,91200,48829
1350,1036,314,775,113200,48831
589,503,86,727,103900,48832
841,644,197,852,119500,48834
1089,913,176,729,153800,48835
4986,4149,837,866,181600,48836
8204,6516,1688,846,180000,48837
7491,5493,1998,681,127300,48838
5840,3659,2181,816,187700,48840
287,268,19,875,120800,48841
8931,6322,2609,920,158200,48842
17162,13088,4074,1021,239800,48843
322,280,42,650,97900,48845
6582,4605,1977,811,119800,48846
2292,1767,525,732,104100,48847
2890,2592,298,837,177000,48848
2308,1894,414,688,134800,48849
1696,1371,325,600,107700,48850
852,729,123,759,106900,48851
75,53,22,769,68300,48852
225,175,50,572,87900,48853
7558,6004,1554,979,169800,48854
5836,5025,811,1229,237200,48855
383,232,151,738,81000,48856
1066,847,219,861,135600,48857
17231,8838,8393,742,140800,48858
610,480,130,470,111900,48860
572,505,67,720,129600,48861
9162,5791,3371,1011,250300,48864
753,537,216,781,94000,48865
1845,1530,315,654,119600,48866
11395,7917,3478,676,108700,48867
57,34,23,-,59100,48870
783,627,156,794,145500,48871
2652,2076,576,815,149400,48872
489,452,37,642,142100,48873
54,54,0,-,77600,48874
3908,3043,865,930,157400,48875
1624,1284,340,865,135900,48876
953,856,97,767,87100,48877
545,439,106,463,112700,48878
6776,5452,1324,781,154800,48879
2523,1868,655,677,93200,48880
2143,1821,322,610,151200,48881
2686,2242,444,671,115400,48883
1613,1404,209,792,114700,48884
374,350,24,664,117000,48885
789,648,141,680,90200,48886
2452,2001,451,680,122700,48888
559,480,79,815,97400,48889
817,697,120,666,149800,48890
1162,930,232,684,119500,48891
1799,1527,272,868,140600,48892
2006,1789,217,713,129300,48893
654,594,60,688,174400,48894
4511,3693,818,808,213800,48895
82,82,0,-,46400,48896
686,581,105,648,155400,48897
10575,7081,3494,815,98500,48906
15698,8705,6993,850,81700,48910
16232,8269,7963,787,90000,48911
7801,3519,4282,869,101800,48912
3817,1852,1965,879,76500,48915
14736,8511,6225,892,152100,48917
0,0,0,-,-,48921
1461,60,1401,751,115500,48933
8884,4660,4224,806,89400,49001
8436,5633,2803,737,149600,49002
6373,4814,1559,897,122000,49004
10366,3802,6564,828,132400,49006
4055,1176,2879,699,64400,49007
6863,4050,2813,769,156300,49008
18439,12147,6292,840,231800,49009
6722,5324,1398,848,138500,49010
816,724,92,725,104600,49011
1376,1197,179,810,183600,49012
1894,1464,430,685,103200,49013
8192,5960,2232,845,116500,49014
11186,7650,3536,875,122400,49015
8914,6570,2344,770,103900,49017
2401,2008,393,807,126600,49021
12980,7459,5521,685,94900,49022
11945,8069,3876,886,171300,49024
964,713,251,766,114500,49026
103,82,21,775,-,49027
2520,1914,606,721,106200,49028
600,540,60,638,112800,49029
874,723,151,671,97800,49030
3058,2198,860,706,141600,49031
1089,881,208,628,132000,49032
723,645,78,835,173100,49033
1009,883,126,783,158300,49034
9020,6361,2659,767,113800,49036
8768,4517,4251,661,66900,49037
3852,2792,1060,793,139100,49038
1376,1036,340,809,114300,49040
1965,1520,445,635,115600,49042
903,502,401,752,102200,49043
2084,1627,457,693,107800,49045
3478,2898,580,820,154300,49046
6355,4512,1843,591,114300,49047
9909,6162,3747,806,103900,49048
612,577,35,667,156400,49050
947,879,68,-,180900,49051
326,268,58,698,116500,49052
2748,2191,557,647,157400,49053
2422,2049,373,640,133500,49055
1304,1107,197,880,87700,49056
2215,1604,611,622,84300,49057
7564,6158,1406,911,136800,49058
777,642,135,567,298900,49060
582,531,51,913,119800,49061
1387,1111,276,670,128600,49064
2522,2102,420,831,142900,49065
218,191,27,950,122800,49066
1749,1527,222,890,130400,49067
6371,4823,1548,725,147800,49068
980,898,82,671,133700,49070
3600,3173,427,923,197600,49071
1154,981,173,848,135100,49072
1859,1441,418,771,119300,49073
80,0,80,390,-,49074
54,44,10,-,75800,49075
1450,1143,307,761,149800,49076
3729,2987,742,803,135600,49078
5250,3957,1293,678,151000,49079
6103,5161,942,740,159000,49080
2348,1975,373,770,104800,49082
3058,2671,387,746,224500,49083
7,0,7,-,-,49084
10187,7800,2387,824,201800,49085
2338,2162,176,708,203000,49087
1488,1359,129,1119,181100,49088
647,508,139,754,104600,49089
6215,4535,1680,734,167500,49090
7805,5533,2272,749,119000,49091
783,623,160,788,114600,49092
7358,5438,1920,723,125100,49093
1665,1237,428,661,96200,49094
893,748,145,885,203600,49095
1217,1024,193,770,136400,49096
4303,3703,600,725,170900,49097
2259,1721,538,725,109900,49098
2407,1788,619,695,130100,49099
1220,1012,208,837,160200,49101
567,413,154,872,193300,49102
3665,2144,1521,688,162800,49103
0,0,0,-,-,49104
2264,1714,550,814,164300,49106
4144,3065,1079,683,133500,49107
1370,1197,173,850,121300,49111
3986,3359,627,847,164100,49112
778,617,161,809,132400,49113
232,232,0,-,379100,49115
125,125,0,-,398300,49116
1762,1413,349,885,300900,49117
35,23,12,-,143800,49119
15169,11177,3992,716,119300,49120
1089,934,155,750,189600,49125
485,410,75,804,122000,49126
4432,3494,938,904,194600,49127
1443,1181,262,790,160100,49128
282,274,8,-,400000,49129
601,484,117,950,303500,49130
15428,11178,4250,782,151800,49201
8626,4501,4125,731,72500,49202
15723,10511,5212,837,103900,49203
1024,804,220,737,155200,49220
14726,10311,4415,761,117400,49221
5046,3577,1469,685,79700,49224
479,413,66,648,91100,49227
2133,1657,476,800,137100,49228
1238,1090,148,742,183600,49229
4483,3992,491,755,177300,49230
953,789,164,771,142500,49232
1096,968,128,738,160300,49233
1073,964,109,834,174700,49234
809,659,150,754,130200,49235
1887,1628,259,724,160100,49236
1124,934,190,737,138000,49237
664,533,131,731,147000,49238
3645,3362,283,865,216800,49240
1069,912,157,742,138800,49241
5684,3819,1865,663,115100,49242
1854,1424,430,714,102300,49245
1245,1126,119,659,164200,49246
2284,1806,478,822,102700,49247
324,292,32,1028,115400,49248
1534,1374,160,936,165800,49249
2473,1896,577,719,114700,49250
2325,2043,282,829,134100,49251
1037,739,298,677,106000,49252
1287,1188,99,566,203000,49253
1510,1293,217,793,120500,49254
755,601,154,887,87300,49255
1531,1151,380,774,86600,49256
918,801,117,773,139500,49259
100,65,35,-,-,49261
506,362,144,695,84600,49262
25,15,10,-,-,49263
712,657,55,1023,140500,49264
2231,1911,320,795,193900,49265
1348,1128,220,703,112000,49266
1587,1401,186,963,179700,49267
483,376,107,705,107400,49268
2264,1965,299,729,132600,49269
2123,1881,242,792,179900,49270
735,598,137,679,116700,49271
1017,946,71,713,169900,49272
1254,1000,254,724,118900,49274
339,301,38,1096,128900,49276
1389,1232,157,870,139100,49277
361,306,55,1148,132200,49279
141,122,19,-,-,49282
1129,857,272,613,171100,49283
1169,925,244,871,114700,49284
2132,1786,346,703,168000,49285
5916,4671,1245,787,154200,49286
805,771,34,-,199500,49287
542,375,167,622,79200,49288
60,39,21,938,38300,49289
6817,6447,370,1462,370600,49301
2933,2791,142,979,266500,49302
348,300,48,728,135000,49303
1547,1124,423,558,82900,49304
964,781,183,641,85700,49305
3921,3779,142,646,234500,49306
7084,4098,2986,716,129100,49307
734,599,135,775,91800,49309
1056,955,101,600,118500,49310
138,116,22,729,88000,49312
8320,7335,985,968,242500,49315
8115,7284,831,1073,244500,49316
552,497,55,916,157500,49318
6309,5396,913,802,159000,49319
22,22,0,-,-,49320
6822,4326,2496,821,169200,49321
521,403,118,827,112500,49322
3555,3379,176,796,191100,49323
695,619,76,725,154700,49325
1688,1489,199,680,121100,49326
3151,2602,549,710,142900,49327
1518,1305,213,677,159300,49328
3055,2629,426,778,126000,49329
1785,1443,342,778,154600,49330
6716,5528,1188,894,205600,49331
1218,1062,156,704,110400,49332
4386,3692,694,992,193700,49333
75,75,0,-,168400,49335
1494,1286,208,723,105000,49336
5103,4329,774,731,121700,49337
780,647,133,834,111300,49338
806,708,98,798,158400,49339
1048,847,201,358,112200,49340
13006,11925,1081,914,240700,49341
637,517,120,750,107900,49342
1927,1662,265,699,149300,49343
1365,1155,210,741,164900,49344
5268,4414,854,759,167600,49345
2144,2019,125,820,164400,49346
467,396,71,804,105600,49347
4845,3733,1112,819,164000,49348
3121,2589,532,675,92300,49349
6868,3330,3538,965,200900,49401
548,476,72,869,121300,49402
960,897,63,897,228300,49403
3047,2555,492,824,171800,49404
590,533,57,721,115300,49405
403,311,92,1118,366100,49406
3731,3152,579,746,152600,49408
771,623,148,764,100200,49410
626,585,41,917,124900,49411
4368,3541,827,714,135800,49412
2594,2399,195,796,159200,49415
12631,9926,2705,884,197400,49417
10902,8383,2519,852,191400,49418
2794,2587,207,929,210600,49419
2322,1788,534,684,106900,49420
2322,2005,317,671,90900,49421
16763,11421,5342,865,166900,49423
17897,13464,4433,921,183600,49424
1316,1064,252,779,103900,49425
12513,11252,1261,930,220200,49426
10089,8506,1583,889,180300,49428
7553,5465,2088,695,152600,49431
6,6,0,-,-,49434
1263,1148,115,729,208900,49435
700,612,88,613,170500,49436
2739,2243,496,666,134600,49437
610,109,501,489,103300,49440
15121,10437,4684,817,121000,49441
15246,9988,5258,717,76200,49442
10038,6951,3087,772,87400,49444
8381,7549,832,871,144700,49445
967,862,105,723,128400,49446
1498,1385,113,776,193400,49448
1189,1023,166,754,223500,49449
930,523,407,751,125900,49450
2147,1870,277,675,142700,49451
743,660,83,813,92200,49452
1166,902,264,714,320700,49453
1780,1399,381,683,120300,49454
1821,1387,434,739,113900,49455
8032,6254,1778,849,202600,49456
3847,3343,504,809,134300,49457
50,46,4,-,120000,49458
532,418,114,793,81500,49459
2973,2719,254,982,241800,49460
3530,2907,623,731,159500,49461
10277,9033,1244,911,193100,49464
15772,6481,9291,891,150100,49503
15421,9425,5996,895,140800,49504
13482,8902,4580,913,143900,49505
12580,9382,3198,954,237800,49506
12296,7134,5162,923,104900,49507
14801,8772,6029,934,157800,49508
10011,6778,3233,785,111200,49509
7649,3281,4368,870,200400,49512
11282,6241,5041,909,141300,49519
11591,9139,2452,973,195500,49525
8761,5936,2825,921,188200,49534
4034,2242,1792,879,166300,49544
13127,8595,4532,1048,285600,49546
12022,8371,3651,871,99800,49548
8735,6502,2233,671,111200,49601
100,93,7,-,49800,49611
606,560,46,883,159900,49612
291,269,22,738,174500,49613
1032,944,88,905,140300,49614
1729,1483,246,707,201500,49615
753,624,129,661,154600,49616
1261,1171,90,499,200600,49617
291,259,32,1011,114000,49618
408,366,42,846,108500,49619
920,773,147,956,137200,49620
1506,1354,152,1163,232100,49621
1118,941,177,621,141200,49622
444,420,24,788,87100,49623
450,406,44,925,120000,49625
151,151,0,-,82800,49626
90,71,19,-,-,49627
69,65,4,-,116500,49628
970,780,190,869,224400,49629
695,642,53,361,286700,49630
2478,1935,543,626,98100,49631
447,368,79,779,99500,49632
1570,1363,207,750,110300,49633
17,17,0,-,-,49634
1470,1265,205,658,238700,49635
196,196,0,-,804300,49636
1282,1118,164,961,142300,49637
354,307,47,553,94500,49638
876,733,143,808,100900,49639
632,596,36,871,206100,49640
360,265,95,552,68800,49642
2704,2440,264,743,172900,49643
953,888,65,650,107900,49644
610,516,94,771,103000,49645
3409,2609,800,673,107900,49646
1014,937,77,933,337400,49648
2203,2000,203,798,163500,49649
1110,1052,58,873,181700,49650
3285,2620,665,783,118400,49651
819,737,82,736,296400,49653
245,195,50,740,498000,49654
1267,1124,143,748,113700,49655
632,567,65,744,84500,49656
1336,1053,283,662,128500,49657
2676,2340,336,737,91500,49659
5538,4386,1152,699,129200,49660
2219,1762,457,714,110600,49663
812,725,87,803,249700,49664
1702,1421,281,638,90100,49665
84,84,0,-,-,49666
227,183,44,588,93600,49667
1316,1075,241,799,93400,49668
903,817,86,1137,291500,49670
12,12,0,-,-,49674
397,344,53,613,246200,49675
1526,1332,194,738,178200,49676
2826,2166,660,599,89300,49677
475,432,43,688,109400,49679
700,607,93,766,108400,49680
1676,1385,291,766,282500,49682
810,696,114,630,123000,49683
16815,12359,4456,950,229600,49684
14054,10551,3503,973,228500,49686
956,834,122,725,127500,49688
592,545,47,600,102900,49689
2812,2321,491,1060,246600,49690
459,314,145,686,165900,49701
344,266,78,685,121400,49705
1781,1408,373,695,123900,49706
9921,7467,2454,598,94500,49707
1705,1499,206,547,95900,49709
200,155,45,447,135600,49710
3494,2860,634,777,172400,49712
875,748,127,824,160400,49713
1328,1111,217,496,136200,49715
345,324,21,925,226300,49716
65,65,0,-,407100,49717
300,265,35,750,129600,49718
597,476,121,562,186000,49719
4052,3092,960,620,182500,49720
6223,5065,1158,716,121300,49721
139,126,13,-,150600,49722
393,356,37,961,138900,49724
291,272,19,575,121700,49725
507,442,65,533,164800,49726
2994,2522,472,595,131100,49727
114,89,25,842,119000,49728
666,575,91,902,138400,49729
841,769,72,792,127500,49730
862,741,121,840,105600,49733
8062,6234,1828,769,143000,49735
246,220,26,596,109400,49736
4278,3308,970,728,104700,49738
3222,2819,403,961,242400,49740
335,317,18,583,116000,49743
334,309,25,755,120400,49744
450,348,102,706,131400,49745
1562,1306,256,590,99600,49746
876,751,125,692,139500,49747
86,76,10,538,110000,49748
1883,1485,398,670,155800,49749
836,743,93,725,135400,49751
315,229,86,529,106300,49752
937,867,70,538,109800,49753
893,771,122,796,156600,49755
1804,1530,274,797,107100,49756
514,182,332,595,373300,49757
715,678,37,936,119800,49759
280,262,18,1167,125000,49760
331,301,30,1125,117900,49762
164,46,118,599,-,49764
1677,1442,235,604,94500,49765
944,781,163,487,91400,49766
181,148,33,-,139800,49768
681,519,162,907,110300,49769
7480,4823,2657,832,196400,49770
787,710,77,683,134200,49774
44,42,2,-,166700,49775
766,651,115,598,98100,49776
831,813,18,890,189100,49777
1993,1686,307,519,88100,49779
649,581,68,961,103900,49780
1859,1207,652,580,126000,49781
294,259,35,625,237500,49782
7887,4697,3190,684,115400,49783
1146,451,695,682,76200,49788
135,110,25,409,158300,49791
88,77,11,-,178400,49793
824,665,159,725,112700,49795
161,127,34,794,-,49796
899,793,106,810,111600,49799
4683,3698,985,664,126200,49801
2833,1918,915,659,84400,49802
158,143,15,-,141300,49805
226,220,6,-,210400,49806
1512,1308,204,597,133200,49807
119,107,12,-,193100,49808
406,361,45,917,116800,49812
526,476,50,646,91400,49814
139,113,26,472,83600,49815
294,279,15,546,124700,49816
235,219,16,675,151800,49817
428,402,26,817,130600,49818
15,15,0,-,-,49819
150,111,39,520,137500,49820
574,510,64,628,96800,49821
70,65,5,-,96300,49822
98,84,14,-,150000,49825
88,85,3,-,111700,49826
420,325,95,682,112500,49827
7906,5377,2529,573,101200,49829
332,326,6,-,113700,49831
112,83,29,-,-,49833
84,78,6,-,152100,49834
397,361,36,1083,119600,49835
372,334,38,510,123900,49836
3949,3323,626,595,119400,49837
227,199,28,964,110100,49838
173,128,45,661,193800,49839
272,253,19,-,138300,49840
2918,1923,995,647,109800,49841
448,338,110,543,90400,49847
46,46,0,-,128800,49848
5086,4046,1040,530,106500,49849
49,47,2,-,67900,49852
540,520,20,-,118200,49853
2748,2250,498,572,106500,49854
12804,7852,4952,799,187700,49855
5678,4154,1524,582,93800,49858
241,230,11,-,155000,49861
1439,1130,309,625,123800,49862
64,64,0,-,46700,49863
51,34,17,-,53300,49864
3180,2669,511,662,150700,49866
1727,1282,445,721,80900,49868
1658,1208,450,704,103300,49870
218,176,42,613,63600,49871
69,51,18,757,102100,49872
50,50,0,-,159400,49873
384,291,93,553,110800,49874
515,469,46,783,92700,49876
8,8,0,-,-,49877
1564,1382,182,475,134100,49878
489,430,59,610,84100,49879
475,423,52,588,107500,49880
125,100,25,850,125000,49881
45,41,4,625,59300,49883
126,113,13,-,96300,49884
771,697,74,775,151400,49885
237,192,45,855,86100,49886
1124,898,226,611,117100,49887
255,227,28,1063,116800,49891
843,767,76,612,152000,49892
699,628,71,565,133400,49893
282,259,23,-,105800,49894
244,226,18,828,168800,49895
602,437,165,466,116900,49896
135,130,5,-,56300,49901
91,79,12,517,40500,49902
45,34,11,238,67500,49903
595,549,46,860,133700,49905
935,676,259,493,112400,49908
138,133,5,-,109400,49910
1226,967,259,414,73800,49911
461,413,48,546,103300,49912
2737,2010,727,536,67900,49913
172,129,43,720,40500,49915
1100,938,162,670,166000,49916
82,73,9,810,46100,49917
63,52,11,-,241700,49918
87,81,6,-,76500,49919
1850,1622,228,592,95500,49920
154,71,83,1291,142400,49921
287,225,62,808,112500,49922
227,196,31,513,74500,49925
201,189,12,950,56800,49927
89,88,1,-,54200,49929
2718,1635,1083,604,122700,49930
3217,1333,1884,678,163500,49931
338,305,33,716,75600,49934
2826,2127,699,470,71900,49935
3638,2691,947,513,62100,49938
132,100,32,-,75000,49942
1053,858,195,504,108600,49945
1613,1276,337,551,87200,49946
215,203,12,-,154000,49947
256,239,17,1667,65000,49948
619,524,95,500,117300,49950
39,35,4,-,133700,49952
1161,957,204,497,69000,49953
149,144,5,-,62000,49955
344,332,12,700,153900,49958
164,126,38,482,46200,49959
68,66,2,-,43300,49960
46,42,4,-,64300,49961
112,110,2,-,141700,49962
379,289,90,556,77800,49963
219,215,4,-,90700,49965
213,207,6,1625,78300,49967
918,787,131,556,62200,49968
604,468,136,525,196900,49969
127,121,6,-,103800,49970
212,199,13,575,42600,49971
341,296,45,846,263300,50001
605,457,148,822,124400,50002
2979,2502,477,724,255500,50003
373,323,50,742,101800,50005
711,511,200,525,104600,50006
167,167,0,-,200900,50007
385,322,63,464,65500,50008
7267,5274,1993,931,202000,50009
14588,7727,6861,868,198000,50010
0,0,0,-,-,50011
8,0,8,-,-,50012
12443,3989,8454,977,243600,50014
618,500,118,752,76200,50020
10937,7826,3111,1211,215400,50021
3771,2458,1313,632,121200,50022
13911,10655,3256,985,227400,50023
1448,1077,371,683,78600,50025
260,211,49,638,84000,50026
153,123,30,639,67900,50027
665,504,161,806,143000,50028
278,226,52,651,55800,50029
146,146,0,-,-,50032
5,2,3,-,-,50033
195,162,33,554,88500,50034
2695,2402,293,961,233800,50035
6908,5364,1544,742,122800,50036
44,44,0,-,-,50038
173,142,31,728,229400,50039
25,25,0,-,-,50041
120,106,14,775,75400,50042
348,267,81,523,80900,50044
628,542,86,900,177600,50046
2267,1827,440,784,160600,50047
375,288,87,746,86700,50048
2810,2089,721,660,96700,50049
300,229,71,535,62700,50050
124,86,38,390,76000,50051
62,57,5,-,77900,50052
1136,953,183,714,134000,50054
341,261,80,827,148600,50055
555,455,100,900,133700,50056
122,122,0,-,112500,50057
821,664,157,623,114200,50058
1012,779,233,595,93300,50060
691,650,41,950,390200,50061
274,211,63,625,114700,50062
951,769,182,620,219000,50063
76,65,11,-,108200,50064
334,222,112,-,64500,50065
62,46,16,531,77300,50066
121,98,23,705,61400,50067
147,140,7,-,214300,50068
419,346,73,690,145600,50069
576,492,84,716,149500,50070
512,409,103,561,68500,50071
897,697,200,851,221100,50072
422,356,66,990,177100,50073
172,147,25,-,342400,50074
351,248,103,725,101800,50075
672,546,126,526,68000,50076
86,52,34,1250,37900,50078
12,10,2,-,34200,50101
67,67,0,-,54600,50102
158,134,24,385,77000,50103
44,32,12,-,64600,50104
350,276,74,710,206400,50105
343,254,89,536,94500,50106
449,332,117,606,76500,50107
190,150,40,531,80000,50108
1161,1051,110,886,259900,50109
5391,4015,1376,1002,238500,50111
4653,2946,1707,732,149900,50112
1134,826,308,655,100700,50115
68,67,1,-,63000,50116
64,43,21,-,154700,50117
399,379,20,1117,132300,50118
140,91,49,713,84800,50119
162,134,28,-,110000,50120
520,423,97,559,100100,50122
344,282,62,478,80900,50123
1530,1282,248,771,208400,50124
7920,5661,2259,802,187400,50125
2806,1975,831,739,102800,50126
0,0,0,-,-,50127
185,138,47,581,105200,50128
2202,1525,677,651,103500,50129
561,470,91,761,114800,50130
8564,6176,2388,1142,263700,50131
102,88,14,950,46000,50132
183,144,39,827,77400,50133
282,203,79,682,209600,50134
601,498,103,705,122600,50135
178,137,41,825,93900,50136
5070,3515,1555,678,112800,50138
478,438,40,642,122100,50139
1048,592,456,612,95600,50140
206,178,28,585,118800,50141
393,300,93,789,123900,50142
255,209,46,575,155800,50143
1080,719,361,473,86600,50144
196,175,21,544,134700,50146
182,148,34,486,57000,50147
175,138,37,598,105400,50148
379,306,73,788,144600,50149
423,380,43,638,85700,50150
254,232,22,1073,171400,50151
347,257,90,671,135400,50153
201,177,24,833,128200,50154
151,120,31,760,75000,50155
1933,1605,328,711,159900,50156
414,295,119,630,81700,50157
11808,8042,3766,689,103900,50158
204,144,60,658,133800,50160
741,625,116,600,158500,50161
530,399,131,813,121800,50162
374,281,93,573,73900,50163
209,145,64,467,85000,50164
56,54,2,-,-,50165
655,578,77,696,138600,50166
248,191,57,668,134700,50167
315,264,51,728,170000,50168
886,636,250,710,158400,50169
1194,980,214,643,138100,50170
1080,823,257,726,180800,50171
328,249,79,920,129600,50173
544,458,86,837,82500,50174
3352,2535,817,665,149300,50201
209,182,27,555,91700,50206
867,715,152,575,134000,50207
8141,5754,2387,738,125300,50208
646,594,52,780,210700,50210
5055,4103,952,855,219200,50211
1254,997,257,714,130800,50212
2909,1910,999,779,113100,50213
297,246,51,-,238200,50214
1062,891,171,845,201900,50216
303,239,64,750,75800,50217
73,59,14,922,62100,50218
5216,3484,1732,826,202000,50219
3605,2186,1419,768,99900,50220
204,196,8,-,159400,50222
288,210,78,481,125000,50223
1143,881,262,650,157200,50225
2010,1758,252,1158,290300,50226
10,9,1,-,-,50227
1041,790,251,878,156400,50228
313,308,5,-,296000,50229
438,372,66,428,113500,50230
73,59,14,725,102900,50231
200,150,50,871,150000,50232
531,478,53,875,154500,50233
192,178,14,585,114400,50234
162,125,37,825,81400,50235
672,545,127,638,158800,50236
1244,1095,149,579,264900,50237
432,381,51,668,79800,50238
31,17,14,-,50800,50239
1108,939,169,878,204400,50240
225,179,46,663,142500,50242
97,86,11,975,107100,50243
761,634,127,745,174700,50244
305,220,85,638,97100,50246
919,731,188,645,139300,50247
1915,1453,462,744,164600,50248
529,409,120,731,110700,50249
930,731,199,679,110100,50250
511,408,103,710,134800,50251
89,80,9,-,-,50252
89,89,0,-,121000,50254
29,29,0,-,-,50255
181,142,39,-,86200,50256
389,320,69,837,165800,50257
423,341,82,504,67000,50258
930,780,150,950,212900,50261
150,137,13,1097,71300,50262
9700,7268,2432,1148,248900,50263
192,136,56,903,75600,50264
13758,9002,4756,929,194700,50265
13777,7631,6146,1091,252500,50266
437,322,115,757,54400,50268
244,188,56,1006,83900,50271
65,57,8,-,53100,50272
3557,2622,935,774,176800,50273
91,75,16,-,-,50274
257,222,35,714,129600,50275
817,678,139,782,177800,50276
143,115,28,763,96200,50277
321,250,71,667,118800,50278
5018,552,4466,874,281100,50309
13256,9187,4069,868,154900,50310
5844,3058,2786,763,149600,50311
7651,4740,2911,827,212500,50312
6560,4672,1888,909,107700,50313
3987,1645,2342,785,91200,50314
14515,9248,5267,825,118800,50315
5698,3235,2463,811,93300,50316
14780,10195,4585,882,117400,50317
0,0,0,-,-,50319
8033,5497,2536,894,164800,50320
3290,2031,1259,899,203800,50321
12762,9011,3751,914,191500,50322
4879,4541,338,1332,339600,50323
2143,1666,477,1019,186700,50324
6592,5036,1556,984,265100,50325
4188,3241,947,1007,215900,50327
13209,8684,4525,722,118800,50401
116,90,26,438,50000,50420
1357,1055,302,599,89600,50421
1206,906,300,578,87100,50423
630,551,79,621,69600,50424
25,14,11,-,54400,50426
4093,2970,1123,636,166800,50428
217,169,48,707,65000,50430
91,65,26,517,61200,50431
121,93,28,660,50800,50432
119,114,5,-,110900,50433
172,148,24,575,100000,50434
307,279,28,669,143400,50435
2331,1754,577,623,117800,50436
1702,1341,361,681,135300,50438
92,76,16,-,-,50439
189,140,49,480,101900,50440
2212,1558,654,745,91100,50441
152,138,14,545,150000,50444
242,178,64,551,126100,50446
530,387,143,569,65600,50447
318,245,73,658,104300,50448
399,265,134,620,79100,50449
1268,893,375,613,103900,50450
251,196,55,675,41400,50451
382,255,127,642,110200,50452
275,236,39,628,133300,50453
36,36,0,-,85300,50454
171,160,11,615,100000,50455
769,541,228,543,91500,50456
157,138,19,733,82900,50457
914,789,125,723,112500,50458
1225,971,254,692,107100,50459
152,135,17,-,195200,50460
2343,1862,481,624,121200,50461
224,179,45,888,92500,50464
92,73,19,675,29300,50465
650,538,112,615,100700,50466
36,24,12,764,141700,50467
664,499,165,496,156100,50468
603,528,75,475,138800,50469
116,91,25,583,61300,50470
284,201,83,575,86000,50471
960,778,182,634,153300,50472
108,98,10,-,58400,50473
650,541,109,633,96600,50475
300,247,53,433,80200,50476
119,97,22,467,59400,50477
349,294,55,689,83000,50478
260,196,64,541,75000,50479
345,310,35,704,59700,50480
363,316,47,890,161400,50482
273,229,44,489,99600,50483
169,140,29,525,65300,50484
11722,7603,4119,650,101400,50501
453,302,151,665,80000,50510
3209,2212,997,708,149000,50511
641,529,112,571,83600,50514
91,64,27,433,40700,50515
253,209,44,611,97000,50516
466,348,118,519,81600,50517
160,135,25,618,106500,50518
254,195,59,497,77200,50519
53,46,7,-,72000,50520
104,64,40,-,-,50521
345,305,40,648,71300,50522
236,161,75,793,77100,50523
232,183,49,631,122100,50524
1553,1025,528,676,92500,50525
102,80,22,-,81800,50527
130,89,41,569,96900,50528
367,299,68,725,83400,50529
447,330,117,521,119700,50530
107,82,25,-,110100,50531
327,243,84,480,126000,50532
1685,1124,561,630,85600,50533
443,304,139,698,84800,50535
1793,1253,540,609,119900,50536
223,168,55,548,58100,50538
217,181,36,657,59500,50539
442,370,72,575,80200,50540
386,268,118,544,83300,50541
414,345,69,633,67300,50542
610,512,98,537,97700,50543
158,119,39,625,81700,50544
79,72,7,-,-,50545
145,123,22,429,54200,50546
2521,1743,778,561,125600,50548
46,36,10,-,68200,50551
792,626,166,615,70500,50554
106,98,8,-,70000,50556
330,275,55,642,83800,50557
247,214,33,683,67500,50558
150,87,63,583,75000,50559
278,201,77,711,48200,50560
214,153,61,479,55000,50561
173,140,33,725,61700,50562
1168,899,269,598,100900,50563
186,157,29,600,73800,50565
196,160,36,-,132100,50566
119,98,21,621,135900,50567
616,476,140,497,89500,50568
344,277,67,547,76900,50569
74,58,16,1025,112500,50570
155,124,31,390,75000,50571
33,30,3,-,44400,50573
994,757,237,589,81900,50574
351,295,56,567,60400,50575
140,89,51,-,75000,50576
174,147,27,496,53700,50577
320,244,76,525,43300,50578
1059,808,251,605,77400,50579
365,231,134,593,43000,50581
143,114,29,-,65000,50582
1182,850,332,651,85200,50583
524,406,118,797,94100,50585
119,109,10,731,87500,50586
4453,2545,1908,699,133800,50588
409,334,75,730,52300,50590
151,124,27,794,93800,50591
19,19,0,-,27500,50593
84,69,15,631,93200,50594
3847,2637,1210,701,104400,50595
459,361,98,588,133000,50597
417,361,56,557,76500,50598
180,136,44,622,84600,50599
1054,863,191,565,89100,50601
680,484,196,516,103200,50602
196,162,34,619,85900,50603
808,672,136,592,115700,50604
116,89,27,621,45000,50605
296,230,66,500,84200,50606
158,147,11,565,125700,50607
174,152,22,733,114300,50609
139,95,44,668,74200,50611
156,139,17,-,240900,50612
16330,10522,5808,880,192700,50613
4447,2977,1470,533,105800,50616
936,655,281,712,119000,50619
19,14,5,800,-,50620
662,509,153,661,128400,50621
1283,1076,207,642,209000,50622
638,542,96,649,197800,50624
455,353,102,614,70300,50625
678,559,119,647,160500,50626
1283,935,348,597,93300,50627
503,419,84,539,116300,50628
929,773,156,658,148000,50629
757,600,157,651,110600,50630
467,406,61,586,90700,50632
152,132,20,917,58000,50633
361,286,75,582,152400,50634
666,526,140,591,105300,50635
775,626,149,551,105600,50636
1437,1153,284,556,123200,50638
505,376,129,579,102300,50641
214,162,52,760,127800,50642
1071,930,141,927,199800,50643
3591,2787,804,740,147400,50644
436,368,68,433,130100,50645
865,780,85,575,223000,50647
1470,1238,232,660,169000,50648
352,274,78,659,75700,50650
1468,1199,269,657,140200,50651
42,35,7,725,57000,50652
272,211,61,581,87500,50653
195,163,32,433,165300,50654
322,270,52,525,106800,50655
1014,821,193,539,113600,50658
2396,1886,510,720,123000,50659
506,410,96,689,114300,50660
2919,2100,819,651,93400,50662
17,17,0,-,-,50664
1214,987,227,594,165400,50665
371,312,59,642,122200,50666
301,267,34,486,189600,50667
463,428,35,523,143500,50668
983,773,210,630,130900,50669
943,787,156,564,135600,50670
77,69,8,-,77000,50671
247,177,70,590,105500,50672
68,55,13,783,97500,50673
1548,1276,272,695,122300,50674
949,673,276,876,129100,50675
900,743,157,576,108400,50676
4654,3742,912,703,181900,50677
482,419,63,513,93400,50680
184,163,21,711,89300,50681
718,577,141,514,138900,50682
12863,8499,4364,760,151800,50701
8347,5116,3231,751,116200,50702
7776,4416,3360,779,77100,50703
3428,2534,894,787,110700,50707
4025,2698,1327,594,103600,50801
682,545,137,547,109200,50830
961,783,178,594,77300,50833
36,36,0,-,100000,50835
156,118,38,479,40000,50836
154,129,25,1010,100400,50837
24,24,0,-,-,50839
209,176,33,750,80000,50840
1107,891,216,493,85800,50841
37,36,1,-,75000,50842
207,139,68,725,74500,50843
290,226,64,748,68900,50845
443,321,122,544,75900,50846
39,35,4,-,36800,50847
143,126,17,610,-,50848
1177,822,355,522,102900,50849
836,604,232,472,102300,50851
299,219,80,606,85400,50853
1072,783,289,652,95600,50854
101,86,15,-,177300,50857
316,267,49,550,91300,50858
259,217,42,900,81400,50859
78,69,9,445,207800,50860
105,98,7,756,107100,50861
64,45,19,741,44600,50862
81,55,26,-,55000,50863
841,621,220,614,74700,50864
928,724,204,632,118600,51001
1077,814,263,744,120400,51002
681,584,97,768,151600,51003
423,357,66,752,88900,51004
636,522,114,529,135300,51005
436,353,83,468,66400,51006
207,202,5,-,159400,51007
67,55,12,825,104500,51008
87,57,30,446,63800,51009
178,132,46,644,75000,51010
29,23,6,650,-,51011
2867,2019,848,564,110700,51012
180,142,38,700,95700,51014
555,500,55,546,93600,51016
149,100,49,488,82900,51018
350,283,67,528,96000,51019
315,222,93,536,73500,51020
282,228,54,625,110900,51022
1211,936,275,583,90400,51023
783,670,113,725,204600,51024
841,664,177,585,110500,51025
333,307,26,483,131300,51026
464,395,69,829,113500,51027
924,673,251,613,155700,51028
144,123,21,343,81000,51029
725,603,122,652,189400,51030
5055,3695,1360,681,162800,51031
176,135,41,919,71700,51033
781,615,166,531,89000,51034
807,639,168,641,112500,51035
333,289,44,723,218300,51036
183,111,72,527,95000,51037
730,639,91,761,155400,51038
1089,828,261,758,158200,51039
1632,1040,592,611,98500,51040
2403,1907,496,690,172900,51041
113,97,16,575,107300,51044
739,590,149,662,109600,51046
280,232,48,675,85000,51047
256,178,78,706,81800,51048
259,223,36,475,55800,51049
1063,837,226,620,160400,51050
33,25,8,340,62500,51051
350,272,78,658,127100,51052
468,374,94,663,85300,51053
1973,1521,452,1071,231900,51054
627,501,126,810,148400,51055
170,145,25,763,69800,51056
395,316,79,563,66600,51058
247,189,58,533,66300,51060
206,173,33,512,87500,51061
162,118,44,536,74700,51062
449,346,103,738,85500,51063
421,32,389,433,215200,51101
5880,3711,2169,803,90200,51103
8499,5437,3062,847,143700,51104
3961,1675,2286,666,66800,51105
10376,7274,3102,813,140800,51106
1983,1769,214,818,129800,51108
1253,783,470,820,96500,51109
36,0,36,850,-,51111
2596,1700,896,561,136800,51201
115,113,2,-,90700,51230
146,112,34,-,85000,51231
330,257,73,717,81200,51232
513,475,38,785,149800,51234
502,451,51,653,173000,51235
707,593,114,821,91400,51237
501,446,55,592,125600,51238
1107,951,156,734,162900,51239
774,568,206,944,150800,51240
687,608,79,723,206900,51241
80,77,3,-,121900,51242
300,261,39,681,81800,51243
40,38,2,-,78000,51244
538,365,173,645,89100,51245
1408,1200,208,591,158800,51246
1764,1389,375,658,163700,51247
845,637,208,589,108100,51248
1386,1042,344,653,98800,51249
2860,2189,671,816,219500,51250
5508,3583,1925,691,131500,51301
571,469,102,828,225800,51331
222,149,73,845,127600,51333
2836,2194,642,722,92800,51334
451,348,103,621,96600,51338
22,12,10,475,40000,51341
542,411,131,554,75700,51342
135,93,42,-,155400,51343
162,131,31,446,101900,51345
1003,791,212,669,84200,51346
679,572,107,806,131100,51347
225,171,54,725,66900,51350
1964,1557,407,756,202900,51351
495,428,67,619,94500,51354
435,344,91,974,343200,51355
245,208,37,675,95000,51357
550,404,146,509,87900,51358
4122,3214,908,862,209200,51360
80,74,6,-,80000,51363
351,268,83,817,76800,51364
156,142,14,650,93800,51365
149,116,33,831,72500,51366
5323,3836,1487,629,156800,51401
311,284,27,533,134000,51430
190,162,28,575,80000,51431
197,148,49,514,71800,51433
337,268,69,602,130600,51436
439,329,110,629,69200,51439
129,122,7,-,107900,51440
170,143,27,-,68300,51441
3318,2021,1297,659,105600,51442
670,538,132,613,130600,51443
100,87,13,663,88000,51444
1215,877,338,439,117400,51445
230,173,57,669,84500,51446
122,106,16,629,118000,51447
240,193,47,550,85800,51448
880,712,168,595,84500,51449
723,630,93,530,151500,51450
58,54,4,-,57500,51451
301,271,30,442,66600,51453
593,482,111,492,89600,51454
991,766,225,576,105200,51455
588,523,65,650,86000,51458
29,26,3,-,52900,51459
490,380,110,455,87800,51461
487,400,87,630,88700,51462
222,176,46,806,127600,51463
343,284,59,675,82200,51465
413,352,61,500,100000,51466
256,223,33,-,117900,51467
13914,8401,5513,842,101300,51501
14634,10176,4458,862,183200,51503
1413,1063,350,917,113900,51510
91,64,27,566,51400,51520
777,596,181,737,130200,51521
165,151,14,630,82800,51523
477,385,92,656,157600,51525
625,572,53,1327,230600,51526
198,175,23,625,109300,51527
335,234,101,591,77500,51528
773,547,226,553,96100,51529
298,217,81,475,105500,51530
309,266,43,534,127600,51531
311,234,77,638,74700,51532
425,272,153,689,119100,51533
3399,2567,832,825,203200,51534
783,620,163,763,98600,51535
163,147,16,-,84600,51536
2936,2219,717,648,124700,51537
141,125,16,975,109900,51540
188,151,37,775,107800,51541
413,356,57,1112,270800,51542
225,158,67,550,82200,51543
289,240,49,663,96200,51544
133,110,23,613,53100,51545
1123,893,230,740,141800,51546
194,177,17,1073,198400,51548
235,201,34,814,163200,51549
70,62,8,550,69100,51550
684,563,121,921,156100,51551
129,98,31,669,172200,51552
435,336,99,664,146600,51553
88,75,13,-,110800,51554
2127,1488,639,729,134200,51555
195,172,23,925,110700,51556
425,387,38,600,135800,51557
203,168,35,620,56700,51558
658,510,148,883,166100,51559
782,561,221,639,124600,51560
433,374,59,983,178400,51561
176,150,26,820,211500,51562
274,226,48,836,122200,51563
187,155,32,581,74400,51564
161,125,36,718,116500,51565
2944,1989,955,642,87500,51566
444,309,135,744,118800,51570
201,178,23,2077,143200,51571
230,179,51,467,75000,51572
454,370,84,831,89800,51573
583,478,105,882,186000,51575
742,635,107,750,213100,51576
549,407,142,788,106800,51577
27,27,0,-,59000,51578
932,697,235,735,130000,51579
2427,1606,821,666,91400,51601
85,85,0,-,77500,51630
144,101,43,706,99200,51631
2641,1918,723,666,102400,51632
205,172,33,650,101100,51636
98,84,14,495,55000,51637
565,432,133,593,81700,51638
368,246,122,591,87900,51639
700,533,167,652,86500,51640
120,92,28,-,-,51645
374,316,58,588,78900,51646
81,70,11,-,60800,51647
105,94,11,-,156300,51648
132,119,13,625,142700,51649
131,113,18,660,59600,51650
672,519,153,583,109100,51652
589,431,158,700,127600,51653
137,101,36,930,151000,51654
15,13,2,-,75000,51656
17192,10907,6285,760,131600,52001
6695,4903,1792,873,217700,52002
5254,4483,771,834,190900,52003
170,101,69,735,89300,52030
2159,1857,302,667,166000,52031
607,562,45,618,185700,52032
1281,946,335,773,160800,52033
395,343,52,529,123600,52035
447,404,43,500,110500,52037
203,163,40,800,164600,52038
339,332,7,675,219200,52039
2442,2127,315,750,166400,52040
655,600,55,647,146500,52041
599,473,126,483,154500,52042
1019,657,362,716,105400,52043
50,36,14,-,175000,52044
948,796,152,704,180000,52045
884,741,143,827,185700,52046
271,232,39,569,109900,52047
160,115,45,654,118800,52048
563,397,166,629,109000,52049
184,156,28,650,103600,52050
1399,1030,369,588,153600,52052
364,313,51,467,158800,52053
347,272,75,927,174600,52054
3255,2685,570,588,125000,52057
3692,2750,942,611,106300,52060
346,277,69,489,135800,52064
447,368,79,950,152400,52065
32,25,7,-,81700,52066
1676,1466,210,479,266900,52068
549,438,111,595,131600,52069
461,367,94,608,148700,52070
113,97,16,538,128700,52072
523,480,43,861,251400,52073
131,126,5,-,142900,52074
950,709,241,633,112900,52076
158,119,39,658,95000,52077
294,240,54,575,128900,52078
351,280,71,586,153200,52079
5123,3935,1188,679,196300,52101
857,612,245,693,155100,52132
288,272,16,646,101100,52133
125,94,31,581,110000,52134
310,271,39,515,114000,52135
2489,1939,550,656,119400,52136
273,242,31,-,125000,52140
504,434,70,542,93800,52141
619,415,204,567,100800,52142
504,475,29,575,145400,52144
426,383,43,758,151800,52146
435,378,57,653,106300,52147
856,709,147,674,140900,52151
391,334,57,441,130600,52154
550,458,92,553,106300,52155
208,188,20,825,112500,52156
795,608,187,534,147400,52157
143,115,28,605,89500,52158
1036,810,226,830,112200,52159
385,298,87,392,115800,52160
614,521,93,621,149600,52161
1304,913,391,679,107700,52162
158,137,21,575,80500,52163
127,114,13,575,114700,52164
324,282,42,750,173000,52165
54,51,3,-,72500,52166
136,105,31,784,129200,52168
143,117,26,444,89400,52169
219,196,23,475,126300,52170
398,326,72,608,164800,52171
2665,2077,588,585,131700,52172
1472,1054,418,588,109900,52175
549,445,104,633,142900,52201
370,301,69,603,176800,52202
866,798,68,499,189800,52203
3491,2730,761,717,143200,52205
918,864,54,585,233400,52206
167,153,14,588,100800,52207
1339,1060,279,538,91100,52208
446,400,46,563,133300,52209
260,192,68,798,151700,52210
1178,869,309,708,144400,52211
128,88,40,830,56300,52212
1508,1285,223,739,196400,52213
1349,1133,216,572,194900,52214
312,283,29,558,111300,52215
561,413,148,575,112100,52216
238,182,56,781,86800,52217
720,611,109,675,143400,52218
78,60,18,642,88000,52219
147,147,0,-,177700,52220
109,104,5,788,-,52221
255,226,29,-,86600,52222
446,386,60,820,168900,52223
824,698,126,758,154600,52224
124,120,4,-,82000,52225
1052,889,163,737,228800,52227
1182,1126,56,1375,211600,52228
315,242,73,815,-,52229
99,78,21,631,98000,52231
75,58,17,694,90000,52232
3034,1886,1148,773,140200,52233
338,220,118,990,156000,52235
285,285,0,-,171800,52236
595,486,109,664,139000,52237
15278,7728,7550,1012,193200,52240
8408,4246,4162,896,226500,52241
0,0,0,-,-,52242
9404,6108,3296,1025,230100,52245
10319,4235,6084,905,249900,52246
1890,1428,462,753,183400,52247
717,585,132,722,114400,52248
390,330,60,820,121900,52249
235,210,25,375,104800,52251
1282,1049,233,718,182800,52253
382,291,91,400,80200,52254
611,480,131,766,141700,52255
92,79,13,-,137500,52257
1518,1196,322,594,115000,52301
16705,12988,3717,728,171400,52302
230,195,35,675,192400,52305
609,506,103,747,122300,52306
79,26,53,-,-,52307
65,56,9,-,74000,52308
199,186,13,575,87100,52309
2560,1987,573,621,148800,52310
25,21,4,-,52500,52312
125,89,36,533,86300,52313
1844,1417,427,764,216700,52314
502,389,113,538,144700,52315
682,547,135,653,110900,52316
7796,5494,2302,1118,230600,52317
373,323,50,775,145200,52318
456,336,120,720,93800,52320
154,116,38,560,77800,52321
969,913,56,950,159900,52322
346,278,68,602,86400,52323
682,613,69,1044,229500,52324
375,336,39,587,181000,52325
220,167,53,645,94000,52326
1262,1014,248,891,219100,52327
1080,1040,40,1602,282200,52328
352,306,46,620,157800,52329
336,265,71,491,123000,52330
801,685,116,783,187000,52332
2493,2233,260,772,310500,52333
79,79,0,-,237500,52334
318,252,66,629,66600,52335
933,816,117,700,153900,52336
288,217,71,754,103000,52337
1260,1160,100,961,291500,52338
1445,884,561,688,88200,52339
1278,944,334,1050,233500,52340
453,385,68,761,354700,52341
1407,1051,356,750,103000,52342
546,481,65,637,151600,52345
498,393,105,630,163000,52346
557,420,137,664,107500,52347
35,35,0,-,65500,52348
3085,2494,591,648,158300,52349
507,479,28,639,216200,52351
580,537,43,556,159400,52352
3782,2412,1370,773,135300,52353
185,153,32,-,178700,52354
128,112,16,813,90000,52355
988,753,235,775,155600,52356
1533,1348,185,808,174700,52358
94,60,34,-,83300,52359
1871,1319,552,600,162900,52361
421,341,80,582,86500,52362
960,271,689,645,120100,52401
17329,11840,5489,812,148200,52402
9744,7518,2226,747,143000,52403
16925,11130,5795,732,133600,52404
10645,7768,2877,811,141200,52405
2852,2822,30,-,303300,52411
12135,8489,3646,723,79800,52501
471,383,88,623,124700,52530
2450,1857,593,546,99000,52531
484,393,91,675,82000,52533
150,121,29,813,65000,52534
405,324,81,584,92000,52535
450,377,73,517,162500,52536
2618,2206,412,633,116000,52537
604,399,205,669,89500,52540
141,118,23,-,100000,52542
130,85,45,-,126300,52543
3310,2157,1153,622,75700,52544
40,36,4,-,58600,52548
269,248,21,1047,88500,52549
244,201,43,-,67100,52550
205,183,22,-,109400,52551
355,311,44,710,151900,52552
711,551,160,916,125700,52553
592,517,75,571,64500,52554
152,130,22,825,73300,52555
5111,3268,1843,684,124900,52556
0,0,0,-,-,52557
103,91,12,725,88800,52560
400,270,130,591,94600,52561
607,410,197,689,87500,52563
772,554,218,594,121100,52565
77,62,15,906,52300,52566
322,258,64,829,109500,52567
277,258,19,1013,89800,52569
329,296,33,738,75800,52570
603,492,111,710,112500,52571
427,325,102,569,74100,52572
56,56,0,-,112500,52573
336,265,71,585,72500,52574
258,212,46,803,110500,52576
6107,3965,2142,662,113400,52577
254,210,44,400,89100,52580
144,97,47,632,89300,52581
161,134,27,-,112500,52583
183,158,25,770,82900,52584
404,299,105,781,92900,52585
219,178,41,-,114000,52586
9,9,0,-,-,52588
473,389,84,550,69800,52590
1274,982,292,690,102600,52591
79,59,20,556,116100,52593
112,100,12,-,102800,52594
132,90,42,704,83300,52595
12578,8650,3928,794,99900,52601
252,157,95,708,231700,52619
343,300,43,586,113500,52620
289,204,85,772,106800,52621
724,623,101,717,149800,52623
129,105,24,-,88100,52624
1105,853,252,666,131000,52625
520,452,68,593,69500,52626
5085,3846,1239,707,90400,52627
173,134,39,788,52000,52630
5291,3562,1729,649,76500,52632
328,215,113,697,107800,52635
957,705,252,615,118500,52637
212,164,48,763,150000,52638
761,643,118,660,105800,52639
539,447,92,629,115400,52640
4671,3192,1479,730,129900,52641
171,148,23,819,138300,52644
1412,1045,367,667,98000,52645
151,133,18,775,103100,52646
86,61,25,629,103000,52647
363,306,57,618,150900,52649
301,229,72,683,202100,52650
262,198,64,386,76000,52651
1367,1049,318,698,125300,52653
629,462,167,548,105700,52654
1788,1220,568,782,117400,52655
1069,921,148,443,173800,52656
28,23,5,-,131300,52657
398,381,17,-,146600,52658
571,436,135,636,99000,52659
59,59,0,-,62200,52660
47,42,5,-,88300,52701
326,292,34,813,125000,52720
313,250,63,583,122200,52721
14586,11016,3570,922,227600,52722
1824,1717,107,842,229500,52726
159,106,53,-,177200,52727
418,324,94,400,114100,52728
367,321,46,632,130900,52729
2342,1904,438,610,125300,52730
323,275,48,644,142400,52731
11177,7592,3585,693,102700,52732
136,126,10,725,85000,52737
1401,984,417,611,99200,52738
242,117,125,779,90500,52739
3034,2359,675,787,161400,52742
239,196,43,905,169300,52745
409,359,50,881,176400,52746
796,600,196,890,165800,52747
3550,2674,876,765,214100,52748
344,315,29,683,170400,52749
198,186,12,1071,161100,52750
378,277,101,728,134100,52751
195,166,29,692,101300,52752
2074,1750,324,855,248100,52753
587,526,61,688,164700,52754
777,606,171,666,172500,52755
737,699,38,880,273200,52756
83,77,6,775,96500,52757
99,81,18,1200,133800,52758
226,209,17,-,137200,52760
12059,8604,3455,853,126000,52761
147,122,25,758,152300,52765
348,334,14,850,108900,52766
42,26,16,-,-,52767
611,526,85,750,191900,52768
242,203,39,719,169800,52769
2092,1624,468,631,147000,52772
1094,835,259,659,156100,52773
47,36,11,-,86000,52774
1583,1149,434,889,142800,52776
454,363,91,736,106000,52777
1726,1330,396,677,140000,52778
745,6,739,736,-,52801
3841,2649,1192,778,70900,52802
8716,5344,3372,753,126800,52803
10574,7136,3438,789,119000,52804
10888,7288,3600,786,145800,52806
6530,3636,2894,756,271200,52807
823,699,124,713,196200,53001
991,797,194,922,225700,53002
63,58,5,-,153100,53003
1276,1110,166,867,214900,53004
7622,6626,996,1570,293200,53005
703,543,160,854,192900,53006
913,405,508,786,161200,53007
2975,2456,519,825,205300,53010
894,768,126,752,203000,53011
7410,5908,1502,865,316600,53012
1331,1058,273,769,188300,53013
3336,2484,852,694,164200,53014
1044,931,113,725,162700,53015
147,120,27,850,103400,53016
2056,2016,40,1034,328700,53017
3128,2473,655,1355,381300,53018
761,661,100,658,175200,53019
1606,1307,299,839,240500,53020
1867,1484,383,864,236200,53021
7807,6027,1780,1060,263300,53022
540,486,54,838,188900,53023
7293,5235,2058,963,263600,53024
9241,6898,2343,833,221600,53027
7988,6399,1589,1028,368200,53029
0,0,0,-,-,53031
1922,1341,581,874,150600,53032
2034,1954,80,1158,273600,53033
711,507,204,825,169800,53034
938,774,164,932,186600,53035
1090,850,240,1033,253300,53036
3962,2985,977,1017,235500,53037
1593,1240,353,992,214700,53038
1688,1265,423,754,166400,53039
3198,2574,624,916,224100,53040
2847,2239,608,721,160500,53042
964,882,82,850,240400,53044
8499,6948,1551,1506,343700,53045
504,416,88,804,177600,53046
53,53,0,-,219400,53047
1439,799,640,854,167800,53048
1082,940,142,693,226500,53049
2805,1971,834,693,145000,53050
15354,11505,3849,1048,247400,53051
613,533,80,620,174800,53057
1476,996,480,1218,370700,53058
742,617,125,664,245600,53059
2113,1689,424,729,136600,53061
661,595,66,440,179300,53063
869,734,135,814,185300,53065
13879,10919,2960,1001,301300,53066
311,295,16,-,335200,53069
1875,1556,319,764,184000,53070
10710,7942,2768,1147,313700,53072
6181,4304,1877,713,181900,53073
5539,3691,1848,894,199900,53074
1352,1035,317,767,195000,53075
1490,1337,153,1243,365200,53076
712,607,105,871,286000,53078
613,533,80,656,168300,53079
2360,1578,782,739,207800,53080
17949,10794,7155,696,116700,53081
8335,6138,2197,808,168200,53083
5109,3622,1487,766,167700,53085
3263,2540,723,1037,270600,53086
200,128,72,758,131500,53088
7432,6051,1381,1004,292100,53089
8632,6563,2069,918,194400,53090
861,684,177,688,155600,53091
8495,6751,1744,1310,382100,53092
787,722,65,814,181500,53093
7532,4665,2867,840,164400,53094
11687,8448,3239,844,212600,53095
2003,1886,117,1166,377300,53097
4645,3272,1373,909,175100,53098
1472,1370,102,1113,261500,53103
2165,1857,308,997,261000,53104
11581,8712,2869,889,223900,53105
1346,1278,68,926,220700,53108
7682,4568,3114,815,152900,53110
969,763,206,1038,165800,53114
6405,4243,2162,874,165000,53115
2860,2394,466,1261,309600,53118
2128,1892,236,1117,288200,53119
3952,3285,667,988,236200,53120
7538,5282,2256,856,204600,53121
2287,2128,159,950,370500,53122
806,711,95,897,400700,53125
2695,2283,412,892,273900,53126
3073,2445,628,1097,172500,53128
5843,4110,1733,955,216800,53129
3141,1822,1319,1114,224300,53130
13653,10606,3047,1091,253500,53132
667,589,78,946,245900,53137
1005,856,149,1000,196600,53139
11905,5316,6589,854,133500,53140
12363,9307,3056,1037,183300,53142
8846,4981,3865,911,134600,53143
9879,5328,4551,914,189400,53144
3109,2956,153,1119,262100,53146
7287,4956,2331,985,231800,53147
7534,6290,1244,918,293900,53149
9651,8179,1472,1056,291100,53150
13511,9875,3636,1224,259300,53151
886,801,85,850,275000,53153
14714,8942,5772,1063,231200,53154
1247,941,306,743,189400,53156
6334,5347,987,1082,230600,53158
372,145,227,877,162900,53167
3420,2853,567,1063,181700,53168
873,642,231,758,203000,53170
8607,5075,3532,838,162000,53172
2545,1987,558,886,166300,53177
1151,896,255,874,220400,53178
2520,2066,454,1198,174700,53179
2844,2098,746,904,220600,53181
3349,2452,897,892,217900,53182
1081,855,226,1014,299900,53183
1576,1019,557,861,200800,53184
7326,6397,929,1023,261600,53185
13933,7582,6351,936,203500,53186
14413,9363,5050,956,237900,53188
9891,7888,2003,1051,286300,53189
6497,3004,3493,789,194800,53190
1251,985,266,1199,257500,53191
0,0,0,-,-,53192
77,64,13,1047,172700,53195
15696,3302,12394,985,251000,53202
985,135,850,1479,270800,53203
13073,3347,9726,783,75600,53204
3311,985,2326,593,77400,53205
7979,2664,5315,829,45900,53206
16588,9480,7108,923,162600,53207
12071,4417,7654,771,141900,53208
18610,8459,10151,874,94400,53209
9768,3703,6065,867,100000,53210
14509,5991,8518,1006,331000,53211
13195,3951,9244,854,137200,53212
11420,6922,4498,997,242000,53213
15642,7996,7646,863,135400,53214
19108,8744,10364,794,106100,53215
13171,6033,7138,859,88200,53216
11437,8605,2832,1267,349700,53217
13875,5934,7941,897,81300,53218
15003,9522,5481,776,142700,53219
11251,6743,4508,866,154400,53220
15951,9605,6346,879,151500,53221
11226,7221,4005,874,142800,53222
12341,6401,5940,897,130700,53223
7877,3812,4065,996,147400,53224
9897,3932,5965,886,128300,53225
8248,5003,3245,1131,237200,53226
10869,5017,5852,880,158500,53227
6249,3537,2712,1148,204600,53228
4531,189,4342,693,81200,53233
4703,2330,2373,752,152300,53235
0,0,0,-,-,53295
13643,9712,3931,867,159900,53402
10530,5226,5304,830,118700,53403
5593,2301,3292,794,99400,53404
10217,6674,3543,914,122800,53405
10904,7635,3269,848,185500,53406
46,46,0,-,-,53501
1008,753,255,720,191400,53502
830,626,204,821,177000,53503
844,656,188,628,155900,53504
148,123,25,1554,175800,53505
443,303,140,699,96800,53506
794,683,111,946,247300,53507
2193,1841,352,966,226400,53508
610,463,147,747,165000,53510
19060,12121,6939,823,107300,53511
997,767,230,759,237700,53515
912,774,138,775,187800,53516
734,612,122,1083,285300,53517
604,497,107,579,144600,53518
2653,2038,615,750,149800,53520
1454,1277,177,1089,255400,53521
412,341,71,600,150300,53522
2142,1772,370,970,250000,53523
1473,1100,373,820,152500,53525
274,201,73,692,125300,53526
3852,3261,591,1236,282300,53527
2501,1850,651,1010,314000,53528
833,661,172,947,282100,53529
1814,1288,526,772,128300,53530
1755,1378,377,842,251700,53531
5968,4745,1223,1003,248000,53532
3028,2046,982,799,191000,53533
4961,3625,1336,826,182300,53534
3509,2561,948,752,209000,53536
328,242,86,800,102000,53537
7381,5086,2295,854,177500,53538
100,59,41,619,82500,53540
361,291,70,538,157000,53541
687,529,158,545,145300,53543
319,263,56,721,255000,53544
10047,6324,3723,853,141100,53545
12272,8902,3370,905,152500,53546
7657,5192,2465,798,142600,53548
4172,2783,1389,816,176300,53549
440,375,65,867,160000,53550
3465,2440,1025,979,218100,53551
224,185,39,-,113700,53553
399,317,82,761,133400,53554
3765,2919,846,881,275100,53555
1181,923,258,701,138300,53556
158,118,40,705,121400,53557
4798,3878,920,1094,263300,53558
2199,1596,603,912,218100,53559
1524,1181,343,818,236300,53560
796,691,105,1083,292600,53561
11336,6841,4495,1100,375800,53562
4258,3297,961,842,193000,53563
2019,1477,542,765,192500,53565
6522,4368,2154,750,147300,53566
470,380,90,753,152100,53569
1091,840,251,688,183400,53570
36,36,0,-,184600,53571
3921,2941,980,949,293700,53572
1337,1032,305,659,114300,53573
1496,1297,199,797,214200,53574
6091,4761,1330,882,276400,53575
878,673,205,1021,164400,53576
582,433,149,756,179000,53577
2686,1849,837,1010,259900,53578
730,542,188,818,173500,53579
225,176,49,775,112500,53580
4375,3104,1271,600,133000,53581
478,403,75,772,164600,53582
2535,1891,644,724,230600,53583
852,539,313,801,160500,53585
910,680,230,659,116500,53586
510,413,97,652,132600,53587
1719,1352,367,808,213800,53588
8117,6293,1824,952,230800,53589
15914,10302,5612,1087,257300,53590
9332,6934,2398,1206,359000,53593
2194,1720,474,779,179700,53594
7464,5765,1699,1033,340000,53597
1027,738,289,1295,284100,53598
29,14,15,-,128100,53599
65,65,0,-,-,53702
16629,2394,14235,1169,335800,53703
20861,11584,9277,1023,203500,53704
12129,5777,6352,1113,331900,53705
59,0,59,1219,-,53706
21205,13098,8107,1096,292500,53711
9799,2657,7142,935,181800,53713
7107,4196,2911,993,186700,53714
4880,905,3975,1331,288400,53715
8117,5796,2321,1009,229300,53716
6037,2943,3094,1124,327200,53717
6698,4089,2609,1281,233400,53718
13615,6743,6872,1178,258700,53719
2384,785,1599,1190,465400,53726
0,0,0,-,-,53792
378,321,57,611,110400,53801
25,17,8,-,85000,53802
520,411,109,656,114500,53803
526,417,109,560,116000,53804
1985,1483,502,572,120700,53805
775,605,170,498,102000,53806
1986,1589,397,689,169500,53807
492,343,149,697,144500,53808
1541,1163,378,648,126300,53809
143,123,20,475,122500,53810
1278,963,315,736,186100,53811
2291,1573,718,626,148200,53813
260,231,29,563,163400,53816
77,63,14,763,95800,53817
5552,3124,2428,834,169000,53818
954,787,167,563,155400,53820
3335,2334,1001,664,129100,53821
176,133,43,635,165200,53825
521,397,124,592,115900,53826
101,85,16,744,114400,53827
6155,4026,2129,779,153400,53901
1616,1025,591,536,90200,53910
493,400,93,1106,215200,53911
8979,5550,3429,812,167100,53913
9597,6159,3438,812,148000,53916
1032,857,175,666,156600,53919
210,185,25,785,171000,53920
391,334,57,775,177000,53922
750,626,124,719,161200,53923
578,467,111,681,155100,53924
3276,2345,931,825,200200,53925
557,443,114,700,156900,53926
43,34,9,-,98800,53928
1129,828,301,643,132700,53929
516,419,97,768,152400,53930
91,64,27,763,105800,53931
1003,766,237,1093,202200,53932
1270,850,420,749,182000,53933
2015,1675,340,586,108100,53934
96,78,18,850,115900,53935
602,544,58,875,87500,53936
383,327,56,625,170900,53937
113,89,24,740,102100,53939
1214,1056,158,764,180400,53941
358,272,86,704,169600,53943
894,762,132,761,155000,53944
1649,1327,322,734,157100,53946
83,69,14,583,122500,53947
3306,2425,881,802,127300,53948
2692,2227,465,663,155900,53949
2021,1543,478,771,125600,53950
913,677,236,657,159000,53951
1436,1223,213,765,146100,53952
120,91,29,738,137500,53953
2857,2400,457,797,188500,53954
2517,1998,519,608,222700,53955
1266,988,278,693,149800,53956
5220,3608,1612,773,160500,53959
1440,1167,273,829,182300,53960
328,289,39,883,173300,53961
5298,3658,1640,704,132100,53963
1474,1120,354,768,153900,53964
4664,3330,1334,793,164600,53965
1017,788,229,711,129200,53968
150,110,40,625,160700,53969
3275,2682,593,742,165000,54001
2647,1951,696,947,184400,54002
368,329,39,1135,245800,54003
930,744,186,767,147600,54004
1252,1018,234,640,159000,54005
284,246,38,875,149100,54006
433,364,69,592,176900,54007
1041,825,216,947,170800,54009
0,0,0,-,-,54010
2699,2112,587,761,188000,54011
1328,1030,298,901,183100,54013
887,758,129,889,190800,54014
1354,1077,277,915,193900,54015
12471,9498,2973,1169,294500,54016
6882,5079,1803,856,216600,54017
2908,2206,702,836,191200,54020
2538,2062,476,968,230800,54021
8364,5341,3023,886,247800,54022
1523,1241,282,978,234600,54023
2074,1581,493,792,185100,54024
2598,2045,553,900,241400,54025
819,685,134,804,227300,54026
392,365,27,1014,211700,54027
944,722,222,816,181500,54028
601,563,38,-,321000,54082
1097,1012,85,835,184600,54101
442,373,69,553,126600,54102
202,184,18,838,113600,54103
544,491,53,768,121900,54104
2007,1715,292,696,169000,54106
1381,1126,255,585,156300,54107
2068,1647,421,695,141800,54110
972,812,160,772,154500,54111
1033,752,281,683,134000,54112
1366,1162,204,851,186500,54113
2456,2008,448,673,144400,54114
17595,11700,5895,887,215400,54115
235,208,27,820,110000,54119
117,98,19,493,135700,54120
1342,1130,212,-,140300,54121
123,98,25,542,135600,54123
1517,1197,320,685,112300,54124
265,196,69,493,84300,54125
1394,1164,230,839,199700,54126
31,8,23,-,112500,54127
681,556,125,663,126300,54128
1270,1118,152,643,170100,54129
10279,7519,2760,828,166700,54130
1047,749,298,539,108300,54135
2643,1741,902,731,144500,54136
487,457,30,805,160300,54137
478,403,75,754,158600,54138
1264,1061,203,761,144500,54139
4103,2745,1358,778,147400,54140
894,834,60,806,188800,54141
6922,4800,2122,700,110100,54143
585,540,45,638,156400,54149
315,146,169,525,58000,54150
1472,1276,196,683,100800,54151
3097,2274,823,691,117100,54153
2329,1631,698,605,147400,54154
3070,2107,963,723,248500,54155
756,634,122,662,107800,54156
2452,1577,875,690,133600,54157
563,506,57,710,153400,54159
118,89,29,750,136200,54160
1216,1013,203,616,146200,54161
3471,2708,763,676,194900,54162
3056,2154,902,670,182700,54165
7257,5061,2196,632,124800,54166
1044,1019,25,842,239200,54169
1388,1245,143,682,185800,54170
1369,1292,77,780,228800,54171
1731,1417,314,1129,243000,54173
1350,1098,252,664,123800,54174
488,456,32,571,186300,54175
1349,1097,252,560,134700,54177
1313,1051,262,971,183200,54180
2188,1662,526,661,134100,54201
657,546,111,992,316400,54202
709,601,108,686,194700,54204
782,708,74,658,163400,54205
60,58,2,-,139300,54207
2431,2050,381,707,198300,54208
631,542,89,935,313800,54209
389,345,44,670,272500,54210
138,125,13,775,383900,54211
488,444,44,868,344600,54212
550,475,75,713,154600,54213
124,85,39,637,132200,54214
2733,2078,655,679,152000,54216
2860,2340,520,771,201600,54217
17292,12158,5134,667,118600,54220
656,570,86,575,183600,54227
1161,995,166,698,149300,54228
1958,1668,290,986,198200,54229
1833,1603,230,524,163900,54230
348,256,92,606,115200,54232
864,679,185,891,324200,54234
8110,6210,1900,784,175200,54235
6477,4742,1735,676,103400,54241
888,751,137,717,160500,54245
407,355,52,688,278100,54246
890,804,86,702,160700,54247
9199,6222,2977,761,150900,54301
12659,6175,6484,718,112400,54302
11913,5243,6670,687,117200,54303
12304,7436,4868,746,133000,54304
0,0,0,-,-,54307
14130,9361,4769,848,202100,54311
14945,12501,2444,871,223000,54313
13127,8675,4452,743,142600,54401
10410,6768,3642,715,150700,54403
1147,818,329,728,112100,54405
1413,1140,273,730,200500,54406
597,538,59,835,211900,54407
438,351,87,602,145400,54408
5687,4116,1571,656,95700,54409
857,787,70,575,163100,54410
1952,1717,235,638,142400,54411
841,703,138,620,162600,54412
68,57,11,830,104800,54413
1317,1080,237,576,133600,54414
675,518,157,625,105800,54416
20,20,0,-,90000,54417
389,348,41,675,123900,54418
474,375,99,520,166500,54420
1306,1002,304,650,130400,54421
395,297,98,647,98800,54422
901,844,57,711,227000,54423
694,652,42,625,170800,54424
786,596,190,662,112300,54425
1642,1391,251,714,154800,54426
486,369,117,691,147000,54427
513,406,107,547,166200,54428
57,48,9,-,115900,54430
741,609,132,636,135800,54433
859,744,115,733,148700,54435
783,665,118,663,126400,54436
1116,908,208,486,126100,54437
1228,1111,117,650,163700,54440
346,325,21,517,180900,54441
436,399,37,763,169900,54442
826,716,110,667,186000,54443
1105,855,250,648,131500,54446
215,169,46,645,89800,54447
1726,1472,254,659,190900,54448
11624,7790,3834,692,159200,54449
161,113,48,638,66900,54450
4979,3694,1285,693,146100,54451
8300,6305,1995,646,125000,54452
539,457,82,615,141600,54454
7273,5929,1344,772,167800,54455
2551,1968,583,583,124900,54456
3647,3220,427,785,128500,54457
35,26,9,706,112500,54458
546,490,56,755,110300,54459
971,784,187,667,111000,54460
193,165,28,650,116900,54462
291,257,34,582,192800,54463
292,280,12,535,178600,54465
1191,1013,178,628,144500,54466
5793,3556,2237,851,174600,54467
730,589,141,665,105300,54469
846,657,189,550,132000,54470
678,653,25,845,197900,54471
1057,905,152,688,176500,54473
1769,1179,590,733,133700,54474
680,615,65,535,156500,54475
7644,4502,3142,825,158000,54476
1501,1254,247,653,140700,54479
572,420,152,649,117500,54480
11542,6639,4903,715,144100,54481
4240,3414,826,881,191100,54482
1986,1660,326,606,166400,54484
165,163,2,-,154900,54485
892,738,154,605,118300,54486
4426,3713,713,719,169600,54487
467,374,93,581,136900,54488
722,606,116,580,137200,54489
347,296,51,594,118800,54490
778,632,146,555,113400,54491
258,230,28,563,156000,54493
11767,8846,2921,785,128700,54494
3356,1994,1362,721,94700,54495
861,669,192,706,122000,54498
1228,914,314,603,141400,54499
8443,6750,1693,766,147300,54501
536,488,48,670,123400,54511
454,385,69,622,228700,54512
195,167,28,725,118400,54513
853,729,124,641,154200,54514
229,208,21,670,96000,54515
59,57,2,-,217500,54517
615,568,47,938,217900,54519
1857,1249,608,480,129800,54520
3817,3013,804,766,183800,54521
280,217,63,829,162200,54524
127,81,46,575,71300,54525
346,284,62,583,97600,54526
442,366,76,538,87000,54527
529,502,27,625,208100,54529
379,340,39,-,85200,54530
580,559,21,850,233800,54531
1199,847,352,530,81800,54534
84,68,16,475,50000,54536
199,191,8,825,108500,54537
1522,1022,500,583,193600,54538
604,563,41,768,194100,54539
482,396,86,708,184400,54540
489,361,128,647,121900,54541
229,210,19,460,108000,54542
431,334,97,919,434600,54545
526,396,130,539,80300,54546
681,545,136,588,226100,54547
2164,1822,342,822,250000,54548
306,253,53,508,78200,54550
2156,1588,568,555,111700,54552
508,407,101,685,205800,54554
2396,1788,608,760,139100,54555
587,469,118,608,89300,54556
458,438,20,927,319500,54557
1041,834,207,805,179000,54558
341,248,93,382,123800,54559
284,231,53,775,149700,54560
0,0,0,-,-,54561
925,813,112,921,265800,54562
317,275,42,792,146500,54563
187,177,10,-,126000,54564
22,17,5,-,67500,54565
640,490,150,439,134800,54566
2416,1691,725,684,167000,54568
20243,11020,9223,839,159300,54601
6449,3334,3115,732,135700,54603
746,571,175,760,157800,54610
454,330,124,743,111200,54611
1920,1306,614,796,159700,54612
864,715,149,659,121900,54613
1087,869,218,740,169000,54614
4137,2850,1287,658,128200,54615
1004,752,252,719,120900,54616
859,715,144,854,139900,54618
1234,1048,186,678,169800,54619
521,425,96,950,182300,54621
887,773,114,717,153000,54622
828,706,122,784,164200,54623
639,555,84,706,168000,54624
119,80,39,583,138500,54625
518,437,81,617,154900,54626
744,592,152,658,161400,54627
444,405,39,545,156600,54628
1124,893,231,918,178400,54629
1744,1318,426,764,168700,54630
710,608,102,658,132300,54631
469,423,46,588,174300,54632
1633,1271,362,618,141600,54634
760,593,167,830,141000,54635
5171,4107,1064,915,215800,54636
98,66,32,-,95700,54637
590,480,110,588,138900,54638
1029,801,228,629,147800,54639
2,2,0,-,-,54641
831,675,156,792,150200,54642
3,3,0,-,-,54643
584,495,89,675,225500,54644
44,26,18,567,70000,54645
1680,1360,320,831,117500,54646
600,463,137,690,148500,54648
10149,7147,3002,889,195100,54650
536,439,97,543,125400,54651
388,311,77,677,129000,54652
332,247,85,793,154000,54653
47,47,0,-,90800,54654
701,509,192,593,154600,54655
7069,5067,2002,838,153500,54656
147,107,40,625,126800,54657
1125,907,218,822,189200,54658
537,420,117,646,150600,54659
6552,3946,2606,821,151200,54660
1597,1296,301,727,176500,54661
635,500,135,729,122400,54664
3604,2526,1078,640,157500,54665
1141,888,253,810,162600,54666
1810,1446,364,838,152800,54667
3077,2321,756,872,197600,54669
530,438,92,733,170400,54670
16169,9423,6746,804,188700,54701
17485,11353,6132,871,154400,54703
3277,2199,1078,789,162900,54720
563,457,106,688,145300,54721
1390,1104,286,681,166700,54722
500,391,109,725,160900,54723
3061,2341,720,567,162000,54724
1188,983,205,759,142800,54725
696,552,144,808,133600,54726
2051,1658,393,713,156300,54727
2583,2182,401,713,163800,54728
13557,9146,4411,864,177800,54729
1972,1698,274,680,174000,54730
299,262,37,575,122300,54731
1209,956,253,599,116400,54732
456,377,79,752,151400,54733
328,290,38,950,160100,54734
1700,1296,404,592,144200,54736
216,195,21,933,164000,54737
1235,1022,213,712,214600,54738
1890,1417,473,917,182600,54739
863,664,199,699,159600,54740
673,559,114,642,137500,54741
1885,1598,287,691,177400,54742
909,797,112,746,181700,54745
279,214,65,685,108300,54746
1036,681,355,732,146200,54747
512,439,73,545,148500,54748
524,403,121,739,174300,54749
397,344,53,780,194400,54750
9532,5545,3987,794,164100,54751
794,610,184,628,136600,54754
2996,2197,799,766,161700,54755
417,336,81,619,159500,54756
1380,1192,188,794,184300,54757
1891,1493,398,691,154000,54758
659,510,149,713,150000,54759
113,43,70,753,157500,54760
445,322,123,657,148000,54761
500,424,76,688,131700,54762
463,378,85,625,159100,54763
6,6,0,-,-,54765
684,567,117,671,138500,54766
1347,1108,239,916,182100,54767
1683,1242,441,758,131900,54768
272,256,16,725,235200,54769
851,700,151,748,160300,54770
1510,1195,315,604,132000,54771
429,329,100,716,158500,54772
1333,927,406,683,151300,54773
3041,2271,770,685,152300,54801
596,422,174,687,106000,54805
4852,3197,1655,662,123000,54806
1001,861,140,822,185400,54810
1943,1264,679,557,122600,54812
260,230,30,738,164600,54813
1214,821,393,540,157500,54814
1006,883,123,751,190100,54817
1072,854,218,496,118000,54819
435,351,84,773,160100,54820
621,554,67,588,187500,54821
1877,1420,457,834,154100,54822
977,748,229,718,159200,54824
333,305,28,650,173600,54826
166,162,4,-,154700,54827
348,263,85,400,142000,54828
2208,1784,424,674,165600,54829
1547,1390,157,725,172600,54830
182,123,59,386,162500,54832
429,364,65,742,129000,54835
408,390,18,725,167600,54836
1640,1288,352,659,145200,54837
512,442,70,758,171000,54838
142,127,15,-,124200,54839
1982,1583,399,746,138300,54840
115,104,11,808,97200,54841
65,62,3,-,155700,54842
5418,3912,1506,656,181700,54843
135,118,17,-,174100,54844
40,40,0,-,150000,54845
212,186,26,588,115800,54846
1017,852,165,844,181600,54847
2581,1843,738,670,96100,54848
802,670,132,765,197300,54849
115,96,19,667,225000,54850
1818,1422,396,684,161700,54853
367,330,37,857,173700,54854
239,218,21,850,163300,54855
678,604,74,869,149600,54856
22,9,13,-,95000,54857
742,488,254,591,130700,54858
906,716,190,767,163900,54859
68,22,46,329,-,54861
113,106,7,-,128100,54862
513,429,84,977,173900,54864
254,220,34,525,135900,54865
241,139,102,727,88800,54867
6830,4760,2070,724,155200,54868
718,656,62,980,205500,54870
1281,1027,254,707,150400,54871
1244,964,280,825,138500,54872
1434,1223,211,646,171100,54873
1502,1386,116,981,162800,54874
508,420,88,748,151700,54875
623,488,135,625,194400,54876
13288,7852,5436,765,129500,54880
634,583,51,750,159200,54888
1134,812,322,663,151700,54889
1512,1240,272,660,170300,54891
1783,1403,380,718,163700,54893
475,390,85,800,163600,54895
788,659,129,792,147000,54896
13838,7249,6589,780,122600,54901
10148,6375,3773,700,120700,54902
8982,6938,2044,804,198700,54904
843,726,117,680,137100,54909
10340,6054,4286,807,142200,54911
8478,6065,2413,908,262900,54913
13096,8409,4687,771,148400,54914
17030,12153,4877,793,170500,54915
447,404,43,709,120600,54921
565,451,114,748,124900,54922
3854,2836,1018,772,135200,54923
213,155,58,809,219500,54927
144,128,16,1563,134600,54928
3843,2836,1007,707,131100,54929
712,585,127,583,124800,54930
99,86,13,-,147700,54931
451,433,18,1275,203400,54932
159,84,75,733,101500,54933
153,78,75,478,128300,54934
17567,10339,7228,723,129500,54935
7645,5876,1769,884,191300,54937
1789,1610,179,739,213100,54940
1130,906,224,663,206500,54941
3749,3286,463,894,242100,54942
871,733,138,617,134400,54943
3387,2980,407,761,214200,54944
1569,1219,350,625,159000,54945
0,0,0,-,-,54946
1036,962,74,884,198900,54947
117,102,15,900,117900,54948
1412,1093,319,701,142800,54949
1146,954,192,614,119900,54950
11490,7661,3829,771,145400,54952
18538,12895,5643,809,164100,54956
1204,1091,113,625,159800,54960
5845,4096,1749,690,160100,54961
503,439,64,625,156800,54962
2866,2182,684,856,172600,54963
368,340,28,1010,223200,54964
554,524,30,767,162900,54965
756,579,177,667,140700,54966
179,114,65,475,102000,54967
1247,965,282,676,119700,54968
1254,963,291,633,111600,54970
4500,3000,1500,717,142000,54971
619,524,95,589,174600,54974
609,514,95,779,194800,54977
564,512,52,581,178900,54979
50,37,13,-,143400,54980
6677,4605,2072,698,153600,54981
3012,2351,661,689,142800,54982
1846,1526,320,728,150000,54983
1363,1087,276,660,156500,54984
0,0,0,-,-,54985
2281,1841,440,677,216400,54986
1110,1047,63,1292,471700,55001
1139,816,323,1343,248900,55003
1621,1518,103,925,237300,55005
1566,1192,374,872,149700,55006
937,853,84,868,158300,55007
5938,4636,1302,977,189100,55008
3198,2592,606,898,254600,55009
3727,3596,131,1694,262300,55011
763,663,100,974,232100,55012
2534,2138,396,1010,268200,55013
9739,8467,1272,1268,238700,55014
12028,10438,1590,1337,248800,55016
301,280,21,1625,209800,55017
361,333,28,1333,265200,55018
751,700,51,1063,225600,55019
1287,1269,18,-,367600,55020
10974,7689,3285,832,172700,55021
12151,10657,1494,1121,257000,55024
9454,7241,2213,1112,275700,55025
167,153,14,-,271700,55026
1208,990,218,932,226500,55027
33,33,0,-,87000,55029
508,449,59,742,163300,55030
707,640,67,965,285200,55031
1321,1253,68,1083,255400,55032
11785,8793,2992,957,244900,55033
37,28,9,1094,60000,55036
1884,1322,562,732,146600,55037
8183,7118,1065,1483,278300,55038
4857,4073,784,1103,198700,55040
3448,2567,881,861,209900,55041
3408,3192,216,1280,438600,55042
1457,1318,139,1112,257900,55043
18998,16257,2741,1353,344100,55044
3090,2693,397,886,236100,55045
1949,1662,287,1463,225100,55046
1023,935,88,1688,428000,55047
912,756,156,697,165900,55049
3824,3136,688,770,163800,55051
793,698,95,1000,178300,55052
387,353,34,1188,222900,55053
738,679,59,-,293600,55054
1422,896,526,901,216300,55055
5027,4390,637,867,203900,55056
8038,5829,2209,828,253500,55057
11828,8668,3160,774,172100,55060
3608,2887,721,793,177800,55063
453,421,32,1125,274400,55065
8039,5489,2550,902,183800,55066
10518,9010,1508,1248,260600,55068
1767,1351,416,833,191400,55069
2662,2332,330,1084,214200,55070
2079,1641,438,1142,195200,55071
1273,928,345,829,136600,55072
1211,1106,105,961,363600,55073
862,744,118,1016,204800,55074
8061,5304,2757,937,192000,55075
8855,6351,2504,1182,229100,55076
5223,3197,2026,1119,382000,55077
3213,2981,232,1005,242300,55079
980,926,54,1553,240200,55080
13953,11152,2801,1213,347100,55082
661,532,129,692,212100,55084
187,164,23,863,227600,55085
143,138,5,-,149200,55087
662,576,86,1313,401400,55088
682,608,74,860,293800,55089
141,112,29,1211,191300,55090
3990,3519,471,1119,241900,55092
4685,944,3741,1251,212800,55101
9319,4079,5240,1000,214100,55102
4932,1834,3098,802,170800,55103
16968,8734,8234,898,224800,55104
10404,7064,3340,995,349800,55105
17974,9804,8170,947,161200,55106
5170,2725,2445,926,181400,55107
6343,3121,3222,1111,284100,55108
13017,8418,4599,1052,214700,55109
16167,12528,3639,1152,247900,55110
25,0,25,556,-,55111
16892,11541,5351,1026,245100,55112
18021,11585,6436,1051,252400,55113
1595,431,1164,1186,236400,55114
3551,2922,629,1220,355500,55115
11309,5883,5426,1016,321200,55116
15970,8712,7258,975,196400,55117
12179,8042,4137,1042,246900,55118
15409,9766,5643,976,187100,55119
1931,1537,394,1195,369000,55120
3735,1620,2115,1193,249500,55121
12988,9213,3775,1171,254800,55122
9503,7453,2050,1258,337500,55123
19976,15538,4438,1353,258000,55124
16320,12864,3456,1433,296900,55125
11172,9197,1975,1203,275400,55126
7771,6496,1275,1345,299400,55127
11637,8837,2800,1070,224100,55128
9046,7624,1422,1771,396900,55129
5536,1966,3570,887,163200,55130
71,44,27,875,218800,55150
0,0,0,-,-,55155
4918,3778,1140,1154,257100,55301
3045,2534,511,850,242300,55302
17977,13267,4710,1110,242400,55303
16723,15373,1350,1450,294800,55304
9935,5413,4522,1402,332400,55305
6350,4067,2283,1282,276200,55306
1350,973,377,715,156500,55307
3217,2972,245,971,225900,55308
6424,5662,762,991,221700,55309
598,533,65,616,102500,55310
13936,12456,1480,1518,361500,55311
591,511,80,675,131400,55312
9016,7062,1954,1002,233700,55313
470,365,105,538,123300,55314
1856,1707,149,2265,340400,55315
9167,7954,1213,1227,237800,55316
8107,7053,1054,1373,361400,55317
10592,7681,2911,1179,277700,55318
1929,1792,137,1071,254900,55319
1933,1618,315,856,227900,55320
1869,1349,520,793,190000,55321
1232,1104,128,1143,281200,55322
478,429,49,795,263500,55324
1676,1415,261,744,231100,55325
1346,1303,43,1244,298600,55327
3393,2839,554,867,284200,55328
826,637,189,671,148000,55329
13504,11345,2159,1028,244500,55330
7119,6105,1014,1066,554300,55331
740,597,143,502,108400,55332
331,226,105,583,90000,55333
1153,845,308,643,155300,55334
628,534,94,657,106400,55335
2946,2429,517,764,167400,55336
18352,11804,6548,1206,239400,55337
444,420,24,900,174200,55338
431,358,73,723,218400,55339
2885,2723,162,1483,479400,55340
1056,983,73,589,297000,55341
758,623,135,794,97100,55342
12158,5467,6691,1103,242500,55343
7047,2294,4753,1357,270900,55344
8782,7073,1709,1288,365600,55345
6256,5578,678,1583,343000,55346
11487,10233,1254,1579,417800,55347
1566,1157,409,796,209100,55349
7761,5673,2088,833,164400,55350
3312,2588,724,1110,290000,55352
1354,1216,138,634,220100,55353
1084,936,148,546,173200,55354
3965,3021,944,759,159800,55355
2087,1727,360,1081,585700,55356
1165,1015,150,663,395700,55357
2063,1769,294,747,219400,55358
2244,1920,324,928,369500,55359
938,858,80,1075,243700,55360
6988,5440,1548,1029,223100,55362
1636,1337,299,975,193200,55363
6184,4971,1213,1074,349700,55364
221,134,87,620,94400,55366
379,313,66,795,225000,55367
911,663,248,768,207900,55368
15375,12315,3060,1433,255400,55369
278,247,31,1113,222300,55370
6229,5043,1186,762,189300,55371
12126,10665,1461,1133,338600,55372
2174,1756,418,978,210400,55373
5253,4614,639,1148,327100,55374
1516,1388,128,925,307400,55375
5375,4733,642,1134,268700,55376
10248,8595,1653,1280,306600,55378
15111,11369,3742,1213,271700,55379
818,708,110,538,172800,55381
1449,1316,133,978,244900,55382
1098,247,851,1075,425000,55384
527,436,91,713,129500,55385
2692,2483,209,1242,410800,55386
4825,3909,916,964,313600,55387
2179,1709,470,742,232700,55388
1019,857,162,540,166900,55389
929,797,132,1097,225300,55390
6772,5343,1429,1430,552400,55391
1121,873,248,717,166700,55395
910,708,202,712,136300,55396
1061,821,240,979,223600,55397
5486,5069,417,1268,229100,55398
6745,2582,4163,1692,346400,55401
408,0,408,1430,-,55402
11310,2268,9042,960,303200,55403
12091,1852,10239,834,258600,55404
7385,2850,4535,970,354700,55405
15571,10190,5381,990,232000,55406
14920,8551,6369,1019,214500,55407
15350,3842,11508,1091,286200,55408
4912,3102,1810,1060,278400,55409
8650,6958,1692,1263,423700,55410
9464,4242,5222,950,155000,55411
8732,5241,3491,1082,152800,55412
6660,2656,4004,1082,253400,55413
12030,2222,9808,1089,320200,55414
1978,645,1333,1639,438100,55415
16594,8182,8412,1332,355400,55416
10867,8671,2196,1045,266300,55417
13243,8634,4609,981,237400,55418
10737,8354,2383,1145,351000,55419
8530,5429,3101,1076,217700,55420
11719,7067,4652,999,179400,55421
12700,8926,3774,1134,227200,55422
15265,9234,6031,1078,225200,55423
3507,3190,317,1353,692700,55424
3997,1888,2109,1083,213200,55425
12106,7510,4596,1177,252000,55426
9649,6894,2755,1089,243600,55427
12010,6923,5087,1010,202900,55428
9886,5394,4492,1033,177000,55429
7652,4727,2925,1085,160800,55430
7958,5554,2404,1299,257000,55431
12143,7817,4326,994,196600,55432
13761,9359,4402,1078,194100,55433
11378,9483,1895,1138,200200,55434
7072,3163,3909,1422,307500,55435
5741,4380,1361,1352,475300,55436
7879,5553,2326,1235,273700,55437
7130,5446,1684,1351,315700,55438
3494,3103,391,1260,527400,55439
7777,4206,3571,1188,330200,55441
5467,4344,1123,1487,336100,55442
10897,8606,2291,1152,247100,55443
5023,4460,563,1107,214000,55444
4205,3510,695,1675,230700,55445
9555,7453,2102,1472,405500,55446
8596,6339,2257,1384,342300,55447
10574,8771,1803,1335,220100,55448
10010,8906,1104,1556,299600,55449
7,7,0,-,-,55450
3454,371,3083,675,138900,55454
0,0,0,-,-,55455
49,43,6,-,267900,55601
104,96,8,-,132100,55602
273,221,52,655,156300,55603
1724,1381,343,707,238300,55604
345,177,168,658,121500,55605
118,118,0,-,329000,55606
84,79,5,-,203000,55607
95,95,0,-,575400,55609
272,198,74,-,317400,55612
109,90,19,-,211500,55613
1159,1003,156,778,110900,55614
123,105,18,950,295800,55615
3293,2591,702,653,189300,55616
231,203,28,786,186200,55702
332,292,40,625,143100,55703
438,361,77,388,148200,55704
1389,1143,246,585,85200,55705
889,739,150,668,81000,55706
1345,1161,184,797,169700,55707
316,229,87,616,68100,55708
1626,1469,157,780,163100,55709
649,603,46,328,152400,55710
199,160,39,888,166100,55711
232,212,20,938,154900,55712
477,363,114,788,78000,55713
151,110,41,794,66300,55716
149,143,6,-,242200,55717
1314,1103,211,720,193900,55718
2594,1898,696,608,86200,55719
6724,4972,1752,768,155700,55720
1353,1221,132,823,209200,55721
489,331,158,709,118300,55722
976,818,158,592,165100,55723
350,332,18,-,159700,55724
84,80,4,-,360000,55725
449,337,112,935,173400,55726
2904,2312,592,498,178000,55731
711,654,57,1057,121200,55732
1888,1761,127,977,247300,55733
2681,1960,721,637,132700,55734
725,679,46,575,159500,55735
641,539,102,553,124800,55736
208,197,11,-,117600,55738
1622,1450,172,692,122300,55741
135,128,7,-,197700,55742
8774,6727,2047,683,173800,55744
7157,5229,1928,528,113800,55746
696,526,170,636,140800,55748
200,173,27,1063,166300,55749
962,899,63,615,69600,55750
705,660,45,878,135600,55751
203,191,12,575,145500,55752
472,394,78,750,61500,55753
150,137,13,720,163000,55756
306,278,28,900,153600,55757
75,70,5,950,57000,55758
1478,1185,293,719,203400,55760
265,245,20,330,140300,55763
298,183,115,617,74500,55764
375,319,56,590,102300,55765
8,8,0,-,-,55766
1259,932,327,726,160700,55767
1258,834,424,504,155200,55768
1130,911,219,767,136300,55769
715,593,122,702,135400,55771
33,17,16,719,-,55772
633,612,21,-,159900,55775
1502,1378,124,1090,219300,55779
71,63,8,-,164600,55780
340,331,9,-,311200,55781
186,172,14,475,73300,55782
978,926,52,697,171500,55783
49,42,7,-,125000,55784
112,109,3,-,171500,55785
169,133,36,558,87300,55786
258,222,36,779,165300,55787
927,726,201,880,247200,55790
4918,2859,2059,633,98900,55792
308,265,43,594,137500,55793
595,499,96,827,156400,55795
664,593,71,944,184100,55797
258,225,33,563,169100,55798
1361,405,956,586,349500,55802
7358,6178,1180,1074,232200,55803
5764,5060,704,1014,218400,55804
4829,1418,3411,773,122700,55805
4257,1803,2454,753,116200,55806
4234,2957,1277,745,124300,55807
2565,1819,746,782,123000,55808
3577,3196,381,671,156200,55810
11123,7857,3266,1046,203600,55811
3480,1691,1789,858,212000,55812
0,0,0,-,-,55814
22877,15262,7615,1026,197300,55901
10361,7336,3025,1126,302100,55902
10569,7281,3288,873,167600,55904
0,0,0,-,-,55905
7611,6152,1459,809,259900,55906
561,481,80,538,142200,55909
488,390,98,807,178300,55910
11412,7893,3519,734,117800,55912
1412,1190,222,724,153100,55917
361,306,55,610,119400,55918
478,398,80,482,163100,55919
2946,2612,334,969,241200,55920
2024,1607,417,659,158800,55921
384,288,96,456,114600,55922
1854,1490,364,756,211200,55923
540,468,72,714,147500,55924
430,393,37,588,212700,55925
295,237,58,525,161900,55926
1602,1243,359,685,164100,55927
475,409,66,890,185600,55929
157,140,17,820,107700,55931
825,638,187,610,184400,55932
95,84,11,925,128600,55933
1308,1086,222,692,220700,55934
336,297,39,640,209600,55935
721,573,148,690,146100,55936
762,610,152,598,144800,55939
1123,890,233,562,164900,55940
421,323,98,735,163500,55941
1273,1034,239,651,171100,55943
2743,2361,382,641,187400,55944
538,473,65,846,178000,55945
1329,1064,265,755,170900,55946
3334,2711,623,847,207900,55947
707,607,100,565,176900,55949
60,50,10,-,82000,55950
653,507,146,589,109100,55951
961,749,212,704,175800,55952
349,275,74,695,136100,55953
597,506,91,758,103000,55954
912,849,63,775,285300,55955
780,655,125,850,225700,55956
291,229,62,683,202800,55957
883,821,62,639,155400,55959
1259,1175,84,1315,301000,55960
182,160,22,725,114300,55961
333,263,70,683,175600,55962
2130,1666,464,716,236400,55963
1742,1373,369,620,167200,55964
1071,790,281,557,154000,55965
374,349,25,925,211200,55967
44,39,5,-,153800,55968
397,336,61,775,179300,55969
387,337,50,770,130900,55970
1142,947,195,683,166400,55971
1822,1417,405,628,200800,55972
105,93,12,1150,187500,55973
883,668,215,646,122200,55974
1840,1529,311,635,132000,55975
3054,2447,607,875,190800,55976
69,61,8,-,123900,55977
341,278,63,694,216700,55979
1749,1388,361,698,182200,55981
184,168,16,840,160700,55982
681,544,137,652,168900,55983
730,590,140,956,160200,55985
13779,9012,4767,702,159400,55987
378,323,55,777,119500,55990
566,480,86,803,260900,55991
2017,1639,378,719,208200,55992
18754,10373,8381,899,190400,56001
6198,4545,1653,819,199000,56003
8984,6490,2494,687,108400,56007
586,499,87,650,120500,56009
517,408,109,640,143800,56010
3088,2702,386,944,234600,56011
2017,1453,564,568,99400,56013
279,228,51,522,71500,56014
411,374,37,685,113200,56016
659,613,46,663,211000,56017
352,292,60,600,117100,56019
50,49,1,-,56900,56020
432,367,65,914,208100,56021
22,22,0,-,29300,56022
236,178,58,567,87200,56023
1210,830,380,1279,192700,56024
186,169,17,675,113300,56025
797,659,138,798,181600,56026
331,268,63,525,50000,56027
546,477,69,915,253700,56028
336,302,34,675,102600,56029
5261,3650,1611,623,135800,56031
112,92,20,760,56900,56032
161,132,29,485,76700,56033
196,170,26,700,140200,56034
166,128,38,541,139700,56035
813,692,121,583,118400,56036
622,532,90,702,164700,56037
338,288,50,693,115900,56039
452,366,86,617,157700,56041
314,251,63,650,114900,56042
193,166,27,330,118800,56043
830,726,104,778,203500,56044
392,354,38,564,113600,56045
36,27,9,950,88800,56046
49,44,5,-,87500,56047
1587,1364,223,741,169500,56048
605,523,82,647,206600,56050
304,248,56,903,58600,56051
321,287,34,920,234800,56052
396,351,45,763,122600,56054
1714,1368,346,791,173100,56055
44,41,3,-,54100,56056
1490,1163,327,708,176900,56057
2326,1696,630,654,169800,56058
173,141,32,-,57000,56060
1283,910,373,729,128800,56062
1203,1025,178,720,290000,56063
1099,871,228,671,157400,56065
422,350,72,613,127700,56068
1814,1497,317,923,186400,56069
4480,3801,679,907,285700,56071
912,739,173,521,142500,56072
7008,5554,1454,646,152000,56073
794,649,145,747,189500,56074
82,69,13,588,59400,56075
177,153,24,858,152700,56078
270,219,51,618,148400,56080
2358,1814,544,641,97100,56081
4847,3409,1438,878,182900,56082
391,349,42,436,87000,56083
2238,1828,410,595,137300,56085
1263,1008,255,628,113500,56087
808,620,188,619,101900,56088
77,59,18,604,56300,56089
281,212,69,913,123500,56090
145,126,19,680,102300,56091
4912,3626,1286,670,160900,56093
1252,949,303,742,178500,56096
1545,1287,258,616,99100,56097
895,660,235,632,92900,56098
2545,1986,559,665,105200,56101
720,583,137,617,124000,56110
180,164,16,492,112500,56111
82,70,12,775,84400,56113
137,124,13,733,112500,56114
546,469,77,582,133500,56115
307,226,81,763,184700,56116
134,111,23,780,95800,56117
161,151,10,467,108800,56118
382,332,50,570,135800,56119
348,312,36,725,75300,56120
290,254,36,583,75000,56121
256,177,79,732,88500,56122
208,185,23,767,104800,56123
29,29,0,-,39600,56125
167,140,27,550,64000,56127
812,662,150,766,132800,56128
336,268,68,655,79300,56129
948,785,163,793,117200,56131
211,179,32,700,191300,56132
193,163,30,535,105400,56134
534,377,157,621,87700,56136
498,387,111,613,97900,56137
371,298,73,798,119500,56138
177,151,26,546,117000,56139
20,17,3,-,72100,56140
129,110,19,625,91100,56141
417,332,85,763,76100,56142
1951,1523,428,712,136400,56143
509,399,110,892,90900,56144
256,232,24,542,65400,56145
37,28,9,-,105800,56146
83,64,19,-,87400,56147
521,416,105,505,124000,56149
1149,934,215,768,108000,56150
336,308,28,618,118100,56151
584,472,112,606,96700,56152
107,98,9,-,62800,56153
154,121,33,744,93800,56155
2392,1740,652,674,157100,56156
286,244,42,725,165000,56157
182,154,28,653,145800,56158
1165,808,357,630,84300,56159
96,80,16,613,75000,56160
141,127,14,850,85400,56161
103,99,4,-,77200,56162
2399,1688,711,539,100400,56164
156,138,18,706,135000,56165
87,78,9,583,106300,56166
310,259,51,495,101300,56167
326,285,41,780,122800,56168
261,218,43,678,132100,56169
275,238,37,775,84500,56170
782,575,207,663,103500,56171
1375,1052,323,498,121300,56172
155,114,41,763,95800,56173
151,123,28,588,66800,56174
1277,1021,256,612,99500,56175
457,375,82,587,83200,56176
17,17,0,-,58300,56177
744,597,147,642,107900,56178
468,359,109,493,84300,56180
470,393,77,571,100400,56181
568,478,90,483,76000,56183
217,189,28,725,103500,56185
143,114,29,482,120000,56186
5173,3252,1921,734,139800,56187
9077,5774,3303,794,149400,56201
97,79,18,747,149000,56207
1026,703,323,540,73600,56208
911,752,159,721,153700,56209
1,1,0,-,-,56210
198,166,32,-,81100,56211
231,188,43,554,71400,56212
312,238,74,707,82000,56214
1978,1251,727,694,119100,56215
281,253,28,950,119900,56216
216,194,22,783,150000,56218
435,324,111,773,93300,56219
1153,945,208,480,104800,56220
290,236,54,429,86900,56221
825,615,210,700,132800,56222
576,461,115,636,85900,56223
134,117,17,646,101800,56224
336,246,90,696,89700,56225
104,92,12,-,128600,56226
87,77,10,-,110400,56227
417,348,69,705,86600,56228
736,585,151,580,168600,56229
294,238,56,638,102600,56230
154,141,13,1000,120400,56231
1028,822,206,534,101500,56232
214,168,46,878,95000,56235
132,121,11,-,92500,56236
222,180,42,492,86700,56237
234,214,20,625,153700,56239
415,309,106,593,99200,56240
1648,1160,488,619,139600,56241
648,496,152,781,146900,56243
479,366,113,768,126400,56244
261,211,50,729,95900,56245
351,257,94,474,100400,56248
131,123,8,-,73100,56249
334,285,49,669,146000,56251
502,364,138,623,121800,56252
479,427,52,700,176800,56253
140,122,18,508,115600,56255
1169,897,272,534,82600,56256
246,219,27,-,52500,56257
5920,3475,2445,690,164500,56258
347,280,67,568,95300,56260
256,200,56,544,79300,56262
206,186,20,444,111600,56263
862,704,158,667,122000,56264
3319,2137,1182,612,117900,56265
623,521,102,495,104400,56266
2619,1677,942,755,180300,56267
456,402,54,650,79300,56270
472,396,76,700,119900,56271
2001,1696,305,780,224700,56273
85,85,0,-,160400,56274
99,81,18,755,71700,56276
1262,824,438,694,136900,56277
1264,874,390,575,105000,56278
495,438,57,645,183800,56279
210,182,28,525,125000,56280
238,199,39,730,138900,56281
601,462,139,781,139000,56282
2579,1844,735,713,120100,56283
782,656,126,593,89700,56284
477,379,98,665,85000,56285
36,34,2,-,55000,56287
2008,1800,208,766,277700,56288
283,263,20,688,216400,56289
184,164,20,563,122200,56291
211,190,21,656,88900,56292
516,416,100,595,137200,56293
29,24,5,-,55500,56294
118,98,20,520,70000,56295
1003,828,175,569,79000,56296
346,290,56,475,86600,56297
12027,6275,5752,874,190600,56301
10852,6581,4271,780,151200,56303
6873,3264,3609,773,161800,56304
1897,1592,305,560,210500,56307
11413,7816,3597,742,223000,56308
562,432,130,778,187500,56309
2095,1900,195,726,223000,56310
311,252,59,-,159200,56311
980,766,214,720,158100,56312
37,27,10,1100,83600,56313
445,384,61,825,209800,56314
672,567,105,583,179700,56315
578,473,105,696,139400,56316
427,392,35,613,216700,56318
554,509,45,750,208100,56319
3273,2852,421,932,212600,56320
0,0,0,-,-,56321
237,183,54,563,90500,56323
424,383,41,750,199500,56324
99,84,15,886,125000,56325
650,552,98,650,162700,56326
322,310,12,829,288500,56327
75,55,20,579,101800,56328
2617,2173,444,670,187200,56329
594,542,52,845,177900,56330
853,761,92,763,213600,56331
669,636,33,738,249100,56332
2690,2003,687,624,199900,56334
87,86,1,-,95500,56335
640,571,69,556,223700,56336
651,587,64,872,199700,56338
461,345,116,598,139200,56339
1046,894,152,632,209900,56340
1261,1048,213,609,170600,56342
446,401,45,657,168100,56343
6082,4326,1756,794,161100,56345
2757,2122,635,680,145700,56347
346,294,52,578,149300,56349
211,191,20,1167,154700,56350
2294,1819,475,842,169500,56352
3517,2793,724,784,163000,56353
599,546,53,717,224100,56354
226,195,31,914,185900,56355
114,112,2,-,121600,56356
409,377,32,950,206800,56357
1270,1093,177,874,174000,56358
1404,956,448,714,152100,56359
1705,1398,307,685,170600,56360
973,837,136,663,136600,56361
2339,1933,406,706,178400,56362
57,32,25,700,152500,56363
2135,1782,353,725,173600,56364
2379,2131,248,688,195400,56367
1773,1646,127,718,233600,56368
260,100,160,689,163500,56369
45,32,13,1313,116700,56371
1200,962,238,698,202300,56373
3284,2486,798,786,194600,56374
343,310,33,675,171700,56375
136,123,13,300,133900,56376
7559,4762,2797,967,207500,56377
3137,2270,867,668,182900,56378
6987,4851,2136,753,179600,56379
1046,812,234,615,158900,56381
585,509,76,546,198500,56382
168,74,94,672,136100,56384
350,301,49,663,145100,56385
305,243,62,629,189600,56386
3318,1151,2167,844,159400,56387
40,37,3,-,109700,56389
12492,8856,3636,746,179300,56401
3246,2254,992,998,209800,56425
4196,3405,791,805,193700,56431
765,654,111,775,188000,56433
81,72,9,542,162500,56434
1227,1087,140,796,165200,56435
33,27,6,-,148400,56436
525,405,120,745,92900,56437
1051,907,144,618,144800,56438
532,425,107,575,122600,56440
1577,1065,512,812,126600,56441
1164,1020,144,850,318200,56442
588,520,68,906,228400,56443
1376,1179,197,668,240600,56444
645,535,110,583,115800,56446
488,443,45,1077,255800,56447
145,135,10,-,285000,56448
710,661,49,733,216600,56449
459,386,73,900,138400,56450
930,799,131,667,260600,56452
364,310,54,721,133100,56453
733,584,149,715,136900,56455
23,19,4,683,143800,56456
169,141,28,688,172800,56458
1300,1173,127,729,178400,56461
1748,1492,256,788,155500,56464
909,871,38,1074,233200,56465
1363,1061,302,715,162000,56466
1057,966,91,775,244800,56467
1860,1655,205,825,283600,56468
532,481,51,691,171900,56469
4432,3220,1212,675,192800,56470
3183,2723,460,732,227500,56472
1459,1275,184,815,176700,56473
1895,1413,482,677,150100,56474
613,505,108,725,157900,56475
1165,992,173,663,143300,56477
2178,1676,502,724,127800,56479
841,689,152,580,144700,56481
2834,2003,831,659,126100,56482
1503,1130,373,771,201900,56484
7348,5391,1957,763,220000,56501
933,710,223,482,99000,56510
812,714,98,686,224200,56511
1412,1144,268,743,178100,56514
1349,1190,159,811,287200,56515
109,96,13,383,120000,56516
118,93,25,850,84200,56517
156,131,25,864,154700,56518
119,95,24,800,111300,56519
1781,1242,539,509,139900,56520
300,261,39,750,128200,56521
182,163,19,1042,81400,56522
209,169,40,595,156600,56523
313,272,41,788,232400,56524
37,37,0,-,114600,56525
319,274,45,575,153500,56527
724,631,93,783,250400,56528
1721,1292,429,601,221400,56529
870,691,179,755,99000,56531
131,114,17,1150,148600,56533
520,488,32,956,204200,56534
516,420,96,519,150000,56535
173,158,15,-,161100,56536
8188,5611,2577,663,159800,56537
821,660,161,658,136500,56540
8,8,0,-,-,56541
1182,832,350,819,137000,56542
93,84,9,-,156300,56543
2039,1673,366,775,187300,56544
307,279,28,350,103000,56545
104,102,2,-,165600,56546
959,815,144,628,207000,56547
334,261,73,685,103100,56548
1931,1593,338,844,224600,56549
180,155,25,675,103100,56550
900,694,206,647,162500,56551
203,171,32,458,119700,56552
104,98,6,-,135700,56553
1088,993,95,639,232600,56554
446,334,112,622,114100,56556
1041,629,412,620,87800,56557
16996,10384,6612,885,196800,56560
21,20,1,-,105600,56565
194,94,100,418,103600,56566
1259,985,274,608,145000,56567
70,62,8,710,112500,56568
482,364,118,415,107600,56569
519,443,76,929,183500,56570
802,754,48,858,236700,56571
2165,1761,404,397,233400,56572
2830,2052,778,706,195400,56573
102,98,4,-,101900,56574
283,234,49,492,151800,56575
351,295,56,855,232200,56576
3,3,0,-,-,56577
298,284,14,1125,289600,56578
485,423,62,728,123400,56579
518,502,16,638,195200,56580
108,97,11,-,83100,56581
66,55,11,-,88300,56583
568,461,107,664,101300,56584
420,349,71,833,129600,56585
810,709,101,746,233700,56586
609,542,67,653,227800,56587
204,193,11,-,236500,56588
772,613,159,505,142100,56589
128,104,24,715,80000,56590
52,42,10,350,65700,56591
181,154,27,675,99200,56592
0,0,0,-,-,56593
198,190,8,488,157300,56594
13635,9037,4598,813,176700,56601
1800,1347,453,709,136200,56621
1064,826,238,633,157100,56623
124,87,37,690,124300,56626
143,115,28,450,48600,56627
776,640,136,911,200700,56628
104,99,5,-,131300,56629
856,635,221,577,119600,56630
1709,1144,565,628,111100,56633
603,495,108,536,137900,56634
2025,1685,340,651,160900,56636
87,77,10,1063,161500,56637
225,202,23,935,164100,56639
144,110,34,292,162500,56641
301,272,29,625,124000,56644
184,155,29,538,156300,56646
260,247,13,775,164700,56647
4056,3071,985,672,111500,56649
291,257,34,581,132900,56650
227,195,32,725,120600,56651
222,208,14,-,171400,56652
604,526,78,595,111800,56653
67,61,6,-,117200,56654
783,693,90,717,252700,56655
154,142,12,-,228800,56657
0,0,0,-,-,56658
27,27,0,-,131300,56659
117,109,8,-,111700,56660
369,323,46,475,105100,56661
274,262,12,-,270300,56662
82,78,4,-,93500,56663
239,97,142,418,91000,56666
230,208,22,944,196700,56667
41,27,14,-,156900,56668
143,140,3,-,158800,56669
285,177,108,492,46200,56670
875,453,422,558,65200,56671
954,793,161,629,203100,56672
290,246,44,839,178400,56673
671,625,46,688,154300,56676
490,449,41,950,144400,56678
76,72,4,-,163900,56680
118,102,16,525,173200,56681
332,271,61,950,177500,56683
109,99,10,-,117500,56684
47,40,7,-,125000,56685
317,304,13,-,141700,56686
20,20,0,-,107100,56687
60,53,7,-,149000,56688
5575,4019,1556,696,156100,56701
242,202,40,547,109200,56710
0,0,0,-,-,56711
410,367,43,635,104200,56713
507,422,85,655,110900,56714
146,134,12,340,138000,56715
3503,2415,1088,711,137100,56716
5,5,0,-,-,56720
4169,2896,1273,727,201100,56721
139,123,16,-,170200,56722
337,264,73,714,166400,56723
62,53,9,-,145800,56724
337,308,29,683,163800,56725
618,537,81,573,109000,56726
298,266,32,575,97800,56727
616,510,106,730,100000,56728
46,44,2,-,66700,56729
34,26,8,725,42000,56731
492,347,145,558,87600,56732
165,153,12,669,59600,56733
190,166,24,425,48600,56734
307,243,64,600,109400,56735
428,372,56,758,281900,56736
408,342,66,436,99100,56737
622,528,94,542,149600,56738
0,0,0,-,-,56741
381,337,44,435,89100,56742
214,175,39,488,117700,56744
246,200,46,738,108300,56748
1013,830,183,583,124400,56750
2317,1804,513,750,158900,56751
230,194,36,641,146200,56754
33,33,0,-,54200,56755
234,213,21,678,121900,56756
386,314,72,638,103400,56757
139,126,13,-,89300,56758
95,84,11,-,128600,56759
156,129,27,781,106300,56760
179,161,18,1125,124400,56761
1074,793,281,678,127600,56762
1889,1519,370,724,131000,56763
751,608,143,573,111000,57001
408,326,82,708,165800,57002
688,622,66,864,186500,57003
1526,1041,485,711,163600,57004
4204,3229,975,932,234300,57005
9702,5123,4579,748,185300,57006
231,208,23,1169,166200,57010
498,371,127,544,136600,57012
1675,1316,359,688,165700,57013
609,462,147,621,112500,57014
301,261,40,534,157500,57015
354,307,47,943,192500,57016
605,480,125,761,191900,57017
504,436,68,733,138100,57018
506,467,39,1114,213000,57020
102,98,4,-,-,57021
1931,1587,344,863,185500,57022
225,190,35,709,79400,57024
1207,913,294,732,160100,57025
512,363,149,663,150300,57026
34,18,16,-,61700,57027
1312,825,487,533,117700,57028
922,694,228,566,112200,57029
1139,949,190,728,199200,57030
353,289,64,625,133000,57031
2697,2344,353,943,212800,57032
2003,1551,452,896,227700,57033
347,296,51,425,118900,57034
409,364,45,684,157300,57035
254,224,30,950,98300,57036
390,235,155,613,114600,57037
611,559,52,405,170500,57038
1371,1030,341,690,156300,57039
162,148,14,575,86100,57040
41,41,0,-,-,57041
3276,2225,1051,571,162600,57042
596,464,132,692,97500,57043
483,381,102,421,67600,57045
334,261,73,680,130100,57046
121,74,47,683,75600,57047
490,359,131,418,160100,57048
2931,1736,1195,939,265500,57049
119,111,8,-,-,57050
151,110,41,558,56700,57051
112,78,34,526,200000,57052
758,636,122,652,170000,57053
251,223,28,625,97500,57054
518,458,60,914,277200,57055
99,91,8,-,-,57057
710,553,157,759,130000,57058
563,436,127,459,87400,57059
36,31,5,-,57700,57061
483,359,124,339,111300,57062
372,287,85,928,93200,57063
2122,1565,557,971,220600,57064
165,122,43,653,98000,57065
713,464,249,608,91000,57066
137,116,21,1261,220800,57067
561,499,62,816,185100,57068
4425,2202,2223,744,173800,57069
650,428,222,619,124100,57070
1285,967,318,782,172300,57071
294,229,65,903,132000,57072
271,203,68,825,77300,57073
453,407,46,731,279700,57075
189,160,29,-,215100,57076
513,474,39,857,164800,57077
7988,4984,3004,640,153400,57078
14341,9799,4542,777,171900,57103
11638,4341,7297,680,114600,57104
9598,6204,3394,836,171800,57105
19237,11825,7412,878,198100,57106
4130,2916,1214,868,170400,57107
8853,6386,2467,991,296200,57108
7286,4869,2417,887,247200,57110
0,0,0,-,-,57117
0,0,0,-,-,57197
11076,7076,4000,760,180400,57201
949,739,210,709,134200,57212
293,264,29,838,122200,57213
25,22,3,-,55600,57214
584,484,100,717,121400,57216
115,102,13,-,80000,57217
132,96,36,-,144400,57218
257,227,30,486,99400,57219
274,233,41,675,149700,57220
320,215,105,519,138800,57221
492,418,74,525,165400,57223
53,37,16,558,75000,57224
876,667,209,530,102400,57225
877,644,233,485,153600,57226
131,109,22,-,241000,57227
716,583,133,380,118100,57231
120,111,9,735,151400,57232
66,54,12,-,-,57233
513,437,76,532,114200,57234
350,283,67,535,150600,57235
68,61,7,-,-,57236
260,224,36,436,100000,57237
215,157,58,659,121200,57238
112,108,4,-,197500,57239
375,322,53,577,153800,57241
164,143,21,-,184900,57242
259,196,63,683,127300,57243
52,46,6,-,107500,57245
102,95,7,-,83800,57246
102,68,34,-,283300,57247
373,286,87,780,145600,57248
398,326,72,440,146400,57249
57,50,7,-,155000,57251
2069,1620,449,615,140100,57252
172,128,44,530,70800,57255
45,40,5,-,50000,57256
224,144,80,496,-,57257
52,49,3,-,71700,57258
194,154,40,533,102300,57259
358,303,55,633,108200,57260
169,159,10,710,90300,57261
1974,1054,920,586,96100,57262
198,150,48,442,92700,57263
126,111,15,519,107400,57264
76,72,4,-,90000,57265
235,178,57,575,80000,57266
195,170,25,725,81400,57268
133,130,3,-,145500,57269
313,193,120,520,54700,57270
71,69,2,-,119300,57271
82,78,4,-,-,57272
516,349,167,456,85500,57273
1224,876,348,516,110900,57274
430,350,80,621,154300,57276
250,208,42,625,109100,57278
536,431,105,616,114000,57279
8077,4741,3336,766,156100,57301
477,409,68,836,129200,57311
263,232,31,-,87600,57312
519,390,129,494,98300,57313
321,260,61,719,100000,57314
506,399,107,575,84500,57315
250,185,65,491,68100,57317
374,273,101,634,86500,57319
163,127,36,617,103300,57321
150,104,46,706,95000,57322
104,80,24,930,64300,57323
145,111,34,646,-,57324
1347,862,485,630,173600,57325
519,411,108,600,119000,57328
137,97,40,645,106300,57329
196,178,18,475,84700,57330
167,148,19,515,151100,57331
251,231,20,675,114900,57332
351,244,107,716,129300,57334
139,121,18,463,54600,57335
49,46,3,-,165600,57337
416,151,265,420,34400,57339
118,97,21,-,113500,57340
56,52,4,-,-,57341
208,185,23,-,78500,57342
47,43,4,-,73200,57344
512,420,92,660,88100,57345
54,5,49,421,-,57346
224,197,27,758,161900,57348
606,481,125,601,66900,57349
6345,3939,2406,619,107800,57350
352,315,37,438,126100,57353
587,365,222,824,108600,57355
579,382,197,493,63600,57356
17,16,1,-,-,57358
324,249,75,633,128100,57359
40,18,22,364,-,57361
989,588,401,517,125600,57362
384,293,91,717,138700,57363
0,0,0,-,-,57364
259,214,45,648,166400,57365
931,722,209,582,117400,57366
104,76,28,675,200000,57367
466,352,114,683,105500,57368
1008,705,303,666,161000,57369
271,199,72,688,86800,57370
71,57,14,-,-,57371
246,193,53,-,145200,57373
162,152,10,-,140400,57374
311,262,49,479,86500,57375
396,342,54,413,49500,57376
36,35,1,-,-,57379
1110,706,404,536,110100,57380
225,180,45,521,78000,57381
644,422,222,486,78200,57382
341,243,98,604,75300,57383
421,385,36,584,117200,57384
518,336,182,490,87300,57385
89,75,14,-,88300,57386
13849,8310,5539,695,172900,57401
48,45,3,-,82500,57420
21,21,0,-,-,57421
113,105,8,-,75000,57422
82,74,8,-,60000,57424
9,4,5,-,-,57426
263,263,0,-,140600,57427
234,186,48,533,80900,57428
46,31,15,-,73800,57429
968,696,272,651,118100,57430
146,128,18,-,64000,57432
198,174,24,580,133300,57433
196,169,27,392,66500,57434
126,108,18,-,155000,57435
196,168,28,610,59700,57436
742,574,168,493,55900,57437
508,397,111,665,85900,57438
41,41,0,-,839800,57439
175,145,30,500,64400,57440
232,214,18,725,109600,57441
776,601,175,680,115300,57442
738,558,180,746,164000,57445
192,179,13,375,55300,57446
191,175,16,433,41000,57448
100,100,0,-,207400,57449
217,180,37,625,85200,57450
892,739,153,660,196100,57451
115,104,11,833,48000,57452
265,224,41,645,103900,57454
33,27,6,-,55000,57455
286,219,67,557,71800,57456
34,33,1,-,-,57457
131,86,45,610,72200,57460
164,137,27,785,91700,57461
129,115,14,605,87000,57465
61,46,15,-,122200,57466
92,81,11,-,57400,57467
179,114,65,631,70000,57468
1449,958,491,614,96400,57469
30,16,14,-,-,57470
227,178,49,714,84000,57471
349,283,66,519,78100,57472
86,86,0,-,93300,57473
65,60,5,-,85000,57474
58,49,9,-,81700,57475
187,154,33,725,120000,57476
50,43,7,-,61300,57477
232,197,35,775,167000,57479
167,152,15,-,87600,57481
7218,4970,2248,673,179500,57501
51,36,15,-,75000,57520
64,48,16,-,39000,57521
211,143,68,785,120200,57522
454,290,164,509,85200,57523
381,279,102,564,76300,57528
139,109,30,-,97000,57529
50,44,6,-,81300,57531
1298,1023,275,772,165000,57532
816,588,228,573,86700,57533
107,107,0,-,-,57534
136,107,29,-,72500,57536
53,44,9,-,-,57537
106,89,17,975,86300,57538
24,18,6,-,56400,57540
45,30,15,-,-,57541
315,213,102,569,48100,57543
205,173,32,767,120100,57544
64,59,5,-,55000,57547
399,132,267,538,51800,57548
789,530,259,548,75000,57551
226,183,43,-,126400,57552
52,52,0,-,-,57553
1223,579,644,449,38400,57555
300,212,88,438,76200,57559
130,67,63,385,-,57560
25,23,2,-,-,57562
57,32,25,553,17600,57563
407,354,53,564,143300,57564
287,120,167,463,"10,000-",57566
587,439,148,704,90800,57567
291,246,45,681,83300,57568
116,93,23,-,86800,57569
509,214,295,451,21000,57570
5,5,0,-,-,57571
490,188,302,377,20600,57572
40,22,18,-,-,57574
102,56,46,-,75000,57576
282,79,203,527,56500,57577
441,340,101,534,30800,57579
1768,1332,436,580,108500,57580
42,35,7,-,-,57584
65,45,20,313,51400,57585
1621,1100,521,693,93800,57601
207,157,50,713,75800,57620
71,22,49,531,-,57621
89,36,53,563,-,57622
318,201,117,585,61900,57623
1169,649,520,578,57400,57625
352,257,95,528,87800,57626
16,16,0,-,-,57630
190,171,19,-,125800,57631
274,234,40,-,83800,57632
143,110,33,575,70000,57633
37,37,0,-,113300,57634
47,19,28,350,202500,57636
828,627,201,588,98300,57638
84,28,56,350,60000,57639
97,37,60,-,260400,57640
139,105,34,531,38800,57641
573,258,315,453,66200,57642
131,119,12,-,83100,57644
62,55,7,525,48300,57645
102,97,5,-,52500,57646
158,134,24,413,67300,57648
91,56,35,278,-,57649
10,0,10,-,-,57650
60,30,30,-,96000,57651
113,67,46,652,62500,57652
292,208,84,571,73300,57656
76,61,15,-,78300,57657
111,49,62,408,36900,57658
30,27,3,-,107800,57660
30,16,14,-,141700,57661
18418,10494,7924,780,158900,57701
14765,11279,3486,945,246700,57702
6240,5201,1039,886,176000,57703
895,5,890,1071,-,57706
134,32,102,602,87700,57714
117,73,44,538,60200,57716
3240,2476,764,743,149100,57717
2821,2555,266,1113,182600,57718
3082,2170,912,908,175500,57719
318,221,97,596,122100,57720
84,69,15,-,-,57722
78,66,12,-,180900,57724
118,92,26,-,-,57725
2590,2059,531,790,214300,57730
1215,810,405,613,183300,57732
577,466,111,690,63200,57735
71,66,5,1042,92900,57738
20,0,20,-,-,57741
851,817,34,875,323300,57744
950,723,227,634,216600,57745
2627,2061,566,576,149800,57747
99,73,26,388,-,57748
52,43,9,-,104200,57750
399,323,76,581,247700,57751
405,177,228,490,-,57752
1748,1171,577,648,141200,57754
37,26,11,-,56000,57755
123,85,38,509,13500,57756
58,28,30,-,22500,57758
77,77,0,-,-,57759
550,428,122,-,90900,57760
470,407,63,1292,163300,57761
254,228,26,875,97400,57762
121,101,20,538,69500,57763
468,258,210,473,26900,57764
51,51,0,-,-,57766
52,44,8,-,187500,57767
1635,1420,215,1065,253900,57769
1162,597,565,513,42300,57770
415,180,235,711,21700,57772
73,57,16,-,-,57773
103,81,22,-,181900,57775
0,0,0,-,-,57776
167,56,111,883,-,57779
20,15,5,-,181300,57780
19,18,1,-,-,57782
6810,4131,2679,778,222100,57783
4059,2825,1234,534,171700,57785
135,103,32,-,120700,57787
170,108,62,-,109600,57788
421,307,114,651,121300,57790
100,92,8,-,66700,57791
54,54,0,-,173300,57792
912,817,95,744,171900,57793
72,0,72,522,-,57794
0,0,0,-,-,57799
14,14,0,-,200000,58001
11,11,0,-,-,58002
135,120,15,870,190600,58004
318,313,5,-,284000,58005
186,130,56,660,155000,58006
40,34,6,-,266700,58007
98,83,15,-,164100,58008
14,14,0,-,144400,58009
170,153,17,466,160800,58011
1110,854,256,673,204300,58012
89,77,12,-,251000,58013
125,104,21,-,180000,58015
100,88,12,-,159700,58016
141,114,27,571,71900,58017
146,136,10,-,180000,58018
179,151,28,545,195700,58021
639,444,195,714,98300,58027
29,29,0,-,-,58029
259,227,32,450,88400,58030
187,156,31,688,87900,58031
311,224,87,675,122700,58032
177,163,14,325,131300,58033
125,107,18,339,98800,58035
95,95,0,-,156000,58036
141,117,24,325,149500,58038
539,316,223,714,120200,58040
633,591,42,425,98000,58041
494,462,32,1354,237900,58042
68,65,3,-,101600,58043
850,582,268,611,160900,58045
232,180,52,498,98000,58046
1663,1614,49,489,360100,58047
194,164,30,658,160700,58048
141,139,2,-,137500,58049
667,571,96,654,286300,58051
264,186,78,679,180000,58052
526,415,111,496,63500,58053
1317,895,422,591,135100,58054
63,63,0,-,-,58056
42,42,0,-,162500,58057
46,37,9,-,-,58058
535,488,47,958,191100,58059
586,452,134,773,108800,58060
163,143,20,421,121600,58061
79,75,4,-,-,58062
145,111,34,781,137500,58063
196,148,48,-,143800,58064
14,14,0,-,-,58065
107,94,13,575,87500,58067
163,108,55,1095,76700,58068
51,43,8,-,109400,58069
210,158,52,472,130900,58071
3712,2377,1335,679,150300,58072
3963,2328,1635,670,132000,58075
0,0,0,-,-,58076
314,285,29,-,197400,58077
14029,9293,4736,920,241800,58078
163,163,0,-,224200,58079
343,294,49,742,125000,58081
13366,6344,7022,718,192000,58102
23497,9365,14132,774,184100,58103
18278,8677,9601,957,283600,58104
0,0,0,-,-,58105
18712,9164,9548,842,230900,58201
0,0,0,-,-,58202
7406,2666,4740,758,165700,58203
718,0,718,1416,-,58204
0,0,0,-,-,58205
170,136,34,533,67000,58210
264,185,79,497,83800,58212
147,117,30,525,143800,58214
53,39,14,-,-,58216
339,276,63,1096,165900,58218
15,15,0,-,-,58219
922,709,213,632,111400,58220
127,111,16,613,73100,58222
96,89,7,-,107300,58223
14,14,0,-,73300,58224
428,343,85,535,101100,58225
246,210,36,636,102400,58227
406,250,156,690,138200,58228
38,35,3,-,63800,58229
272,227,45,588,71600,58230
169,147,22,-,66400,58231
124,105,19,-,112500,58233
186,152,34,735,115600,58235
2293,1581,712,679,98200,58237
70,64,6,-,109100,58238
7,7,0,-,-,58239
542,428,114,577,137300,58240
66,62,4,-,-,58241
300,270,30,807,75700,58243
44,43,1,-,103100,58244
1153,867,286,568,114100,58249
106,91,15,760,73100,58250
768,563,205,644,152300,58251
302,232,70,490,75700,58254
306,282,24,910,191700,58256
877,524,353,643,149100,58257
123,118,5,-,157100,58258
181,126,55,607,80000,58259
89,88,1,-,94300,58260
476,387,89,775,113800,58261
43,20,23,433,-,58262
203,188,15,-,104500,58265
90,59,31,-,103100,58266
568,451,117,642,162500,58267
119,111,8,625,65600,58269
820,643,177,773,85800,58270
278,220,58,563,103800,58271
135,109,26,717,86800,58272
100,99,1,-,71300,58273
421,321,100,445,118300,58274
294,253,41,837,147200,58275
235,186,49,679,76500,58276
64,56,8,-,104200,58277
775,712,63,695,243200,58278
39,39,0,-,-,58281
711,474,237,576,92600,58282
4287,2451,1836,566,168500,58301
38,26,12,-,113500,58311
2075,1396,679,372,84700,58316
94,90,4,-,63600,58317
1718,1331,387,664,165000,58318
29,27,2,-,212500,58321
13,13,0,-,-,58323
646,439,207,591,88600,58324
20,16,4,-,-,58325
146,132,14,-,200000,58327
998,770,228,346,72200,58329
119,109,10,-,45300,58330
66,55,11,-,106500,58331
177,158,19,519,82700,58332
397,131,266,387,52000,58335
26,25,1,-,-,58338
10,1,9,388,-,58339
1225,962,263,606,105600,58341
26,24,2,-,-,58343
429,279,150,530,106000,58344
57,42,15,-,83300,58345
324,244,80,516,80000,58346
337,274,63,494,108800,58348
184,148,36,620,106300,58351
191,158,33,-,85000,58352
58,40,18,523,178100,58353
26,26,0,-,58000,58355
799,506,293,634,88600,58356
107,95,12,-,87100,58357
113,77,36,1656,-,58361
0,0,0,-,-,58362
44,43,1,-,55800,58363
119,90,29,462,-,58365
433,320,113,544,105600,58366
652,417,235,582,105500,58367
1641,1181,460,669,127900,58368
432,379,53,296,86800,58369
391,245,146,400,47100,58370
43,41,2,-,53800,58372
259,222,37,469,76300,58374
151,101,50,613,71200,58377
107,36,71,500,-,58379
190,165,25,438,70700,58380
127,114,13,925,187500,58381
85,76,9,-,161300,58382
231,206,25,450,56400,58384
71,62,9,-,76700,58385
57,48,9,-,88000,58386
7629,4749,2880,687,160700,58401
0,0,0,-,-,58402
0,0,0,-,-,58405
503,389,114,521,74400,58413
59,56,3,-,271400,58415
200,156,44,331,68600,58416
197,150,47,832,71900,58418
107,98,9,-,175000,58420
1234,911,323,598,151200,58421
78,62,16,-,165000,58422
28,25,3,-,158000,58423
116,109,7,-,-,58424
574,449,125,466,120800,58425
77,72,5,-,143800,58426
97,60,37,-,264300,58428
200,132,68,642,176200,58429
61,61,0,-,119600,58430
55,54,1,-,227300,58431
482,334,148,437,127600,58433
740,538,202,570,98900,58436
342,252,90,803,77300,58438
62,62,0,-,125000,58439
52,43,9,-,81700,58440
134,100,34,-,94300,58441
197,178,19,500,78400,58442
75,60,15,363,85700,58443
116,81,35,430,56500,58444
76,57,19,-,162500,58445
163,109,54,550,57600,58448
62,51,11,-,60600,58451
19,12,7,-,-,58452
138,110,28,438,75000,58454
145,121,24,755,68400,58455
254,204,50,540,77000,58456
518,384,134,495,103600,58458
97,82,15,555,46300,58460
192,157,35,425,74300,58461
372,286,86,575,63300,58463
97,92,5,-,121200,58464
154,118,36,715,85800,58466
247,197,50,579,88800,58467
195,184,11,575,161700,58472
1167,862,305,661,127100,58474
92,73,19,-,28800,58475
100,81,19,531,143800,58476
60,47,13,-,-,58477
63,47,16,490,42500,58478
87,82,5,-,126800,58479
151,119,32,675,97000,58480
98,94,4,-,236000,58481
473,359,114,544,133600,58482
138,118,20,413,88600,58483
19,17,2,-,45000,58484
97,84,13,419,84300,58486
223,187,36,556,87500,58487
83,68,15,392,74000,58488
109,95,14,-,78100,58490
212,176,36,492,115200,58492
114,89,25,-,79200,58494
635,433,202,553,89600,58495
83,41,42,388,46300,58496
84,76,8,-,95000,58497
13238,7596,5642,820,227200,58501
13954,10399,3555,989,326400,58503
11080,8010,3070,825,244600,58504
0,0,0,-,-,58505
72,58,14,675,150000,58520
246,236,10,-,407000,58521
1574,1258,316,732,201000,58523
39,39,0,-,133900,58524
143,46,97,463,91300,58528
284,237,47,738,62600,58529
434,384,50,522,172300,58530
211,205,6,-,244100,58531
114,88,26,833,115000,58532
472,392,80,538,93100,58533
218,180,38,845,87300,58535
634,209,425,388,96800,58538
1301,996,305,703,166200,58540
244,205,39,654,95000,58541
115,98,17,725,86700,58542
260,225,35,-,84600,58544
1549,1300,249,887,181200,58545
104,93,11,-,122700,58549
828,690,138,325,107100,58552
11347,7808,3539,867,227300,58554
372,352,20,717,283300,58558
103,95,8,-,171400,58559
67,57,10,681,160400,58560
483,383,100,775,92100,58561
171,155,16,-,76100,58562
1038,847,191,675,147800,58563
48,48,0,-,56700,58564
109,107,2,-,159900,58565
56,46,10,-,77500,58566
220,134,86,645,76300,58568
40,40,0,-,67100,58569
170,142,28,1031,118800,58570
242,220,22,656,114300,58571
100,93,7,575,170800,58572
271,248,23,663,89200,58573
396,293,103,730,139600,58575
401,341,60,721,174500,58576
846,697,149,748,208800,58577
542,454,88,492,185800,58579
174,155,19,917,321900,58580
122,97,25,680,38600,58581
10888,6271,4617,919,252300,58601
58,41,17,925,-,58620
654,458,196,689,115000,58621
771,601,170,894,163500,58622
909,649,260,635,168100,58623
91,85,6,-,151100,58625
164,138,26,860,157800,58626
85,76,9,-,196900,58627
296,223,73,1369,244300,58630
533,410,123,725,116700,58631
85,52,33,-,150000,58632
86,69,17,-,332600,58634
363,269,94,902,192300,58636
524,427,97,631,98200,58638
803,588,215,610,143100,58639
640,490,150,1091,194300,58640
72,67,5,-,264600,58641
121,79,42,1208,270500,58642
77,54,23,617,87000,58643
111,60,51,775,250000,58645
500,394,106,608,92600,58646
484,406,78,867,147700,58647
137,90,47,563,70700,58649
165,133,32,703,97200,58650
254,224,30,620,87900,58651
466,445,21,-,173400,58652
321,266,55,750,114300,58653
106,82,24,-,112500,58654
227,190,37,888,197700,58655
181,160,21,533,168100,58656
13818,8305,5513,918,220000,58701
0,0,0,-,-,58702
9737,5832,3905,933,216800,58703
1494,11,1483,1605,-,58704
0,0,0,-,-,58705
0,0,0,-,-,58707
230,205,25,566,88500,58710
138,109,29,-,151800,58711
49,46,3,-,73800,58712
10,10,0,-,-,58713
63,60,3,-,209400,58716
425,384,41,460,170000,58718
220,174,46,700,101000,58721
637,531,106,994,180900,58722
99,83,16,382,114900,58723
133,118,15,1300,118100,58725
122,101,21,-,121900,58727
623,435,188,726,149100,58730
136,110,26,763,110400,58731
129,125,4,-,170800,58733
130,118,12,-,105600,58734
161,157,4,-,269100,58735
244,199,45,563,68700,58736
62,62,0,-,60000,58737
285,222,63,775,191700,58740
313,260,53,909,119400,58741
56,56,0,-,125000,58744
595,456,139,735,126400,58746
72,57,15,838,-,58748
197,151,46,619,161800,58750
125,67,58,594,109400,58752
58,52,6,-,377800,58755
97,84,13,365,131700,58756
179,109,70,463,131300,58757
108,105,3,-,91700,58758
334,285,49,-,169000,58759
130,105,25,-,133900,58760
374,299,75,738,128700,58761
103,83,20,444,110400,58762
1173,677,496,649,160900,58763
158,132,26,-,-,58765
115,106,9,-,241300,58768
99,83,16,631,155300,58769
500,306,194,731,160700,58770
236,200,36,825,121100,58771
88,71,17,690,81400,58772
340,289,51,1068,159900,58773
63,21,42,471,115600,58775
92,53,39,1091,-,58776
45,45,0,-,158800,58778
190,130,60,577,95700,58779
279,256,23,900,195500,58781
194,167,27,554,143800,58782
182,153,29,486,115600,58783
1200,841,359,1016,186800,58784
526,429,97,1542,239500,58785
73,73,0,-,111600,58787
541,464,77,478,88800,58788
139,99,40,850,62500,58789
731,549,182,557,184400,58790
127,97,30,-,173400,58792
232,193,39,425,99000,58793
68,41,27,-,114800,58794
80,51,29,-,-,58795
12657,6276,6381,969,253900,58801
105,99,6,-,154500,58830
173,128,45,1098,261900,58831
79,52,27,475,165000,58833
92,84,8,-,333300,58835
81,55,26,1077,-,58838
231,224,7,-,381800,58843
35,14,21,-,-,58844
143,123,20,625,163100,58845
136,106,30,-,186300,58847
355,293,62,676,180700,58849
719,474,245,1088,195500,58852
120,78,42,-,107300,58853
3273,1587,1686,1154,248600,58854
52,32,20,-,167900,58856
734,621,113,870,249700,59001
47,32,15,838,220000,59002
433,175,258,565,102300,59003
518,304,214,676,231100,59006
66,55,11,1208,169900,59007
224,182,42,788,158300,59008
87,51,36,-,167000,59010
1347,967,380,691,242900,59011
101,58,43,-,67100,59012
47,29,18,-,194300,59013
660,485,175,735,175700,59014
202,191,11,-,173100,59015
248,161,87,578,98300,59016
221,180,41,686,252100,59018
1603,1318,285,763,249300,59019
41,28,13,830,281300,59020
478,311,167,585,76500,59022
200,110,90,334,160000,59024
21,7,14,129,-,59025
96,70,26,-,143300,59026
371,245,126,950,333800,59027
225,157,68,872,352900,59028
367,342,25,950,201900,59029
684,304,380,678,291900,59030
75,61,14,-,176600,59031
236,185,51,553,154700,59032
99,86,13,-,314300,59033
1682,1033,649,612,142300,59034
75,62,13,-,78700,59035
543,415,128,613,94500,59036
725,696,29,878,203600,59037
282,202,80,615,113200,59038
18,11,7,-,-,59039
708,607,101,690,254300,59041
714,431,283,598,65200,59043
5031,3887,1144,840,225300,59044
170,121,49,859,89200,59046
5904,4128,1776,837,268200,59047
386,273,113,539,127300,59050
73,54,19,775,500000,59052
78,40,38,-,-,59053
136,98,38,619,152900,59054
32,14,18,-,175000,59055
316,301,15,-,349500,59057
12,12,0,-,165000,59058
82,60,22,-,-,59059
125,98,27,750,494100,59061
9,9,0,-,-,59062
759,592,167,713,252000,59063
85,10,75,937,-,59064
90,85,5,-,664100,59065
162,96,66,338,154200,59066
103,66,37,836,-,59067
1654,1105,549,787,288500,59068
235,197,38,860,243800,59069
409,326,83,941,263500,59070
54,33,21,-,360700,59071
1969,1411,558,771,178500,59072
175,148,27,675,117100,59074
84,63,21,-,158100,59075
31,14,17,1083,-,59076
24,18,6,-,-,59077
80,55,25,-,109700,59078
1331,1209,122,565,241200,59079
9,9,0,-,450000,59081
9,6,3,-,187500,59082
52,43,9,-,121900,59085
430,321,109,698,242200,59086
179,135,44,490,188500,59087
641,504,137,1027,235300,59088
138,85,53,546,190600,59089
17263,10292,6971,768,183100,59101
20748,13517,7231,966,219300,59102
12313,9017,3296,958,230600,59105
7303,5610,1693,1187,361400,59106
1546,988,558,450,121600,59201
44,38,6,-,110000,59211
166,135,31,733,178800,59212
213,146,67,264,52500,59213
54,39,15,-,-,59214
466,376,90,563,110400,59215
63,60,3,-,266700,59217
336,257,79,756,209800,59218
101,78,23,-,103100,59219
672,514,158,883,190700,59221
96,83,13,-,311000,59222
200,159,41,683,252300,59223
167,82,85,394,82000,59225
184,122,62,777,118300,59226
2004,1550,454,542,158100,59230
232,164,68,970,19800,59231
14,14,0,-,211100,59240
188,135,53,563,114600,59241
35,31,4,-,117800,59242
95,57,38,493,204400,59243
9,8,1,-,-,59244
172,127,45,725,99500,59247
337,272,65,640,152800,59248
120,68,52,288,110400,59250
30,23,7,-,85000,59252
30,30,0,-,366700,59253
981,779,202,730,153400,59254
908,494,414,378,78500,59255
21,21,0,-,-,59256
35,29,6,-,-,59257
54,38,16,-,77500,59258
150,120,30,500,77300,59259
54,43,11,-,171900,59260
259,202,57,344,97100,59261
238,188,50,658,166700,59262
714,545,169,517,113400,59263
3582,2280,1302,851,236900,59270
105,80,25,-,104200,59274
198,159,39,438,66300,59275
11,11,0,-,-,59276
4795,3281,1514,759,169500,59301
89,60,29,-,-,59311
12,10,2,-,-,59312
1108,780,328,770,164400,59313
38,20,18,-,370000,59314
38,35,3,-,-,59315
501,368,133,654,145200,59317
43,29,14,-,105400,59318
18,11,7,-,107500,59322
884,743,141,810,118700,59323
448,327,121,581,101000,59324
89,50,39,740,260700,59326
1093,816,277,565,153400,59327
3677,2481,1196,790,164500,59330
79,53,26,-,-,59332
3,3,0,-,-,59333
74,52,22,-,179200,59336
326,239,87,566,122800,59337
41,35,6,-,256300,59338
59,51,8,-,65000,59339
23,19,4,-,-,59343
182,149,33,800,203600,59344
142,116,26,-,171300,59347
439,376,63,-,103900,59349
83,69,14,-,87600,59351
498,397,101,817,113500,59353
17,17,0,-,230400,59354
6330,3288,3042,687,157700,59401
10826,8851,1975,814,203200,59404
13483,7181,6302,810,176400,59405
273,174,99,571,196600,59410
90,66,24,-,-,59411
668,516,152,754,183800,59412
429,238,191,597,119000,59414
117,96,21,-,93800,59416
2206,1231,975,423,99500,59417
26,14,12,-,-,59418
44,31,13,625,108800,59419
67,53,14,-,172900,59420
797,632,165,692,228600,59421
1118,718,400,775,181500,59422
5,5,0,-,-,59424
1389,1035,354,727,141900,59425
1689,1021,668,597,111700,59427
177,125,52,686,79300,59430
54,51,3,-,91000,59432
225,176,49,675,90800,59433
178,129,49,642,158200,59434
764,547,217,763,181600,59436
71,24,47,-,-,59440
16,14,2,-,-,59441
832,583,249,571,156300,59442
186,165,21,-,289100,59443
86,39,47,-,98800,59444
224,167,57,815,106300,59446
149,121,28,925,170300,59447
141,75,66,407,56300,59448
228,188,40,725,205500,59450
61,45,16,-,-,59451
242,206,36,617,156700,59452
126,103,23,625,115600,59453
97,76,21,433,68000,59454
88,44,44,-,-,59456
3906,2833,1073,776,140700,59457
98,82,16,-,47900,59460
7,7,0,-,-,59461
84,76,8,-,77000,59462
58,54,4,-,217600,59463
198,149,49,539,159600,59464
20,17,3,-,134400,59465
47,27,20,-,-,59466
46,37,9,-,236100,59467
245,198,47,835,201300,59468
52,46,6,-,-,59469
164,118,46,475,191700,59471
255,156,99,830,163200,59472
1316,755,561,537,152600,59474
123,86,37,686,169900,59477
343,211,132,449,106300,59479
195,143,52,-,154900,59480
236,161,75,680,118100,59482
219,183,36,757,232100,59483
55,32,23,-,120600,59484
237,235,2,-,196200,59485
430,331,99,590,141100,59486
524,394,130,751,158300,59487
138,97,41,717,-,59489
5270,3237,2033,650,157700,59501
410,284,126,614,97500,59520
990,428,562,309,67400,59521
693,405,288,571,115600,59522
960,658,302,514,137700,59523
243,169,74,500,71000,59524
97,70,27,580,104200,59525
802,383,419,459,81600,59526
279,150,129,428,41500,59527
132,93,39,671,68800,59528
87,42,45,-,219000,59529
37,31,6,-,47900,59530
109,103,6,-,76900,59531
76,54,22,-,113900,59532
34,13,21,-,-,59535
23,17,6,-,103100,59537
1193,921,272,559,137200,59538
129,87,42,578,103900,59540
67,45,22,368,73600,59542
70,39,31,286,212500,59544
43,39,4,-,92600,59545
53,47,6,-,-,59546
27,24,3,-,-,59547
13875,7850,6025,804,242400,59601
10258,8560,1698,981,259400,59602
106,91,15,513,168800,59631
589,394,195,648,208200,59632
89,86,3,-,273900,59633
1950,1789,161,1046,352400,59634
2765,2244,521,782,215400,59635
0,0,0,-,-,59636
269,239,30,547,244400,59638
537,419,118,664,169900,59639
29,29,0,-,202800,59640
30,17,13,-,-,59642
186,181,5,-,163900,59643
1659,1271,388,718,196900,59644
624,455,169,652,156800,59645
143,143,0,-,193800,59647
238,169,69,796,243500,59648
14431,9821,4610,639,146500,59701
38,33,5,-,436100,59703
113,82,31,588,240000,59710
3989,2717,1272,553,133100,59711
83,55,28,638,-,59713
8065,5756,2309,984,271400,59714
14434,7553,6881,942,474900,59715
911,479,432,1399,511700,59716
15708,9687,6021,1243,356800,59718
117,117,0,-,-,59720
207,157,50,850,237500,59721
1939,1343,596,754,134300,59722
36,22,14,-,195800,59724
3363,2254,1109,616,213000,59725
76,62,14,596,228600,59727
130,113,17,575,213200,59728
1148,877,271,813,330300,59729
901,674,227,1458,586300,59730
55,43,12,413,203600,59731
81,35,46,867,212500,59732
98,31,67,1023,268800,59733
99,80,19,-,314300,59735
55,40,15,-,-,59736
128,99,29,756,113800,59739
182,163,19,-,432900,59740
1843,1306,537,1202,301100,59741
62,45,17,-,213900,59743
46,43,3,-,164400,59745
79,72,7,-,305600,59746
78,64,14,-,242900,59747
93,89,4,-,173800,59748
739,611,128,636,219900,59749
168,158,10,-,238200,59750
94,52,42,931,154200,59751
1466,1077,389,1045,242400,59752
407,305,102,758,246400,59754
95,79,16,1000,203900,59755
10,0,10,-,-,59756
706,438,268,624,304700,59758
1580,1277,303,744,232400,59759
150,103,47,700,210300,59760
135,86,49,333,278600,59761
121,101,20,-,278300,59762
14519,5609,8910,822,254400,59801
9020,4374,4646,829,270700,59802
6572,5072,1500,924,326600,59803
3230,2158,1072,1063,336400,59804
8384,5328,3056,950,273000,59808
704,575,129,771,244900,59820
915,680,235,702,213800,59821
733,590,143,981,305200,59823
544,364,180,731,247300,59824
984,836,148,945,230900,59825
235,221,14,1000,416400,59826
119,95,24,-,165100,59827
2201,1770,431,743,280500,59828
1037,776,261,636,284000,59829
72,62,10,-,175000,59830
189,138,51,525,114100,59831
272,162,110,515,161400,59832
2210,1940,270,928,321300,59833
826,742,84,888,305500,59834
190,153,37,525,233100,59837
6050,4109,1941,775,249000,59840
188,145,43,571,211800,59841
38,38,0,-,183300,59842
120,57,63,620,310000,59843
295,246,49,741,290200,59844
612,429,183,498,124200,59845
667,630,37,-,401100,59846
2376,1924,452,906,254400,59847
60,38,22,-,162500,59848
55,55,0,-,-,59851
398,275,123,662,242200,59853
77,55,22,675,269400,59854
275,119,156,438,83800,59855
137,79,58,679,140600,59856
559,490,69,788,224500,59858
1371,1107,264,641,257500,59859
4405,3048,1357,739,257100,59860
59,52,7,-,94300,59863
2587,1745,842,645,201900,59864
1279,959,320,616,230600,59865
342,222,120,586,164400,59866
35,9,26,-,-,59867
821,728,93,754,237600,59868
4402,3542,860,766,309800,59870
127,72,55,841,278300,59871
944,714,230,303,167900,59872
1376,1088,288,684,226900,59873
640,538,102,449,254600,59874
1535,1263,272,672,262600,59875
20783,15144,5639,853,255500,59901
194,177,17,-,235600,59910
3593,2920,673,983,361600,59911
5948,4597,1351,753,238000,59912
270,252,18,-,287500,59913
126,106,20,958,475000,59914
157,94,63,-,-,59915
71,71,0,-,330000,59916
1771,1413,358,779,254300,59917
269,220,49,743,330300,59918
272,200,72,1059,102900,59919
607,513,94,643,304700,59920
992,817,175,591,432000,59922
4131,3243,888,701,169700,59923
479,423,56,869,280100,59925
197,137,60,588,-,59926
143,92,51,542,295200,59927
80,61,19,-,431000,59928
98,83,15,-,326200,59929
245,210,35,-,155100,59930
136,110,26,-,645200,59931
608,561,47,808,228100,59932
23,23,0,-,580900,59933
225,211,14,-,245500,59934
1458,1205,253,696,215200,59935
132,95,37,671,434600,59936
5830,3960,1870,991,386700,59937
9023,7095,1928,1030,216300,60002
19910,15657,4253,1392,363200,60004
12663,8169,4494,1242,341300,60005
13390,9882,3508,1244,273800,60007
8129,5585,2544,1339,234600,60008
16773,15098,1675,1545,541400,60010
3690,3433,257,2080,314500,60012
9332,8236,1096,1227,235900,60013
17460,13679,3781,1258,225100,60014
9769,8100,1669,1799,531300,60015
22938,14839,8099,1155,234700,60016
9992,7099,2893,1035,249700,60018
4657,3272,1385,1054,152100,60020
2084,1763,321,1066,239000,60021
3076,2923,153,1238,945600,60022
15172,12399,2773,1350,444200,60025
5300,3790,1510,1782,585400,60026
136,129,7,-,869700,60029
14175,11060,3115,1234,219400,60030
14103,10037,4066,1224,249200,60031
4724,2998,1726,981,154500,60033
751,500,251,1062,180200,60034
11481,9428,2053,1754,584700,60035
1897,704,1193,1287,354800,60040
3291,2797,494,1146,173500,60041
3271,2669,602,1383,171100,60042
777,740,37,2906,1121100,60043
3976,2718,1258,1419,497200,60044
7605,6567,1038,1962,827800,60045
12300,10005,2295,1284,222200,60046
13892,12617,1275,1610,447800,60047
10326,8618,1708,1392,460300,60048
12413,8790,3623,1239,177000,60050
8650,6866,1784,1364,206500,60051
8394,7527,867,1823,317200,60053
20764,14445,6319,1132,328900,60056
12914,9839,3075,1398,250900,60060
9900,6503,3397,1589,352000,60061
16143,13266,2877,1529,507900,60062
5108,2072,3036,968,101000,60064
15364,11958,3406,1298,366700,60067
14185,11889,2296,1433,437300,60068
3407,2814,593,2756,467200,60069
5625,3781,1844,1099,282000,60070
1486,986,500,946,249600,60071
375,351,24,1188,305600,60072
18938,14803,4135,1312,161900,60073
14573,8902,5671,1133,241400,60074
10680,8220,2460,1319,326600,60076
10146,6114,4032,1224,279800,60077
3275,2864,411,1259,285000,60081
3599,3152,447,1656,260400,60083
6356,4854,1502,1162,230600,60084
23235,9415,13820,933,113000,60085
9416,6009,3407,1081,140400,60087
1165,0,1165,1685,-,60088
15384,12261,3123,1646,332300,60089
14441,8762,5679,1265,198700,60090
9696,8461,1235,1484,706600,60091
6816,6013,803,1813,957900,60093
2536,1980,556,1069,196600,60096
4409,3607,802,1183,165700,60097
12242,8134,4108,1056,205900,60098
10284,6397,3887,1050,133900,60099
13245,8836,4409,1067,250900,60101
11791,10245,1546,1697,254600,60102
13966,11859,2107,1576,281100,60103
6212,4297,1915,1062,151200,60104
7275,3945,3330,1131,224700,60106
13180,10949,2231,1743,192800,60107
8642,6345,2297,1399,303900,60108
216,146,70,1258,191700,60109
10971,7683,3288,1164,171800,60110
84,77,7,-,287000,60111
1442,1070,372,1218,154100,60112
121,77,44,906,114000,60113
16427,6609,9818,898,161000,60115
6458,4797,1661,1311,264600,60118
3639,3210,429,1330,321000,60119
15482,10170,5312,1083,169600,60120
16856,11244,5612,1036,173900,60123
7823,7433,390,1869,300700,60124
17053,13808,3245,1513,424600,60126
140,115,25,933,140300,60129
6996,3613,3383,1079,234100,60130
6015,4406,1609,872,204000,60131
11340,8405,2935,1254,195400,60133
10409,8905,1504,1534,358600,60134
2586,1665,921,891,174400,60135
2555,2353,202,2045,261300,60136
14346,11339,3007,1121,394800,60137
11414,7301,4113,1272,194700,60139
6392,5347,1045,1479,272800,60140
101,0,101,-,-,60141
12363,11044,1319,1231,256000,60142
4459,3399,1060,1272,333600,60143
28,19,9,1125,265600,60144
862,650,212,1108,195100,60145
963,725,238,873,155900,60146
20530,14536,5994,1390,264200,60148
744,506,238,914,158100,60150
1578,1270,308,1391,224000,60151
4484,3452,1032,950,192900,60152
7795,4757,3038,965,151300,60153
6478,5943,535,1431,241100,60154
2942,2071,871,1069,158900,60155
9691,7946,1745,1409,227100,60156
979,963,16,-,386000,60157
7891,3979,3912,997,192000,60160
2681,1656,1025,1181,171800,60162
1768,1534,234,956,178700,60163
6724,4734,1990,950,177800,60164
1281,699,582,1099,118500,60165
11659,7942,3717,1351,242100,60169
3643,2303,1340,972,211200,60171
9089,6843,2246,1442,259000,60172
5672,2008,3664,1440,298000,60173
12411,8583,3828,1276,282100,60174
8119,7857,262,2299,409600,60175
4304,2536,1768,1031,203200,60176
7644,6265,1379,1415,234800,60177
8354,5593,2761,979,202400,60178
567,433,134,2128,251200,60180
10729,7432,3297,1252,240200,60181
887,842,45,3500,526800,60184
10671,7976,2695,1108,264500,60185
9883,7210,2673,1362,365000,60187
14822,10254,4568,1195,254300,60188
11508,8900,2608,1470,369000,60189
4436,4100,336,2075,313800,60190
5168,4049,1119,1248,239100,60191
5369,4793,576,2256,352400,60192
15161,11645,3516,1402,265500,60193
7756,5429,2327,1473,225800,60194
1948,654,1294,1463,186400,60195
15045,8851,6194,1483,494100,60201
13307,6945,6362,1310,327800,60202
1530,1398,132,1794,456100,60203
1681,325,1356,1977,197300,60301
13530,7964,5566,1114,401300,60302
6392,4563,1829,1156,383500,60304
3971,3525,446,1143,596900,60305
3040,2600,440,1041,176400,60401
20400,12385,8015,972,208600,60402
7174,4763,2411,1136,169400,60403
6566,5807,759,1636,258400,60404
8561,4222,4339,884,119200,60406
598,447,151,1044,134500,60407
2108,1564,544,979,166000,60408
13843,7562,6281,967,106000,60409
4386,3892,494,1327,220900,60410
19514,12145,7369,964,104300,60411
5223,2859,2364,996,160500,60415
3592,2610,982,1031,205000,60416
5656,4917,739,1075,187000,60417
7805,5116,2689,1284,102500,60419
2019,1398,621,714,127000,60420
1450,1365,85,1026,191500,60421
3681,3272,409,2059,239100,60422
10555,9877,678,1244,321000,60423
936,711,225,890,153600,60424
2958,2240,718,1549,128400,60425
9830,5425,4405,953,72900,60426
4010,2895,1115,1259,91300,60428
5547,3400,2147,1559,113300,60429
7611,5837,1774,1155,162700,60430
7648,6703,945,1435,195700,60431
6061,3142,2919,960,114000,60432
5464,3239,2225,1040,118300,60433
18408,11639,6769,990,159900,60435
5918,3594,2324,1054,120000,60436
70,60,10,-,112500,60437
11146,7314,3832,1001,130100,60438
8287,6992,1295,1122,371400,60439
16843,12686,4157,1354,194000,60440
11933,9566,2367,1197,224500,60441
3471,3006,465,1223,259500,60442
8197,6610,1587,1238,159500,60443
717,517,200,938,173000,60444
10500,7845,2655,971,152000,60445
11609,9694,1915,1571,186800,60446
4744,4224,520,1289,209600,60447
9075,8150,925,1178,310400,60448
3801,3533,268,895,198800,60449
8649,5288,3361,964,215900,60450
11921,10834,1087,1178,289400,60451
10306,8008,2298,1080,195400,60452
21262,16901,4361,1071,204000,60453
5558,3887,1671,966,183400,60455
1697,1396,301,-,117100,60456
4959,3487,1472,950,229700,60457
5246,2723,2523,1098,169100,60458
9215,7021,2194,1111,192600,60459
529,400,129,909,118900,60460
1799,1511,288,1819,227200,60461
15423,12861,2562,1245,272000,60462
5433,5142,291,1553,279500,60463
3839,3399,440,1818,409700,60464
6725,5135,1590,1035,203800,60465
8704,5258,3446,1211,74700,60466
9716,9175,541,1243,338100,60467
2215,1723,492,927,212100,60468
1906,1310,596,1083,121300,60469
229,191,38,815,107300,60470
4937,2733,2204,1070,146700,60471
1539,808,731,884,76400,60472
7162,6006,1156,1508,150300,60473
365,291,74,921,127500,60474
4181,2795,1386,964,106800,60475
1083,817,266,964,106300,60476
15011,11739,3272,1195,210900,60477
5893,4742,1151,1345,131600,60478
374,273,101,1096,167500,60479
2070,1680,390,1142,305000,60480
4759,3716,1043,889,171100,60481
4167,2707,1460,964,169000,60482
2321,1303,1018,969,124100,60484
8886,8228,658,1105,262100,60487
6078,5851,227,2665,291700,60490
7684,7164,520,1211,332600,60491
3534,1875,1659,873,174100,60501
7765,6137,1628,1622,303100,60502
5231,4590,641,1840,248700,60503
13332,8010,5322,1616,204500,60504
21682,12583,9099,1081,128600,60505
18411,11786,6625,1060,173700,60506
10780,8288,2492,1188,309700,60510
634,551,83,1168,235300,60511
429,375,54,-,171900,60512
7056,5606,1450,1024,245200,60513
3826,3031,795,984,480300,60514
11574,8871,2703,1177,368900,60515
11983,9387,2596,1373,341000,60516
12846,8467,4379,1325,267500,60517
1443,1059,384,808,133700,60518
17,17,0,-,-,60519
1071,804,267,965,225500,60520
6082,5261,821,1927,869800,60521
4374,3587,787,610,701200,60523
11646,9322,2324,1106,362700,60525
5068,3632,1436,1163,362000,60526
11490,9325,2165,1526,414400,60527
188,140,48,900,125000,60530
728,572,156,906,183300,60531
12295,7310,4985,1279,325500,60532
3759,2228,1531,979,169800,60534
49,36,13,1125,203800,60536
221,199,22,747,174800,60537
8990,7324,1666,1396,194100,60538
0,0,0,-,-,60539
15975,12316,3659,1463,421600,60540
1161,973,188,981,251900,60541
6877,5393,1484,1174,246700,60542
13294,11261,2033,1487,255400,60543
9563,7931,1632,1694,233800,60544
4560,3572,988,952,174900,60545
5848,4313,1535,1107,294900,60546
4366,3412,954,1150,171200,60548
74,74,0,-,217500,60549
658,470,188,821,182800,60550
1480,1185,295,804,206700,60551
1637,1164,473,1087,191500,60552
310,255,55,900,156000,60553
4414,3964,450,1154,291100,60554
5003,4013,990,1436,224000,60555
737,588,149,785,170500,60556
94,94,0,-,115100,60557
4331,4179,152,2009,609900,60558
10337,5768,4569,1178,290600,60559
8524,6850,1674,1186,264600,60560
9107,7675,1432,1262,328600,60561
15078,8326,6752,1469,347700,60563
13447,11793,1654,1913,451300,60564
13782,12265,1517,1427,392300,60565
7124,6459,665,2040,340100,60585
13576,12496,1080,1801,224400,60586
8941,2982,5959,2289,519400,60601
597,252,345,2713,-,60602
552,316,236,2288,672700,60603
501,145,356,2106,485900,60604
14942,7306,7636,2053,398900,60605
2201,985,1216,2215,402500,60606
12755,5332,7423,1985,396400,60607
25921,9679,16242,960,265400,60608
20890,7838,13052,808,181400,60609
23708,9321,14387,1659,451900,60610
21018,9813,11205,2017,549400,60611
13236,3674,9562,1036,287100,60612
27072,10863,16209,1376,342800,60613
33602,15088,18514,1669,629900,60614
21444,6534,14910,1141,231700,60615
24569,9219,15350,1021,327900,60616
28792,15849,12943,846,133500,60617
35358,16848,18510,1212,407400,60618
26521,11190,15331,891,161100,60619
25323,11853,13470,903,143500,60620
10749,2476,8273,824,114000,60621
23810,8963,14847,1524,492400,60622
24996,8374,16622,873,160800,60623
11948,2993,8955,951,176400,60624
29668,11674,17994,1188,350500,60625
22995,5593,17402,1006,210200,60626
22864,12757,10107,959,120600,60628
31927,18310,13617,926,166500,60629
20872,13556,7316,1101,301200,60630
12043,8925,3118,1168,356900,60631
25013,13396,11617,895,180000,60632
4720,3267,1453,888,126900,60633
25981,19067,6914,1113,264300,60634
10995,4947,6048,884,95900,60636
19459,4878,14581,972,197300,60637
20245,15584,4661,999,217200,60638
25613,12340,13273,1015,234100,60639
35466,11449,24017,1084,306200,60640
24557,12947,11610,1043,296600,60641
9491,3649,5842,1793,450800,60642
17924,13388,4536,1029,194800,60643
16736,4680,12056,938,175600,60644
16004,8208,7796,1149,281700,60645
10953,8290,2663,1076,419100,60646
35383,13464,21919,1286,402100,60647
21460,4660,16800,916,158500,60649
19860,8738,11122,1038,171600,60651
13476,11118,2358,1139,175300,60652
14987,3763,11224,797,290800,60653
12591,5099,7492,2226,457100,60654
10190,8810,1380,1108,256400,60655
12079,7476,4603,1158,296700,60656
37088,14600,22488,1513,457800,60657
13485,5479,8006,1171,305200,60659
21084,7740,13344,1045,251300,60660
6200,1917,4283,2034,380900,60661
8817,6715,2102,1030,280500,60706
15354,10228,5126,1095,265500,60707
4298,3580,718,1894,396100,60712
10950,8200,2750,1141,284400,60714
8726,5544,3182,962,167200,60803
22362,11116,11246,940,165200,60804
6981,5442,1539,1182,193300,60805
10878,4444,6434,854,87600,60827
12753,7467,5286,840,116300,60901
211,143,68,861,96600,60910
504,387,117,919,144200,60911
219,192,27,700,92700,60912
611,550,61,685,186900,60913
10098,7226,2872,970,174700,60914
3810,2411,1399,935,117400,60915
181,160,21,1261,146500,60917
349,310,39,692,80600,60918
220,182,38,975,98000,60919
69,61,8,525,92500,60920
616,422,194,550,75300,60921
975,733,242,843,125900,60922
672,513,159,604,117500,60924
21,21,0,-,73100,60926
859,648,211,913,135300,60927
300,246,54,825,95900,60928
305,195,110,672,92500,60929
339,270,69,879,120500,60930
218,184,34,689,103900,60931
41,33,8,-,80800,60932
139,94,45,733,80000,60933
117,99,18,500,-,60934
383,357,26,1141,216500,60935
1907,1304,603,654,124100,60936
778,572,206,684,109200,60938
1263,1050,213,931,227300,60940
799,678,121,800,172200,60941
2465,1816,649,615,66700,60942
76,67,9,910,77000,60945
167,130,37,708,88600,60946
672,598,74,663,194000,60948
211,145,66,638,74800,60949
4351,3113,1238,871,170600,60950
323,225,98,804,143100,60951
257,224,33,668,84300,60952
1012,794,218,610,75900,60953
2040,1496,544,866,139100,60954
601,525,76,627,103700,60955
2128,1559,569,659,103200,60957
669,407,262,768,76600,60958
481,333,148,745,85400,60959
388,339,49,661,64200,60960
283,260,23,925,123100,60961
229,150,79,743,60700,60962
642,445,197,638,79600,60963
1929,1422,507,717,137100,60964
635,530,105,725,65200,60966
166,142,24,617,85600,60968
22,16,6,-,108300,60969
3153,2094,1059,652,89200,60970
132,99,33,685,65000,60973
100,81,19,725,82500,60974
495,424,71,840,163400,61001
735,516,219,828,132800,61006
212,155,57,733,120600,61007
12032,9252,2780,773,141300,61008
2980,2315,665,788,174300,61010
909,886,23,1320,211600,61011
841,672,169,910,144100,61012
193,167,26,490,91700,61013
445,351,94,731,98100,61014
341,251,90,579,250700,61015
1946,1617,329,747,167200,61016
413,322,91,722,104500,61018
1333,1201,132,903,161300,61019
993,888,105,962,154800,61020
8894,6302,2592,675,118900,61021
967,779,188,680,141500,61024
2032,1526,506,676,144600,61025
35,0,35,-,-,61027
1026,788,238,751,141200,61028
920,689,231,690,105200,61030
614,457,157,704,114500,61031
13221,8465,4756,653,84200,61032
3028,2431,597,679,223600,61036
35,35,0,-,79400,61037
444,414,30,-,185500,61038
351,253,98,771,115200,61039
612,382,230,633,104100,61041
294,212,82,470,127300,61042
38,19,19,790,127500,61043
117,101,16,-,89100,61044
1033,834,199,622,153000,61046
688,555,133,781,168500,61047
1694,1421,273,505,111600,61048
208,184,24,779,170600,61049
154,137,17,-,82500,61050
702,507,195,657,110900,61051
375,352,23,917,181500,61052
1173,938,235,617,110900,61053
1748,1055,693,711,96400,61054
39,39,0,-,-,61057
73,57,16,843,99200,61059
639,464,175,533,116200,61060
2995,2200,795,598,152100,61061
754,630,124,733,140700,61062
1766,1465,301,835,132100,61063
1655,1175,480,706,120600,61064
3456,2945,511,1426,146800,61065
354,279,75,824,181000,61067
5738,3575,2163,775,124700,61068
527,473,54,811,138800,61070
5692,4108,1584,726,89600,61071
4354,3715,639,788,167400,61072
7108,6086,1022,1079,171600,61073
2157,1550,607,615,80600,61074
443,389,54,693,155100,61075
16,16,0,-,-,61077
508,419,89,578,117600,61078
65,62,3,-,96000,61079
4000,3062,938,754,131500,61080
8651,6011,2640,678,106200,61081
1236,1109,127,978,163100,61084
1446,1148,298,675,97400,61085
706,571,135,559,86500,61087
2425,2141,284,838,157800,61088
332,265,67,613,112500,61089
31,31,0,-,-,61091
7552,4085,3467,715,69000,61101
6136,3853,2283,734,73600,61102
10248,5493,4755,739,85600,61103
7768,2432,5336,696,55500,61104
13230,8706,4524,870,124900,61107
11476,7570,3906,858,99200,61108
10918,6639,4279,771,105600,61109
9661,6599,3062,849,109200,61111
55,0,55,-,-,61112
6667,4852,1815,968,154400,61114
8871,6882,1989,957,119900,61115
15547,9529,6018,729,104300,61201
470,420,50,755,130500,61230
2231,1523,708,622,108000,61231
585,522,63,788,142400,61232
547,411,136,670,123500,61234
582,465,117,931,118500,61235
38,29,9,-,88800,61236
1235,1076,159,808,114500,61238
501,182,319,827,97400,61239
2473,2185,288,1189,180200,61240
2849,2486,363,831,139400,61241
537,453,84,760,148600,61242
118,110,8,-,-,61243
9031,6296,2735,668,113200,61244
1033,849,184,648,144400,61250
147,147,0,-,167200,61251
2295,1866,429,670,135000,61252
4398,3542,856,737,168900,61254
857,706,151,926,150800,61256
394,331,63,723,101000,61257
63,57,6,-,57200,61258
455,382,73,1021,184100,61259
402,320,82,663,93300,61260
326,251,75,900,85000,61261
436,401,35,728,137500,61262
249,165,84,598,96300,61263
4670,3497,1173,723,123000,61264
19174,12821,6353,766,119300,61265
2912,2377,535,771,124800,61270
517,437,80,684,92400,61272
1245,1090,155,738,150000,61273
115,80,35,-,110400,61274
1866,1525,341,608,213100,61275
28,28,0,-,143400,61276
1288,1067,221,704,110300,61277
179,168,11,671,193800,61278
421,327,94,867,116000,61279
996,899,97,833,159200,61281
3470,1846,1624,802,118200,61282
567,435,132,571,88600,61283
853,770,83,1198,181600,61284
648,560,88,827,131700,61285
4059,2557,1502,826,100300,61301
1633,1245,388,728,115000,61310
96,86,10,-,122200,61311
196,163,33,1156,115900,61312
84,76,8,-,127100,61313
371,307,64,828,78000,61314
81,50,31,681,48500,61315
120,96,24,781,80000,61316
173,142,31,777,78100,61317
311,210,101,685,135000,61318
584,503,81,785,123400,61319
297,243,54,808,127900,61320
116,101,15,-,86300,61321
558,388,170,724,52100,61322
28,26,2,-,56700,61323
61,61,0,-,89000,61324
430,366,64,686,119400,61325
959,788,171,711,113900,61326
515,387,128,765,173200,61327
9,9,0,-,-,61328
528,474,54,757,103000,61329
557,474,83,683,129700,61330
10,10,0,-,-,61331
52,50,2,-,76400,61332
143,141,2,-,96500,61333
290,220,70,900,96500,61334
152,130,22,722,122400,61335
215,160,55,681,110900,61336
179,143,36,846,85000,61337
114,77,37,588,81200,61338
123,104,19,763,109600,61340
3278,2484,794,936,148200,61341
3401,2316,1085,580,120700,61342
152,116,36,788,60000,61344
310,277,33,803,106600,61345
31,28,3,-,63300,61346
1968,1574,394,564,108000,61348
415,339,76,725,91200,61349
10298,6656,3642,834,138000,61350
522,426,96,691,129800,61353
4587,3225,1362,747,129300,61354
4639,3505,1134,649,135500,61356
139,121,18,663,73900,61358
131,117,14,763,87500,61359
1114,865,249,879,168000,61360
487,384,103,686,92700,61361
2382,1581,801,547,119500,61362
141,104,37,400,82700,61363
8367,6163,2204,658,82900,61364
363,269,94,838,147100,61367
554,455,99,719,107200,61368
689,577,112,647,88600,61369
599,452,147,600,150000,61370
62,47,15,658,120800,61372
902,768,134,874,190500,61373
43,29,14,-,68600,61374
526,499,27,592,131800,61375
836,660,176,655,110300,61376
615,431,184,610,110400,61377
150,146,4,-,119800,61378
499,406,93,748,82600,61379
13472,8099,5373,635,78300,61401
1542,1108,434,547,65300,61410
218,173,45,731,100300,61411
589,541,48,665,74000,61412
410,339,71,720,115800,61413
398,304,94,619,77500,61414
761,638,123,615,90800,61415
111,87,24,-,29600,61416
114,103,11,-,75500,61417
268,227,41,733,88400,61418
64,51,13,675,77900,61419
475,405,70,581,80800,61420
570,451,119,750,86500,61421
1226,948,278,446,78700,61422
284,205,79,-,104200,61423
35,22,13,-,67300,61424
201,194,7,-,103300,61425
49,49,0,-,118000,61426
842,730,112,714,97700,61427
417,411,6,-,189200,61428
314,230,84,670,103300,61430
111,93,18,481,127300,61431
267,244,23,-,87000,61432
36,28,8,-,-,61433
1356,1057,299,525,75100,61434
12,12,0,-,-,61435
314,264,50,643,111400,61436
335,282,53,385,106900,61437
320,279,41,661,106900,61438
103,86,17,721,83500,61439
305,281,24,933,72400,61440
404,345,59,560,80800,61441
271,238,33,658,62900,61442
5530,3713,1817,616,64900,61443
410,385,25,588,86300,61447
1378,1113,265,673,114200,61448
166,145,21,488,53600,61449
735,629,106,631,75300,61450
108,105,3,-,103500,61451
111,111,0,-,53000,61452
251,192,59,598,67700,61453
213,143,70,575,68800,61454
7186,4071,3115,693,108500,61455
317,280,37,1008,83400,61458
164,148,16,-,95200,61459
131,113,18,683,94500,61460
4509,3182,1327,623,82800,61462
509,434,75,516,89200,61465
127,109,18,497,74500,61466
421,321,100,815,100200,61467
54,54,0,-,66100,61468
1020,835,185,544,83200,61469
176,159,17,613,77500,61470
38,38,0,-,46400,61471
274,244,30,624,148400,61472
598,444,154,550,78300,61473
108,82,26,758,55600,61474
120,104,16,475,115200,61475
180,167,13,-,81700,61476
243,204,39,763,78900,61477
118,118,0,-,118300,61478
28,28,0,-,-,61479
465,319,146,540,101700,61480
268,216,52,668,61400,61482
836,654,182,619,85800,61483
373,339,34,717,54300,61484
205,152,53,688,74000,61485
599,483,116,647,113900,61486
494,391,103,505,91200,61488
365,282,83,536,79500,61489
452,370,82,705,96400,61490
877,692,185,601,96800,61491
693,638,55,610,54400,61501
298,246,52,667,114700,61516
1258,1070,188,-,232300,61517
101,77,24,630,97900,61519
6331,4553,1778,618,100200,61520
4311,3380,931,806,142900,61523
121,82,39,836,77300,61524
3072,2575,497,999,276400,61525
271,271,0,-,211900,61526
1041,901,140,1219,259800,61528
1040,813,227,642,142400,61529
2473,1649,824,609,148700,61530
1338,1093,245,744,102500,61531
235,193,42,728,84400,61532
894,725,169,655,137500,61533
667,592,75,747,142200,61534
689,672,17,-,213000,61535
1179,943,236,684,159300,61536
1166,929,237,547,97700,61537
71,56,15,694,59300,61539
1046,857,189,750,101800,61540
41,40,1,-,67500,61541
1511,1191,320,590,95500,61542
63,48,15,595,50800,61543
284,239,45,980,69600,61544
259,240,19,-,116100,61545
1591,1337,254,717,113500,61546
1476,1398,78,1013,194200,61547
4488,3925,563,935,212500,61548
7557,5775,1782,872,201000,61550
74,74,0,-,87300,61552
80,60,20,670,63300,61553
17198,12486,4712,677,109700,61554
1148,945,203,819,162000,61559
276,238,38,654,165800,61560
965,791,174,721,131900,61561
27,27,0,-,-,61562
224,190,34,663,56300,61563
378,311,67,766,80900,61564
642,557,85,680,140300,61565
246,196,50,853,101100,61567
1533,1235,298,663,183200,61568
465,457,8,-,157600,61569
764,612,152,739,92700,61570
9837,7648,2189,854,171400,61571
578,398,180,781,87100,61572
521,83,438,530,226800,61602
6243,2949,3294,841,67400,61603
12344,8330,4014,750,89100,61604
5869,2181,3688,711,37300,61605
2298,971,1327,716,118400,61606
4334,3873,461,867,130000,61607
2027,1527,500,622,82400,61610
10417,7881,2536,723,146200,61611
12749,8069,4680,824,149200,61614
9764,5974,3790,892,177100,61615
2763,1554,1209,731,82800,61616
0,0,0,-,-,61625
15139,8122,7017,776,116800,61701
14759,9801,4958,922,202300,61704
4536,3798,738,968,264500,61705
69,57,12,867,86300,61720
229,188,41,906,108600,61721
186,153,33,1042,99700,61722
1047,885,162,752,111200,61723
207,174,33,829,100000,61724
593,576,17,788,202000,61725
989,704,285,750,116300,61726
4042,3090,952,578,94900,61727
500,387,113,698,117300,61728
399,364,35,817,197300,61729
161,128,33,1044,129000,61730
59,43,16,-,-,61731
730,645,85,733,143500,61732
351,261,90,933,146500,61733
1134,896,238,724,122900,61734
154,141,13,625,212500,61735
645,582,63,950,241800,61736
184,157,27,685,122800,61737
1578,1258,320,792,145000,61738
1899,1388,511,701,118300,61739
583,469,114,766,114000,61740
612,477,135,625,116200,61741
485,432,53,624,211300,61742
76,67,9,-,89200,61743
709,603,106,710,127000,61744
1623,1326,297,697,164200,61745
576,434,142,880,146200,61747
975,910,65,853,180500,61748
245,180,65,711,76200,61749
57,40,17,-,67400,61750
43,35,8,-,79400,61751
1691,1402,289,601,146600,61752
1176,970,206,712,172800,61753
427,349,78,1042,116000,61754
1865,1658,207,805,178600,61755
863,720,143,651,104400,61756
612,494,118,835,131300,61759
937,760,177,809,111600,61760
19483,10808,8675,874,170200,61761
5165,3473,1692,721,104700,61764
240,201,39,646,83300,61769
441,352,89,738,109500,61770
302,288,14,875,130800,61771
101,83,18,-,230600,61772
190,147,43,641,87500,61773
358,321,37,813,113900,61774
114,89,25,879,-,61775
488,412,76,1066,171200,61776
361,315,46,678,121900,61777
241,232,9,730,78800,61778
11617,3640,7977,834,153000,61801
8975,5196,3779,833,131400,61802
114,89,25,761,87100,61810
256,205,51,986,94400,61811
161,143,18,569,90600,61812
658,521,137,700,96700,61813
434,377,57,773,108600,61814
119,92,27,721,110700,61815
179,166,13,850,97300,61816
1119,853,266,695,104500,61817
677,577,100,650,100700,61818
14369,2967,11402,882,136800,61820
13410,7285,6125,974,139400,61821
9922,7010,2912,1158,225000,61822
171,151,20,733,110100,61830
62,62,0,-,90000,61831
14210,8308,5902,687,64900,61832
1003,716,287,744,67500,61833
2748,2295,453,717,129500,61834
248,201,47,750,88100,61839
239,213,26,-,247700,61840
527,487,40,588,114600,61841
1195,939,256,878,125600,61842
902,751,151,732,135000,61843
325,299,26,725,98900,61844
148,136,12,-,-,61845
2118,1557,561,662,80000,61846
518,455,63,642,150800,61847
80,58,22,642,68000,61848
793,685,108,717,125800,61849
186,177,9,629,58600,61850
163,134,29,620,102100,61851
71,65,6,-,53800,61852
4976,4141,835,956,220400,61853
527,449,78,863,131300,61854
64,64,0,-,-,61855
3180,2527,653,965,176900,61856
71,61,10,625,55000,61857
1162,982,180,720,107500,61858
494,443,51,956,136400,61859
229,191,38,663,169000,61862
332,290,42,1063,148500,61863
632,566,66,750,163000,61864
597,490,107,628,98000,61865
5294,2662,2632,773,91900,61866
541,407,134,719,74800,61870
139,125,14,1300,151400,61871
249,224,25,733,122900,61872
2162,1871,291,784,192900,61873
3281,1708,1573,937,226800,61874
349,304,45,863,240800,61875
260,239,21,629,77700,61876
664,562,102,863,161700,61877
573,440,133,713,106800,61878
1517,1295,222,609,148500,61880
303,277,26,767,87500,61882
1691,1301,390,591,77400,61883
418,392,26,572,213400,61884
1536,1043,493,730,122600,61910
1676,1271,405,710,132900,61911
557,468,89,626,84500,61912
592,508,84,582,88100,61913
815,688,127,635,92700,61914
276,201,75,857,68500,61917
365,321,44,783,138000,61919
9109,4967,4142,723,112100,61920
978,782,196,575,82900,61924
261,228,33,529,145800,61925
303,254,49,900,69500,61928
324,251,73,625,88600,61929
303,239,64,758,69300,61930
435,372,63,707,104900,61931
211,169,42,675,68200,61932
429,313,116,326,64500,61933
115,107,8,-,117400,61936
862,617,245,543,82800,61937
9331,5836,3495,658,92400,61938
107,93,14,-,37800,61940
48,7,41,-,-,61941
417,358,59,684,72700,61942
693,544,149,643,81500,61943
5248,3967,1281,617,87000,61944
73,55,18,533,58300,61949
3242,2532,710,731,121100,61951
2614,1781,833,728,121100,61953
80,63,17,1073,54100,61955
1142,951,191,759,94800,61956
752,609,143,722,80600,61957
654,522,132,615,167200,62001
13568,8792,4776,787,93300,62002
155,155,0,-,138400,62006
683,481,202,718,70100,62009
4576,3481,1095,831,140400,62010
108,106,2,-,-,62011
2559,2284,275,746,146200,62012
214,181,33,725,120400,62013
1589,1256,333,731,140200,62014
249,186,63,788,84400,62015
1367,985,382,717,96200,62016
505,423,82,494,83300,62017
1279,889,390,733,70500,62018
142,107,35,907,118100,62019
479,468,11,-,189700,62021
470,439,31,-,173200,62022
41,41,0,-,63500,62023
4287,2969,1318,796,109100,62024
12072,8897,3175,958,225500,62025
256,236,20,-,106100,62027
277,241,36,696,143500,62028
67,38,29,1008,70000,62030
324,302,22,-,103600,62031
313,298,15,700,83900,62032
1998,1492,506,694,85000,62033
5414,4047,1367,1019,220700,62034
6781,5372,1409,938,144200,62035
305,275,30,692,159200,62036
824,725,99,820,182400,62037
17720,12022,5698,769,85600,62040
832,693,139,581,92100,62044
148,141,7,325,-,62045
275,212,63,915,189700,62046
538,440,98,575,114000,62047
710,540,170,901,79600,62048
2593,1931,662,667,89100,62049
122,80,42,708,72000,62050
361,260,101,767,77600,62051
4843,3618,1225,621,139500,62052
198,157,41,546,78300,62053
182,137,45,613,85900,62054
3759,2750,1009,582,90900,62056
357,224,133,726,80000,62058
182,78,104,382,33400,62059
1970,1003,967,730,43400,62060
664,535,129,824,179900,62061
3366,2651,715,934,207000,62062
467,347,120,687,113200,62063
45,45,0,-,-,62065
879,739,140,618,161400,62067
1391,1179,212,790,75600,62069
6,6,0,-,-,62070
426,411,15,785,145800,62074
1452,1146,306,692,77200,62075
62,50,12,-,86000,62076
133,112,21,863,59300,62077
33,29,4,-,45000,62078
118,109,9,-,-,62079
921,818,103,633,87800,62080
132,128,4,-,75800,62081
996,792,204,676,74000,62082
65,65,0,-,132000,62083
630,404,226,785,80100,62084
61,43,18,738,75000,62085
562,494,68,629,91500,62086
796,507,289,671,76400,62087
2892,2065,827,708,113200,62088
207,148,59,653,72700,62089
560,198,362,682,45600,62090
141,114,27,-,72500,62091
1149,869,280,505,61300,62092
193,155,38,778,53100,62093
441,354,87,553,52700,62094
4376,2874,1502,779,83200,62095
1081,995,86,815,165300,62097
11,11,0,-,-,62098
2615,779,1836,324,60200,62201
2974,2146,828,911,56100,62203
3521,1453,2068,444,52800,62204
3373,2020,1353,844,52000,62205
5268,2646,2622,893,46700,62206
3673,1282,2391,555,47700,62207
7071,4421,2650,1033,135000,62208
539,448,91,641,127300,62214
720,542,178,836,170800,62215
985,797,188,857,170800,62216
331,246,85,870,75300,62217
579,539,40,1036,183900,62218
451,357,94,824,93000,62219
7464,4796,2668,837,104400,62220
12327,8516,3811,892,170700,62221
6819,5190,1629,803,112200,62223
1384,25,1359,1596,-,62225
12307,7940,4367,800,121700,62226
2691,2240,451,886,159000,62230
2962,2372,590,822,130300,62231
2517,1961,556,943,90500,62232
2652,1899,753,543,104900,62233
13605,9360,4245,912,137600,62234
5404,4620,784,897,228500,62236
1025,889,136,525,113500,62237
256,193,63,669,62800,62238
2024,1403,621,863,79000,62239
571,321,250,825,86800,62240
399,363,36,683,116700,62241
529,484,45,559,92600,62242
2305,1855,450,903,187000,62243
443,379,64,852,225400,62244
762,635,127,769,160000,62245
3508,2336,1172,565,134900,62246
168,110,58,628,134500,62248
6183,4604,1579,738,173200,62249
192,172,20,783,88500,62250
251,213,38,638,84400,62253
2493,1707,786,861,139900,62254
398,348,50,810,141900,62255
1149,881,268,693,88600,62257
3370,2655,715,925,175000,62258
2970,2459,511,772,203100,62260
37,37,0,-,-,62261
740,685,55,566,76400,62262
2144,1652,492,715,133700,62263
1433,1125,308,806,148300,62264
1629,1238,391,1019,151300,62265
33,33,0,-,-,62266
371,263,108,718,125900,62268
11867,8494,3373,1035,205000,62269
879,654,225,743,115300,62271
672,504,168,695,129600,62272
71,63,8,-,68300,62273
2447,1757,690,502,88900,62274
1450,1266,184,799,155600,62275
528,444,84,672,83800,62277
2579,2030,549,729,161000,62278
0,0,0,-,-,62279
199,174,25,-,121400,62280
1012,918,94,1125,205300,62281
169,150,19,881,131300,62282
246,205,41,681,101100,62284
1698,1503,195,748,180900,62285
2519,1709,810,681,104400,62286
1183,854,329,727,116900,62288
122,86,36,860,83000,62289
344,244,100,635,64800,62292
1736,1349,387,751,174500,62293
5402,4267,1135,867,193000,62294
546,444,102,983,160700,62295
221,183,38,-,274600,62297
6837,5601,1236,845,213100,62298
13907,8499,5408,691,99900,62301
7674,6395,1279,835,174600,62305
334,254,80,1125,72500,62311
812,605,207,556,76200,62312
170,147,23,-,66600,62313
170,145,25,450,73900,62314
233,195,38,558,58800,62316
105,99,6,-,123600,62319
844,640,204,859,142100,62320
1685,1324,361,558,98400,62321
98,92,6,-,101800,62323
482,377,105,419,100800,62324
186,181,5,925,119900,62325
1022,831,191,650,82800,62326
777,632,145,607,74600,62330
71,61,10,721,63200,62334
12,9,3,-,63800,62336
488,464,24,-,159400,62338
336,291,45,488,91900,62339
716,558,158,544,82300,62340
1387,1097,290,655,94200,62341
332,272,60,605,60500,62343
3,3,0,-,-,62344
171,141,30,508,97500,62345
92,92,0,-,75700,62346
731,603,128,548,183600,62347
61,60,1,-,105400,62348
261,235,26,618,123600,62349
669,539,130,859,114900,62351
117,87,30,950,65000,62352
1428,999,429,612,96200,62353
571,438,133,733,113300,62354
290,273,17,-,59600,62355
179,132,47,495,60500,62356
169,109,60,566,84300,62357
231,215,16,-,104800,62358
65,65,0,-,95400,62359
617,539,78,758,105100,62360
150,126,24,621,87800,62361
152,125,27,475,60700,62362
2322,1791,531,584,110700,62363
193,165,28,625,84200,62365
632,508,124,538,69200,62366
481,351,130,543,62200,62367
136,127,9,-,147900,62370
109,109,0,-,90300,62373
203,193,10,608,77600,62374
139,128,11,-,98800,62375
439,296,143,672,108200,62376
481,403,78,-,95400,62378
785,656,129,625,82600,62379
129,114,15,822,25000,62380
7914,5502,2412,622,145300,62401
432,402,30,490,95600,62410
1705,1325,380,757,120700,62411
133,104,29,-,119400,62413
733,624,109,491,103800,62414
1280,1052,228,569,67900,62417
831,635,196,585,100400,62418
83,78,5,692,49200,62419
2091,1645,446,716,81100,62420
206,189,17,811,76100,62421
436,336,100,693,86400,62422
252,239,13,-,125700,62423
853,725,128,763,160900,62424
203,195,8,-,60600,62425
368,317,51,667,61300,62426
737,604,133,711,87500,62427
1134,871,263,558,95100,62428
400,316,84,600,71700,62431
188,173,15,1286,83800,62432
480,413,67,633,80300,62433
168,163,5,-,-,62434
272,228,44,526,75000,62436
115,108,7,-,-,62438
3351,2451,900,688,83700,62439
574,500,74,706,88400,62440
2845,2072,773,693,114000,62441
1126,842,284,567,90300,62442
598,508,90,812,141900,62443
174,164,10,-,108700,62444
482,382,100,562,146700,62445
157,130,27,-,85000,62446
1297,1044,253,587,105700,62447
2257,1669,588,573,98600,62448
1324,1010,314,614,88800,62449
5097,3410,1687,557,98000,62450
946,733,213,494,70400,62451
129,102,27,525,69400,62452
4078,3096,982,648,95400,62454
819,688,131,493,83000,62458
110,98,12,-,73500,62459
555,420,135,630,81400,62460
317,282,35,488,164200,62461
335,268,67,534,114000,62462
511,443,68,582,108400,62463
379,350,29,775,99400,62465
1092,754,338,538,81000,62466
1514,1329,185,649,188300,62467
1091,760,331,623,105900,62468
201,180,21,-,141700,62469
3406,2482,924,622,91700,62471
522,494,28,556,98600,62473
378,336,42,645,72400,62474
166,166,0,-,102800,62475
641,572,69,390,73200,62476
301,266,35,-,69000,62477
164,147,17,-,78000,62478
295,213,82,732,204600,62479
210,177,33,589,89400,62480
179,170,9,-,71200,62481
1025,905,120,727,133600,62501
647,519,128,714,80100,62510
195,160,35,-,79500,62512
641,478,163,874,95300,62513
111,111,0,-,72300,62514
428,307,121,856,156600,62515
75,51,24,817,63600,62517
92,67,25,682,92500,62518
51,51,0,-,73000,62519
670,576,94,938,177500,62520
14840,10483,4357,736,101700,62521
6186,4157,2029,701,84300,62522
386,3,383,316,-,62523
14266,8523,5743,649,80800,62526
628,481,147,836,110000,62530
694,529,165,682,107400,62531
44,44,0,-,89200,62532
345,256,89,627,97300,62533
556,404,152,800,83100,62534
1135,1025,110,1563,224600,62535
288,257,31,-,194600,62536
47,47,0,-,76600,62537
212,180,32,606,85500,62538
485,395,90,717,94300,62539
657,502,155,671,78400,62540
15,15,0,-,-,62541
232,141,91,488,95900,62543
655,573,82,639,106600,62544
499,450,49,752,128300,62545
688,575,113,628,89500,62546
389,350,39,771,89600,62547
1009,844,165,560,121400,62548
2223,1737,486,662,150900,62549
1104,916,188,750,102200,62550
330,287,43,548,88800,62551
182,164,18,665,100600,62553
474,397,77,778,121600,62554
175,159,16,640,115200,62555
160,151,9,-,62700,62556
3122,2431,691,634,84500,62557
1311,1061,250,856,150500,62558
553,413,140,761,88800,62560
2236,1535,701,876,131100,62561
2083,1896,187,1063,206000,62563
3207,2461,746,614,103900,62565
476,370,106,775,95500,62567
6563,4574,1989,675,98900,62568
180,159,21,654,73700,62570
590,489,101,594,67800,62571
222,193,29,586,120200,62572
644,508,136,598,103400,62573
130,109,21,-,114100,62601
62,45,17,683,48500,62610
450,392,58,625,103600,62611
805,618,187,768,105400,62612
1525,1226,299,865,176600,62613
2128,1711,417,816,120500,62615
316,261,55,716,69300,62617
2819,1968,851,585,75800,62618
480,374,106,664,75000,62621
15,10,5,-,-,62622
175,169,6,-,91100,62624
362,341,21,-,176900,62625
2972,2226,746,792,108300,62626
362,294,68,758,78800,62627
303,233,70,760,89800,62628
5394,4338,1056,1035,192700,62629
166,159,7,-,-,62630
130,93,37,684,77200,62631
235,198,37,750,76300,62633
321,272,49,625,107400,62634
285,207,78,789,116800,62635
524,446,78,781,104100,62638
120,106,14,-,155400,62639
1505,1162,343,790,120500,62640
561,437,124,688,95400,62642
206,148,58,783,88000,62643
2150,1604,546,664,77700,62644
214,141,73,751,87100,62649
10486,6739,3747,725,118100,62650
191,146,45,670,73000,62655
6815,4629,2186,689,99900,62656
608,458,150,819,112600,62661
92,82,10,-,76700,62663
1369,1057,312,599,85900,62664
548,447,101,581,70300,62665
232,191,41,715,84800,62666
237,152,85,613,103800,62667
576,493,83,567,115700,62668
1065,857,208,723,151200,62670
235,168,67,621,90000,62671
85,75,10,-,59400,62672
175,155,20,497,86200,62673
620,494,126,590,100000,62674
2616,1972,644,763,160100,62675
953,839,114,572,148000,62677
2097,1508,589,681,85500,62681
388,337,51,656,67200,62682
2109,1772,337,934,224200,62684
947,779,168,672,127100,62685
305,262,43,725,94600,62688
229,201,28,710,68600,62689
1645,1278,367,652,97100,62690
894,704,190,591,80700,62691
843,700,143,690,87400,62692
587,491,96,773,160100,62693
1183,959,224,502,100600,62694
101,90,11,663,96000,62695
559,16,543,561,-,62701
15526,9560,5966,795,83100,62702
11981,6766,5215,804,86000,62703
19058,11185,7873,797,136200,62704
3129,2749,380,824,135200,62707
7112,6039,1073,978,244100,62711
4240,3370,870,870,225900,62712
8368,5929,2439,655,74300,62801
425,324,101,701,110800,62803
1501,1150,351,563,87600,62806
333,249,84,438,70900,62807
634,476,158,748,92500,62808
67,63,4,-,83600,62809
362,314,48,588,86000,62810
118,93,25,650,32100,62811
4433,3059,1374,656,81300,62812
768,665,103,714,86200,62814
124,94,30,418,64000,62815
525,434,91,646,77900,62816
227,184,43,673,81200,62817
117,111,6,525,71200,62818
182,149,33,733,50200,62819
62,50,12,-,58700,62820
3154,2574,580,613,77100,62821
1223,804,419,683,63400,62822
688,563,125,560,94200,62823
828,571,257,518,85100,62824
85,67,18,-,62500,62825
566,413,153,479,62400,62827
518,435,83,575,111900,62828
21,0,21,-,-,62829
586,416,170,321,97700,62830
191,161,30,477,105400,62831
3986,2950,1036,586,77700,62832
185,150,35,489,100000,62833
403,343,60,450,64500,62835
285,245,40,725,96600,62836
4004,2836,1168,635,85000,62837
721,648,73,524,68100,62838
2709,1865,844,606,87200,62839
46,46,0,-,80000,62841
301,243,58,688,82000,62842
72,68,4,-,37500,62843
878,658,220,498,71300,62844
275,174,101,646,74700,62846
288,219,69,695,79800,62848
858,749,109,633,77700,62849
135,131,4,-,108900,62850
66,60,6,-,127400,62851
32,31,1,-,55600,62852
351,304,47,773,79400,62853
644,540,104,557,85300,62854
170,132,38,729,52500,62856
1142,883,259,615,87900,62858
2421,1934,487,588,92800,62859
226,212,14,-,100000,62860
65,54,11,-,21000,62861
159,143,16,-,59400,62862
4168,3167,1001,634,82500,62863
10039,6837,3202,715,93700,62864
833,758,75,-,134600,62865
219,183,36,509,71300,62867
718,612,106,705,77300,62868
1086,892,194,467,76300,62869
856,680,176,690,62600,62870
276,244,32,346,90000,62871
379,349,30,713,111500,62872
204,168,36,600,41600,62874
452,411,41,613,86600,62875
95,88,7,-,55000,62876
222,181,41,775,89200,62877
196,175,21,-,49100,62878
30,24,6,-,20000,62879
279,257,22,500,80200,62880
4599,3229,1370,649,86100,62881
1006,765,241,625,61900,62882
319,278,41,356,119500,62883
1196,999,197,717,79400,62884
274,217,57,409,95700,62885
95,90,5,-,80000,62886
135,97,38,1110,50200,62887
883,706,177,703,98300,62888
357,329,28,-,123400,62889
1093,877,216,661,93700,62890
264,245,19,542,62000,62891
142,123,19,517,112500,62892
435,362,73,630,127000,62893
396,336,60,539,122300,62894
807,669,138,623,94200,62895
5194,3740,1454,585,73700,62896
155,129,26,748,92500,62897
794,705,89,683,123700,62898
708,574,134,377,81000,62899
10855,3639,7216,710,123800,62901
1978,1256,722,658,160500,62902
1182,553,629,778,159200,62903
222,215,7,-,114300,62905
2567,1799,768,622,106600,62906
784,699,85,621,107300,62907
204,181,23,575,82700,62908
1004,886,118,569,63300,62910
495,405,90,700,71900,62912
920,648,272,482,30200,62914
123,97,26,920,68800,62915
360,281,79,540,123200,62916
894,683,211,671,64600,62917
4294,2968,1326,851,148300,62918
316,295,21,467,71700,62919
1349,1141,208,456,142300,62920
153,133,20,-,68800,62921
1196,1088,108,536,134300,62922
182,159,23,814,73600,62923
1159,742,417,791,84000,62924
869,656,213,600,102300,62926
150,106,44,768,39200,62927
95,56,39,406,49200,62928
2500,1942,558,663,55500,62930
576,460,116,361,102400,62931
569,412,157,666,66900,62932
525,298,227,686,115200,62933
363,278,85,425,84700,62934
779,581,198,632,107700,62935
1111,868,243,287,106300,62938
1246,1086,160,693,133200,62939
113,89,24,470,27000,62940
244,228,16,858,101500,62941
262,178,84,541,40300,62942
173,142,31,-,155000,62943
5259,3779,1480,600,81000,62946
226,211,15,-,132700,62947
5228,3621,1607,639,88400,62948
313,194,119,-,55700,62949
92,79,13,-,107300,62950
1904,1539,365,531,69800,62951
1236,1006,230,602,99000,62952
109,66,43,642,40000,62953
237,178,59,377,107900,62954
346,269,77,595,60100,62956
291,181,110,845,54500,62957
866,647,219,721,144300,62958
11083,7212,3871,747,136500,62959
4505,3258,1247,709,86300,62960
13,13,0,-,33800,62961
0,0,0,-,-,62962
247,141,106,522,34600,62963
495,374,121,470,47900,62964
34,22,12,525,47900,62965
6245,4135,2110,608,97600,62966
115,112,3,-,62500,62967
126,90,36,750,69400,62969
273,217,56,479,67300,62970
380,357,23,-,130900,62972
653,593,60,920,116200,62974
61,61,0,-,65000,62975
144,125,19,-,47900,62976
285,245,40,837,95000,62977
494,365,129,526,72700,62979
327,243,84,401,60900,62982
621,482,139,633,61600,62983
704,519,185,414,67300,62984
290,266,24,-,88300,62985
547,487,60,793,85100,62987
462,384,78,477,69200,62988
318,248,70,255,120100,62990
272,213,59,529,76300,62992
271,232,39,667,118000,62994
1589,1203,386,584,99200,62995
178,144,34,631,80000,62996
218,160,58,740,61700,62997
138,108,30,-,-,62998
628,416,212,548,52200,62999
6469,5617,852,1183,570000,63005
13924,10344,3580,908,160000,63010
14517,12098,2419,1243,281700,63011
3809,3460,349,955,161400,63012
610,560,50,-,206100,63013
388,364,24,595,172600,63014
912,830,82,-,145000,63015
3084,2597,487,1025,154400,63016
16557,12968,3589,1208,372200,63017
1874,1323,551,845,133200,63019
7924,6153,1771,747,144600,63020
22329,18048,4281,1135,243600,63021
2120,1809,311,898,163700,63023
5190,4394,796,1071,288000,63025
16703,13448,3255,874,204700,63026
10050,7942,2108,846,158800,63028
111,87,24,-,117900,63030
17633,12639,4994,1088,103500,63031
16603,10730,5873,968,109000,63033
6542,6130,412,1537,181900,63034
479,387,92,768,183500,63036
1248,1021,227,652,165900,63037
2424,2185,239,947,419000,63038
284,267,17,-,128200,63039
3223,2765,458,1180,327700,63040
136,129,7,-,208300,63041
8704,4533,4171,877,109200,63042
9448,6385,3063,1070,159200,63043
3945,2637,1308,924,168100,63044
0,0,0,-,-,63045
21,21,0,-,-,63047
1357,1113,244,1754,158100,63048
6564,5670,894,850,165300,63049
5870,4969,901,815,173200,63050
5139,4126,1013,882,143900,63051
9848,7978,1870,894,182200,63052
28,10,18,833,160000,63053
936,728,208,870,267100,63055
817,724,93,575,205500,63056
0,0,0,-,-,63057
799,650,149,998,118600,63060
58,58,0,-,142200,63061
1930,1600,330,714,167400,63068
5667,4185,1482,755,197800,63069
3129,2095,1034,696,128500,63070
448,318,130,701,66500,63071
1319,1121,198,879,159400,63072
303,303,0,-,653700,63073
6395,3159,3236,860,90000,63074
4577,3197,1380,734,132600,63077
27,27,0,-,-,63079
5709,3725,1984,713,128200,63080
7280,5149,2131,726,166900,63084
308,241,67,645,164800,63087
3978,2354,1624,1035,180700,63088
2101,1751,350,1070,165000,63089
8927,6609,2318,758,196500,63090
545,459,86,500,202200,63091
2360,472,1888,1050,240400,63101
982,21,961,899,-,63102
5026,697,4329,868,175200,63103
9522,3911,5611,899,218800,63104
6662,3911,2751,1235,591800,63105
4480,781,3699,622,138500,63106
4156,1839,2317,743,47700,63107
11261,3262,7999,947,351100,63108
13796,8366,5430,805,173700,63109
8240,3447,4793,884,203500,63110
8626,3118,5508,777,79800,63111
8237,2960,5277,829,142200,63112
4692,2105,2587,804,64700,63113
14675,8304,6371,932,85200,63114
7366,3453,3913,772,54900,63115
19376,10592,8784,797,120400,63116
4486,2539,1947,969,243700,63117
11477,4046,7431,834,146100,63118
14197,10471,3726,1011,247300,63119
3184,1531,1653,749,49000,63120
10256,5387,4869,867,74600,63121
16081,12838,3243,1102,344800,63122
22766,16162,6604,842,150100,63123
4694,3415,1279,995,791300,63124
14021,9721,4300,830,123100,63125
6097,5092,1005,877,206100,63126
2131,1561,570,2207,427700,63127
13035,10250,2785,993,236200,63128
21966,17397,4569,847,219700,63129
12017,6789,5228,1029,271100,63130
6495,6031,464,1818,589500,63131
5402,2975,2427,1125,301000,63132
3163,1020,2143,846,50400,63133
5225,2539,2686,994,66300,63134
8463,5072,3391,986,81600,63135
18533,7950,10583,886,66100,63136
7405,3924,3481,983,60700,63137
7112,3217,3895,814,101600,63138
10985,6592,4393,825,152500,63139
137,32,105,726,-,63140
8729,6603,2126,1185,429900,63141
4927,2192,2735,764,175600,63143
4467,2922,1545,1253,232600,63144
14524,8481,6043,1104,219700,63146
3638,1955,1683,786,64400,63147
0,0,0,-,-,63155
19861,13562,6299,896,176800,63301
20046,14621,5425,1088,217900,63303
15284,13665,1619,1254,244400,63304
71,54,17,573,-,63330
518,474,44,728,344400,63332
339,237,102,908,99500,63333
2654,1915,739,584,101900,63334
527,349,178,633,148600,63336
340,293,47,564,-,63339
1364,1187,177,1108,353900,63341
1675,1118,557,789,107700,63343
541,426,115,713,178800,63344
240,201,39,382,73800,63345
913,786,127,777,134900,63347
2710,2534,176,967,284900,63348
727,636,91,853,179600,63349
217,168,49,650,86700,63350
803,644,159,733,167600,63351
522,383,139,497,86000,63352
1996,1354,642,689,85200,63353
2036,1682,354,818,191800,63357
537,374,163,632,125000,63359
1996,1282,714,604,108800,63361
2524,1874,650,915,172800,63362
790,605,185,698,122600,63363
18498,14961,3537,967,204900,63366
9128,7761,1367,1135,270400,63367
15778,13290,2488,1268,247500,63368
805,573,232,829,158900,63369
9,9,0,-,-,63370
217,181,36,950,156700,63373
28487,23741,4746,1035,187100,63376
899,816,83,729,165800,63377
8525,6707,1818,869,169400,63379
172,132,40,1071,170300,63381
1362,904,458,616,74100,63382
5919,4499,1420,766,154200,63383
719,507,212,648,82800,63384
15144,12676,2468,1028,239500,63385
193,153,40,505,112500,63386
42,29,13,-,-,63387
299,235,64,759,-,63388
2404,1891,513,831,152700,63389
4088,3220,868,836,183800,63390
8801,5498,3303,704,125600,63401
217,177,40,1088,85900,63430
118,99,19,-,115600,63431
196,183,13,-,-,63432
0,0,0,-,-,63433
248,118,130,455,121900,63434
1558,1159,399,651,106200,63435
658,477,181,567,129400,63436
565,439,126,592,66900,63437
156,143,13,-,115000,63438
100,52,48,565,145000,63439
431,327,104,560,80400,63440
448,348,100,606,105300,63441
127,86,41,405,47000,63443
1415,972,443,608,89500,63445
228,196,32,550,75000,63446
453,291,162,470,71700,63447
604,500,104,589,93700,63448
82,47,35,-,97000,63450
86,77,9,-,-,63451
495,397,98,575,80400,63452
202,179,23,775,163100,63453
365,271,94,781,133200,63454
1835,1216,619,642,106900,63456
99,95,4,-,131300,63457
49,30,19,-,57500,63458
1455,1298,157,967,144500,63459
119,116,3,-,65000,63460
2260,1740,520,588,127400,63461
639,552,87,538,117800,63462
287,205,82,573,155300,63463
5,5,0,-,-,63464
123,106,17,-,154200,63465
13,13,0,-,-,63467
975,682,293,619,76200,63468
478,376,102,596,88700,63469
254,220,34,713,144200,63471
231,152,79,518,46700,63472
93,93,0,-,173400,63473
178,119,59,496,107300,63474
7780,4277,3503,645,135300,63501
368,301,67,554,71500,63530
138,124,14,-,77400,63531
540,459,81,608,75500,63532
262,205,57,675,93300,63533
327,287,40,605,57000,63534
25,13,12,-,75000,63535
353,249,104,324,109200,63536
745,602,143,558,77400,63537
104,96,8,-,-,63538
66,51,15,-,69400,63539
33,31,2,-,31900,63540
173,136,37,605,-,63541
79,75,4,625,81000,63543
271,231,40,400,83000,63544
366,279,87,570,83100,63545
604,524,80,484,108400,63546
168,141,27,570,61200,63547
366,268,98,468,66600,63548
927,671,256,603,99800,63549
75,70,5,-,162500,63551
2988,2022,966,524,111700,63552
1277,943,334,514,94900,63555
1224,864,360,639,78400,63556
92,92,0,-,125000,63557
269,213,56,1043,97000,63558
581,476,105,800,75000,63559
86,71,15,513,49500,63560
384,255,129,519,66000,63561
214,144,70,436,230000,63563
1314,952,362,574,88200,63565
38,38,0,-,103600,63566
65,52,13,534,82200,63567
6250,4095,2155,667,82800,63601
482,367,115,545,79200,63620
587,361,226,463,89300,63621
368,351,17,-,103100,63622
314,248,66,623,78800,63623
1517,1170,347,693,91000,63624
164,158,6,-,122500,63625
469,433,36,-,95500,63626
1207,936,271,764,179400,63627
4989,3468,1521,715,137900,63628
539,445,94,288,113500,63629
1391,1214,177,657,74300,63630
415,318,97,789,154900,63631
234,168,66,668,79200,63633
266,180,86,671,74000,63636
586,458,128,-,110800,63637
1035,738,297,614,97100,63638
11074,7543,3531,691,153700,63640
4794,3473,1321,603,108400,63645
467,402,65,722,94400,63648
1682,1309,373,543,88100,63650
525,329,196,766,51700,63653
273,216,57,638,129300,63654
569,468,101,661,126800,63655
104,89,15,595,83800,63656
1121,927,194,540,80200,63660
587,528,59,711,89300,63662
304,103,201,622,88100,63663
3674,2678,996,535,99400,63664
101,84,17,-,87100,63665
27,27,0,-,-,63666
4512,3511,1001,733,160700,63670
701,633,68,777,114800,63673
0,0,0,-,-,63674
73,73,0,-,63700,63675
14355,8858,5497,828,165500,63701
3588,1438,2150,732,82800,63703
1484,1097,387,608,91500,63730
356,336,20,638,130600,63732
296,205,91,533,48100,63735
1372,1070,302,616,85600,63736
0,0,0,-,-,63738
154,99,55,805,135400,63739
1880,1366,514,762,105000,63740
26,22,4,-,53300,63742
25,25,0,-,173400,63743
37,29,8,-,73000,63744
4,1,3,-,-,63745
15,12,3,-,-,63746
151,134,17,-,121100,63747
446,396,50,718,137800,63748
8,8,0,-,-,63750
570,454,116,738,134400,63751
9339,7050,2289,843,167400,63755
85,71,14,-,144100,63758
239,203,36,408,195200,63760
82,82,0,-,-,63763
1923,1387,536,633,119900,63764
473,404,69,718,163500,63766
295,188,107,720,92900,63767
468,418,50,842,155200,63769
48,41,7,1292,91000,63770
1128,804,324,602,97200,63771
54,28,26,-,31000,63774
6676,4875,1801,689,150500,63775
2401,1672,729,699,116400,63780
458,378,80,917,136300,63781
117,102,15,-,80700,63782
58,58,0,-,177300,63783
79,54,25,-,71100,63784
359,283,76,595,117200,63785
295,259,36,513,80100,63787
9360,5944,3416,695,113100,63801
63,57,6,-,34200,63820
354,294,60,543,43300,63821
997,656,341,578,78800,63822
495,366,129,558,88000,63823
42,7,35,804,-,63824
1612,1138,474,561,110500,63825
14,14,0,-,45000,63826
336,260,76,538,62400,63827
70,57,13,-,-,63828
487,277,210,592,49100,63829
2851,1439,1412,617,102200,63830
92,75,17,-,-,63833
2025,1162,863,636,82600,63834
676,393,283,492,42700,63837
152,50,102,672,65600,63839
5318,3386,1932,641,118800,63841
2428,1454,974,548,82400,63845
633,498,135,659,82900,63846
35,14,21,-,-,63847
508,363,145,693,51500,63848
65,27,38,-,-,63849
1496,725,771,650,68400,63851
493,335,158,529,64100,63852
85,57,28,671,38300,63853
405,331,74,456,52900,63855
5142,3021,2121,591,94300,63857
93,79,14,-,65000,63860
657,398,259,599,62900,63862
2512,1525,987,599,71100,63863
174,105,69,763,22400,63866
410,292,118,635,77500,63867
382,210,172,546,57900,63868
1501,813,688,636,89500,63869
374,214,160,730,71700,63870
1890,1183,707,582,84100,63873
172,104,68,715,61000,63874
864,558,306,601,74800,63876
1318,768,550,489,94300,63877
29,29,0,-,26800,63878
300,211,89,570,58300,63879
56,37,19,-,45200,63880
159,97,62,700,31600,63882
13476,8240,5236,689,117300,63901
0,0,0,-,-,63902
397,265,132,525,46200,63932
1319,885,434,563,69100,63933
106,70,36,-,-,63934
3666,2887,779,588,88800,63935
256,141,115,752,157500,63936
1124,929,195,536,88200,63937
509,407,102,573,83000,63939
605,496,109,578,90900,63940
97,62,35,-,-,63941
269,224,45,610,96500,63942
250,187,63,730,103000,63943
682,582,100,478,107500,63944
410,353,57,669,140600,63945
126,77,49,-,-,63951
139,113,26,450,-,63952
609,467,142,524,67200,63953
292,204,88,528,47900,63954
67,56,11,-,-,63955
411,254,157,423,118800,63956
2425,1645,780,586,73800,63957
1110,896,214,587,110400,63960
650,506,144,660,92500,63961
51,0,51,-,-,63962
192,145,47,-,-,63964
1083,828,255,627,116700,63965
1027,882,145,904,88700,63966
797,564,233,443,99300,63967
307,233,74,850,94500,64001
1243,1042,201,681,183900,64011
10464,7249,3215,1070,146000,64012
9149,6498,2651,997,165100,64014
11580,8579,3001,940,171400,64015
1871,1397,474,847,122300,64016
177,133,44,643,66300,64017
347,280,67,634,238700,64018
775,683,92,1039,157500,64019
1525,1072,453,620,125900,64020
250,224,26,733,73600,64021
57,50,7,731,86700,64022
6188,4378,1810,701,142700,64024
6602,4749,1853,1028,190600,64029
10034,4932,5102,830,108700,64030
3334,3004,330,1413,213900,64034
408,322,86,813,84300,64035
107,71,36,850,42600,64036
2294,1294,1000,694,118300,64037
2486,1980,506,670,152200,64040
1530,1385,145,930,227200,64048
9207,4581,4626,742,90800,64050
8990,5160,3830,839,88000,64052
2217,1077,1140,855,60900,64053
1349,749,600,787,74300,64054
14528,9955,4573,924,126900,64055
5789,3850,1939,872,114600,64056
5983,3556,2427,964,164700,64057
2504,1960,544,1006,137300,64058
5117,4174,943,1110,221300,64060
1284,1124,160,920,169500,64061
2198,1828,370,949,159300,64062
8126,5449,2677,972,166000,64063
7077,5826,1251,1102,284700,64064
8,0,8,600,-,64065
10,6,4,-,-,64066
2305,1491,814,669,130600,64067
14018,10372,3646,925,184500,64068
1327,1168,159,1007,241400,64070
252,199,53,443,85000,64071
236,198,38,880,66300,64072
285,235,50,1417,276400,64074
4488,3344,1144,865,168000,64075
3709,2796,913,724,165900,64076
681,565,116,918,124300,64077
3749,3184,565,911,182500,64078
5172,3599,1573,1021,232500,64079
4737,3636,1101,962,212300,64080
9489,7275,2214,1152,236600,64081
5590,4953,637,1386,285800,64082
9199,7573,1626,1154,204800,64083
633,565,68,786,203400,64084
3407,2297,1110,630,121100,64085
8741,6662,2079,992,200000,64086
529,458,71,954,163600,64088
4782,4043,739,823,222900,64089
47,43,4,-,49200,64090
17,0,17,-,-,64092
10406,5579,4827,770,159600,64093
436,326,110,663,86700,64096
551,404,147,489,135300,64097
1300,974,326,860,217500,64098
15,15,0,-,-,64101
0,0,0,-,-,64102
3660,429,3231,1155,182800,64105
4320,723,3597,849,183300,64106
4416,1567,2849,1106,197800,64108
4672,1843,2829,777,128800,64109
7000,3110,3890,894,166400,64110
10084,2821,7263,923,175000,64111
4833,1971,2862,1156,378600,64112
4884,4639,245,2054,386400,64113
12470,7451,5019,1065,171800,64114
7512,3314,4198,930,168600,64116
5716,2915,2801,919,110300,64117
16755,9688,7067,945,145400,64118
11358,8360,2998,1036,147600,64119
166,113,53,728,-,64120
3406,1802,1604,800,62500,64123
4213,2068,2145,717,60200,64124
598,303,295,817,43900,64125
2265,977,1288,779,46000,64126
6336,2697,3639,741,45100,64127
4931,1989,2942,745,44000,64128
3803,1789,2014,851,82600,64129
8550,4408,4142,843,50100,64130
10423,4969,5454,882,151500,64131
5455,2382,3073,819,63400,64132
14822,8969,5853,902,110600,64133
8967,4246,4721,1042,85000,64134
1013,480,533,966,154900,64136
4314,2424,1890,1021,124500,64137
10485,6227,4258,895,108400,64138
717,543,174,1226,314200,64139
1928,1642,286,1034,243600,64145
747,695,52,847,179200,64146
185,0,185,544,-,64147
151,137,14,-,272900,64149
1506,535,971,731,222300,64150
11194,6495,4699,1044,208000,64151
10757,8753,2004,1051,242600,64152
2402,1193,1209,1123,217700,64153
4511,2439,2072,1155,244700,64154
8722,6374,2348,1057,188200,64155
2806,2235,571,1196,263200,64156
6403,5939,464,1458,256300,64157
1915,988,927,1071,224700,64158
138,79,59,930,113400,64161
386,173,213,624,141900,64163
105,59,46,-,-,64164
118,118,0,-,-,64165
89,73,16,-,249000,64166
146,146,0,-,378000,64167
0,0,0,-,-,64192
483,412,71,778,151900,64401
1039,722,317,539,82800,64402
34,28,6,-,116700,64420
323,279,44,1031,103600,64421
156,105,51,-,147800,64422
316,292,24,650,121400,64423
1744,1173,571,494,88100,64424
169,131,38,669,76100,64426
262,190,72,406,106500,64427
285,239,46,472,62200,64428
3849,2425,1424,781,141400,64429
351,271,80,679,163900,64430
140,98,42,459,95000,64431
27,26,1,-,85000,64432
25,22,3,-,70000,64433
202,175,27,392,150600,64434
318,296,22,950,172400,64436
240,204,36,588,89100,64437
82,72,10,-,33900,64438
581,483,98,645,201600,64439
282,238,44,683,150000,64440
59,52,7,-,45000,64441
358,281,77,629,86000,64442
615,495,120,784,251700,64443
503,434,69,767,140400,64444
117,88,29,665,67100,64445
495,349,146,504,69900,64446
417,348,69,730,143200,64448
245,220,25,621,82800,64449
252,195,57,485,83800,64451
81,75,6,-,182300,64453
993,810,183,800,170700,64454
164,119,45,403,85900,64455
597,453,144,562,68500,64456
88,79,9,933,176400,64457
53,44,9,-,57500,64458
172,171,1,-,155500,64459
318,249,69,482,73200,64461
628,447,181,756,109600,64463
1891,1549,342,669,160500,64465
201,149,52,418,78300,64466
83,62,21,-,109800,64467
5751,2722,3029,678,143000,64468
866,659,207,604,97300,64469
672,480,192,442,103100,64470
147,127,20,513,52900,64471
647,506,141,618,86700,64473
315,232,83,758,103600,64474
151,100,51,623,134200,64475
136,109,27,646,105500,64476
1467,1136,331,824,159500,64477
343,273,70,625,101800,64479
100,88,12,-,89500,64480
354,277,77,703,70200,64481
1036,730,306,526,99300,64482
247,207,40,850,122000,64483
381,277,104,692,102800,64484
3080,2317,763,743,132400,64485
192,155,37,533,63000,64486
264,193,71,665,70300,64487
758,588,170,524,110600,64489
733,571,162,712,160400,64490
898,584,314,563,80000,64491
727,597,130,735,172200,64492
203,169,34,823,117300,64493
358,281,77,425,81800,64494
26,25,1,-,46500,64496
133,122,11,475,176700,64497
102,93,9,531,66800,64498
33,28,5,-,33000,64499
4492,1769,2723,686,83000,64501
4820,3257,1563,829,108900,64503
4237,2980,1257,792,85200,64504
5130,3381,1749,796,134900,64505
9061,5639,3422,808,164800,64506
5061,3260,1801,799,110700,64507
4653,2876,1777,674,117100,64601
185,159,26,692,86700,64620
187,144,43,521,90000,64622
150,129,21,767,74300,64623
683,547,136,688,92300,64624
241,190,51,431,86900,64625
2402,1652,750,566,88800,64628
207,180,27,513,119600,64630
357,283,74,335,73500,64631
177,149,28,367,62100,64632
1937,1355,582,653,93300,64633
220,179,41,758,83400,64635
117,100,17,825,40000,64636
222,176,46,481,101900,64637
277,237,40,434,98300,64638
87,74,13,-,64000,64639
1175,871,304,555,117200,64640
273,232,41,421,73900,64641
391,310,81,539,64600,64642
483,382,101,584,111400,64643
1294,983,311,709,115500,64644
71,62,9,231,88000,64645
76,54,22,475,70000,64646
167,138,29,621,73500,64647
696,590,106,525,119000,64648
272,241,31,-,115400,64649
262,154,108,714,120800,64650
293,200,93,593,78200,64651
170,138,32,438,57300,64652
288,243,45,552,86200,64653
22,18,4,-,-,64654
103,101,2,-,215300,64655
101,81,20,280,84300,64656
157,105,52,473,61800,64657
1332,1010,322,518,96900,64658
391,296,95,642,102100,64659
175,159,16,756,64100,64660
317,218,99,334,78100,64661
168,150,18,500,120800,64664
121,106,15,875,-,64667
652,490,162,547,83300,64668
333,252,81,475,110300,64670
784,601,183,485,132100,64671
63,61,2,-,108000,64672
857,711,146,528,88400,64673
182,163,19,293,123900,64674
74,66,8,-,-,64676
265,199,66,517,75000,64679
52,41,11,-,59400,64681
119,109,10,-,77300,64682
3151,2021,1130,556,105600,64683
84,77,7,-,66800,64686
226,189,37,692,80600,64688
240,196,44,828,97700,64689
5536,3623,1913,854,163000,64701
1433,1142,291,732,126500,64720
188,161,27,-,106000,64722
338,264,74,818,143200,64723
813,566,247,503,80200,64724
850,609,241,842,157300,64725
136,124,12,775,158000,64726
214,161,53,775,102400,64728
2751,1743,1008,630,119600,64730
445,314,131,698,155500,64733
759,684,75,950,260500,64734
5685,3880,1805,646,116900,64735
445,356,89,644,103400,64738
359,302,57,807,220500,64739
864,736,128,765,82800,64740
85,70,15,530,78300,64741
940,763,177,788,156900,64742
105,53,52,831,103100,64743
3346,2314,1032,606,86000,64744
70,63,7,-,108600,64745
561,466,95,883,160200,64746
1465,1179,286,788,149800,64747
716,466,250,530,67300,64748
167,148,19,-,100700,64750
291,236,55,682,85800,64752
994,723,271,611,105800,64755
289,238,51,710,91100,64756
3161,2167,994,557,108800,64759
516,400,116,685,121400,64761
630,449,181,561,83500,64762
688,542,146,763,70400,64763
13,10,3,-,"10,000-",64765
320,264,56,-,56100,64767
252,181,71,563,70500,64769
408,318,90,487,88200,64770
190,167,23,525,90700,64771
5501,3648,1853,646,106000,64772
1667,1268,399,601,111700,64776
228,183,45,714,118500,64778
993,784,209,593,74300,64779
196,147,49,639,179200,64780
37,33,4,-,48800,64781
342,300,42,533,69300,64783
485,386,99,608,66200,64784
684,535,149,692,110300,64788
410,328,82,531,87600,64790
15229,8580,6649,775,118200,64801
14024,9767,4257,766,142000,64804
325,196,129,819,75300,64830
2233,1694,539,729,111700,64831
293,230,63,1065,100000,64832
21,17,4,-,85000,64833
3459,2514,945,935,148000,64834
763,544,219,811,79300,64835
8598,5622,2976,741,127100,64836
1158,984,174,632,128400,64840
198,174,24,688,97100,64841
344,243,101,600,85400,64842
1339,1006,333,652,88900,64843
1803,1216,587,717,101200,64844
193,61,132,442,46900,64847
228,188,40,535,-,64848
64,61,3,-,82100,64849
8680,5623,3057,714,123300,64850
1469,728,741,568,90000,64854
962,830,132,796,124500,64855
1580,1041,539,703,144400,64856
135,122,13,694,75700,64857
56,56,0,-,-,64858
511,361,150,486,103800,64859
358,226,132,571,140000,64861
1462,1134,328,625,102700,64862
577,365,212,673,114500,64863
2288,1617,671,707,110400,64865
407,352,55,483,79700,64866
474,381,93,702,139800,64867
5762,3716,2046,753,113700,64870
324,311,13,-,85500,64873
276,150,126,525,81100,64874
115,115,0,-,102300,65001
2432,1871,561,769,208100,65010
717,619,98,535,148800,65011
1275,842,433,565,124500,65013
1027,767,260,532,118300,65014
572,531,41,-,173700,65016
474,440,34,-,-,65017
2922,2238,684,635,126000,65018
5304,4102,1202,781,181300,65020
640,576,64,521,188800,65023
451,379,72,567,94500,65024
249,160,89,711,150900,65025
4618,3268,1350,682,124200,65026
654,597,57,-,133200,65032
361,295,66,-,86100,65034
699,566,133,525,169100,65035
2126,1895,231,516,169500,65037
975,904,71,-,290600,65039
488,443,45,-,159900,65040
2362,1901,461,595,154200,65041
4127,3118,1009,814,148000,65043
504,466,38,438,129500,65046
438,254,184,564,-,65047
54,54,0,-,-,65048
2929,2217,712,715,251400,65049
203,188,15,567,244600,65050
1787,1382,405,521,137900,65051
1272,1083,189,1058,198800,65052
603,571,32,700,223200,65053
267,258,9,-,141500,65054
438,378,60,465,115200,65058
309,206,103,818,157900,65059
289,267,22,915,67100,65061
7,7,0,-,-,65062
1236,1075,161,754,186200,65063
222,209,13,486,160600,65064
2422,1673,749,693,248700,65065
2428,1923,505,634,124700,65066
151,113,38,733,-,65067
259,222,37,725,143400,65068
249,209,40,1188,119600,65069
684,634,50,-,169500,65072
1114,863,251,620,155400,65074
326,276,50,525,158800,65075
296,253,43,820,168800,65076
157,129,28,-,161000,65077
1428,1153,275,593,88300,65078
1766,1492,274,852,256100,65079
470,375,95,1098,185500,65080
1172,786,386,556,106000,65081
378,317,61,595,190800,65082
94,94,0,-,57100,65083
2362,1723,639,552,114800,65084
495,416,79,436,170200,65085
10799,7066,3733,649,161300,65101
16456,10453,6003,669,161500,65109
17189,5337,11852,891,177200,65201
19315,11850,7465,882,157100,65202
24263,14232,10031,881,240300,65203
0,0,0,-,-,65215
227,172,55,430,100000,65230
1296,997,299,654,200800,65231
112,91,21,636,51700,65232
4264,2998,1266,685,140200,65233
581,385,196,442,87400,65236
356,249,107,569,100900,65237
524,481,43,821,123800,65239
3351,2555,796,607,146100,65240
762,671,91,720,144400,65243
146,144,2,-,143800,65244
20,19,1,-,-,65246
275,263,12,-,116300,65247
1366,1054,312,731,120300,65248
243,222,21,594,155100,65250
7133,4692,2441,670,148700,65251
703,579,124,540,110600,65254
1637,1194,443,738,174400,65255
594,578,16,775,184400,65256
588,504,84,758,106700,65257
212,184,28,720,95700,65258
1061,926,135,688,98500,65259
155,134,21,533,106300,65260
390,308,82,344,83300,65261
295,253,42,841,206700,65262
677,550,127,619,91900,65263
272,225,47,405,152400,65264
5941,3851,2090,679,101400,65265
5902,3784,2118,615,105300,65270
667,459,208,458,116100,65274
1140,912,228,402,87300,65275
606,447,159,618,119900,65276
65,53,12,692,67000,65278
750,679,71,988,225300,65279
129,93,36,535,105100,65280
918,713,205,561,80500,65281
66,66,0,-,-,65282
276,272,4,-,150000,65283
821,659,162,687,148000,65284
219,179,40,-,106000,65285
35,32,3,-,-,65286
154,153,1,-,160200,65287
13097,8610,4487,712,113900,65301
971,34,937,1091,-,65305
21,19,2,-,120800,65320
172,149,23,471,104700,65321
219,188,31,673,98900,65322
394,338,56,470,106000,65323
578,512,66,600,168100,65324
1182,958,224,683,120400,65325
906,737,169,-,123600,65326
98,83,15,720,92700,65327
177,142,35,-,140000,65329
171,127,44,662,82600,65330
562,458,104,630,138300,65332
221,183,38,708,119800,65333
346,296,50,875,140000,65334
64,55,9,-,91300,65335
2384,1513,871,737,143400,65336
683,439,244,653,125300,65337
1188,966,222,646,101300,65338
184,155,29,619,71900,65339
5500,3719,1781,647,120700,65340
93,72,21,719,106300,65344
171,105,66,716,208700,65345
254,211,43,636,75600,65347
505,392,113,574,107500,65348
1054,706,348,581,69900,65349
740,679,61,721,164500,65350
872,648,224,675,107000,65351
197,120,77,545,169400,65354
4497,3698,799,633,120700,65355
1801,1403,398,625,103900,65360
13051,7277,5774,742,142300,65401
27,27,0,-,141300,65436
1071,782,289,524,117800,65438
64,56,8,-,29700,65439
141,139,2,-,97300,65440
2301,1746,555,732,126200,65441
40,40,0,-,176800,65443
414,329,85,853,109100,65444
135,66,69,-,179800,65446
194,170,24,-,88400,65449
1036,792,244,719,124300,65452
3413,2298,1115,552,135000,65453
242,180,62,-,111200,65456
45,39,6,-,241700,65457
2428,1866,562,693,142100,65459
43,32,11,-,59100,65461
650,594,56,642,100400,65462
410,400,10,-,109600,65463
449,363,86,-,117000,65464
655,459,196,617,126900,65466
43,43,0,-,-,65468
425,369,56,340,102200,65470
2220,15,2205,1256,-,65473
93,83,10,-,-,65479
1795,1085,710,580,122500,65483
17,17,0,-,-,65484
1393,1221,172,631,114000,65486
60,60,0,-,-,65501
97,89,8,-,83800,65529
312,276,36,-,144700,65534
482,349,133,516,106700,65535
11605,7760,3845,663,113400,65536
116,116,0,-,-,65541
1965,1358,607,565,111900,65542
109,89,20,-,140300,65543
2231,1558,673,541,115800,65548
1215,855,360,568,87800,65550
828,692,136,627,155700,65552
485,390,95,475,70000,65555
2138,1536,602,572,114200,65556
35,35,0,-,-,65557
3598,2436,1162,681,133800,65559
5927,4208,1719,539,105300,65560
42,31,11,-,-,65564
2041,1540,501,641,116700,65565
336,252,84,668,71500,65566
524,452,72,733,122000,65567
235,216,19,900,72500,65570
774,552,222,477,111200,65571
277,267,10,-,151900,65580
939,706,233,608,127700,65582
4546,2490,2056,939,168200,65583
4003,1690,2313,983,173400,65584
45,45,0,-,-,65586
1001,700,301,524,75100,65588
34,23,11,-,66100,65589
514,383,131,-,85000,65590
506,411,95,727,159200,65591
240,213,27,592,122800,65601
88,71,17,-,-,65603
1409,1072,337,613,140900,65604
5188,3797,1391,711,99500,65605
1323,984,339,536,91400,65606
3439,2620,819,576,115300,65608
295,236,59,683,80000,65609
1880,1519,361,735,159600,65610
900,718,182,746,162300,65611
515,456,59,-,187900,65612
6655,4104,2551,700,135600,65613
214,171,43,769,143900,65614
11492,6077,5415,868,156800,65616
464,352,112,916,165600,65617
79,57,22,-,99400,65618
2948,2406,542,762,153200,65619
71,71,0,-,-,65620
3161,2192,969,744,116900,65622
5,5,0,-,-,65623
603,573,30,-,175300,65624
3124,2113,1011,685,112300,65625
700,520,180,596,120900,65626
246,204,42,813,95000,65627
262,211,51,761,120300,65629
114,112,2,-,396800,65630
2032,1636,396,892,129700,65631
993,705,288,717,134400,65632
1515,1092,423,655,109300,65633
233,177,56,617,56100,65634
209,183,26,500,91300,65635
485,409,76,-,140300,65637
218,199,19,-,119900,65638
260,216,44,-,136000,65640
499,391,108,482,160300,65641
892,705,187,639,133400,65644
707,594,113,525,95000,65646
853,641,212,594,101400,65647
2259,2036,223,634,133800,65648
692,520,172,621,123800,65649
527,482,45,810,115800,65650
1367,1032,335,596,141700,65652
2387,1742,645,591,123500,65653
90,58,32,267,71100,65654
1233,815,418,656,89900,65655
1879,1477,402,613,186200,65656
41,37,4,-,95500,65657
690,611,79,606,129200,65658
79,79,0,-,226600,65660
1099,856,243,513,74700,65661
428,366,62,180,70700,65662
906,745,161,641,136700,65663
51,25,26,825,70800,65664
1099,774,325,544,121400,65667
777,606,171,402,91800,65668
966,800,166,799,154300,65669
3608,2139,1469,697,163700,65672
1030,762,268,697,76600,65674
179,134,45,819,123200,65676
939,640,299,688,142300,65679
524,494,30,-,83300,65680
857,778,79,-,166600,65681
741,516,225,687,87200,65682
315,288,27,475,104400,65685
2159,1823,336,706,174000,65686
2190,1532,658,573,137800,65689
75,61,14,-,-,65690
559,443,116,629,112500,65692
108,93,15,-,100600,65702
1387,932,455,488,124300,65704
1549,981,568,770,104900,65705
5818,4171,1647,632,136600,65706
877,735,142,624,105500,65707
4672,3239,1433,739,124700,65708
491,418,73,618,162100,65710
4064,2929,1135,591,99300,65711
3441,2429,1012,588,119200,65712
1012,842,170,546,102200,65713
12464,8930,3534,818,192100,65714
29,9,20,-,-,65715
913,670,243,538,103000,65717
360,334,26,442,122500,65720
11628,8363,3265,859,168000,65721
549,450,99,546,107800,65722
1295,953,342,654,113200,65723
644,605,39,-,59500,65724
1205,960,245,720,140600,65725
91,91,0,-,317300,65727
0,0,0,-,-,65728
110,72,38,-,225000,65729
0,0,0,-,-,65730
159,118,41,804,84900,65731
348,274,74,713,144700,65732
318,304,14,-,69000,65733
1217,868,349,587,89900,65734
32,27,5,-,-,65735
3285,2664,621,808,181700,65737
7614,5069,2545,853,136700,65738
472,472,0,-,202300,65739
1406,897,509,739,74400,65740
4989,3814,1175,698,175400,65742
34,31,3,-,157300,65744
1127,770,357,657,96900,65745
2527,2004,523,691,139000,65746
1477,1320,157,554,190500,65747
171,91,80,702,80900,65752
1775,1428,347,678,128500,65753
258,210,48,-,167400,65754
234,207,27,-,-,65755
207,178,29,650,152800,65756
2839,2423,416,849,178500,65757
535,420,115,712,97000,65759
294,292,2,-,49200,65760
614,554,60,492,185900,65761
167,134,33,-,73800,65762
489,422,67,729,84100,65764
42,39,3,-,55000,65766
766,610,156,616,110700,65767
241,156,85,509,200000,65768
917,714,203,732,122200,65769
1279,1049,230,711,141000,65770
496,482,14,-,220700,65771
765,662,103,666,133100,65772
279,256,23,-,74300,65773
442,329,113,620,106600,65774
9938,6606,3332,643,116000,65775
157,137,20,-,74700,65777
184,149,35,593,152000,65778
949,746,203,559,78100,65779
3247,2471,776,881,150000,65781
39,31,8,-,76600,65783
7,3,4,-,-,65784
2177,1614,563,645,111900,65785
766,611,155,558,153600,65786
505,395,110,-,202700,65787
163,129,34,337,90500,65788
671,487,184,491,126000,65789
355,327,28,-,64700,65790
1840,1276,564,551,95800,65791
2397,1696,701,472,99400,65793
19231,9666,9565,723,109600,65802
18051,9715,8336,727,111000,65803
18412,9994,8418,743,159200,65804
6496,856,5640,659,81500,65806
25835,11664,14171,815,127800,65807
4753,4006,747,863,288900,65809
9347,6713,2634,896,212600,65810
4743,3156,1587,661,107600,66002
2671,2090,581,871,209500,66006
2432,1911,521,1015,243700,66007
116,96,20,-,96200,66008
339,300,39,564,111400,66010
4296,3263,1033,939,201900,66012
759,732,27,-,367500,66013
139,99,40,-,-,66014
335,236,99,533,92400,66015
134,127,7,-,164300,66016
181,136,45,437,80800,66017
2291,1634,657,766,245700,66018
135,0,135,752,-,66019
534,485,49,902,215100,66020
982,850,132,900,167800,66021
449,325,124,732,86700,66023
284,176,108,700,69000,66024
2611,1819,792,1038,179600,66025
216,187,29,938,134400,66026
1551,0,1551,1679,-,66027
8054,5490,2564,1071,195300,66030
0,0,0,-,-,66031
2002,1452,550,676,97200,66032
268,228,40,688,118800,66033
286,194,92,609,90000,66035
230,195,35,550,112500,66039
1540,1030,510,701,107500,66040
299,275,24,600,127500,66041
285,266,19,497,99300,66042
3019,2196,823,1124,170800,66043
10847,4197,6650,819,168700,66044
0,0,0,-,-,66045
8288,3914,4374,850,165400,66046
8458,3845,4613,1011,230500,66047
13187,8045,5142,836,146300,66048
13330,7588,5742,1028,243400,66049
831,744,87,966,189500,66050
942,751,191,1085,186600,66052
2742,2249,493,999,222700,66053
979,740,239,834,171300,66054
847,695,152,646,115400,66056
113,93,20,558,71500,66058
497,313,184,722,93700,66060
22241,15878,6363,909,237700,66061
28440,21570,6870,1090,248300,66062
2281,1532,749,824,112500,66064
1068,895,173,763,171500,66066
6251,4104,2147,797,124500,66067
1063,986,77,857,150100,66070
5183,4074,1109,769,197500,66071
447,428,19,-,131800,66072
1032,841,191,959,151500,66073
1105,818,287,706,89500,66075
942,753,189,841,126000,66076
411,354,57,674,160300,66078
330,294,36,883,129500,66079
337,279,58,835,84000,66080
3349,2873,476,953,242300,66083
3064,2833,231,1412,418600,66085
3694,3189,505,956,198600,66086
794,574,220,656,105400,66087
899,733,166,578,127600,66088
1191,869,322,714,112600,66090
179,135,44,548,66400,66091
1423,1181,242,667,156100,66092
209,175,34,-,118800,66093
140,85,55,552,63500,66094
402,309,93,783,89900,66095
530,420,110,553,146700,66097
4656,1742,2914,682,57200,66101
10300,5044,5256,837,70800,66102
6065,1981,4084,888,95700,66103
9255,5795,3460,887,76900,66104
793,424,369,782,34400,66105
8305,5324,2981,878,103100,66106
8983,6976,2007,1324,171000,66109
3734,2831,903,909,106400,66111
5161,2506,2655,894,121300,66112
0,0,0,-,-,66115
0,0,0,-,-,66118
8078,4091,3987,958,171400,66202
8029,5089,2940,935,168700,66203
8959,4165,4794,1064,165200,66204
5849,4726,1123,1223,229100,66205
4220,3717,503,2304,434100,66206
6186,4815,1371,1425,289400,66207
9134,7433,1701,1456,294800,66208
8282,6024,2258,1222,390500,66209
8582,4825,3757,1149,255900,66210
2085,1371,714,1262,569500,66211
14420,8911,5509,1034,188900,66212
11663,7217,4446,1200,336700,66213
5239,2632,2607,893,213000,66214
10817,6978,3839,1108,217900,66215
9221,7676,1545,1059,231200,66216
2402,1335,1067,1055,343000,66217
2767,2340,427,1700,288500,66218
5500,2110,3390,1212,265900,66219
2753,2500,253,1219,424000,66220
5743,4466,1277,1237,472700,66221
9836,5710,4126,1387,307400,66223
4691,4085,606,1243,461700,66224
4530,3960,570,1106,276000,66226
2372,2104,268,1494,309900,66227
714,612,102,664,151500,66401
1086,899,187,783,157700,66402
296,247,49,769,203100,66403
170,122,48,604,258800,66404
175,143,32,425,102900,66406
195,169,26,1014,158200,66407
114,78,36,777,-,66408
1286,1155,131,810,241600,66409
523,426,97,621,87200,66411
84,79,5,-,-,66412
828,645,183,529,100800,66413
1241,935,306,662,108500,66414
316,263,53,500,79600,66415
230,182,48,504,137500,66416
148,130,18,508,88200,66417
162,151,11,675,89800,66418
168,148,20,-,103600,66419
135,123,12,-,91900,66422
349,272,77,543,84400,66423
194,167,27,567,77900,66424
229,175,54,450,83000,66425
463,414,49,609,86200,66427
145,140,5,-,125000,66428
250,238,12,-,144100,66429
234,220,14,564,91800,66431
134,101,33,758,106300,66432
1948,1329,619,685,96800,66434
2598,1752,846,598,147500,66436
55,55,0,-,173900,66438
1038,674,364,536,75900,66439
742,670,72,807,152600,66440
10064,4367,5697,946,145500,66441
3781,42,3739,1227,-,66442
387,330,57,805,148200,66449
656,551,105,727,124200,66451
128,119,9,-,76600,66501
17515,7093,10422,876,187600,66502
6474,3959,2515,1063,257900,66503
12,0,12,-,-,66506
461,407,54,641,166100,66507
1912,1371,541,593,106100,66508
1091,820,271,821,137500,66509
288,213,75,733,105200,66510
1124,1034,90,758,143900,66512
508,446,62,708,203600,66514
130,123,7,558,97000,66515
123,101,22,488,88600,66516
707,327,380,812,106600,66517
51,50,1,-,97500,66518
244,212,32,850,136700,66520
678,475,203,583,103000,66521
49,8,41,829,65000,66522
1544,898,646,714,113000,66523
950,807,143,759,157200,66524
325,242,83,845,217100,66526
94,58,36,633,106300,66527
345,256,89,669,130800,66528
750,637,113,1023,171900,66531
298,262,36,1063,154500,66532
588,465,123,863,158500,66533
1442,995,447,653,124800,66534
1066,842,224,894,214800,66535
1118,922,196,723,162300,66536
420,365,55,935,105800,66537
1419,1107,312,622,161900,66538
963,728,235,668,173800,66539
210,180,30,714,109500,66540
87,83,4,450,46200,66541
1116,1054,62,-,162100,66542
492,396,96,944,124500,66543
148,103,45,569,89100,66544
419,378,41,589,194000,66546
3466,2594,872,925,188900,66547
331,279,52,610,93900,66548
723,571,152,733,164600,66549
187,148,39,700,83600,66550
189,153,36,614,88100,66552
232,196,36,928,171400,66554
778,118,660,627,31300,66603
9863,5572,4291,850,95600,66604
7242,4918,2324,801,117500,66605
5317,2736,2581,824,83900,66606
3077,1413,1664,707,40000,66607
2194,1241,953,833,66300,66608
2983,2018,965,804,104800,66609
3884,3673,211,1705,249400,66610
4693,2488,2205,860,102000,66611
1448,243,1205,517,51500,66612
13927,8903,5024,865,145300,66614
1482,942,540,990,216800,66615
2425,1489,936,738,68100,66616
3295,2828,467,931,156400,66617
3608,3265,343,982,169900,66618
856,274,582,1136,75800,66619
0,0,0,-,-,66621
0,0,0,-,-,66622
4701,3244,1457,642,83600,66701
219,186,33,725,58100,66710
248,183,65,544,28500,66711
766,472,294,652,79700,66712
2048,1387,661,683,83700,66713
73,68,5,-,41700,66714
148,121,27,740,33900,66716
232,207,25,538,59700,66717
4702,3176,1526,588,81400,66720
443,378,65,675,65600,66724
2228,1585,643,545,86200,66725
25,17,8,-,-,66728
97,91,6,-,106300,66732
875,642,233,687,66600,66733
88,88,0,-,161700,66734
190,185,5,-,-,66735
1658,1181,477,734,81500,66736
111,107,4,-,104900,66738
2063,1517,546,658,81900,66739
129,118,11,-,66300,66740
77,77,0,-,79800,66741
1583,1114,469,791,90500,66743
88,75,13,-,-,66746
1133,904,229,625,73700,66748
3286,2101,1185,683,84900,66749
290,253,37,708,60500,66751
468,402,66,563,57900,66753
172,128,44,1115,200900,66754
375,282,93,582,66200,66755
394,298,96,340,70600,66756
1325,942,383,617,75300,66757
116,86,30,825,72700,66758
0,0,0,-,-,66760
98,94,4,-,87700,66761
9866,5028,4838,715,103200,66762
1280,959,321,804,129900,66763
212,169,43,504,108200,66767
162,125,37,663,-,66769
403,297,106,603,94100,66770
342,289,53,575,116400,66771
81,79,2,-,76300,66772
312,274,38,900,52500,66773
69,60,9,-,160500,66775
510,375,135,631,90900,66776
272,217,55,525,64200,66777
0,0,0,-,-,66778
243,200,43,475,90700,66779
178,164,14,-,78900,66780
487,377,110,652,59800,66781
57,43,14,-,29500,66782
977,728,249,603,74400,66783
11467,6463,5004,669,105600,66801
85,76,9,-,85000,66830
211,189,22,550,153300,66833
358,298,60,764,88600,66834
544,414,130,730,98100,66835
55,55,0,-,-,66838
1591,1109,482,653,134700,66839
237,168,69,630,81500,66840
187,133,54,544,83900,66842
66,66,0,-,105300,66843
429,320,109,448,78300,66845
1333,1004,329,632,119400,66846
175,167,8,-,85400,66849
95,62,33,783,106300,66850
242,173,69,502,35500,66851
285,212,73,771,91400,66852
192,164,28,738,45900,66853
316,205,111,719,76900,66854
773,664,109,606,137300,66856
451,350,101,675,69500,66857
168,137,31,625,60300,66858
104,92,12,900,95000,66859
610,432,178,583,83100,66860
1297,1004,293,655,86500,66861
53,46,7,485,113900,66862
19,19,0,-,12900,66863
176,158,18,713,72600,66864
490,394,96,911,151700,66865
658,513,145,502,98500,66866
331,281,50,820,153800,66868
304,261,43,566,108800,66869
58,52,6,-,-,66870
534,450,84,817,97800,66871
387,306,81,743,100700,66872
115,107,8,538,51300,66873
2487,1702,785,631,83700,66901
108,57,51,-,-,66930
40,29,11,-,102500,66932
156,122,34,613,95000,66933
1139,769,370,609,75000,66935
163,130,33,1068,46000,66936
324,266,58,463,77300,66937
466,377,89,652,71000,66938
235,164,71,588,68900,66939
144,134,10,-,43100,66940
76,69,7,775,47500,66941
124,107,17,-,33500,66942
231,160,71,475,49300,66943
77,60,17,229,-,66944
422,363,59,550,98800,66945
61,61,0,-,86300,66946
196,177,19,450,75000,66948
306,228,78,444,55500,66949
290,235,55,604,79400,66951
234,173,61,279,37800,66952
248,177,71,525,95500,66953
39,33,6,-,62500,66955
511,420,91,527,66300,66956
108,69,39,300,34100,66958
94,85,9,-,30200,66959
64,47,17,-,14600,66960
136,115,21,683,122700,66962
85,64,21,-,30800,66963
63,54,9,331,32800,66964
314,254,60,521,65300,66966
921,690,231,511,76300,66967
659,497,162,449,76600,66968
52,52,0,-,87800,66970
466,385,81,1000,190700,67001
5257,4043,1214,1303,197700,67002
1002,667,335,816,76400,67003
288,196,92,625,106500,67004
6075,4002,2073,662,75900,67005
347,265,82,688,113700,67008
369,227,142,625,57300,67009
5315,3744,1571,877,141200,67010
14,14,0,-,-,67012
1233,1008,225,763,94100,67013
186,161,25,969,112500,67016
889,778,111,921,206200,67017
49,35,14,-,170800,67018
399,329,70,725,82500,67019
573,456,117,663,101500,67020
13,11,2,-,85000,67021
699,519,180,560,58300,67022
114,99,15,670,87500,67023
393,271,122,533,42500,67024
1355,1111,244,879,151200,67025
1654,1393,261,711,170000,67026
129,86,43,760,44400,67028
438,334,104,506,62600,67029
837,765,72,808,174700,67030
950,755,195,708,132600,67031
393,296,97,639,82500,67035
26,20,6,-,75000,67036
10580,7852,2728,939,170200,67037
275,212,63,575,88900,67038
1159,901,258,705,148800,67039
99,98,1,-,110000,67041
6806,4620,2186,769,101000,67042
1414,1003,411,565,64000,67045
348,248,100,695,64400,67047
52,52,0,-,166900,67049
687,607,80,809,176100,67050
193,180,13,672,81800,67051
2589,2204,385,1125,175500,67052
251,195,56,530,88200,67053
529,346,183,675,155800,67054
42,29,13,-,128700,67055
1173,858,315,638,140000,67056
115,87,28,443,48800,67057
750,570,180,667,70300,67058
321,250,71,619,86000,67059
5279,3916,1363,874,107200,67060
57,43,14,-,80600,67061
1705,1226,479,648,138200,67062
1411,1067,344,604,102700,67063
93,82,11,1075,94000,67065
168,130,38,500,117900,67066
651,591,60,1080,169100,67067
1749,1299,450,659,85200,67068
406,299,107,525,79700,67070
93,85,8,-,-,67071
88,83,5,-,52500,67072
146,133,13,531,80800,67073
631,505,126,670,91700,67074
1730,1073,657,870,167600,67101
81,79,2,-,109700,67103
950,641,309,528,71500,67104
66,54,12,-,60000,67105
137,107,30,-,117200,67106
1446,1028,418,675,155700,67107
558,455,103,767,154400,67108
154,115,39,570,77000,67109
3274,2872,402,803,135900,67110
103,82,21,950,-,67111
109,100,9,-,90000,67112
8349,6009,2340,753,116200,67114
677,385,292,604,158000,67117
303,245,58,744,88800,67118
564,424,140,485,86700,67119
394,394,0,-,166700,67120
78,64,14,-,-,67122
219,165,54,681,69800,67123
3051,1988,1063,700,93300,67124
232,196,36,361,77500,67127
151,102,49,396,239300,67131
166,144,22,686,96700,67132
2330,1949,381,1074,163200,67133
182,136,46,575,77800,67134
1131,844,287,829,165300,67135
219,186,33,613,44400,67137
139,121,18,729,76700,67138
351,286,65,613,87300,67140
159,145,14,-,112500,67142
19,15,4,-,71300,67143
1005,839,166,698,125200,67144
802,650,152,941,122500,67146
3874,3129,745,981,184500,67147
342,331,11,-,230500,67149
21,10,11,-,-,67150
186,136,50,915,84700,67151
3694,2388,1306,761,80600,67152
605,498,107,883,166400,67154
92,79,13,-,-,67155
5416,3503,1913,724,104100,67156
48,48,0,-,58900,67159
1097,131,966,872,-,67202
12691,6376,6315,746,98400,67203
7998,5922,2076,733,106800,67204
6608,5605,1003,1217,230300,67205
7168,4705,2463,906,241400,67206
11361,5558,5803,808,146500,67207
7284,3963,3321,830,122500,67208
5132,3749,1383,937,153900,67209
3367,1227,2140,698,132600,67210
8188,3429,4759,708,72600,67211
18594,12186,6408,883,142500,67212
8646,3547,5099,761,72000,67213
6037,2094,3943,709,55100,67214
2065,1934,131,1298,148300,67215
9011,5195,3816,766,77100,67216
11540,7263,4277,880,87900,67217
9539,4575,4964,763,87100,67218
4371,3052,1319,913,114000,67219
5408,3274,2134,820,151200,67220
221,211,10,-,305300,67223
7922,4679,3243,982,205000,67226
103,103,0,-,307900,67227
697,693,4,-,337400,67228
4039,3777,262,1707,304300,67230
203,203,0,-,310200,67232
4498,4352,146,1522,232400,67235
0,0,0,-,-,67260
5217,3495,1722,703,89600,67301
560,417,143,586,89400,67330
42,38,4,-,71200,67332
1191,955,236,555,69100,67333
23,18,5,-,22800,67334
1414,1083,331,690,70900,67335
649,454,195,531,57600,67336
5026,3117,1909,618,66900,67337
194,182,12,788,48300,67340
137,137,0,-,122000,67341
374,299,75,658,85000,67342
364,335,29,715,72800,67344
54,43,11,-,87500,67345
154,139,15,569,72500,67346
174,163,11,-,-,67347
420,314,106,392,60900,67349
148,131,17,700,57400,67351
222,179,43,485,47200,67352
252,197,55,650,52100,67353
271,194,77,557,81300,67354
63,60,3,-,106800,67355
1095,795,300,535,73800,67356
4972,3275,1697,661,76200,67357
175,142,33,-,43600,67360
710,553,157,626,45800,67361
61,61,0,-,82200,67363
107,99,8,-,62000,67364
20553,13437,7116,760,135800,67401
4305,3067,1238,695,131900,67410
404,364,40,750,170900,67416
61,43,18,-,-,67417
69,43,26,-,23400,67418
1848,1250,598,564,96100,67420
585,482,103,738,124700,67422
79,57,22,933,52500,67423
207,170,37,588,156500,67425
189,141,48,692,59300,67427
582,464,118,825,132700,67428
321,237,84,592,62700,67430
827,566,261,775,156000,67431
2493,1761,732,591,96400,67432
261,204,57,763,60000,67436
487,373,114,414,86500,67437
88,72,16,625,78000,67438
1145,814,331,636,115700,67439
432,329,103,488,73200,67441
63,63,0,-,176300,67442
649,559,90,772,157500,67443
275,241,34,426,84700,67444
252,217,35,633,54800,67445
229,187,42,425,79000,67446
173,114,59,395,85000,67447
490,391,99,828,150200,67448
1321,889,432,629,66100,67449
305,254,51,567,79600,67450
481,317,164,650,84000,67451
73,73,0,-,51000,67452
308,252,56,631,83800,67454
820,627,193,527,75100,67455
1724,1192,532,675,166300,67456
306,204,102,679,109200,67457
90,55,35,450,56800,67458
98,73,25,-,95000,67459
6652,4419,2233,770,152900,67460
491,394,97,665,98100,67464
354,270,84,490,58000,67466
1126,865,261,616,93300,67467
102,85,17,670,68500,67468
197,148,49,1100,115900,67470
796,551,245,551,72000,67473
108,92,16,-,56000,67474
57,52,5,-,81400,67475
31,26,5,525,18300,67478
613,487,126,633,134300,67480
243,208,35,393,81100,67481
40,27,13,-,72800,67482
175,140,35,530,67100,67483
367,309,58,491,108000,67484
142,122,20,436,88800,67485
501,368,133,878,139100,67487
372,308,64,665,82100,67490
156,132,24,665,125000,67491
82,71,11,1125,57800,67492
9777,5798,3979,668,67000,67501
10077,7674,2403,803,140500,67502
1238,709,529,532,98200,67505
97,93,4,-,88300,67510
120,114,6,-,63800,67511
68,58,10,-,41000,67512
39,35,4,-,38500,67513
346,265,81,704,57700,67514
22,18,4,-,185700,67515
158,130,28,531,45800,67516
24,19,5,-,156300,67518
79,57,22,519,39200,67519
119,109,10,-,70500,67520
61,30,31,-,131300,67521
717,541,176,665,152100,67522
168,138,30,638,53900,67523
238,182,56,558,28600,67524
431,358,73,525,92100,67525
1073,801,272,646,77500,67526
78,60,18,550,46700,67529
7481,5104,2377,650,98800,67530
803,599,204,767,98900,67543
1247,872,375,657,74300,67544
73,68,5,-,62500,67545
923,676,247,780,161300,67546
814,620,194,596,57000,67547
669,453,216,513,84900,67548
2141,1373,768,609,86000,67550
290,241,49,556,66900,67552
75,62,13,875,39100,67553
1691,1273,418,559,73800,67554
118,103,15,-,66800,67556
209,178,31,806,52900,67557
4,2,2,-,-,67559
727,597,130,647,85700,67560
506,387,119,660,68700,67561
138,113,25,550,78500,67563
87,78,9,-,52900,67564
211,191,20,600,73400,67565
191,171,20,770,97200,67566
243,168,75,579,48000,67567
102,85,17,568,99400,67568
506,426,80,646,94400,67570
228,208,20,511,62100,67572
88,67,21,435,110400,67573
73,58,15,575,52000,67574
248,196,52,703,60600,67575
821,676,145,669,90000,67576
557,420,137,575,50000,67578
1197,887,310,580,100400,67579
130,117,13,392,65400,67581
379,307,72,527,48900,67583
101,86,15,550,48200,67584
9681,5592,4089,711,176900,67601
160,125,35,440,65000,67621
236,182,54,604,100500,67622
77,60,17,488,27100,67623
121,86,35,500,46700,67625
92,86,6,-,-,67626
45,39,6,-,108600,67628
63,62,1,-,64900,67629
70,68,2,-,151100,67631
115,75,40,475,89600,67632
81,62,19,494,73100,67634
49,42,7,-,105000,67635
1109,911,198,713,123400,67637
139,114,25,185,41300,67638
72,67,5,-,88300,67639
221,168,53,725,101900,67640
863,705,158,605,81800,67642
114,97,17,718,-,67643
113,92,21,-,39300,67644
242,222,20,400,62500,67645
332,279,53,559,68600,67646
105,73,32,478,77000,67647
258,200,58,520,51000,67648
119,101,18,242,48200,67649
105,96,9,-,63500,67650
199,160,39,518,49300,67651
196,132,64,675,57000,67653
1354,1066,288,645,87500,67654
41,33,8,-,-,67656
139,95,44,531,81300,67657
51,43,8,-,167700,67658
50,47,3,-,55500,67659
44,36,8,-,105000,67660
1412,1024,388,703,88900,67661
1060,815,245,583,86500,67663
113,89,24,625,59500,67664
2209,1715,494,647,104300,67665
64,59,5,-,107200,67667
799,607,192,513,67300,67669
624,472,152,791,158000,67671
1171,857,314,580,95200,67672
43,33,10,467,52100,67673
28,28,0,-,75000,67674
88,83,5,-,46800,67675
2878,1896,982,641,133300,67701
790,564,226,631,109200,67730
321,234,87,494,76500,67731
192,145,47,622,110100,67732
94,68,26,-,88100,67733
117,74,43,-,112500,67734
2245,1480,765,832,118200,67735
101,73,28,600,103100,67736
218,180,38,534,100900,67737
259,208,51,600,83600,67738
87,71,16,510,34200,67739
747,563,184,662,118100,67740
182,142,40,617,75000,67741
38,34,4,-,-,67743
71,61,10,-,118100,67744
178,137,41,385,73500,67745
57,54,3,-,71000,67747
1022,698,324,693,106000,67748
1053,750,303,656,70800,67749
130,121,9,-,53400,67751
591,415,176,680,110500,67752
169,119,50,619,99300,67753
889,737,152,618,79700,67756
203,176,27,492,108800,67757
474,348,126,575,86800,67758
96,86,10,667,95400,67761
79,57,22,342,91300,67762
155,126,29,392,57400,67764
10040,6095,3945,786,112600,67801
424,312,112,483,59400,67831
349,262,87,620,87100,67834
1018,740,278,642,150000,67835
55,43,12,-,-,67836
383,272,111,478,122700,67837
318,261,57,833,57400,67838
603,479,124,435,94800,67839
41,38,3,-,42500,67840
148,136,12,775,78900,67841
156,111,45,694,57000,67842
103,0,103,714,-,67843
355,230,125,614,79700,67844
11512,7166,4346,808,151800,67846
150,119,31,495,58500,67849
157,96,61,545,64100,67850
871,780,91,1012,155100,67851
240,189,51,775,114500,67853
557,446,111,815,87800,67854
645,465,180,671,96900,67855
57,29,28,-,201700,67857
240,181,59,747,79200,67859
831,623,208,638,130100,67860
825,628,197,705,89200,67861
100,89,11,758,72500,67862
128,71,57,711,79300,67863
745,505,240,614,95000,67864
447,331,116,688,107300,67865
634,515,119,674,125500,67867
72,72,0,-,206100,67868
577,428,149,679,122100,67869
437,344,93,650,87100,67870
1983,1374,609,827,137300,67871
474,377,97,761,129200,67876
774,607,167,663,118900,67877
798,581,217,665,83400,67878
519,327,192,720,111200,67879
2578,1910,668,643,116100,67880
137,67,70,629,162100,67882
7027,4659,2368,788,106300,67901
728,517,211,610,91400,67950
1633,1126,507,669,112700,67951
184,151,33,931,120300,67952
52,27,25,-,66400,67953
290,196,94,735,83200,67954
24,19,5,-,66300,68001
939,723,216,675,189300,68002
1856,1293,563,763,203700,68003
385,284,101,571,103000,68004
9292,5288,4004,837,140400,68005
4119,3675,444,1137,245900,68007
4988,3831,1157,717,178000,68008
13,2,11,-,-,68010
117,97,20,680,110100,68014
452,387,65,924,148100,68015
191,175,16,1150,240400,68016
761,639,122,732,161700,68017
191,178,13,525,161000,68018
163,144,19,717,102100,68019
290,244,46,494,86700,68020
9147,6887,2260,1068,332300,68022
1005,774,231,876,287500,68023
12679,7639,5040,773,138600,68025
4902,4073,829,1024,265800,68028
356,240,116,633,126900,68029
340,247,93,883,116100,68030
699,492,207,684,147600,68031
138,120,18,850,205200,68033
290,260,30,1089,155000,68034
112,75,37,753,-,68036
929,720,209,795,226900,68037
563,455,108,606,85700,68038
309,95,214,613,52100,68039
171,132,39,992,162200,68040
428,315,113,728,154300,68041
28,27,1,-,103100,68042
226,200,26,988,132700,68044
815,556,259,707,109200,68045
10125,7302,2823,937,218300,68046
717,576,141,689,119100,68047
4983,3909,1074,848,165600,68048
288,243,45,719,108700,68050
114,85,29,568,60600,68055
656,482,174,601,89600,68057
123,115,8,725,350000,68058
1331,1143,188,927,230700,68059
1001,776,225,625,106400,68061
118,91,27,713,156300,68062
114,83,31,544,87900,68063
1617,1192,425,883,211900,68064
591,505,86,769,171200,68065
2227,1611,616,740,157400,68066
322,209,113,558,42600,68067
38,36,2,-,145000,68068
1152,985,167,840,267500,68069
319,285,34,665,155900,68070
577,263,314,593,72100,68071
30,20,10,-,65000,68072
779,655,124,795,186700,68073
4416,600,3816,1020,314100,68102
14273,8159,6114,837,105700,68104
9629,3902,5727,814,125900,68105
9512,5860,3652,954,139500,68106
9229,5695,3534,834,95300,68107
5107,2380,2727,879,96300,68108
3235,1494,1741,722,65400,68110
8135,3580,4555,936,65200,68111
4305,2859,1446,1022,98600,68112
238,0,238,1219,-,68113
8179,3999,4180,1010,183100,68114
11447,8862,2585,1139,229100,68116
3053,2237,816,976,112100,68117
3537,3097,440,1544,275800,68118
4212,3474,738,1180,159900,68122
11467,6506,4961,1177,195100,68123
6507,4247,2260,1080,210700,68124
10000,4424,5576,836,161100,68127
7753,4580,3173,1028,176700,68128
7875,6090,1785,1275,282200,68130
5411,1570,3841,848,117600,68131
5644,2885,2759,758,265600,68132
3763,3279,484,1180,259900,68133
12670,6834,5836,837,142300,68134
9819,8926,893,1529,239900,68135
6013,5138,875,1228,247500,68136
10381,6921,3460,1051,157500,68137
4850,3758,1092,856,154600,68138
1813,1657,156,1119,221200,68142
9923,6924,2999,906,172300,68144
3915,2840,1075,987,141000,68147
2449,1937,512,807,188600,68152
9831,6022,3809,945,222800,68154
2661,1777,884,1069,156100,68157
11888,7671,4217,1030,167100,68164
0,0,0,-,-,68178
542,436,106,905,249000,68301
133,122,11,-,57300,68303
112,105,7,1031,196600,68304
1859,1305,554,559,111700,68305
205,157,48,700,133800,68307
51,38,13,-,41400,68309
5938,3732,2206,630,114100,68310
293,243,50,1265,103300,68313
182,143,39,736,-,68314
56,43,13,-,-,68315
248,198,50,588,114300,68316
706,665,41,932,207700,68317
186,157,29,850,65700,68318
215,174,41,586,108300,68319
190,145,45,637,89800,68320
130,124,6,-,88300,68321
193,151,42,-,93000,68322
136,105,31,-,115300,68323
49,38,11,-,100000,68324
75,69,6,-,84600,68325
58,49,9,-,89200,68326
144,134,10,-,40500,68327
212,159,53,714,130700,68328
273,213,60,519,80300,68329
355,302,53,1021,167100,68331
51,45,6,-,-,68332
2883,1889,994,789,117200,68333
224,191,33,644,58500,68335
253,249,4,-,212500,68336
157,140,17,531,78200,68337
158,129,29,-,92500,68338
481,430,51,444,286100,68339
420,309,111,654,68500,68340
474,362,112,791,131300,68341
252,187,65,608,92300,68342
361,301,60,725,102700,68343
170,144,26,794,115800,68344
117,108,9,-,68800,68345
222,167,55,670,147900,68346
973,937,36,868,224800,68347
122,87,35,471,207400,68348
457,399,58,764,171200,68349
93,81,12,-,71500,68350
389,302,87,543,83500,68351
2257,1478,779,655,80400,68352
423,368,55,508,68700,68354
2241,1640,601,521,74000,68355
128,118,10,688,125000,68357
594,555,39,666,278200,68358
584,460,124,772,125900,68359
192,153,39,1317,157700,68360
1030,762,268,558,86800,68361
25,21,4,-,44200,68362
44,44,0,-,112500,68364
117,98,19,-,105000,68365
369,335,34,1092,158400,68366
143,121,22,432,52600,68367
189,178,11,1063,266000,68368
912,667,245,585,87400,68370
671,523,148,766,124900,68371
1225,1111,114,967,248700,68372
57,49,8,375,"10,000-",68375
628,475,153,515,68100,68376
189,151,38,-,102800,68377
290,275,15,650,124600,68378
33,33,0,-,78300,68379
48,32,16,-,35600,68380
78,58,20,467,-,68381
9,5,4,-,104200,68382
278,225,53,752,151400,68401
473,397,76,925,255500,68402
81,64,17,694,135000,68403
371,332,39,-,248900,68404
1266,789,477,736,180500,68405
208,158,50,713,62700,68406
254,208,46,850,195800,68407
333,270,63,888,148600,68409
3593,2303,1290,705,131800,68410
235,211,24,629,179400,68413
125,79,46,577,73000,68414
265,238,27,675,93000,68415
93,66,27,531,38600,68416
138,110,28,906,-,68417
414,350,64,862,171200,68418
81,65,16,683,153800,68419
583,495,88,486,74600,68420
333,204,129,494,82600,68421
194,175,19,814,198900,68422
464,422,42,658,253100,68423
298,252,46,700,99400,68424
485,424,61,1324,355100,68428
672,597,75,1319,360500,68430
148,135,13,-,61900,68431
99,69,30,-,43900,68433
3224,2227,997,701,175800,68434
216,170,46,617,90000,68436
112,106,6,600,58900,68437
46,41,5,-,117500,68438
266,221,45,634,111900,68439
49,46,3,-,-,68440
87,68,19,-,-,68441
172,141,31,-,82800,68442
375,343,32,719,107100,68443
26,21,5,-,95000,68444
68,59,9,-,75900,68445
1185,802,383,607,148500,68446
245,205,40,629,48800,68447
161,140,21,721,107400,68448
966,622,344,685,91900,68450
49,45,4,-,-,68452
175,130,45,-,54400,68453
278,223,55,671,163100,68454
195,173,22,-,265600,68455
512,377,135,831,142000,68456
191,138,53,644,40000,68457
71,62,9,713,86700,68458
289,229,60,694,119800,68460
331,260,71,1008,380000,68461
1600,1276,324,803,191400,68462
562,416,146,631,141800,68463
259,239,20,614,58100,68464
870,633,237,646,124200,68465
716,562,154,616,57000,68466
3820,2592,1228,712,142400,68467
11150,5890,5260,684,150100,68502
6284,2061,4223,695,103400,68503
7769,2959,4810,836,125300,68504
6805,3996,2809,907,147800,68505
12995,7973,5022,944,172800,68506
6450,4542,1908,843,150100,68507
5184,487,4697,619,91100,68508
9199,5412,3787,764,150600,68510
5445,3459,1986,1000,231200,68512
26,26,0,-,-,68514
17671,12666,5005,1013,238400,68516
207,188,19,-,338000,68517
948,915,33,1394,333900,68520
13761,7855,5906,887,165200,68521
4354,3125,1229,971,158700,68522
497,480,17,-,372900,68523
2110,1275,835,828,141900,68524
2447,1988,459,1151,327700,68526
285,285,0,-,413200,68527
2460,1571,889,974,157600,68528
247,98,149,979,337500,68531
224,224,0,-,343100,68532
11200,7942,3258,766,150500,68601
1189,891,298,579,138400,68620
203,203,0,-,-,68621
111,63,48,400,76300,68622
176,145,31,624,31000,68623
376,341,35,722,122500,68624
286,229,57,703,108700,68626
293,242,51,725,108300,68627
366,270,96,733,86500,68628
546,444,102,600,84800,68629
178,147,31,438,116500,68631
1577,1094,483,775,117200,68632
534,416,118,650,97500,68633
226,202,24,1113,94600,68634
202,173,29,675,163800,68635
605,471,134,601,89900,68636
154,104,50,581,90000,68637
748,583,165,553,82600,68638
579,471,108,755,87500,68640
491,401,90,548,109500,68641
752,630,122,812,190600,68642
452,366,86,670,124300,68643
255,192,63,800,122100,68644
272,224,48,631,110700,68647
123,86,37,726,131500,68648
797,569,228,684,138800,68649
556,461,95,570,108400,68651
297,251,46,622,86700,68652
282,261,21,968,116600,68653
223,162,61,821,67100,68654
46,34,12,-,-,68655
319,293,26,806,109100,68658
83,52,31,582,150000,68659
512,361,151,558,99600,68660
2254,1544,710,725,105100,68661
494,422,72,596,116000,68662
279,239,40,725,75000,68663
135,107,28,882,65900,68664
401,332,69,675,59800,68665
578,471,107,655,95600,68666
32,26,6,-,48000,68667
220,181,39,570,115200,68669
12694,8292,4402,702,151000,68701
312,261,51,575,119200,68710
95,78,17,-,67100,68711
998,768,230,554,119500,68713
546,436,110,504,97200,68714
597,473,124,663,158000,68715
431,288,143,682,79100,68716
104,98,6,-,122200,68717
769,522,247,610,84400,68718
52,42,10,738,-,68719
135,98,37,756,87300,68720
242,179,63,463,55400,68722
221,188,33,770,83600,68723
59,43,16,-,129200,68724
250,212,38,634,71700,68725
211,152,59,533,66200,68726
328,256,72,535,100700,68727
112,86,26,-,75700,68728
838,674,164,558,105300,68729
784,644,140,423,160100,68730
969,686,283,704,119900,68731
104,97,7,392,62500,68732
524,390,134,609,98000,68733
31,22,9,-,-,68734
329,262,67,635,74600,68735
246,212,34,-,123800,68736
1216,1030,186,759,136800,68739
400,326,74,829,216700,68740
289,223,66,972,154700,68741
74,57,17,725,-,68742
211,147,64,746,207300,68743
628,466,162,666,112500,68745
209,183,26,513,58100,68746
46,36,10,-,167900,68747
1030,760,270,694,103500,68748
28,19,9,-,53600,68749
26,21,5,-,63600,68751
300,261,39,500,123400,68752
59,32,27,-,183300,68753
139,122,17,-,110000,68755
824,604,220,641,86900,68756
310,275,35,819,89800,68757
545,372,173,550,86300,68758
94,78,16,-,86000,68759
523,313,210,423,80200,68760
164,136,28,735,23600,68761
2046,1322,724,739,139700,68763
374,293,81,432,81500,68764
547,467,80,693,120400,68765
182,150,32,492,97900,68766
1410,1071,339,583,161400,68767
269,182,87,1021,90000,68768
752,548,204,711,88500,68769
649,514,135,575,99800,68770
626,439,187,669,110900,68771
66,53,13,567,160900,68773
88,80,8,-,118800,68774
5364,3347,2017,818,116800,68776
297,241,56,559,83300,68777
203,160,43,667,67500,68778
1019,768,251,493,112800,68779
478,361,117,582,106500,68780
564,409,155,541,87500,68781
417,322,95,630,76800,68783
724,548,176,736,103700,68784
100,78,22,675,150000,68785
368,302,66,-,78400,68786
2462,1348,1114,678,137300,68787
1910,1298,612,722,136000,68788
60,53,7,-,-,68789
419,322,97,545,91700,68790
732,517,215,628,117400,68791
147,126,21,643,103100,68792
10853,6531,4322,759,121800,68801
9913,6173,3740,775,171100,68803
416,329,87,764,87800,68810
200,162,38,664,117300,68812
230,170,60,722,69500,68813
379,272,107,699,75000,68814
268,180,88,665,118800,68815
93,82,11,-,109700,68816
152,130,22,594,81600,68817
2237,1614,623,752,157000,68818
153,141,12,914,112500,68820
25,14,11,558,-,68821
2174,1411,763,646,133300,68822
994,771,223,446,115200,68823
586,434,152,719,153200,68824
441,336,105,578,130700,68825
1695,1110,585,674,124600,68826
257,197,60,777,87600,68827
127,95,32,738,78100,68828
351,253,98,739,142500,68831
790,626,164,913,202200,68832
135,101,34,-,82500,68833
77,61,16,583,94400,68834
275,196,79,535,107100,68835
680,557,123,885,133900,68836
59,36,23,1697,300000,68837
92,84,8,-,78800,68838
1167,871,296,832,143100,68840
203,187,16,813,159200,68841
245,173,72,436,87700,68842
308,278,30,738,125800,68843
103,96,7,-,143100,68844
8175,4727,3448,781,207000,68845
97,75,22,513,81900,68846
6997,4545,2452,781,165000,68847
0,0,0,-,-,68849
4338,2623,1715,750,101500,68850
243,185,58,652,77200,68852
689,508,181,523,87800,68853
373,308,65,1262,123600,68854
181,131,50,581,79500,68855
310,179,131,827,120400,68856
111,85,26,606,78300,68858
256,203,53,365,73300,68859
169,137,32,465,58600,68860
37,31,6,-,101000,68861
1330,1007,323,553,115200,68862
432,309,123,637,85900,68863
461,393,68,683,123300,68864
385,315,70,659,171500,68865
411,344,67,594,165900,68866
882,675,207,625,108300,68869
228,187,41,853,218300,68870
106,87,19,-,114800,68871
317,268,49,820,148000,68872
1457,1081,376,691,160200,68873
386,272,114,813,72300,68874
271,230,41,479,86900,68875
590,413,177,652,118800,68876
158,107,51,675,124200,68878
200,151,49,338,78500,68879
0,0,0,-,-,68881
181,135,46,680,57100,68882
915,686,229,754,135300,68883
10648,6670,3978,721,124100,68901
726,561,165,700,119100,68920
581,445,136,656,87400,68922
35,35,0,-,65000,68923
488,422,66,625,151100,68924
196,167,29,883,194300,68925
278,202,76,568,58100,68926
554,403,151,685,123400,68927
130,125,5,-,82500,68928
69,67,2,-,45000,68929
599,484,115,625,118900,68930
190,173,17,556,50300,68932
436,347,89,519,93600,68933
69,44,25,-,100000,68934
296,183,113,550,72000,68935
114,62,52,629,30900,68936
808,599,209,646,162000,68937
232,199,33,619,86400,68938
533,400,133,438,80200,68939
233,164,69,692,225000,68940
324,289,35,823,99500,68941
150,112,38,733,38000,68942
105,77,28,480,22500,68943
443,315,128,611,82500,68944
109,89,20,756,173600,68945
11,11,0,-,29400,68946
251,218,33,580,91500,68947
147,117,30,620,47200,68948
2789,1952,837,670,137000,68949
151,121,30,594,91700,68950
41,24,17,-,-,68952
18,11,7,-,-,68954
770,705,65,670,185100,68955
548,440,108,730,118400,68956
252,231,21,481,67300,68957
280,244,36,594,120500,68958
1564,1176,388,686,150900,68959
85,65,20,-,34800,68960
300,268,32,508,72900,68961
32,27,5,-,27500,68964
309,240,69,424,84200,68966
456,311,145,696,71100,68967
9,9,0,-,65000,68969
655,487,168,349,59300,68970
191,152,39,650,113900,68971
81,57,24,-,102500,68972
172,161,11,725,108500,68973
75,72,3,-,85000,68974
43,43,0,-,-,68975
154,124,30,814,106300,68976
112,105,7,-,53400,68977
1038,740,298,476,67500,68978
746,620,126,701,115100,68979
158,121,37,731,138800,68980
165,130,35,869,65800,68981
234,158,76,714,94300,68982
3789,2710,1079,617,113600,69001
194,158,36,620,74700,69020
633,453,180,471,76700,69021
786,631,155,640,93600,69022
103,94,9,-,162500,69023
538,394,144,765,86100,69024
454,262,192,430,96300,69025
81,62,19,-,-,69026
16,8,8,-,-,69027
365,303,62,721,120400,69028
178,148,30,425,65800,69029
97,62,35,671,46300,69030
220,166,54,503,78900,69032
1131,866,265,742,160700,69033
395,319,76,706,77200,69034
39,26,13,-,31700,69036
66,66,0,-,-,69037
226,160,66,606,77000,69038
44,23,21,-,143800,69039
279,231,48,638,49500,69040
33,27,6,-,-,69041
9,9,0,-,-,69042
215,167,48,700,55900,69043
338,215,123,380,65800,69044
525,359,166,577,77100,69045
69,60,9,-,40000,69046
12288,7910,4378,755,140200,69101
492,392,100,625,98900,69120
172,114,58,658,115300,69121
312,222,90,661,84300,69122
358,286,72,694,139300,69123
162,79,83,685,38800,69125
377,315,62,588,171000,69127
67,57,10,950,81300,69128
518,411,107,598,91200,69129
2101,1494,607,679,89900,69130
295,252,43,1018,83300,69131
51,37,14,-,240600,69132
177,153,24,975,81400,69133
188,160,28,589,118300,69134
29,29,0,-,-,69135
1596,1176,420,672,112600,69138
767,558,209,687,121300,69140
159,126,33,809,90000,69141
52,29,23,700,75800,69142
612,520,92,725,141200,69143
77,63,14,-,-,69144
1378,940,438,738,83200,69145
165,117,48,-,157600,69146
232,181,51,753,109700,69147
56,41,15,-,-,69148
317,263,54,510,79500,69149
151,139,12,783,164400,69150
330,275,55,667,158800,69151
379,243,136,573,97800,69152
2743,1755,988,636,123400,69153
546,431,115,596,84800,69154
474,372,102,531,109700,69155
292,242,50,788,83100,69156
43,35,8,-,57200,69157
47,36,11,-,250000,69161
3392,2087,1305,791,112600,69162
393,299,94,612,115700,69163
764,596,168,805,125000,69165
259,176,83,592,116700,69166
152,108,44,610,95000,69167
108,89,19,775,56300,69168
218,171,47,725,101700,69169
113,92,21,688,122200,69170
5,5,0,-,-,69171
1742,1000,742,749,134300,69201
1079,822,257,519,82300,69210
180,119,61,575,69200,69211
115,54,61,440,78000,69212
108,53,55,766,105500,69214
44,30,14,-,-,69216
202,173,29,575,47400,69217
128,85,43,-,39400,69218
76,30,46,-,228600,69219
14,6,8,-,-,69220
58,42,16,-,-,69221
4148,2805,1343,668,119700,69301
27,19,8,-,-,69331
141,105,36,1607,38800,69333
851,686,165,621,95900,69334
12,4,8,-,-,69335
982,666,316,735,103600,69336
2703,1609,1094,721,137700,69337
641,531,110,505,77500,69339
22,14,8,-,-,69340
4242,3160,1082,763,135300,69341
1066,689,377,704,65800,69343
175,123,52,428,144900,69345
261,183,78,588,79700,69346
611,483,128,684,86800,69347
663,498,165,667,89600,69348
175,123,52,425,59300,69350
112,52,60,-,112800,69351
253,206,47,1299,100000,69352
13,11,2,-,68300,69353
54,7,47,-,-,69354
76,72,4,700,114300,69355
730,532,198,625,97100,69356
1530,1183,347,756,117800,69357
809,578,231,721,136800,69358
552,361,191,610,71700,69360
7207,4230,2977,784,132600,69361
8,8,0,-,-,69365
89,59,30,-,110600,69366
152,144,8,556,139300,69367
17517,8865,8652,937,229500,70001
8508,4348,4160,939,298300,70002
15941,12038,3903,930,197300,70003
11377,7072,4305,987,298100,70005
6019,3756,2263,1024,261900,70006
1312,1232,80,1287,180400,70030
484,455,29,1600,143300,70031
1683,1167,516,932,155600,70032
483,473,10,-,163200,70036
6070,3847,2223,1366,266100,70037
68,59,9,-,53900,70038
980,603,377,1058,155700,70039
485,384,101,575,88400,70040
1057,928,129,883,67600,70041
7544,4222,3322,960,152900,70043
4698,3848,850,1104,235100,70047
571,459,112,719,97700,70049
67,42,25,-,83300,70050
756,634,122,-,113000,70051
1261,1032,229,981,150700,70052
6712,3142,3570,882,157300,70053
14161,8117,6044,1006,171600,70056
1654,1228,426,579,163200,70057
13936,8761,5175,1024,150200,70058
6250,3010,3240,928,144400,70062
19222,11771,7451,986,193500,70065
865,797,68,1020,171100,70067
11788,9258,2530,970,161600,70068
4813,4168,645,1148,219800,70070
1338,986,352,-,152400,70071
19771,14720,5051,960,154200,70072
1790,1498,292,856,173900,70075
66,55,11,-,150400,70076
1201,916,285,939,162200,70079
527,462,65,-,156400,70080
101,68,33,-,-,70082
989,750,239,848,86400,70083
2357,1829,528,464,122900,70084
1688,1474,214,870,104600,70085
853,595,258,790,104000,70086
2914,2065,849,730,152700,70087
2749,2177,572,465,138800,70090
82,57,25,-,93900,70091
2300,1799,501,964,136100,70092
11037,6723,4314,975,108200,70094
1566,214,1352,1315,378600,70112
3535,724,2811,753,207200,70113
9537,4337,5200,919,163200,70114
14575,7322,7253,1172,462900,70115
5934,2285,3649,940,353100,70116
11690,5598,6092,958,184500,70117
12491,6317,6174,1016,358900,70118
15919,5438,10481,1029,280400,70119
5557,2942,2615,914,188900,70121
14625,8297,6328,987,201400,70122
11766,6953,4813,1124,254800,70123
8174,5821,2353,1461,432400,70124
6179,2708,3471,1052,344100,70125
10259,4866,5393,952,158000,70126
9819,4326,5493,870,157200,70127
7127,4659,2468,967,171100,70128
2939,1900,1039,955,145100,70129
7455,2580,4875,1169,392800,70130
11995,6848,5147,942,188700,70131
0,0,0,-,-,70139
0,0,0,-,-,70163
17310,12410,4900,825,174000,70301
2352,1801,551,746,144200,70339
99,99,0,-,-,70340
1635,1215,420,939,148500,70341
1712,1209,503,733,138300,70342
1890,1719,171,1057,170900,70343
1846,1571,275,614,88200,70344
3771,3003,768,1022,146400,70345
4170,2778,1392,634,125300,70346
66,49,17,-,95000,70352
521,490,31,-,64600,70353
1770,1563,207,743,135600,70354
427,396,31,-,151600,70355
766,508,258,631,95500,70356
1090,739,351,635,89000,70357
330,214,116,1009,203600,70358
3130,2401,729,783,156300,70359
10841,7454,3387,969,233100,70360
8680,5627,3053,759,120200,70363
10535,7748,2787,853,160900,70364
1048,865,183,888,103000,70372
2513,1950,563,654,129300,70373
2708,2019,689,763,124500,70374
48,48,0,-,213000,70375
1462,1217,245,627,81100,70377
8649,5012,3637,809,115500,70380
2499,1891,608,630,104000,70390
95,84,11,-,-,70391
3213,1988,1225,742,117400,70392
303,227,76,-,157100,70393
5602,4469,1133,759,152500,70394
1735,1335,400,752,127100,70395
294,223,71,-,145600,70397
7714,3984,3730,807,187300,70401
0,0,0,-,-,70402
11352,7190,4162,851,166600,70403
2981,2469,512,988,215200,70420
4938,3686,1252,794,124200,70422
1811,1313,498,627,100900,70426
7693,4737,2956,613,93800,70427
2018,1844,174,1132,232100,70431
14730,10548,4182,1177,255200,70433
6213,5722,491,1032,210800,70435
317,229,88,-,253100,70436
3235,2861,374,1004,235300,70437
7270,5205,2065,696,105800,70438
1722,1216,506,703,102900,70441
91,91,0,-,201800,70442
3469,2678,791,786,100300,70443
3746,2736,1010,741,110700,70444
4023,3545,478,1298,167300,70445
2617,2225,392,745,170500,70446
5026,4554,472,1349,292200,70447
9237,7418,1819,1311,261500,70448
1457,1260,197,829,160800,70449
1048,820,228,782,114200,70450
0,0,0,-,-,70451
5095,4098,997,733,162500,70452
240,240,0,-,143300,70453
11333,8806,2527,888,169500,70454
280,280,0,-,-,70455
826,615,211,723,120000,70456
14098,10041,4057,1076,174900,70458
7645,5723,1922,1049,150300,70460
10451,7796,2655,950,213200,70461
2123,1800,323,755,162800,70462
46,30,16,631,-,70463
162,143,19,-,110500,70464
185,127,58,700,33900,70465
3054,2148,906,837,127300,70466
8116,6184,1932,1012,293200,70471
11455,5374,6081,768,114800,70501
11507,8015,3492,1041,239000,70503
17125,8952,8173,845,172300,70506
6412,4355,2057,851,157000,70507
16540,11263,5277,1001,252900,70508
9711,7030,2681,691,121900,70510
3621,3021,600,696,94700,70512
130,25,105,313,-,70513
850,462,388,684,96700,70514
1323,985,338,518,80800,70515
202,202,0,-,177100,70516
9873,7680,2193,714,136700,70517
5205,4020,1185,1156,201700,70518
78,78,0,-,-,70519
7016,5422,1594,712,164300,70520
292,221,71,845,109200,70523
114,72,42,534,85800,70524
5201,3751,1450,653,102000,70525
6723,4098,2625,730,123100,70526
912,684,228,694,96800,70528
4644,3224,1420,733,146500,70529
567,469,98,904,115200,70531
951,741,210,607,81100,70532
2722,2165,557,664,113700,70533
285,185,100,638,67300,70534
6297,4105,2192,649,123500,70535
169,136,33,-,31800,70537
5295,3378,1917,752,83900,70538
134,91,43,719,95000,70541
1470,1266,204,579,125500,70542
1617,1270,347,506,168400,70543
3756,2646,1110,715,86300,70544
6474,4570,1904,603,120700,70546
3655,2854,801,598,96300,70548
1257,801,456,595,86200,70549
0,0,0,-,-,70550
555,346,209,910,78900,70552
2117,1305,812,465,106000,70554
3002,2550,452,719,185300,70555
130,63,67,275,76100,70556
0,0,0,-,-,70558
983,767,216,760,84700,70559
14524,8772,5752,755,87600,70560
7253,5833,1420,920,161100,70563
14588,9689,4899,672,107700,70570
30,30,0,-,-,70575
292,166,126,644,88500,70576
1504,1169,335,587,93400,70577
6056,4517,1539,667,133300,70578
111,38,73,-,-,70580
284,264,20,-,85300,70581
7289,5605,1684,616,118200,70582
4215,2871,1344,780,113900,70583
2848,2076,772,671,137300,70584
113,93,20,500,69200,70585
7461,4792,2669,601,92100,70586
1255,925,330,556,117900,70589
1846,1432,414,733,121300,70591
8495,6858,1637,1125,199700,70592
14029,6875,7154,746,124600,70601
15110,10855,4255,1130,217600,70605
11481,6379,5102,814,122900,70607
7225,6058,1167,871,206800,70611
4706,3038,1668,771,113100,70615
813,672,141,693,160900,70630
159,154,5,-,92000,70631
160,160,0,-,113500,70632
2663,2131,532,623,118700,70633
9629,7030,2599,740,147100,70634
322,247,75,-,67100,70637
298,218,80,1066,91400,70638
200,200,0,-,83400,70639
123,93,30,560,62100,70640
169,108,61,-,-,70643
81,81,0,-,112700,70644
531,457,74,823,123400,70645
294,209,85,-,91400,70646
3390,2455,935,809,185200,70647
2658,2021,637,714,120700,70648
58,40,18,-,105000,70650
52,30,22,-,-,70651
699,591,108,-,66800,70652
1252,1019,233,366,92400,70653
103,103,0,-,108400,70654
888,620,268,531,84100,70655
1361,1116,245,991,69100,70656
1810,1684,126,815,117800,70657
285,242,43,767,126500,70658
532,264,268,920,126500,70659
595,519,76,-,63100,70660
753,674,79,-,74400,70661
132,123,9,-,128900,70662
10526,7829,2697,815,139500,70663
3999,3349,650,1054,165900,70665
2372,1807,565,682,107000,70668
3751,2868,883,994,136800,70669
7465,6184,1281,1066,172600,70706
1694,1346,348,1034,205100,70710
1674,1335,339,678,167600,70711
136,32,104,803,"10,000-",70712
6656,4859,1797,952,142000,70714
588,510,78,459,107500,70715
1774,1265,509,728,213900,70719
298,76,222,920,56100,70721
2363,1926,437,543,169600,70722
414,344,70,1054,143300,70723
607,607,0,-,178400,70725
19779,15345,4434,961,169300,70726
236,214,22,-,186400,70729
1413,1232,181,823,163500,70730
520,404,116,567,109500,70732
515,437,78,912,169000,70733
2590,2007,583,1090,267100,70734
189,171,18,-,106400,70736
15792,12229,3563,991,195400,70737
4685,4269,416,985,240500,70739
616,410,206,846,98100,70740
87,81,6,-,231300,70743
2106,1874,232,847,120500,70744
86,31,55,-,-,70747
1660,1263,397,619,88900,70748
506,405,101,956,183400,70749
601,422,179,589,75900,70750
314,205,109,-,-,70752
290,214,76,1181,85300,70753
4452,3774,678,1013,159300,70754
720,615,105,671,137700,70755
158,127,31,-,203300,70756
1200,1004,196,414,81700,70757
752,611,141,856,130500,70759
2528,1556,972,885,148600,70760
292,241,51,450,130500,70761
400,293,107,-,207800,70762
1500,1283,217,442,256300,70763
5914,4396,1518,802,146400,70764
5984,4243,1741,904,188000,70767
15236,13527,1709,1160,231300,70769
1153,1077,76,-,180500,70770
319,292,27,-,105600,70772
92,53,39,-,147800,70773
3467,2901,566,919,166900,70774
3614,2745,869,796,231500,70775
1264,1009,255,655,254400,70776
1439,1123,316,848,143300,70777
1241,1090,151,869,198500,70778
473,436,37,-,131600,70780
52,30,22,-,175000,70782
1250,1163,87,797,167600,70783
7959,6804,1155,840,170700,70785
67,25,42,-,-,70787
1363,862,501,695,137900,70788
252,192,60,556,137500,70789
9243,7030,2213,887,226300,70791
117,9,108,1444,-,70801
9259,3450,5809,781,73200,70802
0,0,0,-,-,70803
9085,3932,5153,769,79400,70805
12236,5420,6816,827,237600,70806
5457,2631,2826,685,83600,70807
13372,7751,5621,1000,300700,70808
11128,6147,4981,1163,264600,70809
15649,10986,4663,1199,305300,70810
4827,2833,1994,895,114300,70811
3542,2091,1451,915,106300,70812
4859,3442,1417,891,153200,70814
10176,6672,3504,881,167800,70815
17645,8650,8995,965,184000,70816
12492,10204,2288,1152,243500,70817
3721,2986,735,898,200000,70818
1594,1307,287,1163,139400,70819
7028,2154,4874,902,229700,70820
0,0,0,-,-,70836
1900,1215,685,493,85600,71001
450,372,78,775,80900,71003
267,193,74,763,141500,71004
4826,4242,584,946,249100,71006
373,351,22,-,86400,71007
359,288,71,570,59500,71008
856,644,212,615,71000,71016
663,420,243,301,57900,71018
2966,2139,827,660,84000,71019
388,210,178,-,42300,71021
1530,1308,222,854,89600,71023
635,528,107,373,102200,71024
636,398,238,880,73700,71027
515,384,131,396,82800,71028
73,63,10,-,120800,71029
666,508,158,-,160600,71030
340,189,151,715,96300,71031
954,813,141,637,152900,71032
1443,1118,325,729,160300,71033
144,135,9,-,87900,71034
7280,5943,1337,960,166300,71037
1870,1169,701,504,74400,71038
694,623,71,776,74600,71039
2932,1796,1136,636,76600,71040
195,160,35,922,81100,71043
284,238,46,644,74300,71044
295,257,38,475,110900,71045
475,446,29,-,172700,71046
4383,3764,619,789,162700,71047
32,32,0,-,-,71048
1332,951,381,632,82500,71049
758,653,105,-,88500,71051
3890,2256,1634,506,84000,71052
7865,4873,2992,745,93800,71055
884,669,215,749,111900,71060
682,449,233,457,149600,71061
304,245,59,-,-,71063
1266,1067,199,500,58700,71064
499,307,192,450,80800,71065
1295,823,472,653,82100,71067
1562,1207,355,336,64600,71068
229,182,47,-,-,71069
675,583,92,713,73000,71070
1011,845,166,682,86000,71071
632,558,74,739,74200,71072
874,541,333,892,76900,71073
2764,1571,1193,608,63500,71075
2533,2079,454,870,211400,71078
86,78,8,-,189700,71079
1985,1264,721,580,81400,71082
2847,736,2111,634,68700,71101
2384,952,1432,700,74800,71103
6368,2787,3581,841,134100,71104
9813,5314,4499,979,182700,71105
12969,8652,4317,781,245800,71106
12073,7703,4370,776,125500,71107
6687,3471,3216,775,76000,71108
7561,3076,4485,697,74300,71109
983,23,960,1387,-,71110
17415,9983,7432,906,202800,71111
13936,8387,5549,1004,154000,71112
7050,4077,2973,994,206200,71115
9424,5970,3454,864,149500,71118
4462,3435,1027,863,159100,71119
5058,2894,2164,802,151600,71129
8701,4587,4114,741,201000,71201
8657,3909,4748,676,64600,71202
13463,7303,6160,800,149500,71203
0,0,0,-,-,71209
502,430,72,-,81000,71219
8130,5281,2849,572,87600,71220
1185,807,378,467,83400,71222
135,93,42,513,43600,71223
2535,2190,345,845,201400,71225
784,511,273,438,66900,71226
1482,1148,334,798,110900,71227
479,342,137,671,127300,71229
2672,1765,907,591,82100,71232
114,58,56,775,-,71233
1270,1175,95,1051,127200,71234
1742,1314,428,682,115500,71235
536,370,166,596,81600,71237
994,937,57,655,112700,71238
3207,2557,650,664,110000,71241
87,65,22,-,167500,71243
1650,492,1158,686,106300,71245
466,266,200,452,65400,71247
104,51,53,-,36900,71250
3084,1976,1108,588,89600,71251
77,44,33,606,86000,71253
1755,820,935,482,67800,71254
368,286,82,420,62900,71256
655,553,102,808,83800,71259
1104,893,211,432,72700,71260
506,351,155,492,83300,71261
2968,2257,711,527,95400,71263
406,371,35,-,164700,71264
598,540,58,481,90300,71266
1032,964,68,446,108300,71268
4370,2815,1555,625,102100,71269
12384,5919,6465,743,166700,71270
0,0,0,-,-,71272
953,658,295,626,76500,71275
38,15,23,-,87000,71276
536,507,29,-,41100,71277
51,0,51,-,-,71279
1688,1119,569,915,183300,71280
3419,1823,1596,608,78800,71282
182,168,14,-,78500,71286
13292,8115,5177,808,160600,71291
7556,5264,2292,727,108900,71292
4809,3374,1435,608,86900,71295
8138,3746,4392,798,129100,71301
5138,2834,2304,725,94800,71302
8930,4893,4037,939,190800,71303
21,21,0,-,-,71316
2393,1712,681,884,97800,71322
338,272,66,735,93600,71323
438,243,195,-,80200,71325
308,233,75,547,55200,71326
1446,1006,440,622,126200,71327
2691,2362,329,922,160600,71328
423,389,34,-,118800,71331
270,188,82,505,85200,71333
3465,2007,1458,615,69700,71334
696,508,188,566,93000,71336
86,86,0,-,120300,71339
342,294,48,282,115200,71340
1279,906,373,764,96900,71341
2553,1873,680,630,117400,71342
2751,2232,519,476,84700,71343
43,0,43,-,-,71345
1002,690,312,748,120900,71346
1556,854,702,652,118200,71350
4350,2975,1375,626,101800,71351
721,536,185,489,90700,71353
684,604,80,-,152700,71354
1175,849,326,603,101900,71355
309,257,52,-,95200,71356
663,476,187,729,73800,71357
337,240,97,480,83200,71358
12778,8080,4698,787,159500,71360
803,609,194,539,95000,71362
673,443,230,496,56000,71366
420,355,65,910,-,71367
462,286,176,502,132800,71368
989,612,377,427,71800,71369
750,569,181,-,72400,71371
2328,1601,727,774,93300,71373
456,291,165,486,71300,71375
67,67,0,-,-,71377
913,631,282,429,81300,71378
67,67,0,-,-,71401
1642,1350,292,761,119600,71403
338,242,96,569,94100,71404
2065,1330,735,832,135300,71405
39,17,22,-,-,71406
325,290,35,-,82000,71407
2038,1503,535,833,143300,71409
44,26,18,-,-,71410
1355,591,764,649,98700,71411
65,2,63,757,-,71414
378,179,199,711,88300,71416
2114,1304,810,634,87200,71417
2344,1687,657,575,69900,71418
801,633,168,638,69900,71419
684,580,104,606,72100,71422
1640,1249,391,891,133600,71423
376,330,46,-,77900,71424
47,36,11,-,-,71425
98,56,42,807,74500,71426
207,167,40,-,100300,71427
1240,924,316,694,124900,71429
1083,732,351,757,82800,71430
380,289,91,602,56300,71432
1486,1211,275,607,85500,71433
1353,1171,182,690,84700,71435
682,528,154,-,119600,71438
709,498,211,663,117400,71439
227,169,58,642,118700,71441
8101,5125,2976,843,125300,71446
539,339,200,723,85600,71447
3465,2121,1344,572,118800,71449
446,298,148,725,102900,71450
61,38,23,-,49500,71452
798,505,293,686,68500,71454
56,56,0,-,-,71455
571,284,287,675,240900,71456
9980,3991,5989,703,158900,71457
3546,4,3542,1093,-,71459
902,399,503,724,115200,71461
675,503,172,580,47800,71462
3266,2283,983,476,81000,71463
1111,924,187,804,80000,71465
243,203,40,-,137600,71466
1615,1133,482,615,112000,71467
290,119,171,753,96100,71468
1014,623,391,781,79000,71469
123,123,0,-,-,71472
202,176,26,-,38800,71473
174,143,31,606,121700,71474
340,241,99,643,80400,71479
217,184,33,-,75700,71480
3733,2372,1361,597,85800,71483
925,765,160,928,232500,71485
1983,1363,620,624,76000,71486
5479,2720,2759,674,56000,71601
6065,3800,2265,783,106100,71602
12808,8337,4471,758,88900,71603
196,154,42,595,54400,71630
209,199,10,-,72700,71631
4429,3337,1092,519,79200,71635
1279,795,484,581,67800,71638
2369,1457,912,540,71800,71639
1261,697,564,598,56200,71640
307,238,69,770,53100,71642
514,354,160,473,58000,71643
323,226,97,604,60000,71644
2373,1903,470,610,80100,71646
866,536,330,475,76400,71647
71,71,0,-,209700,71651
472,278,194,625,60800,71652
1720,1157,563,642,75000,71653
1879,1216,663,461,83600,71654
5795,3770,2025,657,109300,71655
265,201,64,575,-,71658
33,28,5,-,-,71659
296,257,39,-,67000,71660
137,97,40,-,-,71661
87,0,87,-,-,71662
251,190,61,465,77500,71663
2264,1741,523,632,107200,71665
36,7,29,-,-,71666
2790,2213,577,593,79200,71667
624,390,234,508,55400,71670
3348,2149,1199,663,100600,71671
295,239,56,828,61700,71674
823,684,139,563,88000,71675
184,145,39,633,54600,71676
79,58,21,-,41300,71677
7309,4925,2384,532,79900,71701
21,0,21,-,-,71711
976,650,326,399,56700,71720
28,21,7,-,-,71722
208,186,22,-,73700,71724
196,149,47,492,60100,71725
615,494,121,300,68200,71726
11919,8483,3436,675,105100,71730
626,523,103,335,77600,71740
1992,1189,803,712,76200,71742
1562,1081,481,655,77700,71743
1209,1031,178,676,72100,71744
131,101,30,475,74200,71745
428,380,48,517,59200,71747
1129,1025,104,636,84100,71749
351,300,51,634,80500,71751
383,220,163,546,50900,71752
5831,3887,1944,685,94800,71753
136,136,0,-,111000,71758
262,229,33,817,76100,71759
909,745,164,805,78100,71762
696,630,66,550,68100,71763
724,601,123,532,63500,71764
850,754,96,606,39000,71765
222,175,47,583,93000,71766
1343,1124,219,498,77300,71770
2,2,0,-,-,71772
5954,3815,2139,696,84000,71801
8,8,0,-,-,71820
3668,2524,1144,620,88900,71822
17,13,4,-,62500,71823
171,148,23,600,76000,71825
411,313,98,433,42700,71826
340,318,22,-,54800,71827
3649,2591,1058,589,90300,71832
838,680,158,375,74800,71833
404,382,22,-,78700,71834
441,383,58,439,63700,71835
1257,977,280,448,62000,71836
2045,1680,365,706,89800,71837
422,335,87,789,54300,71838
135,117,18,-,-,71839
388,324,64,583,73000,71841
867,612,255,498,74300,71842
846,615,231,456,80400,71845
998,692,306,584,78900,71846
276,267,9,-,79300,71847
801,574,227,641,86500,71851
3763,2537,1226,581,107700,71852
122,88,34,581,33400,71853
13842,8440,5402,743,114700,71854
227,174,53,696,-,71855
2071,1234,837,710,69100,71857
906,729,177,750,61700,71858
244,185,59,-,97400,71859
886,674,212,561,58500,71860
766,624,142,656,76500,71861
317,245,72,647,-,71862
75,51,24,900,55600,71865
233,188,45,811,131000,71866
11550,6996,4554,659,123200,71901
7651,6547,1104,1060,192700,71909
19967,13180,6787,801,139000,71913
1270,986,284,646,81100,71921
57,31,26,617,39600,71922
6054,3209,2845,600,132600,71923
1659,1596,63,-,101600,71929
561,347,214,522,133400,71933
217,217,0,-,84400,71935
861,629,232,575,76400,71937
713,568,145,585,70400,71940
858,751,107,524,84900,71941
1732,1275,457,607,78300,71943
317,257,60,432,83200,71944
521,402,119,705,95400,71945
726,530,196,-,121100,71949
340,312,28,-,95000,71950
16,16,0,-,-,71952
5847,4564,1283,662,109700,71953
630,502,128,615,53400,71956
1220,969,251,543,118600,71957
953,647,306,549,85200,71958
291,262,29,-,-,71959
714,561,153,507,85100,71960
409,345,64,1021,75900,71961
320,249,71,398,67000,71962
1413,1088,325,734,162900,71964
127,92,35,617,82500,71965
1554,1458,96,719,141200,71968
153,138,15,-,130000,71969
333,323,10,-,119600,71970
198,157,41,-,159700,71971
150,91,59,638,83500,71972
570,398,172,539,66800,71973
0,0,0,-,-,71998
0,0,0,-,-,71999
329,274,55,688,68700,72001
6331,5400,931,860,157000,72002
350,307,43,617,69600,72003
375,311,64,588,68500,72004
51,42,9,-,45000,72005
1104,613,491,470,65700,72006
3136,2439,697,847,144800,72007
2460,1544,916,596,86500,72010
1426,1210,216,909,133600,72011
4982,3340,1642,744,132600,72012
863,677,186,704,93600,72013
22,17,5,-,30500,72014
10512,7227,3285,807,128900,72015
1080,883,197,700,125900,72016
300,202,98,392,47200,72017
9636,8034,1602,861,181300,72019
1515,1259,256,603,61400,72020
1649,892,757,529,67000,72021
6977,4495,2482,891,160500,72022
13602,9257,4345,862,159600,72023
1431,1064,367,772,93300,72024
279,252,27,616,92400,72025
108,52,56,-,-,72026
522,455,67,425,109600,72027
783,435,348,368,55700,72029
301,262,39,-,-,72030
2916,2188,728,518,110700,72031
12556,7461,5095,836,137000,72032
18901,9970,8931,831,181800,72034
0,0,0,-,-,72035
321,217,104,455,36300,72036
13,9,4,-,-,72037
28,20,8,-,-,72038
794,674,120,670,127300,72039
1225,883,342,523,68000,72040
584,415,169,687,34800,72041
2113,1472,641,570,77900,72042
341,296,45,805,164100,72044
547,263,284,824,213500,72045
1616,1031,585,653,103500,72046
291,252,39,-,145800,72047
34,34,0,-,68100,72048
205,178,27,-,74100,72051
415,283,132,621,85000,72055
360,285,75,856,164400,72057
6124,4508,1616,795,164200,72058
20,20,0,-,-,72059
272,193,79,617,71400,72060
65,51,14,800,204500,72061
764,611,153,534,123600,72063
1058,782,276,683,69500,72064
1805,1504,301,713,134800,72065
1164,860,304,698,129200,72067
146,86,60,781,78100,72068
641,476,165,454,59700,72069
644,506,138,577,106700,72070
215,189,26,-,77500,72072
446,307,139,-,73800,72073
72,60,12,-,75000,72074
14493,8387,6106,782,118300,72076
255,245,10,-,58700,72079
189,174,15,-,74300,72080
2835,2039,796,713,100000,72081
805,479,326,549,66200,72082
67,50,17,817,84300,72083
432,338,94,563,54500,72084
83,39,44,729,69200,72085
4125,2992,1133,680,138500,72086
724,666,58,2151,225000,72087
1225,1068,157,1045,104600,72088
0,0,0,-,-,72099
1256,904,352,578,74200,72101
1028,765,263,676,81600,72102
4543,3456,1087,839,107000,72103
8626,6254,2372,622,95600,72104
1922,1381,541,805,121300,72106
45,44,1,-,93300,72107
38,38,0,-,-,72108
4522,2498,2024,645,105400,72110
471,416,55,808,117800,72111
3612,2239,1373,588,70200,72112
10577,6258,4319,897,220000,72113
4745,1264,3481,679,55700,72114
9332,5899,3433,921,177600,72116
5258,3222,2036,861,92700,72117
8566,4966,3600,823,106200,72118
0,0,0,-,-,72119
12795,9380,3415,876,158600,72120
1231,918,313,707,95800,72121
232,214,18,-,218800,72122
207,131,76,470,35400,72123
277,178,99,675,95000,72125
1295,930,365,639,107300,72126
892,763,129,723,94000,72127
318,262,56,900,128400,72128
428,360,68,561,85900,72129
275,212,63,468,126600,72130
1948,1628,320,776,131800,72131
1293,939,354,872,104800,72132
182,127,55,-,53800,72134
1084,868,216,1254,258100,72135
504,458,46,-,104800,72136
877,677,200,571,76800,72137
122,62,60,306,67000,72139
145,122,23,-,79500,72140
268,216,52,-,95300,72141
816,692,124,595,154200,72142
12839,8035,4804,712,148600,72143
0,0,0,-,-,72149
4882,3847,1035,735,129500,72150
201,142,59,-,82500,72152
919,731,188,641,113200,72153
233,121,112,-,137500,72156
507,393,114,882,130700,72157
4077,2446,1631,664,102100,72160
53,35,18,-,-,72165
48,48,0,-,-,72166
619,545,74,649,78000,72167
148,110,38,-,-,72168
41,30,11,-,47000,72169
139,106,33,586,70000,72170
3159,2785,374,699,153100,72173
134,88,46,621,61100,72175
3215,1973,1242,798,117700,72176
153,121,32,-,83000,72179
0,0,0,-,-,72181
668,304,364,964,347400,72201
4687,1383,3304,839,131800,72202
11939,6773,5166,827,94800,72204
10360,5055,5305,866,168500,72205
8989,5794,3195,720,100300,72206
5160,3408,1752,869,339800,72207
11265,5759,5506,779,80100,72209
7039,4213,2826,868,187200,72210
9855,5226,4629,910,191500,72211
4723,4094,629,877,283900,72212
9582,6140,3442,1081,345800,72223
5216,3543,1673,919,192500,72227
9761,4680,5081,706,87000,72301
42,30,12,-,76700,72311
8588,4960,3628,651,87600,72315
10,10,0,-,-,72320
61,37,24,738,74500,72321
68,54,14,-,50000,72322
871,629,242,690,74300,72324
13,6,7,-,-,72325
940,572,368,756,73000,72326
677,488,189,568,103900,72327
19,0,19,-,-,72328
37,15,22,-,-,72329
181,142,39,732,46700,72330
1173,718,455,682,71300,72331
36,9,27,564,-,72332
223,101,122,345,38600,72333
6152,3098,3054,647,67900,72335
7,7,0,-,-,72338
55,40,15,685,-,72339
54,54,0,-,57000,72340
92,76,16,764,60000,72341
1818,646,1172,586,101100,72342
242,179,63,1097,51900,72346
277,186,91,465,48400,72347
1114,663,451,516,65800,72348
435,291,144,513,46900,72350
272,148,124,687,68000,72351
49,15,34,-,-,72353
937,555,382,534,69100,72354
976,732,244,805,85200,72355
424,246,178,478,34000,72358
208,84,124,736,20700,72359
2331,1300,1031,525,75300,72360
5789,3921,1868,849,153400,72364
1069,618,451,533,53200,72365
875,470,405,609,41600,72366
6,0,6,-,-,72367
587,409,178,488,77900,72368
3033,1403,1630,646,80000,72370
710,528,182,561,65800,72372
411,226,185,448,56300,72373
354,263,91,-,67100,72374
743,633,110,758,92700,72376
22,8,14,-,-,72377
6,6,0,-,-,72379
42,42,0,-,-,72383
382,169,213,526,54300,72384
758,539,219,580,67200,72386
132,64,68,-,43300,72389
3089,1293,1796,578,71300,72390
229,192,37,450,59300,72392
205,125,80,518,30600,72394
388,240,148,593,93100,72395
5048,3360,1688,730,96000,72396
22693,11422,11271,752,140500,72401
10505,6713,3792,826,170400,72404
186,130,56,569,55800,72410
881,546,335,691,83900,72411
269,203,66,-,207300,72412
230,155,75,570,47200,72413
141,71,70,417,76800,72414
474,370,104,558,75200,72415
2132,1543,589,733,118600,72416
2221,1470,751,745,121600,72417
635,422,213,554,49600,72419
176,56,120,585,55900,72421
1947,1176,771,588,77700,72422
33,26,7,715,32800,72424
139,117,22,-,84200,72425
74,48,26,393,88200,72426
94,85,9,900,-,72427
30,21,9,825,-,72428
144,89,55,505,65700,72429
170,117,53,663,58800,72430
146,102,44,544,51800,72431
2558,1729,829,547,83800,72432
1299,838,461,510,69100,72433
781,637,144,418,86300,72434
181,145,36,663,58100,72435
384,349,35,834,79500,72436
1422,1068,354,842,85500,72437
1039,530,509,511,73100,72438
95,62,33,544,83300,72440
30,29,1,-,-,72441
1696,1037,659,583,120200,72442
1185,798,387,719,76700,72443
749,625,124,554,84200,72444
20,19,1,-,81900,72445
824,494,330,488,81500,72447
132,79,53,773,42100,72449
14920,9803,5117,699,124900,72450
98,84,14,-,58600,72453
2111,1437,674,733,89000,72454
5170,3566,1604,632,95700,72455
224,153,71,680,59600,72456
72,50,22,493,72100,72457
242,230,12,-,67900,72458
558,438,120,487,97600,72459
343,259,84,480,61000,72460
1547,1109,438,506,76200,72461
161,95,66,398,53400,72462
28,19,9,-,-,72464
562,377,185,445,62800,72466
0,0,0,-,-,72467
412,344,68,520,85400,72469
83,73,10,-,-,72470
456,353,103,497,56900,72471
3655,2294,1361,664,90800,72472
1056,797,259,611,70500,72473
2383,1376,1007,587,82400,72476
161,161,0,-,81900,72478
604,338,266,668,71300,72479
541,441,100,613,68000,72482
9991,6908,3083,617,109900,72501
1056,774,282,601,74200,72512
966,702,264,426,116300,72513
0,0,0,-,-,72515
111,111,0,-,235400,72517
1210,882,328,636,94600,72519
105,105,0,-,-,72520
2100,1465,635,572,78000,72521
194,149,45,425,79600,72522
400,316,84,553,87500,72523
118,66,52,-,-,72524
89,58,31,298,-,72526
99,84,15,-,-,72527
0,0,0,-,-,72528
2385,2018,367,705,73500,72529
697,625,72,593,109300,72530
339,328,11,-,159600,72531
548,404,144,449,87000,72532
164,144,20,775,78800,72533
598,564,34,-,89000,72534
172,148,24,506,76700,72536
333,260,73,838,146000,72537
159,140,19,-,127800,72538
63,63,0,-,-,72539
48,27,21,722,137500,72540
1696,1451,245,510,104800,72542
5252,3595,1657,706,146800,72543
316,209,107,768,-,72544
81,65,16,-,109700,72546
302,302,0,-,100700,72550
20,14,6,-,65000,72553
1065,911,154,460,82700,72554
66,39,27,-,135400,72555
1308,951,357,517,83900,72556
3605,2594,1011,573,150300,72560
248,211,37,532,86800,72561
956,693,263,612,75500,72562
166,131,35,600,74500,72564
267,222,45,544,73800,72565
228,201,27,-,61900,72566
91,83,8,-,118800,72567
464,339,125,953,80400,72568
255,228,27,-,83700,72569
132,132,0,-,-,72571
64,40,24,-,46700,72572
82,69,13,-,-,72573
1749,1181,568,504,79400,72576
245,175,70,396,110900,72577
49,49,0,-,-,72578
489,296,193,732,86300,72579
508,476,32,-,136600,72581
773,573,200,663,85400,72583
133,133,0,-,82400,72584
161,161,0,-,-,72585
26,7,19,-,-,72587
12148,8334,3814,637,126300,72601
626,483,143,669,157100,72611
4088,3142,946,598,118300,72616
25,24,1,-,156300,72617
951,741,210,522,126300,72619
375,361,14,-,150700,72623
159,143,16,-,120000,72624
651,488,163,563,149200,72626
350,306,44,-,109900,72628
172,162,10,-,71200,72629
117,96,21,458,90000,72630
1901,1666,235,776,162700,72631
1914,1427,487,646,162800,72632
673,632,41,517,124100,72633
1794,1308,486,590,116500,72634
1490,1105,385,703,97100,72635
3,3,0,-,187500,72636
2565,1645,920,556,108900,72638
230,186,44,-,83300,72639
138,138,0,-,185700,72640
1174,894,280,538,120500,72641
1017,887,130,735,135300,72642
1040,873,167,543,106700,72644
909,662,247,497,90400,72645
144,108,36,-,93500,72648
1674,1197,477,557,118700,72650
477,358,119,589,110300,72651
12697,9433,3264,707,137200,72653
124,105,19,-,69600,72655
604,483,121,696,139600,72658
260,233,27,769,84400,72660
271,227,44,-,120800,72661
1095,949,146,825,129100,72662
78,61,17,-,-,72663
64,64,0,-,-,72666
104,104,0,-,251900,72668
40,39,1,-,-,72669
40,40,0,-,-,72670
114,62,52,635,-,72672
620,465,155,605,96600,72675
149,85,64,588,71400,72677
7,0,7,-,-,72679
302,209,93,832,136000,72680
119,116,3,-,65500,72682
94,87,7,-,-,72683
483,437,46,490,109900,72685
45,45,0,-,116900,72686
2697,2129,568,743,124200,72687
17058,6673,10385,772,210800,72701
14695,5912,8783,739,237500,72703
10616,6125,4491,978,186600,72704
20695,12051,8644,955,248600,72712
5482,4742,740,1010,164400,72714
7180,6236,944,896,169100,72715
283,252,31,-,119400,72717
1126,1039,87,1526,299200,72718
4519,2617,1902,1090,174100,72719
152,142,10,-,150000,72721
1229,858,371,653,116500,72722
2229,1634,595,778,142400,72727
99,99,0,-,134300,72729
3244,2300,944,938,168700,72730
1990,1762,228,775,198300,72732
2918,1888,1030,782,141000,72734
2356,1725,631,815,200400,72736
866,766,100,925,115000,72738
307,207,100,734,116000,72739
3493,2584,909,605,125500,72740
257,228,29,-,90000,72742
1933,1322,611,761,131400,72744
4926,3339,1587,810,168500,72745
125,115,10,-,-,72747
40,0,40,-,-,72749
2646,1990,656,1016,134900,72751
180,125,55,-,46600,72752
3484,2595,889,774,163000,72753
15882,9878,6004,715,160200,72756
14907,9317,5590,984,225900,72758
128,106,22,-,125000,72760
7533,4660,2873,744,160100,72761
14524,9501,5023,878,175900,72762
18672,8582,10090,750,147300,72764
491,355,136,609,149600,72768
462,307,155,715,-,72769
509,475,34,625,136600,72773
2308,1879,429,806,163000,72774
328,311,17,-,123800,72776
6478,2525,3953,672,107000,72801
7931,6562,1369,724,158200,72802
783,566,217,617,74000,72821
2319,1743,576,694,87900,72823
537,365,172,642,84100,72824
16,13,3,-,-,72826
114,85,29,-,-,72827
25,25,0,-,-,72828
5594,3476,2118,635,112100,72830
401,275,126,408,77600,72832
1379,918,461,547,107100,72833
3574,2580,994,646,122800,72834
349,321,28,-,112100,72835
2851,2316,535,697,110700,72837
56,56,0,-,64200,72838
128,89,39,628,84200,72839
851,712,139,429,74900,72840
85,58,27,-,23200,72841
450,362,88,575,72200,72842
940,814,126,641,107000,72843
410,387,23,700,124300,72845
1612,1307,305,602,106700,72846
1039,819,220,863,91300,72847
191,184,7,-,107300,72851
38,38,0,-,131700,72852
946,646,300,506,94200,72853
338,307,31,625,79000,72854
2491,1780,711,585,96500,72855
138,122,16,-,107500,72856
552,436,116,425,76600,72857
1300,1026,274,592,133700,72858
108,100,8,-,191200,72860
685,596,89,743,115400,72863
504,443,61,766,126400,72865
9137,3743,5394,588,91400,72901
10977,5248,5729,681,165400,72903
8252,4407,3845,686,76600,72904
5500,3532,1968,840,142700,72908
3590,2566,1024,821,198700,72916
5278,4088,1190,627,149300,72921
1817,1050,767,925,109700,72923
269,193,76,668,94000,72926
3129,2067,1062,561,92000,72927
306,257,49,638,127100,72928
116,74,42,-,52500,72930
555,500,55,728,91900,72932
1942,1521,421,660,93800,72933
340,330,10,620,80800,72934
166,116,50,583,84300,72935
5664,4370,1294,731,134000,72936
1396,1130,266,786,118800,72937
459,373,86,814,66200,72938
1020,912,108,649,122200,72940
2079,1678,401,667,120600,72941
925,678,247,581,95100,72943
1268,1000,268,663,88100,72944
99,68,31,533,64500,72945
1495,1398,97,533,97200,72946
1573,1352,221,651,95300,72947
134,134,0,-,81400,72948
3711,2445,1266,610,112100,72949
150,122,28,-,-,72950
380,307,73,617,64900,72951
1041,925,116,718,103100,72952
192,179,13,-,-,72955
13554,9551,4003,725,113300,72956
2691,1904,787,550,74600,72958
1081,972,109,638,154500,72959
367,297,70,650,73200,73002
9009,5295,3714,1077,167800,73003
361,284,77,831,121600,73004
3465,2270,1195,568,77000,73005
1238,946,292,664,83200,73006
1038,941,97,688,427500,73007
7871,4439,3432,852,122100,73008
489,358,131,497,93100,73009
6603,5747,856,814,181400,73010
131,112,19,817,56000,73011
13023,10711,2312,1615,238200,73012
19577,15250,4327,1162,221800,73013
563,437,126,911,111700,73014
1085,743,342,549,70500,73015
636,577,59,922,183200,73016
558,443,115,523,88700,73017
7767,4810,2957,714,91100,73018
0,0,0,-,-,73019
8600,7410,1190,1009,183700,73020
100,94,6,867,110000,73021
275,219,56,836,108500,73024
4058,3933,125,-,342200,73025
4104,3742,362,934,183300,73026
526,375,151,731,126400,73027
1410,1159,251,826,108400,73028
613,482,131,563,102800,73029
1565,983,582,681,110000,73030
97,86,11,533,108300,73032
142,87,55,752,67000,73033
16637,11866,4771,928,284100,73034
6576,4065,2511,757,114600,73036
777,638,139,537,83300,73038
742,473,269,658,80200,73040
154,127,27,638,70700,73041
393,284,109,629,83700,73042
94,86,8,-,54700,73043
7862,6147,1715,767,147200,73044
4544,3573,971,858,159700,73045
1400,1029,371,756,108600,73047
928,706,222,683,105800,73048
2131,1729,402,737,151700,73049
19,7,12,569,-,73050
2719,2067,652,752,114600,73051
2484,1834,650,724,113000,73052
246,184,62,511,116700,73053
1603,1391,212,861,156000,73054
3735,2906,829,669,118100,73055
147,136,11,556,93800,73056
903,645,258,681,92500,73057
63,55,8,475,172900,73058
1115,888,227,696,104600,73059
667,541,126,838,139700,73061
585,464,121,444,57100,73062
234,219,15,720,101800,73063
8098,6329,1769,1048,167100,73064
3379,2741,638,759,187100,73065
146,121,25,825,77000,73066
785,643,142,834,105100,73067
4189,3132,1057,889,121800,73068
10319,4808,5511,826,152300,73069
17435,8099,9336,895,154500,73071
17501,9932,7569,887,234400,73072
181,151,30,-,160100,73073
421,267,154,723,87300,73074
3614,2301,1313,693,106300,73075
2741,2114,627,758,93400,73077
3589,3437,152,899,214300,73078
189,144,45,640,99200,73079
3536,2458,1078,809,164200,73080
1178,961,217,603,81600,73082
2716,1877,839,738,81500,73084
3233,2341,892,711,141700,73086
4470,4044,426,780,188700,73089
357,285,72,644,166900,73090
342,242,100,655,64500,73092
1105,930,175,848,188000,73093
834,649,185,679,123500,73095
5057,2814,2243,695,175700,73096
57,42,15,-,-,73097
1701,1288,413,675,99800,73098
22912,17068,5844,1052,166400,73099
1141,89,1052,1116,163600,73102
2646,860,1786,901,256700,73103
1362,357,1005,1309,271100,73104
2794,1195,1599,920,111100,73105
4634,1899,2735,777,118300,73106
10537,5660,4877,834,100400,73107
4583,1857,2726,685,52900,73108
7053,3208,3845,711,70700,73109
13804,6132,7672,845,95800,73110
4759,2324,2435,788,71300,73111
14576,7520,7056,819,126600,73112
7787,2947,4840,885,93000,73114
8333,4845,3488,859,83500,73115
4487,3196,1291,984,233400,73116
2541,1055,1486,652,80300,73117
6326,3518,2808,879,169200,73118
9772,4629,5143,802,65500,73119
17425,9389,8036,831,171400,73120
1268,1027,241,907,171900,73121
5100,3116,1984,763,120600,73122
9074,4238,4836,760,114000,73127
1528,1008,520,1055,150000,73128
6361,3182,3179,778,52200,73129
7932,5948,1984,948,142400,73130
1379,931,448,1051,271700,73131
10808,6130,4678,829,160700,73132
2771,571,2200,1050,115700,73134
8374,4874,3500,989,140500,73135
7377,3058,4319,781,122000,73139
1072,734,338,799,86000,73141
6623,3530,3093,1000,241600,73142
509,0,509,1294,-,73145
1936,971,965,821,66200,73149
1815,1693,122,971,231500,73150
602,585,17,-,409600,73151
12019,7262,4757,891,110900,73159
22882,14860,8022,1001,140500,73160
11654,8197,3457,932,183700,73162
2157,2087,70,1000,219400,73165
768,610,158,920,146500,73169
14296,11437,2859,1261,195300,73170
1097,1069,28,-,310200,73173
1915,1699,216,1317,208200,73179
13608,8851,4757,790,126800,73401
18,18,0,-,42000,73425
479,443,36,-,124800,73430
436,309,127,710,103700,73432
1081,885,196,643,99800,73433
231,173,58,811,77900,73434
43,37,6,-,53000,73437
1396,1014,382,620,70500,73438
3069,2354,715,706,99900,73439
175,147,28,-,132200,73440
62,54,8,575,45000,73441
152,141,11,-,79300,73442
1462,1122,340,744,107300,73443
64,46,18,-,-,73444
2951,1998,953,680,83600,73446
473,394,79,710,81400,73447
1999,1437,562,700,99800,73448
1086,811,275,700,100500,73449
472,386,86,694,90700,73450
202,161,41,914,205200,73453
233,164,69,700,60900,73455
757,590,167,563,83100,73456
387,264,123,908,100000,73458
362,275,87,820,115100,73459
1937,1310,627,575,80200,73460
269,208,61,650,77300,73461
1157,993,164,650,93300,73463
354,294,60,485,73100,73481
68,56,12,575,40000,73487
239,175,64,592,84300,73491
7052,2861,4191,713,110600,73501
1651,4,1647,1251,-,73503
18371,9850,8521,791,127200,73505
8945,4852,4093,898,118700,73507
70,48,22,675,91700,73520
8033,4402,3631,745,114700,73521
825,635,190,688,118200,73526
1652,1343,309,733,162900,73527
208,159,49,1000,112500,73528
1956,1492,464,723,76000,73529
180,155,25,557,36500,73530
127,115,12,-,94200,73531
210,124,86,609,109200,73532
10630,7352,3278,695,116000,73533
229,191,38,722,49700,73537
1870,1340,530,1468,195500,73538
89,89,0,-,69200,73539
174,135,39,685,117600,73540
1059,855,204,735,119300,73541
1611,1180,431,625,53900,73542
669,461,208,769,100900,73543
104,82,22,-,46700,73544
426,327,99,588,50200,73546
659,479,180,418,83300,73547
197,189,8,-,38700,73548
76,56,20,840,94300,73549
962,700,262,638,67200,73550
25,25,0,-,14800,73551
506,431,75,525,113600,73552
22,22,0,-,212500,73553
1258,852,406,577,73500,73554
56,47,9,-,42500,73555
58,45,13,538,84100,73556
177,150,27,975,174400,73557
212,158,54,508,37500,73559
283,198,85,537,82100,73560
217,189,28,583,86500,73562
211,152,59,423,73000,73564
385,277,108,455,64100,73565
709,482,227,530,70000,73566
257,167,90,500,83500,73567
404,312,92,600,30900,73568
230,163,67,525,32500,73569
430,321,109,586,66600,73570
24,9,15,-,-,73571
1368,1012,356,588,83700,73572
941,635,306,509,68200,73573
3716,2431,1285,801,104000,73601
458,359,99,-,142200,73620
107,82,25,763,-,73622
739,358,381,689,88500,73624
294,218,76,797,96900,73625
393,308,85,842,109400,73626
250,206,44,-,122900,73627
535,399,136,593,95300,73628
1371,933,438,644,79300,73632
86,47,39,-,279000,73638
252,198,54,544,87600,73639
205,168,37,540,47800,73641
82,64,18,-,-,73642
5104,3362,1742,744,152700,73644
564,354,210,686,88900,73645
190,173,17,-,84300,73646
193,179,14,-,141300,73647
340,276,64,565,117600,73650
1473,1017,456,643,63000,73651
297,224,73,803,141700,73654
349,292,57,515,61800,73655
85,69,16,-,64500,73658
63,50,13,488,-,73659
155,116,39,325,77000,73660
159,142,17,813,81900,73661
1799,1188,611,653,102400,73662
420,342,78,558,114800,73663
452,310,142,580,68300,73664
90,66,24,-,76300,73666
243,163,80,658,76100,73667
651,470,181,578,120500,73669
119,94,25,-,72500,73673
8811,5235,3576,810,72700,73701
11746,7760,3986,943,152600,73703
0,0,0,-,-,73705
261,246,15,483,152600,73716
2443,1570,873,681,109400,73717
224,191,33,-,89000,73718
34,29,5,-,115600,73719
64,53,11,-,78400,73720
145,121,24,650,157800,73722
449,351,98,613,59700,73724
189,155,34,843,54500,73726
76,76,0,-,194400,73727
771,564,207,508,86000,73728
232,200,32,725,87700,73729
283,227,56,714,70800,73730
64,58,6,-,100000,73731
112,99,13,-,97300,73733
331,245,86,872,78800,73734
266,241,25,836,115900,73735
241,206,35,-,-,73736
1400,1083,317,731,94500,73737
423,325,98,704,77400,73738
153,149,4,-,95000,73739
217,163,54,773,81500,73741
1457,1037,420,740,126300,73742
37,27,10,-,86300,73743
73,54,19,-,63800,73744
14,10,4,-,-,73746
156,74,82,848,84500,73747
208,183,25,710,75600,73749
2614,2006,608,763,153500,73750
177,151,26,1073,88800,73753
412,354,58,850,107700,73754
376,320,56,430,81300,73755
140,124,16,-,133700,73756
119,86,33,576,-,73757
55,49,6,-,-,73758
593,466,127,713,73900,73759
182,155,27,495,124400,73760
132,126,6,-,79000,73761
749,599,150,948,170600,73762
768,620,148,583,84000,73763
78,43,35,630,136200,73764
502,326,176,735,100000,73766
658,552,106,718,121200,73768
152,125,27,592,67700,73771
1308,865,443,563,95800,73772
719,582,137,803,88500,73773
5887,3941,1946,799,127900,73801
423,362,61,531,108700,73832
610,481,129,731,78200,73834
96,78,18,-,79000,73835
166,137,29,617,141800,73838
269,226,43,741,93100,73840
178,144,34,842,73300,73841
228,196,32,-,142500,73842
338,230,108,692,75800,73843
102,78,24,-,74400,73844
695,526,169,680,76700,73848
26,22,4,-,216700,73851
772,668,104,895,115800,73852
181,150,31,-,170000,73853
36,24,12,-,100000,73855
310,279,31,-,169800,73857
636,433,203,635,85900,73858
523,409,114,713,124300,73859
511,371,140,775,79200,73860
49,30,19,-,76000,73901
186,141,45,535,151600,73931
805,580,225,707,95000,73932
710,554,156,540,57100,73933
76,41,35,-,88800,73937
276,239,37,842,69600,73938
519,260,259,610,101400,73939
4085,2782,1303,844,129000,73942
176,120,56,634,81100,73944
1049,785,264,657,107200,73945
14,10,4,-,-,73946
172,105,67,460,44200,73947
627,408,219,611,83100,73949
498,405,93,638,114500,73950
374,303,71,900,85000,73951
130,113,17,494,54300,74001
777,613,164,623,84000,74002
5586,3362,2224,717,77900,74003
10819,8039,2780,793,147500,74006
10493,8117,2376,985,222200,74008
3951,2764,1187,647,110800,74010
10609,8578,2031,1119,170300,74011
23008,15651,7357,1015,166300,74012
14728,12721,2007,1151,176000,74014
3652,2561,1091,892,144500,74015
2268,1742,526,689,93800,74016
11079,7615,3464,879,135500,74017
6988,5700,1288,845,170700,74019
2867,2043,824,764,96700,74020
7093,5813,1280,1029,164400,74021
715,626,89,738,102800,74022
4369,2883,1486,718,98500,74023
332,240,92,684,68500,74026
389,312,77,514,78100,74027
600,498,102,617,85200,74028
1944,1361,583,680,88400,74029
1548,1052,496,531,78100,74030
897,732,165,684,126200,74032
4382,3264,1118,992,138200,74033
53,43,10,-,49000,74034
1363,962,401,588,67600,74035
2636,2185,451,783,145700,74036
6296,4728,1568,1172,207200,74037
826,708,118,700,101900,74038
1312,1026,286,761,118600,74039
906,719,187,879,153200,74041
150,103,47,640,57000,74042
2764,2151,613,803,126400,74044
132,110,22,525,85000,74045
50,29,21,-,-,74046
2586,2164,422,820,142600,74047
2464,1721,743,596,88400,74048
115,63,52,615,-,74050
725,662,63,823,111800,74051
409,270,139,640,52100,74052
1647,1375,272,809,154600,74053
303,257,46,458,57300,74054
17226,12717,4509,999,195900,74055
2169,1492,677,635,77500,74056
1424,1007,417,644,102700,74058
2231,1662,569,768,123500,74059
204,150,54,663,63600,74060
794,629,165,738,117500,74061
374,297,77,760,118800,74062
12291,9544,2747,823,132000,74063
12207,8918,3289,889,132600,74066
2,2,0,-,-,74068
5508,4185,1323,871,155800,74070
65,49,16,579,59500,74071
732,572,160,677,93300,74072
2132,1731,401,862,136900,74073
11736,5889,5847,933,204600,74074
10810,4235,6575,772,162100,74075
0,0,0,-,-,74078
1596,1139,457,693,105000,74079
1070,881,189,805,150900,74080
744,686,58,779,86200,74081
24,18,6,800,65000,74082
387,316,71,-,138200,74083
194,155,39,600,67900,74084
855,649,206,708,77200,74085
357,3,354,1530,-,74103
5195,2299,2896,911,162500,74104
12255,6509,5746,803,226300,74105
6968,3097,3871,646,66900,74106
8130,4239,3891,767,93600,74107
2714,1685,1029,895,92300,74108
4919,2381,2538,763,53200,74110
9142,4937,4205,898,109200,74112
7339,5595,1744,1071,180500,74114
7984,4181,3803,856,59700,74115
1414,615,799,725,102300,74116
12,6,6,-,-,74117
2225,569,1656,825,157400,74119
2455,968,1487,763,279300,74120
3745,2106,1639,814,51000,74126
6632,3878,2754,816,84700,74127
4482,2753,1729,883,85700,74128
7155,3379,3776,780,110400,74129
704,485,219,786,53800,74130
1123,850,273,829,154100,74131
3553,2141,1412,962,180200,74132
19657,10030,9627,906,187700,74133
5986,3241,2745,829,124700,74134
9459,4757,4702,782,173300,74135
13672,4896,8776,762,229100,74136
10949,7378,3571,961,298000,74137
7514,3790,3724,852,126800,74145
5601,1797,3804,688,95800,74146
4305,2950,1355,765,110100,74301
1082,751,331,794,117800,74330
3149,2435,714,788,123500,74331
722,555,167,948,132800,74332
409,330,79,675,97600,74333
1886,1547,339,737,105400,74337
1984,1473,511,701,107100,74338
905,617,288,594,58800,74339
108,88,20,938,86300,74340
1084,905,179,625,66300,74342
1182,894,288,626,89700,74343
6587,4890,1697,685,153300,74344
2711,1882,829,605,98800,74346
934,720,214,667,75600,74347
137,81,56,588,74100,74349
311,232,79,689,95000,74350
2455,1899,556,702,97800,74352
6746,4358,2388,712,92400,74354
85,62,23,690,51700,74358
236,183,53,598,90600,74359
17,17,0,-,-,74360
6615,4364,2251,765,129200,74361
1029,810,219,674,83000,74363
732,609,123,447,109900,74364
1736,1248,488,699,89200,74365
614,539,75,589,74700,74366
205,174,31,736,98300,74367
37,22,15,817,56300,74368
766,603,163,696,116900,74369
1359,1094,265,603,99600,74370
6385,3673,2712,660,88800,74401
12218,7695,4523,699,107400,74403
1848,1474,374,779,128000,74421
302,257,45,950,97100,74422
358,293,65,535,99400,74423
514,403,111,539,105300,74425
3995,3144,851,581,89700,74426
493,455,38,723,155300,74427
495,420,75,594,137300,74428
5361,4142,1219,879,156000,74429
210,157,53,599,96200,74430
317,250,67,690,62600,74431
4166,3404,762,594,104200,74432
3441,2634,807,663,149300,74434
1223,973,250,583,89500,74435
1779,1344,435,743,156900,74436
3891,2833,1058,666,78600,74437
46,39,7,-,-,74438
1927,1584,343,673,99500,74441
375,318,57,788,94000,74442
1157,802,355,697,121800,74445
198,150,48,713,83000,74446
6172,3893,2279,630,76200,74447
694,603,91,743,110700,74450
1547,1266,281,677,128000,74451
131,100,31,707,166100,74452
1226,984,242,772,112700,74454
1267,1020,247,588,85300,74455
96,79,17,553,88800,74456
158,136,22,-,90000,74457
25,20,5,-,90000,74458
50,41,9,-,79200,74459
87,67,20,544,58300,74460
3032,2253,779,623,98300,74462
75,38,37,538,-,74463
10738,6382,4356,660,119800,74464
6158,4150,2008,741,112500,74467
107,97,10,742,87500,74468
837,591,246,612,88500,74469
627,511,116,540,88500,74470
561,475,86,469,101800,74471
249,208,41,836,92700,74472
9,0,9,-,-,74477
10941,7612,3329,734,119100,74501
87,68,19,758,67100,74521
130,109,21,792,108700,74522
2281,1644,637,560,74800,74523
3734,2628,1106,538,107000,74525
81,71,10,463,48800,74528
64,58,6,-,77500,74530
344,264,80,583,81700,74531
340,253,87,725,84500,74533
62,50,12,714,-,74534
29,25,4,-,115600,74535
653,444,209,493,96700,74536
1642,1146,496,617,81500,74538
89,78,11,525,108900,74540
147,131,16,-,144800,74543
292,210,82,675,69100,74546
1383,978,405,675,88600,74547
31,26,5,-,55700,74549
487,360,127,494,102500,74552
520,396,124,650,90000,74553
753,422,331,766,106500,74554
324,249,75,488,85500,74555
156,138,18,444,75300,74556
215,184,31,708,90000,74557
170,139,31,433,76900,74558
237,174,63,704,71300,74560
817,639,178,505,86600,74561
392,319,73,431,79800,74562
798,646,152,543,90600,74563
258,194,64,772,78500,74565
75,72,3,-,118800,74567
273,222,51,658,79100,74569
421,349,72,950,82800,74570
1418,966,452,509,80000,74571
257,212,45,660,81300,74572
449,376,73,613,89000,74574
53,39,14,-,156300,74576
88,57,31,504,56400,74577
2407,1593,814,669,83700,74578
7258,4174,3084,686,74700,74601
4995,4088,907,643,148900,74604
245,143,102,575,41000,74630
3032,2091,941,765,66400,74631
231,185,46,546,57500,74632
166,155,11,560,72700,74633
115,87,28,764,110600,74636
663,532,131,475,41900,74637
115,98,17,625,77900,74640
309,284,25,475,101400,74641
184,152,32,650,50000,74643
174,129,45,638,65500,74644
60,56,4,-,152100,74646
1417,1055,362,613,91700,74647
250,218,32,613,60000,74650
253,150,103,425,-,74651
308,260,48,350,51400,74652
1468,967,501,604,77300,74653
9381,5048,4333,758,139300,74701
183,138,45,613,60700,74720
83,66,17,431,155000,74722
532,387,145,576,109800,74723
104,85,19,-,53200,74724
946,697,249,688,83900,74726
755,517,238,538,80900,74727
4224,2873,1351,592,90600,74728
1107,873,234,738,107300,74729
1816,1159,657,779,116900,74730
636,535,101,679,81300,74731
1192,810,382,680,89300,74733
474,384,90,459,84600,74734
651,538,113,543,97300,74735
410,339,71,582,106300,74736
251,213,38,817,70200,74738
934,736,198,575,79200,74740
442,375,67,625,112100,74741
3322,2057,1265,566,96900,74743
3753,2385,1368,582,84600,74745
108,61,47,738,74200,74747
227,209,18,819,67700,74748
133,113,20,583,71500,74750
15,15,0,-,-,74753
162,136,26,-,57500,74754
25,25,0,-,-,74755
280,239,41,775,135600,74756
570,475,95,739,90500,74759
141,97,44,535,115600,74760
26,17,9,575,82500,74761
1445,1066,379,617,76300,74764
626,511,115,435,63400,74766
8482,4938,3544,700,97400,74801
7552,5139,2413,720,151800,74804
11814,7345,4469,715,133800,74820
460,397,63,700,102400,74824
747,602,145,598,93100,74825
412,335,77,658,83800,74826
123,101,22,760,120100,74827
179,134,45,475,84200,74829
79,68,11,613,32700,74830
269,200,69,553,70000,74831
312,229,83,770,92400,74832
275,233,42,536,77400,74833
2816,2249,567,597,130900,74834
80,39,41,-,-,74836
119,94,25,700,55800,74837
225,169,56,558,61300,74839
655,487,168,681,103500,74840
46,38,8,-,175000,74842
116,97,19,700,156300,74843
166,129,37,704,-,74844
161,126,35,358,73300,74845
2283,1639,644,543,70700,74848
1230,867,363,583,81200,74849
106,88,18,-,80000,74850
3230,2655,575,734,128200,74851
553,456,97,1030,89600,74852
669,518,151,525,66300,74854
1863,1538,325,808,118900,74855
305,229,76,754,102100,74856
3549,3138,411,706,149800,74857
2284,1486,798,550,78400,74859
588,522,66,589,99700,74860
1791,1314,477,603,145900,74864
612,525,87,650,114900,74865
281,214,67,563,72700,74867
4838,3262,1576,686,79400,74868
308,259,49,939,79700,74869
930,816,114,575,117400,74871
1253,889,364,564,94800,74872
4284,3354,930,782,98700,74873
429,360,69,717,100400,74875
514,446,68,657,88200,74878
725,553,172,558,67000,74880
1799,1504,295,668,93600,74881
817,526,291,548,66700,74883
2202,1432,770,594,70800,74884
751,433,318,566,70900,74901
1481,1033,448,697,96700,74902
794,668,126,619,73400,74930
477,427,50,733,84500,74931
889,662,227,713,89600,74932
70,52,18,650,37500,74935
422,309,113,711,88900,74936
1889,1351,538,599,67000,74937
262,201,61,475,73800,74939
921,708,213,640,98100,74940
940,672,268,582,81100,74941
59,38,21,513,67500,74942
59,41,18,-,82500,74943
449,337,112,531,84800,74944
154,111,43,607,66300,74945
45,15,30,508,30800,74946
4375,3488,887,713,93900,74948
142,112,30,725,76300,74949
534,328,206,729,64900,74951
4453,2933,1520,656,123900,74953
1817,1090,727,775,95500,74954
5835,3939,1896,658,108400,74955
696,495,201,676,90700,74956
432,363,69,475,89500,74957
2679,1893,786,647,93700,74959
4600,3105,1495,541,87600,74960
1751,1312,439,649,94100,74962
198,185,13,283,89600,74963
1015,771,244,738,87800,74964
1785,1172,613,572,89500,74965
1381,1159,222,602,97100,74966
8129,1391,6738,1351,321000,75001
22414,17640,4774,1527,276000,75002
18580,9408,9172,1179,204900,75006
19465,14069,5396,1276,240000,75007
4207,3352,855,1578,302000,75009
11834,5499,6335,1316,319200,75010
14569,10492,4077,1456,417600,75013
16212,11199,5013,1448,388700,75019
8895,5556,3339,804,115500,75020
3312,2570,742,854,130700,75021
8372,7697,675,1877,428600,75022
18196,11207,6989,1503,259000,75023
17791,7462,10329,1412,410100,75024
18662,12848,5814,1483,351300,75025
16262,13453,2809,1729,324200,75028
11355,9346,2009,1313,330400,75032
38172,25583,12589,1403,409900,75034
24220,19227,4993,1848,364700,75035
12381,2090,10291,1097,266700,75038
10160,1646,8514,1497,455300,75039
18295,12796,5499,1223,152900,75040
9199,5568,3631,1047,131700,75041
11312,5850,5462,969,144600,75042
21088,12455,8633,1137,166300,75043
15333,10348,4985,1237,202100,75044
8115,7087,1028,1486,243100,75048
14693,6474,8219,1069,130400,75050
12754,6078,6676,934,100300,75051
29675,22060,7615,1319,172700,75052
3486,3043,443,1982,328700,75054
22537,14204,8333,1354,276100,75056
5181,1939,3242,1227,128000,75057
873,712,161,1164,328600,75058
13818,8539,5279,980,135200,75060
17245,6656,10589,962,145400,75061
16177,6635,9542,1065,153100,75062
16119,6386,9733,1264,361900,75063
4561,3434,1127,1218,196400,75065
24812,9582,15230,1189,210800,75067
20590,16711,3879,1686,260600,75068
13816,7032,6784,1116,275700,75069
36849,25680,11169,1546,322600,75070
17814,13332,4482,1639,310000,75071
17907,9454,8453,1325,228900,75074
14421,8986,5435,1340,271000,75075
3322,2550,772,986,145500,75076
12667,10231,2436,1465,301600,75077
8486,7498,988,1520,453500,75078
18856,10408,8448,1398,287100,75080
15029,8578,6451,1330,229200,75081
8410,6294,2116,1633,343800,75082
12415,10079,2336,1352,276300,75087
9177,7865,1312,1588,219600,75088
11492,9882,1610,1643,236400,75089
8393,5326,3067,867,89500,75090
9968,5494,4474,897,162800,75092
18802,11972,6830,1479,457200,75093
6133,5202,931,2138,347400,75094
17367,13862,3505,1506,233600,75098
170,121,49,888,68800,75101
508,375,133,937,101600,75102
5464,4526,938,1012,157200,75103
15621,10982,4639,1374,170600,75104
51,47,4,-,156700,75105
1703,1381,322,1319,138400,75109
9935,6243,3692,797,95500,75110
2013,1615,398,1154,157600,75114
19183,12267,6916,1190,170000,75115
6574,3697,2877,1057,137100,75116
1487,1099,388,920,151200,75117
9509,6584,2925,921,119800,75119
1717,1398,319,717,120000,75124
2063,1620,443,1019,84600,75125
14280,12294,1986,1564,219700,75126
606,437,169,732,113900,75127
602,544,58,-,209800,75132
7274,3990,3284,1049,136900,75134
2358,1949,409,1002,146500,75135
6932,4930,2002,1272,165500,75137
2337,1784,553,720,114200,75140
1131,698,433,1040,69500,75141
5642,4075,1567,968,116100,75142
5339,4236,1103,850,103600,75143
1361,923,438,802,91200,75144
6873,4335,2538,1113,142800,75146
2480,1718,762,795,121900,75147
2227,1560,667,777,95700,75148
18138,11294,6844,1048,119900,75149
21086,9771,11315,1113,138000,75150
1636,1234,402,1201,117600,75152
128,110,18,674,97100,75153
12899,10249,2650,1246,187500,75154
947,780,167,861,93900,75155
6730,5080,1650,726,115400,75156
98,73,25,817,65800,75157
1373,1186,187,974,164200,75158
5359,3960,1399,980,121600,75159
8313,5211,3102,990,138000,75160
2106,1758,348,1014,137500,75161
1164,860,304,1015,76000,75163
265,194,71,1069,152700,75164
15459,9604,5855,1092,187300,75165
1389,1226,163,1680,252500,75166
3656,3460,196,-,260100,75167
5379,4072,1307,754,101800,75169
1384,775,609,913,59500,75172
1421,1284,137,1076,207400,75173
6372,3786,2586,1059,102800,75180
8040,6984,1056,1697,182500,75181
1860,1797,63,-,380400,75182
9258,7836,1422,1552,208800,75189
10335,1174,9161,1757,545700,75201
1497,337,1160,1487,243700,75202
6425,1816,4609,851,84700,75203
17628,3475,14153,1492,381600,75204
9316,6108,3208,1552,1201800,75205
20919,5807,15112,1283,400500,75206
1731,10,1721,1635,-,75207
10716,5837,4879,1047,294500,75208
6648,4063,2585,1372,618400,75209
2868,708,2160,755,63200,75210
21720,10928,10792,942,108000,75211
7923,3988,3935,744,103000,75212
16243,8704,7539,1221,490100,75214
6809,2215,4594,820,71700,75215
18482,9053,9429,855,69800,75216
24375,14505,9870,933,86200,75217
10404,6979,3425,1209,329200,75218
15447,4753,10694,1405,301200,75219
14402,4551,9851,883,294100,75220
4555,2371,2184,921,119500,75223
11274,5232,6042,888,115000,75224
8932,7013,1919,1999,1083400,75225
1933,104,1829,1289,-,75226
17897,10047,7850,975,106700,75227
25670,11739,13931,887,148800,75228
11085,8010,3075,1109,396700,75229
13207,8053,5154,1133,655600,75230
17126,3028,14098,906,345700,75231
10867,6240,4627,977,108200,75232
5255,2570,2685,1023,152800,75233
12784,7791,4993,1331,184900,75234
7937,2041,5896,1223,169300,75235
6146,2250,3896,959,140000,75236
9159,1256,7903,881,126200,75237
12755,6440,6315,958,362900,75238
10115,2450,7665,1051,261200,75240
11021,6186,4835,931,87500,75241
28307,6811,21496,936,238600,75243
5864,2921,2943,1454,431500,75244
1343,142,1201,773,223100,75246
209,0,209,851,-,75247
16460,8670,7790,1195,401400,75248
5386,4042,1344,1504,159600,75249
1740,0,1740,1346,-,75251
12410,5244,7166,1031,371700,75252
6461,4218,2243,1057,43100,75253
11837,2086,9751,1139,323100,75254
0,0,0,-,-,75270
28087,5836,22251,1081,304700,75287
0,0,0,-,-,75390
6888,3587,3301,852,71000,75401
6744,4572,2172,994,149500,75402
5732,4017,1715,1268,180500,75407
4831,3641,1190,1685,213100,75409
1945,1599,346,768,141500,75410
342,270,72,968,-,75411
253,242,11,-,76400,75412
114,85,29,1025,60400,75413
1168,981,187,720,135800,75414
90,81,9,-,-,75415
1113,904,209,775,114000,75416
994,852,142,558,88000,75417
4891,3279,1612,783,117700,75418
385,313,72,756,136100,75420
192,170,22,728,110100,75421
1163,968,195,808,114800,75422
1129,938,191,924,160400,75423
1126,920,206,1200,167300,75424
1925,1284,641,637,50500,75426
3635,1745,1890,836,80800,75428
702,487,215,819,58200,75431
1260,877,383,610,84000,75432
1051,828,223,880,106000,75433
412,293,119,508,70600,75435
878,653,225,527,114800,75436
480,433,47,-,125400,75437
373,303,70,700,105400,75438
398,223,175,826,131900,75439
2489,2042,447,664,138700,75440
71,71,0,-,-,75441
3045,2206,839,1138,161900,75442
1181,836,345,812,87800,75446
440,385,55,639,175700,75447
228,206,22,-,-,75448
543,377,166,807,96400,75449
55,46,9,-,88000,75450
536,450,86,603,121200,75451
1548,1085,463,822,123900,75452
1126,904,222,1048,120500,75453
3044,2705,339,1888,300000,75454
9405,6070,3335,717,109100,75455
2315,1687,628,826,131500,75457
1903,1366,537,787,131700,75459
9917,4867,5050,709,74900,75460
4551,3544,1007,798,155600,75462
335,284,51,-,70900,75468
108,95,13,-,115600,75469
119,119,0,-,38400,75470
396,286,110,562,134100,75471
1454,1070,384,751,108000,75472
1410,1186,224,726,99600,75473
5392,4152,1240,854,105500,75474
60,55,5,-,97000,75475
435,390,45,913,145700,75476
386,257,129,558,68100,75477
403,322,81,679,117600,75478
709,569,140,648,94100,75479
624,573,51,647,188800,75480
114,104,10,-,83800,75481
9481,6228,3253,822,116900,75482
870,754,116,-,128600,75486
726,557,169,588,103100,75487
251,200,51,673,161100,75488
388,239,149,956,105900,75489
955,814,141,1071,168100,75490
1799,1468,331,638,143900,75491
195,173,22,519,148600,75492
171,123,48,617,45800,75493
3564,2791,773,806,127800,75494
2818,2342,476,1066,201600,75495
1258,1040,218,785,127200,75496
1665,1394,271,603,163700,75497
13291,7690,5601,687,103100,75501
9565,6117,3448,886,169200,75503
308,269,39,546,59800,75550
4170,3392,778,738,98000,75551
827,708,119,585,93800,75554
722,658,64,647,76600,75555
408,298,110,775,81100,75556
501,449,52,-,72100,75558
2067,1600,467,593,92200,75559
452,394,58,707,67500,75560
1966,1406,560,712,85600,75561
63,63,0,-,71300,75562
1870,1387,483,527,89700,75563
85,56,29,-,-,75565
310,296,14,830,116100,75566
1625,1232,393,871,110700,75567
1029,706,323,570,85100,75568
1329,662,667,836,118100,75569
3298,2146,1152,603,106900,75570
1088,974,114,613,103800,75571
1654,1269,385,579,57200,75572
41,37,4,-,84300,75573
707,564,143,613,77100,75574
5657,3392,2265,763,138900,75601
7094,4390,2704,768,82500,75602
2295,1908,387,748,107300,75603
11320,6199,5121,862,145700,75604
12396,7315,5081,960,189200,75605
1204,1038,166,720,95400,75630
1131,834,297,788,100600,75631
5061,3773,1288,756,107900,75633
2303,1671,632,700,85200,75638
1094,892,202,812,75400,75639
1836,1538,298,907,138500,75640
43,32,11,-,125000,75641
19,19,0,-,-,75642
787,633,154,718,93600,75643
4453,3306,1147,695,126500,75644
3701,3207,494,979,159200,75645
4885,3490,1395,947,126000,75647
3530,2249,1281,922,171600,75650
843,779,64,891,117500,75651
4381,3187,1194,744,150400,75652
4714,3672,1042,692,128100,75654
1687,1232,455,545,88800,75656
3297,2408,889,742,103500,75657
1004,822,182,641,86500,75661
8884,6310,2574,832,121900,75662
453,338,115,814,95600,75667
996,643,353,686,110300,75668
279,259,20,-,84300,75669
5781,3386,2395,670,68700,75670
5970,4553,1417,850,131400,75672
965,839,126,773,113900,75681
171,171,0,-,156300,75682
1444,1184,260,769,85500,75683
2535,1827,708,814,117200,75684
4734,3483,1251,740,101400,75686
1556,1144,412,760,119800,75691
1463,1223,240,1048,105200,75692
2430,1847,583,1080,165900,75693
12195,6739,5456,900,138600,75701
7936,4271,3665,759,77200,75702
16627,9149,7478,990,229600,75703
3034,2336,698,828,130400,75704
807,761,46,-,87900,75705
3136,2166,970,721,103200,75706
5373,4124,1249,1197,191300,75707
2230,1609,621,739,80700,75708
1756,1022,734,1040,133500,75709
1355,1093,262,736,133900,75750
5475,3281,2194,867,101400,75751
2807,2431,376,770,131300,75752
2528,1885,643,899,158600,75754
1844,1172,672,760,145500,75755
1530,1336,194,818,88100,75756
4371,3871,500,794,195600,75757
3444,2639,805,783,112700,75758
23,16,7,975,-,75759
932,697,235,624,99800,75760
4480,3587,893,1111,173500,75762
2341,2008,333,755,124200,75763
80,64,16,525,54300,75764
2970,2454,516,876,130500,75765
9638,6573,3065,717,96700,75766
1124,868,256,746,120700,75770
7461,5772,1689,1028,170600,75771
4953,3821,1132,778,137400,75773
1214,889,325,682,104200,75778
35,35,0,-,64500,75779
54,43,11,475,-,75780
2967,2359,608,779,118000,75783
267,233,34,782,104100,75784
3436,2596,840,865,91800,75785
23,0,23,-,-,75788
2761,2165,596,887,155900,75789
1458,1045,413,712,117500,75790
4692,3421,1271,1104,163000,75791
998,800,198,1049,93000,75792
5854,3377,2477,762,106300,75801
6030,4447,1583,811,99000,75803
1973,1476,497,758,96000,75831
9,0,9,-,-,75832
1159,827,332,806,120000,75833
4402,2833,1569,698,97800,75835
249,223,26,-,197900,75838
2256,1905,351,896,95800,75839
2382,1723,659,757,128400,75840
2543,1940,603,712,98300,75844
1163,917,246,772,86600,75845
1153,904,249,733,69000,75846
781,580,201,585,85400,75847
55,37,18,619,58100,75848
27,15,12,638,-,75849
289,274,15,646,189100,75850
923,760,163,784,137900,75851
461,380,81,914,119400,75852
280,216,64,543,-,75853
1138,935,203,718,84000,75855
78,23,55,-,-,75856
0,0,0,-,-,75858
944,863,81,1073,101200,75859
1799,1433,366,635,97800,75860
718,394,324,728,83200,75861
4254,3258,996,752,80900,75862
10547,6812,3735,844,110800,75901
12530,7509,5021,852,127500,75904
1490,974,516,685,92200,75925
466,414,52,-,82500,75926
370,309,61,-,67900,75928
704,555,149,-,152000,75929
732,663,69,845,69200,75930
950,851,99,781,99700,75931
652,611,41,-,96400,75932
469,437,32,-,66400,75933
65,42,23,-,68600,75934
4699,3351,1348,574,75000,75935
358,299,59,-,106000,75936
339,295,44,509,79500,75937
997,807,190,721,108400,75938
1888,1163,725,530,76400,75939
2616,2015,601,553,85500,75941
51,51,0,-,-,75942
495,385,110,775,72400,75943
518,486,32,830,69100,75944
1375,915,460,660,110600,75946
2643,2364,279,573,153400,75948
3103,2347,756,658,84600,75949
5698,4074,1624,789,97800,75951
964,785,179,650,73600,75954
3194,2480,714,690,103800,75956
383,344,39,-,113800,75959
257,234,23,-,34900,75960
6145,3068,3077,797,114600,75961
0,0,0,-,-,75962
6694,4110,2584,745,96400,75964
7604,3803,3801,764,178700,75965
1883,1429,454,660,75100,75966
641,496,145,603,55800,75968
1403,1188,215,746,106700,75969
2552,1935,617,547,85300,75972
1083,918,165,424,91100,75973
1350,984,366,556,80000,75974
1489,1081,408,650,114100,75975
267,113,154,390,114800,75976
172,140,32,675,76400,75977
48,42,6,-,132100,75978
3675,2955,720,682,81700,75979
978,785,193,692,83500,75980
10489,8546,1943,1410,194400,76001
9669,8193,1476,1845,191800,76002
11553,2733,8820,1017,257700,76006
5955,5300,655,1860,326700,76008
6709,5072,1637,1027,112400,76009
17734,6096,11638,922,104700,76010
9702,1882,7820,943,127100,76011
10295,6339,3956,994,200100,76012
12877,6592,6285,960,195900,76013
10977,5528,5449,1172,119200,76014
6482,2997,3485,1160,148700,76015
11278,8986,2292,1530,199400,76016
17029,11596,5433,1156,179800,76017
9200,6474,2726,1514,146800,76018
10335,7962,2373,850,156500,76020
14929,8147,6782,1102,234500,76021
5526,2944,2582,1150,170100,76022
2331,1804,527,981,187700,76023
24275,18370,5905,1251,196800,76028
6003,4648,1355,917,102600,76031
9889,6173,3716,957,136300,76033
9290,8915,375,2141,515700,76034
721,658,63,875,195000,76035
8985,6748,2237,1197,184700,76036
15082,6407,8675,1227,210600,76039
11308,4954,6354,933,186500,76040
140,115,25,1277,110500,76041
2630,2015,615,869,224700,76043
1650,1297,353,835,196100,76044
9487,6444,3043,923,159600,76048
11237,9534,1703,1061,217800,76049
2149,1733,416,987,170000,76050
20644,10895,9749,1380,320300,76051
7057,6341,716,1480,274700,76052
10861,5997,4864,1085,162900,76053
4381,3740,641,1404,254800,76054
1021,749,272,836,85900,76055
6515,5024,1491,980,124200,76058
1740,677,1063,828,120100,76059
2820,2138,682,953,223500,76060
19,19,0,-,-,76061
23679,18080,5599,1404,254500,76063
545,419,126,1063,175900,76064
12168,10087,2081,1181,241100,76065
1090,852,238,513,173400,76066
6903,4659,2244,805,101200,76067
305,305,0,-,214800,76070
1365,1068,297,872,162900,76071
1900,1587,313,1018,163500,76073
98,98,0,-,-,76077
3108,2670,438,1138,163800,76078
6242,5128,1114,1032,148100,76082
2469,2032,437,963,118200,76084
3353,2929,424,945,228500,76085
8348,4381,3967,1036,126900,76086
9688,8656,1032,1247,250200,76087
4051,3154,897,1074,260400,76088
9453,8874,579,1367,678800,76092
686,442,244,839,102500,76093
3671,1177,2494,1366,260800,76102
5192,3177,2015,836,99600,76103
6270,2485,3785,935,73900,76104
6548,3561,2987,819,67800,76105
10462,5078,5384,930,84700,76106
14327,7077,7250,1118,301400,76107
15381,10394,4987,1098,152000,76108
9688,5225,4463,1198,476200,76109
10349,5963,4386,946,129600,76110
6672,4070,2602,970,97800,76111
16698,8110,8588,891,121800,76112
9107,5214,3893,964,97200,76114
5991,2994,2997,884,79200,76115
21343,7826,13517,940,198900,76116
9878,5516,4362,900,106300,76117
5586,4271,1315,953,176500,76118
14632,7442,7190,910,74700,76119
6943,2921,4022,999,160600,76120
11208,8642,2566,1635,169700,76123
8543,6980,1563,1184,212800,76126
48,10,38,1733,-,76127
0,0,0,-,-,76129
13361,9892,3469,1532,201400,76131
12798,4064,8734,1034,312700,76132
18648,11652,6996,1075,139800,76133
8370,5180,3190,1018,123300,76134
7929,5513,2416,934,160300,76135
19826,12250,7576,1316,172700,76137
9602,6646,2956,1140,120000,76140
7885,6351,1534,1395,132100,76148
3023,0,3023,1178,-,76155
4428,2390,2038,892,74200,76164
4273,2513,1760,1399,240800,76177
20867,15819,5048,1539,209000,76179
14829,7026,7803,1163,180800,76180
11099,9174,1925,1221,234700,76182
9745,1941,7804,919,168300,76201
7330,2822,4508,1087,224800,76205
5515,3629,1886,1215,238000,76207
7891,5261,2630,1205,262000,76208
9218,4297,4921,1062,176500,76209
14954,11215,3739,1388,239200,76210
1044,800,244,796,181700,76225
8935,8212,723,1593,393900,76226
11412,9027,2385,1673,231300,76227
367,317,50,806,93000,76228
4089,2942,1147,928,131800,76230
1180,860,320,1090,149400,76233
5946,4605,1341,1030,189300,76234
142,109,33,675,89700,76238
479,393,86,950,184600,76239
10829,6819,4010,889,154900,76240
24758,19590,5168,1692,254100,76244
791,681,110,667,96100,76245
4211,3542,669,1360,196100,76247
13207,10527,2680,1404,374900,76248
2890,2292,598,1302,187900,76249
419,357,62,1171,192200,76250
258,190,68,1078,159600,76251
1006,831,175,836,192800,76252
95,80,15,-,-,76253
2172,1527,645,616,106000,76255
2736,1836,900,1072,243000,76258
1927,1504,423,1278,210900,76259
116,92,24,-,71800,76261
12919,10050,2869,1263,379500,76262
24,24,0,-,-,76263
653,491,162,813,156500,76264
578,459,119,670,108800,76265
5373,4154,1219,1181,199000,76266
85,69,16,-,41200,76268
651,478,173,440,146100,76270
580,487,93,1030,223400,76271
1629,1370,259,859,138400,76272
3544,2619,925,957,169700,76273
6480,2972,3508,663,56700,76301
5065,2951,2114,820,112700,76302
1730,1502,228,680,117900,76305
5954,3369,2585,807,80100,76306
8290,4839,3451,812,140700,76308
5126,3243,1883,806,102200,76309
7349,5231,2118,825,142500,76310
639,10,629,1313,-,76311
888,659,229,561,83200,76351
4945,3101,1844,830,105800,76354
197,154,43,696,75600,76357
1600,1123,477,471,45700,76360
169,143,26,419,23500,76363
69,46,23,722,68600,76364
1941,1551,390,809,98800,76365
785,627,158,833,118000,76366
3584,3027,557,949,93700,76367
118,82,36,-,25800,76370
555,475,80,504,52800,76371
433,324,109,440,81000,76372
63,63,0,-,-,76373
1656,1142,514,644,55800,76374
254,224,30,425,58500,76377
178,130,48,653,105900,76379
1552,1129,423,523,61900,76380
4947,3006,1941,608,68800,76384
107,82,25,744,43300,76388
463,395,68,615,125300,76389
10049,5706,4343,913,162300,76401
0,0,0,-,-,76402
2943,2416,527,726,70400,76424
4231,2868,1363,896,147500,76426
350,228,122,580,83200,76427
87,39,48,-,143100,76429
923,750,173,592,90200,76430
1281,1022,259,977,134700,76431
541,487,54,908,134200,76432
582,514,68,1106,293300,76433
206,195,11,-,52500,76435
84,74,10,-,291200,76436
2027,1677,350,490,80000,76437
3160,2600,560,483,110900,76442
858,669,189,486,84300,76443
1435,1110,325,614,88000,76444
131,131,0,-,73900,76445
2524,2049,475,710,120500,76446
1900,1450,450,589,88900,76448
988,805,183,745,121900,76449
5294,4143,1151,719,113300,76450
32,16,16,-,-,76452
570,498,72,917,192000,76453
670,398,272,470,65000,76454
361,317,44,585,87000,76455
1439,1085,354,754,126600,76457
2011,1653,358,745,88500,76458
110,106,4,-,59200,76459
114,114,0,-,181800,76460
1224,1105,119,1042,225600,76462
176,158,18,1083,68700,76463
256,216,40,583,-,76464
106,106,0,-,-,76466
49,49,0,-,54500,76469
1182,845,337,542,57800,76470
694,565,129,611,53000,76471
643,489,154,-,110700,76472
89,85,4,-,119100,76474
348,276,72,721,90600,76475
978,818,160,797,180700,76476
51,28,23,-,-,76481
449,304,145,346,57200,76483
356,307,49,716,186300,76484
456,399,57,537,86100,76486
991,872,119,1174,176900,76487
47,42,5,-,-,76490
156,139,17,646,51200,76491
6293,3888,2405,707,121000,76501
15369,10396,4973,1129,163600,76502
9107,3574,5533,854,96100,76504
0,0,0,-,-,76508
641,494,147,709,91500,76511
13669,9180,4489,936,173000,76513
561,466,95,850,98300,76518
145,134,11,-,202000,76519
2833,1879,954,658,94700,76520
13651,7859,5792,868,118300,76522
0,0,0,-,-,76523
1113,995,118,919,124000,76524
438,335,103,825,104900,76525
1007,669,338,778,171200,76527
6256,4409,1847,726,113600,76528
675,530,145,788,150400,76530
1743,1456,287,642,136200,76531
1014,751,263,827,157300,76534
1814,1439,375,1327,180000,76537
360,242,118,1275,158800,76538
3182,2850,332,780,190400,76539
7564,2085,5479,696,69900,76541
18194,10066,8128,1050,153900,76542
11847,4314,7533,847,91500,76543
3319,70,3249,1251,92000,76544
10234,6268,3966,934,202100,76548
17895,8737,9158,1073,138900,76549
4956,3583,1373,740,145900,76550
749,534,215,912,112300,76554
591,515,76,757,118200,76556
1874,1564,310,636,150400,76557
2128,1226,902,877,132600,76559
372,283,89,700,88800,76561
51,51,0,-,275000,76565
98,91,7,-,179900,76566
3556,2365,1191,774,109800,76567
812,584,228,1034,85500,76569
868,671,197,642,65000,76570
2933,2428,505,716,292700,76571
9,9,0,-,-,76573
6356,4322,2034,923,163400,76574
1214,938,276,838,149300,76577
433,358,75,1096,160400,76578
1586,1202,384,994,140600,76579
0,0,0,-,-,76596
0,0,0,-,-,76597
0,0,0,-,-,76598
0,0,0,-,-,76599
355,315,40,808,173900,76621
444,354,90,947,104400,76622
81,76,5,-,92900,76623
727,582,145,699,109500,76624
457,314,143,905,93800,76626
531,479,52,881,89000,76627
27,23,4,-,-,76628
721,481,240,683,84300,76629
472,426,46,1016,148800,76630
193,154,39,993,107100,76631
588,466,122,1099,83900,76632
1793,1614,179,940,213500,76633
2930,2248,682,840,141700,76634
450,342,108,608,65900,76635
574,487,87,718,126000,76636
251,189,62,497,126800,76637
1036,913,123,950,240700,76638
559,368,191,525,84500,76639
1222,836,386,817,88200,76640
578,483,95,756,86800,76641
2528,1845,683,691,117100,76642
5425,3962,1463,1155,167500,76643
3746,2238,1508,789,93600,76645
1055,774,281,740,90000,76648
245,222,23,700,128100,76649
64,57,7,-,69500,76650
1247,827,420,849,105600,76651
519,445,74,730,87100,76652
468,382,86,663,132500,76653
57,39,18,875,97500,76654
2921,2446,475,1003,201100,76655
712,570,142,538,108800,76656
3379,2438,941,1104,194200,76657
169,131,38,838,82600,76660
2081,1183,898,453,58400,76661
1214,876,338,803,109200,76664
954,673,281,703,112800,76665
91,72,19,-,110000,76666
3814,2697,1117,721,84700,76667
476,345,131,988,101500,76670
711,574,137,776,116700,76671
460,341,119,596,124100,76673
98,88,10,-,90000,76676
84,44,40,836,147700,76678
530,428,102,-,101500,76679
108,108,0,-,-,76680
294,213,81,981,112700,76681
1015,772,243,873,95200,76682
32,15,17,-,-,76685
84,65,19,725,79600,76686
769,666,103,876,137800,76687
1330,1078,252,951,127600,76689
379,249,130,806,93200,76690
2360,1823,537,851,113600,76691
4081,3101,980,687,105900,76692
514,320,194,726,112900,76693
706,156,550,1043,-,76701
3140,1131,2009,646,85500,76704
10632,6291,4341,743,97800,76705
13310,5269,8041,873,123400,76706
5225,2377,2848,829,77800,76707
9740,6088,3652,886,140500,76708
10814,5249,5565,807,137300,76710
3470,1790,1680,1047,68500,76711
10007,7137,2870,982,209000,76712
0,0,0,-,-,76798
9324,6302,3022,787,98100,76801
1985,1511,474,751,119200,76802
50,40,10,-,395200,76820
1792,1315,477,767,80300,76821
1165,978,187,527,89400,76823
9,0,9,-,-,76824
2599,1809,790,742,91600,76825
171,154,17,-,103800,76827
95,88,7,-,123500,76828
0,0,0,-,-,76831
224,137,87,629,137500,76832
2223,1575,648,726,69100,76834
0,0,0,-,-,76836
562,371,191,735,78200,76837
10,10,0,-,-,76841
94,79,15,-,46600,76842
1306,1078,228,623,136600,76844
109,91,18,-,158900,76845
31,31,0,-,-,76848
1467,1086,381,732,123500,76849
121,101,20,567,132800,76852
530,398,132,812,127700,76853
163,111,52,-,-,76854
1501,1029,472,790,168800,76856
800,631,169,-,87300,76857
127,99,28,-,55500,76858
950,646,304,602,58500,76859
617,483,134,738,119500,76861
92,71,21,-,179900,76862
301,275,26,-,164500,76864
68,63,5,-,134700,76865
206,192,14,-,161000,76866
43,43,0,-,-,76869
95,79,16,-,90800,76870
277,200,77,608,150000,76871
336,288,48,665,134400,76872
41,37,4,-,850800,76873
0,0,0,-,-,76874
239,180,59,917,99300,76875
1484,1020,464,766,107900,76877
622,475,147,648,91700,76878
103,82,21,-,112500,76882
41,33,8,-,33100,76884
71,48,23,-,-,76885
51,43,8,-,-,76887
86,69,17,-,170300,76888
336,308,28,-,122900,76890
11617,7912,3705,933,119700,76901
11682,7228,4454,782,84500,76903
14343,8247,6096,888,202300,76904
4332,2934,1398,964,143100,76905
0,0,0,-,-,76908
41,34,7,-,81800,76930
1092,726,366,842,99300,76932
556,386,170,679,81700,76933
359,310,49,775,-,76934
565,544,21,-,221400,76935
1075,848,227,439,77800,76936
8,8,0,-,-,76937
0,0,0,-,-,76939
47,47,0,-,-,76940
602,477,125,975,120600,76941
1352,1012,340,554,105500,76943
876,667,209,566,61300,76945
5,5,0,-,-,76949
1421,981,440,637,92100,76950
458,392,66,850,59000,76951
67,25,42,-,-,76953
53,32,21,-,205000,76955
31,0,31,-,-,76957
80,77,3,-,195200,76958
4678,797,3881,1490,236700,77002
4698,2123,2575,1183,302800,77003
13418,4504,8914,1052,292800,77004
10107,7320,2787,1772,1060400,77005
12972,4543,8429,1484,464900,77006
20394,10517,9877,1690,422200,77007
16337,9687,6650,1274,445800,77008
14123,8309,5814,885,281200,77009
600,58,542,3026,864300,77010
5922,2557,3365,685,89400,77011
5981,2516,3465,775,82300,77012
5823,2294,3529,925,90500,77013
11801,5144,6657,977,146400,77014
17384,8889,8495,933,109500,77015
9679,5758,3921,897,71300,77016
10087,5260,4827,869,101300,77017
10934,7703,3231,934,405000,77018
11233,5731,5502,1687,596500,77019
8670,3876,4794,747,78900,77020
10720,4155,6565,949,107900,77021
9255,4057,5198,767,106700,77022
9837,4506,5331,829,142900,77023
15218,9901,5317,1617,996100,77024
12590,5212,7378,1250,439300,77025
7960,3205,4755,719,65500,77026
9733,3095,6638,1588,765400,77027
5847,3269,2578,870,69600,77028
5647,3500,2147,820,76400,77029
5058,2065,2993,1525,591800,77030
6296,2673,3623,914,153700,77031
4315,1513,2802,975,87200,77032
9165,5356,3809,940,67000,77033
12248,5243,7005,1017,125700,77034
13764,5779,7985,889,223900,77035
26500,4918,21582,824,151100,77036
5136,3646,1490,922,105500,77037
9075,5076,3999,1003,119100,77038
7607,4543,3064,937,102700,77039
17785,9657,8128,1065,170500,77040
11350,8483,2867,1455,193200,77041
19251,5009,14242,1080,244900,77042
9274,5313,3961,1152,256900,77043
14294,10748,3546,1355,204400,77044
10391,6695,3696,979,85100,77045
809,267,542,1943,344600,77046
10533,7217,3316,1292,149900,77047
6041,3680,2361,869,81000,77048
10809,7353,3456,1136,154900,77049
1454,1128,326,744,84900,77050
6379,2441,3938,897,78000,77051
8840,5821,3019,1237,92200,77053
13097,1937,11160,1172,143200,77054
15458,6692,8766,985,461900,77055
11370,4465,6905,1624,644800,77056
20169,6699,13470,1145,352700,77057
7689,2230,5459,1134,184500,77058
5899,5509,390,1588,314000,77059
14165,3140,11025,814,104600,77060
8700,3195,5505,822,131200,77061
9545,7577,1968,1039,205100,77062
18753,4214,14539,1109,220400,77063
16139,9333,6806,1257,162300,77064
14847,6889,7958,1146,173600,77065
10804,7497,3307,1205,143800,77066
10217,3999,6218,922,119600,77067
3986,2743,1243,1147,219000,77068
8275,4643,3632,1193,268700,77069
20264,10122,10142,1266,194100,77070
10110,5709,4401,951,146800,77071
17954,8468,9486,1028,111200,77072
13745,7629,6116,1066,142700,77073
12840,4198,8642,892,146700,77074
12953,6973,5980,968,144000,77075
10382,4938,5444,935,106600,77076
27097,9452,17645,1241,302600,77077
4640,2818,1822,939,79700,77078
12275,7265,5010,1363,518900,77079
15225,6636,8589,985,214000,77080
18846,984,17862,843,298900,77081
22308,7821,14487,1142,161000,77082
22338,14271,8067,1084,149800,77083
35082,21304,13778,1279,162000,77084
5274,3615,1659,1146,119300,77085
7922,4718,3204,1008,116300,77086
11109,5907,5202,787,92400,77087
17379,10759,6620,898,112900,77088
17362,11869,5493,1126,159100,77089
15927,3442,12485,1005,153500,77090
9911,4036,5875,841,127000,77091
13954,4973,8981,894,185400,77092
12831,7300,5531,881,82700,77093
3370,2732,638,1772,416700,77094
24114,18068,6046,1283,216800,77095
12995,6465,6530,1001,359900,77096
8246,2316,5930,1631,527900,77098
17017,5779,11238,949,120200,77099
0,0,0,-,-,77201
10503,5275,5228,924,134300,77301
6283,5104,1179,1134,190800,77302
6689,5019,1670,1073,141200,77303
13149,7462,5687,1114,228100,77304
4252,3215,1037,928,103800,77306
8428,7491,937,1203,330900,77316
6276,4871,1405,1129,195400,77318
9077,5792,3285,916,139500,77320
37,37,0,-,-,77326
7802,5510,2292,700,99200,77327
4559,3659,900,904,118400,77328
3148,2649,499,798,139500,77331
123,48,75,-,-,77334
1202,1036,166,814,106300,77335
4569,3426,1143,1090,168400,77336
15062,8428,6634,1061,150600,77338
15735,10200,5535,1346,198000,77339
11268,4311,6957,908,166400,77340
0,0,0,-,-,77342
9347,8285,1062,1533,286700,77345
21444,17776,3668,1474,205900,77346
52,50,2,-,-,77350
12140,9256,2884,781,123100,77351
12327,9883,2444,1206,260000,77354
9634,8173,1461,1123,256900,77355
11675,9630,2045,1317,265000,77356
8062,6157,1905,890,141200,77357
1943,1499,444,926,165300,77358
125,80,45,-,-,77359
2328,1836,492,858,92100,77360
1873,1590,283,1678,177500,77362
1282,1104,178,975,166900,77363
969,787,182,811,117100,77364
11455,9137,2318,1150,206600,77365
46,33,13,-,-,77367
103,103,0,-,123900,77368
232,184,48,-,78300,77369
2532,1906,626,591,83100,77371
4420,3317,1103,992,111400,77372
20588,14280,6308,1396,155900,77373
233,192,41,-,45400,77374
18153,13058,5095,1186,196100,77375
255,255,0,-,11500,77376
12502,10260,2242,1405,264000,77377
5677,4032,1645,958,132600,77378
27653,21795,5858,1275,257300,77379
11986,4583,7403,1343,273300,77380
13738,10137,3601,1438,359500,77381
13380,9586,3794,1718,422200,77382
7879,4565,3314,1261,320400,77384
8580,6796,1784,1300,226600,77385
18181,13977,4204,1514,235400,77386
16886,12605,4281,1587,197200,77388
12034,9556,2478,1628,320000,77389
18675,10990,7685,1197,159700,77396
7069,6070,999,1807,840000,77401
15422,13415,2007,1388,305500,77406
17015,13884,3131,1490,245200,77407
7,7,0,-,-,77412
8854,5866,2988,868,121300,77414
13,13,0,-,-,77415
900,542,358,944,111600,77417
4190,3159,1031,812,253800,77418
460,384,76,571,135400,77419
908,696,212,844,120600,77420
4582,3733,849,983,126200,77422
3608,2937,671,945,217300,77423
917,659,258,1315,236000,77426
0,0,0,-,-,77428
28691,24117,4574,1416,247300,77429
752,681,71,-,184600,77430
19,0,19,-,-,77432
27222,22879,4343,1618,272900,77433
1602,1224,378,730,62000,77434
1573,1325,248,866,165800,77435
14,14,0,-,-,77436
6167,3996,2171,732,155400,77437
27,0,27,-,-,77440
3942,3822,120,-,428500,77441
323,255,68,525,131300,77442
81,49,32,-,-,77443
207,144,63,731,154400,77444
4848,2657,2191,858,150400,77445
810,182,628,1042,171400,77446
5044,4059,985,1238,180900,77447
63,16,47,-,-,77448
37128,26133,10995,1568,162400,77449
24938,17697,7241,1413,271100,77450
20,18,2,-,61300,77451
99,29,70,671,-,77453
0,0,0,-,-,77454
728,663,65,634,131600,77455
529,469,60,753,91000,77456
235,206,29,633,115500,77457
130,106,24,-,92600,77458
22624,19222,3402,1789,277100,77459
7,7,0,-,-,77460
3889,3110,779,1059,174600,77461
53,24,29,763,225000,77464
2632,2011,621,811,116000,77465
229,153,76,994,195800,77466
17,0,17,-,-,77467
20,20,0,-,-,77468
17216,12651,4565,1133,232600,77469
153,118,35,-,84300,77470
13099,7068,6031,1054,153200,77471
45,3,42,-,-,77473
4548,3437,1111,933,172300,77474
287,287,0,-,85600,77475
62,45,17,-,302400,77476
12934,6057,6877,1234,170400,77477
9603,7237,2366,1542,302200,77478
29475,24281,5194,1801,372000,77479
2975,2386,589,926,110200,77480
30,2,28,-,-,77481
835,626,209,863,93200,77482
107,70,37,-,-,77483
3581,2463,1118,960,202500,77484
1560,1022,538,794,149600,77485
2636,2029,607,1075,144300,77486
5365,3295,2070,780,110200,77488
12388,9193,3195,1431,132500,77489
11074,9103,1971,1463,209200,77493
36575,27679,8896,1667,351400,77494
15286,11254,4032,1620,212800,77498
10809,6727,4082,965,105700,77502
7752,4187,3565,950,105100,77503
8878,3812,5066,950,152600,77504
8177,5449,2728,1160,188100,77505
10698,3989,6709,873,81000,77506
182,0,182,1579,-,77507
5237,4085,1152,930,179000,77510
16203,11328,4875,1020,153500,77511
1908,1535,373,775,106600,77514
10831,7456,3375,923,131500,77515
1907,1817,90,1186,192100,77517
3546,2215,1331,925,128100,77518
404,382,22,-,85500,77519
12169,7039,5130,896,89600,77520
20015,12460,7555,979,153400,77521
7594,6380,1214,1004,232000,77523
9415,6404,3011,891,105200,77530
6108,3508,2600,990,134200,77531
10646,8435,2211,908,158400,77532
347,206,141,636,71200,77533
816,731,85,945,164400,77534
9877,7994,1883,904,132700,77535
10663,8406,2257,1231,173400,77536
346,315,31,1375,123400,77538
16676,12359,4317,1041,171200,77539
6452,3693,2759,890,100200,77541
7113,5918,1195,1551,174900,77545
17660,14059,3601,1413,242300,77546
2580,1592,988,956,79600,77547
9744,4165,5579,943,167200,77550
8356,3384,4972,998,176400,77551
3744,2475,1269,1175,293000,77554
171,171,0,-,159200,77560
43,36,7,-,108300,77561
3763,2807,956,891,117000,77562
4284,3112,1172,921,158800,77563
714,627,87,-,121900,77564
3796,2089,1707,1271,263100,77565
11238,7516,3722,1224,190500,77566
5671,4062,1609,895,111600,77568
13217,10007,3210,1084,150500,77571
30260,23365,6895,1424,250900,77573
6173,4585,1588,867,108700,77575
538,521,17,-,155900,77577
7140,6039,1101,1293,273100,77578
331,306,25,-,332100,77580
17071,13269,3802,1225,235900,77581
9920,7772,2148,780,204100,77583
30802,22650,8152,1462,252400,77584
338,338,0,-,17700,77585
8752,5648,3104,1180,245100,77586
4737,2660,2077,866,95200,77587
11366,6372,4994,944,114700,77590
5572,2946,2626,1016,137200,77591
268,229,39,-,-,77597
11244,2244,9000,1094,153600,77598
3055,2376,679,936,143800,77611
3367,2984,383,763,106100,77612
489,367,122,734,115900,77613
140,108,32,-,-,77614
316,268,48,633,85300,77615
257,240,17,-,-,77616
49,40,9,-,-,77617
5701,4030,1671,970,112900,77619
471,404,67,1144,155800,77622
224,191,33,-,84500,77623
282,238,44,-,66500,77624
3413,2879,534,768,87900,77625
8709,6113,2596,879,141700,77627
344,304,40,588,103300,77629
11333,7483,3850,819,106800,77630
8591,7052,1539,854,123700,77632
6180,3853,2327,871,64900,77640
13726,7612,6114,799,65800,77642
754,524,230,562,188400,77650
4936,3692,1244,996,165900,77651
114,99,15,-,104700,77655
6205,4948,1257,736,102700,77656
7731,6096,1635,855,158900,77657
1735,1446,289,805,166200,77659
322,294,28,-,76500,77660
258,133,125,-,120500,77661
9832,7876,1956,741,97100,77662
488,409,79,-,173400,77663
1020,932,88,436,112300,77664
2140,1630,510,782,150500,77665
4717,2557,2160,760,51000,77701
1295,674,621,938,102100,77702
4841,2377,2464,729,67600,77703
10451,6312,4139,740,83000,77705
12602,6877,5725,922,174600,77706
6778,4697,2081,989,120200,77707
4952,2395,2557,826,118400,77708
6173,3942,2231,1120,156700,77713
6027,917,5110,860,113900,77801
10888,5682,5206,976,177900,77802
9690,5660,4030,863,85900,77803
3518,2240,1278,979,174300,77807
4579,4126,453,948,235700,77808
1186,1043,143,631,264500,77830
1166,974,192,809,127400,77831
10163,7530,2633,860,182200,77833
1143,916,227,967,120800,77835
4526,3524,1002,720,149100,77836
744,487,257,716,94100,77837
20409,2453,17956,920,196400,77840
24343,16415,7928,1154,256200,77845
439,368,71,678,94600,77853
50,14,36,-,-,77855
1977,1559,418,835,172400,77856
331,258,73,831,209500,77857
2471,1915,556,606,94600,77859
848,729,119,754,201200,77861
2769,1961,808,723,95900,77864
865,733,132,1103,115400,77865
47,39,8,-,83100,77867
4659,3228,1431,749,137600,77868
1127,849,278,770,148200,77871
756,649,107,859,161900,77872
568,476,92,518,153700,77873
33,16,17,-,-,77876
170,95,75,830,567300,77878
2084,1692,392,738,89200,77879
501,382,119,-,268900,77880
14280,7891,6389,884,99600,77901
10604,7338,3266,983,187800,77904
5484,4654,830,951,152800,77905
82,65,17,-,77700,77950
583,377,206,697,42300,77951
3616,2485,1131,903,128000,77954
2947,2011,936,850,109900,77957
65,37,28,-,-,77960
103,64,39,-,-,77961
1179,866,313,875,130300,77962
2009,1594,415,620,128000,77963
3300,2276,1024,731,181700,77964
1049,939,110,593,289100,77968
73,73,0,-,264100,77969
156,100,56,738,-,77970
231,126,105,679,-,77971
8,0,8,-,-,77973
125,102,23,883,186100,77974
643,502,141,777,129400,77975
44,37,7,-,197500,77976
229,162,67,603,64900,77977
268,149,119,887,87900,77978
6220,4526,1694,726,115600,77979
306,191,115,835,222300,77982
715,590,125,703,146900,77983
1551,1257,294,829,183900,77984
88,79,9,-,-,77987
156,140,16,-,118100,77988
311,225,86,-,87700,77990
71,39,32,1219,-,77991
35,14,21,-,-,77993
149,93,56,1075,98100,77994
3902,2937,965,719,117300,77995
0,0,0,-,-,78001
1765,1282,483,850,102700,78002
3750,3088,662,915,164400,78003
431,404,27,-,361000,78004
367,367,0,-,-,78005
12165,8857,3308,1219,346000,78006
60,45,15,806,128100,78007
252,209,43,-,64500,78008
2842,2340,502,1081,164700,78009
1301,989,312,865,153500,78010
578,512,66,533,40000,78011
96,85,11,-,79400,78012
2157,1780,377,833,209400,78013
1984,1316,668,634,84900,78014
5274,4768,506,1611,432500,78015
3606,2706,900,629,100300,78016
1020,575,445,775,60400,78017
276,202,74,680,56600,78019
75,70,5,-,-,78021
1390,1127,263,722,102500,78022
8900,8099,801,1616,300600,78023
579,429,150,820,388800,78024
1928,1441,487,863,134900,78025
2041,1447,594,934,91900,78026
88,88,0,-,360800,78027
16856,11597,5259,879,181900,78028
0,0,0,-,-,78029
646,561,85,586,108100,78039
11512,4964,6548,693,77500,78040
14536,7707,6829,828,157500,78041
12689,6763,5926,845,104100,78043
133,72,61,620,-,78044
19138,14608,4530,1159,175500,78045
16371,12114,4257,850,96600,78046
203,140,63,-,-,78050
2062,1676,386,802,100800,78052
621,477,144,647,291100,78055
794,685,109,-,420900,78056
146,146,0,-,541700,78057
400,353,47,575,311200,78058
1813,1635,178,846,145700,78059
0,0,0,-,-,78060
3076,2115,961,859,77700,78061
3641,3235,406,1052,169700,78063
5189,3619,1570,1075,150600,78064
3456,2582,874,696,82300,78065
173,141,32,-,171200,78066
274,248,26,-,121500,78067
1556,1339,217,663,95000,78069
5498,5233,265,1147,307800,78070
1102,826,276,627,113000,78071
189,144,45,838,85700,78072
2160,1617,543,775,85400,78073
86,55,31,-,99100,78075
4112,3032,1080,515,76300,78076
2206,2000,206,681,223000,78101
6868,4070,2798,859,95000,78102
59,45,14,-,-,78104
155,74,81,-,-,78107
12246,9938,2308,1725,222800,78108
11599,8295,3304,1273,158100,78109
2279,1946,333,1012,85400,78112
1241,924,317,1039,170100,78113
7641,6085,1556,908,165700,78114
97,97,0,-,232100,78116
207,155,52,784,147500,78117
1078,800,278,841,96900,78118
1755,1353,402,700,90100,78119
4266,3900,366,1003,271700,78121
130,93,37,-,65000,78122
987,748,239,922,143500,78123
2433,2034,399,988,173000,78124
28,28,0,-,61300,78125
28154,17568,10586,1169,204400,78130
10462,9025,1437,1068,372900,78132
7217,5940,1277,1060,224100,78133
1124,676,448,816,77700,78140
223,189,34,717,82300,78141
53,36,17,-,87500,78142
47,47,0,-,153500,78143
29,0,29,-,-,78144
37,30,7,-,-,78145
204,111,93,832,89000,78146
591,404,187,850,131500,78147
7716,4263,3453,991,168300,78148
0,0,0,-,-,78150
554,405,149,634,95400,78151
638,591,47,1281,249700,78152
14457,10246,4211,1323,204400,78154
17359,12531,4828,900,156900,78155
390,336,54,817,-,78159
1567,1323,244,861,158100,78160
280,270,10,-,159400,78161
109,86,23,-,-,78162
4279,4048,231,1044,359100,78163
1486,1224,262,772,165900,78164
16307,7815,8492,792,111300,78201
3812,1805,2007,826,82200,78202
1984,1006,978,822,74300,78203
4195,2355,1840,897,87400,78204
1069,166,903,741,365300,78205
15443,7448,7995,677,60300,78207
1636,523,1113,785,78300,78208
17623,9632,7991,1164,381000,78209
12428,6787,5641,817,94100,78210
8956,5904,3052,875,73700,78211
10784,4956,5828,845,172800,78212
16276,7906,8370,906,132900,78213
7831,4541,3290,809,79500,78214
1849,82,1767,1475,407700,78215
17410,6506,10904,963,198500,78216
13649,5502,8147,962,140500,78217
12483,6051,6432,905,113700,78218
5571,2675,2896,933,89400,78219
5426,3150,2276,951,76200,78220
11572,7222,4350,847,87700,78221
7391,5259,2132,914,117500,78222
18074,10234,7840,833,95700,78223
5948,3375,2573,943,93800,78224
4212,2837,1375,844,71100,78225
2409,966,1443,774,74900,78226
14764,8025,6739,864,91500,78227
18411,10858,7553,850,96100,78228
14196,2210,11986,970,153700,78229
18223,9102,9121,1034,232900,78230
3430,2415,1015,1188,292700,78231
15778,8918,6860,1162,246600,78232
17290,9986,7304,1112,136400,78233
948,44,904,1780,56500,78234
640,0,640,1212,-,78235
413,0,413,1846,-,78236
10961,6975,3986,803,64900,78237
9127,4360,4767,962,142000,78238
8588,6307,2281,1179,144000,78239
23493,8774,14719,1064,172900,78240
9078,4977,4101,893,82800,78242
0,0,0,-,-,78243
9113,6417,2696,1259,131700,78244
21705,15409,6296,1211,158900,78245
17423,13207,4216,1278,179200,78247
5488,4227,1261,1332,338000,78248
20657,11054,9603,1216,201400,78249
18903,14222,4681,1204,153900,78250
20610,11039,9571,1116,171700,78251
2656,2010,646,1214,122700,78252
12352,9932,2420,1392,244600,78253
16905,13427,3478,1327,203500,78254
4516,3970,546,1433,330700,78255
4271,1435,2836,1338,405100,78256
3616,1669,1947,1285,532800,78257
16083,10784,5299,1409,337000,78258
9449,6349,3100,1237,270300,78259
8340,7488,852,1729,335400,78260
5803,4576,1227,1417,311000,78261
1412,1290,122,1116,182400,78263
2824,2342,482,885,88000,78264
2462,2293,169,2131,391800,78266
309,258,51,1078,82000,78330
9355,6269,3086,703,77100,78332
0,0,0,-,-,78335
4051,2610,1441,900,119000,78336
13,0,13,-,-,78338
157,141,16,-,65400,78339
149,132,17,808,90900,78340
650,494,156,537,49500,78341
101,59,42,825,30600,78342
1594,1216,378,855,89100,78343
146,116,30,-,77900,78344
165,159,6,-,97300,78349
123,72,51,875,30400,78351
106,106,0,-,31300,78352
132,118,14,-,63300,78353
2074,1256,818,611,70800,78355
954,622,332,614,60400,78357
298,199,99,1044,64100,78358
630,417,213,563,61700,78359
1649,1188,461,584,66400,78361
3463,2484,979,1159,144200,78362
10414,5326,5088,857,92700,78363
3308,2472,836,693,65000,78368
128,81,47,-,-,78369
1528,1080,448,847,100200,78370
75,59,16,-,85000,78371
1549,1180,369,761,100500,78372
2175,1392,783,1022,352500,78373
6389,4350,2039,1303,168900,78374
933,779,154,815,53400,78375
196,128,68,599,-,78376
1221,830,391,587,88800,78377
534,453,81,1118,71300,78379
7890,5444,2446,828,86600,78380
8328,6831,1497,982,167600,78382
1604,1441,163,767,110700,78383
1721,992,729,674,35900,78384
173,46,127,-,24400,78385
3080,2121,959,656,68100,78387
601,512,89,895,62000,78389
1810,1151,659,816,80500,78390
79,59,20,-,63300,78391
831,648,183,817,83200,78393
1816,361,1455,767,79700,78401
156,71,85,1171,173400,78402
6853,3446,3407,912,101200,78404
5243,2728,2515,733,58500,78405
383,270,113,1131,45800,78406
821,394,427,954,75000,78407
4103,2026,2077,675,76900,78408
993,529,464,756,78500,78409
9632,6336,3296,1089,157100,78410
9949,6199,3750,1045,123700,78411
15172,6929,8243,1044,127200,78412
15002,8267,6735,1162,182000,78413
14959,9710,5249,1226,205600,78414
13284,7770,5514,950,101600,78415
5193,3069,2124,917,74200,78416
1275,906,369,739,104300,78417
12122,7403,4719,1107,207700,78418
172,0,172,1816,-,78419
21189,11388,9801,689,106200,78501
6505,4188,2317,892,91700,78503
18141,12384,5757,900,150800,78504
9452,7175,2277,608,62500,78516
18073,10933,7140,689,89000,78520
25324,14748,10576,720,73400,78521
13397,9571,3826,872,112600,78526
195,136,59,675,57900,78535
129,113,16,-,76400,78536
12520,9587,2933,561,62000,78537
3155,2307,848,479,61000,78538
12203,6813,5390,797,143000,78539
12997,6805,6192,794,94800,78541
17350,13270,4080,652,83800,78542
2399,1784,615,567,54700,78543
109,109,0,-,37900,78545
166,149,17,-,34200,78548
288,258,30,-,45600,78549
16813,8613,8200,718,83600,78550
12527,9421,3106,793,98000,78552
3758,2663,1095,675,100600,78557
219,171,48,-,59900,78558
3948,2909,1039,678,64300,78559
1344,875,469,677,79600,78560
179,132,47,602,54400,78561
777,574,203,413,63400,78562
101,84,17,-,153400,78563
39,8,31,-,-,78564
61,39,22,-,-,78565
4776,3490,1286,787,113600,78566
142,128,14,-,47100,78567
1190,993,197,629,68600,78569
8886,6386,2500,581,64200,78570
24530,17278,7252,764,93200,78572
9865,6683,3182,715,89200,78573
15548,12106,3442,712,81200,78574
3455,2562,893,956,126100,78575
2508,1968,540,539,65700,78576
22111,13329,8782,752,81000,78577
4384,2975,1409,703,130700,78578
1416,1274,142,617,58000,78579
3756,2358,1398,681,50200,78580
10636,8088,2548,605,72100,78582
2482,2073,409,543,76500,78583
4988,3566,1422,579,72300,78584
114,112,2,-,71400,78585
15680,12156,3524,689,59600,78586
45,43,2,-,-,78588
10593,8134,2459,758,87400,78589
81,81,0,-,35600,78590
79,58,21,-,238600,78591
209,165,44,580,34100,78592
1555,1130,425,636,56200,78593
526,457,69,319,49900,78594
1639,1348,291,535,54400,78595
18790,13292,5498,699,79700,78596
1645,1087,558,1081,306800,78597
53,49,4,-,152100,78598
9315,7282,2033,983,195400,78602
1966,1693,273,922,163800,78605
2031,1575,456,808,264500,78606
57,47,10,-,350000,78607
202,157,45,-,168500,78608
825,633,192,833,160000,78609
12584,9485,3099,1316,255000,78610
4468,3432,1036,734,179500,78611
3893,3210,683,1311,163200,78612
26937,18709,8228,1414,295000,78613
248,188,60,924,191200,78614
331,257,74,982,178400,78615
2633,1999,634,1032,132000,78616
6790,5280,1510,1280,148300,78617
130,111,19,920,326400,78618
1532,1343,189,997,486600,78619
6107,5249,858,1204,413300,78620
6966,5299,1667,981,166300,78621
106,77,29,1125,-,78622
435,423,12,-,248000,78623
9036,6419,2617,958,294000,78624
11129,7422,3707,1221,221900,78626
12333,8830,3503,1186,309800,78628
4402,2801,1601,732,139000,78629
1061,930,131,976,227200,78631
394,349,45,-,213300,78632
11966,10893,1073,1698,319500,78633
10403,8580,1823,1420,203900,78634
150,119,31,-,343000,78635
1530,1143,387,864,262300,78636
886,760,126,1196,123000,78638
3389,2453,936,878,154700,78639
18428,12991,5437,1406,189100,78640
21929,17744,4185,1529,253600,78641
3812,3061,751,833,280100,78642
2301,1806,495,776,171300,78643
5980,4055,1925,961,141000,78644
4550,3796,754,1343,252800,78645
3177,2005,1172,816,157900,78648
535,414,121,850,155700,78650
2138,1422,716,1462,306200,78652
7270,5997,1273,1447,187700,78653
7082,5044,2038,820,207900,78654
987,763,224,788,178300,78655
711,409,302,923,152600,78656
2720,2290,430,1127,314700,78657
942,806,136,729,181000,78659
30885,22871,8014,1383,232700,78660
125,90,35,967,76300,78661
772,601,171,1068,191900,78662
354,302,52,788,-,78663
20606,11385,9221,1309,215800,78664
14791,10429,4362,1496,266400,78665
29054,11368,17686,1056,172100,78666
4667,4178,489,934,449800,78669
47,29,18,-,158800,78670
323,188,135,730,156000,78671
611,573,38,-,123600,78672
150,127,23,-,-,78675
5312,4441,871,1212,296800,78676
14,14,0,-,-,78677
17448,13305,4143,1436,299700,78681
6395,2127,4268,2262,448100,78701
9713,4104,5609,1223,399400,78702
9545,5213,4332,1507,849600,78703
25071,8938,16133,1428,553300,78704
8873,875,7998,1313,431300,78705
0,0,0,-,-,78712
10552,6061,4491,1382,369200,78717
428,351,77,1008,144000,78719
4208,2222,1986,1179,284400,78721
3260,1432,1828,1414,423100,78722
13527,6242,7285,1115,338100,78723
6776,4407,2369,1261,147400,78724
2775,2309,466,1546,167700,78725
5877,2427,3450,1257,473500,78726
13557,6391,7166,1364,295200,78727
10008,2651,7357,1171,257500,78728
11898,5090,6808,1301,285500,78729
4059,2451,1608,1365,730800,78730
12537,7270,5267,1297,636800,78731
5867,4602,1265,1837,536800,78732
2932,2612,320,2512,623900,78733
7751,6334,1417,1820,421300,78734
7609,4001,3608,1560,496200,78735
3678,2759,919,1577,344200,78736
5621,5188,433,1875,454600,78737
6216,4477,1739,1601,562800,78738
6695,6366,329,2424,467000,78739
21664,3388,18276,1150,208300,78741
271,168,103,1095,-,78742
15493,6727,8766,1180,164300,78744
26756,12379,14377,1337,279500,78745
10894,7562,3332,1638,903900,78746
6971,5312,1659,1459,235600,78747
20239,12294,7945,1396,272100,78748
15428,9837,5591,1423,344700,78749
11858,7461,4397,1425,418900,78750
7911,2381,5530,1375,483300,78751
8484,2179,6305,1114,275500,78752
20552,7306,13246,1105,199600,78753
8816,4859,3957,1247,223700,78754
4339,1883,2456,1261,537700,78756
10937,6012,4925,1213,416300,78757
20844,5823,15021,1196,222400,78758
20671,9572,11099,1287,444100,78759
7223,5201,2022,658,91100,78801
21,21,0,-,-,78802
390,294,96,537,59200,78827
83,83,0,-,-,78828
382,310,72,722,29000,78829
269,229,40,800,60300,78830
1337,1024,313,515,68800,78832
532,371,161,643,73100,78833
2409,1482,927,732,78100,78834
68,68,0,-,36900,78836
93,84,9,-,70000,78837
110,107,3,-,265300,78838
2718,1901,817,613,53800,78839
15578,9883,5695,730,103700,78840
54,0,54,-,-,78843
378,329,49,700,163900,78850
25,21,4,-,-,78851
15986,10454,5532,658,97800,78852
21,21,0,-,-,78860
3982,3070,912,811,132900,78861
349,226,123,562,111300,78870
7,7,0,-,-,78871
483,371,112,589,43600,78872
652,531,121,912,164100,78873
229,177,52,-,151200,78877
40,40,0,-,141700,78879
635,526,109,391,66300,78880
815,646,169,624,65100,78881
171,159,12,-,-,78883
420,369,51,-,188000,78884
47,40,7,-,370000,78885
189,162,27,-,152100,78886
151,138,13,-,342600,78931
195,161,34,723,-,78932
570,439,131,-,121900,78933
2380,1841,539,685,142700,78934
398,390,8,-,281300,78935
130,97,33,629,155100,78938
884,795,89,781,176800,78940
935,804,131,785,161900,78941
2965,2098,867,881,125300,78942
109,109,0,-,114900,78943
241,227,14,-,244800,78944
4080,3204,876,860,199800,78945
458,360,98,925,117600,78946
1732,1550,182,985,192300,78947
268,248,20,-,259100,78948
214,193,21,-,158400,78949
800,745,55,757,220000,78950
0,0,0,-,-,78951
377,304,73,1401,161800,78953
513,461,52,789,487500,78954
1928,1484,444,878,167500,78956
3465,2722,743,1051,173100,78957
850,652,198,507,104700,78959
1895,1609,286,747,163800,78962
356,350,6,-,148400,78963
69,58,11,-,94000,79001
74,51,23,1125,92500,79003
597,448,149,720,114000,79005
4529,3451,1078,778,80700,79007
583,370,213,657,91300,79009
170,103,67,-,-,79010
105,77,28,811,157800,79011
519,480,39,-,260500,79012
953,543,410,670,55800,79013
1285,912,373,825,151000,79014
7474,4946,2528,843,189200,79015
0,0,0,-,-,79016
135,74,61,610,81400,79018
646,568,78,938,141500,79019
56,21,35,-,73600,79021
3398,2201,1197,802,120100,79022
146,107,39,681,84500,79024
14,14,0,-,-,79025
1557,947,610,640,82300,79027
5006,3325,1681,859,133900,79029
482,360,122,720,70700,79031
33,18,15,-,-,79032
29,20,9,-,-,79033
195,157,38,721,92600,79034
1729,1126,603,768,91300,79035
1727,1591,136,782,75100,79036
378,309,69,827,121800,79039
567,406,161,868,156000,79040
1049,744,305,639,76000,79041
449,339,110,783,84800,79042
517,326,191,592,54700,79043
269,111,158,1063,81700,79044
6175,3949,2226,790,90800,79045
243,167,76,850,78900,79046
0,0,0,-,-,79051
436,357,79,675,68300,79052
27,18,9,-,95000,79053
250,200,50,738,30300,79054
20,16,4,-,109400,79056
493,328,165,665,45800,79057
0,0,0,-,-,79058
263,219,44,820,115800,79059
146,106,40,546,70800,79061
58,46,12,-,-,79062
278,226,52,521,161500,79063
903,587,316,645,60500,79064
7202,5292,1910,748,81800,79065
1291,979,312,802,131300,79068
3328,2410,918,833,103700,79070
8368,4968,3400,647,84700,79072
86,80,6,417,70000,79078
1131,698,433,712,75900,79079
197,175,22,820,49500,79080
1333,907,426,734,88900,79081
97,90,7,-,76000,79082
710,565,145,685,73000,79083
742,556,186,753,107500,79084
7,7,0,-,-,79085
780,571,209,781,87100,79086
242,189,53,750,105300,79087
1811,1235,576,703,84100,79088
21,21,0,-,-,79091
404,357,47,780,99200,79092
68,68,0,-,-,79093
11,11,0,-,81300,79094
917,698,219,611,53000,79095
782,563,219,758,104800,79096
311,285,26,887,107300,79097
154,124,30,1058,100000,79098
1090,113,977,765,71600,79101
4216,2094,2122,783,107200,79102
3927,2687,1240,921,91200,79103
2452,1561,891,829,62900,79104
0,0,0,-,-,79105
11656,5633,6023,789,117400,79106
11561,6748,4813,788,67200,79107
4390,3255,1135,943,115900,79108
18235,11171,7064,783,164100,79109
6692,4620,2072,1066,112200,79110
509,15,494,1081,-,79111
7993,6430,1563,946,167800,79118
6810,4871,1939,1052,259000,79119
2538,1801,737,933,208700,79121
3444,2823,621,1006,262900,79124
2430,1464,966,745,85600,79201
75,43,32,-,56900,79220
376,277,99,696,38900,79225
1121,793,328,666,76500,79226
549,459,90,491,46100,79227
160,142,18,450,45000,79229
43,38,5,-,-,79230
28,0,28,-,-,79231
67,40,27,729,24500,79233
14,7,7,-,-,79234
1321,1026,295,726,47500,79235
74,26,48,592,36700,79236
203,136,67,608,-,79237
95,66,29,-,81100,79239
22,14,8,-,-,79240
880,632,248,723,81200,79241
18,14,4,-,-,79243
303,210,93,624,59100,79244
943,611,332,517,53700,79245
28,26,2,-,28500,79247
687,377,310,342,44100,79248
536,419,117,650,62800,79250
8,8,0,-,66000,79251
1240,817,423,482,45800,79252
260,179,81,625,96100,79255
146,91,55,623,51400,79256
343,253,90,-,49600,79257
18,18,0,-,58200,79258
15,15,0,-,-,79259
163,111,52,563,54100,79261
1236,908,328,667,87700,79311
354,286,68,478,61900,79312
534,363,171,609,61100,79313
18,11,7,-,-,79314
3672,2505,1167,702,76100,79316
748,583,165,600,63200,79322
2152,1712,440,834,145100,79323
14,14,0,-,256300,79324
755,550,205,671,110500,79325
23,23,0,-,107000,79326
1117,872,245,689,148000,79329
33,27,6,-,167700,79330
4191,2895,1296,644,74100,79331
6050,4165,1885,697,98900,79336
2298,1551,747,787,66100,79339
147,89,58,428,78100,79342
554,384,170,583,76300,79343
32,25,7,-,64200,79344
310,254,56,642,93200,79345
810,625,185,547,33600,79346
2125,1585,540,597,74400,79347
134,101,33,746,74500,79350
542,370,172,779,69300,79351
6,4,2,-,-,79353
620,468,152,727,69800,79355
1498,1057,441,773,79600,79356
755,574,181,615,56700,79357
410,317,93,793,120700,79358
807,575,232,632,52800,79359
4689,3674,1015,735,159600,79360
1988,1502,486,840,169700,79363
3005,2042,963,684,83100,79364
432,408,24,1222,252700,79366
252,168,84,931,73600,79367
40,40,0,-,36800,79369
626,483,143,514,51900,79370
548,426,122,642,61300,79371
440,319,121,569,86100,79372
1096,709,387,608,76600,79373
14,14,0,-,-,79376
85,58,27,-,84000,79377
68,61,7,-,40700,79378
170,146,24,500,69500,79379
34,26,8,-,75000,79380
519,393,126,717,128300,79381
2778,2123,655,952,177000,79382
3302,375,2927,989,78600,79401
5713,3264,2449,816,58800,79403
3284,1899,1385,717,56400,79404
0,0,0,-,-,79406
9475,4237,5238,873,114200,79407
3929,1429,2500,1156,151100,79410
3015,1109,1906,901,69500,79411
5640,2795,2845,815,81800,79412
8461,5135,3326,1069,143100,79413
7702,3026,4676,892,106700,79414
6579,2606,3973,859,63500,79415
12939,6380,6559,1134,137000,79416
15129,10386,4743,1043,160500,79423
18856,13047,5809,981,207100,79424
1081,768,313,729,77900,79501
520,384,136,531,55800,79502
58,37,21,-,87500,79503
1207,973,234,584,79300,79504
81,58,23,-,42800,79505
358,306,52,505,66700,79506
511,390,121,792,163800,79508
2896,2365,531,853,103600,79510
486,419,67,754,101600,79511
2011,1547,464,670,70200,79512
77,62,15,-,122100,79517
19,19,0,-,-,79518
29,29,0,-,167500,79519
915,717,198,707,51300,79520
1267,942,325,488,62900,79521
1143,913,230,854,119900,79525
372,309,63,829,81000,79526
97,76,21,498,59200,79527
246,166,80,475,30900,79528
532,426,106,600,40300,79529
214,179,35,-,53600,79530
292,252,40,821,57300,79532
172,127,45,379,31100,79533
71,66,5,-,110200,79534
88,83,5,-,55800,79535
1970,1639,331,738,78100,79536
22,22,0,-,31700,79537
108,105,3,-,110500,79538
95,77,18,631,-,79539
42,42,0,-,-,79540
314,253,61,-,-,79541
457,377,80,622,71100,79543
247,176,71,669,26100,79544
656,545,111,737,78600,79545
796,510,286,532,62500,79546
303,237,66,658,32600,79547
84,71,13,-,87000,79548
5458,4077,1381,760,86100,79549
1430,969,461,635,60300,79553
4571,2947,1624,694,77300,79556
74,47,27,921,90600,79560
241,173,68,636,61700,79561
1256,1130,126,1043,170000,79562
374,266,108,847,68600,79563
91,87,4,-,72500,79565
106,80,26,-,218800,79566
1291,826,465,616,56300,79567
7519,3425,4094,797,104300,79601
8349,6196,2153,939,162600,79602
8489,5019,3470,900,79300,79603
11175,5987,5188,907,109300,79605
10223,5598,4625,987,188300,79606
687,0,687,1201,-,79607
0,0,0,-,-,79699
10006,6635,3371,1037,126200,79701
7887,5404,2483,1451,163100,79703
14807,10086,4721,1306,248900,79705
7594,5929,1665,1293,189900,79706
14497,8900,5597,1264,297600,79707
184,142,42,525,151600,79713
5573,4130,1443,1028,143900,79714
340,248,92,733,52300,79718
189,145,44,820,44100,79719
10537,6782,3755,873,99800,79720
71,59,12,-,24200,79730
1415,1199,216,835,101700,79731
68,46,22,408,72500,79733
1005,843,162,704,112600,79734
3965,2847,1118,850,90200,79735
78,55,23,-,162500,79738
338,227,111,-,251600,79739
113,98,15,1172,70000,79741
179,144,35,559,-,79742
106,56,50,438,-,79743
454,346,108,771,105300,79744
2339,1861,478,858,62600,79745
81,67,14,-,-,79748
100,67,33,500,197900,79749
870,647,223,838,65000,79752
30,19,11,-,-,79754
61,25,36,750,263200,79755
3276,2315,961,956,91500,79756
838,639,199,1132,276300,79758
0,0,0,-,-,79759
11428,6900,4528,990,122100,79761
15737,8925,6812,1119,167900,79762
11632,7484,4148,983,105500,79763
7014,5180,1834,1028,102300,79764
5959,4526,1433,1569,238100,79765
2034,1544,490,1001,98200,79766
0,0,0,-,-,79770
3058,2218,840,877,66800,79772
94,34,60,-,-,79777
389,301,88,561,77500,79778
85,48,37,-,-,79780
92,76,16,-,-,79781
1347,989,358,844,142900,79782
87,78,9,-,212500,79783
35,35,0,-,-,79785
240,208,32,733,63800,79788
254,198,56,731,56400,79789
1855,1401,454,833,102000,79821
3398,1906,1492,723,167900,79830
4,4,0,-,-,79831
106,4,102,599,-,79834
3315,2190,1125,800,80400,79835
1723,1320,403,716,85200,79836
182,94,88,-,28500,79837
1905,1320,585,538,61500,79838
442,353,89,653,48500,79839
210,151,59,-,100300,79842
954,657,297,639,172900,79843
1556,814,742,406,58100,79845
19,0,19,-,-,79846
61,23,38,2172,16600,79847
382,368,14,-,74700,79848
3363,2316,1047,728,79900,79849
217,116,101,591,57200,79851
370,298,72,381,78600,79852
717,608,109,531,73700,79853
48,12,36,-,-,79854
557,383,174,444,61900,79855
3669,367,3302,432,56800,79901
8067,3216,4851,650,174200,79902
5884,3583,2301,647,94000,79903
10958,4523,6435,818,100300,79904
7565,3757,3808,495,81800,79905
1293,0,1293,1379,-,79906
16518,9446,7072,737,90100,79907
988,0,988,1534,-,79908
2004,1565,439,1678,234900,79911
28490,15284,13206,920,188800,79912
12465,7214,5251,632,90000,79915
0,0,0,-,-,79916
0,0,0,-,-,79920
2520,2125,395,801,262800,79922
20077,12540,7537,849,99900,79924
14668,7363,7305,838,140800,79925
11256,8516,2740,774,89400,79927
15529,12853,2676,948,120200,79928
10214,5038,5176,799,96900,79930
8899,6390,2509,863,170000,79932
9206,5895,3311,1148,141900,79934
6216,3573,2643,828,152900,79935
35437,23534,11903,991,130000,79936
23642,18197,5445,1086,147700,79938
15,15,0,-,-,79942
8346,4563,3783,1198,347800,80002
14301,9971,4330,1314,318800,80003
14863,10140,4723,1314,383400,80004
11078,9694,1384,1544,412700,80005
4849,4604,245,2406,609200,80007
13789,4889,8900,1058,243300,80010
16743,8747,7996,1258,220800,80011
18744,8694,10050,1263,256800,80012
24982,18839,6143,1472,303700,80013
17995,10241,7754,1389,262100,80014
22679,18651,4028,1721,365200,80015
19203,15285,3918,1665,510000,80016
12967,7358,5609,1352,254400,80017
4098,3489,609,1833,370300,80018
952,791,161,1343,324100,80019
19767,13861,5906,1604,366700,80020
14971,7996,6975,1671,353100,80021
14919,10569,4350,1221,305900,80022
8365,6868,1497,1751,585500,80023
74,34,40,-,122400,80024
68,59,9,-,-,80025
12626,9270,3356,1496,437300,80026
12955,8592,4363,1765,584000,80027
6021,3143,2878,1069,269200,80030
13441,9912,3529,1596,348900,80031
11702,5886,5816,1116,374400,80033
564,0,564,1577,-,80045
195,128,67,1671,365200,80101
2015,1643,372,1101,371700,80102
1003,867,136,1232,305900,80103
11112,8669,2443,1525,391100,80104
494,418,76,740,264600,80105
2149,2020,129,791,402200,80106
4642,4260,382,1488,474600,80107
9564,7959,1605,1660,627400,80108
7835,6498,1337,1474,449500,80109
9454,5116,4338,1261,298000,80110
12805,7846,4959,1687,657000,80111
13851,8199,5652,1637,440500,80112
10574,5737,4837,1179,456200,80113
1540,1402,138,-,642500,80116
1112,964,148,1184,360600,80117
2503,2328,175,2005,594100,80118
13936,8098,5838,1180,403700,80120
7330,6073,1257,1405,455200,80121
12647,10790,1857,1713,426600,80122
19755,14191,5564,1541,390100,80123
8564,5059,3505,1731,517200,80124
3845,3655,190,2056,457700,80125
15392,12905,2487,1808,483700,80126
16864,14820,2044,1688,440300,80127
14235,11785,2450,1502,378300,80128
11873,8988,2885,1835,459900,80129
9982,7619,2363,2092,455200,80130
141,104,37,-,243800,80131
7210,6502,708,1740,474200,80132
1056,857,199,977,286100,80133
24572,20035,4537,1662,448300,80134
1528,1396,132,1104,638000,80135
1789,1629,160,1139,331200,80136
474,372,102,992,469300,80137
11713,9783,1930,1633,467800,80138
9769,2763,7006,1757,521300,80202
14882,2999,11883,1198,360900,80203
13504,4898,8606,1119,337000,80204
15217,6568,8649,1317,434600,80205
13531,6007,7524,1244,666300,80206
10578,7146,3432,1374,427100,80207
13654,6747,6907,1542,664300,80209
15406,9565,5841,1444,610600,80210
16876,8940,7936,1379,515700,80211
9026,5641,3385,1111,482300,80212
12099,4262,7837,1120,355300,80214
8310,5108,3202,1353,447800,80215
4336,1539,2797,1485,236300,80216
11509,3788,7721,1184,418000,80218
21901,11433,10468,1089,257200,80219
15961,9462,6499,1294,498100,80220
13864,8603,5261,1324,286700,80221
10862,5184,5678,1229,383000,80222
8060,3993,4067,1171,294300,80223
8071,4764,3307,1322,398200,80224
13733,7636,6097,1414,346300,80226
14958,9416,5542,1446,348300,80227
14394,9686,4708,1399,403100,80228
18205,11588,6617,1350,240700,80229
4232,2373,1859,1472,609200,80230
16913,6118,10795,1235,340700,80231
9214,6548,2666,1301,329000,80232
16820,9795,7025,1525,299200,80233
10506,6364,4142,1391,348200,80234
3742,1926,1816,1367,327000,80235
6522,3886,2636,1138,322400,80236
10815,5110,5705,1565,429700,80237
7646,5903,1743,1848,593300,80238
12501,7392,5109,1421,250100,80239
11510,9026,2484,1651,339300,80241
7468,1569,5899,1299,435900,80246
14517,5695,8822,1331,210300,80247
10303,8199,2104,1744,297300,80249
11837,7162,4675,1198,142700,80260
0,0,0,-,-,80264
0,0,0,-,-,80290
0,0,0,-,-,80293
0,0,0,-,-,80294
11518,7019,4499,1662,532500,80301
11956,4657,7299,1487,816600,80302
11117,5186,5931,1432,693200,80303
11077,7558,3519,1591,832200,80304
6993,4306,2687,1885,704900,80305
0,0,0,-,-,80310
16656,11440,5216,1423,505900,80401
8161,6918,1243,1504,534800,80403
0,0,0,-,-,80419
334,239,95,1189,362700,80420
3609,3106,503,1055,333500,80421
2119,1855,264,1147,350700,80422
55,49,6,-,-,80423
3465,2219,1246,1494,604100,80424
81,81,0,-,465600,80425
27,25,2,-,-,80426
442,151,291,1153,285800,80427
256,233,23,-,516400,80428
100,86,14,-,233300,80432
3623,3192,431,1638,466000,80433
22,22,0,-,-,80434
2330,1613,717,1357,592000,80435
246,222,24,-,296000,80436
269,210,59,829,137500,80438
10089,8626,1463,1667,550100,80439
951,689,262,1192,315100,80440
711,280,431,1081,351900,80442
1856,1155,701,1502,537300,80443
571,347,224,1058,294900,80444
1667,1202,465,1147,276800,80446
953,731,222,-,381300,80447
0,0,0,-,-,80448
397,393,4,-,267500,80449
309,245,64,986,246500,80451
1493,1022,471,957,282400,80452
41,28,13,-,-,80453
536,524,12,-,436700,80454
236,155,81,1294,276600,80455
302,255,47,-,331100,80456
94,54,40,-,376200,80457
1014,706,308,944,210300,80459
3283,2221,1062,989,226700,80461
82,71,11,-,350000,80463
6140,5593,547,1524,396900,80465
1533,1017,516,1223,483700,80466
979,692,287,1011,353400,80467
181,110,71,-,255600,80468
212,123,89,1123,176400,80469
1437,1305,132,1136,404700,80470
0,0,0,-,-,80471
3,3,0,-,-,80473
0,0,0,-,-,80475
84,55,29,825,257800,80476
43,25,18,-,554700,80477
571,472,99,1088,492000,80478
4,4,0,-,-,80479
533,421,112,625,197300,80480
196,155,41,1679,391700,80481
442,246,196,884,588000,80482
253,195,58,1082,263500,80483
6760,4849,1911,1423,638400,80487
60,0,60,1357,-,80488
128,105,23,-,379500,80497
2862,1878,984,1233,577200,80498
16912,8926,7986,1198,307100,80501
13681,9371,4310,1412,485400,80503
19479,15807,3672,1599,379400,80504
126,96,30,-,364000,80510
0,0,0,-,-,80511
790,771,19,-,396300,80512
4816,4128,688,1354,413600,80513
1928,1357,571,1169,268300,80514
374,365,9,-,278100,80515
9641,8385,1256,2144,472900,80516
5185,3418,1767,852,435100,80517
516,429,87,1348,266700,80520
13295,5057,8238,1265,369000,80521
14811,10025,4786,1208,354900,80524
22621,13552,9069,1375,389000,80525
18645,10837,7808,1288,352500,80526
7903,5980,1923,1644,443500,80528
1674,1462,212,997,307400,80530
70,70,0,-,386700,80532
6095,5327,768,1551,348800,80534
1158,812,346,855,343900,80535
904,866,38,-,361400,80536
18330,12038,6292,1236,330900,80537
19710,13644,6066,1285,322900,80538
1765,1482,283,1423,549900,80540
1565,1526,39,1703,370000,80542
2571,2174,397,995,278500,80543
54,54,0,-,-,80544
505,472,33,-,267200,80545
99,99,0,-,220200,80546
783,743,40,1185,492900,80547
4307,3826,481,1552,339700,80549
10820,8966,1854,1257,393900,80550
12796,8268,4528,1300,313700,80601
11628,10777,851,2108,440100,80602
4453,3788,665,1361,330600,80603
1238,835,403,897,274800,80610
333,251,82,1077,353000,80611
144,133,11,-,357500,80612
3055,2508,547,992,307200,80615
6525,3910,2615,1231,216700,80620
4280,3256,1024,908,273800,80621
56,38,18,-,272200,80622
295,234,61,1125,189300,80623
368,205,163,1542,390000,80624
17409,8344,9065,897,198200,80631
22632,16085,6547,1219,276300,80634
3572,3016,556,1642,314600,80640
1796,1409,387,1279,348100,80642
1247,1093,154,1149,341600,80643
1035,677,358,899,276400,80644
1592,1155,437,856,266700,80645
497,446,51,1204,314100,80648
155,91,64,738,281900,80649
565,509,56,1268,275300,80650
1499,1235,264,992,295300,80651
275,220,55,-,-,80652
329,250,79,711,225900,80653
993,716,277,872,272100,80654
5899,3597,2302,838,203500,80701
455,251,204,815,98600,80705
1085,716,369,725,138300,80720
96,77,19,-,154700,80721
174,124,50,838,165100,80722
2931,1959,972,835,171800,80723
197,136,61,957,201700,80726
271,113,158,856,84300,80727
397,326,71,637,137200,80728
250,165,85,827,169100,80729
534,447,87,758,151800,80731
227,159,68,1010,139500,80733
1174,768,406,731,165600,80734
145,89,56,839,217200,80735
194,160,34,732,131300,80736
671,446,225,546,102600,80737
57,34,23,-,266700,80740
364,277,87,924,211000,80741
95,61,34,840,137500,80742
488,320,168,794,150000,80743
177,153,24,629,76600,80744
100,80,20,-,194400,80745
24,15,9,675,97200,80746
153,119,34,680,154200,80747
119,91,28,575,107500,80749
91,60,31,-,152800,80750
6824,4264,2560,784,157700,80751
71,51,20,-,212500,80754
33,12,21,-,-,80755
107,56,51,210,165600,80757
1480,968,512,785,169500,80758
1801,1288,513,896,214000,80759
89,83,6,-,177200,80801
87,56,31,-,-,80802
123,81,42,506,91700,80804
187,171,16,725,122000,80805
1776,1102,674,748,115500,80807
2165,1656,509,863,244400,80808
555,480,75,1529,323000,80809
501,350,151,487,137900,80810
107,87,20,-,81300,80812
727,412,315,888,190300,80813
1563,1384,179,1071,263600,80814
364,251,113,655,147500,80815
2603,2346,257,1161,252700,80816
10290,6982,3308,1401,227100,80817
154,136,18,750,119300,80818
387,266,121,876,270300,80819
354,354,0,-,279700,80820
379,293,86,725,142900,80821
117,93,24,-,172500,80822
57,47,10,-,121900,80823
98,83,15,-,165400,80824
161,122,39,632,60000,80825
307,307,0,-,286300,80827
789,499,290,804,176100,80828
2758,1635,1123,947,379300,80829
79,66,13,-,182100,80830
8086,7177,909,1707,328200,80831
297,239,58,1021,238200,80832
271,241,30,-,205200,80833
174,131,43,582,99000,80834
366,231,135,744,178100,80835
437,270,167,745,156000,80836
629,0,629,1665,-,80840
320,228,92,670,117000,80860
102,94,8,525,171700,80861
21,21,0,-,68300,80862
5172,4200,972,1235,326100,80863
588,443,145,1031,228900,80864
2859,12,2847,1654,-,80902
7095,2829,4266,835,244600,80903
10169,5747,4422,1004,275800,80904
7471,3798,3673,964,233300,80905
15248,9399,5849,1221,357800,80906
12834,7012,5822,973,222100,80907
6415,5926,489,1975,480000,80908
16197,7846,8351,861,219400,80909
12033,5009,7024,963,166000,80910
11911,9430,2481,1333,204800,80911
85,0,85,1713,-,80913
41,0,41,2276,-,80914
8238,5632,2606,1096,202400,80915
14032,6949,7083,1139,171500,80916
12856,7409,5447,1091,231200,80917
18725,11026,7699,1215,265300,80918
11272,8397,2875,1300,373500,80919
13840,9884,3956,1487,332000,80920
8555,6588,1967,1570,444900,80921
10040,7429,2611,1604,258700,80922
10644,7801,2843,1673,287000,80923
3187,2374,813,1824,451900,80924
3609,3018,591,1746,283600,80925
554,437,117,716,226300,80926
1368,1208,160,2278,384600,80927
410,366,44,1083,166800,80928
62,62,0,-,329500,80929
674,261,413,1610,239100,80930
25,25,0,-,-,80938
0,0,0,-,-,80939
1534,1080,454,1606,260100,80951
11915,6169,5746,794,128600,81001
5762,2572,3190,675,109700,81003
10900,5523,5377,792,108000,81004
12605,9159,3446,835,166800,81005
4583,3762,821,869,193200,81006
11443,9310,2133,1037,221700,81007
4541,2960,1581,1123,181100,81008
521,369,152,940,196500,81019
440,309,131,587,96800,81020
12,8,4,-,-,81021
564,459,105,698,164700,81022
502,445,57,1325,191400,81023
139,124,15,-,179500,81024
290,246,44,830,107800,81025
75,47,28,-,51300,81027
137,91,46,343,74500,81029
67,50,17,575,-,81030
53,47,6,-,42500,81033
478,380,98,741,84500,81036
0,0,0,-,-,81038
695,438,257,739,103300,81039
193,193,0,-,-,81040
324,220,104,449,82100,81041
22,15,7,-,61300,81043
146,115,31,427,81500,81044
26,23,3,-,78800,81045
565,410,155,651,87100,81047
114,69,45,778,131300,81049
4230,2620,1610,666,98800,81050
3689,2364,1325,724,108500,81052
1357,727,630,653,72800,81054
751,568,183,891,211800,81055
168,122,46,582,153800,81057
410,314,96,651,87100,81058
46,33,13,-,-,81059
315,225,90,1597,90400,81062
691,522,169,728,77600,81063
123,89,34,392,56800,81064
2090,1344,746,724,82000,81067
888,786,102,729,244800,81069
122,63,59,756,123200,81071
850,596,254,446,90900,81073
222,138,84,1075,93100,81076
297,213,84,596,126500,81077
37,33,4,-,327500,81081
5484,3634,1850,708,149500,81082
66,24,42,-,82300,81084
59,45,14,372,75000,81087
2164,1436,728,609,116900,81089
430,338,92,619,76300,81090
337,249,88,1060,210100,81091
387,279,108,633,133200,81092
5799,3309,2490,688,158800,81101
1030,770,260,478,96500,81120
157,135,22,788,193300,81121
3553,2902,651,1130,339600,81122
399,306,93,748,84000,81123
68,59,9,-,-,81124
1333,734,599,434,93300,81125
104,99,5,-,88700,81126
52,39,13,-,629200,81128
48,39,9,-,61300,81129
354,312,42,720,302600,81130
752,582,170,771,198000,81131
1413,1084,329,609,139200,81132
455,354,101,618,165400,81133
93,69,24,595,153400,81136
2184,1512,672,972,249100,81137
38,12,26,-,-,81138
834,663,171,684,147800,81140
483,397,86,708,118600,81141
328,273,55,815,112500,81143
2858,1652,1206,675,157500,81144
270,181,89,842,118200,81146
5541,3968,1573,962,316300,81147
111,98,13,768,72900,81148
412,283,129,603,141300,81149
657,539,118,500,134900,81151
677,372,305,338,108700,81152
477,393,84,221,268100,81154
122,99,23,-,367900,81155
4160,3274,886,986,365200,81201
191,152,39,-,513200,81210
3137,2403,734,901,343600,81211
11403,8269,3134,801,178300,81212
76,76,0,-,340000,81220
118,107,11,775,93900,81221
161,113,48,1043,167200,81222
690,640,50,741,142700,81223
1250,844,406,1446,584700,81224
520,331,189,1273,462100,81225
2534,1840,694,916,141400,81226
0,0,0,-,-,81227
4144,2299,1845,876,314800,81230
0,0,0,-,-,81231
9,9,0,-,-,81232
449,382,67,-,280000,81233
345,240,105,756,365100,81235
698,566,132,-,416200,81236
17,17,0,-,-,81237
56,56,0,-,347800,81239
1505,1252,253,1070,204400,81240
46,45,1,-,246400,81241
236,162,74,817,280200,81242
40,34,6,-,-,81243
188,167,21,906,131800,81244
54,54,0,-,-,81248
109,99,10,-,450000,81251
1903,1630,273,611,246900,81252
278,278,0,-,-,81253
12196,8110,4086,1187,454600,81301
3199,2316,883,1137,395700,81303
111,111,0,-,151600,81320
5999,4081,1918,831,193400,81321
1917,1532,385,974,248700,81323
520,450,70,714,104000,81324
78,69,9,-,183000,81325
837,712,125,1227,305800,81326
213,195,18,-,256400,81327
1788,1426,362,950,288200,81328
24,0,24,-,-,81330
139,129,10,-,259800,81331
111,64,47,860,319000,81332
596,339,257,342,152300,81334
23,11,12,-,-,81335
9535,6353,3182,887,206200,81401
4524,3695,829,1058,308600,81403
685,509,176,883,258800,81410
26,26,0,-,145000,81411
2135,1657,478,846,258500,81413
540,467,73,1125,348300,81415
5116,3535,1581,772,227600,81416
668,523,145,1066,220100,81418
1539,1089,450,879,254300,81419
314,193,121,625,148200,81422
693,474,219,1071,294900,81423
452,363,89,680,153800,81424
2074,1595,479,777,206000,81425
62,51,11,1063,620500,81426
509,360,149,887,380000,81427
1455,1197,258,771,237700,81428
20,20,0,-,233300,81429
401,361,40,-,602300,81430
158,148,10,-,200000,81431
1373,977,396,1267,491900,81432
270,165,105,1026,320800,81433
114,73,41,1077,-,81434
2371,1255,1116,1172,496900,81435
9933,4166,5767,822,181900,81501
6336,4677,1659,1015,202300,81503
11743,8610,3133,1068,182400,81504
4560,3125,1435,1138,289700,81505
5517,3343,2174,1066,295300,81506
6177,5380,797,1329,336400,81507
5377,3369,2008,846,142200,81520
6422,4847,1575,1172,237400,81521
61,61,0,-,-,81522
389,389,0,-,437500,81523
702,577,125,574,327600,81524
441,374,67,-,193200,81525
2183,1592,591,857,323700,81526
764,661,103,1158,322000,81527
5853,3605,2248,1190,453300,81601
116,87,29,539,134400,81610
4601,2783,1818,1551,649300,81611
0,0,0,-,-,81612
1227,781,446,1142,884400,81615
3446,2018,1428,1485,546200,81620
2488,1674,814,2037,627000,81621
5851,3868,1983,1643,621200,81623
444,366,78,860,263900,81624
5093,3278,1815,783,184000,81625
387,308,79,933,216100,81630
2647,1923,724,1449,572200,81631
3112,2370,742,1540,668000,81632
0,0,0,-,-,81633
2579,1625,954,838,195700,81635
2802,2110,692,1717,362700,81637
33,23,10,-,166000,81638
1008,694,314,953,231100,81639
83,61,22,-,-,81640
1404,973,431,738,220400,81641
10,0,10,-,-,81642
248,200,48,968,334700,81643
395,201,194,1508,646300,81645
91,73,18,-,364300,81646
2486,1918,568,1440,344400,81647
890,650,240,781,164700,81648
101,63,38,1875,345300,81649
4811,3430,1381,1010,257500,81650
1748,1282,466,1357,330100,81652
9,9,0,-,-,81653
543,487,56,-,297000,81654
11,0,11,-,-,81655
124,124,0,-,-,81656
2382,1705,677,1613,768300,81657
15631,9575,6056,934,197000,82001
0,0,0,-,-,82005
8440,5415,3025,1008,160700,82007
13819,11264,2555,923,290100,82009
76,60,16,650,-,82050
25,8,17,-,-,82051
0,0,0,-,-,82052
453,360,93,1316,215600,82053
359,255,104,-,222200,82054
171,140,31,-,308800,82055
7,7,0,-,-,82058
98,98,0,-,173400,82059
138,138,0,-,259800,82060
0,0,0,-,-,82061
103,17,86,-,-,82063
8588,4737,3851,822,235700,82070
6962,3119,3843,769,236300,82072
0,0,0,-,-,82073
55,44,11,-,312000,82081
622,491,131,-,238300,82082
117,79,38,1067,68100,82083
7,7,0,-,-,82084
200,0,200,435,-,82190
3133,2338,795,770,197200,82201
180,98,82,586,85000,82210
273,227,46,850,210900,82212
207,181,26,522,139800,82213
521,396,125,779,146900,82214
65,46,19,925,214600,82215
9,9,0,-,-,82217
8,8,0,-,-,82219
146,99,47,541,124500,82221
19,15,4,-,182500,82222
378,307,71,777,205200,82223
6,6,0,-,-,82224
743,558,185,578,157600,82225
118,107,11,415,160200,82227
1,1,0,-,-,82229
4108,2960,1148,711,168600,82240
16,16,0,-,180000,82242
46,35,11,-,-,82243
206,165,41,534,211700,82244
3288,2157,1131,835,173500,82301
323,241,82,775,198900,82321
49,42,7,488,45000,82322
72,53,19,1396,137500,82323
116,71,45,-,177100,82324
478,392,86,876,217600,82325
300,201,99,675,83500,82327
190,135,55,577,-,82329
1087,825,262,672,223800,82331
69,30,39,-,150000,82332
222,182,40,667,132800,82334
30,30,0,-,-,82335
88,48,40,-,51700,82336
3044,2326,718,640,162100,82401
787,594,193,602,151400,82410
178,114,64,904,196900,82411
178,146,32,567,118800,82412
6579,4824,1755,926,283200,82414
292,241,51,650,152000,82420
130,113,17,913,119800,82421
8,8,0,-,-,82422
75,46,29,450,82700,82423
1168,860,308,710,172000,82426
73,45,28,-,-,82428
32,30,2,-,102300,82430
1288,896,392,710,175300,82431
127,103,24,-,190600,82432
481,344,137,859,282600,82433
58,24,34,-,-,82434
4935,3589,1346,819,248200,82435
68,68,0,-,-,82440
79,79,0,-,-,82441
359,254,105,638,256800,82442
2081,1558,523,729,148500,82443
73,73,0,-,373000,82450
7197,4936,2261,779,179200,82501
102,87,15,-,129200,82510
85,47,38,685,413600,82512
898,683,215,738,209000,82513
424,249,175,503,117000,82514
166,137,29,717,161400,82515
156,108,48,928,-,82516
4997,3592,1405,873,234500,82520
365,288,77,896,226900,82523
11416,7326,4090,781,200200,82601
10916,8371,2545,1082,206400,82604
7792,4767,3025,884,251600,82609
94,50,44,-,400000,82620
0,0,0,-,-,82630
3844,2932,912,710,209200,82633
70,33,37,808,66300,82635
1624,1232,392,908,182300,82636
1547,1038,509,784,199300,82637
0,0,0,-,-,82638
267,176,91,1007,208300,82639
25,25,0,-,-,82640
49,46,3,-,-,82642
116,95,21,655,50700,82643
781,479,302,810,101900,82644
0,0,0,-,-,82646
10,10,0,-,-,82648
468,330,138,619,156600,82649
2130,1835,295,788,162600,82701
111,100,11,-,311800,82710
55,37,18,-,-,82711
146,146,0,-,226100,82712
22,0,22,-,-,82714
0,0,0,-,-,82715
6853,4822,2031,771,194800,82716
9349,7001,2348,1057,237900,82718
337,263,74,820,153800,82720
1086,897,189,680,233000,82721
150,140,10,-,252100,82723
202,189,13,-,254400,82725
462,379,83,-,268200,82727
1092,874,218,904,223200,82729
716,520,196,750,170500,82730
85,0,85,-,-,82731
623,509,114,1049,203800,82732
11305,7561,3744,837,264600,82801
119,99,20,1031,398700,82831
298,272,26,-,424400,82832
45,45,0,-,-,82833
3410,2362,1048,932,247600,82834
144,88,56,672,206300,82835
425,311,114,738,257400,82836
24,15,9,-,"2,000,000+",82837
133,127,6,-,335100,82838
482,417,65,971,264000,82839
396,283,113,-,334300,82842
10,10,0,-,-,82844
13,13,0,-,-,82845
10184,7706,2478,876,204300,82901
165,165,0,-,589900,82922
179,164,15,-,-,82923
158,158,0,-,389600,82925
62,0,62,-,-,82929
5197,3849,1348,677,172300,82930
164,108,56,-,165900,82932
210,210,0,-,121500,82933
26,24,2,-,52500,82934
4610,3600,1010,895,214500,82935
0,0,0,-,-,82936
1476,1263,213,720,195600,82937
79,79,0,-,-,82938
685,503,182,822,174900,82939
1661,1337,324,1145,243200,82941
35,35,0,-,-,82942
123,103,20,-,200500,82943
34,34,0,-,355600,82944
103,87,16,-,81500,82945
6854,3882,2972,1419,830600,83001
64,64,0,-,-,83011
86,18,68,-,-,83012
113,113,0,-,-,83013
1235,963,272,1220,916200,83014
279,202,77,-,1560300,83025
1335,1040,295,802,185400,83101
1537,1222,315,763,229400,83110
262,172,90,-,332400,83111
134,108,26,-,-,83112
799,573,226,777,208200,83113
286,253,33,1114,205300,83114
378,344,34,-,325000,83115
301,237,64,829,150400,83116
340,340,0,-,434000,83118
79,79,0,-,-,83119
244,237,7,-,291800,83120
0,0,0,-,-,83121
201,162,39,-,-,83122
169,122,47,768,107000,83123
71,66,5,-,105000,83124
111,111,0,-,439700,83126
1433,1212,221,1057,294100,83127
473,353,120,1181,345000,83128
13971,9137,4834,662,153800,83201
7701,5613,2088,783,173700,83202
120,88,32,428,100000,83203
7379,4596,2783,630,149500,83204
132,0,132,667,-,83209
1144,857,287,694,132300,83210
1991,1408,583,633,154900,83211
70,58,12,-,225000,83212
467,357,110,542,80900,83213
233,160,73,-,147900,83214
27,25,2,-,65900,83215
296,250,46,464,156000,83217
110,83,27,794,144800,83218
76,52,24,-,136100,83220
8932,6727,2205,643,160300,83221
47,36,11,-,250000,83223
1017,782,235,549,171700,83226
7,7,0,-,-,83227
196,135,61,738,216100,83228
181,143,38,713,169700,83232
24,24,0,-,-,83233
562,455,107,638,132300,83234
54,54,0,-,58200,83235
796,640,156,613,167800,83236
320,271,49,829,177100,83237
38,32,6,-,167500,83238
216,186,30,680,147700,83239
834,677,157,558,142600,83241
9,9,0,-,-,83243
114,108,6,-,209400,83244
879,749,130,730,174400,83245
411,361,50,655,222500,83246
590,483,107,683,171800,83250
438,350,88,652,183600,83251
1606,1281,325,748,167800,83252
43,36,7,-,215400,83253
1481,1064,417,558,124500,83254
528,428,100,710,166600,83255
249,211,38,825,153600,83261
384,353,31,1008,156600,83262
3222,2603,619,647,217000,83263
179,147,32,-,130800,83271
112,94,18,-,252000,83272
3074,2489,585,786,174000,83274
1380,1093,287,598,145100,83276
74,74,0,-,142400,83277
122,111,11,-,-,83278
18,8,10,-,-,83281
60,60,0,-,336400,83283
27,14,13,-,275000,83285
418,362,56,835,215500,83286
123,111,12,-,432900,83287
21347,13904,7443,809,169100,83301
99,44,55,673,111100,83302
306,217,89,775,179600,83311
55,32,23,-,137500,83312
1432,1034,398,776,356600,83313
371,265,106,777,173700,83314
3943,3010,933,680,133400,83316
5684,3930,1754,643,161000,83318
316,254,62,733,232900,83320
204,153,51,796,143800,83321
14,14,0,-,430000,83322
578,446,132,695,140200,83323
208,152,56,650,153400,83324
296,182,114,813,130000,83325
338,242,96,853,162500,83327
2076,1598,478,889,172800,83328
2428,1750,678,619,153200,83330
1065,787,278,733,215000,83332
3560,2371,1189,686,419400,83333
764,505,259,917,116700,83334
594,407,187,536,150500,83335
1851,1382,469,864,154100,83336
21,21,0,-,-,83337
7130,4645,2485,774,167000,83338
1935,1322,613,1127,670100,83340
2383,2045,338,782,227100,83341
396,376,20,-,185200,83342
428,259,169,763,166000,83344
535,378,157,736,184500,83346
1126,875,251,676,150800,83347
118,91,27,-,-,83348
395,290,105,611,137100,83349
4511,3137,1374,628,147200,83350
1158,781,377,645,142100,83352
533,463,70,1680,823100,83353
0,0,0,-,-,83354
1573,1007,566,697,137700,83355
14143,9635,4508,837,168900,83401
9393,5735,3658,701,163800,83402
8999,6703,2296,929,198200,83404
6058,4571,1487,916,207000,83406
208,206,2,-,772200,83414
809,639,170,723,220100,83420
121,105,16,-,160000,83421
1103,829,274,1168,341900,83422
257,155,102,608,85000,83423
156,77,79,-,253400,83424
163,136,27,963,144300,83425
608,584,24,1146,215100,83427
196,170,26,491,218800,83428
272,267,5,-,383300,83429
239,191,48,705,175400,83431
6,6,0,-,-,83433
581,444,137,754,154900,83434
191,122,69,663,210000,83435
180,143,37,988,188000,83436
10500,4562,5938,720,219100,83440
6730,5526,1204,805,218100,83442
342,301,41,893,162900,83443
409,247,162,-,133700,83444
2515,1977,538,785,158800,83445
16,16,0,-,137500,83446
633,481,152,1185,198500,83448
90,68,22,698,282500,83449
294,257,37,660,123300,83450
254,201,53,828,158100,83451
684,620,64,800,399300,83452
186,152,34,745,146700,83454
1764,1356,408,781,337800,83455
0,0,0,-,-,83460
220,180,40,-,342600,83462
55,38,17,-,181300,83463
127,79,48,470,99800,83464
51,40,11,-,273300,83465
137,108,29,-,202400,83466
2854,2204,650,672,168600,83467
81,79,2,-,243800,83468
13,13,0,-,-,83469
14460,10523,3937,725,194900,83501
103,51,52,596,222600,83520
705,545,160,660,169200,83522
343,288,55,638,116000,83523
393,273,120,733,167000,83524
148,118,30,-,163600,83525
119,103,16,825,195500,83526
2036,1362,674,688,168500,83530
113,95,18,729,218500,83533
441,318,123,851,178300,83535
1837,1338,499,609,163400,83536
460,381,79,725,172000,83537
876,674,202,623,159500,83539
719,440,279,734,108900,83540
447,412,35,933,216200,83541
64,47,17,555,238600,83542
296,233,63,655,118400,83543
2396,1812,584,741,163500,83544
201,164,37,731,153800,83545
257,218,39,525,91500,83546
179,148,31,-,213100,83547
54,49,5,738,102500,83548
332,243,89,779,195300,83549
458,402,56,679,159100,83552
489,415,74,642,107100,83553
209,187,22,475,167700,83554
236,194,42,575,166100,83555
12,12,0,-,-,83601
6,6,0,-,-,83602
237,109,128,550,154200,83604
14428,9025,5403,779,150000,83605
8454,6299,2155,912,217800,83607
390,333,57,554,169300,83610
762,675,87,717,271900,83611
830,597,233,673,186600,83612
426,312,114,974,233300,83615
10674,9194,1480,1141,426500,83616
6118,4509,1609,732,164000,83617
3094,2399,695,737,187900,83619
1006,886,120,697,275000,83622
568,341,227,478,108300,83623
523,284,239,541,208300,83624
444,345,99,879,171400,83626
258,200,58,-,187500,83627
1596,1058,538,712,97600,83628
848,654,194,757,202100,83629
412,329,83,713,152800,83631
157,137,20,-,239800,83632
254,176,78,680,146200,83633
7379,5932,1447,1267,216700,83634
46,25,21,-,-,83636
72,54,18,-,240600,83637
2666,2125,541,763,341300,83638
1292,1030,262,546,159700,83639
1176,969,207,710,210700,83641
17250,12064,5186,1006,278700,83642
65,65,0,-,202900,83643
4206,3676,530,866,238400,83644
315,260,55,706,182400,83645
22509,18651,3858,1192,290000,83646
8559,5655,2904,784,154800,83647
902,0,902,997,-,83648
214,143,71,-,175700,83650
11895,7770,4125,927,149800,83651
680,587,93,673,247600,83654
1569,1247,322,670,172400,83655
215,166,49,1053,102600,83656
105,92,13,-,257100,83657
2122,1543,579,639,171300,83660
3862,2563,1299,754,137400,83661
20,18,2,-,87500,83666
4014,3350,664,1131,300600,83669
173,167,6,-,222600,83670
5,5,0,-,-,83671
3312,2316,996,692,140900,83672
1644,1178,466,740,209300,83676
59,59,0,-,-,83677
17224,12504,4720,888,203300,83686
11870,7822,4048,981,188100,83687
10995,5831,5164,818,424600,83702
7348,4583,2765,983,261100,83703
15972,9268,6704,958,198400,83704
12031,6225,5806,861,194900,83705
13770,6803,6967,948,280400,83706
20765,16793,3972,1168,251700,83709
4207,2702,1505,999,428400,83712
10456,7292,3164,1175,243400,83713
10324,6974,3350,993,246900,83714
6625,5293,1332,1239,326900,83716
2836,2369,467,1044,297900,83801
33,8,25,-,-,83802
422,234,188,1067,234100,83803
708,607,101,715,242200,83804
3376,2610,766,668,204800,83805
102,84,18,705,84400,83806
61,50,11,513,86300,83808
139,139,0,-,308300,83809
525,478,47,-,197800,83810
656,460,196,818,161500,83811
24,24,0,-,70000,83812
445,387,58,-,383900,83813
11149,6057,5092,886,297100,83814
14343,8797,5546,1098,251700,83815
115,107,8,-,426900,83821
858,704,154,654,163800,83822
616,506,110,853,209500,83823
98,66,32,506,175000,83824
97,73,24,1722,245000,83825
0,0,0,-,-,83826
86,73,13,-,107700,83827
160,160,0,-,189000,83830
621,507,114,803,202400,83832
649,555,94,908,454700,83833
66,43,23,-,306500,83834
8673,7385,1288,1053,296900,83835
459,370,89,818,328600,83836
1294,753,541,601,120400,83837
646,516,130,778,165500,83839
103,78,25,732,137500,83840
175,102,73,556,322400,83841
63,46,17,-,220000,83842
11211,5034,6177,735,237200,83843
0,0,0,-,-,83844
589,482,107,663,170800,83845
346,272,74,647,83600,83846
688,475,213,525,237500,83847
91,76,15,-,-,83848
849,634,215,599,124700,83849
809,668,141,768,143400,83850
657,478,179,717,134300,83851
368,100,268,761,163200,83852
16124,11860,4264,988,226700,83854
851,588,263,652,166800,83855
2523,2036,487,758,199700,83856
368,322,46,-,310100,83857
5829,4727,1102,1053,266100,83858
2367,2049,318,995,293000,83860
2524,1842,682,629,176500,83861
7358,5021,2337,953,280300,83864
37,37,0,-,-,83866
207,178,29,-,182600,83867
359,223,136,778,71300,83868
1948,1641,307,800,219900,83869
107,74,33,513,-,83870
783,660,123,697,229900,83871
261,230,31,1228,334200,83872
804,465,339,674,138900,83873
15,15,0,-,-,83874
672,538,134,673,246800,83876
214,194,20,917,180000,84001
108,87,21,1125,224000,84002
13689,10819,2870,1260,358300,84003
2819,2474,345,1740,571900,84004
7256,6341,915,1567,280900,84005
336,249,87,1086,189800,84006
208,204,4,-,181600,84007
15231,10983,4248,1074,314500,84010
286,275,11,825,253900,84013
5617,4730,887,1159,321700,84014
19627,14650,4977,1054,222100,84015
1340,1130,210,1065,317100,84017
78,78,0,-,436800,84018
13698,10912,2786,1415,469000,84020
1332,979,353,869,163600,84021
302,23,279,857,-,84022
69,48,21,375,262500,84023
11,11,0,-,-,84024
6758,5511,1247,1178,386700,84025
341,293,48,731,146300,84026
215,188,27,1375,183000,84027
194,117,77,821,274200,84028
3091,2594,497,862,254700,84029
85,68,17,-,195800,84031
6791,4889,1902,1288,396200,84032
364,279,85,743,271800,84033
78,50,28,238,73800,84034
108,95,13,-,210200,84035
2457,1838,619,1125,397800,84036
10910,9639,1271,995,354800,84037
114,102,12,-,274000,84038
247,233,14,-,166800,84039
7476,6289,1187,1366,306600,84040
16581,10695,5886,990,233200,84041
2883,2376,507,1367,401900,84042
16698,13321,3377,1480,352900,84043
7901,5950,1951,1120,205000,84044
7011,5832,1179,1486,341600,84045
94,94,0,-,145300,84046
13244,5845,7399,1120,256500,84047
2197,1693,504,2297,438700,84049
3287,2793,494,1182,371900,84050
167,137,30,956,182000,84051
459,327,132,804,154900,84052
367,329,38,788,205500,84053
6583,4824,1759,1166,303100,84054
473,386,87,875,354700,84055
1002,7,995,1287,-,84056
12355,7331,5024,1072,243700,84057
12033,6097,5936,1077,291100,84058
3003,1907,1096,1495,1056500,84060
204,129,75,1608,327800,84061
13668,9716,3952,1148,317300,84062
53,41,12,-,155500,84063
194,134,60,520,166700,84064
11804,10568,1236,1433,382100,84065
4089,2989,1100,861,191300,84066
12863,10729,2134,1077,191500,84067
174,148,26,1063,237500,84069
10339,6448,3891,1166,255500,84070
488,468,20,909,289700,84071
155,133,22,750,177200,84072
88,75,13,-,186600,84073
15912,13134,2778,1049,219400,84074
7831,7276,555,1514,315600,84075
80,75,5,-,138300,84076
9003,6648,2355,803,206800,84078
97,91,6,1125,161000,84080
13398,11062,2336,1330,308100,84081
246,232,14,-,344200,84082
420,108,312,600,54300,84083
12053,9096,2957,1239,258300,84084
118,89,29,793,122500,84085
126,102,24,-,165000,84086
4752,3948,804,1397,282900,84087
11368,7867,3501,1168,285200,84088
9165,8578,587,1674,457100,84092
7495,6648,847,1803,405500,84093
9577,7578,1999,1390,299300,84094
20968,16934,4034,1415,405300,84095
13140,11420,1720,1427,362800,84096
6683,4971,1712,1072,326700,84097
6988,5694,1294,1698,750400,84098
2961,609,2352,934,282500,84101
9218,2300,6918,965,323100,84102
10781,5198,5583,937,479900,84103
7738,3952,3786,1092,173600,84104
9398,6111,3287,1088,394300,84105
14324,8157,6167,1147,322900,84106
13737,6960,6777,1070,260300,84107
7822,5952,1870,1101,527300,84108
9082,6943,2139,1304,431100,84109
6759,1449,5310,843,271900,84111
179,3,176,850,-,84112
38,0,38,-,-,84113
11301,4417,6884,877,231700,84115
11062,6196,4866,983,186100,84116
9875,6426,3449,1167,378900,84117
19684,15941,3743,1256,226200,84118
17133,9656,7477,1085,187300,84119
13703,9734,3969,1088,219900,84120
15962,12165,3797,1259,374300,84121
14629,8342,6287,1075,250300,84123
7870,5865,2005,1112,436100,84124
6890,6005,885,1511,233300,84128
231,105,126,1831,1115000,84144
0,0,0,-,-,84180
267,251,16,-,195600,84301
8699,6309,2390,754,198400,84302
26,26,0,-,-,84304
233,215,18,917,159900,84305
90,90,0,-,385000,84306
369,328,41,941,198800,84307
94,74,20,1325,194100,84308
130,123,7,-,230900,84309
1485,1399,86,2642,462300,84310
174,121,53,661,172300,84311
1530,1346,184,748,179600,84312
46,19,27,-,-,84313
327,286,41,688,231100,84314
2554,2454,100,1216,328600,84315
89,73,16,825,143800,84316
768,712,56,742,410100,84317
1343,1168,175,827,284100,84318
2351,1832,519,853,192100,84319
748,615,133,874,191000,84320
14950,7456,7494,725,211600,84321
245,232,13,925,285500,84324
650,602,48,725,315200,84325
585,473,112,642,251100,84326
246,224,22,638,218300,84327
506,472,34,925,343500,84328
46,46,0,-,-,84329
127,120,7,738,180400,84330
100,86,14,669,167600,84331
2387,2069,318,982,282400,84332
870,671,199,797,220800,84333
42,42,0,-,186400,84334
3735,3161,574,910,238800,84335
42,36,6,-,144400,84336
4007,3036,971,738,202400,84337
146,111,35,621,196600,84338
1492,1346,146,774,260100,84339
1157,1039,118,896,271600,84340
8031,3665,4366,941,247700,84341
14244,7893,6351,814,216600,84401
12926,8854,4072,848,234400,84403
20458,14950,5508,906,189800,84404
11227,8267,2960,914,226100,84405
9283,8096,1187,1036,281000,84414
4831,3525,1306,676,151300,84501
1380,1053,327,632,163400,84511
217,191,26,-,68300,84512
536,440,96,583,138700,84513
0,0,0,-,-,84515
61,57,4,-,167500,84516
302,239,63,867,194600,84518
464,348,116,594,66400,84520
267,220,47,592,127000,84521
130,120,10,-,104700,84522
639,499,140,541,155800,84523
338,228,110,520,114100,84525
1688,1261,427,651,144200,84526
913,656,257,660,137300,84528
121,102,19,-,85800,84529
78,37,41,-,-,84530
192,182,10,-,32500,84531
4343,2834,1509,859,250100,84532
98,11,87,-,-,84533
633,515,118,590,57100,84534
1085,883,202,904,181500,84535
431,379,52,414,34700,84536
479,359,120,730,143400,84537
90,85,5,-,52900,84539
18,18,0,-,-,84540
635,452,183,702,123500,84542
10733,4732,6001,871,230300,84601
11883,6186,5697,900,340100,84604
10562,2287,8275,865,234500,84606
328,305,23,950,166800,84620
54,54,0,-,-,84621
585,501,84,1023,188500,84622
111,61,50,-,-,84623
1911,1296,615,696,159800,84624
88,59,29,-,352700,84626
2059,1280,779,701,214700,84627
268,246,22,-,95000,84628
998,925,73,1104,260800,84629
131,74,57,719,151400,84630
1102,855,247,716,147400,84631
339,289,50,641,173300,84632
340,309,31,718,211200,84633
418,391,27,647,172600,84634
262,225,37,797,97100,84635
205,163,42,675,161300,84636
276,222,54,720,178600,84637
120,83,37,721,163000,84638
300,243,57,767,182500,84639
55,55,0,-,121300,84640
1201,846,355,772,167700,84642
187,155,32,1022,220800,84643
756,671,85,575,273500,84645
526,476,50,658,162400,84646
1339,1070,269,914,174400,84647
2063,1524,539,810,221900,84648
243,215,28,631,163600,84649
7218,5802,1416,1024,253900,84651
300,267,33,892,148300,84652
2383,2150,233,1250,347100,84653
993,778,215,714,122400,84654
3375,2863,512,986,260200,84655
127,109,18,789,184200,84656
192,159,33,828,142000,84657
11111,8538,2573,1124,281900,84660
524,448,76,881,221300,84662
9553,6662,2891,1096,263400,84663
2518,2338,180,1164,427100,84664
150,138,12,-,266700,84665
116,90,26,-,211100,84667
3021,2059,962,689,181500,84701
53,35,18,792,218800,84710
269,238,31,863,219200,84711
54,47,7,-,203100,84712
1245,873,372,629,213700,84713
341,244,97,856,181600,84714
143,131,12,500,212500,84715
152,90,62,835,250000,84716
86,64,22,950,231300,84718
34,22,12,-,-,84719
7540,4462,3078,781,238200,84720
7371,4814,2557,844,205100,84721
444,404,40,-,191300,84722
250,204,46,685,196400,84723
444,349,95,634,123500,84724
487,419,68,1005,200400,84725
372,297,75,678,179300,84726
15,8,7,-,-,84728
89,79,10,-,155700,84729
97,95,2,-,184400,84730
38,38,0,-,-,84731
20,20,0,-,309100,84732
56,52,4,-,313300,84733
111,74,37,530,210000,84734
94,86,8,-,320000,84735
85,80,5,-,111400,84736
6266,4366,1900,975,242100,84737
3545,2941,604,1004,309200,84738
173,106,67,771,140900,84739
69,67,2,-,182700,84740
2150,1729,421,1017,216900,84741
99,81,18,625,350000,84742
2,2,0,-,-,84743
87,79,8,-,158700,84744
1337,1116,221,1030,182400,84745
459,395,64,755,330000,84746
381,263,118,589,169100,84747
86,67,19,-,231900,84749
173,139,34,921,155800,84750
674,523,151,922,131500,84751
346,258,88,864,172500,84752
8,8,0,-,-,84753
1377,1261,116,656,197400,84754
24,24,0,-,-,84755
120,85,35,-,-,84756
598,449,149,1379,405400,84757
189,156,33,828,156700,84758
637,549,88,706,182700,84759
190,155,35,688,191100,84760
1189,936,253,935,180700,84761
51,23,28,-,-,84762
110,80,30,840,383800,84763
91,26,65,627,235700,84764
2195,1835,360,1445,308200,84765
91,66,25,-,178000,84766
176,122,54,542,633900,84767
15118,8787,6331,938,274800,84770
91,53,38,-,295000,84772
123,82,41,-,216700,84773
470,445,25,1225,314500,84774
156,122,34,595,234800,84775
188,154,34,638,194600,84776
253,209,44,833,330300,84779
8623,6030,2593,1163,289700,84780
68,54,14,-,-,84781
353,335,18,-,282700,84782
346,334,12,-,397900,84783
406,57,349,929,-,84784
15866,11824,4042,1111,299800,84790
4101,1610,2491,882,346000,85003
3017,685,2332,1191,282300,85004
9355,3630,5725,834,219500,85006
5287,1915,3372,826,286800,85007
22404,5918,16486,931,183600,85008
12963,5707,7256,837,101500,85009
3679,1938,1741,1132,440100,85012
10129,4536,5593,1046,294800,85013
13166,4744,8422,977,278300,85014
15181,5464,9717,848,178500,85015
16838,7769,9069,1028,318900,85016
11879,4757,7122,828,124100,85017
17137,9086,8051,981,534000,85018
7758,3601,4157,943,155300,85019
15846,8691,7155,967,259300,85020
16354,6135,10219,895,283400,85021
22331,11951,10380,1122,248300,85022
12746,7300,5446,1003,227500,85023
10178,7056,3122,1316,267700,85024
15786,8975,6811,1117,189300,85027
8080,6730,1350,1252,376800,85028
17072,8590,8482,941,186100,85029
7948,4372,3576,981,145100,85031
28127,15394,12733,1058,247300,85032
16095,7742,8353,1003,150800,85033
1994,401,1593,730,160800,85034
15140,6005,9135,1055,154800,85035
14716,8395,6321,1205,169700,85037
10323,4521,5802,929,145300,85040
17333,11150,6183,1122,174800,85041
14771,8829,5942,1087,191500,85042
9796,5937,3859,1208,170000,85043
17106,10374,6732,1241,296800,85044
2528,2319,209,1905,393900,85045
13605,9522,4083,1441,370800,85048
12076,8665,3411,1658,337400,85050
15394,8049,7345,887,166400,85051
11289,6633,4656,1017,205200,85053
4109,1453,2656,1543,396500,85054
6467,5899,568,1773,365400,85083
8840,5611,3229,1282,375200,85085
15037,12013,3024,1700,349600,85086
3104,2783,321,1643,309000,85087
6405,5952,453,1094,283500,85118
10608,8254,2354,908,152600,85119
14141,11241,2900,822,93300,85120
500,144,356,484,85300,85121
19080,12374,6706,944,137900,85122
4537,3078,1459,934,113600,85123
4539,2865,1674,801,121200,85128
3535,2292,1243,737,98700,85131
8089,6144,1945,1039,160900,85132
174,129,45,625,33900,85135
948,691,257,969,100500,85137
11896,9471,2425,1404,204300,85138
5628,3996,1632,1211,181000,85139
14432,11833,2599,1364,221900,85140
128,101,27,843,51700,85141
21437,18405,3032,1493,310400,85142
12512,9517,2995,1335,209500,85143
1199,988,211,1148,161200,85145
1170,529,641,714,93800,85147
487,279,208,824,-,85172
1296,1012,284,802,87800,85173
816,755,61,619,73200,85192
1545,1166,379,866,82000,85193
3014,2631,383,1012,207000,85194
20030,6821,13209,938,173100,85201
15782,6989,8793,971,228300,85202
12676,6974,5702,977,245300,85203
21933,11946,9987,1041,190800,85204
17637,12005,5632,995,203000,85205
15645,10149,5496,1198,200500,85206
18179,14262,3917,1174,282300,85207
14586,10848,3738,1149,151700,85208
16265,12441,3824,1286,223900,85209
14726,6067,8659,943,191500,85210
11073,8999,2074,1466,320600,85212
12745,9713,3032,1089,272900,85213
7338,6023,1315,1373,258200,85215
17059,9651,7408,1285,252100,85224
25440,14927,10513,1165,235100,85225
14502,9036,5466,1326,303700,85226
12700,8670,4030,1390,302800,85233
15670,11093,4577,1329,307800,85234
16253,12816,3437,1415,325800,85248
13877,12426,1451,1806,378600,85249
8714,6146,2568,1248,339600,85250
20899,9749,11150,1215,332000,85251
7613,6326,1287,1671,1248000,85253
18576,13075,5501,1453,455500,85254
18601,14454,4147,1902,692200,85255
1642,1264,378,587,54200,85256
14867,8589,6278,1176,273000,85257
13137,9305,3832,1463,488500,85258
9657,7503,2154,1278,632000,85259
18143,11144,6999,1456,439000,85260
5524,5042,482,2299,750700,85262
1481,1415,66,-,499300,85263
429,368,61,545,318800,85264
5480,5267,213,2763,754000,85266
12039,9508,2531,1259,404500,85268
24844,5169,19675,1118,215100,85281
22834,10074,12760,1143,245700,85282
19809,9302,10507,1186,259300,85283
7306,5963,1343,1719,434400,85284
14535,9603,4932,1568,363300,85286
14789,9421,5368,1525,330300,85295
14132,11004,3128,1667,304400,85296
9845,7445,2400,1655,339500,85297
10237,9381,856,2111,382600,85298
22097,8096,14001,831,116500,85301
14194,7536,6658,956,187400,85302
9904,5938,3966,1073,182900,85303
9531,6681,2850,1153,216000,85304
4393,2531,1862,1280,257500,85305
8675,5276,3399,1160,217700,85306
3387,1570,1817,1141,193800,85307
24750,17721,7029,1239,272200,85308
0,0,0,-,-,85309
6665,5569,1096,1565,323000,85310
311,233,78,637,215500,85320
1580,1087,493,833,75600,85321
291,226,65,488,158100,85322
12799,6628,6171,1119,186200,85323
1379,1148,231,785,115800,85324
671,639,32,-,95000,85325
16213,11537,4676,1185,195200,85326
136,59,77,1086,206300,85328
12042,10761,1281,1749,459100,85331
777,681,96,1096,166300,85332
231,144,87,713,93300,85333
514,331,183,596,73200,85334
10538,6716,3822,1228,160800,85335
145,103,42,930,128700,85336
792,385,407,606,97600,85337
15646,11511,4135,1342,248000,85338
13332,9691,3641,1490,236500,85339
11060,8659,2401,1500,318700,85340
0,0,0,-,-,85341
828,669,159,629,156900,85342
65,44,21,-,138600,85343
3984,2651,1333,635,112900,85344
19842,12986,6856,1113,168800,85345
2385,1611,774,510,61900,85346
181,68,113,706,55000,85347
1326,1197,129,333,41300,85348
8254,5766,2488,671,117500,85349
5883,4020,1863,715,133400,85350
17289,14648,2641,1066,154300,85351
194,168,26,-,76700,85352
10701,7128,3573,1256,196900,85353
2293,1762,531,990,162500,85354
3621,3278,343,1561,314000,85355
2020,1540,480,671,86700,85356
239,167,72,391,94400,85357
64,20,44,-,116700,85360
2219,1878,341,1085,245100,85361
403,283,120,831,139100,85362
2491,1185,1306,957,155400,85363
26296,14488,11808,792,133000,85364
19008,13766,5242,1083,136900,85365
10916,8984,1932,1080,129600,85367
91,31,60,373,-,85371
8910,7596,1314,1446,209100,85373
21569,15620,5949,1203,217300,85374
16966,15068,1898,1272,230700,85375
1750,1413,337,1446,688900,85377
14183,10580,3603,1470,243800,85379
9082,6006,3076,1285,264800,85381
15440,10836,4604,1377,258900,85382
17285,15633,1652,1803,383200,85383
4722,4074,648,1281,300500,85387
8971,7046,1925,1441,249000,85388
4585,3536,1049,632,249600,85390
12842,7469,5373,1240,235500,85392
10070,8251,1819,1454,347500,85395
6854,5977,877,1492,285700,85396
5266,3590,1676,860,111900,85501
451,340,111,364,30300,85530
118,71,47,1054,191300,85531
1056,646,410,586,72800,85533
1007,865,142,661,92000,85534
0,0,0,-,-,85535
197,178,19,-,117900,85536
1762,1319,443,648,78800,85539
1057,0,1057,439,-,85540
9797,7766,2031,923,227700,85541
705,397,308,415,30400,85542
1126,905,221,975,127500,85543
1431,1267,164,861,258700,85544
315,271,44,-,111300,85545
6096,4226,1870,741,142500,85546
1237,718,519,381,34800,85550
131,123,8,-,113800,85551
2159,1514,645,871,186200,85552
925,736,189,425,126400,85553
297,228,69,665,197400,85554
413,331,82,-,99000,85601
4147,3217,930,806,121800,85602
3253,2309,944,692,133800,85603
246,141,105,539,62500,85605
500,414,86,583,109700,85606
5264,3641,1623,614,92900,85607
0,0,0,-,-,85608
162,162,0,-,187800,85609
451,373,78,565,118200,85610
436,407,29,-,283700,85611
853,9,844,1258,-,85613
13104,10768,2336,1011,174800,85614
3940,3413,527,1024,188800,85615
2408,1634,774,715,119700,85616
618,462,156,625,134800,85617
607,467,140,624,59300,85618
32,17,15,-,-,85619
245,147,98,763,69900,85620
7419,3966,3453,597,117000,85621
3602,3205,397,1138,239500,85622
2228,1904,324,841,262700,85623
536,366,170,719,240000,85624
1015,879,136,702,100800,85625
365,306,59,-,86600,85626
497,361,136,1044,133900,85627
8559,7189,1370,1410,194200,85629
937,738,199,493,163600,85630
1368,1032,336,870,73400,85631
381,307,74,588,158500,85632
9,0,9,413,-,85633
1648,956,692,518,63300,85634
14762,8153,6609,844,156100,85635
512,477,35,-,370700,85637
901,619,282,697,134700,85638
84,84,0,-,172800,85640
9141,8366,775,1444,239000,85641
3335,2234,1101,568,101600,85643
772,692,80,786,110500,85645
780,682,98,1846,344900,85646
6243,4902,1341,904,146400,85648
6504,5550,954,918,213100,85650
6124,5059,1065,1026,162600,85653
0,0,0,-,-,85654
4922,4145,777,1174,350800,85658
2724,654,2070,854,281900,85701
14904,8584,6320,1010,267500,85704
23587,10683,12904,712,80400,85705
17393,10279,7114,808,98600,85706
0,0,0,-,-,85707
1206,18,1188,1344,-,85708
25020,13217,11803,863,162500,85710
16837,8270,8567,785,157600,85711
15926,5924,10002,807,160900,85712
16624,10618,6006,817,93500,85713
5307,2795,2512,635,98100,85714
7993,5321,2672,1070,233900,85715
14978,6198,8780,765,195300,85716
12627,8556,4071,989,490700,85718
17340,4823,12517,871,213700,85719
0,0,0,-,-,85723
0,0,0,-,-,85724
0,0,0,-,-,85726
15391,10270,5121,945,143800,85730
4269,3812,457,876,132100,85735
1755,1555,200,1028,92500,85736
9586,7069,2517,1343,305400,85737
9066,8117,949,970,303800,85739
14469,8365,6104,1094,176400,85741
10599,8298,2301,1284,209100,85742
11574,9680,1894,1328,219100,85743
16073,9592,6481,921,224500,85745
14820,9915,4905,947,133400,85746
8859,6936,1923,1422,217700,85747
7803,5695,2108,1203,229800,85748
7727,6456,1271,1166,382400,85749
11392,8074,3318,1033,395300,85750
7226,6372,854,1498,326300,85755
11217,8447,2770,1062,123000,85756
6258,4679,1579,906,171300,85757
7091,4852,2239,917,176100,85901
412,262,150,495,59800,85911
135,135,0,-,75600,85912
246,218,28,815,200000,85920
12,12,0,-,-,85922
249,197,52,-,143400,85923
1202,1128,74,1569,105800,85924
1723,1395,328,715,172100,85925
100,53,47,440,65800,85926
66,46,20,-,-,85927
407,264,143,506,273100,85928
3162,2222,940,874,167000,85929
266,151,115,556,117000,85930
73,66,7,-,338100,85931
147,129,18,-,441400,85932
1324,973,351,746,202400,85933
156,133,23,-,193800,85934
1976,1617,359,704,238800,85935
1074,799,275,680,98800,85936
2449,1926,523,721,154900,85937
811,607,204,661,117800,85938
1550,1164,386,692,185100,85939
522,494,28,1125,185400,85940
2549,1541,1008,459,57500,85941
28,28,0,-,-,85942
17476,8765,8711,1293,370800,86001
15,10,5,-,-,86003
13298,8356,4942,1236,325000,86004
101,0,101,668,-,86011
121,59,62,-,-,86015
17,17,0,-,-,86016
521,493,28,-,225000,86017
425,338,87,1370,278400,86018
551,476,75,575,54900,86020
742,208,534,1221,184300,86021
704,500,204,628,135900,86022
759,139,620,445,33000,86023
378,369,9,1750,294700,86024
1733,941,792,725,103200,86025
0,0,0,-,-,86028
21,21,0,-,-,86029
388,337,51,-,108500,86030
530,371,159,646,65800,86031
534,393,141,691,136200,86032
2259,1298,961,608,48700,86033
583,377,206,508,73800,86034
561,426,135,517,67000,86035
161,119,42,-,119600,86036
24,24,0,-,-,86038
395,346,49,865,98300,86039
3205,2180,1025,1045,85900,86040
519,309,210,868,62700,86042
574,479,95,454,86300,86043
954,802,152,758,54200,86044
2998,1974,1024,629,50000,86045
2597,1846,751,975,192300,86046
4189,2485,1704,621,86500,86047
0,0,0,-,-,86052
602,511,91,569,52800,86053
510,361,149,536,58500,86054
10121,6780,3341,1044,287500,86301
8717,5852,2865,839,335500,86303
8418,6858,1560,937,399600,86305
0,0,0,-,-,86313
15767,9804,5963,974,216000,86314
3091,2715,376,1905,288400,86315
880,806,74,873,112200,86320
770,128,642,566,-,86321
4187,3168,1019,649,192600,86322
7035,5555,1480,888,232000,86323
2082,1479,603,938,227900,86324
2513,2094,419,1403,270800,86325
10642,6786,3856,955,206400,86326
4624,4039,585,1118,222000,86327
423,376,47,636,165000,86329
232,160,72,844,287000,86331
884,736,148,809,154600,86332
2695,2234,461,668,113500,86333
1903,1272,631,873,208300,86334
2081,1342,739,882,164400,86335
6319,4874,1445,1279,489300,86336
652,478,174,567,86800,86337
178,134,44,721,390900,86338
30,30,0,-,162500,86343
3160,2200,960,1175,478200,86351
10303,7349,2954,853,150800,86401
7649,4502,3147,847,205200,86403
7929,6020,1909,949,242100,86404
10540,8027,2513,961,266200,86406
11704,8309,3395,812,108800,86409
105,98,7,-,139300,86411
5252,4540,712,766,82900,86413
6201,4592,1609,909,164600,86426
3515,2074,1441,811,241000,86429
269,197,72,515,52500,86431
1553,1059,494,755,78300,86432
25,25,0,-,-,86433
471,243,228,442,62700,86434
0,0,0,-,-,86435
633,467,166,-,74900,86436
42,28,14,1083,-,86437
371,349,22,-,75900,86438
3077,2198,879,688,152600,86440
1190,920,270,770,77200,86441
14179,8028,6151,775,116000,86442
0,0,0,-,-,86443
704,649,55,-,102600,86444
147,147,0,-,99600,86445
357,334,23,555,40000,86502
3266,2387,879,485,32400,86503
1780,1140,640,557,40900,86504
2066,1721,345,471,40100,86505
395,365,30,525,41700,86506
578,547,31,850,45700,86507
199,195,4,-,37500,86508
1358,1125,233,485,110200,86510
1021,937,84,458,48800,86511
685,476,209,396,72600,86512
882,679,203,634,52300,86514
1290,781,509,422,51300,86515
440,387,53,608,56600,86520
351,343,8,-,43300,86535
657,468,189,391,45700,86538
268,236,32,463,67400,86540
327,279,48,575,45000,86544
407,352,55,555,43800,86545
272,256,16,-,47100,86547
513,314,199,327,47800,86556
874,616,258,540,210700,87001
8318,6310,2008,790,139800,87002
4254,3079,1175,797,158100,87004
145,68,77,-,"10,000-",87005
276,233,43,-,172800,87006
293,238,55,-,74200,87007
1100,1018,82,1723,279300,87008
521,442,79,1063,286200,87010
27,27,0,-,128100,87011
86,54,32,-,167100,87012
1569,1144,425,529,73700,87013
318,270,48,-,100600,87014
5139,4586,553,973,195900,87015
1125,917,208,643,153500,87016
89,85,4,-,178100,87017
159,97,62,-,24400,87018
3836,2339,1497,685,105100,87020
1148,671,477,708,88500,87021
294,288,6,-,46700,87022
180,180,0,-,126900,87023
511,407,104,570,123500,87024
619,579,40,-,310500,87025
1112,880,232,352,88000,87026
159,92,67,530,122100,87027
82,82,0,-,-,87028
137,134,3,-,-,87029
15127,12499,2628,952,137400,87031
90,46,44,-,-,87032
483,440,43,575,72000,87034
2651,2212,439,758,109900,87035
625,531,94,689,75200,87036
182,147,35,613,43200,87037
166,108,58,226,48500,87038
129,129,0,-,40300,87040
278,197,81,724,132600,87041
1261,1098,163,533,190000,87042
2305,2008,297,1168,366700,87043
97,97,0,-,255200,87044
508,468,40,538,28600,87045
70,61,9,-,203800,87046
1875,1662,213,1365,303500,87047
3900,3573,327,1094,442900,87048
386,360,26,689,70200,87049
367,367,0,-,78100,87051
565,402,163,575,165600,87052
411,281,130,856,109900,87053
422,378,44,691,289500,87056
4483,4137,346,1284,254700,87059
190,190,0,-,-,87061
330,287,43,722,60800,87062
73,38,35,633,56700,87063
49,49,0,-,239600,87064
1855,1684,171,900,197100,87068
25,0,25,-,-,87070
178,143,35,535,95000,87072
263,236,27,1278,152800,87083
9128,3181,5947,714,138000,87102
5822,3352,2470,838,236800,87104
20143,14772,5371,734,144900,87105
11410,4591,6819,747,255500,87106
12614,8143,4471,747,222900,87107
16639,5512,11127,683,164100,87108
17724,8769,8955,864,228100,87109
17238,10829,6409,849,195600,87110
24349,15292,9057,1042,271200,87111
18081,11192,6889,817,184800,87112
5799,4458,1341,1138,256800,87113
25592,17530,8062,1094,217900,87114
1264,25,1239,1351,-,87116
0,0,0,-,-,87117
24171,17883,6288,1132,202600,87120
24356,17603,6753,1035,134900,87121
7098,6261,837,1363,492100,87122
17220,10983,6237,784,183100,87123
20882,15858,5024,1086,181400,87124
14444,11599,2845,1298,197300,87144
7857,4523,3334,748,118700,87301
955,877,78,-,40100,87305
270,238,32,517,62000,87310
1106,887,219,724,31900,87311
172,133,39,-,20800,87312
1727,998,729,602,61500,87313
77,46,31,-,83600,87315
298,197,101,571,34300,87316
519,436,83,-,-,87317
569,542,27,-,38700,87319
169,150,19,425,34200,87320
860,695,165,444,89300,87321
72,72,0,-,183800,87322
1324,996,328,699,54700,87323
867,760,107,586,52300,87325
499,458,41,-,44400,87326
1898,1547,351,563,72800,87327
717,342,375,449,52500,87328
96,60,36,-,152300,87347
219,109,110,500,26900,87357
315,289,26,375,47000,87364
823,757,66,440,48100,87375
15892,9954,5938,848,169700,87401
3868,3130,738,1099,217300,87402
6468,4762,1706,841,157900,87410
326,283,43,-,106000,87412
5761,4375,1386,779,151200,87413
713,611,102,-,176300,87415
1505,1192,313,981,85300,87416
2010,1344,666,792,133200,87417
374,307,67,655,166700,87418
173,127,46,-,-,87419
3309,2169,1140,520,81300,87420
546,434,112,939,122700,87421
547,443,104,569,41900,87455
423,393,30,617,50200,87461
158,124,34,-,101500,87499
7689,4930,2759,1241,455200,87501
14003,8524,5479,1048,331300,87505
5966,4825,1141,961,420800,87506
18082,12166,5916,1002,228900,87507
7890,6914,976,1314,368900,87508
393,230,163,-,149300,87510
697,465,232,-,127600,87511
31,31,0,-,-,87512
332,226,106,1043,285400,87513
276,276,0,-,333900,87514
113,113,0,-,334100,87515
45,45,0,-,168800,87516
232,177,55,-,251300,87517
0,0,0,-,-,87518
193,97,96,832,148400,87519
549,491,58,741,226100,87520
332,277,55,550,150700,87521
1103,934,169,-,169500,87522
199,162,37,-,318200,87523
35,35,0,-,-,87524
24,21,3,-,611800,87525
230,218,12,-,137500,87527
775,555,220,487,101200,87528
1534,1211,323,979,245600,87529
184,184,0,-,143800,87530
196,172,24,-,169400,87531
6475,4370,2105,699,174500,87532
53,38,15,569,17100,87533
629,512,117,-,184000,87535
925,697,228,628,164900,87537
275,208,67,-,168000,87538
25,25,0,-,-,87539
384,338,46,-,477700,87540
55,55,0,-,-,87543
7931,5878,2053,1062,302800,87544
499,384,115,-,118300,87548
338,295,43,-,163500,87549
161,161,0,-,297600,87551
1478,1162,316,643,151400,87552
461,337,124,557,135500,87553
0,0,0,-,-,87554
973,837,136,629,154800,87556
2171,1785,386,917,310000,87557
187,119,68,792,259700,87558
606,388,218,768,69500,87560
162,137,25,-,60900,87562
99,99,0,-,411600,87564
179,152,27,-,"10,000-",87565
816,736,80,619,363600,87566
418,237,181,493,-,87567
243,216,27,-,162100,87569
4578,3143,1435,696,248500,87571
32,32,0,-,-,87573
44,38,6,-,-,87574
301,176,125,-,336500,87575
149,149,0,-,-,87577
112,79,33,1073,160300,87578
254,214,40,838,119800,87579
225,198,27,-,225300,87580
19,19,0,-,-,87581
326,247,79,-,-,87582
98,81,17,-,-,87583
7644,5031,2613,644,128700,87701
716,590,126,636,267200,87710
266,198,68,-,77400,87711
100,68,32,-,-,87712
158,144,14,-,-,87713
523,299,224,629,94400,87714
208,155,53,-,163700,87715
197,146,51,900,233300,87718
279,279,0,-,110300,87722
105,86,19,-,-,87723
27,0,27,-,-,87724
158,107,51,428,75000,87728
32,32,0,-,-,87729
10,6,4,-,-,87730
117,103,14,-,317300,87731
443,394,49,802,81000,87732
46,37,9,-,107300,87733
110,95,15,-,343100,87734
77,65,12,-,-,87735
34,34,0,-,-,87736
3528,2469,1059,723,87700,87740
268,245,23,-,219400,87742
126,72,54,547,73300,87743
309,275,34,-,200900,87745
46,10,36,-,-,87746
626,470,156,444,105900,87747
57,28,29,-,-,87749
0,0,0,-,-,87750
147,112,35,513,48600,87752
35,16,19,-,-,87753
2812,1825,987,641,135600,87801
33,33,0,-,110800,87820
226,222,4,-,232000,87821
295,243,52,-,217300,87823
32,32,0,-,-,87824
588,521,67,-,59200,87825
78,70,8,-,-,87827
89,82,7,-,-,87828
312,271,41,-,167600,87829
403,303,100,641,171000,87830
53,48,5,-,-,87831
91,91,0,-,52500,87832
3120,2031,1089,496,87100,87901
306,230,76,573,114900,87930
465,388,77,736,139500,87931
38,38,0,-,-,87933
825,728,97,928,132800,87935
143,126,17,-,102500,87936
1068,840,228,-,85600,87937
49,49,0,-,345800,87939
203,165,38,-,-,87940
342,218,124,-,31400,87941
445,380,65,798,140800,87942
96,96,0,-,-,87943
13747,5776,7971,702,112400,88001
292,24,268,1069,-,88002
0,0,0,-,-,88003
0,0,0,-,-,88004
10480,6508,3972,713,158800,88005
8624,6295,2329,687,167700,88007
2980,2023,957,856,190400,88008
2,0,2,-,-,88009
12769,7165,5604,993,264000,88011
10233,7873,2360,991,146300,88012
254,208,46,557,86000,88020
5975,3981,1994,582,106100,88021
345,275,70,755,114300,88022
951,664,287,636,87500,88023
39,22,17,-,-,88024
86,86,0,-,-,88025
556,398,158,645,81000,88026
128,109,19,-,189900,88027
105,76,29,-,212200,88028
469,321,148,337,70500,88029
8435,5101,3334,572,89600,88030
135,85,50,-,58900,88032
0,0,0,-,-,88033
17,17,0,-,-,88034
109,78,31,-,235700,88038
231,221,10,-,138500,88039
56,41,15,-,65800,88040
569,457,112,535,117000,88041
161,142,19,-,279700,88042
566,461,105,828,80200,88043
1190,970,220,711,111500,88044
1302,870,432,501,83900,88045
432,223,209,727,198900,88046
756,592,164,872,-,88047
849,754,95,-,95000,88048
188,131,57,-,205200,88049
54,54,0,-,153900,88051
94,50,44,-,-,88052
123,22,101,601,335300,88053
28,28,0,-,-,88055
111,98,13,-,122100,88056
7851,5111,2740,679,155000,88061
4401,3032,1369,533,97800,88063
257,178,79,930,135400,88065
596,385,211,442,100700,88072
4331,3366,965,643,78000,88081
17420,9708,7712,848,126900,88101
0,0,0,-,-,88103
81,55,26,-,143800,88112
37,11,26,-,104200,88113
16,16,0,-,272200,88114
39,35,4,-,-,88115
196,159,37,-,116500,88116
123,74,49,398,171900,88118
636,407,229,676,98500,88119
101,79,22,-,106700,88120
52,42,10,469,95000,88121
494,431,63,629,123200,88124
19,9,10,-,-,88125
12,12,0,-,55700,88126
6271,3608,2663,781,117500,88130
93,64,29,-,125000,88132
14,0,14,-,-,88134
496,330,166,761,103200,88135
22,14,8,-,-,88136
10026,7217,2809,805,154100,88201
10641,6962,3679,757,91700,88203
6717,4327,2390,861,179700,88210
13617,9793,3824,990,150400,88220
1636,1146,490,762,88900,88230
1148,924,224,1065,98700,88231
635,514,121,623,80700,88232
12909,7827,5082,895,136900,88240
2561,2027,534,1045,199600,88242
99,32,67,-,-,88250
764,555,209,677,68600,88252
320,229,91,868,101100,88253
45,32,13,-,-,88254
12,12,0,-,-,88255
663,452,211,900,116400,88256
4613,3321,1292,841,122000,88260
4,4,0,-,-,88262
53,42,11,-,82900,88263
17,0,17,-,-,88264
72,63,9,-,130700,88265
419,308,111,639,81400,88267
38,38,0,-,-,88268
428,370,58,575,85000,88301
14765,8934,5831,789,120100,88310
457,367,90,582,67200,88311
1289,1217,72,-,297300,88312
17,17,0,-,-,88314
870,696,174,827,165200,88316
676,618,58,-,166700,88317
168,144,24,-,212500,88318
73,48,25,-,-,88321
0,0,0,-,-,88323
78,72,6,-,171300,88324
382,298,84,763,216800,88325
1096,12,1084,1128,-,88330
97,72,25,-,110300,88336
762,666,96,569,117600,88337
35,35,0,-,-,88338
253,232,21,-,150000,88339
1113,643,470,247,66800,88340
318,316,2,-,248400,88341
24,18,6,-,-,88342
4,4,0,-,-,88343
12,12,0,-,-,88344
3262,2594,668,810,185700,88345
836,457,379,514,142400,88346
30,16,14,-,-,88347
125,83,42,-,269400,88348
12,12,0,-,-,88349
197,197,0,-,116600,88350
80,60,20,-,280800,88351
1906,1685,221,581,110500,88352
144,92,52,375,46700,88353
16,16,0,-,-,88354
0,0,0,-,-,88355
2349,1330,1019,562,67100,88401
49,40,9,-,-,88410
24,14,10,-,216700,88411
7,6,1,-,-,88414
1122,731,391,556,81800,88415
33,33,0,-,-,88416
0,0,0,-,-,88417
83,49,34,-,-,88418
40,30,10,-,218200,88419
0,0,0,-,-,88421
52,30,22,-,166700,88422
14,10,4,-,132100,88424
326,270,56,697,85600,88426
66,48,18,-,87100,88427
56,40,16,-,-,88430
9,9,0,-,-,88431
158,118,40,496,84300,88434
1048,668,380,398,85200,88435
49,31,18,-,-,88436
544,426,118,630,121400,89001
12139,9185,2954,1350,291100,89002
471,208,263,622,85000,89003
129,103,26,987,383800,89004
6615,4516,2099,1002,287000,89005
337,259,78,567,228000,89007
476,301,175,596,131500,89008
210,130,80,500,108000,89010
10452,6575,3877,1198,277000,89011
14442,9381,5061,1419,329500,89012
153,113,40,518,65000,89013
16134,7670,8464,1167,271600,89014
14776,8822,5954,1040,237800,89015
39,39,0,-,-,89017
321,256,65,815,97100,89018
850,568,282,566,159500,89019
412,218,194,704,125000,89020
971,763,208,1040,255100,89021
0,0,0,-,-,89022
367,268,99,665,152100,89025
0,0,0,-,-,89026
8042,5852,2190,879,236700,89027
4203,1896,2307,751,161200,89029
14173,5082,9091,878,134300,89030
20696,14637,6059,1405,233100,89031
13957,8029,5928,1211,212300,89032
106,87,19,681,78600,89039
1440,1071,369,768,158700,89040
443,332,111,-,141500,89042
516,412,104,571,169100,89043
9345,8029,1316,1736,362000,89044
869,670,199,889,69600,89045
219,129,90,381,-,89046
87,43,44,558,36800,89047
8961,6153,2808,884,173600,89048
1240,478,762,665,107600,89049
21981,14599,7382,1465,410500,89052
30,30,0,-,170800,89054
4215,3322,893,852,132600,89060
2666,2243,423,1111,222000,89061
20167,12107,8060,1334,297500,89074
11092,6638,4454,1385,244000,89081
9362,6082,3280,1369,308700,89084
1249,1019,230,1873,328800,89085
1927,768,1159,1269,279900,89086
15138,2725,12413,737,142700,89101
14952,3593,11359,890,203900,89102
21888,6906,14982,977,164400,89103
14225,6417,7808,847,163900,89104
8864,2823,6041,909,154200,89106
12689,6251,6438,991,170900,89107
27040,12137,14903,1033,182000,89108
4104,1270,2834,976,345300,89109
21181,11408,9773,999,185300,89110
11908,6623,5285,1275,304300,89113
18423,5975,12448,952,153300,89115
22889,10936,11953,1200,327400,89117
8216,3352,4864,1149,259400,89118
21815,3723,18092,883,187800,89119
9359,4926,4433,1066,231900,89120
23697,11192,12505,955,173400,89121
17988,10083,7905,1082,172800,89122
23722,12888,10834,1273,284900,89123
514,467,47,875,491200,89124
14809,7437,7372,1184,251100,89128
20337,13291,7046,1323,280100,89129
12489,8716,3773,1346,274100,89130
16792,12822,3970,1476,343500,89131
11507,9192,2315,1672,314300,89134
11880,8164,3716,1800,429500,89135
6095,4295,1800,1851,512500,89138
12946,7768,5178,1512,302400,89139
11603,8002,3601,1615,344000,89141
10908,6187,4721,1116,186900,89142
4213,3287,926,1560,288400,89143
7552,4835,2717,1494,355200,89144
9947,6034,3913,1186,238100,89145
6919,3190,3729,1032,284300,89146
20559,10149,10410,1261,246800,89147
18714,9015,9699,1444,309900,89148
14825,9511,5314,1365,316600,89149
9527,5389,4138,961,167000,89156
93,93,0,-,360200,89161
7860,5452,2408,1372,302700,89166
9478,1833,7645,868,173700,89169
13566,9715,3851,1500,301900,89178
2364,2030,334,1643,311000,89179
14463,6782,7681,1325,258100,89183
0,0,0,-,-,89191
2798,2051,747,708,163700,89301
168,125,43,-,160500,89310
55,49,6,-,186500,89311
171,94,77,388,32000,89314
464,313,151,-,152300,89316
111,111,0,-,196200,89317
465,363,102,675,84500,89318
80,80,0,-,-,89319
8,8,0,-,-,89402
6053,4350,1703,987,246900,89403
0,0,0,-,-,89404
44,0,44,-,-,89405
9912,6475,3437,821,192000,89406
7570,5083,2487,1162,220100,89408
66,66,0,-,28200,89409
4838,3105,1733,985,366000,89410
285,244,41,732,803800,89411
44,44,0,-,192700,89412
351,290,61,2708,1396300,89413
77,68,9,-,85500,89414
1512,1061,451,662,119300,89415
102,98,4,-,47400,89418
1593,956,637,675,108600,89419
7,0,7,-,-,89420
230,207,23,-,67000,89421
125,119,6,-,38500,89422
4614,3885,729,1386,425500,89423
104,87,17,-,82100,89424
96,58,38,-,-,89425
72,38,34,-,-,89426
386,262,124,315,44400,89427
88,63,25,-,312500,89428
2943,2281,662,1008,150100,89429
116,110,6,-,346100,89430
14937,6443,8494,899,222200,89431
6806,4674,2132,1010,169600,89433
10666,6738,3928,1233,277800,89434
16390,12552,3838,1633,353500,89436
43,43,0,-,-,89438
632,506,126,1276,379300,89439
315,233,82,-,320700,89440
4551,3766,785,1637,411100,89441
429,307,122,686,112300,89442
1315,1113,202,923,233300,89444
6252,4479,1773,842,186700,89445
0,0,0,-,-,89446
3430,2315,1115,736,146400,89447
828,654,174,1580,720800,89448
1430,793,637,1127,526700,89449
24,10,14,-,-,89450
3857,2784,1073,1556,884700,89451
5460,3641,1819,1020,342000,89460
2418,638,1780,733,352100,89501
18948,6415,12533,890,244900,89502
11910,5437,6473,915,293400,89503
14684,9784,4900,1166,255800,89506
4716,4128,588,1431,276300,89508
16937,8815,8122,1012,423900,89509
608,534,74,534,377500,89510
11141,8184,2957,1329,624300,89511
10570,3246,7324,861,199000,89512
3724,3005,719,1469,578100,89519
12661,9146,3515,1648,396100,89521
14702,8519,6183,1294,384200,89523
10338,5772,4566,897,269300,89701
0,0,0,-,-,89702
4599,3160,1439,853,385900,89703
1824,1605,219,1038,365400,89704
2182,1596,586,1174,286700,89705
8477,4439,4038,1014,205200,89706
9365,6194,3171,1016,219900,89801
4755,4239,516,1288,233500,89815
2075,1522,553,846,181500,89820
244,199,45,1012,66100,89821
757,560,197,995,150500,89822
69,69,0,-,528800,89823
456,152,304,512,-,89825
0,0,0,-,-,89826
181,181,0,-,306700,89828
103,48,55,-,-,89830
11,11,0,-,-,89831
488,294,194,431,53300,89832
52,14,38,-,-,89833
41,19,22,-,-,89834
644,411,233,752,175500,89835
1265,770,495,733,157800,89883
13669,4904,8765,1150,359000,90001
12917,4517,8400,1187,345900,90002
17484,4948,12536,1212,362800,90003
22004,3651,18353,1307,1063200,90004
16781,1299,15482,1235,777100,90005
19337,1748,17589,1116,608600,90006
11919,1465,10454,1182,622600,90007
14858,4906,9952,1203,701800,90008
2029,357,1672,1931,866000,90010
24433,6343,18090,1178,377600,90011
13216,1195,12021,1688,533200,90012
7308,573,6735,741,657400,90013
5644,145,5499,1710,544500,90014
10270,1201,9069,1375,705000,90015
17218,6353,10865,1238,566600,90016
11510,480,11030,1117,651500,90017
16568,5061,11507,1189,586500,90018
24464,6836,17628,1407,932700,90019
16396,1529,14867,1376,633700,90020
1734,156,1578,647,888900,90021
17603,5764,11839,1107,416900,90022
11691,3219,8472,1139,427300,90023
16515,4982,11533,2265,1184100,90024
22015,5882,16133,2062,867400,90025
26045,6170,19875,1355,838400,90026
21668,4156,17512,1468,1146900,90027
16403,777,15626,1419,792800,90028
13997,1418,12579,1200,719900,90029
11739,3715,8024,1161,550000,90031
13493,6770,6723,1205,504700,90032
13303,2493,10810,1091,434200,90033
25248,4681,20567,1727,983300,90034
11816,3875,7941,1921,1094900,90035
18559,3207,15352,2265,1504000,90036
17699,4264,13435,1106,407200,90037
12229,1115,11114,1330,821600,90038
11685,5318,6367,1727,854200,90039
3461,1613,1848,1163,406900,90040
9661,4899,4762,1460,735100,90041
21017,9444,11573,1342,627200,90042
17376,9613,7763,1137,556400,90043
29029,8533,20496,1137,391100,90044
15622,8059,7563,2132,959400,90045
29025,6554,22471,1699,1183200,90046
17893,10120,7773,1241,433700,90047
11636,3517,8119,2144,1229900,90048
16720,8533,8187,2238,"2,000,000+",90049
3412,2288,1124,1826,991300,90056
17298,648,16650,1079,457000,90057
706,85,621,635,328400,90058
10906,5137,5769,986,348100,90059
7396,3097,4299,1179,361500,90061
10063,4619,5444,1255,444000,90062
13686,5448,8238,1175,406600,90063
11083,6121,4962,1955,1178000,90064
15414,7484,7930,1318,706900,90065
25785,9378,16407,1783,1121400,90066
1421,1131,290,3045,1146700,90067
11316,5605,5711,1770,1228400,90068
12488,4520,7968,1832,846700,90069
119,7,112,1671,-,90071
0,0,0,-,-,90073
3173,2731,442,2566,"2,000,000+",90077
0,0,0,-,-,90079
9,0,9,-,-,90089
0,0,0,-,-,90090
4361,1708,2653,3042,1030600,90094
0,0,0,-,-,90095
24464,5523,18941,1245,406800,90201
7936,5856,2080,2488,"2,000,000+",90210
3661,1106,2555,1922,1722200,90211
5887,1604,4283,2323,"2,000,000+",90212
13206,7860,5346,1233,330800,90220
12144,6189,5955,1196,364100,90221
7979,3896,4083,1208,352800,90222
13327,7228,6099,1789,769700,90230
6598,2393,4205,1778,1125200,90232
7544,4817,2727,1547,612400,90240
13176,5647,7529,1402,582300,90241
12325,6017,6308,1509,513900,90242
6417,2792,3625,1928,1094300,90245
16001,6164,9837,1290,455900,90247
3777,2544,1233,1275,490700,90248
8826,5050,3776,1248,487900,90249
31905,9919,21986,1271,567900,90250
8956,4245,4711,2181,1542900,90254
18577,6162,12415,1095,411700,90255
10532,4249,6283,1493,541000,90260
15374,7059,8315,1212,399100,90262
0,0,0,-,-,90263
7391,5765,1626,2396,"2,000,000+",90265
13427,9344,4083,2628,"2,000,000+",90266
6684,1747,4937,1104,387000,90270
8724,6904,1820,2537,"2,000,000+",90272
9153,7986,1167,2619,1655300,90274
15544,12139,3405,2645,1155900,90275
15844,7329,8515,2061,1089500,90277
15312,8971,6341,2049,881900,90278
24071,10315,13756,1160,408200,90280
2275,1643,632,2853,1036300,90290
13692,4690,9002,2100,1650000,90291
12606,3908,8698,2968,978900,90292
6604,3217,3387,2281,800400,90293
12046,3060,8986,1300,437400,90301
10636,3069,7567,1376,484800,90302
7048,2864,4184,1364,468900,90303
6583,2025,4558,1180,472600,90304
5814,3735,2079,1576,537800,90305
4603,313,4290,1796,1079500,90401
4999,3425,1574,1817,"2,000,000+",90402
12739,3024,9715,1959,1246500,90403
9957,2271,7686,1702,834400,90404
13943,4773,9170,1748,1460400,90405
14242,6492,7750,1448,645400,90501
5975,4085,1890,1418,459900,90502
16647,8468,8179,1815,798800,90503
11685,7271,4414,1563,633500,90504
13992,7913,6079,1781,863300,90505
0,0,0,-,-,90506
10981,6486,4495,1372,550700,90601
7643,3031,4612,1278,548800,90602
6661,5356,1305,1891,607200,90603
12432,8130,4302,1501,527200,90604
10382,7180,3202,1507,474900,90605
8996,6077,2919,1497,444800,90606
13142,9440,3702,1820,576700,90620
10366,4154,6212,1580,591500,90621
4845,3289,1556,1771,660200,90623
15804,10615,5189,1891,632300,90630
21229,12950,8279,1576,577600,90631
14350,11085,3265,1687,570200,90638
18898,8170,10728,1334,492200,90640
26964,17154,9810,1592,440800,90650
16852,11499,5353,1403,440600,90660
4862,3295,1567,1413,448900,90670
9037,4544,4493,1643,400200,90680
4468,2163,2305,1662,543200,90701
15515,11947,3568,2385,683300,90703
1553,423,1130,1555,634200,90704
23240,9126,14114,1368,458600,90706
9230,4885,4345,1203,500600,90710
10338,7696,2642,1991,572000,90712
9111,7417,1694,1998,593600,90713
6018,3447,2571,1699,477300,90715
3670,1518,2152,1403,366400,90716
8477,3965,4512,1377,603200,90717
7843,5045,2798,1912,894600,90720
14207,5823,8384,1388,343800,90723
22695,7307,15388,1330,590700,90731
8810,6223,2587,2034,615000,90732
12550,9450,3100,1930,370100,90740
379,110,269,1992,1117600,90742
110,71,39,-,1173600,90743
14788,5397,9391,1146,397700,90744
14936,10159,4777,1485,445100,90745
8205,6879,1326,1759,506600,90746
0,0,0,-,-,90747
4743,2479,2264,1449,507500,90755
20756,4202,16554,1307,404100,90802
16718,7266,9452,1703,897800,90803
14955,3193,11762,1360,517600,90804
27354,11201,16153,1212,405300,90805
12788,4503,8285,1189,466000,90806
12741,6658,6083,1411,608400,90807
13916,10915,3001,1832,650400,90808
9400,5131,4269,1175,414300,90810
17192,2099,15093,1147,393000,90813
9165,3271,5894,1455,704800,90814
14556,9818,4738,1865,645100,90815
0,0,0,-,-,90822
0,0,0,-,-,90831
12669,9600,3069,1728,748100,91001
10575,7420,3155,1749,995400,91006
11657,6173,5484,1624,1046500,91007
426,261,165,2516,1399200,91008
8060,5054,3006,1547,471500,91010
6434,5846,588,2858,1517500,91011
14318,7081,7237,1577,642400,91016
3524,1252,2272,1708,615900,91020
4664,2878,1786,1615,969700,91024
9815,4659,5156,1802,1071000,91030
7339,5275,2064,1411,579200,91040
9961,5365,4596,1495,556800,91042
95,0,95,1292,-,91046
10739,1739,9000,1773,545200,91101
8515,3980,4535,1488,716700,91103
13164,6556,6608,1510,744000,91104
5505,3137,2368,2466,1159700,91105
10665,3805,6860,1717,737600,91106
12466,7464,5002,1744,843700,91107
4582,3946,636,3218,"2,000,000+",91108
8309,2274,6035,1593,795200,91201
8903,3403,5500,1754,767500,91202
6110,1002,5108,1678,514900,91203
6485,633,5852,1456,500500,91204
14382,2158,12224,1480,585100,91205
13372,4810,8562,1645,781300,91206
4081,2311,1770,1711,1021600,91207
5855,3863,1992,1975,915100,91208
228,41,187,3458,475900,91210
10357,7616,2741,1945,777300,91214
9295,7340,1955,2536,834300,91301
9488,6928,2560,2498,1275100,91302
10097,2343,7754,1541,465100,91303
17508,8768,8740,1521,614500,91304
14654,8164,6490,1426,520200,91306
8650,7249,1401,2787,660900,91307
14283,9222,5061,1868,616400,91311
12409,6220,6189,1746,685300,91316
14971,11449,3522,2267,695200,91320
10781,6074,4707,1642,483700,91321
10012,5098,4914,1744,624400,91324
11920,5673,6247,1569,667300,91325
12778,9571,3207,1895,764300,91326
0,0,0,-,-,91330
23447,14369,9078,1436,425300,91331
24391,11622,12769,1459,496700,91335
8886,4959,3927,1381,431100,91340
25121,16367,8754,1607,462700,91342
18035,9127,8908,1389,534500,91343
17037,12755,4282,1817,616100,91344
5402,3929,1473,1636,476800,91345
11402,9590,1812,1933,543200,91350
10076,7325,2751,1711,427400,91351
12436,6647,5789,1399,488600,91352
10444,8204,2240,2352,601700,91354
11709,6985,4724,2040,563400,91355
11802,6708,5094,1624,957400,91356
14955,9959,4996,1934,673600,91360
8556,6153,2403,2317,952900,91361
13519,9816,3703,2119,814000,91362
10648,7114,3534,2440,849100,91364
18433,9780,8653,2196,697600,91367
0,0,0,-,-,91371
5303,3665,1638,2489,760200,91377
6554,4566,1988,2041,730100,91381
7091,5932,1159,1727,531000,91384
12815,8230,4585,1943,536200,91387
6000,5498,502,2242,593600,91390
14933,5053,9880,1403,703100,91401
19839,6643,13196,1311,421800,91402
11400,5120,6280,1908,1027200,91403
18246,4944,13302,1290,488300,91405
18398,7165,11233,1448,545300,91406
9493,2383,7110,1454,652900,91411
15085,5844,9241,1857,938500,91423
5600,4376,1224,2592,1351500,91436
8057,2577,5480,1684,770500,91501
5071,464,4607,1478,570800,91502
9387,5080,4307,1728,754000,91504
12902,6063,6839,1858,699300,91505
7522,4027,3495,1607,721400,91506
16710,2994,13716,1538,656100,91601
9813,3246,6567,1755,734400,91602
14641,6910,7731,1970,1140800,91604
16271,6007,10264,1363,498500,91605
15401,4881,10520,1308,560800,91606
13607,4031,9576,1611,822300,91607
10,0,10,-,-,91608
13060,10268,2792,1801,522800,91701
15502,8945,6557,1485,419000,91702
18328,10408,7920,1467,409400,91706
727,368,359,2079,568900,91708
25289,18945,6344,2136,622300,91709
22758,14485,8273,1576,458700,91710
11997,7789,4208,1571,675600,91711
9841,6842,2999,1598,445000,91722
6233,2477,3756,1420,496100,91723
8094,5728,2366,1726,557100,91724
24015,10705,13310,1737,407000,91730
8263,2986,5277,1201,450300,91731
16066,6818,9248,1318,465200,91732
11026,4914,6112,1332,435700,91733
7974,5654,2320,1938,619900,91737
11663,8313,3350,1828,612000,91739
8308,5492,2816,1655,501100,91740
8896,6429,2467,1807,694100,91741
18969,12593,6376,1464,420300,91744
16324,12281,4043,1883,595700,91745
6670,4959,1711,1396,443700,91746
13558,8424,5134,1606,628000,91748
12110,9056,3054,1528,595700,91750
8794,5604,3190,1480,455000,91752
11290,6135,5155,1345,619800,91754
8665,4266,4399,1444,610800,91755
157,101,56,1469,458000,91759
17335,11229,6106,1613,394000,91761
17636,9059,8577,1295,380600,91762
10233,5506,4727,1408,356500,91763
16482,7247,9235,1567,353600,91764
15119,11451,3668,2021,668600,91765
17987,9287,8700,1406,399600,91766
14065,7516,6549,1367,392100,91767
8045,4285,3760,1252,385900,91768
16648,8422,8226,1374,550700,91770
11387,8030,3357,1800,574300,91773
8113,5205,2908,1611,810400,91775
11713,4401,7312,1452,621300,91776
11355,6661,4694,1631,706300,91780
9023,7736,1287,2303,636700,91784
19107,8057,11050,1411,437900,91786
13348,11090,2258,2272,734900,91789
12254,7978,4276,1665,514800,91790
10080,6666,3414,1557,606100,91791
8585,4789,3796,1751,492800,91792
20065,7069,12996,1453,611900,91801
9644,4767,4877,1390,613800,91803
6320,4529,1791,1622,599800,91901
6008,4473,1535,1900,662900,91902
585,325,260,722,281600,91905
1311,886,425,1144,275400,91906
24942,12283,12659,1439,476700,91910
24684,12666,12018,1482,427200,91911
15188,10691,4497,2301,524200,91913
4621,3770,851,2518,665800,91914
8731,6301,2430,2447,555700,91915
666,614,52,-,395300,91916
210,202,8,-,397700,91917
167,125,42,-,-,91931
9547,2940,6607,1459,563600,91932
209,209,0,-,139000,91934
2948,2610,338,1860,624900,91935
11574,7214,4360,1519,624900,91941
16305,6406,9899,1571,495000,91942
8603,4500,4103,1349,432000,91945
37,37,0,-,-,91948
16963,6145,10818,1154,400300,91950
697,565,132,1675,444500,91962
260,223,37,-,279900,91963
19154,11220,7934,1463,441700,91977
3369,2083,1286,1767,438200,91978
0,0,0,-,-,91980
1815,1225,590,1841,637400,92003
1136,976,160,729,170900,92004
4619,2679,1940,1995,1076000,92007
11307,5190,6117,1873,808000,92008
16564,12327,4237,2166,870400,92009
6235,4346,1889,2165,678800,92010
9425,6282,3143,2276,818200,92011
5751,3807,1944,2336,1509800,92014
14512,9730,4782,1670,520100,92019
19256,7749,11507,1344,526600,92020
22518,11462,11056,1390,418400,92021
19821,12796,7025,1975,931400,92024
15957,6827,9130,1386,499400,92025
16948,9764,7184,1523,482500,92026
16589,10164,6425,1416,440100,92027
16297,11109,5188,1285,564800,92028
7006,5333,1673,1879,639400,92029
1203,929,274,1146,348000,92036
16666,10020,6646,2031,1562100,92037
15245,9990,5255,1434,460900,92040
15381,6345,9036,1508,598000,92054
292,0,292,2902,-,92055
18995,12000,6995,1900,507500,92056
19560,13144,6416,1929,460600,92057
14037,3996,10041,2048,420800,92058
505,346,159,1297,306100,92059
89,29,60,-,272500,92060
772,551,221,1193,482400,92061
15983,11878,4105,1625,687000,92064
11883,8996,2887,1616,515000,92065
220,140,80,1154,345800,92066
2683,2343,340,2975,"2,000,000+",92067
14956,8551,6405,1569,513700,92069
328,246,82,525,391500,92070
19168,13780,5388,1751,445400,92071
5299,3145,2154,2219,1202900,92075
17532,12181,5351,1897,572100,92078
10280,5525,4755,1875,550300,92081
5992,4790,1202,1199,591600,92082
11274,5155,6119,1564,421900,92083
14877,8379,6498,1501,548400,92084
658,568,90,1052,196700,92086
638,564,74,2400,911900,92091
24355,6179,18176,1700,610300,92101
14757,4318,10439,1303,429000,92102
18273,6217,12056,1543,774700,92103
21077,5671,15406,1437,608100,92104
21958,6391,15567,1175,398400,92105
7711,4386,3325,1895,1032700,92106
13743,5391,8352,1662,859700,92107
11072,2587,8485,2145,384800,92108
21973,6502,15471,1743,888800,92109
11388,4688,6700,1702,592200,92110
17120,8595,8525,1636,543600,92111
13581,3528,10053,1183,353900,92113
18081,12090,5991,1399,415100,92114
21203,7271,13932,1388,499100,92115
16317,5433,10884,1438,639800,92116
21046,12301,8745,1743,612000,92117
8435,4459,3976,2479,1617000,92118
9538,6941,2597,1782,579300,92119
11755,7857,3898,1886,615100,92120
1858,1059,799,2036,774200,92121
19957,6282,13675,2121,732600,92122
12438,6038,6400,2133,568100,92123
11148,5200,5948,2402,632900,92124
25218,13462,11756,2083,547100,92126
15809,10623,5186,2053,819900,92127
20810,13064,7746,2145,623100,92128
18043,12363,5680,2046,722200,92129
19908,13145,6763,2492,1064700,92130
11980,9372,2608,2391,790200,92131
0,0,0,-,-,92132
0,0,0,-,-,92134
0,0,0,-,-,92135
10350,6028,4322,1620,411100,92139
0,0,0,-,-,92140
563,428,135,1297,1376000,92145
0,0,0,-,-,92147
22449,13414,9035,1611,411200,92154
0,0,0,-,-,92155
7947,2449,5498,1165,364100,92173
23607,15411,8196,1027,246300,92201
11902,9058,2844,1551,349000,92203
2657,2204,453,788,712400,92210
12717,9489,3228,1472,370700,92211
11919,7903,4016,1029,239600,92220
0,0,0,-,-,92222
16868,13093,3775,1220,317000,92223
5950,3365,2585,764,149400,92225
7228,3873,3355,829,191900,92227
832,462,370,877,197800,92230
9033,5071,3962,904,208000,92231
927,478,449,718,152000,92233
18816,11429,7387,1193,279500,92234
15601,11172,4429,880,220600,92236
94,85,9,-,113400,92239
12734,6232,6502,988,197600,92240
3573,2817,756,842,79300,92241
610,491,119,620,77700,92242
13001,6949,6052,808,192400,92243
1936,1160,776,798,216800,92249
2349,1363,986,608,215600,92250
5352,4016,1336,1272,243300,92251
3932,2212,1720,897,146800,92252
15815,11771,4044,1478,398200,92253
2897,1908,989,598,150500,92254
1456,1093,363,899,166400,92256
491,369,122,498,50300,92257
216,130,86,636,91200,92258
71,49,22,-,-,92259
15837,9517,6320,1277,334300,92260
13458,7742,5716,1074,408600,92262
11058,7154,3904,1171,365100,92264
75,68,7,-,-,92266
6,0,6,-,-,92267
257,217,40,846,286500,92268
9290,7614,1676,1191,498700,92270
504,268,236,795,160800,92273
5036,3704,1332,663,111900,92274
945,749,196,984,139800,92275
2584,1932,652,1132,181600,92276
8911,3341,5570,937,141200,92277
370,0,370,1261,-,92278
0,0,0,-,-,92280
692,294,398,768,123300,92281
454,325,129,1315,189600,92282
512,234,278,523,100000,92283
10573,7181,3392,934,168600,92284
1078,892,186,892,155500,92285
7956,4309,3647,1165,194200,92301
13,0,13,-,-,92304
251,167,84,1531,295900,92305
12772,8576,4196,1048,259500,92307
14125,9401,4724,1083,247800,92308
201,57,144,670,-,92309
2708,4,2704,1369,-,92310
11429,5432,5997,798,121000,92311
4377,2681,1696,1405,324800,92313
4418,2861,1557,1114,262400,92314
2243,1197,1046,957,392200,92315
7505,5130,2375,1253,277700,92316
3205,2699,506,1135,214400,92320
414,337,77,1021,288900,92321
331,315,16,-,240500,92322
18325,9855,8470,1200,265400,92324
3154,2159,995,1002,261200,92325
288,143,145,779,101700,92327
230,24,206,263,"10,000-",92328
44,3,41,-,-,92332
211,192,19,-,406100,92333
25098,12367,12731,1197,306500,92335
25079,19653,5426,1828,417900,92336
10022,7204,2818,1683,352100,92337
0,0,0,-,-,92338
413,319,94,1358,259500,92339
116,99,17,-,255500,92341
2598,1999,599,1429,224200,92342
6003,4465,1538,1562,304800,92344
23946,14492,9454,1154,232800,92345
17747,12063,5684,1129,335100,92346
288,238,50,-,61900,92347
2181,1632,549,1404,440600,92352
8037,3351,4686,1337,372300,92354
2343,1543,800,911,156100,92356
384,284,100,1372,305200,92358
3097,1995,1102,1000,306400,92359
2188,1150,1038,638,89700,92363
6,0,6,-,-,92364
1082,773,309,980,120900,92365
290,123,167,978,149000,92368
5268,4043,1225,1139,230500,92371
2077,1515,562,1036,260100,92372
12712,7219,5493,1410,456400,92373
13921,8412,5509,1298,344700,92374
21415,12621,8794,1224,288300,92376
5530,4858,672,1677,364800,92377
94,94,0,-,273600,92378
1716,1146,570,1217,260600,92382
13,0,13,-,-,92384
88,75,13,-,303100,92385
1000,644,356,1109,200000,92386
102,88,14,-,61500,92389
809,474,335,767,267100,92391
15880,9145,6735,1403,232500,92392
8120,5070,3050,1237,227000,92394
13446,7105,6341,1155,221000,92395
1792,1433,359,1030,327100,92397
676,272,404,685,112200,92398
18447,13452,4995,1179,331300,92399
762,118,644,826,217300,92401
17848,8087,9761,1033,255500,92404
8739,3875,4864,1076,235500,92405
17408,10774,6634,1321,329500,92407
3640,1342,2298,964,250400,92408
12659,5064,7595,950,161100,92410
6428,3452,2976,1092,196400,92411
6699,2887,3812,1184,317600,92501
25056,15851,9205,1351,369700,92503
16569,9773,6796,1297,359600,92504
13700,6976,6724,1539,352500,92505
14692,11269,3423,1466,439000,92506
17046,5465,11581,1314,331500,92507
10010,7902,2108,2053,463900,92508
18735,12742,5993,1345,342800,92509
483,41,442,1669,289700,92518
15466,9183,6283,1352,324100,92530
7141,5736,1405,1812,371000,92532
1087,842,245,881,297200,92536
1629,1239,390,814,201400,92539
12775,6238,6537,991,136600,92543
15408,10340,5068,1219,230800,92544
14642,10057,4585,1341,226400,92545
2256,1430,826,1096,161600,92548
1196,862,334,1139,335100,92549
7937,5286,2651,1526,290600,92551
18385,8777,9608,1397,271800,92553
10873,8280,2593,1803,353000,92555
13901,9190,4711,1520,326500,92557
628,550,78,1177,332200,92561
19614,13438,6176,1736,434700,92562
18089,12526,5563,1824,416900,92563
2636,1928,708,1195,331100,92567
13783,8839,4944,1186,280600,92570
12846,8491,4355,1565,280200,92571
4019,3037,982,1566,273400,92582
9349,5660,3689,1141,213300,92583
14974,12011,2963,1921,372100,92584
6115,5001,1114,1665,352400,92585
9049,6151,2898,1192,235600,92586
5840,4528,1312,1806,386200,92587
1662,708,954,989,1063300,92590
13098,7582,5516,1795,448400,92591
24544,18152,6392,2000,463900,92592
9502,6725,2777,1590,360100,92595
8178,6004,2174,1999,426000,92596
8062,3843,4219,2372,852600,92602
7201,4740,2461,2491,1280500,92603
9685,6056,3629,2309,750300,92604
9208,3791,5417,2320,814200,92606
5603,3805,1798,2268,739700,92610
12999,4052,8947,2386,727200,92612
10097,4164,5933,2392,746500,92614
3971,904,3067,1395,511900,92617
19247,6890,12357,2428,839500,92618
18977,12024,6953,2370,908400,92620
2799,1846,953,2060,810300,92624
5759,3954,1805,2851,"2,000,000+",92625
18947,7544,11403,1979,761600,92626
22259,8246,14013,1769,742100,92627
11843,7652,4191,2039,895800,92629
20806,14344,6462,1942,622700,92630
11003,8073,2930,1755,288400,92637
21205,15813,5392,2114,762400,92646
21452,9665,11787,1907,688400,92647
19540,9580,9960,1833,920500,92648
14339,8416,5923,1884,790400,92649
10904,7139,3765,2335,1890000,92651
10308,7579,2729,2133,722300,92653
2422,785,1637,1371,573400,92655
19244,11557,7687,2240,626400,92656
3905,3244,661,2623,"2,000,000+",92657
15062,8028,7034,2437,1668800,92660
1501,739,762,1942,"2,000,000+",92661
1295,804,491,2149,"2,000,000+",92662
10072,4551,5521,1916,1462700,92663
14113,7787,6326,1830,911700,92672
10319,8782,1537,2383,902800,92673
13155,9749,3406,2052,731600,92675
827,702,125,2066,699500,92676
25550,17445,8105,2265,827100,92677
207,143,64,1875,724500,92678
10863,9459,1404,2441,890700,92679
27634,14369,13265,1583,603800,92683
15984,10898,5086,2060,627700,92688
17050,12748,4302,2196,670800,92691
17421,13343,4078,2237,722500,92692
9048,6951,2097,2439,781600,92694
13209,3772,9437,1313,448100,92701
13575,6379,7196,1587,442600,92703
20018,10701,9317,1696,477800,92704
14738,9825,4913,1733,861400,92705
9355,5037,4318,1452,626000,92706
13801,7121,6680,1697,472100,92707
18756,12955,5801,2010,734500,92708
18547,8938,9609,1718,590300,92780
7980,4949,3031,2383,787200,92782
17921,6079,11842,1606,469100,92801
11527,4003,7524,1488,523600,92802
24954,10035,14919,1612,549000,92804
19611,7666,11945,1556,499600,92805
12339,4742,7597,1821,576800,92806
12437,9950,2487,2135,681700,92807
7435,5610,1825,2240,717700,92808
13750,8200,5550,1828,640900,92821
1458,1261,197,3036,828600,92823
12438,4878,7560,1653,643600,92831
8322,2916,5406,1571,555800,92832
16310,9721,6589,1724,634900,92833
8513,6286,2227,1842,770500,92835
15065,8164,6901,1634,531100,92840
9384,4916,4468,1503,567600,92841
11833,5591,6242,1487,515100,92843
6713,2624,4089,1635,485500,92844
5564,4543,1021,1950,616200,92845
7120,5975,1145,1892,545100,92860
1975,1914,61,"3,500+",1187000,92861
6406,3930,2476,1857,604700,92865
5418,1953,3465,1617,651200,92866
12944,8678,4266,1772,701600,92867
8061,2592,5469,1887,480700,92868
11508,8553,2955,1866,702300,92869
17177,11260,5917,1796,630300,92870
14255,8023,6232,1617,413400,92879
17384,12899,4485,2316,549300,92880
9566,7580,1986,1566,544300,92881
21310,13778,7532,1593,463600,92882
10533,8560,1973,2391,472300,92883
16816,13737,3079,2298,823800,92886
6847,5857,990,1931,891500,92887
12694,5089,7605,1426,589800,93001
19247,11066,8181,1738,567600,93003
11030,7200,3830,1737,556500,93004
16042,9984,6058,1857,635800,93010
13209,9528,3681,2201,624300,93012
6213,3579,2634,1975,793200,93013
5188,3242,1946,1418,437200,93015
12141,9227,2914,2047,636800,93021
2488,1908,580,1526,543500,93022
7765,5108,2657,1561,676100,93023
14617,6957,7660,1425,478000,93030
17217,9532,7685,1527,402100,93033
9929,5804,4125,2073,573200,93035
13074,6741,6333,1683,477700,93036
524,332,192,1128,342100,93040
7111,3248,3863,1707,412200,93041
0,0,0,-,-,93042
12,4,8,-,-,93043
9622,5146,4476,1266,396700,93060
18980,13459,5521,1919,567500,93063
0,0,0,-,-,93064
23881,17588,6293,2090,601500,93065
1020,701,319,1409,964200,93066
260,118,142,3204,668800,93067
13100,3084,10016,1640,892300,93101
7749,3720,4029,1979,1040400,93103
11655,6270,5385,1890,1089900,93105
4052,2914,1138,2414,"2,000,000+",93108
4543,2734,1809,1994,1220100,93109
6457,4134,2323,1957,859400,93110
6166,4105,2061,2227,897800,93111
16059,5876,10183,1725,812200,93117
410,173,237,835,93800,93201
1162,657,505,1073,150100,93202
5280,2515,2765,899,166500,93203
2489,1226,1263,856,152500,93204
902,614,288,844,96300,93205
485,228,257,945,150800,93206
114,106,8,-,175000,93207
85,18,67,-,-,93208
4699,2504,2195,874,170800,93210
4386,1997,2389,838,151200,93212
12336,7158,5178,905,184500,93215
258,188,70,792,118100,93218
2537,1215,1322,738,143500,93219
65,0,65,-,-,93220
4825,3336,1489,901,245600,93221
834,647,187,1321,240300,93222
2912,1876,1036,718,153800,93223
156,108,48,1031,107900,93224
1942,1278,664,846,198800,93225
73,62,11,-,270000,93226
22204,12661,9543,973,225600,93230
1800,475,1325,714,163000,93234
1188,715,473,788,138700,93235
392,222,170,672,234400,93238
329,141,188,769,-,93239
2676,1748,928,863,122400,93240
4022,1610,2412,813,132100,93241
1018,484,534,901,177500,93242
676,480,196,1005,-,93243
117,89,28,850,247700,93244
12213,5709,6504,1156,235300,93245
5413,2895,2518,735,155700,93247
514,155,359,691,126600,93249
3678,2117,1561,900,174000,93250
68,42,26,506,-,93251
569,305,264,795,103800,93252
306,174,132,972,128200,93254
403,351,52,-,111000,93255
1509,602,907,874,128200,93256
22264,11912,10352,933,174200,93257
550,247,303,810,120600,93258
104,73,31,-,138500,93260
681,290,391,710,111700,93261
0,0,0,-,-,93262
5825,3145,2680,881,177000,93263
1736,1380,356,1094,246900,93265
307,125,182,1134,124300,93266
1863,1095,768,847,141900,93267
6420,3281,3139,779,140900,93268
1627,1017,610,808,194900,93270
1126,930,196,1305,296400,93271
1137,461,676,911,150400,93272
21468,11932,9536,1036,209600,93274
49,25,24,630,-,93276
18141,10179,7962,1018,225000,93277
6255,3663,2592,757,169100,93280
986,782,204,578,84600,93283
1241,945,296,948,109100,93285
2861,1630,1231,700,179600,93286
28,28,0,-,225000,93287
17429,10607,6822,994,267200,93291
13594,8573,5021,1136,224600,93292
4698,1493,3205,858,214500,93301
14981,6662,8319,952,158600,93304
10701,3891,6810,796,153800,93305
21865,13914,7951,1032,196800,93306
22585,11673,10912,960,160900,93307
19488,8451,11037,1004,219100,93308
21431,9958,11473,1011,204900,93309
14524,10539,3985,1459,298800,93311
19616,15213,4403,1578,298700,93312
14481,10163,4318,1558,243100,93313
9217,7691,1526,1332,384000,93314
12261,5772,6489,1457,689300,93401
6401,4556,1845,1516,551500,93402
8651,3063,5588,1684,690000,93405
0,0,0,-,-,93410
11734,8154,3580,1494,663500,93420
12793,8284,4509,1423,520200,93422
507,297,210,-,885700,93424
479,389,90,886,453200,93426
2280,1509,771,1713,541700,93427
2840,2110,730,1463,672400,93428
69,47,22,-,258000,93429
1405,856,549,1254,769300,93430
605,555,50,-,623300,93432
5307,2731,2576,1481,493700,93433
2030,1041,989,1209,257100,93434
17510,9218,8292,1237,340700,93436
1022,0,1022,1874,-,93437
567,356,211,1669,450000,93440
404,286,118,2041,893900,93441
5056,3005,2051,1556,614500,93442
7246,5484,1762,1563,598200,93444
2462,1376,1086,1291,403700,93445
17500,11548,5952,1253,462700,93446
4213,2678,1535,1774,768600,93449
204,61,143,1000,277200,93450
1412,892,520,1632,378200,93451
322,87,235,1111,288300,93452
1173,856,317,1198,500000,93453
11666,5932,5734,1365,349000,93454
15518,11437,4081,1808,418500,93455
13176,5898,7278,1361,323600,93458
2023,1480,543,1481,926000,93460
523,260,263,1651,293800,93461
3230,2168,1062,1525,806600,93463
3357,2523,834,1710,651800,93465
1919,856,1063,721,101300,93501
4205,2324,1881,968,124300,93505
2608,2357,251,1488,565500,93510
130,115,15,-,202500,93512
736,534,202,830,238800,93513
5968,4108,1860,987,316200,93514
966,563,403,703,70200,93516
267,264,3,-,229500,93517
372,297,75,1031,191400,93518
0,0,0,-,-,93519
59,59,0,-,32800,93522
1161,229,932,1556,74500,93523
0,0,0,-,-,93524
306,199,107,890,170200,93526
680,535,145,1066,167300,93527
58,8,50,-,-,93528
187,177,10,-,404300,93529
10,10,0,-,-,93530
132,122,10,-,466700,93531
976,772,204,1344,294800,93532
14161,4866,9295,1115,224800,93534
21334,12082,9252,1153,209500,93535
21427,14114,7313,1371,332000,93536
166,104,62,-,203000,93541
3698,2484,1214,1273,239900,93543
554,486,68,-,231900,93544
772,460,312,919,183300,93545
2954,1527,1427,1244,355300,93546
134,108,26,-,191300,93549
21548,11221,10327,1143,232100,93550
15771,12280,3491,1712,361400,93551
9806,7647,2159,1679,273900,93552
670,508,162,1325,263400,93553
82,76,6,-,-,93554
12986,8352,4634,893,182200,93555
16,16,0,-,-,93558
7148,4709,2439,949,206100,93560
11679,8718,2961,1052,268200,93561
775,410,365,621,58000,93562
96,92,4,-,326700,93563
1948,1438,510,1185,183600,93591
71,45,26,-,-,93592
596,436,160,779,300700,93601
1400,1168,232,798,294000,93602
85,69,16,-,-,93603
269,269,0,-,673000,93604
57,16,41,956,320000,93605
238,112,126,914,156600,93606
361,121,240,789,144400,93608
1541,861,680,948,189100,93609
4710,2443,2267,904,228600,93610
15823,11782,4041,1675,326300,93611
13491,5043,8448,1046,209000,93612
4747,4203,544,1429,270000,93614
1549,711,838,974,135900,93615
707,402,305,715,270600,93616
8222,4335,3887,917,213300,93618
13031,11344,1687,1958,419600,93619
2757,1542,1215,939,217900,93620
57,57,0,-,-,93621
2748,1055,1693,664,170600,93622
52,52,0,-,339500,93623
177,2,175,593,-,93624
2507,1274,1233,946,262600,93625
849,732,117,1496,409300,93626
35,0,35,-,-,93627
69,13,56,-,-,93628
5373,2724,2649,965,227600,93630
5387,3455,1932,1014,292200,93631
0,0,0,-,-,93633
2,2,0,-,-,93634
11473,6480,4993,1252,298700,93635
4285,3848,437,1243,331400,93636
12360,6833,5527,1077,244300,93637
12214,6583,5631,968,207800,93638
2966,1147,1819,787,159800,93640
128,109,19,-,232800,93641
1243,962,281,866,246500,93643
3559,2470,1089,997,293300,93644
50,50,0,-,-,93645
3048,1152,1896,772,158700,93646
2932,1447,1485,869,154000,93647
4149,1621,2528,851,164900,93648
1213,570,643,945,80300,93650
667,555,112,1347,363500,93651
142,67,75,775,164200,93652
542,427,115,1354,350000,93653
8572,5537,3035,980,226100,93654
1690,959,731,905,174900,93656
10720,6749,3971,958,269600,93657
1017,383,634,690,167200,93660
8807,5093,3714,960,194100,93662
209,172,37,970,560500,93664
234,187,47,-,84300,93665
217,42,175,787,106600,93666
864,712,152,1238,287600,93667
353,220,133,1044,264000,93668
86,55,31,-,256800,93669
187,91,96,803,146300,93673
1299,1148,151,969,229200,93675
3417,406,3011,678,152100,93701
11961,3925,8036,822,123500,93702
9901,3857,6044,926,159500,93703
11334,5777,5557,1043,262000,93704
12103,4996,7107,936,172300,93705
11026,4408,6618,847,161600,93706
11238,4562,6676,1008,246600,93710
15929,9595,6334,1192,357300,93711
18125,10636,7489,1516,333000,93720
2032,261,1771,800,168500,93721
25288,14379,10909,1185,241300,93722
3906,3096,810,1212,324700,93723
6835,3689,3146,987,202900,93725
14135,5532,8603,942,182600,93726
24745,14381,10364,960,254200,93727
5832,2388,3444,882,165100,93728
4454,3442,1012,1933,464200,93730
9853,4213,5640,1350,490300,93901
13015,4886,8129,1234,375600,93905
16800,8850,7950,1592,400800,93906
7380,5346,2034,1584,531900,93907
4435,3608,827,2547,803500,93908
546,153,393,731,-,93920
1743,928,815,2206,1542700,93921
5571,4214,1357,1886,1163000,93923
2544,1855,689,1679,954700,93924
430,164,266,932,372700,93925
2277,1126,1151,1194,358800,93926
4071,1917,2154,1364,309200,93927
16,0,16,-,-,93928
4347,2305,2042,1138,278700,93930
272,161,111,1027,263300,93932
9088,3599,5489,1392,522300,93933
13358,5637,7721,1821,790500,93940
0,0,0,-,-,93943
6849,3184,3665,1758,856800,93950
1742,1431,311,2914,1365700,93953
116,65,51,967,214700,93954
10823,4366,6457,1781,490300,93955
4098,2468,1630,1195,368600,93960
148,111,37,-,477600,93962
10323,6293,4030,2342,1524000,94002
1892,1418,474,1919,889200,94005
16062,9483,6579,2220,"2,000,000+",94010
14044,8156,5888,1897,718100,94014
20295,11847,8448,2310,821900,94015
7452,5525,1927,1888,1049400,94019
661,516,145,1566,857400,94020
91,68,23,-,717900,94021
7202,5652,1550,3172,"2,000,000+",94022
7815,6934,881,3099,"2,000,000+",94024
15106,9220,5886,2346,"2,000,000+",94025
2318,2141,177,"3,500+","2,000,000+",94027
2508,2068,440,2914,"2,000,000+",94028
7976,5080,2896,2508,1403100,94030
1028,847,181,1708,1012400,94037
1157,902,255,1862,972400,94038
14567,5935,8632,2455,1736400,94040
6238,2118,4120,2442,1546500,94041
13046,5974,7072,2495,1135800,94043
13750,9722,4028,2414,882800,94044
300,173,127,2170,808600,94060
13942,7034,6908,2272,1342600,94061
10190,7593,2597,2125,1722300,94062
10647,3667,6980,2155,861400,94063
5197,3668,1529,3396,1332000,94065
15063,8867,6196,2372,908300,94066
11537,8434,3103,2321,1637900,94070
74,74,0,-,1116700,94074
21442,13115,8327,2111,843600,94080
8418,3175,5243,2570,1000500,94085
19564,6192,13372,2426,1223800,94086
20041,11426,8615,2445,1666300,94087
8231,4711,3520,2810,293300,94089
18036,1598,16438,1146,906600,94102
15714,2330,13384,1342,901300,94103
220,30,190,755,"2,000,000+",94104
5487,2289,3198,2918,1228900,94105
14392,5789,8603,2495,1090900,94107
7800,840,6960,1196,1127500,94108
33532,5258,28274,1826,1095700,94109
27504,10032,17472,1816,1150300,94110
2211,493,1718,2210,1211800,94111
23415,15548,7867,1777,868200,94112
16845,7383,9462,2243,1525600,94114
17062,4464,12598,1977,1378400,94115
16224,11288,4936,2235,1080100,94116
18244,5578,12666,2270,1443500,94117
17854,6331,11523,2072,1598700,94118
17448,7365,10083,1904,1241600,94121
22936,11379,11557,2171,1133400,94122
13769,3683,10086,2506,"2,000,000+",94123
11219,5802,5417,1070,745500,94124
7603,6032,1571,2907,1387700,94127
0,0,0,-,-,94128
1293,10,1283,3367,-,94129
606,0,606,2106,-,94130
13012,7332,5680,2298,1273400,94131
10314,4465,5849,2106,986500,94132
12981,2258,10723,1395,1433000,94133
12172,7347,4825,1587,827800,94134
4461,1315,3146,3035,1061700,94158
7042,3661,3381,2379,"2,000,000+",94301
14310,7564,6746,1994,1409800,94303
1846,280,1566,2972,"2,000,000+",94304
3578,950,2628,1618,"2,000,000+",94305
10680,5865,4815,2393,"2,000,000+",94306
12397,5890,6507,2266,833000,94401
9542,6484,3058,2364,1603500,94402
16529,9078,7451,2665,1199800,94403
14341,8149,6192,3202,1195500,94404
25452,10497,14955,1816,855300,94501
4966,4091,875,2264,871700,94502
5303,4110,1193,1830,499700,94503
5523,4575,948,2532,615200,94505
8277,7383,894,2886,1274500,94506
5241,4869,372,2796,1670200,94507
997,583,414,1666,775800,94508
21537,11504,10033,1652,369200,94509
11339,8149,3190,1858,586700,94510
906,751,155,730,168900,94511
16,16,0,-,-,94512
20690,16043,4647,2150,581700,94513
451,348,103,1313,616500,94514
3001,1952,1049,1418,680700,94515
48,41,7,644,786800,94516
4797,4445,352,2550,754500,94517
10588,7251,3337,1938,597300,94518
6924,4774,2150,1826,510200,94519
13669,4792,8877,1575,418400,94520
15932,11525,4407,1877,603600,94521
13960,9054,4906,1988,719000,94523
1459,799,660,1337,507100,94525
12390,10287,2103,2463,1077200,94526
201,201,0,-,"2,000,000+",94528
10313,6110,4203,1931,802500,94530
12479,9010,3469,2268,436400,94531
24038,13017,11021,1403,355600,94533
13097,9924,3173,2182,495200,94534
1035,16,1019,2252,-,94535
24973,14097,10876,2257,868900,94536
22222,10067,12155,2314,790700,94538
16822,13819,3003,2652,1352400,94539
21808,9562,12246,1708,581800,94541
4392,2985,1407,2146,793400,94542
22920,11035,11885,1810,549700,94544
9414,6533,2881,1908,576700,94545
16363,10735,5628,1777,699800,94546
8402,6859,1543,2201,561600,94547
150,107,43,1629,1062500,94548
10852,8000,2852,2230,1361100,94549
18117,13555,4562,2058,834600,94550
15988,11614,4374,2096,714700,94551
4943,4478,465,3073,926700,94552
18961,12936,6025,1722,570200,94553
11683,7939,3744,2561,906400,94555
5881,4846,1035,2128,1142100,94556
23924,16309,7615,1765,645500,94558
10210,4978,5232,1646,640200,94559
14047,9669,4378,2277,742100,94560
12190,9229,2961,1694,441400,94561
7167,6456,711,2813,1462800,94563
6757,4505,2252,1828,500500,94564
28368,15523,12845,1672,369500,94565
16475,11917,4558,2287,1070900,94566
231,165,66,1600,346600,94567
18660,11719,6941,2675,847400,94568
83,0,83,1864,-,94569
5211,4003,1208,1267,344100,94571
3373,1940,1433,1406,459900,94572
14,0,14,-,-,94573
3796,2416,1380,1653,1123800,94574
0,0,0,-,-,94575
47,31,16,-,-,94576
17132,9367,7765,1663,609300,94577
14502,5823,8679,1596,545000,94578
6800,5098,1702,1797,585100,94579
8879,6367,2512,1819,578700,94580
14036,10070,3966,2423,1067500,94582
12096,8845,3251,2344,890500,94583
9300,5755,3545,1714,357400,94585
305,240,65,1606,1166700,94586
21852,14281,7571,2202,765500,94587
13032,8814,4218,2498,928800,94588
9785,5982,3803,1642,329300,94589
14589,5553,9036,1257,308700,94590
18557,12150,6407,1733,427000,94591
291,224,67,2658,490000,94592
9761,8250,1511,1872,592400,94595
9922,4253,5669,2031,1029400,94596
10497,5021,5476,2136,769300,94597
10358,7897,2461,2601,951700,94598
1446,920,526,1790,547000,94599
15536,5128,10408,1271,480000,94601
11813,6712,5101,1426,835400,94602
10006,4595,5411,1500,370300,94603
16446,9394,7052,1448,596000,94605
15260,3119,12141,1299,548600,94606
11503,3537,7966,1263,581800,94607
14368,5170,9198,2059,602200,94608
9915,2919,6996,1638,832700,94609
15211,5534,9677,1677,1021400,94610
17257,10402,6855,1586,1109200,94611
8750,751,7999,1220,725600,94612
4,0,4,-,-,94613
7156,4630,2526,2164,1208800,94618
9095,6193,2902,1492,718200,94619
9685,2901,6784,1274,353500,94621
7499,3493,4006,1460,851400,94702
8674,3527,5147,1816,917500,94703
8251,913,7338,1711,804000,94704
5787,3290,2497,1713,1235900,94705
7981,3863,4118,1858,884300,94706
4838,4076,762,1938,1172000,94707
4749,4046,703,2642,1112900,94708
4984,1409,3575,1769,982100,94709
3103,1062,2041,1714,849300,94710
26,26,0,-,"2,000,000+",94720
9335,4091,5244,1404,379900,94801
9114,6419,2695,1735,534000,94803
14392,6537,7855,1354,436900,94804
5254,3393,1861,1706,518100,94805
19943,9193,10750,1618,402800,94806
0,0,0,-,-,94850
15990,7301,8689,1826,1020200,94901
12348,8608,3740,2409,855800,94903
5302,3441,1861,1964,1568300,94904
5359,3645,1714,2550,"2,000,000+",94920
265,203,62,2270,772500,94922
506,299,207,1292,848800,94923
535,368,167,1694,1094400,94924
3930,2611,1319,2642,1200300,94925
16393,8994,7399,1688,455900,94928
96,66,30,2700,964300,94929
3766,2442,1324,1889,871700,94930
3263,1983,1280,1630,555800,94931
339,155,184,2308,696000,94933
402,272,130,1482,907800,94937
374,280,94,2850,908000,94938
3127,1688,1439,2206,1551400,94939
113,96,17,-,827600,94940
13290,9095,4195,2329,1441100,94941
7400,5068,2332,2008,831300,94945
291,222,69,1984,1375000,94946
10186,7681,2505,1975,795600,94947
7533,4735,2798,2152,800400,94949
51,34,17,-,1125000,94950
1855,1338,517,1494,849700,94951
13786,8429,5357,1730,776600,94952
13781,9503,4278,1877,606200,94954
643,286,357,1755,1110600,94956
419,372,47,1938,"2,000,000+",94957
6283,4496,1787,1964,1150100,94960
129,120,9,-,854200,94963
70,0,70,-,-,94964
5950,2964,2986,2178,1206900,94965
378,200,178,1841,1742500,94970
116,94,22,-,554200,94971
13,13,0,-,-,94972
652,556,96,1349,932100,94973
625,419,206,2071,564600,95002
10263,7752,2511,1994,852500,95003
1252,895,357,1642,696800,95004
2674,1893,781,1806,703500,95005
3992,3103,889,1543,600500,95006
133,133,0,-,552200,95007
17878,8934,8944,2205,1081300,95008
3942,1912,2030,1804,776700,95010
2434,1091,1343,1188,378500,95012
32,15,17,-,-,95013
21618,12755,8863,3107,1711800,95014
259,162,97,1200,918900,95017
2849,2227,622,1790,622300,95018
2089,755,1334,1066,453900,95019
18592,11716,6876,1863,698500,95020
15752,10072,5680,1549,534600,95023
5088,3770,1318,2262,"2,000,000+",95030
9840,6628,3212,2387,1592200,95032
3566,3074,492,2232,1094300,95033
23660,15240,8420,2426,859600,95035
17297,12883,4414,1804,880100,95037
314,180,134,1174,183000,95039
100,42,58,846,728300,95041
284,186,98,1411,669600,95043
1434,838,596,1459,689100,95045
1698,1146,552,1446,1018500,95046
14112,4986,9126,2013,985500,95050
21679,10273,11406,2502,1075600,95051
0,0,0,-,-,95053
8564,3650,4914,2762,988100,95054
18913,9631,9282,1890,890000,95060
14982,7978,7004,1717,747400,95062
421,163,258,1669,370000,95064
3220,2157,1063,2167,893700,95065
5598,4082,1516,2080,844000,95066
11183,9472,1711,3098,"2,000,000+",95070
3964,2924,1040,1825,829000,95073
144,104,40,2150,758300,95075
23856,13002,10854,1485,559000,95076
6547,2536,4011,2134,631500,95110
16169,9753,6416,1579,569300,95111
20879,6076,14803,1692,700200,95112
1309,178,1131,2709,855600,95113
14227,5215,9012,1631,568900,95116
10821,4059,6762,1949,1006000,95117
11147,7458,3689,2039,952300,95118
3209,2495,714,2472,850300,95119
12522,11222,1300,3495,1377200,95120
9756,7167,2589,2113,707000,95121
12664,6419,6245,1851,594000,95122
23201,14387,8814,2525,806300,95123
17249,12682,4567,2326,1102000,95124
21088,13364,7724,1926,1077200,95125
15031,4914,10117,2021,893900,95126
16530,11024,5506,2009,692000,95127
13778,5668,8110,1907,909300,95128
13910,8137,5773,2325,1462100,95129
5135,2991,2144,1865,1216700,95130
9700,6281,3419,2480,827800,95131
12040,8769,3271,2655,904200,95132
8774,5123,3651,1621,746500,95133
12443,1870,10573,2901,224600,95134
7548,6494,1054,2511,1026900,95135
15700,9000,6700,2300,798300,95136
6145,5324,821,2709,1021400,95138
2235,1813,422,2776,784900,95139
71,45,26,-,1026800,95140
12024,9941,2083,2769,865000,95148
2926,171,2755,607,216900,95202
5472,2113,3359,890,226400,95203
11076,5968,5108,1019,244700,95204
10702,4303,6399,1020,161200,95205
17227,8989,8238,1169,236300,95206
18414,7215,11199,1090,269600,95207
13182,8943,4239,1483,312600,95209
11929,5444,6485,1137,219600,95210
0,0,0,-,-,95211
7186,5095,2091,1711,353300,95212
6612,4065,2547,998,234500,95215
10811,6141,4670,1393,384500,95219
2570,1803,767,1278,514300,95220
2339,1501,838,1156,368500,95222
1274,1013,261,1277,298600,95223
85,65,20,769,240800,95224
160,55,105,-,331300,95225
0,0,0,-,-,95226
222,162,60,-,802400,95227
1728,1483,245,1659,337900,95228
269,107,162,1944,587300,95230
777,395,382,988,316700,95231
66,66,0,-,527000,95232
185,155,30,-,315600,95233
0,0,0,-,-,95234
1531,960,571,755,427200,95236
1269,922,347,1233,354400,95237
16478,8074,8404,1080,296100,95240
10021,6474,3547,1444,380200,95242
667,545,122,1122,272400,95245
545,412,133,1080,310500,95246
1630,1329,301,1492,324300,95247
56,45,11,-,208300,95248
1637,997,640,1294,225000,95249
0,0,0,-,-,95250
301,266,35,-,294400,95251
5221,4374,847,1669,330000,95252
316,316,0,-,387800,95254
603,469,134,805,220600,95255
155,98,57,1593,165000,95257
1441,1097,344,1114,396500,95258
11999,6916,5083,980,260800,95301
371,148,223,1027,476200,95303
3756,2727,1029,1629,578100,95304
0,0,0,-,-,95305
358,273,85,1244,289300,95306
12589,7684,4905,1158,266000,95307
954,697,257,695,323200,95310
939,725,214,789,235200,95311
70,44,26,-,-,95312
446,244,202,881,430800,95313
0,0,0,-,-,95314
3622,2344,1278,1111,250500,95315
2237,1599,638,1142,346400,95316
341,112,229,852,421100,95317
119,15,104,660,-,95318
623,261,362,782,179200,95319
4440,2951,1489,1471,371400,95320
1681,1335,346,927,293700,95321
3238,1995,1243,1033,256800,95322
410,259,151,706,354900,95323
2878,1656,1222,1151,297400,95324
40,29,11,-,-,95325
3465,2250,1215,1586,349400,95326
2553,1993,560,880,226800,95327
1105,564,541,1075,253700,95328
1078,797,281,1137,256800,95329
5642,4165,1477,1690,359300,95330
812,568,244,912,170700,95333
4485,2214,2271,1028,234800,95334
98,27,71,-,-,95335
15477,9227,6250,1369,360800,95336
12048,7793,4255,1471,418100,95337
4776,3319,1457,923,290200,95338
11801,6206,5595,978,272800,95340
8492,3508,4984,880,199700,95341
427,294,133,679,296000,95345
541,349,192,1126,312500,95346
10517,4003,6514,1143,243200,95348
19832,10002,9830,1107,265000,95350
13385,6152,7233,1092,196300,95351
8890,4203,4687,1070,256000,95354
21394,12851,8543,1230,315700,95355
11477,7073,4404,1269,341100,95356
3643,2598,1045,1418,301400,95357
8781,5146,3635,1236,257600,95358
3909,2629,1280,1065,263900,95360
12206,7907,4299,1100,365200,95361
7606,4672,2934,1387,319200,95363
0,0,0,-,-,95364
1353,754,599,725,144800,95365
6135,4308,1827,1428,457400,95366
7217,4885,2332,1192,297200,95367
3987,2905,1082,1570,302100,95368
370,190,180,713,270000,95369
12058,8039,4019,1031,291100,95370
723,681,42,-,283400,95372
569,307,262,1076,325400,95374
0,0,0,-,-,95375
16220,9237,6983,1629,397200,95376
8851,6266,2585,2215,491600,95377
1601,1094,507,679,293300,95379
14470,6654,7816,1010,274500,95380
13520,8253,5267,1316,343900,95382
1778,1407,371,1373,323400,95383
148,81,67,-,-,95385
3057,2052,1005,1135,262200,95386
158,20,138,-,-,95387
4135,2417,1718,850,184100,95388
283,32,251,-,656300,95389
5044,3768,1276,2460,594000,95391
13635,7471,6164,1496,470700,95401
16103,8597,7506,1642,524500,95403
16340,9168,7172,1520,677800,95404
8174,4780,3394,1818,613400,95405
12785,6591,6194,1472,424000,95407
12310,7873,4437,1825,632300,95409
395,273,122,1393,483000,95410
153,133,20,-,509400,95412
442,208,234,1015,500000,95415
141,86,55,-,-,95417
181,113,68,-,399100,95420
787,594,193,936,510500,95421
5962,2971,2991,867,112700,95422
1668,1170,498,1025,188700,95423
4112,2771,1341,1390,497900,95425
608,501,107,-,258900,95426
115,53,62,734,-,95427
974,659,315,828,266200,95428
58,58,0,-,336800,95429
7,0,7,-,-,95430
0,0,0,-,-,95431
326,216,110,1654,522700,95432
88,13,75,-,-,95435
2823,2032,791,1357,516400,95436
6080,3595,2485,1111,398300,95437
220,142,78,-,750000,95439
624,349,275,1366,1023600,95441
1312,915,397,1470,1272300,95442
81,0,81,855,-,95443
214,142,72,-,685000,95444
1068,835,233,1724,535500,95445
2510,1658,852,1210,472000,95446
6797,4258,2539,1687,854100,95448
542,292,250,1185,434000,95449
127,60,67,1109,650000,95450
4621,3479,1142,1255,241200,95451
483,457,26,-,910300,95452
4662,2996,1666,887,280400,95453
1076,756,320,442,353900,95454
452,296,156,1375,409400,95456
1331,1088,243,861,190100,95457
1203,843,360,822,210000,95458
246,197,49,-,374600,95459
1267,958,309,1211,520100,95460
1090,706,384,1028,231100,95461
583,377,206,981,454700,95462
73,73,0,-,446300,95463
976,728,248,1054,145000,95464
1094,761,333,2090,769900,95465
337,148,189,890,831400,95466
2054,1530,524,1623,316000,95467
559,245,314,949,392400,95468
757,458,299,1432,464100,95469
2116,1652,464,1283,407700,95470
270,83,187,1405,-,95471
12493,8466,4027,1499,804400,95472
15332,10071,5261,1641,689600,95476
11451,6131,5320,1172,364200,95482
1079,859,220,981,293900,95485
33,17,16,-,-,95486
79,42,37,-,-,95488
5235,2970,2265,1118,284300,95490
9757,7417,2340,1764,606600,95492
183,140,43,-,373800,95493
64,35,29,-,1025000,95494
604,514,90,1413,867100,95497
10135,4003,6132,913,277300,95501
10226,6940,3286,1081,298400,95503
108,108,0,-,351600,95511
60,60,0,-,840300,95514
7552,4920,2632,970,313300,95519
8331,3427,4904,1025,351100,95521
738,608,130,1141,478500,95524
652,384,268,1172,329900,95525
122,101,21,704,365000,95526
276,229,47,778,240200,95527
499,401,98,1137,343700,95528
8497,5208,3289,889,219700,95531
1124,573,551,1142,452400,95536
114,114,0,-,-,95537
5402,3239,2163,907,289700,95540
917,507,410,945,543300,95542
252,198,54,733,165600,95543
38,38,0,-,452900,95545
1163,839,324,519,216400,95546
450,352,98,994,485400,95547
454,324,130,800,185400,95548
350,287,63,1603,454000,95549
40,8,32,1728,666700,95550
570,345,225,875,282200,95551
384,327,57,-,257600,95552
403,156,247,976,-,95553
178,139,39,-,-,95554
174,80,94,782,308300,95555
212,122,90,472,261500,95556
186,143,43,700,548600,95558
49,14,35,-,-,95559
651,426,225,1129,303100,95560
1336,804,532,902,198900,95562
341,187,154,943,373400,95563
158,48,110,1125,304300,95564
284,74,210,1127,321200,95565
742,543,199,723,255000,95567
79,63,16,858,298100,95568
178,140,38,-,407500,95569
1026,778,248,1160,447800,95570
128,90,38,-,295800,95571
634,418,216,1004,309000,95573
208,133,75,988,322500,95585
41,41,0,-,-,95587
535,432,103,2023,395900,95589
60,52,8,-,333300,95595
68,22,46,850,409100,95601
7010,5370,1640,1277,471000,95602
12072,7876,4196,1200,426300,95603
51,39,12,-,674100,95604
4927,2001,2926,924,267400,95605
98,47,51,987,-,95606
167,167,0,-,710100,95607
25440,13454,11986,1148,397400,95608
17927,8715,9212,1247,331400,95610
424,251,173,1500,656300,95612
1690,1470,220,2019,393600,95614
245,58,187,866,189000,95615
17302,6030,11272,1483,672300,95616
9692,5489,4203,1715,665200,95618
2159,1552,607,1544,279600,95619
6703,4604,2099,1435,395300,95620
16385,10845,5540,1285,268000,95621
1505,1316,189,1242,413400,95623
19948,15457,4491,1556,399600,95624
67,8,59,1172,-,95625
1903,1458,445,1497,334800,95626
1177,744,433,1269,321100,95627
16090,11253,4837,1386,437200,95628
350,286,64,978,398900,95629
27836,19353,8483,1710,524100,95630
2699,2157,542,899,368500,95631
10042,7333,2709,1250,354900,95632
1376,1261,115,1705,366300,95633
1386,1046,340,1379,294900,95634
441,404,37,-,277000,95635
545,545,0,-,238300,95636
97,52,45,-,-,95637
741,688,53,1337,593200,95638
114,40,74,1653,450000,95639
3217,2436,781,1150,310400,95640
719,479,240,827,253500,95641
3147,2271,876,1024,306400,95642
618,351,267,857,215200,95645
34,18,16,-,659100,95646
19587,15565,4022,1776,454400,95648
5390,4470,920,1626,637700,95650
219,198,21,-,743800,95651
218,0,218,1268,-,95652
193,140,53,-,169400,95653
1402,1057,345,-,358800,95655
2699,2295,404,1403,614400,95658
391,224,167,1055,377800,95659
10593,5542,5051,1161,209500,95660
12031,7239,4792,1520,472500,95661
12247,9003,3244,1445,372900,95662
884,794,90,1581,615800,95663
578,392,186,1750,510100,95664
1679,1363,316,1421,310300,95665
2357,2020,337,1111,266000,95666
14335,10936,3399,1166,395900,95667
235,166,69,1825,487200,95668
884,687,197,1190,369600,95669
20736,11218,9518,1217,320000,95670
1953,1659,294,1732,477900,95672
4958,3448,1510,1302,274400,95673
254,210,44,933,398100,95674
217,160,57,-,155200,95675
9363,6251,3112,1540,426300,95677
16154,8724,7430,1563,367000,95678
24,14,10,-,-,95679
10,10,0,-,-,95680
404,389,15,-,272200,95681
11309,8440,2869,1340,473200,95682
2575,2291,284,2020,483600,95683
1305,1069,236,1367,361400,95684
1953,1283,670,1055,379500,95685
372,159,213,790,237500,95686
22220,13497,8723,1679,408400,95687
13231,8978,4253,1480,476600,95688
726,656,70,-,348600,95689
748,408,340,930,525900,95690
13665,8580,5085,1125,367300,95691
1910,1357,553,1353,278600,95692
2510,1938,572,1459,597700,95693
3477,2127,1350,1204,442100,95694
14749,7495,7254,1162,370700,95695
94,85,9,-,-,95697
107,65,42,-,-,95698
20,20,0,-,-,95699
347,289,58,1375,422200,95701
381,323,58,1685,384400,95703
2090,1737,353,1256,397500,95709
4091,3107,984,1311,381900,95713
224,167,57,955,317700,95714
36,29,7,-,-,95715
87,39,48,708,331300,95717
48,48,0,-,333300,95720
0,0,0,-,-,95721
2048,1845,203,1596,531500,95722
0,0,0,-,-,95724
3317,2720,597,1207,305800,95726
101,93,8,-,678000,95728
7,7,0,-,687500,95735
64,0,64,532,-,95736
3645,3239,406,2233,422600,95742
8378,7344,1034,2166,765600,95746
23180,18207,4973,1745,467200,95747
14382,10786,3596,1932,456700,95757
21507,15349,6158,1659,369200,95758
14577,12592,1985,1977,639100,95762
12912,8674,4238,1751,512900,95765
7595,4766,2829,1258,378200,95776
3449,651,2798,1050,517000,95811
6709,483,6226,917,472700,95814
9226,3105,6121,1031,211300,95815
9961,2733,7228,1145,574700,95816
6148,2504,3644,1022,330600,95817
9943,5305,4638,1117,569700,95818
7901,5480,2421,1561,568800,95819
12964,6868,6096,1183,248200,95820
15044,6153,8891,988,328700,95821
15979,9056,6923,1187,307100,95822
23710,10824,12886,1164,244100,95823
9103,3593,5510,1006,192500,95824
16404,3836,12568,1100,298100,95825
15214,7950,7264,1307,305800,95826
7292,4207,3085,1312,266900,95827
17852,11052,6800,1319,263500,95828
8443,6486,1957,1562,381500,95829
258,252,6,-,603300,95830
18443,10613,7830,1389,417700,95831
3147,1551,1596,1485,261400,95832
14656,6235,8421,1394,293400,95833
10613,4696,5917,1369,359900,95834
13718,8848,4870,1777,398000,95835
119,83,36,-,885000,95837
11056,5564,5492,1230,227800,95838
8191,3077,5114,1115,256700,95841
11449,5334,6115,1202,251000,95842
14275,9725,4550,1619,325700,95843
9359,7019,2340,1436,587000,95864
11734,6377,5357,952,232600,95901
341,0,341,1986,-,95903
53,53,0,-,123300,95910
1576,979,597,865,306600,95912
320,231,89,957,213900,95914
0,0,0,-,-,95915
568,468,100,788,173000,95916
1104,827,277,1071,235400,95917
1290,986,304,1123,393200,95918
484,403,81,1101,273200,95919
131,98,33,577,196700,95920
321,225,96,1325,272700,95922
16,16,0,-,550000,95923
142,71,71,-,-,95925
14942,6558,8384,1068,332600,95926
14473,6506,7967,1120,343000,95928
34,34,0,-,-,95930
2874,1683,1191,860,260300,95932
97,76,21,-,-,95934
130,49,81,-,-,95935
69,61,8,-,-,95936
536,392,144,987,241400,95937
1522,956,566,1385,512200,95938
192,83,109,582,139700,95939
361,295,66,-,235500,95941
564,488,76,-,509600,95942
325,170,155,925,335500,95943
14,14,0,-,-,95944
11162,6168,4994,1118,372000,95945
3799,3066,733,1655,408700,95946
826,655,171,686,215900,95947
3718,2214,1504,902,231000,95948
8408,7366,1042,1616,407300,95949
151,68,83,872,196300,95950
854,542,312,697,177900,95951
3262,1911,1351,936,222400,95953
4934,3900,1034,1050,178200,95954
513,311,202,903,253700,95955
167,167,0,-,235100,95956
313,197,116,855,292500,95957
7538,5911,1627,1279,442900,95959
348,248,100,1140,295700,95960
8926,5666,3260,985,261200,95961
626,524,102,1300,263700,95962
5473,3536,1937,912,254400,95963
6983,3930,3053,851,182400,95965
11266,8040,3226,968,215600,95966
434,330,104,708,122400,95968
9961,7023,2938,1079,226700,95969
254,159,95,1027,324400,95970
2428,1483,945,997,232800,95971
14219,8606,5613,1141,353000,95973
16,0,16,-,-,95974
796,657,139,-,386000,95975
714,492,222,1415,405900,95977
81,16,65,581,-,95978
203,126,77,757,240600,95979
13,13,0,-,-,95981
1187,887,300,1152,261100,95982
149,124,25,-,-,95983
127,64,63,-,256300,95984
32,25,7,-,138400,95986
1766,1133,633,955,250800,95987
3204,1643,1561,786,230600,95988
14432,6914,7518,988,246700,95991
12285,8181,4104,1180,316700,95993
13992,8140,5852,982,284700,96001
12627,7589,5038,993,257700,96002
18410,10853,7557,1165,262000,96003
191,174,17,-,143800,96006
9110,6103,3007,935,225200,96007
464,433,31,793,272800,96008
163,126,37,873,274200,96009
50,39,11,-,243800,96010
79,55,24,658,124400,96011
1766,1139,627,772,153300,96013
89,47,42,-,155500,96014
40,24,16,-,-,96015
189,153,36,945,-,96016
77,60,17,940,300000,96017
3891,2480,1411,1116,182700,96019
1124,806,318,691,212500,96020
5798,3819,1979,845,190500,96021
6243,4782,1461,892,233900,96022
503,364,139,665,105300,96023
423,345,78,1074,262500,96024
1003,627,376,891,166300,96025
934,756,178,918,242600,96027
559,468,91,656,281600,96028
61,47,14,850,303800,96029
60,55,5,-,164400,96031
1091,708,383,821,260400,96032
209,158,51,1104,117000,96033
136,96,40,846,225000,96034
1262,904,358,793,187500,96035
121,75,46,-,-,96037
266,171,95,770,164800,96038
439,258,181,705,155600,96039
63,63,0,-,210200,96040
1271,811,460,669,306400,96041
471,333,138,783,179700,96044
57,30,27,-,-,96046
350,282,68,768,306300,96047
368,321,47,690,345900,96048
27,20,7,-,"10,000-",96049
211,155,56,468,192000,96050
570,435,135,1092,220300,96051
640,469,171,788,273400,96052
144,111,33,-,-,96054
1537,1109,428,853,217700,96055
696,565,131,634,228600,96056
611,444,167,884,206200,96057
195,136,59,656,217300,96058
205,118,87,692,410700,96059
11,11,0,-,-,96061
434,330,104,1018,360300,96062
137,78,59,841,171700,96063
1875,1367,508,811,192700,96064
177,123,54,700,286800,96065
3462,2015,1447,1097,283300,96067
49,23,26,-,-,96068
366,327,39,1266,245100,96069
15,15,0,-,-,96071
1478,1301,177,2150,423700,96073
57,37,20,863,-,96074
159,132,27,-,190900,96075
135,91,44,-,227600,96076
11184,6667,4517,916,224100,96080
189,150,39,-,212500,96084
19,19,0,-,259400,96085
139,107,32,825,167600,96086
249,199,50,-,252500,96087
2092,1815,277,1417,243400,96088
219,151,68,794,167000,96090
355,275,80,795,350000,96091
116,76,40,-,290000,96092
1644,957,687,779,273800,96093
2861,1742,1119,917,211900,96094
286,243,43,857,319600,96096
4336,2768,1568,807,169300,96097
2182,1632,550,749,122000,96101
690,550,140,1122,333300,96103
348,240,108,595,159500,96104
204,204,0,-,141000,96105
122,70,52,946,388900,96106
497,373,124,866,233100,96107
55,44,11,-,44600,96108
354,266,88,699,135900,96109
53,37,16,-,-,96110
51,51,0,-,541700,96111
85,54,31,315,225000,96112
391,148,243,890,-,96113
1334,1056,278,1302,263900,96114
75,69,6,-,171600,96115
109,109,0,-,"2,000,000+",96116
154,136,18,-,219000,96117
738,467,271,933,203400,96118
19,5,14,-,-,96119
316,271,45,675,357200,96120
149,129,20,-,191800,96121
1518,1067,451,734,211400,96122
9,7,2,-,220800,96123
192,160,32,-,130100,96124
60,60,0,-,354200,96125
50,39,11,-,-,96126
302,302,0,-,224400,96128
138,138,0,-,-,96129
5023,3134,1889,985,207100,96130
27,19,8,-,-,96132
70,46,24,-,-,96133
727,463,264,659,100200,96134
125,125,0,-,-,96135
22,22,0,-,-,96136
1635,1179,456,850,200700,96137
480,353,127,1490,711800,96140
184,167,17,-,710800,96141
334,205,129,1388,450000,96142
1558,870,688,1191,478900,96143
1032,736,296,1054,666300,96145
503,290,213,1492,911900,96146
214,130,84,1625,750000,96148
11767,6111,5656,1049,442300,96150
0,0,0,-,-,96155
6927,5300,1627,1735,604100,96161
13276,8474,4802,1798,705200,96701
664,522,142,1202,439000,96703
2672,1579,1093,1277,480700,96704
812,559,253,1316,446000,96705
19748,13900,5848,2296,595600,96706
13408,9035,4373,2097,599800,96707
3788,2303,1485,1891,786000,96708
161,137,24,-,756300,96710
2481,1368,1113,1639,1099100,96712
394,240,154,-,380000,96713
358,142,216,1377,1125000,96714
877,610,267,1528,430700,96716
1241,631,610,1665,664300,96717
479,330,149,931,527100,96719
16900,10448,6452,1050,330600,96720
814,641,173,1760,759400,96722
1058,703,355,1389,642100,96725
127,57,70,-,-,96726
1474,1064,410,1036,370000,96727
194,153,41,1458,296900,96728
330,274,56,1109,153400,96729
479,303,176,1725,775600,96730
791,539,252,1622,623300,96731
7667,4668,2999,1373,603500,96732
15801,9634,6167,2832,967900,96734
1640,1193,447,875,135000,96737
2699,1971,728,1565,441000,96738
14439,9193,5246,1399,569000,96740
2051,1321,730,1410,680400,96741
39,0,39,1063,-,96742
4484,2767,1717,1648,532200,96743
16214,12188,4026,1998,788000,96744
6680,4251,2429,1463,566500,96746
240,0,240,778,-,96747
1379,941,438,874,301500,96748
5904,4867,1037,1253,292900,96749
1273,755,518,864,454600,96750
57,48,9,-,587800,96751
1151,804,347,1317,390700,96752
10780,6238,4542,1696,649400,96753
1019,776,243,1830,802100,96754
1066,784,282,1010,388400,96755
2134,1183,951,1248,658400,96756
213,141,72,1346,248400,96757
120,0,120,1322,-,96759
1113,957,156,777,253100,96760
7382,3618,3764,1563,744300,96761
885,288,597,1782,764900,96762
1181,706,475,1052,421700,96763
250,217,33,1094,479700,96764
113,43,70,1568,-,96765
4889,3131,1758,1372,553800,96766
6556,4410,2146,1549,659700,96768
108,0,108,638,-,96769
268,108,160,757,392300,96770
2862,2008,854,987,181100,96771
1003,794,209,987,264400,96772
59,35,24,-,690200,96773
119,119,0,-,261800,96774
502,337,165,895,330300,96776
488,367,121,825,173600,96777
5796,4204,1592,1129,186900,96778
797,556,241,2175,744300,96779
195,105,90,779,277200,96780
408,267,141,943,268800,96781
11435,7556,3879,1850,645000,96782
595,338,257,331,280200,96783
1493,1298,195,1247,226200,96785
12775,3423,9352,2373,582300,96786
17669,13577,4092,2026,637400,96789
3464,2308,1156,1439,976400,96790
2280,1351,929,1797,686400,96791
12098,7033,5065,1433,414600,96792
10272,6748,3524,1305,561000,96793
2226,1679,547,1237,594400,96795
691,289,402,1146,462500,96796
18782,12083,6699,1678,600000,96797
10628,4665,5963,1480,634200,96813
10611,4056,6555,1435,593800,96814
13488,5972,7516,1675,523700,96815
17225,10537,6688,1693,931100,96816
19023,7578,11445,1192,729200,96817
18373,6478,11895,2874,571100,96818
11963,5760,6203,1524,747200,96819
6523,5541,982,2363,1104000,96821
18280,9694,8586,1419,700400,96822
10254,8213,2041,2729,886500,96825
14718,4195,10523,1332,428400,96826
0,0,0,-,-,96850
0,0,0,-,-,96853
0,0,0,-,-,96857
0,0,0,-,-,96859
0,0,0,-,-,96860
0,0,0,-,-,96863
69,23,46,638,317900,97001
2413,2053,360,969,383300,97002
1707,1541,166,1206,460600,97004
11286,4071,7215,1169,330700,97005
27222,14570,12652,1424,343600,97006
25528,18311,7217,1429,372100,97007
12136,6860,5276,1238,364400,97008
2908,2474,434,1263,416200,97009
382,382,0,-,420300,97011
8718,6201,2517,997,342200,97013
585,341,244,800,257300,97014
8903,5429,3474,1358,360800,97015
2539,1977,562,717,199700,97016
1064,985,79,1078,348800,97017
763,637,126,1117,279700,97018
1217,1088,129,1059,409600,97019
331,298,33,1375,187500,97020
462,287,175,1056,225000,97021
1341,1091,250,1089,364500,97022
3867,3162,705,1154,357300,97023
4248,2572,1676,1213,292900,97024
1138,838,300,1223,252400,97026
4796,2856,1940,1334,309200,97027
105,75,30,-,352400,97028
105,55,50,933,-,97029
14800,6432,8368,1216,267800,97030
7237,4849,2388,1185,386000,97031
1689,1298,391,1250,275500,97032
35,9,26,-,-,97033
7771,6234,1537,1636,737000,97034
11305,7825,3480,1598,540700,97035
431,263,168,698,189700,97037
5633,4155,1478,1081,308100,97038
239,146,93,688,169300,97039
592,357,235,1112,388800,97040
817,602,215,901,351900,97041
1086,948,138,1019,433400,97042
20559,15467,5092,1270,381800,97045
2704,2105,599,770,243300,97048
672,592,80,1273,272900,97049
95,70,25,680,146400,97050
6383,4264,2119,913,244800,97051
1247,1134,113,858,346800,97053
580,550,30,489,263600,97054
7027,5558,1469,1191,334100,97055
4627,3423,1204,1088,314100,97056
4,3,1,-,-,97057
8122,4983,3139,831,211400,97058
7098,4827,2271,1196,305800,97060
11175,6634,4541,1324,428200,97062
460,383,77,950,174300,97063
1275,1122,153,1243,229000,97064
274,203,71,713,156100,97065
863,666,197,990,339600,97067
10994,9026,1968,1589,520900,97068
10185,4785,5400,1356,435800,97070
9188,6015,3173,1026,217400,97071
15399,11077,4322,1272,336900,97080
11378,7390,3988,1317,468300,97086
4639,4259,380,1658,433000,97089
1473,1090,383,1165,354300,97101
147,147,0,-,638500,97102
7380,4699,2681,922,276400,97103
1519,1324,195,1354,452500,97106
750,588,162,992,231300,97107
226,198,28,713,297400,97108
195,175,20,1450,448300,97109
505,193,312,819,484700,97110
1302,1043,259,1289,373200,97111
788,536,252,1083,246700,97112
4465,3499,966,1113,268700,97113
1606,1219,387,984,271500,97114
1474,1248,226,1530,338400,97115
9479,5892,3587,1074,335100,97116
262,241,21,-,419700,97117
335,225,110,1047,261700,97118
1511,1300,211,1219,387400,97119
545,321,224,878,278900,97121
168,162,6,-,251600,97122
16272,11233,5039,1306,338600,97123
20830,10343,10487,1531,371100,97124
52,52,0,-,450000,97125
1346,1188,158,1097,246000,97127
14262,9167,5095,992,259600,97128
273,211,62,1050,434000,97130
1211,951,260,1134,258400,97131
10351,7138,3213,1152,354700,97132
1766,1500,266,1130,411500,97133
173,157,16,-,385900,97134
281,243,38,-,212500,97135
714,538,176,807,229000,97136
435,279,156,927,399000,97137
4368,2323,2045,942,299900,97138
9045,7396,1649,1473,447900,97140
5347,3270,2077,854,243000,97141
65,65,0,-,424400,97144
156,100,56,870,675000,97145
2370,1754,616,1029,272400,97146
166,74,92,642,281800,97147
1346,1085,261,1357,378900,97148
345,309,36,-,343700,97149
9180,2647,6533,1432,636800,97201
18304,9296,9008,1246,544500,97202
12249,7063,5186,1194,349900,97203
384,41,343,631,473200,97204
5069,992,4077,1024,590000,97205
20618,13118,7500,1324,352800,97206
0,0,0,-,-,97208
13072,2955,10117,1204,478400,97209
6710,2649,4061,1272,770500,97210
13620,8898,4722,1464,447700,97211
10908,7322,3586,1362,651100,97212
14023,8890,5133,1203,448800,97213
13149,4198,8951,1346,581200,97214
7850,4935,2915,1308,518400,97215
6652,3377,3275,1257,306300,97216
14694,8746,5948,1354,415600,97217
5476,3365,2111,1110,360500,97218
16878,12177,4701,1353,481900,97219
11372,6397,4975,1101,315000,97220
5149,3985,1164,1221,610900,97221
15791,8551,7240,1213,312800,97222
19693,12077,7616,1228,417000,97223
14763,10053,4710,1291,411800,97224
11388,6186,5202,1381,534200,97225
2574,734,1840,1394,539600,97227
25161,17806,7355,1499,550500,97229
15147,9056,6091,1116,299600,97230
1578,1378,200,1294,625400,97231
7236,1944,5292,1297,616100,97232
13682,6274,7408,1092,252700,97233
13079,7646,5433,1154,282600,97236
9022,4314,4708,1440,593500,97239
12653,7056,5597,1202,274700,97266
13426,9658,3768,1245,339700,97267
18558,8121,10437,896,182600,97301
15794,9293,6501,948,282000,97302
14991,8865,6126,1034,261800,97303
12298,8285,4013,1061,290100,97304
14613,7990,6623,962,211300,97305
12209,7644,4565,1140,277200,97306
7758,5214,2544,1165,255900,97317
10593,7847,2746,927,284700,97321
14067,7606,6461,983,212200,97322
499,380,119,829,224200,97324
2343,1778,565,947,248100,97325
446,358,88,867,297100,97326
1289,1010,279,984,248200,97327
68,33,35,-,-,97329
18095,9147,8948,1042,350000,97330
0,0,0,-,-,97331
9497,4504,4993,1175,327000,97333
8159,6007,2152,880,253600,97338
1336,926,410,982,274400,97341
51,37,14,711,173200,97342
105,80,25,-,323500,97343
512,413,99,1037,162100,97344
204,128,76,1335,232100,97345
388,290,98,738,201300,97346
725,463,262,446,189800,97347
609,452,157,753,222000,97348
82,56,26,767,141700,97350
3676,2139,1537,1056,217900,97351
2105,1442,663,981,251600,97352
11759,7736,4023,952,219900,97355
108,97,11,-,347700,97357
1053,942,111,796,236700,97358
958,574,384,906,180200,97360
4047,2085,1962,1011,245700,97361
1610,964,646,814,284900,97362
191,124,67,-,345900,97364
4912,2779,2133,889,258700,97365
772,557,215,998,256000,97366
4532,2584,1948,922,253100,97367
1461,1049,412,967,171300,97368
92,77,15,-,271200,97369
3301,2565,736,918,293700,97370
246,152,94,-,500000,97371
0,0,0,-,-,97373
1677,1224,453,989,271600,97374
441,416,25,1589,371900,97375
550,420,130,1394,275700,97376
316,230,86,1163,327000,97377
2410,1650,760,903,220900,97378
966,681,285,939,169000,97380
5707,4180,1527,982,335800,97381
3567,2150,1417,969,254400,97383
0,0,0,-,-,97384
1221,805,416,1097,331600,97385
5538,3895,1643,919,179300,97386
365,278,87,930,376100,97388
697,483,214,1179,251800,97389
328,233,95,1060,316900,97390
2257,1599,658,933,241600,97391
2450,1949,501,1077,286500,97392
2397,1793,604,788,250200,97394
1287,890,397,928,214600,97396
21055,6104,14951,989,320900,97401
21335,10352,10983,964,219500,97402
4116,2020,2096,1026,387200,97403
13547,9326,4221,1156,252400,97404
19215,12769,6446,1088,339500,97405
30,30,0,-,-,97406
5880,3582,2298,1306,353000,97408
323,188,135,827,269400,97410
3394,2122,1272,861,255500,97411
204,177,27,1069,223600,97412
486,282,204,807,307000,97413
116,51,65,-,161900,97414
6548,4678,1870,894,283100,97415
405,299,106,621,215100,97416
1063,649,414,771,122000,97417
479,408,71,1122,291400,97419
11631,7386,4245,821,192800,97420
2927,2162,765,755,187000,97423
7212,5136,2076,909,225500,97424
3868,2826,1042,913,256000,97426
301,227,74,807,246900,97429
165,125,40,1125,257500,97430
808,702,106,689,308000,97431
342,229,113,705,293800,97434
910,723,187,775,172000,97435
318,262,56,883,239600,97436
1078,906,172,950,287000,97437
440,359,81,1077,305100,97438
7074,4932,2142,924,250300,97439
211,67,144,850,305000,97441
907,481,426,809,172700,97442
832,493,339,654,271400,97443
2547,1734,813,899,256600,97444
1937,1500,437,1075,246600,97446
247,164,83,-,-,97447
5091,3708,1383,854,278200,97448
1172,972,200,892,175000,97449
247,209,38,-,258000,97450
138,138,0,-,350000,97451
676,558,118,972,214100,97452
411,279,132,928,248600,97453
540,479,61,950,298400,97454
935,789,146,1733,350000,97455
1099,844,255,831,281000,97456
3998,3022,976,798,169700,97457
1950,1329,621,651,168600,97458
5386,3459,1927,885,217300,97459
269,223,46,-,340200,97461
1592,1154,438,708,253400,97462
1685,1068,617,781,152400,97463
1046,747,299,864,188400,97465
463,331,132,425,132300,97466
2217,1415,802,630,157900,97467
978,690,288,780,135500,97469
8830,5522,3308,837,176900,97470
12626,8848,3778,903,235300,97471
125,111,14,-,167000,97473
128,128,0,-,228300,97476
15892,7659,8233,883,214300,97477
14505,10275,4230,1048,238700,97478
4193,2952,1241,888,176900,97479
167,116,51,-,179300,97480
257,200,57,995,195700,97481
86,60,26,683,233300,97484
282,266,16,-,288300,97486
3459,2754,705,871,235200,97487
482,426,56,888,350000,97488
346,300,46,-,334900,97489
92,48,44,1222,275000,97490
243,189,54,978,169400,97492
146,116,30,745,323100,97493
46,46,0,-,-,97494
711,554,157,834,322700,97495
2998,1850,1148,808,167900,97496
644,540,104,613,247100,97497
780,573,207,1083,255100,97498
830,655,175,828,192600,97499
17855,9514,8341,936,213700,97501
11179,8207,2972,1035,275700,97502
4096,3239,857,1012,181200,97503
19469,10989,8480,1026,303900,97504
11608,6851,4757,1081,452000,97520
260,205,55,838,201300,97522
2481,1671,810,793,218000,97523
5871,4598,1273,1152,293400,97524
1828,1526,302,1031,266000,97525
15157,9361,5796,877,267500,97526
14931,10190,4741,985,268400,97527
3164,2155,1009,1099,425700,97530
270,215,55,-,235800,97531
1082,789,293,819,326100,97532
495,366,129,556,198800,97534
2509,1556,953,903,202200,97535
466,325,141,640,194200,97536
3093,2052,1041,922,275000,97537
677,584,93,713,272300,97538
1573,1198,375,1196,185100,97539
3902,2291,1611,956,249600,97540
628,473,155,911,263100,97541
277,214,63,993,328300,97543
1093,799,294,-,331000,97544
9726,5133,4593,764,176100,97601
11878,7861,4017,799,175300,97603
0,0,0,-,-,97604
95,44,51,329,130000,97620
118,118,0,-,-,97621
196,149,47,513,86600,97622
1093,931,162,722,154100,97623
1660,1367,293,802,167100,97624
102,85,17,655,-,97625
45,16,29,-,-,97626
266,253,13,-,157200,97627
2097,1393,704,754,144100,97630
565,376,189,508,119900,97632
579,434,145,688,140000,97633
71,67,4,-,161100,97634
85,70,15,-,137000,97635
204,101,103,475,94200,97636
54,35,19,625,-,97637
227,157,70,728,156500,97638
243,193,50,-,106700,97639
72,46,26,-,216700,97640
656,305,351,696,154400,97641
28405,17472,10933,1240,422100,97701
19563,13689,5874,1365,389300,97702
2592,1945,647,1221,326700,97707
53,22,31,-,300000,97710
19,16,3,-,875000,97711
28,0,28,-,-,97712
2029,1479,550,642,95700,97720
106,71,35,-,181300,97721
30,14,16,-,-,97722
101,80,21,-,451700,97730
182,27,155,-,-,97731
38,14,24,625,163600,97732
227,127,100,611,127600,97733
1075,815,260,926,216600,97734
53,53,0,-,-,97735
46,13,33,-,171900,97736
263,177,86,1188,269000,97737
744,598,146,713,134600,97738
5117,3882,1235,963,226000,97739
4406,2609,1797,844,211700,97741
153,109,44,675,167700,97750
43,34,9,-,-,97751
0,0,0,-,-,97752
927,785,142,1625,488600,97753
8580,6081,2499,840,226400,97754
14969,9788,5181,1103,291200,97756
41,22,19,-,357100,97758
3265,2614,651,1201,421700,97759
2897,2511,386,1051,274000,97760
1001,642,359,465,109600,97761
7373,4379,2994,772,179600,97801
409,316,93,850,284200,97810
356,207,149,967,118100,97812
530,382,148,885,147300,97813
5150,3595,1555,677,169800,97814
11,11,0,-,-,97817
1522,978,544,717,140900,97818
10,4,6,-,-,97819
400,317,83,592,190400,97820
455,331,124,704,109700,97823
715,549,166,884,287500,97824
116,87,29,500,162500,97825
450,238,212,751,146400,97826
1076,837,239,697,157700,97827
1451,949,502,631,222400,97828
316,250,66,672,132400,97830
346,266,80,-,278300,97833
460,317,143,692,185400,97834
121,85,36,744,187500,97835
837,515,322,875,137500,97836
38,23,15,-,96800,97837
9276,6294,2982,773,187300,97838
118,101,17,1031,153800,97839
62,40,22,-,339400,97840
205,150,55,1099,263200,97841
65,34,31,-,-,97842
254,172,82,871,155400,97843
1358,1089,269,844,133700,97844
1337,869,468,752,127400,97845
891,670,221,718,296200,97846
76,51,25,446,246900,97848
7013,4053,2960,804,184700,97850
206,125,81,513,212500,97856
209,169,40,754,275000,97857
57,52,5,-,-,97859
4295,2969,1326,636,148000,97862
112,68,44,644,270000,97864
534,402,132,524,189900,97865
295,205,90,815,147800,97867
703,524,179,763,121800,97868
410,315,95,738,142800,97869
377,294,83,600,178000,97870
144,122,22,619,76700,97873
193,152,41,595,206800,97874
1083,738,345,944,129000,97875
359,319,40,920,338100,97876
186,176,10,-,202400,97877
126,83,43,775,113800,97880
2086,1308,778,697,148200,97882
1022,781,241,869,147500,97883
71,60,11,-,211100,97884
598,417,181,725,176200,97885
419,330,89,931,123900,97886
286,189,97,670,233800,97901
25,17,8,-,-,97903
105,58,47,525,337500,97904
45,19,26,-,186500,97905
106,60,46,567,213600,97906
235,161,74,542,70500,97907
19,11,8,-,71700,97908
22,22,0,-,-,97909
207,140,67,706,164100,97910
46,21,25,575,137500,97911
1778,1090,688,657,118300,97913
5948,3384,2564,694,137700,97914
1555,886,669,714,137200,97918
57,45,12,-,189500,97920
11247,8822,2425,1457,339600,98001
13475,6261,7214,1150,238100,98002
18547,9150,9397,1218,287300,98003
17070,7166,9904,2151,1207200,98004
8008,4237,3771,1874,839100,98005
13337,10376,2961,2217,863000,98006
11859,4102,7757,1761,629300,98007
9278,6830,2448,1879,715300,98008
2135,1797,338,-,443800,98010
13304,8711,4593,1664,543400,98011
24246,16599,7647,1806,502000,98012
2656,2303,353,1536,556500,98014
4100,3794,306,2060,500000,98019
8602,6318,2284,1601,611200,98020
10817,8542,2275,1917,557300,98021
8461,6015,2446,1194,364700,98022
17782,11297,6485,1498,346800,98023
2373,2013,360,1532,713100,98024
14818,11011,3807,1460,477300,98026
11945,8466,3479,1800,661300,98027
8876,6453,2423,1433,573700,98028
11271,7532,3739,2279,660300,98029
12615,6182,6433,1367,349800,98030
12333,8406,3927,1396,355400,98031
13956,5634,8322,1365,299700,98032
16524,10799,5725,1949,836300,98033
17646,10655,6991,1817,557600,98034
14952,9305,5647,1387,438800,98036
11162,6439,4723,1472,433200,98037
12127,10397,1730,1874,439600,98038
1195,1032,163,2855,"2,000,000+",98039
10199,7005,3194,2162,1218200,98040
16686,13888,2798,1641,380600,98042
8557,4582,3975,1464,392600,98043
5666,4693,973,1477,488400,98045
2316,1165,1151,1231,279000,98047
155,155,0,-,-,98050
1622,1328,294,1533,468700,98051
28022,14632,13390,1927,725300,98052
8163,6980,1183,2065,776400,98053
9618,4774,4844,1638,375000,98055
14049,8033,6016,1579,487800,98056
6023,1552,4471,1300,364800,98057
15830,11432,4398,1638,403100,98058
13795,10560,3235,1808,538000,98059
5189,4423,766,1870,605800,98065
208,201,7,-,524700,98068
4664,3734,930,1126,524200,98070
9205,6745,2460,1876,674200,98072
9455,8470,985,2101,810800,98074
7860,6674,1186,2445,913100,98075
4566,4265,301,1993,803300,98077
14677,7295,7382,1635,396600,98087
16397,11641,4756,1411,379300,98092
9199,1597,7602,1817,661700,98101
15650,4393,11257,1650,762500,98102
24994,11643,13351,1681,739100,98103
8286,1059,7227,1218,592900,98104
17146,5600,11546,1456,895300,98105
11001,5434,5567,1241,432400,98106
14213,5194,9019,1770,713400,98107
8491,4466,4025,1236,459400,98108
17342,4173,13169,1874,727300,98109
10115,8036,2079,1555,705400,98110
11648,6457,5191,1660,998200,98112
22922,14079,8843,1745,751900,98115
12997,7653,5344,1647,709300,98116
14965,10766,4199,1757,706400,98117
17318,10403,6915,1415,487100,98118
12769,5206,7563,1673,858500,98119
12943,2962,9981,1975,613300,98121
19467,6328,13139,1627,665900,98122
19283,8885,10398,1495,558900,98125
10362,5896,4466,1428,563100,98126
21650,10333,11317,1419,494700,98133
221,101,120,2106,377000,98134
7612,5269,2343,1555,673600,98136
13947,6668,7279,1371,667000,98144
10200,6362,3838,1332,429300,98146
4616,1855,2761,1335,363200,98148
0,0,0,-,-,98154
13602,9460,4142,1522,528000,98155
0,0,0,-,-,98158
129,94,35,-,678000,98164
8786,5577,3209,1253,513900,98166
11818,6350,5468,1242,330300,98168
0,0,0,-,-,98174
8280,6543,1737,1512,732800,98177
9895,6305,3590,1425,397200,98178
9217,4000,5217,1243,314600,98188
0,0,0,-,-,98195
14020,7802,6218,1401,352900,98198
9883,6203,3680,1718,835500,98199
12942,5161,7781,1043,305300,98201
13903,8315,5588,1353,349200,98203
17032,6182,10850,1335,252300,98204
5203,4301,902,1757,360400,98205
0,0,0,-,-,98207
20690,14499,6191,1534,395300,98208
240,199,41,-,348500,98220
9591,6727,2864,1194,429300,98221
48,48,0,-,700000,98222
16390,12486,3904,1345,361800,98223
121,102,19,1352,219600,98224
21229,8428,12801,1042,389000,98225
17584,10557,7027,1100,357800,98226
13132,9204,3928,1124,383600,98229
7423,5851,1572,1094,294600,98230
1689,1285,404,1757,408000,98232
6331,3979,2352,1132,276600,98233
38,38,0,-,186500,98235
2550,1936,614,1149,426800,98236
1826,1369,457,952,193300,98237
0,0,0,-,-,98238
3433,2824,609,952,376700,98239
1160,981,179,1129,322200,98240
833,550,283,919,173500,98241
277,206,71,1071,648800,98243
1121,791,330,832,310900,98244
1913,1404,509,977,465500,98245
3209,2260,949,990,303500,98247
9150,6881,2269,974,337500,98248
2122,1545,577,1288,412000,98249
3823,2752,1071,1030,492900,98250
1838,1456,382,1096,223100,98251
3745,2800,945,1156,291800,98252
897,851,46,-,503000,98253
73,60,13,-,168300,98255
159,106,53,1013,219200,98256
1934,1433,501,970,316500,98257
11498,9012,2486,1604,376400,98258
2709,2067,642,1198,443300,98260
1409,1104,305,998,453800,98261
473,391,82,1070,408400,98262
34,27,7,-,198800,98263
7507,5061,2446,1149,346500,98264
1520,892,628,949,156500,98266
141,103,38,-,117500,98267
17791,11985,5806,1373,332000,98270
10990,8091,2899,1410,324100,98271
9160,6968,2192,1395,385700,98272
11182,6787,4395,965,280500,98273
6796,5410,1386,1252,317800,98274
8176,5831,2345,1796,582700,98275
194,164,30,1083,283300,98276
15825,9160,6665,1243,292000,98277
0,0,0,-,-,98278
339,251,88,964,579900,98279
258,231,27,888,492200,98280
643,541,102,803,241900,98281
7232,6464,768,1238,398200,98282
161,127,34,-,238000,98283
9628,6548,3080,1125,265400,98284
82,61,21,830,802100,98286
110,78,32,950,281300,98288
13073,10374,2699,1131,457500,98290
8380,6807,1573,1190,380400,98292
2699,1993,706,1165,287200,98294
954,692,262,820,232700,98295
10096,8912,1184,1936,553800,98296
25,23,2,-,202800,98297
628,577,51,-,273400,98303
459,315,144,746,123500,98304
155,140,15,-,220000,98305
8981,4499,4482,1041,257100,98310
10498,7422,3076,1337,275900,98311
12810,7939,4871,1087,269400,98312
16,0,16,2000,-,98314
1152,0,1152,1656,-,98315
629,537,92,875,207800,98320
5591,4528,1063,1360,340200,98321
264,236,28,1385,239200,98323
668,547,121,631,227600,98325
348,176,172,737,107000,98326
3831,2034,1797,1787,328900,98327
3827,3214,613,1162,293100,98328
3861,3237,624,1322,305000,98329
67,67,0,-,-,98330
2411,1501,910,647,173600,98331
6970,5827,1143,1600,461100,98332
1480,1414,66,1588,642000,98333
10100,7513,2587,1433,478300,98335
344,290,54,580,153200,98336
3511,1548,1963,975,213400,98337
9889,8560,1329,1411,284500,98338
1452,923,529,818,257900,98339
1434,1292,142,948,294900,98340
584,450,134,1250,447200,98342
239,79,160,988,461100,98345
3898,3015,883,1131,369700,98346
1700,1324,376,944,238800,98349
119,60,59,485,56700,98350
557,440,117,805,381600,98351
18,0,18,-,-,98353
2982,1769,1213,1311,307500,98354
352,295,57,-,109100,98355
754,606,148,900,168000,98356
477,338,139,469,87700,98357
424,315,109,1125,530300,98358
1901,1640,261,1133,372800,98359
4688,3897,791,1626,298200,98360
440,329,111,969,155800,98361
10498,6942,3556,878,239600,98362
5786,4113,1673,979,236400,98363
44,0,44,-,-,98364
2490,2115,375,1689,382000,98365
13391,8489,4902,1209,281500,98366
11062,9247,1815,1334,317900,98367
7619,5355,2264,949,350400,98368
12393,9622,2771,1426,375100,98370
8510,5807,2703,1170,320000,98371
10363,5866,4497,1321,345100,98372
9423,5365,4058,1330,318100,98373
14515,10219,4296,1585,311500,98374
9949,7510,2439,1738,284000,98375
886,706,180,853,302400,98376
911,587,324,640,144700,98377
1720,1395,325,1116,388700,98380
140,96,44,850,165200,98381
13561,10253,3308,1073,295400,98382
8720,4765,3955,1437,363700,98383
175,159,16,1250,304800,98385
16318,11928,4390,1297,240100,98387
2495,1617,878,1152,361300,98388
4456,2303,2153,1190,336700,98390
17728,15165,2563,1543,351100,98391
1379,990,389,1083,279200,98392
560,483,77,1181,337500,98394
282,208,74,1385,244300,98396
3604,598,3006,1173,390300,98402
4178,1593,2585,1003,437600,98403
11692,7155,4537,1066,210600,98404
9800,4526,5274,1054,262600,98405
9753,6409,3344,1176,351300,98406
9298,5582,3716,1409,377200,98407
7725,4524,3201,1299,222200,98408
10267,3665,6602,1204,212100,98409
0,0,0,-,-,98416
3828,2418,1410,1162,222800,98418
0,0,0,-,-,98421
7771,5969,1802,1658,389700,98422
4186,1805,2381,1354,299500,98424
0,0,0,-,-,98430
4249,66,4183,1729,-,98433
4,0,4,-,-,98438
2058,277,1781,1153,18400,98439
2143,1794,349,1204,305300,98443
12950,5112,7838,1086,211200,98444
11237,7575,3662,1271,251700,98445
3959,2831,1128,1103,291400,98446
0,0,0,-,-,98447
3126,1484,1642,1114,358100,98465
11915,6034,5881,1207,354200,98466
6044,3224,2820,1172,378000,98467
11277,6658,4619,1180,282900,98498
13173,4448,8725,980,245000,98499
17413,10244,7169,1162,330500,98501
14290,7973,6317,1172,365900,98502
15810,8587,7223,1211,247100,98503
7666,5049,2617,1033,315500,98506
12316,8333,3983,1237,296800,98512
13381,9409,3972,1485,262600,98513
10079,7417,2662,1417,335200,98516
8193,4847,3346,757,156500,98520
1491,1236,255,858,323500,98524
76,49,27,725,170800,98526
149,143,6,-,89500,98527
4109,3247,862,959,242200,98528
234,156,78,872,150700,98530
10183,6167,4016,877,175900,98531
9134,6606,2528,918,256500,98532
198,193,5,-,210600,98533
355,292,63,-,-,98535
54,54,0,-,266300,98536
855,642,213,903,172800,98537
144,97,47,1016,270800,98538
4078,2757,1321,718,175000,98541
215,180,35,-,298400,98542
21,21,0,-,-,98544
1338,1059,279,1163,302600,98546
753,597,156,800,165200,98547
1107,1004,103,1220,174900,98548
4864,2931,1933,751,143000,98550
183,171,12,725,114900,98552
204,204,0,-,188900,98555
1356,1032,324,960,189500,98557
90,31,59,-,-,98558
0,0,0,-,-,98559
66,66,0,-,268300,98560
47,0,47,-,-,98562
3045,2517,528,725,214500,98563
970,802,168,673,195100,98564
283,189,94,920,177400,98565
1013,753,260,779,208000,98568
3317,2426,891,936,232600,98569
1555,1291,264,784,232200,98570
89,36,53,-,-,98571
280,207,73,628,145600,98572
65,54,11,-,158300,98575
1996,1638,358,964,263100,98576
2791,2289,502,743,160800,98577
4871,4053,818,1072,247700,98579
4263,3272,991,1259,276700,98580
335,313,22,-,128200,98581
98,98,0,-,-,98582
64,35,29,-,-,98583
13696,9996,3700,963,207100,98584
430,300,130,983,267900,98585
625,443,182,548,133000,98586
239,163,76,513,100900,98587
892,705,187,1373,231300,98588
2909,2160,749,1110,261800,98589
129,108,21,327,145000,98590
1505,1237,268,712,251100,98591
780,747,33,-,278500,98592
395,324,71,823,131700,98593
1095,747,348,802,192600,98595
2739,2127,612,1003,206500,98596
8507,6462,2045,1359,240100,98597
1088,801,287,1314,331700,98601
77,68,9,-,-,98602
503,444,59,-,270600,98603
12310,9784,2526,1268,352100,98604
454,290,164,1014,234100,98605
3053,2781,272,1008,464300,98606
11294,8757,2537,1336,437000,98607
1255,809,446,1019,220100,98610
3509,2843,666,901,236600,98611
1254,1093,161,756,226000,98612
158,117,41,1125,212000,98613
86,86,0,-,-,98614
50,50,0,-,339000,98616
492,292,200,944,181600,98617
232,162,70,818,226100,98619
3217,2147,1070,743,178600,98620
138,127,11,-,193500,98621
637,462,175,823,231100,98624
2658,2164,494,776,292500,98625
9391,6346,3045,812,200000,98626
135,73,62,778,127100,98628
3113,2682,431,1569,376300,98629
1601,1080,521,679,199000,98631
20963,12276,8687,864,200100,98632
762,517,245,878,270800,98635
551,454,97,970,217800,98638
426,263,163,820,256500,98639
2200,1978,222,949,188000,98640
11,11,0,-,-,98641
6990,5890,1100,1618,424800,98642
192,183,9,-,209700,98643
212,152,60,673,205400,98644
560,460,100,883,256900,98645
186,158,28,-,166400,98647
1300,920,380,810,297200,98648
347,285,62,-,259600,98649
360,285,75,870,404700,98650
387,310,77,1068,402600,98651
5591,2515,3076,915,290800,98660
18797,8364,10433,1112,273100,98661
12362,8147,4215,1387,276100,98662
6130,3578,2552,1080,282200,98663
9188,5485,3703,1227,294000,98664
10061,6334,3727,1212,289200,98665
22,22,0,-,270000,98670
8600,6914,1686,1180,355400,98671
2804,1991,813,1032,367000,98672
210,123,87,915,133700,98673
4659,3330,1329,876,307100,98674
2116,1860,256,1020,339700,98675
20854,14849,6005,1397,283100,98682
13759,7743,6016,1372,339100,98683
10891,6277,4614,1410,295000,98684
10760,8681,2079,1469,370500,98685
7912,5831,2081,1406,360300,98686
15998,9601,6397,938,270700,98801
11442,8069,3373,959,293200,98802
64,35,29,-,70700,98811
1711,859,852,750,160400,98812
817,452,365,692,104700,98813
427,323,104,850,391100,98814
2646,1842,804,796,279200,98815
2344,1475,869,880,369000,98816
87,87,0,-,-,98817
125,72,53,546,180000,98819
96,96,0,-,357500,98821
749,581,168,1091,257600,98822
3959,2749,1210,717,171000,98823
101,34,67,680,150000,98824
3118,2187,931,956,397300,98826
191,46,145,-,-,98827
881,697,184,844,295400,98828
181,135,46,-,350000,98829
285,182,103,575,132600,98830
1341,824,517,651,279000,98831
85,69,16,-,155800,98832
63,51,12,-,-,98833
87,79,8,-,253100,98834
320,219,101,-,-,98836
15087,9084,6003,849,191000,98837
1981,1167,814,636,159100,98840
3914,2593,1321,707,165400,98841
666,304,362,532,356500,98843
2094,1470,624,635,168800,98844
130,97,33,813,252400,98845
445,284,161,691,282400,98846
735,640,95,588,339800,98847
3417,2220,1197,756,173700,98848
528,315,213,835,194600,98849
566,392,174,1052,173700,98850
1743,1309,434,631,149700,98851
7,4,3,-,-,98852
7,7,0,-,-,98853
2592,1815,777,745,166300,98855
1104,789,315,806,313100,98856
1177,827,350,672,144000,98857
806,614,192,742,177200,98858
91,91,0,-,110400,98859
116,93,23,843,84400,98860
1175,868,307,767,372400,98862
10635,5548,5087,730,170300,98901
16464,8606,7858,779,150300,98902
5387,4050,1337,898,166300,98903
14574,10527,4047,1058,235000,98908
59,0,59,-,-,98921
3028,2148,880,891,307800,98922
422,174,248,1080,112500,98923
285,241,44,-,356400,98925
13327,7312,6015,1008,286600,98926
0,0,0,-,-,98929
4425,2729,1696,775,166300,98930
1409,814,595,844,129300,98932
345,229,116,861,151300,98933
460,244,216,967,154500,98934
1061,726,335,836,111100,98935
1981,1606,375,1183,184500,98936
1658,1146,512,813,213600,98937
729,502,227,1171,217400,98938
44,44,0,-,-,98939
136,117,19,-,405600,98940
277,196,81,930,302900,98941
6605,4520,2085,978,235100,98942
393,255,138,1215,192500,98943
6388,4041,2347,739,154000,98944
251,177,74,1018,366100,98946
967,617,350,690,166300,98947
3751,2268,1483,675,137400,98948
23,10,13,-,-,98950
3530,2077,1453,693,135600,98951
561,316,245,557,110600,98952
2293,1751,542,956,189500,98953
1606,802,804,918,163100,99001
1817,1577,240,767,302700,99003
7933,4463,3470,894,225100,99004
3032,2713,319,1595,328300,99005
4808,4345,463,766,240400,99006
233,169,64,792,166100,99008
1619,1351,268,641,180700,99009
804,6,798,1341,-,99011
335,255,80,736,158100,99012
686,448,238,387,170800,99013
6207,4633,1574,1166,248900,99016
52,47,5,-,103100,99017
98,76,22,925,191700,99018
4919,3417,1502,1129,313000,99019
0,0,0,-,-,99020
3709,3280,429,964,264600,99021
3124,2311,813,739,218600,99022
234,220,14,-,340000,99023
2029,1806,223,742,281500,99025
3313,3101,212,-,269200,99026
2457,2246,211,1324,241000,99027
469,388,81,636,237500,99029
439,399,40,830,163100,99030
553,422,131,639,244000,99031
314,249,65,859,106000,99032
314,231,83,570,123200,99033
16,16,0,-,-,99034
644,558,86,950,410600,99036
5978,3816,2162,974,258900,99037
32,23,9,525,102100,99039
293,212,81,458,100000,99040
549,495,54,752,191600,99101
230,151,79,719,136700,99102
216,176,40,950,185000,99103
19,13,6,-,83000,99105
2055,1431,624,573,196400,99109
672,424,248,711,256900,99110
1689,1003,686,721,172500,99111
324,270,54,822,224300,99113
5127,3728,1399,715,193600,99114
467,356,111,575,140300,99115
718,543,175,752,147800,99116
211,168,43,609,122000,99117
319,222,97,808,227100,99118
553,484,69,681,159800,99119
91,64,27,-,204500,99121
1663,1330,333,793,195700,99122
392,314,78,763,201700,99123
138,106,32,731,102100,99124
241,169,72,650,100900,99125
375,292,83,745,136500,99126
144,126,18,-,171300,99128
321,244,77,478,115600,99129
369,272,97,928,161800,99130
93,88,5,-,238500,99131
813,511,302,638,118600,99133
248,185,63,793,98900,99134
113,82,31,600,160700,99135
11,11,0,-,-,99136
164,111,53,583,192200,99137
436,296,140,563,155400,99138
498,412,86,733,228400,99139
170,102,68,434,167900,99140
2127,1572,555,674,169700,99141
323,258,65,589,98000,99143
11,7,4,-,-,99144
21,21,0,-,232800,99146
73,73,0,-,340500,99147
892,785,107,768,225000,99148
113,101,12,-,58800,99149
146,131,15,-,230100,99150
49,39,10,-,129900,99151
47,41,6,-,171900,99152
235,116,119,536,150700,99153
11,11,0,-,154200,99154
407,216,191,480,93300,99155
3662,2854,808,823,226600,99156
338,237,101,713,139600,99157
224,165,59,850,148500,99158
653,477,176,823,105600,99159
70,66,4,-,185400,99160
656,551,105,545,188200,99161
12168,3671,8497,834,270600,99163
0,0,0,-,-,99164
1359,904,455,683,152800,99166
251,236,15,688,183300,99167
1091,723,368,731,128800,99169
406,317,89,596,124000,99170
508,363,145,638,151600,99171
642,522,120,644,152400,99173
24,14,10,-,105000,99174
77,53,24,831,201500,99176
178,134,44,850,262100,99179
466,382,84,737,225900,99180
712,581,131,746,166900,99181
538,425,113,799,167900,99185
6983,2014,4969,657,168000,99201
7534,3138,4396,817,158800,99202
9051,6809,2242,1098,281600,99203
3482,1065,2417,731,206800,99204
18221,11808,6413,991,161200,99205
15374,9259,6115,879,224200,99206
12204,6144,6060,888,128800,99207
21836,13989,7847,877,249000,99208
8729,6005,2724,971,176300,99212
10886,5162,5724,952,202600,99216
6805,4449,2356,959,187400,99217
6189,3119,3070,869,264700,99218
13517,8299,5218,964,282800,99223
8964,6020,2944,969,268400,99224
23938,16741,7197,924,206500,99301
3739,2973,766,907,188400,99320
107,43,64,-,-,99321
103,86,17,575,172400,99322
1303,1063,240,913,215000,99323
3759,2278,1481,932,202700,99324
1334,756,578,798,133200,99326
1635,1117,518,783,181000,99328
59,46,13,956,133300,99329
320,249,71,-,164800,99330
17,12,5,-,-,99333
102,71,31,570,97500,99335
18815,9394,9421,908,183300,99336
11260,9871,1389,1054,218500,99337
5580,5172,408,1146,327700,99338
295,188,107,760,128700,99341
839,390,449,697,-,99343
4941,3048,1893,833,162500,99344
44,29,15,813,245800,99345
219,190,29,827,183500,99346
991,700,291,596,149400,99347
468,159,309,696,152500,99348
2216,1114,1102,798,193900,99349
4897,2974,1923,805,211400,99350
12877,8648,4229,1133,297700,99352
5342,4564,778,1307,279300,99353
9175,5637,3538,1005,230200,99354
60,33,27,706,102500,99356
1031,495,536,750,190400,99357
94,67,27,481,-,99359
555,431,124,989,284100,99360
750,604,146,689,210400,99361
15717,10082,5635,950,233300,99362
87,50,37,-,192500,99363
132,92,40,692,66300,99371
176,176,0,-,263200,99401
608,452,156,727,223600,99402
8338,5820,2518,801,195800,99403
7545,2553,4992,1056,346700,99501
9009,5865,3144,1323,336800,99502
5823,1778,4045,1018,239000,99503
14872,9857,5015,1399,250700,99504
1139,0,1139,2275,-,99505
2181,9,2172,1842,-,99506
13796,9592,4204,1416,307000,99507
12458,6578,5880,1149,252400,99508
0,0,0,-,-,99510
0,0,0,-,-,99513
7939,6212,1727,1575,325600,99515
7141,6620,521,2114,464300,99516
6794,3875,2919,1346,316300,99517
4280,2670,1610,1500,262400,99518
0,0,0,-,-,99519
201,115,86,805,293100,99540
58,23,35,1313,25800,99546
12,8,4,-,95000,99547
23,19,4,-,117500,99548
29,23,6,-,55000,99549
78,73,5,-,154200,99550
135,102,33,475,54300,99551
78,59,19,950,52500,99552
65,48,17,-,97500,99553
160,127,33,771,100800,99554
60,42,18,1125,208300,99555
1016,897,119,933,186000,99556
204,138,66,1113,189600,99557
38,25,13,1063,43800,99558
2222,926,1296,1523,259400,99559
83,68,15,725,45700,99561
181,152,29,-,60700,99563
18,13,5,725,-,99564
25,19,6,-,212500,99565
12,5,7,-,-,99566
3036,2508,528,957,333200,99567
162,154,8,-,203300,99568
17,11,6,-,95000,99569
69,33,36,900,123400,99571
156,129,27,-,349400,99572
206,163,43,727,158600,99573
835,600,235,1105,329300,99574
28,18,10,-,-,99575
818,466,352,1177,254600,99576
9509,6795,2714,1857,345100,99577
126,85,41,469,53500,99578
9,8,1,-,65000,99579
28,26,2,-,110700,99580
209,151,58,806,90700,99581
21,3,18,-,-,99583
61,33,28,475,56900,99585
102,74,28,413,333300,99586
783,331,452,1306,434300,99587
262,195,67,863,212300,99588
44,31,13,375,61000,99589
58,38,20,525,50000,99590
26,17,9,-,75000,99591
71,55,16,625,43500,99602
4047,2818,1229,1002,286100,99603
204,140,64,525,60000,99604
42,42,0,-,340900,99605
105,70,35,719,108300,99606
65,47,18,1000,128100,99607
96,77,19,675,45600,99609
812,661,151,1083,234500,99610
5839,4257,1582,961,231000,99611
311,195,116,923,121000,99612
150,71,79,1198,179700,99613
129,96,33,-,58200,99614
4001,2114,1887,1468,289100,99615
177,141,36,625,58600,99620
141,103,38,525,59200,99621
82,65,17,-,91700,99622
22,17,5,1125,87500,99624
35,26,9,-,65000,99625
58,45,13,508,156300,99626
134,86,48,975,70000,99627
144,98,46,675,67500,99628
87,76,11,675,84200,99630
106,57,49,-,263200,99631
168,105,63,540,61800,99632
164,105,59,1034,213100,99633
121,89,32,440,35600,99634
124,80,44,625,116700,99636
121,83,38,563,69000,99637
9,6,3,1125,26300,99638
436,352,84,742,211400,99639
52,35,17,788,156300,99640
135,101,34,625,52500,99641
88,66,22,925,86700,99643
72,56,16,-,-,99644
8617,6703,1914,1109,260000,99645
11,11,0,-,-,99647
29,25,4,-,83000,99648
33,26,7,763,85000,99649
127,79,48,575,52700,99650
5,4,1,-,-,99651
1175,902,273,973,201700,99652
32,11,21,850,-,99653
18523,14095,4428,1142,253900,99654
163,135,28,638,24200,99655
8,8,0,-,-,99656
45,32,13,-,96700,99657
236,177,59,738,85800,99658
89,53,36,1125,95000,99659
119,65,54,920,85900,99660
424,289,135,988,127200,99661
121,71,50,625,61300,99662
172,130,42,725,214500,99663
1453,839,614,950,226200,99664
24,9,15,375,62500,99665
35,28,7,-,54000,99666
52,52,0,-,237500,99667
32,24,8,-,120000,99668
5947,4291,1656,1091,243900,99669
20,8,12,1083,137500,99670
130,94,36,450,115600,99671
1332,1046,286,942,266800,99672
553,436,117,980,168200,99674
600,467,133,1186,217500,99676
16,12,4,-,93300,99677
236,162,74,600,68300,99678
66,37,29,683,33100,99679
141,96,45,483,60000,99680
82,61,21,850,-,99681
110,77,33,1000,32200,99682
188,178,10,-,121200,99683
170,115,55,1188,112500,99684
900,216,684,1446,368000,99685
1559,1241,318,1192,169400,99686
981,805,176,1133,190000,99688
219,145,74,900,202300,99689
35,35,0,-,57500,99690
50,33,17,-,51500,99691
63,0,63,1250,-,99692
124,47,77,875,63100,99693
513,406,107,993,167700,99694
0,0,0,-,-,99695
6653,2852,3801,1182,192400,99701
1003,4,999,2053,-,99702
2061,11,2050,2044,-,99703
0,0,0,-,-,99704
8200,5712,2488,1241,225200,99705
3,3,0,-,-,99706
11890,7573,4317,1134,253600,99709
5806,4847,959,1054,273000,99712
449,326,123,1336,169000,99714
69,43,26,389,52500,99720
61,45,16,825,134700,99721
54,41,13,-,108000,99722
1356,616,740,1039,185000,99723
29,18,11,-,95000,99724
10,7,3,-,66300,99726
114,82,32,917,87300,99727
93,80,13,700,153600,99729
34,31,3,-,65000,99730
7,0,7,-,-,99732
21,12,9,-,-,99733
0,0,0,-,-,99734
34,22,12,1083,60000,99736
1407,1064,343,1148,192000,99737
66,46,20,575,98800,99738
67,48,19,738,49200,99739
219,160,59,900,106400,99740
183,138,45,1250,119800,99741
152,130,22,1025,58300,99742
365,302,63,875,256500,99743
56,47,9,950,120300,99744
36,17,19,-,71000,99745
100,88,12,725,53800,99746
56,44,12,950,96700,99747
56,38,18,708,-,99748
77,60,17,858,108900,99749
114,86,28,717,86000,99750
26,16,10,775,133300,99751
949,400,549,1453,236500,99752
89,53,36,610,88800,99753
37,33,4,-,57500,99754
86,58,28,729,360700,99755
25,19,6,767,88300,99756
17,17,0,-,-,99757
63,33,30,781,43800,99758
52,23,29,788,106300,99759
207,167,40,650,108000,99760
93,72,21,-,80000,99761
1453,717,736,1489,241900,99762
116,67,49,620,114600,99763
90,57,33,1675,97000,99764
74,60,14,-,56300,99765
149,119,30,933,92300,99766
16,14,2,-,75000,99767
59,47,12,331,79200,99768
199,175,24,950,97500,99769
155,115,40,788,83600,99770
85,68,17,950,85000,99771
136,90,46,843,78300,99772
58,44,14,867,96700,99773
8,2,6,-,-,99774
129,0,129,1215,-,99775
32,23,9,-,87500,99776
81,49,32,613,53200,99777
60,39,21,440,113400,99778
636,446,190,714,158500,99780
48,35,13,488,21900,99781
135,88,47,788,95000,99782
55,41,14,-,72500,99783
63,37,26,881,101600,99784
96,60,36,706,85000,99785
59,45,14,-,102100,99786
32,26,6,-,80000,99788
108,62,46,888,91300,99789
15,15,0,-,-,99790
42,33,9,1250,112500,99791
11662,7697,3965,1321,346000,99801
134,85,49,508,144600,99820
1014,515,499,1228,344900,99824
33,27,6,-,308300,99825
196,167,29,1042,258700,99826
1039,693,346,948,251200,99827
277,190,87,1038,205400,99829
194,139,55,925,144300,99830
52,44,8,-,-,99832
1187,817,370,954,227400,99833
3547,2102,1445,1131,358600,99835
33,30,3,-,110000,99836
375,200,175,1004,338500,99840
67,60,7,-,253800,99841
5397,3322,2075,1169,289900,99901
0,0,0,-,-,99903
102,88,14,-,284600,99918
293,237,56,832,164000,99919
814,543,271,865,225700,99921
117,83,34,613,110500,99922
14,14,0,-,-,99923
317,230,87,735,183300,99925
487,361,126,663,155100,99926
0,0,0,-,-,99927
1027,697,330,844,216200,99929
