housing_units_occ,homeowner_units_occ,renters_units_occ,med_rent,med_household_price,zip
5555,3562,1993,385,81800,601
12901,9867,3034,393,85600,602
19431,11098,8333,418,116000,603
1983,1490,493,353,86000,606
8864,6576,2288,433,87100,610
23327,14462,8865,394,96200,612
3478,2680,798,356,95100,616
8097,5939,2158,520,101400,617
2282,1678,604,442,116400,622
13929,9503,4426,479,103700,623
7312,5261,2051,438,77900,624
11349,8532,2817,489,93300,627
608,329,279,228,91000,631
7032,5386,1646,428,95700,637
5850,4170,1680,382,88000,638
9459,5417,4042,403,88900,641
11860,9251,2609,577,133400,646
1979,1494,485,-,83100,647
5092,3490,1602,561,94900,650
1401,1149,252,646,96900,652
3644,2442,1202,291,84100,653
6521,4719,1802,351,78200,656
13914,10318,3596,446,90700,659
6291,4559,1732,433,100500,660
14313,8946,5367,468,106800,662
5064,2907,2157,383,94100,664
8046,5248,2798,469,89000,667
9701,6178,3523,454,86800,669
2696,2042,654,273,85300,670
14885,10890,3995,511,105200,674
13523,8506,5017,409,89900,676
5467,3776,1691,484,124800,677
8911,6144,2767,459,98200,678
18449,10518,7931,426,87400,680
11640,6227,5413,404,114400,682
10877,7615,3262,418,80200,683
13881,9377,4504,403,96100,685
9691,6992,2699,497,103900,687
4112,2824,1288,450,89200,688
2343,1775,568,599,116300,690
11580,7903,3677,548,118700,692
19633,15125,4508,494,104500,693
16,16,0,-,-,694
11593,8634,2959,406,91500,698
8597,5596,3001,448,119500,703
2476,1989,487,520,80600,704
8750,6800,1950,478,109500,705
3874,2733,1141,424,84600,707
6057,4755,1302,435,87000,714
979,753,226,335,84300,715
11180,6979,4201,385,113400,716
6760,3178,3582,314,105200,717
8211,6213,1998,467,92900,718
8615,6026,2589,492,90300,719
6789,4589,2200,422,83800,720
6120,4187,1933,329,89300,723
30383,19679,10704,490,122200,725
19338,13805,5533,746,134100,727
13430,10401,3029,414,99600,728
16608,12240,4368,535,104400,729
11748,7512,4236,406,93100,730
4265,3003,1262,441,77800,731
4326,3104,1222,492,93100,735
17321,10929,6392,482,122100,736
11672,7883,3789,539,103200,738
11870,7612,4258,498,120500,739
740,297,443,369,81200,740
1336,1018,318,548,85600,741
15782,11816,3966,540,114700,745
7751,6106,1645,427,82500,751
13580,10149,3431,521,108500,754
7368,5780,1588,522,93000,757
2376,1674,702,612,96900,765
8100,5802,2298,434,90700,766
11687,8387,3300,454,87000,767
13130,10048,3082,467,91800,769
11904,9340,2564,548,115700,771
6633,4327,2306,371,89200,772
6660,4680,1980,470,111000,773
502,314,188,542,166700,775
13313,9575,3738,455,103000,777
14645,11684,2961,646,140600,778
4030,3466,564,776,95000,780
4906,2243,2663,481,101700,782
10624,7724,2900,529,98100,783
13902,9800,4102,385,84500,784
81,81,0,-,111600,786
16480,11874,4606,421,101000,791
8863,6202,2661,415,108700,794
14933,10906,4027,531,93000,795
3047,1160,1887,555,321800,901
102,86,16,-,370500,906
8504,5250,3254,859,234700,907
2353,1054,1299,503,129700,909
3757,1932,1825,715,294700,911
2734,1561,1173,578,124900,912
3186,536,2650,223,385700,913
10772,4529,6243,413,87200,915
8391,3909,4482,485,113800,917
7885,3867,4018,443,166400,918
6947,3876,3071,699,137700,920
13656,6552,7104,563,128400,921
10259,4505,5754,403,109200,923
19540,10526,9014,410,126700,924
3412,719,2693,444,132400,925
36288,25819,10469,584,168300,926
6043,3164,2879,533,197100,927
29,0,29,-,-,934
0,0,0,-,-,936
26044,19580,6464,615,124500,949
0,0,0,-,-,950
0,0,0,-,-,951
2832,1847,985,489,97400,952
22037,17984,4053,675,133100,953
24307,16959,7348,565,118800,956
14578,10409,4169,543,127800,957
17919,11615,6304,578,135900,959
0,0,0,-,-,960
11079,7247,3832,596,149400,961
6800,3777,3023,447,105500,962
2694,1568,1126,475,82500,965
5924,4225,1699,966,234900,966
1820,1301,519,865,197600,968
14606,10930,3676,810,216300,969
8828,5804,3024,623,131100,971
21565,14587,6978,545,143900,976
8662,5588,3074,917,167500,979
5809,3950,1859,580,134300,982
13143,8788,4355,551,132200,983
12167,8572,3595,533,129400,985
20296,14987,5309,721,138400,987
6871,5053,1818,1165,220900,1001
10182,5054,5128,1276,366900,1002
23,4,19,-,-,1003
1883,1743,140,1133,257200,1005
5667,4685,982,984,277000,1007
453,429,24,-,230200,1008
253,227,26,-,205700,1009
1494,1296,198,835,287900,1010
511,383,128,935,208200,1011
269,225,44,1023,249100,1012
9246,4702,4544,868,188600,1013
13109,8323,4786,988,193500,1020
1094,787,307,1563,123600,1022
442,335,107,911,223200,1026
8180,5282,2898,1001,271000,1027
5762,4772,990,1045,274100,1028
239,189,50,1675,276700,1029
4797,3780,1017,974,248400,1030
560,343,217,978,190000,1031
212,188,24,1125,260700,1032
2584,2256,328,915,267400,1033
850,806,44,1406,280500,1034
2256,1754,502,1152,331100,1035
2025,1878,147,1193,286400,1036
193,163,30,-,296000,1037
1082,797,285,1250,323600,1038
599,439,160,1453,327000,1039
15464,6189,9275,847,197700,1040
1025,842,183,1022,226500,1050
588,482,106,1100,283300,1053
727,642,85,1617,353800,1054
8310,6252,2058,1026,240000,1056
3603,3050,553,869,252400,1057
6682,3069,3613,1264,361400,1060
4082,3080,1002,982,324200,1062
0,0,0,-,-,1063
30,30,0,-,-,1066
620,583,37,1167,302700,1068
3578,2801,777,831,204400,1069
284,246,38,871,240000,1070
565,508,57,905,232100,1071
640,571,69,1389,273900,1072
2336,2127,209,863,338400,1073
94,22,72,-,-,1074
6993,5360,1633,969,261900,1075
3869,3124,745,1095,299500,1077
232,160,72,1208,195200,1079
843,515,328,1032,190900,1080
765,665,100,798,214200,1081
4446,2963,1483,878,209600,1082
1050,769,281,685,232000,1083
71,57,14,1125,230400,1084
15414,10582,4832,965,249000,1085
0,0,0,-,-,1086
307,156,151,965,332400,1088
12402,7033,5369,912,235200,1089
499,278,221,690,238800,1092
129,112,17,-,354000,1093
184,101,83,368,198700,1094
5296,4803,493,740,301100,1095
1008,799,209,1116,280900,1096
32,15,17,-,-,1097
573,524,49,805,279900,1098
1385,129,1256,797,157400,1103
9022,4208,4814,914,151400,1104
5135,550,4585,762,177800,1105
5894,5293,601,1601,349600,1106
4043,1170,2873,663,164900,1107
10031,4185,5846,985,167800,1108
9220,3851,5369,932,143700,1109
5613,4483,1130,1040,179400,1118
4967,3551,1416,818,161400,1119
1085,1038,47,1671,200400,1128
2541,1959,582,1157,170800,1129
3589,1720,1869,1042,151700,1151
0,0,0,-,-,1199
19745,12582,7163,908,178500,1201
3999,2364,1635,779,161600,1220
301,278,23,-,250600,1222
1155,1071,84,1243,283200,1223
73,62,11,-,225700,1224
1534,1246,288,1095,199400,1225
3127,2396,731,881,244200,1226
28,21,7,-,425000,1229
3500,2582,918,918,378200,1230
1037,857,180,775,192400,1235
562,367,195,1282,294400,1236
1078,975,103,1500,254900,1237
2329,1790,539,1021,291500,1238
2105,1342,763,1022,340300,1240
128,104,24,-,189600,1242
133,127,6,-,236200,1243
53,41,12,-,420800,1244
382,356,26,1208,443700,1245
6521,4126,2395,788,154900,1247
408,347,61,-,279000,1253
427,413,14,1625,479700,1254
316,313,3,-,266500,1255
316,301,15,642,193400,1256
944,778,166,925,329100,1257
211,176,35,879,493900,1258
287,261,26,1094,378900,1259
87,66,21,-,666700,1260
450,254,196,781,484600,1262
82,61,21,1000,416700,1264
550,478,72,1568,375300,1266
2411,1770,641,955,331700,1267
368,368,0,-,303400,1270
8248,4519,3729,882,198000,1301
752,630,122,788,325200,1330
5269,3916,1353,841,182400,1331
1030,841,189,888,258100,1337
50,50,0,-,233300,1338
601,532,69,850,223600,1339
740,599,141,994,221700,1340
776,665,111,1282,341800,1341
408,314,94,1725,270700,1342
33,24,9,-,245500,1343
550,422,128,818,208200,1344
248,244,4,-,233000,1346
76,53,23,-,157400,1347
461,381,80,1037,201500,1349
48,36,12,920,122200,1350
1057,821,236,1041,268000,1351
591,477,114,1050,255900,1354
412,354,58,892,258800,1355
1278,1076,202,796,244300,1360
3036,2121,915,862,167700,1364
472,427,45,1250,297500,1366
205,188,17,1250,230300,1367
539,452,87,852,271600,1368
1754,1200,554,881,284400,1370
2186,1804,382,996,329400,1373
1606,653,953,1462,324600,1375
2285,1150,1135,918,204900,1376
315,295,20,1375,254200,1378
379,317,62,1172,213600,1379
15555,8279,7276,964,216500,1420
2103,1935,168,1544,277400,1430
1261,1177,84,1083,272500,1431
3424,2232,1192,1172,335900,1432
286,251,35,-,329000,1434
1207,958,249,-,245900,1436
211,189,22,-,184400,1438
8535,4739,3796,867,192500,1440
3944,3511,433,1313,487100,1450
1486,1405,81,1211,617200,1451
1761,1567,194,1024,289400,1452
17019,10298,6721,1006,261700,1453
3501,3110,391,1595,476800,1460
4342,3595,747,1689,326400,1462
4571,3617,954,1071,364700,1463
2578,2041,537,871,307700,1464
147,147,0,-,529600,1467
1591,1447,144,1151,258800,1468
2913,2421,492,996,299900,1469
3067,2658,409,1037,303100,1473
658,620,38,1667,312800,1474
3942,2894,1048,822,220300,1475
6618,5728,890,926,274800,1501
1291,1083,208,1072,438200,1503
3767,2901,866,945,287400,1504
1818,1477,341,1171,441300,1505
1368,1196,172,903,225900,1506
4861,3854,1007,1015,317800,1507
5864,3191,2673,1121,269700,1510
843,649,194,906,255000,1515
3174,2492,682,1168,336600,1516
1376,1015,361,1062,330500,1518
2605,1904,701,1679,385300,1519
5893,5170,723,1180,344200,1520
1041,907,134,1270,251000,1521
1183,999,184,949,300200,1522
2633,2112,521,1510,369500,1523
2363,1893,470,870,286700,1524
123,25,98,983,-,1525
5147,3829,1318,1187,291800,1527
1305,1092,213,1119,332300,1529
449,376,73,925,304400,1531
5444,4463,981,2008,451100,1532
2347,1816,531,777,354700,1534
1874,1269,605,840,250500,1535
2759,2077,682,902,361200,1536
954,689,265,1044,260700,1537
4074,3200,874,947,271900,1540
1267,1194,73,746,393700,1541
968,852,116,1385,277400,1542
2879,2461,418,1046,326100,1543
13753,10055,3698,1534,434000,1545
6760,3167,3593,917,214500,1550
1816,1188,628,1124,371600,1560
31,31,0,-,-,1561
5114,3320,1794,856,281100,1562
3143,2918,225,1327,367500,1564
2350,2176,174,1410,290400,1566
2753,2435,318,905,483800,1568
5360,4204,1156,1272,336100,1569
6987,3899,3088,917,260000,1570
4103,2826,1277,1004,274300,1571
6950,4300,2650,1692,482400,1581
2614,2213,401,981,300400,1583
1923,1454,469,912,263000,1585
3945,2306,1639,1031,310700,1588
3338,3050,288,1212,365900,1590
9820,6107,3713,1272,254800,1602
6919,3121,3798,1052,213100,1603
15426,7006,8420,1192,237600,1604
10702,3023,7679,1062,228800,1605
8328,5327,3001,1210,244700,1606
3751,1360,2391,1063,217900,1607
1881,186,1695,1088,253300,1608
7816,2972,4844,1067,325400,1609
7715,1279,6436,1084,190400,1610
751,582,169,893,246700,1611
1621,1463,158,1107,349000,1612
13503,10496,3007,1622,455700,1701
14926,5440,9486,1363,385900,1702
209,133,76,-,248900,1718
2259,1578,681,1285,586200,1719
8527,6141,2386,1512,598700,1720
7124,5647,1477,1851,418600,1721
5286,3804,1482,2031,695400,1730
531,0,531,3135,-,1731
1777,1679,98,-,578100,1740
1775,1656,119,1115,855000,1741
6464,4793,1671,2213,907700,1742
246,169,77,1613,409700,1745
5452,4899,553,971,466500,1746
2073,1684,389,1332,354600,1747
6468,5568,900,1896,608600,1748
7813,5670,2143,1296,370500,1749
16044,9292,6752,1498,365200,1752
4285,3347,938,1114,367700,1754
2059,1896,163,1510,519200,1756
11064,7715,3349,1286,333000,1757
14830,10119,4711,1625,601700,1760
1478,1422,56,1039,790500,1770
3289,2990,299,1134,638200,1772
2055,1584,471,1645,996200,1773
2569,2209,360,1390,514100,1775
6301,5737,564,1245,754200,1776
4761,4351,410,1263,736700,1778
15901,9266,6635,1763,486600,1801
10625,7966,2659,2016,588600,1803
12926,10402,2524,1714,637600,1810
11879,9183,2696,1687,421700,1821
9595,7971,1624,1718,450800,1824
11696,9409,2287,1398,340600,1826
1155,1103,52,1750,499200,1827
10167,5563,4604,1178,327000,1830
9299,5033,4266,1252,316000,1832
3322,2585,737,1727,461400,1833
2460,2207,253,1381,409600,1834
5146,3723,1423,1235,311500,1835
2330,92,2238,889,120200,1840
15384,4796,10588,1192,289500,1841
8838,2999,5839,1258,276100,1843
17610,12943,4667,1276,350100,1844
11226,7949,3277,1803,523200,1845
5367,2531,2836,1209,265700,1850
10812,4599,6213,1341,302500,1851
14020,6788,7232,1217,292000,1852
10061,3543,6518,1080,259600,1854
2800,2269,531,1115,384800,1860
3737,2954,783,1605,404700,1862
3676,3041,635,1450,355400,1863
5824,4922,902,1696,578100,1864
9374,7929,1445,1363,594000,1867
11808,10030,1778,1938,421700,1876
4181,3436,745,1266,417200,1879
10479,7814,2665,1482,557800,1880
8544,7562,982,2064,556100,1886
7882,6646,1236,2009,495500,1887
8065,6755,1310,2068,968000,1890
1079,125,954,982,281100,1901
17594,6537,11057,1237,338200,1902
6215,4806,1409,1413,390300,1904
8338,3948,4390,1223,334600,1905
10207,7925,2282,965,433200,1906
6157,4464,1693,2011,505900,1907
1723,1389,334,1574,582600,1908
7404,5015,2389,1180,351400,1913
16568,9999,6569,1308,463000,1915
2853,2765,88,922,673200,1921
1163,1080,83,769,553700,1922
10652,7499,3153,1620,451100,1923
1371,1129,242,1246,611700,1929
13410,8406,5004,1233,435200,1930
0,0,0,-,-,1937
5653,4161,1492,1260,508200,1938
4868,3957,911,1815,699100,1940
2128,1616,512,1544,851800,1944
8126,6419,1707,1562,705600,1945
3062,2838,224,1638,573100,1949
7419,5573,1846,1326,608300,1950
1477,1323,154,-,559900,1951
3914,3179,735,1485,368900,1952
21944,14280,7664,1503,419800,1960
3402,2319,1083,1590,543200,1966
2269,1901,368,1390,498600,1969
19025,9508,9517,1321,379400,1970
2720,2246,474,1231,565600,1982
2159,1919,240,1109,638100,1983
1361,1201,160,-,638600,1984
1720,1612,108,1614,585900,1985
6548,5363,1185,1547,325000,2019
9238,7044,2194,1826,540500,2021
3231,2564,667,1172,867000,2025
10491,7477,3014,1823,482300,2026
2013,1905,108,2217,993100,2030
1412,1260,152,1394,496600,2032
7081,4772,2309,1440,451500,2035
12414,9999,2415,1468,432800,2038
9121,7505,1616,2178,842000,2043
4473,3452,1021,1530,425900,2045
72,56,16,-,684200,2047
8925,6837,2088,1329,420100,2048
9992,8156,1836,1349,464200,2050
4362,3802,560,1513,701200,2052
4712,4185,527,1248,425800,2053
3110,2572,538,1727,446200,2054
3116,2948,168,1180,529300,2056
3519,3209,310,1740,628400,2061
12157,6705,5452,1655,455300,2062
7461,6607,854,1122,607800,2066
6436,5698,738,1628,573800,2067
250,174,76,-,515200,2071
11052,8245,2807,1566,374300,2072
7068,5656,1412,1443,506400,2081
5374,4631,743,1787,754800,2090
4290,3626,664,1034,474900,2093
2046,883,1163,2610,1534500,2108
1892,756,1136,3071,786300,2109
1325,876,449,2739,1123600,2110
3626,962,2664,1396,937300,2111
4286,692,3594,2079,670200,2113
7235,1799,5436,2488,725200,2114
9276,1105,8171,1730,786800,2115
12014,4598,7416,2104,1212700,2116
13672,4059,9613,1210,920100,2118
11738,3232,8506,860,489800,2119
4973,346,4627,1308,538100,2120
10740,2733,8007,1023,536800,2121
8656,3845,4811,1533,526200,2122
19555,7922,11633,1496,451000,2124
13063,4734,8329,1444,548700,2125
9968,4157,5811,1540,405600,2126
17109,7419,9690,1704,700100,2127
17123,4380,12743,1609,528400,2128
9390,4419,4971,1609,756200,2129
17680,8155,9525,1878,632700,2130
12625,6887,5738,1651,491500,2131
11454,7934,3520,1728,579300,2132
8308,1309,6999,1834,522300,2134
19739,4411,15328,1891,568700,2135
12242,6536,5706,1387,428800,2136
14312,5591,8721,2319,894700,2138
15224,5647,9577,2230,851300,2139
9384,2987,6397,2145,850000,2140
6846,2096,4750,2233,720100,2141
1943,285,1658,3241,948500,2142
11363,3320,8043,1999,729200,2143
10939,3973,6966,2135,748500,2144
11490,4083,7407,1959,652800,2145
23367,9825,13542,1650,447000,2148
16107,6346,9761,1587,434300,2149
13158,3539,9619,1475,369900,2150
18571,9194,9377,1461,388900,2151
8061,4501,3560,1578,461000,2152
23819,13203,10616,2008,551900,2155
473,0,473,2578,-,2163
25724,10323,15401,1661,426600,2169
7633,3949,3684,1538,481800,2170
7965,4070,3895,1801,479900,2171
11238,7513,3725,1638,599600,2176
9829,6510,3319,1522,526800,2180
13751,10206,3545,1501,489600,2184
8656,7193,1463,1239,651600,2186
7012,4456,2556,1591,384600,2188
6239,4101,2138,1437,361200,2189
7535,5121,2414,1591,416200,2190
3606,2946,660,1618,378500,2191
914,45,869,3124,-,2199
24,11,13,-,-,2203
2711,758,1953,3197,879100,2210
8055,766,7289,2048,487600,2215
20675,10144,10531,1218,286700,2301
10784,7478,3306,1124,270700,2302
1634,1229,405,1328,364200,2322
8367,6144,2223,1658,380700,2324
4609,4167,442,1481,308300,2330
5800,5202,598,1733,657400,2332
4899,3943,956,1276,372600,2333
2901,2700,201,1031,345900,2338
4663,4111,552,1162,550000,2339
3872,3522,350,1750,385700,2341
4352,3421,931,944,335700,2343
9922,7764,2158,1325,329500,2346
4091,3443,648,1509,395000,2347
6081,4512,1569,1364,385000,2351
4514,3347,1167,1495,462200,2356
20,9,11,-,-,2357
6643,5677,966,1641,412800,2359
24412,19699,4713,1487,376800,2360
5234,4286,948,882,410800,2364
0,0,0,-,-,2366
993,896,97,868,392600,2367
11727,8079,3648,1626,351700,2368
6806,5060,1746,1256,324700,2370
4404,3462,942,1607,376200,2375
2503,2170,333,1637,369700,2379
5596,3955,1641,1378,343200,2382
5095,4544,551,2175,934400,2420
6861,5229,1632,2580,933300,2421
8675,4830,3845,2350,1033100,2445
13277,5268,8009,2240,932800,2446
7278,4479,2799,1925,585600,2451
4965,2743,2222,1846,604700,2452
11502,4723,6779,1682,544800,2453
19,19,0,-,-,2457
4836,3048,1788,1774,870900,2458
6173,5196,977,1979,1101300,2459
3717,2223,1494,1865,886700,2460
2536,2000,536,2446,911400,2461
527,324,203,1456,947400,2462
1352,974,378,2107,701500,2464
4400,3167,1233,1830,882200,2465
3014,1649,1365,1895,893900,2466
6594,4380,2214,2321,1016300,2467
1886,1814,72,-,1309000,2468
16288,8256,8032,1889,599100,2472
11560,6355,5205,1799,673500,2474
7558,4708,2850,1663,709100,2476
9846,6328,3518,2059,902500,2478
4495,3892,603,2124,1327100,2481
3812,2986,826,2217,1081300,2482
7132,6395,737,1404,923100,2492
3730,3203,527,1725,1270000,2493
3633,2697,936,1696,851500,2494
5950,4624,1326,1304,369200,2532
369,336,33,-,578900,2534
792,667,125,1444,1375000,2535
8446,7071,1375,1541,366700,2536
2518,2342,176,1673,449100,2537
1564,988,576,1221,276700,2538
1449,1069,380,1785,830000,2539
4081,2733,1348,1014,620300,2540
306,16,290,1910,-,2542
378,308,70,1307,798700,2543
96,96,0,-,-,2553
3658,2512,1146,1781,1109600,2554
1078,956,122,1194,549900,2556
1873,1331,542,1724,673800,2557
968,650,318,1360,307200,2558
1596,1169,427,1279,395300,2559
105,78,27,-,378600,2561
1151,934,217,1439,401200,2562
4099,3566,533,1542,388100,2563
51,51,0,-,"2,000,000+",2564
1932,1195,737,1414,733400,2568
4804,3454,1350,1089,346100,2571
819,712,107,1533,806600,2575
1828,1621,207,1304,226600,2576
0,0,0,-,-,2584
6253,3248,3005,1310,298000,2601
750,664,86,1684,604800,2630
4360,3678,682,1008,450600,2631
4781,3689,1092,1823,382800,2632
2053,1751,302,1179,636400,2633
1371,1217,154,-,454900,2635
75,75,0,-,584400,2637
1499,1219,280,1385,484900,2638
1581,915,666,1460,326900,2639
117,117,0,-,-,2641
2447,2227,220,1326,502100,2642
0,0,0,-,-,2643
1525,1373,152,1349,371500,2644
4197,3550,647,1302,447900,2645
864,782,82,1335,525500,2646
68,50,18,-,1875000,2647
2906,2593,313,1832,397600,2648
6552,5542,1010,1374,371800,2649
391,333,58,1892,891400,2650
7,7,0,-,-,2651
466,364,102,-,662700,2652
2822,2277,545,1045,638800,2653
1460,1271,189,1272,485200,2655
1725,1298,427,1170,691500,2657
510,455,55,1101,618100,2659
2898,2136,762,1243,368600,2660
54,43,11,-,497700,2663
3989,2848,1141,1526,364400,2664
227,227,0,-,344700,2666
1470,1137,333,1284,544000,2667
1098,963,135,1327,475900,2668
53,53,0,-,-,2669
710,533,177,1304,483100,2670
475,434,41,-,529400,2671
120,111,9,-,869500,2672
3775,3038,737,1608,303100,2673
2989,2736,253,1500,399500,2675
1673,1552,121,1556,381300,2702
17491,11901,5590,1125,313400,2703
22,16,6,-,500000,2713
1475,1302,173,1111,377700,2715
1699,1486,213,1670,364300,2717
2344,2056,288,849,320400,2718
6767,5023,1744,939,286800,2719
13199,5363,7836,902,259500,2720
10372,3951,6421,814,259400,2721
7124,2320,4804,808,237100,2723
7887,2496,5391,810,261700,2724
959,742,217,856,293500,2725
6159,5173,986,1179,293000,2726
1946,1580,366,1270,485500,2738
2895,2239,656,1460,481400,2739
18125,7055,11070,859,230900,2740
4158,3553,605,837,298700,2743
4739,1665,3074,886,242200,2744
9802,5785,4017,901,248800,2745
6324,1014,5310,849,231100,2746
7155,5625,1530,1056,357400,2747
4675,3610,1065,968,381800,2748
10623,7187,3436,1078,351400,2760
3727,2615,1112,1600,359500,2762
694,526,168,1632,433300,2763
1412,1274,138,687,361000,2764
6843,5734,1109,1528,367500,2766
5458,4381,1077,1453,366700,2767
4241,3766,475,1205,401300,2769
1909,1713,196,1088,424600,2770
5958,5094,864,1212,358300,2771
6580,5711,869,1048,315300,2777
2267,2215,52,-,367900,2779
19649,11663,7986,1030,284900,2780
6421,5372,1049,1113,362300,2790
229,174,55,1190,701200,2791
240,53,187,-,-,2802
780,666,114,970,241300,2804
5854,5196,658,1390,437400,2806
400,268,132,818,900700,2807
910,579,331,1003,240500,2808
8122,5345,2777,1141,348100,2809
470,442,28,-,330200,2812
3438,2842,596,1211,351100,2813
2974,2584,390,1081,308200,2814
62,43,19,-,210300,2815
13394,10473,2921,997,242500,2816
2352,1986,366,2220,360800,2817
7823,5865,1958,1169,415500,2818
2022,1679,343,1527,341500,2822
1863,1676,187,868,335800,2825
161,149,12,-,260900,2826
822,798,24,1047,284000,2827
3145,2657,488,1445,312500,2828
2247,1848,399,834,312500,2830
1322,1119,203,1389,294000,2831
1926,1581,345,1022,300500,2832
407,328,79,317,231200,2833
2387,2056,331,1492,664900,2835
78,78,0,-,242400,2836
1556,1236,320,1494,581500,2837
1255,552,703,1098,277900,2838
808,526,282,1288,232500,2839
10116,4423,5693,1331,495000,2840
0,0,0,-,-,2841
6773,3864,2909,1419,387300,2842
8851,6650,2201,979,351900,2852
3189,2843,346,1317,328500,2857
190,163,27,-,240300,2858
2687,1882,805,911,271200,2859
18025,6772,11253,905,212100,2860
9952,6519,3433,1021,215400,2861
6086,1446,4640,884,176300,2863
13203,10215,2988,987,309300,2864
6625,4770,1855,1282,345700,2865
7193,5714,1479,1562,390800,2871
101,88,13,-,291000,2872
43,43,0,-,304500,2873
2463,2130,333,1711,489200,2874
179,151,28,-,342600,2875
307,89,218,1505,-,2876
6452,5053,1399,1020,281900,2878
8914,6671,2243,1103,379000,2879
914,682,232,1388,368700,2881
5956,3838,2118,1352,464400,2882
4992,2778,2214,931,296900,2885
12725,8000,4725,1221,245000,2886
8156,6310,1846,1076,228900,2888
11454,8638,2816,1116,230300,2889
9805,6812,2993,1079,327700,2891
1899,1557,342,1495,351600,2892
13359,7144,6215,1068,223400,2893
265,246,19,-,234800,2894
16515,6151,10364,921,191500,2895
4634,3563,1071,960,317000,2896
500,453,47,835,272900,2898
4826,838,3988,1162,357900,2903
11804,5758,6046,963,223500,2904
9509,4548,4961,935,228700,2905
11218,5356,5862,1376,426300,2906
10081,3047,7034,935,198300,2907
13431,6369,7062,1071,201300,2908
14507,4955,9552,945,195100,2909
8516,5942,2574,1108,221700,2910
6639,3706,2933,1092,237300,2911
0,0,0,-,-,2912
9073,4591,4482,988,224900,2914
7150,4794,2356,1043,229800,2915
3758,2804,954,901,260900,2916
4729,3587,1142,873,294600,2917
11517,8134,3383,1015,238600,2919
14009,9037,4972,1083,256600,2920
4622,3701,921,1208,365500,2921
4339,3942,397,1172,371400,3031
1924,1746,178,1875,374000,3032
1738,1658,80,1402,344700,3033
1515,1465,50,1695,287500,3034
1744,1730,14,-,359100,3036
1616,1377,239,1428,317300,3037
12844,8533,4311,1194,264300,3038
2730,2354,376,1397,309600,3042
619,567,52,1326,306300,3043
1679,1572,107,1648,283900,3044
5181,4248,933,1214,275300,3045
1003,943,60,967,326800,3046
669,550,119,478,245800,3047
1501,1247,254,1067,204000,3048
2959,2709,250,1557,480400,3049
9396,7936,1460,1300,312500,3051
3020,2620,400,1643,334500,3052
9433,8171,1262,1430,345700,3053
9956,8651,1305,1564,299000,3054
6434,3691,2743,1308,265700,3055
929,841,88,1542,352700,3057
11848,4272,7576,1159,244300,3060
11695,8009,3686,1520,295500,3062
6775,4091,2684,1433,280400,3063
6128,3555,2573,1253,292100,3064
2104,1864,240,1085,323400,3070
1855,1668,187,877,250900,3071
4755,4294,461,1214,361600,3076
4102,3166,936,1297,245700,3077
11885,9252,2633,1277,339000,3079
621,575,46,1417,263800,3082
506,438,68,1239,294100,3084
1679,1338,341,1134,271400,3086
5024,4697,327,2645,482900,3087
1689,99,1590,1253,253900,3101
13977,4849,9128,1235,225800,3102
14797,6335,8462,1060,222100,3103
13903,7679,6224,1130,272000,3104
5130,3845,1285,1434,274700,3106
4008,3048,960,1359,241700,3109
7912,6764,1148,1705,437300,3110
111,93,18,1047,363300,3215
901,790,111,926,235300,3216
921,460,461,1009,174300,3217
433,340,93,1153,193400,3218
3104,2709,395,885,194000,3220
845,765,80,1017,232400,3221
2284,1813,471,863,204700,3222
1302,1076,226,780,188200,3223
918,875,43,-,266200,3224
1343,1239,104,1204,199900,3225
412,360,52,1039,365100,3226
608,569,39,1675,297600,3227
2214,1970,244,1067,281000,3229
620,569,51,1080,156000,3230
103,80,23,-,307900,3231
151,141,10,-,580900,3233
1721,1487,234,1020,240600,3234
3969,2595,1374,891,189500,3235
743,682,61,-,245400,3237
47,46,1,-,125000,3238
512,475,37,1000,173200,3240
366,324,42,1071,291700,3241
1828,1285,543,841,243900,3242
334,309,25,1304,185000,3243
2831,2586,245,968,202000,3244
814,602,212,1662,297600,3245
7075,4044,3031,991,193400,3246
3016,2726,290,994,257100,3249
542,411,131,971,241100,3251
3089,2396,693,1215,314200,3253
1809,1622,187,1397,333800,3254
797,728,69,406,299300,3255
932,787,145,976,244200,3256
1520,1265,255,1315,366400,3257
1041,957,84,1268,279400,3258
233,225,8,-,323400,3259
411,385,26,1531,280000,3260
1697,1449,248,978,265900,3261
501,393,108,1298,243600,3262
1778,1193,585,775,203000,3263
2510,1431,1079,892,194100,3264
794,700,94,808,179900,3266
587,562,25,1055,221400,3268
1115,834,281,1000,277800,3269
110,102,8,-,266200,3273
4477,3388,1089,1017,214000,3275
3393,2335,1058,894,180100,3276
1244,765,479,1047,249800,3278
270,230,40,915,131000,3279
466,431,35,995,212700,3280
3279,3039,240,1441,250600,3281
403,359,44,1114,212500,3282
318,275,43,-,234800,3284
1020,831,189,1168,251200,3285
667,541,126,1029,288500,3287
1950,1850,100,1036,306600,3290
24,24,0,-,-,3291
57,51,6,-,188500,3293
13565,7248,6317,1093,254400,3301
6437,4336,2101,1121,216600,3303
2738,2427,311,1197,326000,3304
2179,1938,241,1131,234700,3307
10045,5370,4675,1032,186300,3431
1109,819,290,976,228400,3440
66,36,30,-,155400,3441
695,433,262,990,171200,3442
125,125,0,-,229300,3443
652,544,108,1085,271800,3444
286,251,35,1161,183400,3445
2725,1747,978,1345,191200,3446
1009,907,102,994,204500,3447
285,260,25,1288,187200,3448
798,671,127,881,336900,3449
374,350,24,-,273500,3450
1615,1354,261,957,147700,3451
2276,1642,634,873,179100,3452
1000,649,351,1035,210300,3455
328,285,43,955,219200,3456
277,243,34,950,287500,3457
3165,1984,1181,825,252800,3458
1817,1462,355,924,254500,3461
645,472,173,773,252300,3462
382,346,36,1406,210200,3464
729,510,219,938,156300,3465
698,560,138,795,208500,3466
850,749,101,1099,278400,3467
1856,1265,591,949,168600,3470
2858,1696,1162,733,178000,3561
3998,2340,1658,673,85100,3570
1146,895,251,635,171900,3574
6,6,0,-,-,3575
1360,1072,288,706,158300,3576
184,164,20,-,237000,3579
580,490,90,833,344800,3580
1628,1217,411,676,149700,3581
900,666,234,705,79200,3582
487,380,107,728,276900,3583
1518,1193,325,757,150300,3584
1020,797,223,813,160200,3585
251,228,23,938,361500,3586
687,599,88,928,165400,3588
451,372,79,613,134700,3590
581,484,97,658,203300,3592
189,142,47,1013,246500,3593
392,323,69,874,189400,3595
190,137,53,593,95900,3597
1423,1017,406,830,140900,3598
163,149,14,1250,180100,3601
1011,717,294,820,180600,3602
2252,1657,595,1041,113000,3603
63,49,14,-,341700,3604
355,327,28,911,168100,3605
127,118,9,-,167600,3607
1353,907,446,961,275500,3608
265,166,99,1307,148900,3609
319,277,42,692,186500,3740
1625,1313,312,989,206600,3741
5603,3302,2301,979,134400,3743
743,707,36,1070,229800,3745
65,59,6,-,316700,3746
2221,1719,502,1321,263700,3748
315,291,24,-,522200,3750
285,241,44,-,256000,3751
319,272,47,1071,180800,3752
1151,1027,124,1198,308000,3753
13,0,13,-,-,3754
2713,1562,1151,1693,548600,3755
202,187,15,-,205000,3765
4140,2273,1867,1219,266800,3766
650,589,61,1550,512800,3768
103,98,5,-,437500,3770
340,306,34,783,189800,3771
3087,2075,1012,1074,164300,3773
761,569,192,1289,134400,3774
498,403,95,1197,286900,3777
310,253,57,950,215400,3779
250,236,14,-,166300,3780
896,785,111,1538,318900,3781
1051,783,268,1310,306900,3782
1725,739,986,1299,243000,3784
819,494,325,957,132500,3785
10520,5416,5104,1361,464400,3801
1370,1228,142,-,235900,3809
717,704,13,-,514900,3810
2838,2632,206,1779,371300,3811
355,254,101,948,206400,3812
1700,1354,346,1050,161500,3813
1042,826,216,600,162100,3814
511,419,92,682,261200,3816
426,358,68,-,263700,3817
1685,1213,472,927,196500,3818
1708,1500,208,1601,297900,3819
13897,7402,6495,1184,274000,3820
677,582,95,1299,375700,3823
3206,1833,1373,1126,386200,3824
3335,3075,260,1630,290900,3825
883,531,352,859,325000,3826
1131,1031,100,1133,394200,3827
792,720,72,-,254900,3830
158,110,48,906,291200,3832
8997,6692,2305,1240,347000,3833
2815,2020,795,1041,207000,3835
572,551,21,-,242400,3836
726,633,93,1258,257900,3837
523,393,130,783,358700,3838
1548,1084,464,1086,202900,3839
1566,1288,278,1992,463400,3840
2746,2306,440,1106,359500,3841
6963,5205,1758,1243,386000,3842
826,744,82,1768,484700,3844
726,576,150,1121,222200,3845
492,381,111,1318,434200,3846
229,186,43,-,359800,3847
2747,2234,513,1164,300000,3848
586,486,100,1100,245400,3849
114,99,15,-,335700,3850
1560,1383,177,788,204000,3851
153,153,0,-,187200,3852
329,298,31,-,450000,3853
418,378,40,2688,1140000,3854
1015,929,86,1145,253000,3855
617,592,25,1844,458700,3856
4066,2200,1866,1297,307100,3857
1763,1526,237,1041,332400,3858
2027,1192,835,894,241300,3860
1883,1673,210,1098,324200,3861
1916,1704,212,1594,444100,3862
769,713,56,-,185500,3864
3311,2681,630,1278,296800,3865
9298,6007,3291,1060,191300,3867
2305,1728,577,1122,160400,3868
1010,800,210,1067,265900,3869
2180,1878,302,1210,691700,3870
124,124,0,-,1151300,3871
1571,1430,141,849,239000,3872
2200,1882,318,1673,315000,3873
3973,2794,1179,1197,286400,3874
352,282,70,820,322600,3875
5272,2912,2360,1152,211300,3878
583,471,112,1063,205600,3882
93,49,44,-,-,3883
1341,1237,104,1036,290200,3884
2869,2633,236,1638,475500,3885
775,485,290,850,197700,3886
661,612,49,844,195800,3887
19,9,10,-,-,3890
3021,2238,783,920,315200,3894
3349,2833,516,896,246300,3901
763,663,100,1323,392800,3902
2777,2432,345,930,368400,3903
3997,2351,1646,1234,330600,3904
918,786,132,1654,439100,3905
1887,1573,314,775,267100,3906
608,505,103,1405,605900,3907
2835,2342,493,972,280100,3908
4293,3406,887,1267,437700,3909
228,195,33,-,401000,3910
30,30,0,-,-,3911
1106,1066,40,779,216400,4001
2925,2667,258,829,229400,4002
113,87,26,-,342500,4003
10125,5185,4940,980,263100,4005
77,24,53,1272,842100,4006
1228,1035,193,1294,289200,4008
2429,1953,476,806,174200,4009
641,529,112,1172,188200,4010
8295,5990,2305,1082,255000,4011
1888,1591,297,780,207500,4015
276,195,81,1625,439800,4017
35,35,0,-,435000,4019
618,485,133,933,167700,4020
2379,1940,439,1220,347500,4021
406,380,26,894,225500,4022
216,175,41,960,182500,4024
2259,1933,326,1110,220100,4027
800,654,146,881,173900,4029
741,614,127,1072,271900,4030
3415,2659,756,1358,330500,4032
1338,1074,264,562,191000,4037
6058,4905,1153,1184,287100,4038
3388,2626,762,1142,252400,4039
1571,1450,121,886,181900,4040
614,509,105,909,161700,4041
2027,1863,164,947,217400,4042
5019,3741,1278,962,360600,4043
3222,2712,510,1124,340600,4046
706,589,117,709,185100,4047
1186,1020,166,925,183000,4048
1475,1358,117,1139,187900,4049
117,92,25,1639,364000,4050
525,454,71,1049,209600,4051
1940,1656,284,1506,201400,4055
102,96,6,-,162500,4056
50,50,0,-,-,4057
976,916,60,-,169900,4061
7103,6253,850,1144,257200,4062
285,142,143,331,333300,4063
4862,3351,1511,1004,216700,4064
369,174,195,1089,527800,4066
523,408,115,983,162700,4068
562,467,95,1146,312500,4069
2214,1962,252,1178,268500,4071
8341,5647,2694,1187,273100,4072
6775,4118,2657,890,195700,4073
8376,6758,1618,1414,377300,4074
1082,1010,72,963,226900,4076
1900,1543,357,1089,384700,4079
1978,1439,539,961,185400,4083
2598,2377,221,776,239400,4084
953,881,72,-,228100,4085
3864,2983,881,948,240700,4086
949,906,43,1011,191600,4087
545,481,64,794,169300,4088
4525,3665,860,930,310000,4090
324,273,51,-,201500,4091
8386,5407,2979,1076,240800,4092
3257,2394,863,1271,239100,4093
616,575,41,1051,227200,4095
3247,2466,781,1367,386500,4096
1427,1163,264,1233,358600,4097
9903,1940,7963,1187,422900,4101
7610,3825,3785,1184,307400,4102
12791,7714,5077,1247,283100,4103
4700,3997,703,1581,463000,4105
11360,7308,4052,1338,275700,4106
3722,3330,392,1151,472300,4107
406,363,43,1175,364300,4108
51,51,0,-,451200,4109
541,499,42,-,632400,4110
10140,5747,4393,801,174600,4210
205,192,13,629,137500,4216
1511,1267,244,450,214200,4217
561,505,56,962,165100,4219
1184,1098,86,969,157700,4220
339,298,41,813,141100,4221
1675,1498,177,798,225600,4222
1012,778,234,646,92700,4224
77,67,10,-,89300,4226
30,30,0,-,65000,4227
0,0,0,-,-,4228
82,69,13,1250,156300,4231
30,30,0,-,-,4234
1696,1555,141,847,197000,4236
139,132,7,850,271300,4237
474,424,50,988,180800,4238
1856,1679,177,598,138000,4239
15844,7609,8235,748,150100,4240
1841,1412,429,805,169400,4250
1876,1369,507,825,161800,4252
832,726,106,493,157700,4253
1464,728,736,665,84800,4254
312,235,77,995,173400,4255
1111,862,249,1053,154200,4256
1105,882,223,664,59600,4257
988,920,68,897,215100,4258
1487,1187,300,859,182800,4259
2041,1713,328,999,253500,4260
177,162,15,783,159400,4261
757,679,78,-,169600,4263
367,309,58,1089,165700,4265
19,15,4,-,-,4267
1963,1269,694,722,146100,4268
2310,1975,335,944,159200,4270
0,0,0,-,-,4271
2345,2142,203,975,214800,4274
264,250,14,900,100800,4275
2343,1685,658,561,88900,4276
2917,2601,316,611,159700,4280
1902,1339,563,690,146500,4281
2420,1948,472,850,196800,4282
420,343,77,753,257700,4284
206,189,17,650,170600,4285
0,0,0,-,-,4286
1489,1406,83,-,215900,4287
743,564,179,745,152000,4289
624,577,47,648,117200,4290
399,358,41,-,127400,4292
1499,1140,359,-,131300,4294
12060,7292,4768,736,153700,4330
803,699,104,979,175400,4342
0,0,0,-,-,4343
1327,905,422,759,158900,4344
4459,3355,1104,779,155100,4345
818,584,234,735,125800,4346
1114,554,560,904,219000,4347
1135,976,159,823,178400,4348
520,437,83,779,215700,4349
1470,1333,137,825,206700,4350
1037,838,199,926,244100,4351
633,574,59,771,152400,4352
879,797,82,845,158600,4353
636,590,46,1092,182400,4354
977,785,192,1000,222000,4355
1583,1068,515,857,183300,4357
1644,1419,225,859,181100,4358
137,95,42,632,143300,4359
207,199,8,633,173100,4360
1014,813,201,791,159100,4363
2539,1766,773,862,243400,4364
18801,10410,8391,836,169800,4401
291,272,19,704,127300,4406
83,79,4,-,170500,4408
467,417,50,643,148300,4410
655,534,121,938,148400,4411
3891,2321,1570,873,167600,4412
83,83,0,-,85900,4413
543,474,69,739,98800,4414
139,98,41,708,64400,4415
2331,1772,559,699,151200,4416
198,190,8,-,85500,4417
676,564,112,685,90900,4418
1183,978,205,992,182300,4419
308,229,79,785,362200,4421
454,432,22,525,138300,4422
374,304,70,506,103800,4424
1901,1354,547,750,106200,4426
1103,974,129,531,115900,4427
1272,1077,195,939,152700,4428
2040,1706,334,874,199700,4429
778,578,200,579,61100,4430
22,13,9,-,-,4431
419,389,30,963,105500,4434
474,455,19,1028,122200,4435
534,460,74,638,151000,4438
759,592,167,575,181900,4441
32,32,0,-,170000,4442
912,664,248,399,135900,4443
3501,2901,600,982,218600,4444
571,475,96,710,90400,4448
510,449,61,843,113700,4449
599,500,99,883,104900,4450
137,125,12,-,55900,4451
321,237,84,695,87200,4453
11,11,0,-,78300,4454
274,245,29,-,113900,4455
1197,1006,191,967,174500,4456
2780,1905,875,618,109200,4457
368,302,66,370,66100,4459
627,531,96,625,65500,4460
1205,1027,178,954,123000,4461
2338,1887,451,531,69100,4462
1321,961,360,767,70600,4463
224,168,56,489,116700,4464
3965,2676,1289,755,134800,4468
0,0,0,-,-,4469
273,264,9,-,78800,4471
903,794,109,943,176600,4472
3220,1530,1690,898,176800,4473
1519,1369,150,910,189800,4474
227,186,41,375,80000,4475
466,414,52,911,231200,4476
153,126,27,-,241200,4478
654,539,115,665,101600,4479
208,194,14,725,150000,4481
63,54,9,-,151700,4485
399,375,24,-,59500,4487
503,404,99,595,161200,4488
138,96,42,1179,145600,4489
98,96,2,-,84200,4490
82,76,6,-,72900,4491
36,35,1,-,87000,4492
777,674,103,619,125400,4493
171,153,18,625,81000,4495
1614,1371,243,569,172800,4496
164,145,19,475,55800,4497
5015,3212,1803,873,206400,4530
299,270,29,1056,229200,4535
694,608,86,1068,277600,4537
924,656,268,694,250500,4538
642,551,91,970,245800,4539
26,26,0,-,412500,4541
1004,551,453,837,270100,4543
481,281,200,-,356400,4544
503,449,54,1167,250500,4547
462,373,89,776,308500,4548
291,271,20,1031,273500,4551
722,557,165,900,298200,4553
333,296,37,-,398600,4554
703,608,95,835,222700,4555
590,519,71,1034,245700,4556
96,96,0,-,330200,4558
1090,896,194,864,230600,4562
655,555,100,1061,258600,4563
237,237,0,-,297200,4564
275,164,111,1133,466700,4568
0,0,0,-,-,4570
343,306,37,-,192800,4571
2590,1866,724,296,174600,4572
175,149,26,788,352500,4573
630,586,44,1534,148100,4574
38,38,0,-,-,4575
290,277,13,755,455000,4576
2052,1484,568,766,200700,4578
1293,1111,182,1005,172900,4579
6175,4477,1698,863,185800,4605
589,532,57,703,144600,4606
515,422,93,693,216100,4607
2408,1621,787,881,297500,4609
183,143,40,648,181300,4611
233,222,11,-,300000,4612
45,45,0,-,225000,4613
1267,794,473,758,260900,4614
323,297,26,958,207200,4616
358,303,55,763,348000,4617
1666,1178,488,527,94400,4619
461,349,112,475,125300,4622
377,304,73,833,120800,4623
76,68,8,-,338500,4624
32,26,6,-,466700,4625
246,209,37,548,137500,4626
688,583,105,381,246100,4627
235,194,41,287,112500,4628
0,0,0,-,-,4629
560,466,94,749,125900,4630
645,477,168,475,108000,4631
821,692,129,948,166700,4634
4,2,2,-,-,4635
109,96,13,625,154200,4637
979,830,149,865,195600,4640
62,56,6,-,366700,4642
351,288,63,978,127300,4643
0,0,0,-,-,4644
19,13,6,-,-,4645
40,34,6,-,275000,4646
269,205,64,900,68800,4648
544,371,173,348,132500,4649
183,161,22,1354,419000,4650
837,687,150,346,129900,4652
287,168,119,972,256900,4653
1341,946,395,500,121400,4654
392,266,126,927,146900,4655
157,131,26,637,190600,4657
580,452,128,795,152400,4658
496,455,41,1000,417900,4660
200,126,74,1060,564300,4662
474,383,91,967,161300,4664
548,470,78,926,95000,4666
543,397,146,467,105300,4667
626,449,177,268,84400,4668
70,70,0,-,121900,4669
238,214,24,1188,198300,4671
64,61,3,-,219400,4673
161,139,22,730,264500,4674
74,62,12,-,-,4675
578,465,113,1156,196000,4676
116,87,29,1350,225000,4677
647,410,237,470,320000,4679
528,468,60,863,152000,4680
516,363,153,722,240600,4681
43,34,9,-,282700,4683
852,673,179,747,237200,4684
339,312,27,-,169500,4685
64,46,18,731,75000,4686
183,152,31,1464,161800,4691
213,162,51,819,173200,4693
999,760,239,681,93300,4694
3976,2703,1273,518,110400,4730
761,515,246,-,100800,4732
145,106,39,-,95000,4733
371,321,50,700,175300,4734
232,203,29,438,86400,4735
4347,3225,1122,562,95100,4736
295,239,56,533,101600,4739
603,483,120,384,109600,4740
4,4,0,-,-,4741
1319,1037,282,677,104300,4742
1842,1405,437,687,106600,4743
407,360,47,775,100800,4745
199,178,21,404,52800,4746
579,496,83,522,104600,4747
798,460,338,631,78300,4750
1555,956,599,483,104200,4756
1192,954,238,531,137800,4757
471,346,125,575,94300,4758
302,250,52,541,103000,4760
199,167,32,539,167900,4761
230,188,42,400,123600,4762
332,251,81,567,82800,4763
18,16,2,-,109400,4764
470,363,107,577,84600,4765
168,136,32,725,97800,4766
192,168,24,913,138600,4768
4243,2580,1663,695,113900,4769
388,313,75,500,131900,4772
259,221,38,-,98400,4773
360,300,60,371,89400,4774
367,344,23,971,91100,4776
152,133,19,650,83200,4777
159,149,10,-,203100,4779
313,276,37,860,93300,4780
223,186,37,-,116100,4781
183,162,21,732,123700,4783
953,574,379,617,77100,4785
769,601,168,376,78700,4786
212,198,14,600,82700,4787
3586,2218,1368,761,169300,4841
2315,1726,589,922,337800,4843
645,602,43,900,231800,4847
331,312,19,775,240300,4848
1617,1422,195,968,267600,4849
39,39,0,-,292500,4851
43,36,7,-,477800,4852
193,151,42,950,315900,4853
704,517,187,1024,259800,4854
221,221,0,-,365100,4855
1290,1022,268,889,250000,4856
569,518,51,1083,238200,4858
347,266,81,1156,263300,4859
747,689,58,986,206600,4860
1417,993,424,795,183300,4861
1659,1385,274,800,184500,4862
461,375,86,900,327500,4863
1497,1434,63,950,166400,4864
11431,6728,4703,767,138000,4901
838,710,128,855,140400,4910
816,619,197,690,79400,4911
291,254,37,605,69700,4912
4176,2925,1251,875,174000,4915
1129,1091,38,921,221700,4917
149,121,28,-,223700,4918
841,587,254,670,82600,4920
683,581,102,770,134200,4921
445,377,68,590,129600,4922
237,229,8,-,124600,4923
910,740,170,778,130100,4924
19,19,0,-,350000,4925
113,113,0,-,-,4926
1468,1201,267,846,135900,4927
905,782,123,764,128700,4928
348,235,113,832,122000,4929
1831,1409,422,810,122100,4930
523,431,92,800,144200,4932
28,22,6,-,-,4933
91,85,6,-,200800,4936
2875,2212,663,694,130000,4937
3978,2448,1530,787,156400,4938
417,367,50,905,104200,4939
0,0,0,-,-,4940
753,576,177,682,163900,4941
566,454,112,590,132400,4942
810,692,118,631,109600,4943
28,28,0,-,-,4944
540,459,81,631,130700,4945
827,731,96,1000,206500,4947
350,312,38,681,194500,4949
2050,1543,507,865,108800,4950
484,417,67,838,138500,4951
857,730,127,830,158700,4952
1432,1062,370,674,157500,4953
579,533,46,785,142100,4955
294,265,29,643,116100,4956
1673,1286,387,784,153400,4957
738,663,75,699,129800,4958
392,374,18,575,93500,4961
76,22,54,823,-,4962
3149,2801,348,817,161700,4963
77,73,4,-,396200,4964
799,630,169,998,119500,4965
752,633,119,357,113200,4966
1604,1085,519,597,111600,4967
471,384,87,913,118800,4969
728,549,179,625,213900,4970
768,671,97,853,139000,4971
538,461,77,699,197400,4973
1339,923,416,758,103400,4974
14,14,0,-,-,4975
4339,2907,1432,783,135400,4976
364,327,37,646,194500,4978
367,323,44,687,150900,4979
1272,1120,152,843,165500,4981
267,161,106,566,178100,4982
719,640,79,670,121100,4983
288,261,27,723,137000,4984
48,44,4,-,283300,4985
653,512,141,827,122900,4986
461,411,50,874,141700,4987
705,533,172,675,165300,4988
1902,1548,354,860,176600,4989
30,30,0,-,-,4992
4396,3118,1278,1034,234100,5001
44,44,0,-,500000,5031
1158,903,255,1056,188100,5032
1063,775,288,940,178900,5033
104,52,52,776,210000,5034
302,275,27,1114,210500,5035
521,431,90,1038,279400,5036
331,312,19,1031,249200,5037
517,414,103,867,151300,5038
616,500,116,1072,182800,5039
270,263,7,-,155400,5040
128,85,43,-,170700,5041
203,160,43,800,154400,5042
477,409,68,1120,257000,5043
975,758,217,1106,207000,5045
465,397,68,567,161700,5046
1256,1055,201,938,223100,5048
61,16,45,827,156300,5050
656,509,147,1089,200400,5051
133,91,42,1523,219200,5052
109,103,6,-,405000,5053
1264,935,329,903,445300,5055
198,177,21,860,303800,5056
159,123,36,1694,223000,5058
232,178,54,-,328600,5059
1989,1346,643,913,206800,5060
582,464,118,1286,221800,5061
216,188,28,1052,257700,5062
421,299,122,1038,221400,5065
90,74,16,-,294800,5067
1342,910,432,1010,198700,5068
243,228,15,-,206300,5069
232,189,43,1135,343800,5070
77,72,5,-,380000,5071
256,237,19,-,317200,5072
405,362,43,1313,217200,5075
138,115,23,982,156900,5076
519,388,131,829,236900,5077
355,333,22,1125,174700,5079
185,111,74,720,147300,5081
86,68,18,756,85000,5083
24,24,0,-,-,5084
249,216,33,815,157900,5086
1876,1204,672,964,178800,5089
1604,1293,311,992,383100,5091
1955,1088,867,873,177000,5101
84,68,16,-,230000,5141
237,200,37,1250,214800,5142
1844,1565,279,868,205000,5143
242,214,28,743,248800,5146
534,456,78,1192,268600,5148
888,593,295,847,246100,5149
338,325,13,-,137300,5150
574,542,32,950,223800,5151
181,159,22,990,309700,5152
236,181,55,1005,248400,5153
255,101,154,786,220700,5154
354,217,137,904,264800,5155
4215,2954,1261,850,148300,5156
452,384,68,981,156700,5158
266,236,30,785,379200,5161
5979,3635,2344,873,171500,5201
1400,1184,216,1178,222800,5250
477,423,54,786,351700,5251
122,119,3,-,168300,5252
227,171,56,642,328800,5253
72,72,0,-,508900,5254
1984,1389,595,674,309900,5255
833,573,260,987,217900,5257
186,186,0,-,200700,5260
882,797,85,831,159800,5261
811,733,78,772,245000,5262
7634,4512,3122,854,222500,5301
335,307,28,905,270500,5340
243,153,90,537,264500,5341
205,180,25,923,172100,5342
394,334,60,983,233100,5343
902,758,144,1086,230700,5345
2066,1669,397,1047,226800,5346
289,241,48,-,172000,5350
378,354,24,850,218500,5352
502,404,98,1120,221200,5353
889,606,283,823,213100,5354
277,241,36,980,174000,5355
291,193,98,1045,279700,5356
71,64,7,1094,185700,5358
217,180,37,1188,241700,5359
95,76,19,533,281300,5360
403,333,70,944,194200,5361
55,51,4,-,337000,5362
973,645,328,877,222500,5363
12325,3676,8649,1293,353600,5401
8508,4989,3519,1421,309000,5403
3342,1187,2155,1231,231300,5404
161,0,161,1479,-,5405
3896,2559,1337,1123,271900,5408
0,0,0,-,-,5439
778,639,139,963,205600,5440
357,341,16,-,200300,5441
170,160,10,-,164700,5442
2914,2304,610,1079,246100,5443
554,464,90,1097,248800,5444
1595,1421,174,1729,546500,5445
6669,4693,1976,1161,276200,5446
34,29,5,-,134400,5447
390,382,8,-,197000,5448
1814,1463,351,813,213100,5450
9228,6528,2700,1274,316900,5452
1985,1568,417,1159,260900,5454
471,378,93,1036,268400,5455
465,418,47,-,298600,5456
714,593,121,734,195500,5457
877,735,142,1045,314100,5458
827,624,203,747,198500,5459
2049,1569,480,1193,360900,5461
751,690,61,1295,281300,5462
194,183,11,1042,191800,5463
1161,813,348,964,268300,5464
2049,1866,183,986,333600,5465
5187,4459,728,1270,263300,5468
386,278,108,-,166700,5471
703,586,117,1089,284500,5472
574,438,136,1287,343100,5473
474,446,28,1175,288200,5474
1264,887,377,950,149700,5476
1969,1482,487,974,328800,5477
6077,4105,1972,1104,222700,5478
0,0,0,-,-,5481
3274,2370,904,1371,398800,5482
568,503,65,1309,189800,5483
32,32,0,-,116700,5485
637,538,99,1219,378000,5486
591,521,70,1273,219800,5487
2851,2336,515,1040,213200,5488
1332,1173,159,1544,320400,5489
2437,1770,667,1059,240300,5491
332,271,61,850,203100,5492
633,579,54,1058,303300,5494
4309,3372,937,1515,344500,5495
5650,3566,2084,1071,262500,5602
104,83,21,1239,329800,5640
7503,4831,2672,838,182000,5641
476,403,73,906,193800,5647
188,155,33,-,284400,5648
214,214,0,-,157600,5649
442,373,69,1375,286000,5650
597,554,43,549,244400,5651
253,222,31,1296,150500,5652
268,203,65,-,186300,5653
471,226,245,919,132500,5654
1181,1041,140,884,176800,5655
1360,818,542,891,153400,5656
34,34,0,-,187500,5657
587,538,49,-,172100,5658
677,588,89,1063,283300,5660
2626,1754,872,926,201200,5661
2273,1589,684,859,188400,5663
46,46,0,-,-,5664
849,589,260,961,226200,5667
355,311,44,794,203300,5669
2342,1601,741,1075,443900,5672
1214,945,269,1104,349300,5673
662,567,95,792,368200,5674
545,502,43,974,146500,5675
2033,1412,621,977,273800,5676
890,758,132,806,331100,5677
52,52,0,-,102200,5678
1296,1170,126,-,184100,5679
839,711,128,829,192500,5680
164,159,5,-,217900,5681
508,434,74,958,230900,5682
9381,5529,3852,823,165600,5701
91,81,10,1050,177100,5730
441,327,114,795,241400,5732
2632,2031,601,837,184100,5733
550,416,134,936,264800,5734
1479,1112,367,954,178100,5735
209,128,81,1025,165700,5736
347,306,41,800,204400,5737
493,451,42,1142,247500,5738
547,439,108,861,229700,5739
22,22,0,-,-,5740
259,209,50,745,222600,5742
1495,1150,345,818,155400,5743
217,126,91,1223,220000,5744
153,121,32,967,168300,5747
228,121,107,846,158200,5748
310,269,41,1181,318500,5751
3635,2352,1283,997,292500,5753
302,267,35,1031,214800,5757
289,275,14,900,198700,5758
651,511,140,871,192700,5759
379,347,32,-,225000,5760
409,371,38,875,213400,5761
179,146,33,908,202600,5762
1160,981,179,897,184400,5763
1171,853,318,815,159300,5764
694,571,123,948,167600,5765
231,189,42,1393,235100,5766
621,540,81,788,174500,5767
466,371,95,981,278000,5769
439,341,98,997,227000,5770
319,277,42,918,219000,5772
996,759,237,855,211600,5773
433,371,62,860,166100,5774
265,148,117,772,147100,5775
305,240,65,727,303800,5776
1430,1214,216,904,160400,5777
339,206,133,897,253800,5778
3909,2514,1395,766,166800,5819
207,186,21,-,165900,5820
482,433,49,913,203200,5821
633,476,157,700,128000,5822
483,434,49,663,162700,5824
41,33,8,-,121900,5825
366,303,63,922,173900,5826
116,92,24,738,223500,5827
870,658,212,621,222200,5828
822,565,257,795,176300,5829
560,439,121,725,147600,5830
495,455,40,803,238400,5832
73,73,0,-,189800,5833
533,494,39,800,169300,5836
167,146,21,1398,119700,5837
290,260,30,760,187200,5839
200,180,20,721,276500,5841
181,167,14,625,160100,5842
944,823,121,923,96500,5843
555,491,64,598,195600,5845
593,417,176,671,125700,5846
375,271,104,923,132600,5847
57,35,22,-,-,5850
2467,1706,761,818,175100,5851
282,259,23,739,172700,5853
2992,1955,1037,830,159500,5855
1193,1044,149,1050,195500,5857
194,180,14,-,114700,5858
749,610,139,1063,175000,5859
1148,894,254,768,137000,5860
218,194,24,793,220900,5862
286,241,45,856,138600,5866
316,281,35,1063,207500,5867
98,98,0,-,178800,5868
565,453,112,725,185300,5871
400,361,39,836,144300,5872
334,237,97,1296,171800,5873
217,187,30,793,187500,5874
261,245,16,-,215700,5875
9,9,0,-,-,5901
86,74,12,-,116200,5902
372,312,60,700,123000,5903
80,45,35,1042,70700,5904
435,384,51,950,214300,5905
567,480,87,761,137000,5906
67,59,8,-,116300,5907
7278,6070,1208,1474,369200,6001
8620,5873,2747,1428,219400,6002
24408,15470,8938,1093,198600,6010
3442,3177,265,1224,339000,6013
2581,1882,699,1522,247900,6016
1199,779,420,968,193800,6018
4198,3325,873,1196,327500,6019
0,0,0,-,-,6020
146,131,15,-,273700,6021
40,40,0,-,-,6022
683,568,115,1182,307300,6023
117,109,8,-,233100,6024
1939,1552,387,955,285900,6026
574,517,57,1094,272500,6027
6844,4555,2289,1351,276800,6029
596,493,103,1306,407300,6031
7456,5271,2185,1638,341500,6032
11723,9229,2494,1370,335600,6033
3214,2937,277,1054,282000,6035
7559,6351,1208,1196,291100,6037
728,475,253,1168,373900,6039
14388,7466,6922,1122,191900,6040
9550,5267,4283,1531,171400,6042
1835,1680,155,1161,270900,6043
11879,3316,8563,969,157500,6051
3198,1864,1334,1083,203900,6052
12636,6088,6548,1084,157500,6053
2364,2145,219,1640,291400,6057
701,528,173,984,334400,6058
0,0,0,-,-,6059
887,837,50,-,394200,6060
102,57,45,-,152500,6061
8187,5533,2654,1003,214000,6062
1130,1004,126,1319,261300,6063
323,316,7,-,267300,6065
12949,6671,6278,1170,211600,6066
8677,5685,2992,1459,270800,6067
652,457,195,1690,869800,6068
1214,887,327,985,328500,6069
5857,4556,1301,1660,338700,6070
3436,3016,420,1165,318200,6071
2227,2013,214,1315,414700,6073
9753,8390,1363,1510,290500,6074
5103,3951,1152,1002,206700,6076
3873,3342,531,1227,328500,6078
664,383,281,1045,212300,6081
16897,12940,3957,1229,191300,6082
5460,5062,398,1279,296600,6084
2813,2215,598,1039,323300,6085
2407,1676,731,1129,164200,6088
1291,835,456,1675,317500,6089
324,295,29,-,431900,6090
56,50,6,-,319400,6091
1585,1500,85,1642,397300,6092
1252,1193,59,1612,331600,6093
11073,9271,1802,1335,223400,6095
5398,4419,979,1174,195200,6096
5413,3201,2212,957,195500,6098
1276,80,1196,1625,378600,6103
9891,1804,8087,932,302500,6105
14634,3550,11084,994,163300,6106
7805,6496,1309,1496,381500,6107
8778,4046,4732,1034,167900,6108
10929,8604,2325,1093,257200,6109
5298,3471,1827,1244,222600,6110
12581,9791,2790,1217,233200,6111
7481,2998,4483,1062,164200,6112
9864,2976,6888,1036,185400,6114
5663,4480,1183,1594,366900,6117
10104,7003,3101,1096,168600,6118
6304,2958,3346,1312,302100,6119
4963,770,4193,923,135900,6120
0,0,0,-,-,6160
6852,2377,4475,911,148800,6226
1354,1301,53,-,299900,6231
1203,1039,164,866,297400,6232
2819,2141,678,1056,227200,6234
972,878,94,955,206800,6235
2370,1989,381,727,266800,6237
4743,4259,484,1256,257800,6238
4637,2876,1761,1044,194300,6239
2438,1737,701,995,196700,6241
482,394,88,926,263500,6242
95,95,0,-,-,6243
1043,902,141,1173,231700,6247
2249,1999,250,1192,305900,6248
2921,2704,217,1208,258000,6249
1999,1382,617,1558,237800,6250
702,575,127,695,242000,6254
1845,1230,615,1010,234200,6255
876,801,75,991,160300,6256
1782,1427,355,1022,285300,6259
3959,2321,1638,1029,197600,6260
388,299,89,-,176700,6262
114,41,73,-,192700,6263
64,24,40,-,-,6264
203,85,118,888,166800,6266
3606,1555,2051,1383,258700,6268
12,12,0,-,-,6269
1554,1412,142,1475,218700,6277
1865,1439,426,1021,269100,6278
2692,1664,1028,1096,243000,6279
1277,729,548,1323,196800,6280
2900,2456,444,1036,304900,6281
421,353,68,-,233600,6282
11001,4373,6628,1034,186900,6320
1267,815,452,1150,217700,6330
2121,1808,313,973,233900,6331
114,72,42,-,166700,6332
2712,2070,642,1480,360100,6333
950,784,166,1046,218300,6334
2195,1921,274,1665,236600,6335
37,25,12,-,340500,6336
3447,2872,575,1157,232300,6339
12639,4951,7688,1269,213800,6340
26,26,0,-,-,6350
7041,5572,1469,1033,198200,6351
125,106,19,-,-,6353
2143,1371,772,952,193100,6354
5465,4476,989,1313,342600,6355
4649,3290,1359,1291,294700,6357
2192,1932,260,963,294600,6359
15179,8258,6921,1069,173300,6360
1808,1584,224,1340,264100,6365
2717,2387,330,1006,233300,6370
4061,3381,680,1409,424300,6371
89,55,34,-,319600,6373
3273,2677,596,919,193900,6374
1410,1246,164,1134,232600,6375
89,63,26,-,457300,6376
1116,878,238,1273,204300,6377
2703,1984,719,1375,415000,6378
3960,2778,1182,1020,301400,6379
1176,403,773,904,135300,6380
3873,2987,886,1165,205100,6382
1134,892,242,948,252200,6384
6533,5082,1451,1390,260500,6385
176,30,146,1069,179200,6387
0,0,0,-,-,6389
24,16,8,-,-,6390
8137,4801,3336,1117,217300,6401
2644,2307,337,1552,251600,6403
12656,8266,4390,1347,310400,6405
393,312,81,841,273600,6409
10231,8846,1385,1336,338900,6410
1724,1314,410,1258,336900,6412
5293,4393,900,1248,288200,6413
48,48,0,-,246700,6414
6407,5035,1372,1265,267600,6415
5706,4229,1477,1347,243300,6416
1987,1389,598,1133,291800,6417
5794,3730,2064,1101,200400,6418
2353,2208,145,1227,348700,6419
1654,1406,248,1394,306700,6420
2932,2725,207,1454,332500,6422
2298,2126,172,1022,317300,6423
4812,4264,548,1249,262100,6424
1587,1125,462,1071,548400,6426
8482,7298,1184,1523,398400,6437
901,696,205,858,348500,6438
2066,1814,252,-,325200,6441
927,698,229,881,356700,6442
6789,5853,936,1360,424000,6443
81,63,18,-,-,6444
2289,2038,251,1167,305500,6447
15139,9382,5757,1066,168500,6450
10075,5197,4878,1006,179500,6451
1191,1078,113,1406,297600,6455
122,122,0,-,345900,6456
19876,10400,9476,1138,234300,6457
16702,11566,5136,1617,319100,6460
5658,5096,562,1489,328000,6461
169,169,0,-,240400,6467
6653,5969,684,1207,376800,6468
1251,887,364,1119,277300,6469
5748,5066,682,1349,408300,6470
3089,2626,463,1388,292200,6471
2514,2202,312,1341,319100,6472
9287,7689,1598,1383,297100,6473
4218,3457,761,1631,405400,6475
5013,4537,476,1543,391500,6477
4987,4613,374,1079,363000,6478
4255,3522,733,1063,276400,6479
3674,3031,643,1129,240500,6480
651,406,245,"3,500+",269400,6481
4186,3874,312,1848,368000,6482
6297,4579,1718,1154,271100,6483
16516,13139,3377,1375,345200,6484
8019,6864,1155,1666,327800,6488
12538,10492,2046,1145,293000,6489
18375,13272,5103,1105,275100,6492
3491,2867,624,1178,364400,6498
1578,122,1456,1577,330800,6510
20397,4279,16118,1295,234000,6511
11032,7364,3668,1184,218700,6512
15135,5707,9428,1082,184400,6513
9976,6359,3617,1330,199600,6514
6327,2555,3772,1259,230700,6515
19729,10140,9589,1164,196800,6516
5683,3605,2078,1138,239500,6517
6476,4141,2335,1704,256100,6518
5145,1473,3672,1155,171700,6519
1860,1705,155,1530,408900,6524
2935,2621,314,1681,472400,6525
9903,3179,6724,1124,202500,6604
8968,2501,6467,1181,218700,6605
16421,9883,6538,1260,187600,6606
2842,1003,1839,1165,150200,6607
4700,1138,3562,1168,167000,6608
8801,4138,4663,1102,168700,6610
11942,10340,1602,2004,400000,6611
2702,2402,300,3177,629400,6612
12686,11120,1566,1525,273000,6614
7301,4643,2658,1284,245200,6615
1779,59,1720,504,-,6702
9868,4254,5614,1007,132100,6704
10469,4438,6031,1020,124900,6705
5151,2447,2704,976,118900,6706
11453,6631,4822,1057,144700,6708
3403,1120,2283,1026,153100,6710
3314,3044,270,1249,286400,6712
6405,5459,946,1435,248100,6716
472,302,170,692,266400,6750
1342,1016,326,889,342300,6751
730,618,112,2072,510800,6752
694,583,111,1600,383300,6754
321,289,32,-,276300,6755
968,894,74,1976,333900,6756
1037,820,217,823,331500,6757
118,118,0,-,318200,6758
2354,1899,455,1187,351600,6759
2889,2523,366,-,360500,6762
773,662,111,937,306300,6763
11917,8056,3861,1096,188000,6770
9856,7831,2025,1281,304900,6776
628,579,49,1488,382400,6777
589,547,42,962,254400,6778
3555,2210,1345,1165,200700,6779
785,710,75,967,229700,6782
958,756,202,1382,595400,6783
1605,1416,189,2055,451100,6784
240,200,40,-,523400,6785
4076,3018,1058,1011,201000,6786
3072,2302,770,970,223100,6787
14344,9876,4468,951,153600,6790
2038,1954,84,1281,301000,6791
523,363,160,1612,850700,6793
396,259,137,1225,340100,6794
5435,4637,798,968,267300,6795
480,433,47,1063,436900,6796
4533,3665,868,1313,383100,6798
7221,5455,1766,1273,344500,6801
6268,5342,926,1640,375100,6804
2611,1750,861,1876,1066400,6807
19473,8788,10685,1466,281400,6810
11554,8915,2639,1495,339400,6811
4693,4347,346,1875,362900,6812
6945,5952,993,3052,1465800,6820
12173,10088,2085,1950,678700,6824
7294,5903,1391,1751,459900,6825
9438,5017,4421,1963,1595800,6830
5133,3856,1277,2183,1241400,6831
6855,5574,1281,2324,1245400,6840
7862,4590,3272,1835,439200,6850
10792,6976,3816,1767,448700,6851
1472,1175,297,1792,1035000,6853
10682,5172,5510,1579,386600,6854
3553,1751,1802,1666,447600,6855
0,0,0,-,-,6856
2712,2207,505,2199,1485300,6870
9250,7853,1397,1766,657100,6877
2583,2216,367,2775,1601000,6878
10127,8785,1342,1886,1110400,6880
3531,3457,74,2659,840700,6883
1679,1489,190,2322,871600,6890
3401,2877,524,1375,576800,6896
5955,5263,692,1981,785200,6897
4065,567,3498,1789,367700,6901
27532,10863,16669,1876,451400,6902
5068,4699,369,3483,742000,6903
7488,5339,2149,2063,562400,6905
3476,1987,1489,2003,461300,6906
3229,2078,1151,1573,480100,6907
5145,2435,2710,1441,277900,7001
24784,10061,14723,1325,346000,7002
18732,9809,8923,1399,348400,7003
2854,2388,466,2289,499500,7004
5488,3939,1549,1406,476900,7005
9573,7318,2255,1711,567300,7006
8036,4641,3395,1521,281000,7008
4525,3703,822,1447,488500,7009
10592,5324,5268,1552,454400,7010
12662,5488,7174,1424,327000,7011
4896,2669,2227,1451,363300,7012
10335,7164,3171,1358,373600,7013
1788,1302,486,1951,328500,7014
9079,7203,1876,1583,507600,7016
13722,3546,10176,1145,229100,7017
10720,2259,8461,1180,218500,7018
6046,2383,3663,2422,617500,7020
693,651,42,3250,861900,7021
5395,1844,3551,1399,426700,7022
2604,2253,351,1859,495700,7023
17396,10102,7294,1909,348300,7024
11670,5207,6463,1357,356500,7026
1782,1022,760,1552,409600,7027
2441,2271,170,1725,648600,7028
8262,2073,6189,1573,335100,7029
24983,8654,16329,2360,759800,7030
6376,3072,3304,1408,372400,7031
13698,6386,7312,1338,354700,7032
2727,1918,809,1644,356800,7033
3750,2240,1510,1192,336800,7034
3850,2862,988,1561,344400,7035
15503,9042,6461,1313,292800,7036
10280,8730,1550,2472,626000,7039
8110,6629,1481,1838,544000,7040
2537,1750,787,1663,833500,7041
10054,5169,4885,1693,502100,7042
4057,3458,599,2140,741900,7043
5349,4394,955,1643,466300,7044
3549,3382,167,2846,616500,7045
1385,1327,58,1441,837300,7046
21992,8916,13076,1433,375100,7047
11831,2241,9590,1197,256300,7050
16804,11497,5307,1580,391200,7052
11222,5679,5543,1404,469700,7054
19837,4280,15557,1189,347900,7055
4781,1911,2870,1293,386600,7057
2114,1411,703,2039,661800,7058
5298,4640,658,2000,779000,7059
15315,6161,9154,1259,279700,7060
3994,2513,1481,1350,262400,7062
3902,2395,1507,1415,264100,7063
1283,1102,181,1326,322000,7064
11621,6687,4934,1271,276500,7065
6043,4725,1318,1460,466400,7066
6026,5337,689,1675,369100,7067
2237,1716,521,2594,516500,7068
2117,1789,328,2085,713900,7069
6835,4100,2735,1474,476200,7070
9043,5227,3816,1488,408400,7071
2318,1535,783,1472,403200,7072
4319,1425,2894,1504,381000,7073
836,589,247,1021,359100,7074
3408,2286,1122,1614,443600,7075
8584,7212,1372,1665,536900,7076
984,665,319,1462,314800,7077
4186,3765,421,3168,1392300,7078
5201,3551,1650,1857,644900,7079
8198,7063,1135,1675,352200,7080
6797,4162,2635,1831,445800,7081
1979,1891,88,2653,486600,7082
19268,14395,4873,1680,341700,7083
6905,2209,4696,1825,714700,7086
25550,5070,20480,1247,359900,7087
1114,654,460,1695,258600,7088
10177,8224,1953,1713,773800,7090
2544,2198,346,3432,638500,7092
23585,6041,17544,1386,328200,7093
7672,4395,3277,1907,473600,7094
7319,4023,3296,1811,283400,7095
5721,537,5184,874,310800,7102
12192,2894,9298,1048,195800,7103
18429,4673,13756,1139,282100,7104
17353,3633,13720,1281,341400,7105
11944,3948,7996,1088,240200,7106
13574,3358,10216,1093,248300,7107
9658,1648,8010,918,207500,7108
12819,7028,5791,1391,307300,7109
11138,7520,3618,1401,390600,7110
20636,5717,14919,1089,212000,7111
9911,2753,7158,1127,241100,7112
3537,579,2958,696,347600,7114
8976,2047,6929,1211,279500,7201
13284,3501,9783,1199,281400,7202
7445,4321,3124,1192,230600,7203
5042,2822,2220,1299,295800,7204
7162,4974,2188,1440,274600,7205
8040,2234,5806,1226,260600,7206
11417,3017,8400,1180,332800,7208
23261,5983,17278,2524,736700,7302
15476,4765,10711,1204,361900,7304
23147,9646,13501,1243,333100,7305
20026,4697,15329,1270,386100,7306
15628,4891,10737,1382,452500,7307
6019,755,5264,2945,739500,7310
301,0,301,3208,-,7311
2235,1714,521,1964,699100,7401
2897,1951,946,1797,319800,7403
6703,5286,1417,1369,462600,7405
6933,3703,3230,1698,369500,7407
11488,9236,2252,1826,439100,7410
2543,1634,909,1112,200100,7416
3839,3429,410,2730,1009800,7417
926,912,14,-,276300,7418
3699,2810,889,1385,233600,7419
1888,1473,415,1466,269000,7420
2831,2522,309,2104,287700,7421
2188,2064,124,1553,225300,7422
1438,1354,84,2405,786800,7423
10559,7251,3308,1432,372000,7424
9788,7720,2068,2091,490500,7430
2885,1869,1016,1662,497500,7432
1144,953,191,2062,407400,7435
4248,3767,481,1612,472400,7436
4579,4232,347,1163,359700,7438
801,701,100,1629,224500,7439
1583,1377,206,1381,462400,7440
4216,3047,1169,1451,324700,7442
4814,3899,915,2574,401800,7444
5346,4699,647,1733,605000,7446
8441,6852,1589,2062,743000,7450
3593,3335,258,1791,666600,7452
4232,3998,234,1827,359800,7456
1853,1355,498,2496,336500,7457
3867,3387,480,2303,1106500,7458
1288,1183,105,2212,305700,7460
6782,5711,1071,1309,281200,7461
2649,1986,663,1350,211700,7462
3399,3042,357,1725,462200,7463
2585,2063,522,1737,344100,7465
18670,14580,4090,1778,482700,7470
6018,5431,587,1565,292400,7480
5808,5258,550,1880,787600,7481
0,0,0,-,-,7495
11039,1630,9409,1127,253800,7501
4412,2155,2257,1308,260600,7502
5476,1741,3735,1256,261800,7503
3779,1394,2385,1306,293900,7504
1111,61,1050,859,-,7505
7138,4403,2735,1485,411900,7506
7478,4736,2742,1447,355600,7508
3692,2797,895,1346,370300,7512
3138,879,2259,1366,262900,7513
6080,1834,4246,1204,230200,7514
6396,1168,5228,1210,198900,7522
4196,1009,3187,1199,286200,7524
19537,6583,12954,1493,306700,7601
2883,2092,791,1475,335400,7603
4250,2878,1372,1553,432000,7604
3344,2130,1214,1478,522000,7605
803,383,420,1531,400400,7606
3717,2574,1143,1581,396000,7607
36,0,36,1643,-,7608
518,455,63,1117,"2,000,000+",7620
9037,6191,2846,1420,369500,7621
2632,2183,449,1956,689100,7624
2917,2357,560,2467,680500,7626
1672,1401,271,"3,500+",716100,7627
6558,4804,1754,1353,383900,7628
2639,2281,358,1845,532200,7630
11064,5879,5185,1511,403800,7631
1906,1632,274,"3,500+",1086600,7632
1746,1689,57,3010,597400,7640
1084,1042,42,-,679300,7641
3454,3040,414,1326,566300,7642
4106,1601,2505,1408,363900,7643
8825,3524,5301,1373,389400,7644
2902,2532,370,1789,612600,7645
5886,3805,2081,1442,433000,7646
1806,1540,266,1394,460600,7647
1945,1625,320,1827,629900,7648
2672,2351,321,1733,642300,7649
7291,2729,4562,1638,577900,7650
8334,6886,1448,2503,614900,7652
3315,2743,572,1491,605300,7656
3865,1800,2065,1668,471400,7657
4795,2390,2405,1402,367500,7660
4119,3128,991,1598,523900,7661
2139,1686,453,1710,391500,7662
5184,3373,1811,1728,375800,7663
13164,10090,3074,1467,406500,7666
4670,3673,997,3073,848600,7670
9697,7248,2449,1847,587200,7675
3334,3191,143,1412,540800,7676
1890,1724,166,1980,840100,7677
10559,6824,3735,1647,422900,7701
1374,1269,105,2940,610300,7702
46,33,13,-,-,7703
1887,1775,112,"3,500+",772200,7704
574,470,104,1403,761500,7711
16623,7884,8739,1242,435100,7712
3593,2575,1018,1309,471300,7716
876,569,307,1456,939700,7717
2471,2217,254,1690,392300,7718
8742,6268,2474,1464,487600,7719
1934,874,1060,1427,665900,7720
1258,750,508,1448,292700,7721
3451,3094,357,2123,750000,7722
284,159,125,1153,1066900,7723
8733,5944,2789,1312,375800,7724
15792,13430,2362,1591,468100,7726
2255,1785,470,1119,462700,7727
20180,14826,5354,1650,398400,7728
6260,5585,675,1016,356600,7730
12737,11384,1353,1672,351500,7731
2688,1943,745,1270,290100,7732
5975,5252,723,2582,700400,7733
4844,2841,2003,1405,229700,7734
7567,5688,1879,1177,279200,7735
1422,1280,142,1387,340400,7737
2223,2022,201,559,585900,7738
2064,1922,142,"3,500+",709600,7739
12153,4942,7211,1370,368800,7740
5808,5612,196,2545,565100,7746
12235,9501,2734,1684,374900,7747
9584,8130,1454,1428,453500,7748
1485,1132,353,1912,845600,7750
6595,5974,621,2285,545200,7751
16009,10697,5312,1472,306100,7753
2033,1726,307,1773,434300,7755
1871,951,920,1280,695300,7756
2258,2015,243,-,521900,7757
1609,1307,302,1181,330400,7758
2960,2540,420,1779,1037000,7760
3964,2648,1316,1485,686800,7762
2692,1959,733,1467,454900,7764
8472,3993,4479,1523,284500,7801
1269,1122,147,1764,297300,7803
0,0,0,-,-,7820
3434,3076,358,1395,332800,7821
344,344,0,-,378600,7822
3704,2425,1279,795,254900,7823
3420,3053,367,1272,337500,7825
2236,1831,405,1571,285600,7826
1696,1497,199,886,227100,7827
5992,3172,2820,1233,349900,7828
2721,2588,133,1066,520200,7830
1249,1131,118,1145,288500,7832
59,48,11,-,215800,7833
6820,5691,1129,1599,442000,7834
4117,2634,1483,1653,411100,7836
1237,1075,162,1405,333800,7838
11603,7912,3691,1267,308800,7840
31,31,0,-,-,7842
4341,3692,649,1491,242600,7843
12,12,0,-,233300,7846
848,656,192,1730,267700,7847
1635,1420,215,1205,353800,7848
3630,3111,519,1485,349200,7849
2429,1859,570,1434,312300,7850
62,60,2,-,279200,7851
1577,1406,171,1608,365100,7852
4272,4095,177,1911,477000,7853
1837,1262,575,2162,329100,7856
1638,856,782,1172,269300,7857
9801,7710,2091,1212,270100,7860
1482,1286,196,792,231000,7863
651,567,84,-,323800,7865
8324,6887,1437,1489,357000,7866
9024,6863,2161,1509,549700,7869
8,8,0,-,-,7870
7167,6401,766,1771,377900,7871
3021,2667,354,1643,264400,7874
3307,3068,239,1786,399400,7876
244,221,23,-,330400,7878
64,64,0,-,131800,7880
4,4,0,-,-,7881
5769,4064,1705,1159,252500,7882
3947,2653,1294,1798,293100,7885
8409,5878,2531,1928,816200,7901
9811,8167,1644,2016,665900,7920
3870,3018,852,2115,371200,7921
4101,3945,156,2242,633500,7922
2505,2179,326,1721,656000,7924
20,9,11,-,-,7926
1720,1003,717,2629,486800,7927
6304,5329,975,2005,857300,7928
2896,2645,251,1438,663200,7930
1047,893,154,2583,906300,7931
4228,3016,1212,2524,611200,7932
989,870,119,3309,567100,7933
497,444,53,1669,727300,7934
106,85,21,-,"2,000,000+",7935
3765,3587,178,2599,598100,7936
43,13,30,-,-,7939
5755,3715,2040,1908,740800,7940
3240,2978,262,1473,774900,7945
1133,1027,106,3076,623500,7946
7468,5641,1827,2147,481200,7950
17712,11095,6617,1934,609900,7960
0,0,0,-,-,7961
40,40,0,-,-,7970
4511,3801,710,1826,634400,7974
253,146,107,1317,"2,000,000+",7976
206,85,121,1717,619300,7977
171,171,0,-,677100,7979
899,637,262,1509,573800,7980
3701,3224,477,1816,519300,7981
281,213,68,960,232800,8001
8684,6055,2629,1493,244500,8002
10884,9481,1403,1712,334900,8003
4072,3392,680,1229,199400,8004
9660,8562,1098,1693,269200,8005
189,174,15,-,669400,8006
2106,1110,996,947,174300,8007
3356,3078,278,1290,826000,8008
4882,4270,612,1354,227000,8009
4244,2826,1418,1310,185000,8010
0,0,0,-,-,8011
14625,10063,4562,1184,214700,8012
124,112,12,-,169800,8014
7173,5734,1439,1292,167200,8015
12742,9533,3209,1079,239600,8016
451,404,47,2156,318900,8019
1208,1174,34,-,324200,8020
18973,9167,9806,1060,148600,8021
3729,3515,214,1209,324900,8022
128,43,85,1309,150700,8023
757,718,39,2281,216300,8026
1895,1589,306,1113,180200,8027
6696,4396,2300,1379,211800,8028
2050,1469,581,545,170300,8029
5162,3374,1788,1137,127000,8030
4491,2701,1790,977,169400,8031
6003,4474,1529,1135,456400,8033
7233,5616,1617,1496,254000,8034
3199,2481,718,1110,282400,8035
2313,2168,145,1051,335800,8036
8453,6371,2082,1184,231400,8037
92,46,46,-,179200,8038
44,23,21,-,311500,8039
320,307,13,-,388700,8041
112,100,12,-,601200,8042
11035,7135,3900,1453,337100,8043
1162,800,362,914,176900,8045
10784,8383,2401,1637,171200,8046
4735,3584,1151,1354,331100,8048
2063,1405,658,1018,166100,8049
10190,9034,1156,1622,287900,8050
4104,3263,841,1457,183500,8051
8332,3822,4510,1245,187400,8052
18109,13078,5031,1558,299800,8053
17494,13243,4251,1619,275700,8054
9895,8752,1143,1409,359500,8055
1539,1478,61,1447,352500,8056
7215,6125,1090,1239,506400,8057
2153,1396,757,1077,169200,8059
9088,6604,2484,1294,235200,8060
893,851,42,2138,295000,8061
5467,5073,394,1147,361500,8062
1055,918,137,1306,146300,8063
22,22,0,-,-,8064
2761,1895,866,1456,175400,8065
3839,2394,1445,894,131200,8066
582,485,97,1438,233200,8067
2838,1697,1141,1070,211000,8068
4763,2316,2447,1048,140900,8069
5129,3764,1365,1018,157100,8070
3684,2609,1075,1300,190100,8071
107,107,0,-,131600,8072
40,40,0,-,290000,8073
0,0,0,-,-,8074
11098,7410,3688,1304,226900,8075
6837,5899,938,1668,280300,8077
3123,2184,939,1014,163000,8078
4018,2379,1639,866,167100,8079
13425,11751,1674,1447,260400,8080
16793,13498,3295,1273,203700,8081
3935,2889,1046,1112,199800,8083
2724,2061,663,970,180900,8084
6911,5686,1225,1637,297100,8085
3197,2340,857,1482,205000,8086
10617,8932,1685,1426,239400,8087
9440,9011,429,2035,279400,8088
1486,1363,123,1125,196500,8089
2911,2632,279,1098,200000,8090
2068,1486,582,1158,187000,8091
1275,1034,241,1292,279400,8092
3753,2348,1405,1055,158800,8093
15072,12878,2194,1123,205800,8094
7,7,0,-,-,8095
13638,10103,3535,1206,196500,8096
1146,1026,120,1038,200100,8097
3428,2559,869,1082,264500,8098
2687,671,2016,691,85300,8102
4932,1735,3197,993,79800,8103
8832,3281,5551,885,66900,8104
8366,4070,4296,1027,89700,8105
3878,2380,1498,993,221300,8106
5476,3000,2476,1121,189800,8107
7951,5091,2860,1332,274600,8108
8359,6079,2280,1010,172900,8109
5868,4231,1637,996,139400,8110
3752,2527,1225,1464,190100,8201
812,779,33,1300,1195300,8202
4151,2931,1220,1300,362100,8203
7461,5842,1619,1130,293800,8204
10208,8091,2117,1386,197200,8205
6614,5399,1215,1295,255500,8210
93,92,1,-,847800,8212
5163,3651,1512,1030,225900,8215
0,0,0,-,-,8217
2523,2185,338,1640,283200,8221
1875,1672,203,1394,273800,8223
142,121,21,1125,248800,8224
2903,2616,287,1256,225600,8225
5203,3696,1507,1291,573400,8226
1966,1835,131,1148,326700,8230
6232,3093,3139,1028,131700,8232
14263,12145,2118,1250,215900,8234
0,0,0,-,-,8240
442,418,24,1583,298800,8241
1340,917,423,1227,273900,8242
1105,1029,76,1325,732800,8243
4460,2468,1992,1124,219900,8244
32,32,0,-,-,8246
506,461,45,1294,1394200,8247
20,20,0,-,-,8248
4555,3653,902,1270,185700,8251
6251,4204,2047,1031,343400,8260
3111,2339,772,1075,264500,8270
13622,8071,5551,1125,165000,8302
665,427,238,974,156800,8310
585,507,78,1329,156700,8311
2971,2318,653,963,213000,8312
146,136,10,-,166000,8314
68,68,0,-,132600,8316
642,506,136,-,255000,8317
4724,3946,778,1075,216600,8318
420,415,5,-,255800,8319
0,0,0,-,-,8320
71,47,24,919,191100,8321
3433,3052,381,1344,215400,8322
200,162,38,1096,222900,8323
128,85,43,-,218800,8324
482,356,126,1467,154500,8326
192,125,67,1254,128100,8327
657,557,100,1426,178600,8328
141,124,17,-,269100,8329
10681,7830,2851,1382,190000,8330
14107,9807,4300,1052,164300,8332
485,386,99,1356,223100,8340
915,427,488,843,192300,8341
1587,1447,140,1725,277900,8343
1761,1594,167,1392,174000,8344
283,258,25,1313,160700,8345
252,252,0,-,155600,8346
53,45,8,-,144100,8348
809,559,250,1356,123800,8349
182,182,0,-,250000,8350
219,176,43,-,158400,8352
135,96,39,970,159800,8353
15066,9324,5742,1063,157300,8360
6392,5152,1240,1073,218500,8361
15775,4454,11321,927,150000,8401
2877,2421,456,1370,490400,8402
475,399,76,1773,856300,8403
4655,3000,1655,1266,260800,8406
2405,2215,190,1287,439000,8501
3654,3011,643,2146,635000,8502
6729,4953,1776,1274,293000,8505
1898,1742,156,1969,599900,8510
472,349,123,956,242800,8511
4264,2516,1748,1364,521600,8512
2023,1860,163,1661,391600,8514
1675,1560,115,1802,454100,8515
2206,1492,714,1062,241400,8518
9280,6757,2523,1388,299600,8520
1872,1518,354,1537,444900,8525
20187,17292,2895,1551,373700,8527
50,35,15,-,-,8528
2958,2141,817,1389,444500,8530
2597,2082,515,1175,354900,8533
4781,4049,732,1738,463600,8534
1564,1439,125,1836,595600,8535
7742,3582,4160,1645,552400,8536
18143,11795,6348,1967,650300,8540
1500,438,1062,1490,527800,8542
6620,5373,1247,2161,631800,8550
1979,1783,196,2295,501300,8551
234,206,28,1700,515300,8553
1625,1343,282,1332,163400,8554
288,232,56,2054,317600,8555
2549,2208,341,1451,672100,8558
2166,1848,318,1744,477200,8559
1545,1475,70,1830,378600,8560
172,112,60,-,369200,8561
1747,1061,686,1451,170300,8562
481,25,456,670,-,8608
4216,1260,2956,1060,74500,8609
11024,7536,3488,1239,200800,8610
9289,3441,5848,1137,97300,8611
12788,5449,7339,1029,172200,8618
9031,6337,2694,1445,255500,8619
3945,3170,775,1043,277600,8620
4133,2605,1528,1420,290500,8628
4087,2865,1222,1194,108200,8629
8081,4690,3391,1246,176900,8638
1065,1,1064,2098,-,8640
1140,0,1140,2091,-,8641
11678,7949,3729,1742,335000,8648
6749,5769,980,1382,302600,8690
6336,5473,863,1780,409100,8691
24079,12251,11828,1414,359800,8701
270,228,42,-,558500,8720
7706,6507,1199,1523,291100,8721
3992,3614,378,1642,235700,8722
12933,9902,3031,1418,298900,8723
16716,13923,2793,1646,290900,8724
1690,1554,136,2273,655500,8730
7963,6977,986,1679,277500,8731
655,575,80,1625,420100,8732
1017,637,380,1232,190600,8733
3082,2821,261,-,325600,8734
2220,1877,343,1419,656300,8735
5188,4539,649,1406,654100,8736
694,634,60,1457,1217600,8738
680,496,184,1529,256500,8740
1019,939,80,1300,345700,8741
10085,7974,2111,1649,419200,8742
1358,1247,111,1173,865800,8750
2047,1093,954,1282,451800,8751
1248,954,294,1322,662000,8752
24019,19040,4979,1502,297400,8753
10224,8471,1753,1358,280700,8755
17031,14681,2350,1447,180900,8757
3491,3039,452,1682,337500,8758
19639,16892,2747,1078,131700,8759
2563,2164,399,1764,443800,8801
1482,1400,82,1590,377700,8802
1067,848,219,595,347500,8804
4176,2294,1882,1490,293600,8805
12996,10698,2298,1676,483400,8807
77,57,20,-,83000,8808
2069,1548,521,1499,361100,8809
2855,2460,395,1764,411200,8810
4551,3570,981,1226,335200,8812
16129,13197,2932,1535,406400,8816
15071,8371,6700,1667,328700,8817
12535,9475,3060,1611,494700,8820
142,142,0,-,394700,8821
10847,8717,2130,1453,425900,8822
3454,2391,1063,1870,258700,8823
4152,3551,601,1498,458400,8824
1670,1260,410,1350,416100,8825
2042,1701,341,1322,355000,8826
1624,1426,198,511,363300,8827
915,694,221,1712,243900,8828
1401,1073,328,1383,263000,8829
6304,4513,1791,1821,317200,8830
21941,19553,2388,1407,371400,8831
966,184,782,1435,307100,8832
3293,2833,460,1697,486300,8833
4007,2896,1111,1387,267400,8835
1357,1295,62,1818,641500,8836
6404,3094,3310,1431,332800,8837
5957,4749,1208,1723,427100,8840
14039,11967,2072,1861,447300,8844
4909,3661,1248,1419,320500,8846
3215,2957,258,1395,330900,8848
2983,2430,553,1590,345700,8850
6639,4542,2097,1690,416900,8852
1885,1587,298,1421,578700,8853
15899,10620,5279,1650,346500,8854
15326,10285,5041,1237,363900,8857
35,35,0,-,-,8858
8362,5285,3077,1375,322100,8859
17576,5633,11943,1374,270900,8861
4245,3073,1172,1630,316400,8863
12227,8180,4047,1050,202400,8865
1876,1641,235,1344,462200,8867
3005,1697,1308,1508,361400,8869
7541,4402,3139,1277,301600,8872
20785,14224,6561,1674,350400,8873
8479,5594,2885,1444,391100,8876
9086,4846,4240,1378,307400,8879
1646,959,687,1535,273100,8880
5883,3634,2249,1316,311200,8882
3150,2502,648,960,307800,8884
2504,2111,393,1443,315400,8886
546,409,137,1480,210400,8887
4428,3974,454,1835,445900,8889
9,0,9,-,-,8890
15546,3032,12514,1524,267200,8901
14640,8163,6477,1648,339900,8902
6034,2509,3525,1465,364900,8904
13311,3600,9711,2169,403800,10001
33790,4895,28895,979,696900,10002
25158,8688,16470,2437,989500,10003
1822,697,1125,3393,1892400,10004
4649,735,3914,"3,500+",1159600,10005
1811,347,1464,3371,941300,10006
2940,997,1943,"3,500+","2,000,000+",10007
29356,2169,27187,1706,476000,10009
16499,4999,11500,2502,966500,10010
28775,11095,17680,2281,1084700,10011
12574,2250,10324,2293,1731700,10012
12294,3305,8989,1946,"2,000,000+",10013
17139,4928,12211,2464,1221600,10014
29005,7683,21322,2760,871400,10016
9858,3557,6301,2370,752800,10017
4321,566,3755,3287,680200,10018
27340,6231,21109,2050,947500,10019
0,0,0,-,-,10020
22084,10153,11931,2363,1492900,10021
17977,8776,9201,2540,999100,10022
33770,13344,20426,2413,1450300,10023
28850,10802,18048,2536,1743700,10024
40188,12531,27657,1621,1055900,10025
15362,2935,12427,1278,940300,10026
23835,3138,20697,1274,730300,10027
24974,8410,16564,2373,1301100,10028
31485,2136,29349,974,651300,10029
12817,1748,11069,1073,659300,10030
21863,3011,18852,1503,494100,10031
21814,2113,19701,1296,500800,10032
19689,2466,17223,1502,530600,10033
15774,1368,14406,1395,397500,10034
14740,1226,13514,882,642700,10035
17437,1503,15934,2184,1236900,10036
9797,499,9298,1260,375000,10037
10800,2751,8049,2524,827700,10038
11490,1763,9727,981,455500,10039
16100,2008,14092,1417,449200,10040
5047,1293,3754,2772,919100,10044
15708,4993,10715,2527,1721800,10065
3106,889,2217,1749,1731600,10069
12075,5094,6981,2175,1083700,10075
0,0,0,-,-,10103
0,0,0,-,-,10110
0,0,0,-,-,10111
0,0,0,-,-,10112
0,0,0,-,-,10115
0,0,0,-,-,10119
29698,9225,20473,2271,1214600,10128
0,0,0,-,-,10152
0,0,0,-,-,10153
0,0,0,-,-,10154
622,0,622,3073,-,10162
0,0,0,-,-,10165
0,0,0,-,-,10167
0,0,0,-,-,10168
0,0,0,-,-,10169
0,0,0,-,-,10170
0,0,0,-,-,10171
0,0,0,-,-,10172
0,0,0,-,-,10173
0,0,0,-,-,10174
0,0,0,-,-,10177
0,0,0,-,-,10199
0,0,0,-,-,10271
0,0,0,-,-,10278
40,0,40,-,-,10279
4524,1217,3307,"3,500+",1055900,10280
2499,215,2284,"3,500+","2,000,000+",10282
14466,6337,8129,1409,523500,10301
5982,3429,2553,1333,431700,10302
8490,5272,3218,1197,354000,10303
14928,7674,7254,1135,542000,10304
15379,10448,4931,1333,493200,10305
19704,13752,5952,1412,557500,10306
5068,4000,1068,1292,728000,10307
10245,8364,1881,1738,573900,10308
11750,9688,2062,1564,610800,10309
8678,5197,3481,1412,503000,10310
0,0,0,-,-,10311
21107,17530,3577,1459,575700,10312
31363,23284,8079,1422,563800,10314
20229,2543,17686,1109,217000,10451
27018,737,26281,1168,438600,10452
27401,1298,26103,1193,521100,10453
13573,683,12890,817,577100,10454
14826,1328,13498,1005,307900,10455
31449,1623,29826,1074,370600,10456
24333,1589,22744,1222,412000,10457
28705,978,27727,1314,448000,10458
17058,2101,14957,1094,452000,10459
20212,2055,18157,1131,443400,10460
19122,6406,12716,1451,497700,10461
28981,6690,22291,1434,344100,10462
29490,9451,20039,1400,294100,10463
1874,1154,720,1439,588200,10464
16122,8697,7425,1463,511900,10465
25009,9745,15264,1345,478100,10466
37713,5255,32458,1348,325100,10467
26917,2346,24571,1314,228800,10468
22886,11956,10930,1518,482500,10469
6096,2137,3959,1457,481000,10470
8714,4625,4089,1512,360600,10471
22221,3625,18596,1260,516600,10472
21940,6666,15274,969,442900,10473
3506,215,3291,1197,442500,10474
18653,8580,10073,1038,26400,10475
424,392,32,-,793700,10501
1897,1488,409,"3,500+",704800,10502
67,67,0,-,510700,10503
2755,2522,233,2854,986000,10504
520,168,352,3122,650800,10505
1920,1822,98,2808,912100,10506
2140,1147,993,1718,617200,10507
7070,5521,1549,1598,359200,10509
3664,3115,549,1598,744600,10510
769,601,168,1435,383500,10511
9460,7696,1764,1268,333000,10512
4190,3859,331,2309,911200,10514
2193,1702,491,1580,522600,10516
163,106,57,2540,400000,10517
381,359,22,-,605900,10518
83,56,27,-,597800,10519
4994,3295,1699,1521,567600,10520
3672,2134,1538,2044,660600,10522
3083,1508,1575,2428,432200,10523
1428,1299,129,1685,443800,10524
708,664,44,-,515800,10526
278,254,24,-,619800,10527
4678,2597,2081,2227,800100,10528
5899,4833,1066,2119,409900,10530
1744,1511,233,2390,611400,10532
2393,1913,480,1578,755000,10533
105,105,0,-,364100,10535
3544,3113,431,2962,710100,10536
879,708,171,2126,237500,10537
5861,4693,1168,1903,983400,10538
9086,7710,1376,1597,381900,10541
7272,4572,2700,1925,628600,10543
0,0,0,-,-,10545
373,359,14,-,781900,10546
2735,1659,1076,1922,371100,10547
1360,1009,351,1332,352300,10548
5921,4241,1680,1659,581400,10549
14488,3146,11342,1240,359200,10550
9095,5192,3903,1533,353400,10552
3507,1942,1565,1485,387000,10553
1692,1396,296,1750,536800,10560
11688,7139,4549,1768,404100,10562
9679,4801,4878,1524,288300,10566
6473,5844,629,1918,414000,10567
4060,3547,513,1809,739400,10570
12676,6586,6090,1775,562700,10573
1808,1669,139,3324,869200,10576
841,761,80,"3,500+",1158100,10577
419,403,16,-,541800,10578
2871,2682,189,1819,389700,10579
5992,4288,1704,2238,1536700,10580
13947,11668,2279,2065,955200,10583
1196,669,527,1677,362400,10588
3701,3274,427,2839,462100,10589
2665,2393,272,2176,570800,10590
9356,4665,4691,1602,603400,10591
1641,1418,223,1799,627800,10594
2347,1599,748,1835,621900,10595
400,223,177,1611,377100,10596
272,272,0,-,824800,10597
10514,9497,1017,1424,458100,10598
5126,2083,3043,1815,364000,10601
7097,4288,2809,1705,434900,10603
3794,2146,1648,1890,695700,10604
7645,5514,2131,1743,656200,10605
5766,2274,3492,1865,564200,10606
2360,1651,709,1617,533000,10607
23636,7243,16393,1433,358300,10701
7460,3887,3573,1229,379700,10703
11696,6813,4883,1609,445900,10704
14593,4919,9674,1453,418200,10705
3215,2512,703,1851,669600,10706
3964,2476,1488,1721,573400,10707
9163,6834,2329,1740,477300,10708
3479,2613,866,1796,672000,10709
9875,6827,3048,1444,445400,10710
15125,6410,8715,1471,479100,10801
4044,3276,768,1835,788200,10803
4881,4635,246,2031,752800,10804
7990,3468,4522,1618,368000,10805
8722,6227,2495,1527,403300,10901
0,0,0,-,-,10910
0,0,0,-,-,10911
1533,1465,68,1875,526900,10913
153,153,0,-,335700,10914
26,26,0,-,-,10915
1346,1346,0,-,358400,10916
492,422,70,1529,386800,10917
4303,3352,951,1363,322000,10918
497,478,19,-,321200,10919
2931,2471,460,1434,454300,10920
1369,1004,365,1712,300900,10921
663,410,253,1179,269300,10922
2614,1760,854,1636,348400,10923
4541,3402,1139,1291,340900,10924
1540,1152,388,1249,255900,10925
1301,714,587,1713,243000,10926
3608,1547,2061,1403,270100,10927
1726,908,818,1372,229500,10928
3128,2859,269,1706,339900,10930
297,171,126,1792,332300,10931
33,33,0,-,-,10932
130,85,45,-,287500,10933
17920,11174,6746,1314,220600,10940
5061,3273,1788,1385,251800,10941
13043,8265,4778,1406,348800,10950
10005,4073,5932,1471,649400,10952
36,36,0,-,-,10953
9098,6695,2403,2098,403500,10954
9833,8937,896,1798,512100,10956
963,863,100,1409,293300,10958
6025,3064,2961,1930,531800,10960
1883,1607,276,1207,508900,10962
1240,813,427,858,208400,10963
563,508,55,-,666700,10964
5462,4058,1404,1604,451800,10965
1196,751,445,1864,582800,10968
357,350,7,-,308200,10969
3677,2715,962,1428,325000,10970
837,714,123,1526,291500,10973
1288,1104,184,1861,363100,10974
72,35,37,-,153800,10975
687,407,280,646,462300,10976
15729,7227,8502,1377,462000,10977
17,17,0,-,-,10979
4845,4263,582,1508,379900,10980
1846,1735,111,2696,475800,10983
910,828,82,1903,415800,10984
43,43,0,-,268400,10985
550,455,95,2145,543700,10986
1376,1127,249,1133,496400,10987
215,146,69,1172,240000,10988
3534,3110,424,2107,426200,10989
7785,5994,1791,1207,362900,10990
3043,2494,549,1042,285000,10992
1712,963,749,1320,238800,10993
2619,2562,57,-,502500,10994
966,19,947,3096,212500,10996
1081,868,213,1258,350900,10998
8733,7125,1608,1775,595400,11001
12270,9709,2561,1774,428300,11003
4808,3528,1280,1683,557500,11004
1609,1508,101,-,739200,11005
8089,6745,1344,1802,532600,11010
1848,1507,341,2214,1063300,11020
7623,5540,2083,1844,750300,11021
2964,2354,610,-,919000,11023
1953,1662,291,1987,1569300,11024
6277,5549,728,1970,1542000,11030
13078,11662,1416,1994,657300,11040
0,0,0,-,-,11042
11103,7660,3443,2183,854500,11050
2558,1150,1408,1465,454400,11096
14951,2022,12929,1966,959000,11101
12960,1874,11086,1869,730800,11102
15575,2290,13285,1819,824000,11103
11281,2454,8827,1686,542700,11104
15274,4163,11111,1877,898300,11105
16975,3063,13912,1715,642600,11106
2777,429,2348,3456,600200,11109
29262,10414,18848,2690,1025500,11201
29249,11834,17415,1348,498000,11203
23520,8920,14600,1456,911500,11204
16779,4574,12205,1632,762700,11205
31489,3399,28090,1199,792100,11206
34010,9244,24766,1306,536000,11207
34368,9054,25314,1357,540400,11208
29186,11374,17812,1626,813600,11209
21851,9601,12250,1446,678700,11210
40821,6546,34275,2040,1074400,11211
31207,4526,26681,982,443700,11212
26377,4534,21843,1339,865900,11213
31717,11182,20535,1481,793300,11214
28714,11622,17092,2332,1291000,11215
25771,6225,19546,1676,1201100,11216
18627,5303,13324,2256,1345100,11217
25219,10017,15202,1676,785600,11218
23871,6163,17708,1452,956400,11219
27849,7626,20223,1452,868500,11220
33067,6980,26087,1587,976900,11221
17941,3096,14845,2129,1098300,11222
27709,10315,17394,1379,871000,11223
19272,5805,13467,865,448400,11224
24177,4432,19745,1488,892700,11225
37483,4731,32752,1458,662400,11226
15473,8517,6956,1565,953000,11228
31099,14757,16342,1388,669300,11229
31254,9609,21645,1440,796900,11230
15871,5155,10716,1951,1356300,11231
8936,2012,6924,1715,775000,11232
31811,7099,24712,1308,920800,11233
32227,21898,10329,1522,615500,11234
32492,12502,19990,1414,603200,11235
34018,16413,17605,1442,575800,11236
17383,1569,15814,1697,846300,11237
25443,7839,17604,2020,983500,11238
6771,193,6578,676,532700,11239
0,0,0,-,-,11351
20115,7673,12442,1546,426400,11354
28422,8569,19853,1474,652900,11355
7346,3483,3863,1788,683400,11356
14437,10468,3969,1835,794200,11357
12923,7461,5462,1769,840800,11358
0,0,0,-,-,11359
8293,6087,2206,2102,590300,11360
10659,6589,4070,1936,744800,11361
7153,5631,1522,1963,399000,11362
2779,2113,666,2055,807300,11363
13141,9259,3882,1869,619600,11364
15702,7177,8525,1576,763000,11365
4514,3172,1342,1738,808500,11366
13930,6414,7516,1390,544400,11367
28163,5754,22409,1684,621500,11368
9566,5684,3882,1700,613400,11369
7550,3986,3564,1736,768900,11370
0,0,0,-,-,11371
23842,7934,15908,1539,378700,11372
31255,9624,21631,1616,612700,11373
19044,7888,11156,1730,433800,11374
32509,16933,15576,1807,468400,11375
31601,9934,21667,1529,570000,11377
12887,7013,5874,1668,673900,11378
13561,8124,5437,1696,708700,11379
35589,11068,24521,1626,673600,11385
6183,5383,800,1352,464100,11411
11259,8429,2830,1486,475000,11412
12694,9151,3543,1748,486900,11413
11058,8216,2842,1658,538500,11414
7849,3089,4760,1600,377700,11415
7409,3287,4122,1577,591600,11416
8887,5255,3632,1647,587600,11417
11250,5205,6045,1568,593100,11418
12497,7857,4640,1626,577200,11419
13042,9311,3731,1725,563300,11420
11325,6071,5254,1689,554400,11421
9951,6629,3322,1824,480100,11422
9838,5683,4155,1431,553300,11423
0,0,0,-,-,11424
0,0,0,-,-,11425
6287,4811,1476,1744,576600,11426
7745,4731,3014,1486,558600,11427
6121,4373,1748,1511,551600,11428
8006,5803,2203,1355,480000,11429
0,0,0,-,-,11430
18790,7460,11330,1590,650800,11432
10655,4638,6017,1312,459400,11433
21510,10698,10812,1179,441000,11434
19310,6631,12679,1604,441300,11435
5496,3817,1679,1631,459900,11436
0,0,0,-,-,11451
7812,4993,2819,1811,534100,11501
2419,2365,54,-,702400,11507
742,683,59,2550,785100,11509
11022,9601,1421,1829,433700,11510
1709,1230,479,1926,550400,11514
2758,1823,935,1755,528300,11516
4057,2755,1302,1941,441800,11518
14473,9715,4758,1663,362300,11520
9303,8472,831,3299,827800,11530
10365,5695,4670,1828,499100,11542
4485,3935,550,1707,891400,11545
214,180,34,1354,631000,11547
477,298,179,2359,757900,11548
0,0,0,-,-,11549
17038,7827,9211,1484,345000,11550
7206,6485,721,1972,469600,11552
6943,5126,1817,1706,364000,11553
12339,10788,1551,1933,478700,11554
0,0,0,-,-,11556
2658,2401,257,1738,621500,11557
2827,1961,866,1772,460700,11558
2427,1949,478,1827,866100,11559
2366,1967,399,1959,817800,11560
15697,9710,5987,2087,574300,11561
7738,5638,2100,1879,479400,11563
3278,3150,128,1839,478600,11565
11422,10926,496,2169,562000,11566
1067,986,81,1475,1943300,11568
555,451,104,3181,806800,11569
10516,7869,2647,1651,641200,11570
10206,9089,1117,1731,492600,11572
4365,3101,1264,2151,328400,11575
4451,3919,532,1861,1089700,11576
4248,3679,569,2195,832300,11577
1899,1592,307,2414,749200,11579
13015,11059,1956,1631,451200,11580
6908,5590,1318,1786,507600,11581
14617,11369,3248,1963,488700,11590
3542,2905,637,1887,653800,11596
3902,3400,502,2165,807200,11598
21163,5234,15929,1278,548000,11691
7408,2705,4703,1170,456600,11692
5210,2527,2683,964,353400,11693
8069,4307,3762,1435,704200,11694
1295,1244,51,788,598600,11697
8720,5853,2867,1717,368500,11701
5461,4563,898,2184,471500,11702
5284,4384,900,1846,370500,11703
12761,9491,3270,1933,368300,11704
2856,2425,431,1773,474300,11705
18917,14059,4858,1682,355600,11706
2572,2212,360,1867,566600,11709
11177,9983,1194,1975,509400,11710
2986,1993,993,2166,363800,11713
7824,7006,818,2185,482300,11714
1640,1329,311,1895,445100,11715
3524,2740,784,2000,411500,11716
14710,11296,3414,1413,332000,11717
1022,961,61,3036,541300,11718
1109,836,273,1389,442400,11719
8967,7339,1628,2050,359500,11720
2333,2268,65,2302,644600,11721
9566,6882,2684,1805,297600,11722
959,893,66,2674,1219400,11724
9447,8744,703,1840,509200,11725
5969,4502,1467,1617,334500,11726
10844,7049,3795,2056,316700,11727
8426,7110,1316,1526,384300,11729
4799,3934,865,2161,429300,11730
10541,9486,1055,2003,504600,11731
1427,944,483,2420,630700,11732
5731,5060,671,2148,522900,11733
11460,9257,2203,1720,438400,11735
5360,4583,777,2234,367000,11738
436,436,0,-,645100,11739
3197,2584,613,913,553600,11740
8941,7024,1917,1935,401200,11741
4312,3520,792,1900,366600,11742
15250,13524,1726,1979,639100,11743
21696,18265,3431,1849,506400,11746
7181,6188,993,2592,639800,11747
1086,1012,74,1884,331100,11749
5087,4542,545,1765,384200,11751
2984,2506,478,2259,360700,11752
4428,3859,569,2145,848700,11753
7027,5854,1173,1645,459500,11754
4077,3478,599,2028,437300,11755
13955,13102,853,2094,421600,11756
14426,12019,2407,1710,371900,11757
18658,17041,1617,2020,486200,11758
7740,7589,151,2559,497200,11762
9480,8188,1292,1882,335000,11763
4412,3781,631,1218,453500,11764
279,254,25,2800,1865400,11765
3877,3754,123,-,460700,11766
4951,4303,648,2055,462500,11767
7689,6905,784,2060,660800,11768
3200,2720,480,1606,436800,11769
27,25,2,-,625000,11770
3647,2669,978,1673,787400,11771
16981,11876,5105,1636,341200,11772
7859,6163,1696,1844,377800,11776
3526,2645,881,1981,555400,11777
4265,3657,608,1644,322600,11778
12525,9537,2988,1674,360100,11779
5707,5160,547,1728,549900,11780
5288,4048,1240,1926,470700,11782
6952,6566,386,2235,488300,11783
8185,6976,1209,1849,338900,11784
1882,1754,128,2000,446700,11786
11734,10354,1380,1783,517500,11787
5512,4447,1065,2209,501500,11788
2757,2475,282,1399,326100,11789
4352,3990,362,2172,469900,11790
8098,7553,545,2756,714300,11791
2984,2826,158,2812,447300,11792
10305,9850,455,1404,487800,11793
0,0,0,-,-,11794
7969,7661,308,2028,453200,11795
1329,1008,321,1806,404800,11796
3097,2745,352,2956,833000,11797
4345,3312,1033,1562,332900,11798
12872,11202,1670,2141,476900,11801
10076,9150,926,1993,607900,11803
1583,1472,111,-,627800,11804
10173,7095,3078,1594,344500,11901
300,273,27,1917,1585500,11930
20,0,20,-,-,11931
445,394,51,1125,1125000,11932
2871,2605,266,2183,348000,11933
2577,2308,269,1403,402000,11934
1197,1067,130,1778,636000,11935
6752,5436,1316,2344,840600,11937
532,429,103,2047,681800,11939
1718,1367,351,1810,455600,11940
685,617,68,1352,482500,11941
2045,1795,250,1956,610900,11942
1954,1394,560,1734,535600,11944
5923,4097,1826,1899,515000,11946
238,238,0,-,628800,11947
260,260,0,-,585300,11948
4807,3928,879,1739,427500,11949
4626,3809,817,1937,263600,11950
4730,3789,941,1779,237800,11951
2144,2010,134,1319,549700,11952
5592,3797,1795,1798,295800,11953
1311,1104,207,2345,929600,11954
1599,825,774,1769,403900,11955
157,133,24,1583,854200,11956
480,426,54,1766,811500,11957
297,231,66,-,693900,11958
252,205,47,1164,1355800,11959
346,346,0,-,891900,11960
5693,4817,876,1595,304400,11961
122,110,12,-,"2,000,000+",11962
2832,2260,572,2377,895800,11963
1046,1009,37,-,852600,11964
329,264,65,-,724500,11965
8533,7408,1125,1918,281500,11967
4302,3573,729,1921,981100,11968
160,118,42,-,-,11970
2521,2263,258,1738,604600,11971
386,224,162,1792,528000,11972
0,0,0,-,-,11973
73,65,8,-,1680600,11975
851,793,58,2636,1724100,11976
886,779,107,1855,781600,11977
1210,902,308,1915,721400,11978
2319,1545,774,2292,319200,11980
10,10,0,-,-,12007
188,178,10,-,221800,12008
2991,2400,591,1129,272500,12009
11459,6995,4464,778,131900,12010
1163,924,239,871,205100,12015
264,236,28,1038,124300,12017
2962,2506,456,1138,248600,12018
6093,4951,1142,1118,304500,12019
14088,10404,3684,1284,243000,12020
280,241,39,721,157900,12022
928,795,133,836,200200,12023
0,0,0,-,-,12024
2281,1858,423,828,184800,12025
1515,1255,260,1649,287100,12027
275,250,25,1080,146800,12028
479,420,59,1091,309200,12029
77,58,19,609,120000,12031
363,352,11,-,140200,12032
3501,2628,873,1045,227100,12033
234,200,34,-,100000,12035
85,85,0,-,121300,12036
1764,1247,517,985,249000,12037
45,36,9,-,157700,12040
211,192,19,-,173600,12041
138,128,10,-,144700,12042
2939,1819,1120,813,140400,12043
196,71,125,961,148600,12045
488,443,45,1089,195000,12046
9336,4425,4911,979,192300,12047
1695,1184,511,843,209800,12051
731,678,53,1080,191000,12052
1655,1301,354,792,219900,12053
6971,5185,1786,1236,278400,12054
834,712,122,1081,234900,12056
843,734,109,934,180100,12057
431,358,73,717,164600,12058
717,660,57,871,257900,12059
747,676,71,975,273000,12060
3944,3026,918,1349,259800,12061
622,476,146,1050,185400,12062
355,282,73,-,234000,12063
169,135,34,917,84800,12064
17303,12215,5088,1190,284100,12065
801,710,91,1273,162200,12066
604,546,58,760,286100,12067
1130,941,189,675,125700,12068
111,111,0,-,130700,12069
774,609,165,948,120700,12070
107,87,20,-,151700,12071
928,774,154,919,131500,12072
1134,1019,115,983,226400,12074
939,791,148,1120,217300,12075
573,522,51,871,160800,12076
2614,1895,719,1291,287400,12077
9790,6019,3771,745,95500,12078
1316,1119,197,986,183900,12083
2100,572,1528,1298,281800,12084
162,53,109,884,156300,12085
730,595,135,776,145700,12086
342,302,40,1308,202900,12087
35,26,9,-,-,12089
2322,1511,811,846,140900,12090
503,319,184,922,108000,12092
711,624,87,638,133100,12093
817,674,143,1073,187000,12094
4980,3446,1534,829,121200,12095
1062,899,163,1016,243500,12106
79,56,23,-,195000,12108
7442,4738,2704,1253,261600,12110
33,33,0,-,394400,12115
696,594,102,850,114900,12116
1394,1176,218,950,155200,12117
6999,4645,2354,908,268200,12118
301,250,51,950,236200,12120
706,680,26,-,252500,12121
2122,1566,556,731,141600,12122
2107,1769,338,866,207400,12123
174,174,0,-,228500,12124
470,308,162,933,202600,12125
316,269,47,-,198400,12130
40,32,8,-,164300,12131
137,113,24,-,272000,12132
1652,1227,425,776,159000,12134
267,259,8,-,309200,12136
779,683,96,875,221400,12137
1312,1131,181,936,147300,12138
61,60,1,-,190000,12139
679,594,85,679,209700,12140
2112,1479,633,931,189100,12143
9260,5329,3931,1021,197100,12144
224,194,30,1303,238700,12147
1735,1342,393,-,348900,12148
939,694,245,653,130600,12149
310,286,24,-,168800,12150
498,415,83,1332,302700,12151
316,303,13,-,292600,12153
1343,1181,162,958,210400,12154
870,695,175,816,113500,12155
263,241,22,-,222600,12156
1723,1432,291,854,155700,12157
2779,1925,854,1566,231800,12158
3512,2612,900,1204,349100,12159
328,262,66,1000,120200,12160
62,62,0,-,-,12161
106,88,18,817,158900,12164
108,93,15,1688,335700,12165
468,421,47,850,132700,12166
1084,786,298,669,162400,12167
856,715,141,828,178500,12168
170,170,0,-,-,12169
1933,1522,411,1211,226200,12170
61,11,50,-,227500,12172
787,613,174,1103,168600,12173
213,200,13,-,106000,12174
277,247,30,950,122900,12175
129,127,2,-,192100,12176
169,154,15,-,133900,12177
21563,9699,11864,1009,179900,12180
6002,2933,3069,874,149300,12182
1303,360,943,864,133900,12183
2572,1928,644,906,240700,12184
806,661,145,811,212600,12185
2483,2214,269,1108,258700,12186
209,140,69,704,170200,12187
5042,3579,1463,987,236500,12188
8565,3096,5469,915,173100,12189
190,160,30,750,169300,12190
680,617,63,1015,166300,12192
771,683,88,1008,180300,12193
57,57,0,-,87700,12194
135,119,16,-,192700,12195
1371,1251,120,903,264700,12196
805,674,131,882,127200,12197
2837,2285,552,910,195200,12198
3961,699,3262,854,126900,12202
13666,6458,7208,1130,216500,12203
3421,915,2506,1111,187100,12204
11175,7812,3363,1157,221100,12205
6315,1691,4624,1000,132300,12206
1211,79,1132,572,-,12207
9668,4686,4982,1057,212500,12208
4072,2541,1531,997,160800,12209
5545,1144,4401,987,162800,12210
4205,3949,256,-,299400,12211
0,0,0,-,-,12222
10320,7553,2767,1038,186600,12302
11006,8118,2888,948,186000,12303
8111,4581,3530,960,132400,12304
3017,460,2557,830,114100,12305
9852,6996,2856,945,169200,12306
2348,509,1839,803,86100,12307
5381,2575,2806,950,128900,12308
11110,9187,1923,1242,259300,12309
14269,7696,6573,1085,198200,12401
1479,1064,415,941,230600,12404
190,155,35,-,167300,12405
330,137,193,775,176000,12406
72,62,10,-,233300,12407
334,251,83,1117,381500,12409
226,195,31,780,202200,12410
159,145,14,-,229800,12411
190,153,37,-,220700,12412
1224,810,414,1154,174500,12413
4329,2912,1417,923,182200,12414
190,135,55,-,271300,12416
213,209,4,-,71000,12417
106,65,41,1279,191400,12418
236,132,104,1321,264800,12419
145,145,0,-,78800,12420
123,123,0,-,197700,12421
101,97,4,-,145500,12422
437,315,122,930,199500,12423
101,79,22,-,231300,12424
153,153,0,-,-,12427
2450,1371,1079,1019,152500,12428
100,100,0,-,276100,12429
698,619,79,747,191400,12430
560,537,23,1070,152000,12431
240,26,214,1208,209400,12432
244,228,16,-,263900,12433
445,378,67,577,133800,12434
54,54,0,-,-,12435
129,80,49,-,-,12436
0,0,0,-,-,12438
160,153,7,-,148400,12439
603,500,103,1367,323000,12440
82,42,40,-,168800,12441
470,246,224,930,252400,12442
1604,1512,92,1305,231800,12443
190,179,11,-,233100,12444
1842,1484,358,747,223100,12446
189,158,31,-,414800,12448
1228,705,523,1117,183100,12449
43,43,0,-,172400,12450
470,338,132,1090,157500,12451
94,90,4,-,159200,12452
130,93,37,-,278400,12453
145,131,14,-,219000,12454
807,642,165,641,211300,12455
276,246,30,-,134000,12456
485,321,164,933,-,12457
1039,706,333,764,131000,12458
93,93,0,-,202300,12459
118,85,33,734,133100,12460
544,487,57,-,248400,12461
761,634,127,923,191200,12463
616,496,120,1213,242100,12464
132,126,6,-,300000,12465
908,739,169,1104,219400,12466
429,389,40,469,178000,12468
304,304,0,-,175000,12469
202,153,49,1194,200900,12470
307,251,56,-,190700,12471
645,402,243,1063,265400,12472
247,247,0,-,183700,12473
412,360,52,760,172800,12474
154,52,102,1470,259100,12475
7566,5304,2262,1050,249500,12477
203,199,4,-,202800,12480
563,497,66,-,192700,12481
182,151,31,-,133300,12482
86,67,19,-,96200,12483
1568,1288,280,1600,336900,12484
255,142,113,800,229600,12485
577,503,74,1322,235700,12486
1420,1060,360,1197,235200,12487
178,157,21,-,127100,12489
21,21,0,-,-,12490
623,552,71,1958,221200,12491
44,44,0,-,144400,12492
77,77,0,-,189400,12493
386,386,0,-,274600,12494
61,51,10,-,393800,12495
588,482,106,638,236700,12496
2451,1731,720,1014,350200,12498
812,417,395,1169,280900,12501
534,456,78,1167,278300,12502
226,190,36,1950,300000,12503
70,9,61,955,-,12504
74,38,36,1475,423100,12507
7349,4401,2948,1381,306800,12508
85,85,0,-,330300,12512
201,160,41,-,232800,12513
1205,1179,26,1109,330700,12514
548,391,157,815,272200,12515
763,659,104,958,214700,12516
170,80,90,916,317900,12517
2348,1462,886,1495,305800,12518
1108,737,371,1275,324900,12520
698,662,36,1661,260400,12521
1994,1318,676,864,226200,12522
817,697,120,898,279300,12523
6171,4059,2112,1434,304600,12524
1075,692,383,1199,307300,12525
1611,1185,426,1056,320700,12526
0,0,0,-,-,12527
5088,3365,1723,1378,255700,12528
821,636,185,859,286600,12529
24,24,0,-,-,12530
1015,850,165,-,349600,12531
8659,7791,868,1319,353100,12533
7767,4608,3159,927,192100,12534
5262,3782,1480,1011,236400,12538
2943,2557,386,1843,367700,12540
2320,1690,630,1077,261700,12542
1448,784,664,983,182900,12543
2138,1326,812,1159,368400,12545
1244,871,373,972,253800,12546
1137,794,343,1709,263600,12547
514,409,105,979,264200,12548
3820,2860,960,1377,292800,12549
20156,11262,8894,1197,234100,12550
9701,6861,2840,1297,260100,12553
6477,4103,2374,1291,299200,12561
2323,1916,407,1474,332600,12563
2829,2151,678,1149,329200,12564
499,245,254,855,160800,12565
4055,3070,985,1377,259700,12566
1063,790,273,1269,269100,12567
3967,2557,1410,1376,278700,12569
2334,2049,285,1659,331400,12570
3953,2990,963,1163,324400,12571
3862,2571,1291,1378,372300,12572
200,178,22,-,360000,12574
652,585,67,-,365300,12575
563,517,46,-,323000,12577
874,743,131,994,316900,12578
1679,1327,352,958,271900,12580
917,660,257,1171,288200,12581
1421,1262,159,1375,359400,12582
834,562,272,1505,334300,12583
340,234,106,893,420500,12585
4284,3048,1236,1232,261300,12586
4925,3885,1040,1061,266800,12589
13196,9231,3965,1377,292000,12590
577,425,152,725,258500,12592
1622,1195,427,964,261200,12594
16000,6275,9725,1147,216100,12601
16265,11903,4362,1264,260200,12603
7,7,0,-,-,12604
4199,2141,2058,906,156500,12701
553,479,74,1114,209600,12719
53,32,21,-,-,12720
1898,1333,565,1165,263100,12721
21,21,0,-,-,12722
751,644,107,871,168600,12723
91,91,0,-,336300,12724
54,51,3,-,220800,12725
612,544,68,1167,237300,12726
659,510,149,1107,110500,12729
410,396,14,-,213000,12732
194,95,99,1298,89600,12733
330,166,164,756,186800,12734
56,46,10,-,127300,12736
668,614,54,1193,229700,12737
135,101,34,868,230100,12738
780,614,166,1304,246100,12740
90,75,15,685,93100,12741
55,44,11,-,-,12742
123,81,42,1317,239100,12743
127,47,80,2130,184300,12745
270,222,48,1082,170500,12746
815,620,195,-,162100,12747
823,619,204,865,185600,12748
172,93,79,780,136900,12749
42,25,17,-,-,12750
382,178,204,947,122100,12751
159,119,40,771,243200,12752
2505,1201,1304,850,141600,12754
1807,1358,449,852,120800,12758
693,456,237,818,67600,12759
229,184,45,-,123500,12760
263,93,170,-,212500,12762
300,252,48,835,169300,12763
847,667,180,766,179500,12764
416,361,55,-,296600,12765
137,117,20,-,201400,12766
76,71,5,-,164600,12767
307,252,55,-,143800,12768
124,124,0,-,-,12769
66,66,0,-,262100,12770
5729,3628,2101,977,170700,12771
828,668,160,1355,239300,12775
866,794,72,1250,183700,12776
378,360,18,-,237100,12777
167,136,31,-,202500,12778
770,317,453,718,226600,12779
899,662,237,982,189000,12780
106,106,0,-,157800,12781
589,472,117,1164,159500,12783
15,9,6,-,-,12784
488,466,22,-,197600,12785
207,156,51,-,165700,12786
122,115,7,-,98400,12787
875,624,251,837,206000,12788
851,446,405,780,132500,12789
1560,1251,309,1126,181600,12790
217,167,50,-,313400,12791
60,60,0,-,209400,12792
6518,3310,3208,899,158000,12801
3747,2228,1519,934,187000,12803
11624,8570,3054,1054,241800,12804
132,132,0,-,288200,12808
1434,1197,237,1076,167200,12809
257,236,21,879,158600,12810
44,38,6,-,185700,12811
63,60,3,-,275000,12812
690,584,106,922,250000,12814
538,413,125,853,198600,12815
2101,1606,495,841,164300,12816
1028,812,216,732,236800,12817
113,91,22,1067,151600,12819
112,112,0,-,146000,12821
2343,1795,548,903,156400,12822
165,156,9,-,160000,12823
422,359,63,820,-,12824
1415,1148,267,902,161200,12827
3771,3073,698,910,159300,12828
6652,5138,1514,1102,248600,12831
2814,1986,828,705,116800,12832
1858,1615,243,730,247300,12833
2416,2003,413,970,204900,12834
1158,977,181,792,188700,12835
292,253,39,1021,252500,12836
416,332,84,1024,128800,12837
254,221,33,882,191900,12838
5577,2981,2596,889,133700,12839
111,101,10,-,790400,12841
297,253,44,711,163900,12842
206,174,32,668,143400,12843
114,103,11,-,664100,12844
2015,1559,456,1017,324900,12845
1594,1276,318,1012,169700,12846
174,159,15,638,204500,12847
143,143,0,-,178900,12849
1096,836,260,1088,255900,12850
163,147,16,-,117000,12851
197,185,12,1286,153000,12852
794,623,171,760,171600,12853
119,102,17,960,120800,12855
156,77,79,-,173500,12856
282,248,34,889,202300,12857
62,62,0,-,457100,12858
804,664,140,1160,251500,12859
253,253,0,-,153500,12860
224,207,17,841,218100,12861
0,0,0,-,-,12862
311,242,69,745,252600,12863
9,6,3,-,-,12864
1345,1060,285,913,150500,12865
17437,10858,6579,1364,346600,12866
786,625,161,728,192800,12870
1710,1293,417,925,195800,12871
47,43,4,-,-,12872
391,267,124,737,192300,12873
97,90,7,-,470400,12874
254,229,25,775,178700,12878
2277,1544,733,753,129300,12883
208,165,43,1030,123000,12884
1942,1382,560,888,150700,12885
140,114,26,-,333800,12886
1839,1263,576,804,125600,12887
13449,7447,6002,834,144000,12901
677,369,308,1287,141200,12903
658,495,163,840,85700,12910
0,0,0,-,-,12911
856,677,179,781,132900,12912
494,387,107,764,158200,12913
373,269,104,672,77300,12914
896,596,300,676,94800,12916
516,384,132,680,107900,12917
1087,960,127,860,166700,12918
1090,730,360,835,108300,12919
1000,815,185,864,98500,12920
994,782,212,842,156000,12921
18,15,3,-,154200,12922
253,217,36,383,71500,12923
22,13,9,-,-,12924
971,741,230,680,93100,12926
140,129,11,-,119600,12927
854,704,150,835,135100,12928
298,205,93,811,107900,12929
267,218,49,850,88500,12930
563,443,120,828,158900,12932
28,28,0,-,-,12933
443,325,118,674,85600,12934
621,471,150,635,121000,12935
219,182,37,957,165000,12936
719,514,205,786,86100,12937
67,39,28,-,105200,12939
594,555,39,872,163300,12941
312,295,17,-,317300,12942
166,97,69,739,225000,12943
1564,1141,423,900,119400,12944
181,171,10,-,144100,12945
2073,1363,710,1010,355500,12946
292,258,34,1090,116200,12950
113,93,20,-,-,12952
4789,3292,1497,755,100100,12953
181,159,22,739,120600,12955
500,350,150,728,72200,12956
608,414,194,495,121300,12957
955,919,36,-,142600,12958
728,589,139,647,100600,12959
255,200,55,-,98400,12960
178,113,65,-,-,12961
2003,1652,351,950,151500,12962
27,19,8,-,270800,12964
193,174,19,-,67200,12965
1085,886,199,690,86900,12966
451,370,81,783,77400,12967
177,155,22,-,97400,12969
113,85,28,1583,203100,12970
2614,2145,469,915,165700,12972
49,49,0,-,102500,12973
962,753,209,-,113900,12974
141,85,56,890,169800,12975
113,100,13,-,225000,12976
0,0,0,-,-,12977
81,81,0,-,127000,12978
1136,624,512,609,134500,12979
487,426,61,682,66200,12980
1016,827,189,600,111300,12981
3514,2195,1319,741,178500,12983
346,260,86,1031,153600,12985
2529,1763,766,643,107500,12986
121,112,9,-,169700,12987
475,424,51,733,173000,12989
1520,1138,382,807,132900,12992
708,513,195,737,161300,12993
929,810,119,867,185400,12996
522,433,89,888,229000,12997
186,186,0,-,147400,12998
30,30,0,-,125000,13020
16548,10071,6477,750,135300,13021
0,0,0,-,-,13024
565,425,140,1010,160100,13026
14058,10311,3747,989,170500,13027
409,338,71,1022,116100,13028
2801,2074,727,833,183400,13029
1396,1182,214,726,162500,13030
6485,4983,1502,951,161300,13031
4577,3460,1117,806,124300,13032
1321,1118,203,773,121300,13033
768,642,126,758,143000,13034
3086,2645,441,1045,213600,13035
3917,3071,846,853,130100,13036
3589,2862,727,578,164900,13037
6621,5509,1112,950,177400,13039
1001,778,223,752,110600,13040
4608,4202,406,1229,151400,13041
941,735,206,1156,119600,13042
1166,998,168,904,120200,13044
10613,6314,4299,780,131700,13045
79,79,0,-,-,13051
615,500,115,680,102200,13052
1774,1239,535,910,184800,13053
531,406,125,850,158900,13054
6152,4311,1841,846,126400,13057
1279,1115,164,826,125400,13060
357,304,53,813,188800,13061
14,14,0,-,-,13062
807,728,79,-,180400,13063
96,80,16,789,-,13064
5253,4056,1197,1072,245500,13066
2193,1526,667,918,176800,13068
9484,6250,3234,800,84000,13069
357,288,69,779,121900,13071
349,287,62,743,85800,13072
2682,2041,641,995,151100,13073
1659,1278,381,775,104900,13074
792,749,43,-,108800,13076
2877,2169,708,836,133200,13077
3798,3198,600,1170,211900,13078
1320,1139,181,655,125200,13080
490,461,29,-,183800,13081
1653,1477,176,758,139500,13082
820,629,191,698,115700,13083
1548,1336,212,738,159400,13084
95,92,3,-,158000,13087
10149,6210,3939,934,132400,13088
11954,8108,3846,1048,157600,13090
953,845,108,799,148300,13092
887,615,272,783,112700,13101
42,42,0,-,104800,13102
114,86,28,1364,"10,000-",13103
5965,4828,1137,920,255500,13104
2658,2095,563,864,181300,13108
894,807,87,688,180000,13110
591,530,61,848,102900,13111
575,491,84,958,137900,13112
92,71,21,667,117700,13113
2652,2017,635,697,121600,13114
102,57,45,750,99500,13115
1362,1008,354,934,133300,13116
119,80,39,-,86000,13117
2090,1725,365,747,133200,13118
786,713,73,646,103200,13120
519,424,95,822,312400,13122
74,74,0,-,-,13123
42,42,0,-,85000,13124
13507,9037,4470,840,115200,13126
1367,1159,208,589,102700,13131
1574,1455,119,799,157700,13132
48,39,9,-,75600,13134
2430,1592,838,765,128100,13135
161,127,34,625,77200,13136
43,43,0,-,-,13138
1739,1373,366,809,95800,13140
224,207,17,869,132700,13141
2620,2006,614,805,126100,13142
891,760,131,663,105500,13143
505,375,130,601,81900,13144
650,537,113,845,110000,13145
789,628,161,718,87400,13146
396,311,85,1052,109000,13147
4890,3304,1586,779,102600,13148
3401,2888,513,1110,314900,13152
172,133,39,-,209000,13153
217,166,51,757,89100,13155
717,581,136,652,114000,13156
262,192,70,845,100000,13157
652,497,155,648,139400,13158
2118,1757,361,933,190700,13159
818,641,177,909,140700,13160
148,100,48,-,177400,13162
131,131,0,-,128200,13163
887,850,37,775,174400,13164
4208,3081,1127,786,93700,13165
2342,1791,551,940,128300,13166
1206,929,277,1019,143100,13167
2882,149,2733,803,70400,13202
7579,2239,5340,783,127600,13203
8037,2283,5754,830,80600,13204
7029,3338,3691,785,78100,13205
8023,4048,3975,811,91600,13206
5346,3326,2020,878,87800,13207
8503,3847,4656,832,87300,13208
5530,3854,1676,864,124500,13209
7493,1841,5652,908,149100,13210
2386,1728,658,985,91900,13211
8990,6946,2044,889,124300,13212
2827,1973,854,866,168000,13214
5504,4568,936,1003,212900,13215
6036,4963,1073,969,140500,13219
3721,2446,1275,893,157000,13224
0,0,0,-,-,13290
63,63,0,-,279800,13301
576,496,80,847,88100,13302
574,514,60,652,142100,13303
744,579,165,1063,171900,13304
108,64,44,-,119300,13305
1372,1196,176,889,104400,13308
2435,1766,669,655,149200,13309
326,275,51,-,90800,13310
167,141,26,-,244600,13312
181,123,58,641,68500,13313
103,99,4,-,71700,13314
576,500,76,779,160000,13315
2817,2247,570,667,117800,13316
1430,1023,407,724,97400,13317
507,472,35,675,132000,13318
417,252,165,730,83400,13319
766,637,129,718,174200,13320
401,310,91,837,85700,13321
390,288,102,864,163500,13322
4353,3128,1225,940,183300,13323
877,774,103,712,99700,13324
365,318,47,775,87400,13325
2237,1621,616,976,274700,13326
671,544,127,662,120100,13327
662,590,72,498,167200,13328
1674,1156,518,675,87800,13329
33,33,0,-,507400,13331
1023,896,127,765,89900,13332
22,13,9,-,156300,13333
423,349,74,-,106900,13334
515,432,83,433,135300,13335
339,193,146,783,273300,13337
579,545,34,500,122400,13338
2213,1740,473,740,84100,13339
3156,2581,575,734,108300,13340
75,75,0,-,141000,13341
94,87,7,-,151300,13342
662,547,115,643,117800,13343
68,50,18,-,121900,13345
1951,1435,516,828,171900,13346
541,427,114,845,163100,13348
4403,2671,1732,695,103800,13350
10,10,0,-,-,13352
11,11,0,-,128100,13353
1441,1277,164,713,160500,13354
440,374,66,762,128600,13355
4469,2997,1472,638,85800,13357
36,33,3,-,325000,13360
233,184,49,697,159000,13361
44,41,3,-,84200,13362
915,803,112,1079,129900,13363
120,106,14,-,114400,13364
3155,2395,760,654,102600,13365
3491,2714,777,694,140400,13367
466,400,66,733,93000,13368
693,584,109,831,99700,13402
1874,1494,380,739,178300,13403
63,50,13,-,63300,13404
295,267,28,950,97600,13406
1946,1514,432,664,102100,13407
870,751,119,738,137800,13408
778,700,78,846,91500,13409
160,74,86,536,82500,13410
1251,992,259,648,105800,13411
6565,4760,1805,1011,171200,13413
10,10,0,-,-,13415
819,641,178,628,120400,13416
1565,684,881,723,126000,13417
87,56,31,1322,108300,13418
522,445,77,489,210100,13420
5550,3622,1928,774,117800,13421
863,662,201,879,152000,13424
859,668,191,731,105000,13425
726,499,227,410,104200,13428
732,639,93,738,162900,13431
637,515,122,676,84200,13433
92,81,11,-,108900,13435
29,27,2,-,181300,13436
121,106,15,536,102800,13437
1269,1009,260,715,143000,13438
1456,1130,326,731,154600,13439
16866,10978,5888,777,113800,13440
118,0,118,782,-,13441
43,43,0,-,138000,13450
1819,1356,463,682,85300,13452
353,336,17,-,59200,13454
1574,1323,251,896,182300,13456
929,698,231,912,152200,13459
1648,1263,385,700,105600,13460
1307,938,369,838,159200,13461
573,470,103,858,63500,13464
178,130,48,603,157300,13468
471,471,0,-,180300,13469
285,268,17,704,113700,13470
1321,1140,181,834,95100,13471
40,40,0,-,-,13472
383,359,24,850,108700,13473
4,2,2,-,-,13475
1398,937,461,740,146700,13476
475,342,133,626,102800,13477
1310,1189,121,814,151500,13478
1385,1000,385,723,118000,13480
97,94,3,-,182100,13483
45,45,0,-,-,13484
456,385,71,814,105900,13485
340,311,29,763,135400,13486
29,21,8,-,157500,13488
229,215,14,575,120800,13489
541,541,0,-,170600,13490
1248,1029,219,682,114100,13491
4787,3580,1207,800,154600,13492
815,684,131,734,85800,13493
110,107,3,-,152500,13494
800,509,291,693,112700,13495
13583,7110,6473,717,111600,13501
12745,7957,4788,805,115700,13502
15206,7499,7707,851,146800,13601
136,0,136,1626,-,13602
3297,61,3236,1372,-,13603
2003,1531,472,820,148400,13605
1026,766,260,1131,151400,13606
798,509,289,679,137900,13607
639,489,150,736,105900,13608
978,654,324,776,163400,13612
1057,788,269,729,87800,13613
135,60,75,722,60000,13614
387,286,101,870,163800,13615
844,294,550,1063,116300,13616
3908,2479,1429,868,122300,13617
697,608,89,725,138800,13618
4219,2348,1871,889,126500,13619
849,704,145,925,139300,13620
200,165,35,-,95000,13621
795,694,101,990,162200,13622
9,9,0,-,-,13623
2009,1448,561,857,164300,13624
636,538,98,592,124400,13625
868,688,180,719,133700,13626
89,62,27,1098,120800,13628
534,454,80,518,69700,13630
106,102,4,-,72400,13633
1459,1163,296,637,163000,13634
428,369,59,514,77100,13635
71,54,17,906,165000,13636
1541,440,1101,1186,170800,13637
163,95,68,-,74100,13638
92,78,14,-,51000,13639
143,143,0,-,371300,13640
20,20,0,-,76300,13641
4039,2949,1090,751,94100,13642
8,0,8,-,-,13643
775,647,128,756,103400,13646
54,17,37,960,-,13647
860,695,165,868,87400,13648
632,501,131,682,182200,13650
63,63,0,-,321400,13651
594,487,107,525,80800,13652
839,688,151,729,103300,13654
1292,987,305,610,219400,13655
942,826,116,382,134800,13656
878,753,125,638,135000,13658
150,133,17,938,103500,13659
587,451,136,685,106100,13660
547,518,29,818,112000,13661
7394,5065,2329,696,91800,13662
143,116,27,900,129500,13664
281,216,65,842,87500,13665
80,61,19,-,38800,13666
1153,825,328,714,88500,13667
1419,1191,228,841,100100,13668
5962,4295,1667,615,84500,13669
198,175,23,1083,79000,13670
180,66,114,810,85400,13672
896,507,389,1013,157400,13673
72,51,21,-,64800,13674
57,57,0,-,-,13675
5419,3355,2064,802,126200,13676
1,1,0,-,-,13677
216,54,162,626,-,13678
597,528,69,1050,169800,13679
505,447,58,636,94800,13680
412,369,43,836,92200,13681
272,229,43,1250,150400,13682
400,357,43,600,85200,13684
1083,553,530,1238,249600,13685
219,204,15,-,132400,13687
284,210,74,525,63000,13690
1243,850,393,891,150000,13691
63,63,0,-,276700,13692
182,182,0,-,166700,13693
594,440,154,808,163500,13694
40,37,3,-,-,13695
35,19,16,-,-,13696
753,691,62,855,88800,13697
1260,911,349,673,112000,13730
482,411,71,1143,245100,13731
3156,2749,407,805,143200,13732
2501,2062,439,733,98700,13733
741,658,83,-,109500,13734
834,692,142,744,115900,13736
374,289,85,731,160100,13739
237,210,27,705,243500,13740
1527,1185,342,763,112900,13743
458,418,40,630,105600,13744
736,637,99,912,116900,13746
1607,1245,362,718,114400,13748
359,282,77,818,135900,13750
76,39,37,736,-,13751
321,202,119,848,186100,13752
1729,1202,527,823,172100,13753
1254,948,306,627,115300,13754
413,359,54,645,107700,13755
248,227,21,-,147500,13756
581,505,76,906,158000,13757
18825,12576,6249,766,125300,13760
96,70,26,-,132500,13774
778,645,133,700,157500,13775
236,184,52,658,128000,13776
167,164,3,-,175000,13777
2337,1814,523,636,141400,13778
291,291,0,-,131000,13780
315,252,63,755,186900,13782
1203,864,339,717,119900,13783
84,72,12,1286,"10,000-",13784
235,214,21,-,127900,13786
1321,1010,311,578,115600,13787
381,279,102,660,144800,13788
7793,4687,3106,830,97500,13790
19,13,6,-,-,13794
1418,1082,336,855,97300,13795
502,375,127,840,144500,13796
889,706,183,622,95600,13797
655,558,97,675,95300,13801
491,467,24,-,49900,13802
1425,1200,225,781,112100,13803
126,83,43,1049,114400,13804
103,83,20,600,156300,13806
545,408,137,617,132500,13807
551,456,95,609,123100,13808
734,647,87,1022,122400,13809
588,494,94,659,192600,13810
1571,1305,266,745,111000,13811
963,788,175,901,115800,13812
363,363,0,-,155600,13813
5874,3715,2159,691,100300,13815
8082,4859,3223,882,153700,13820
1280,938,342,753,156700,13825
0,0,0,-,-,13826
5227,3724,1503,783,110900,13827
2235,1693,542,679,90500,13830
219,200,19,528,94500,13832
1349,1071,278,846,104400,13833
92,18,74,1549,-,13834
543,442,101,698,92800,13835
1525,921,604,638,84000,13838
505,473,32,-,105700,13839
231,194,37,742,90000,13841
205,190,15,-,226100,13842
856,746,110,682,120400,13843
250,199,51,866,88900,13844
71,71,0,-,-,13845
226,207,19,-,171300,13846
17,9,8,-,-,13847
1976,1598,378,665,95600,13849
9372,7106,2266,916,154300,13850
2687,1806,881,640,120800,13856
57,38,19,-,152500,13859
5,5,0,-,-,13860
257,134,123,-,145000,13861
1667,1268,399,718,111400,13862
237,149,88,695,87000,13863
646,391,255,770,193600,13864
2791,2516,275,589,134300,13865
7958,4392,3566,720,130900,13901
0,0,0,-,-,13902
7878,4886,2992,742,118700,13903
3782,2491,1291,631,95900,13904
11154,5348,5806,816,116800,13905
4024,2891,1133,739,166300,14001
4118,3558,560,751,190300,14004
841,704,137,683,154900,14005
4155,3369,786,810,125800,14006
596,458,138,446,157100,14008
2602,1969,633,760,128200,14009
2832,2248,584,678,133100,14011
923,785,138,567,122000,14012
653,541,112,819,105900,14013
9811,6002,3809,807,110200,14020
562,516,46,694,112900,14024
1664,1503,161,828,198600,14025
323,214,109,-,161400,14026
621,513,108,874,141000,14028
692,594,98,742,158800,14030
4144,3413,731,835,268600,14031
3631,3390,241,1446,401000,14032
633,506,127,950,252900,14033
591,551,40,642,105200,14034
35,15,20,-,-,14035
2299,1849,450,694,152800,14036
315,315,0,-,154600,14037
31,23,8,-,83600,14039
733,647,86,865,183400,14040
73,65,8,-,60600,14041
1798,1325,473,681,85800,14042
10988,7582,3406,908,136700,14043
2598,2032,566,793,154200,14047
6479,3861,2618,726,77900,14048
7569,6092,1477,1607,299700,14051
7294,6080,1214,785,244900,14052
590,427,163,681,124000,14054
651,539,112,715,135400,14055
3365,2828,537,772,186200,14057
747,634,113,828,126800,14058
4177,3196,981,1068,274000,14059
239,189,50,-,-,14060
122,89,33,888,121500,14061
1375,1105,270,809,97400,14062
5091,3442,1649,787,143500,14063
640,570,70,711,100000,14065
506,407,99,711,94400,14066
1937,1651,286,886,141300,14067
2627,1854,773,1061,272700,14068
255,233,22,-,169600,14069
2126,1534,592,666,89500,14070
8797,6905,1892,1091,212900,14072
18976,13949,5027,927,182100,14075
1855,1543,312,645,189600,14080
1232,988,244,756,96600,14081
184,156,28,-,155200,14082
2818,2742,76,1028,206700,14085
13874,11526,2348,793,199000,14086
547,464,83,-,149400,14091
4961,3858,1103,922,208900,14092
20909,14947,5962,695,133500,14094
1173,881,292,777,99000,14098
707,631,76,747,102300,14101
505,458,47,-,268800,14102
4593,3389,1204,834,95500,14103
1849,1480,369,636,117300,14105
2062,1797,265,719,107400,14108
0,0,0,-,-,14109
1229,969,260,688,140600,14111
50,33,17,-,-,14112
251,195,56,869,124500,14113
18972,13876,5096,736,151000,14120
1353,971,382,723,107200,14125
247,212,35,-,108900,14126
12518,9101,3417,983,252100,14127
549,469,80,617,111800,14129
80,61,19,-,74600,14130
2059,1905,154,1021,169800,14131
2390,1904,486,837,155500,14132
51,46,5,-,137500,14134
30,25,5,-,-,14135
2035,1690,345,883,110500,14136
718,511,207,777,80600,14138
790,748,42,640,210200,14139
3182,2282,900,602,156200,14141
442,367,75,1400,126600,14143
592,495,97,834,163200,14145
18904,13448,5456,865,137300,14150
654,570,84,682,133500,14167
5,5,0,-,-,14168
82,82,0,-,"10,000-",14169
910,794,116,850,190800,14170
852,781,71,626,122200,14171
1266,1060,206,649,143500,14172
71,32,39,-,-,14173
2358,2001,357,903,189800,14174
5414,1304,4110,746,224700,14201
2034,519,1515,599,430900,14202
1275,26,1249,866,270000,14203
4287,1331,2956,623,106500,14204
8985,5438,3547,719,80200,14206
9386,3320,6066,730,73700,14207
4200,2115,2085,778,70900,14208
3664,870,2794,826,275600,14209
6465,3320,3145,740,85400,14210
9187,3718,5469,801,56400,14211
4650,2155,2495,714,68700,14212
8851,3164,5687,813,124400,14213
7701,3386,4315,893,173700,14214
16795,7534,9261,805,71100,14215
10561,4938,5623,952,202200,14216
11033,7443,3590,808,142000,14217
7880,4234,3646,735,104400,14218
5553,3793,1760,756,141100,14219
9451,6137,3314,779,123000,14220
23397,17646,5751,1240,236400,14221
6649,2633,4016,950,335400,14222
9981,8117,1864,787,144500,14223
18064,13972,4092,911,160500,14224
15675,10834,4841,812,110300,14225
12728,9182,3546,972,166200,14226
9767,6300,3467,924,137800,14227
9738,5182,4556,1095,195100,14228
6,0,6,-,-,14261
5735,2581,3154,613,60000,14301
148,0,148,479,-,14302
2645,1210,1435,724,62900,14303
12858,9801,3057,742,112300,14304
7420,4485,2935,638,80300,14305
5244,3454,1790,776,82600,14411
3037,2171,866,816,158000,14414
61,43,18,-,102200,14415
1397,1203,194,640,132800,14416
423,388,35,-,152200,14418
7457,4605,2852,833,144500,14420
850,722,128,852,118600,14422
1870,1481,389,770,137800,14423
12424,8307,4117,967,194700,14424
4898,3384,1514,1204,159300,14425
865,735,130,718,85700,14427
2858,2425,433,1059,166700,14428
1961,1654,307,584,119700,14432
1516,1130,386,759,77800,14433
1091,982,109,872,155000,14435
4266,3487,779,751,96400,14437
101,73,28,750,95400,14441
3426,2089,1337,953,109900,14445
17801,13919,3882,1031,215400,14450
3309,1645,1664,880,173300,14454
8127,4930,3197,825,129200,14456
228,206,22,743,147600,14462
2866,2537,329,821,119100,14464
643,615,28,578,141100,14466
3959,2697,1262,970,151600,14467
6753,5799,954,1044,158700,14468
2489,2089,400,800,149700,14469
3159,2644,515,684,111500,14470
1045,763,282,1057,173700,14471
3416,2717,699,894,275700,14472
135,130,5,-,330300,14475
941,834,107,794,125200,14476
609,527,82,772,119800,14477
307,267,40,-,190800,14478
70,70,0,-,-,14479
384,279,105,808,-,14480
773,642,131,816,119800,14481
3562,2687,875,800,131400,14482
1551,1196,355,773,153200,14485
158,148,10,-,118000,14486
2320,2016,304,765,165400,14487
2600,1966,634,855,86100,14489
4333,3544,789,817,171500,14502
692,499,193,907,95300,14504
2132,1742,390,587,126100,14505
432,419,13,-,243300,14506
358,329,29,698,141100,14507
1992,1454,538,731,88500,14510
156,85,71,440,108100,14511
1833,1541,292,685,154500,14512
5611,3751,1860,790,103200,14513
2627,1919,708,1120,165500,14514
888,721,167,1022,89600,14516
1215,873,342,669,94500,14517
4957,4023,934,845,167500,14519
1085,802,283,759,120200,14521
4162,3074,1088,724,125700,14522
1038,874,164,750,119100,14525
7924,6562,1362,977,213200,14526
4809,3356,1453,713,154200,14527
6,6,0,-,-,14529
2099,1464,635,701,95000,14530
1638,1276,362,764,151300,14532
933,743,190,802,148400,14533
11972,10682,1290,1500,260400,14534
297,211,86,570,85000,14536
60,29,31,-,84500,14537
35,35,0,-,173200,14539
960,685,275,999,134600,14541
46,33,13,-,-,14542
1277,1181,96,810,189700,14543
858,642,216,880,140700,14544
86,86,0,-,108000,14545
1955,1385,570,1133,141900,14546
1667,1373,294,922,121100,14548
47,38,9,-,212000,14549
564,419,145,586,87300,14550
2341,1923,418,714,106400,14551
618,537,81,905,153400,14555
7250,5813,1437,1089,170700,14559
991,854,137,930,151600,14560
1091,946,145,995,146200,14561
6074,5022,1052,1064,289400,14564
2403,2274,129,744,154000,14568
2710,1736,974,555,118700,14569
531,480,51,1323,132600,14571
2012,1619,393,654,91700,14572
22569,16431,6138,1116,197000,14580
28,20,8,-,"10,000-",14585
4349,3219,1130,1278,192200,14586
75,66,9,-,119600,14588
3082,2422,660,689,150700,14589
2424,1963,461,680,85000,14590
676,554,122,675,119300,14591
26,26,0,-,167500,14592
1764,233,1531,1074,-,14604
4095,953,3142,701,52700,14605
11044,6755,4289,858,116500,14606
10201,1534,8667,898,225000,14607
5431,1210,4221,819,119500,14608
17346,10396,6950,941,102700,14609
6956,3834,3122,939,180500,14610
6547,2103,4444,924,59300,14611
15066,10519,4547,899,145500,14612
5449,2020,3429,832,77600,14613
59,0,59,-,-,14614
7280,3651,3629,897,91900,14615
11492,7751,3741,1009,105800,14616
9413,7932,1481,952,138900,14617
8185,6125,2060,1190,219500,14618
5471,2843,2628,976,82800,14619
11514,3407,8107,967,156000,14620
12939,4337,8602,827,59900,14621
5836,4612,1224,914,119000,14622
8044,4360,3684,1067,132500,14623
14914,11710,3204,1078,137300,14624
4440,3934,506,1109,182700,14625
12894,8758,4136,991,146300,14626
0,0,0,-,-,14627
17234,9821,7413,624,76100,14701
2649,2060,589,715,119900,14706
47,36,11,-,-,14707
74,74,0,-,56300,14708
587,494,93,697,79800,14709
1312,1181,131,788,104900,14710
678,525,153,625,70200,14711
1452,1231,221,843,163800,14712
252,212,40,967,113000,14714
1121,766,355,718,64300,14715
825,565,260,558,85900,14716
241,209,32,664,97400,14717
733,603,130,811,100100,14718
1429,1116,313,563,86200,14719
318,158,160,695,51500,14720
84,74,10,-,133700,14721
49,49,0,-,-,14722
441,374,67,759,80700,14723
844,724,120,577,129300,14724
560,493,67,665,81900,14726
2306,1918,388,695,87400,14727
501,450,51,423,113000,14728
443,353,90,746,118100,14729
569,483,86,950,237500,14731
87,87,0,-,103700,14732
1465,1024,441,631,87000,14733
1077,881,196,585,89000,14735
74,57,17,-,76600,14736
1732,1472,260,668,79000,14737
1439,1190,249,843,92100,14738
1094,940,154,629,57000,14739
440,357,83,1314,89600,14740
741,647,94,632,113300,14741
78,65,13,-,98100,14742
833,643,190,515,74200,14743
436,311,125,620,112300,14744
768,669,99,596,75200,14747
220,166,54,475,68600,14748
1993,1347,646,782,127800,14750
158,121,37,-,144200,14752
545,432,113,617,64400,14753
245,195,50,663,74900,14754
1225,962,263,599,98800,14755
28,10,18,-,-,14756
1268,1019,249,647,150600,14757
8024,4537,3487,640,85000,14760
788,663,125,663,108900,14767
454,370,84,763,80000,14769
1198,904,294,541,89400,14770
1656,1255,401,598,93000,14772
29,28,1,-,104400,14774
993,840,153,587,91100,14775
264,218,46,664,87500,14777
0,0,0,-,-,14778
2783,1599,1184,651,71600,14779
778,626,152,653,87300,14781
970,838,132,630,87000,14782
106,83,23,738,85400,14783
358,317,41,621,87700,14784
2344,1634,710,630,79200,14787
5,5,0,-,-,14788
1953,1501,452,631,91800,14801
359,180,179,710,115500,14802
339,279,60,671,108300,14803
668,569,99,791,89900,14804
426,324,102,1032,134400,14805
855,652,203,707,74400,14806
1226,1022,204,812,95500,14807
218,187,31,728,77500,14808
941,705,236,753,85800,14809
5328,3539,1789,623,94200,14810
1214,960,254,798,93400,14812
891,683,208,628,73700,14813
717,419,298,1050,181800,14814
348,285,63,765,107400,14815
200,198,2,-,93300,14816
1009,597,412,1068,176800,14817
845,777,68,950,162900,14818
262,227,35,950,77200,14819
306,245,61,783,91800,14820
1230,1087,143,852,122100,14821
437,394,43,900,77100,14822
1437,1054,383,612,83700,14823
254,182,72,817,95600,14824
326,280,46,682,114100,14825
886,741,145,700,84600,14826
81,81,0,-,84900,14827
8640,5865,2775,893,129100,14830
382,363,19,638,70600,14836
2126,1740,386,630,112700,14837
751,718,33,795,106300,14838
346,286,60,671,100700,14839
1312,1118,194,694,158300,14840
295,236,59,1045,212100,14841
259,215,44,768,251900,14842
5477,3190,2287,622,80200,14843
8901,6327,2574,1058,146600,14845
385,348,37,758,86300,14846
945,738,207,648,132500,14847
26184,10988,15196,1179,261100,14850
0,0,0,-,-,14853
14,14,0,-,-,14854
278,240,38,842,97900,14855
108,57,51,-,-,14856
439,383,56,658,114600,14858
388,346,42,1016,107200,14859
547,368,179,588,124600,14860
486,430,56,963,97400,14861
417,393,24,929,88500,14864
1131,778,353,685,104600,14865
2480,1961,519,1000,146700,14867
494,365,129,663,140200,14869
4164,3111,1053,855,143000,14870
1931,1624,307,1001,138200,14871
229,188,41,588,166700,14872
850,782,68,1250,107800,14873
113,104,9,-,88900,14874
207,155,52,761,116900,14877
198,185,13,858,184400,14878
956,873,83,787,89400,14879
841,754,87,711,84000,14880
93,51,42,-,263800,14881
1555,1277,278,1384,232300,14882
1935,1427,508,907,152800,14883
128,101,27,742,98500,14884
269,215,54,900,120100,14885
2819,2266,553,1092,194700,14886
579,487,92,894,97600,14889
1964,1255,709,684,126200,14891
3193,2209,984,759,112700,14892
0,0,0,-,-,14893
420,367,53,889,94800,14894
4285,3125,1160,631,74100,14895
305,252,53,578,63700,14897
570,472,98,703,90000,14898
5384,2923,2461,694,81800,14901
3122,1862,1260,807,119400,14903
6478,3872,2606,870,73100,14904
3686,2449,1237,823,132200,14905
14093,10724,3369,791,148500,15001
5104,3303,1801,745,98900,15003
138,138,0,-,108700,15004
3948,3375,573,604,167000,15005
131,124,7,-,91000,15006
167,129,38,-,180400,15007
6509,5016,1493,673,194000,15009
11363,7701,3662,735,152800,15010
6883,5181,1702,730,160800,15012
1450,986,464,710,71900,15014
490,474,16,617,379000,15015
7035,5087,1948,927,183200,15017
546,479,67,747,69300,15018
715,558,157,683,116300,15019
17,9,8,-,-,15020
3108,2399,709,715,137200,15021
4127,3072,1055,641,94500,15022
3534,2874,660,880,148800,15024
6793,4719,2074,935,169500,15025
1393,1032,361,831,177100,15026
1169,810,359,582,137500,15027
68,64,4,-,80000,15028
551,299,252,811,72400,15030
231,152,79,593,92300,15031
2207,1027,1180,750,62500,15033
928,473,455,526,67700,15034
980,666,314,636,70800,15035
4382,3823,559,805,132700,15037
150,96,54,-,77600,15038
3588,3064,524,1173,174400,15042
897,815,82,807,169600,15043
10609,9763,846,1222,300600,15044
1853,1285,568,735,71700,15045
1105,926,179,941,146700,15046
36,36,0,-,-,15047
524,431,93,855,105800,15049
1006,959,47,942,187800,15050
229,159,70,1061,86200,15051
1254,1005,249,835,140400,15052
50,43,7,-,81700,15053
132,115,17,-,106900,15054
562,480,82,897,187600,15055
566,327,239,854,86600,15056
6153,5411,742,836,244300,15057
1724,869,855,581,74100,15059
347,291,56,600,109300,15060
5256,3467,1789,798,147900,15061
3430,2629,801,617,76900,15062
4960,3918,1042,751,125600,15063
120,74,46,894,-,15064
5088,3859,1229,670,116600,15065
5631,3619,2012,716,100400,15066
1117,822,295,648,88900,15067
16994,11754,5240,720,138500,15068
4967,3579,1388,1188,204400,15071
8,0,8,-,-,15072
3771,2437,1334,696,110400,15074
20,20,0,-,-,15075
321,183,138,783,104500,15076
85,63,22,800,140600,15077
141,120,21,-,77100,15078
151,100,51,668,99100,15081
82,41,41,-,-,15082
396,354,42,875,89200,15083
4702,3282,1420,685,85300,15084
3284,2679,605,738,146000,15085
188,136,52,1329,235200,15086
38,29,9,-,-,15087
174,111,63,720,62500,15088
2996,2252,744,673,139300,15089
9269,7274,1995,1427,353400,15090
10485,7773,2712,1012,238700,15101
13019,10699,2320,1004,207200,15102
4046,1909,2137,543,46000,15104
9768,6460,3308,847,147700,15106
17387,12830,4557,935,207200,15108
2246,900,1346,631,45200,15110
1494,664,830,636,69500,15112
6005,5232,773,969,192600,15116
8638,5163,3475,755,90100,15120
8314,6393,1921,737,99300,15122
3176,2556,620,650,207100,15126
4407,3414,993,1109,167700,15129
3890,2668,1222,814,120500,15131
9977,4820,5157,688,53800,15132
2877,2254,623,830,75300,15133
2110,1541,569,768,128200,15135
9832,6035,3797,858,145400,15136
4726,3109,1617,760,85000,15137
3244,1837,1407,881,238700,15139
1557,595,962,663,72100,15140
441,391,50,-,670500,15142
8757,6852,1905,1284,350500,15143
1877,1291,586,693,114800,15144
3186,1434,1752,711,63000,15145
12122,8503,3619,1052,155300,15146
7980,5323,2657,779,104300,15147
1140,424,716,743,52600,15148
6769,3636,3133,1157,185900,15201
9899,4975,4924,805,145300,15202
5853,2238,3615,1268,221700,15203
3584,2266,1318,838,82500,15204
10050,5938,4112,917,136300,15205
14846,6079,8767,1047,226700,15206
4981,3180,1801,865,97600,15207
4354,2246,2108,850,134500,15208
5738,4250,1488,870,169100,15209
11412,6198,5214,853,70300,15210
5776,2568,3208,998,138700,15211
13991,7063,6928,883,102300,15212
10267,2465,7802,985,179500,15213
6071,3890,2181,856,121500,15214
5624,4139,1485,881,236000,15215
10647,6526,4121,917,141500,15216
12000,6058,5942,1151,310900,15217
6828,3860,2968,890,158600,15218
5307,1201,4106,754,100000,15219
8342,4604,3738,1060,167300,15220
15992,6891,9101,843,108700,15221
2865,506,2359,1602,379300,15222
3289,2062,1227,772,112200,15223
5871,2000,3871,974,177100,15224
558,310,248,787,92500,15225
6404,4490,1914,905,123000,15226
11965,8608,3357,746,129100,15227
7115,5149,1966,999,292400,15228
6108,4486,1622,895,161100,15229
6496,1859,4637,1173,407600,15232
1482,597,885,733,222400,15233
6149,4435,1714,927,141300,15234
14976,10951,4025,923,102600,15235
12721,9774,2947,931,169500,15236
17741,13740,4001,1043,239000,15237
5314,4153,1161,967,359800,15238
8326,7023,1303,998,155500,15239
7950,6869,1081,1246,303000,15241
5483,4678,805,978,211600,15243
0,0,0,-,-,15260
0,0,0,-,-,15290
20833,13907,6926,780,164900,15301
111,96,15,833,123000,15310
542,497,45,790,224400,15311
1602,1286,316,779,167300,15312
137,119,18,940,108900,15313
1433,1082,351,511,133900,15314
222,187,35,-,59400,15315
53,33,20,-,-,15316
15790,12409,3381,1045,262600,15317
2331,1768,563,448,114500,15320
575,446,129,1293,232600,15321
732,592,140,676,84400,15322
1687,1364,323,679,158600,15323
315,219,96,873,83900,15324
172,102,70,-,34100,15325
622,497,125,800,111500,15327
616,486,130,785,179100,15329
2070,1850,220,930,259800,15330
314,227,87,930,66900,15331
3781,3303,478,717,157400,15332
738,501,237,614,164700,15333
54,50,4,-,168800,15334
174,137,37,-,162500,15337
674,553,121,750,90200,15338
519,476,43,777,265100,15340
333,230,103,764,154200,15341
2265,1856,409,902,191600,15342
719,628,91,1268,121600,15344
564,468,96,819,108800,15345
210,190,20,-,83600,15346
132,82,50,-,-,15347
65,45,20,-,-,15348
634,487,147,819,187300,15349
170,82,88,823,60600,15350
373,206,167,-,-,15351
451,387,64,633,135600,15352
71,51,20,-,199000,15353
602,510,92,731,117000,15357
400,273,127,849,97700,15358
82,38,44,792,97500,15359
679,590,89,883,178200,15360
91,59,32,-,-,15361
357,317,40,700,117900,15362
208,113,95,688,129800,15363
320,278,42,692,157100,15364
245,55,190,-,-,15366
3058,2820,238,-,407400,15367
174,125,49,586,56300,15368
4959,3372,1587,668,152900,15370
607,487,120,767,167100,15376
250,196,54,986,226500,15377
21,12,9,-,-,15378
42,33,9,-,102500,15379
300,227,73,659,85800,15380
13513,9414,4099,678,115400,15401
522,434,88,-,58900,15410
271,229,42,831,160200,15411
209,175,34,768,71500,15412
149,124,25,-,32100,15413
3556,2404,1152,658,81600,15417
1594,602,992,641,100500,15419
74,44,30,-,63300,15420
23,23,0,-,-,15421
79,38,41,-,-,15422
791,643,148,889,156100,15423
936,657,279,626,111900,15424
8518,5924,2594,576,112400,15425
418,322,96,792,127200,15427
745,669,76,767,100600,15428
139,114,25,-,-,15429
139,139,0,-,64100,15430
1812,1421,391,648,88400,15431
210,146,64,738,79300,15432
298,242,56,-,153300,15433
132,98,34,-,80000,15434
170,133,37,855,70700,15435
1103,786,317,699,88800,15436
803,502,301,950,172900,15437
873,760,113,674,106900,15438
62,57,5,-,159700,15440
912,608,304,789,88600,15442
8,8,0,-,-,15443
198,198,0,-,100800,15444
1194,1004,190,687,123600,15445
80,65,15,-,79300,15446
51,51,0,-,-,15447
93,77,16,-,68200,15448
94,94,0,-,66700,15449
92,92,0,-,-,15450
470,424,46,-,95900,15451
48,29,19,-,-,15454
138,115,23,-,-,15455
1257,994,263,729,104700,15456
997,709,288,1116,85700,15458
559,460,99,706,150000,15459
55,53,2,-,70700,15460
1709,1214,495,717,94600,15461
97,97,0,-,"10,000-",15462
45,45,0,-,-,15463
588,484,104,922,101600,15464
192,167,25,1106,82900,15466
59,56,3,-,36000,15467
1073,832,241,696,70000,15468
1085,792,293,682,95300,15469
296,245,51,627,204200,15470
90,21,69,736,-,15472
1639,1376,263,679,168600,15473
683,436,247,847,86500,15474
551,335,216,702,66100,15475
22,22,0,-,-,15476
382,311,71,642,106300,15477
2379,1941,438,685,123500,15478
905,766,139,842,167100,15479
941,685,256,691,105300,15480
142,118,24,625,127300,15482
186,152,34,673,83800,15483
169,169,0,-,53100,15484
974,854,120,669,129300,15486
144,134,10,-,57300,15489
207,192,15,-,117500,15490
53,53,0,-,73700,15492
6378,4574,1804,585,126400,15501
44,44,0,-,163900,15502
8,8,0,-,-,15510
104,92,12,-,-,15520
675,584,91,775,161600,15521
4961,3912,1049,680,163600,15522
2047,1675,372,545,129700,15530
1539,1119,420,551,97600,15531
61,44,17,758,82000,15532
520,376,144,735,156700,15533
383,335,48,658,134900,15534
830,709,121,646,154400,15535
146,126,20,875,188500,15536
3518,2527,991,691,145300,15537
283,261,22,521,116900,15538
125,104,21,-,147700,15539
127,110,17,-,175000,15540
1358,1244,114,535,134300,15541
451,373,78,718,81700,15542
48,48,0,-,107900,15544
1134,947,187,678,105100,15545
204,204,0,-,56200,15546
284,215,69,686,170100,15547
721,571,150,692,125200,15550
267,223,44,606,109600,15551
2289,1759,530,547,100600,15552
1142,926,216,551,130200,15554
30,30,0,-,65700,15555
1447,1172,275,617,110100,15557
772,565,207,697,119100,15558
720,602,118,582,148000,15559
57,48,9,775,85000,15560
87,58,29,660,121200,15561
81,66,15,936,195000,15562
1286,1093,193,612,101700,15563
23,18,5,575,95000,15564
24492,17936,6556,734,170400,15601
1806,1602,204,683,175500,15610
259,165,94,1516,-,15611
170,134,36,-,130300,15612
5527,4651,876,750,153100,15613
139,139,0,-,158100,15615
0,0,0,-,-,15616
152,140,12,825,92100,15617
1096,891,205,670,90000,15618
268,219,49,775,-,15620
30,30,0,-,-,15621
491,462,29,230,155000,15622
326,272,54,738,143000,15623
186,169,17,-,68300,15624
27,27,0,-,-,15625
2433,1972,461,690,176500,15626
2639,2162,477,673,120100,15627
245,180,65,-,82200,15628
309,170,139,763,58100,15629
440,236,204,735,88100,15631
3595,2716,879,791,212000,15632
241,128,113,841,118500,15633
193,93,100,638,60700,15634
79,43,36,-,-,15635
1743,1535,208,1296,274100,15636
490,361,129,916,156900,15637
66,66,0,-,-,15638
936,585,351,1151,167200,15639
211,187,24,-,103400,15640
235,170,65,583,90900,15641
18578,15555,3023,742,183000,15642
8678,6776,1902,769,124100,15644
104,76,28,-,111800,15646
159,139,20,-,78300,15647
11495,8288,3207,752,149400,15650
102,71,31,716,-,15655
4074,3347,727,720,126800,15656
4125,3328,797,759,197700,15658
216,199,17,-,135100,15660
297,260,37,828,124700,15661
280,280,0,-,93700,15662
226,186,40,625,157800,15663
479,436,43,-,115400,15665
7218,5616,1602,694,132300,15666
5423,5055,368,1252,263900,15668
1324,1143,181,798,151400,15670
253,253,0,-,110600,15671
1406,973,433,897,195400,15672
596,501,95,565,108600,15673
389,314,75,822,79000,15675
263,171,92,1302,170100,15676
158,145,13,-,135400,15677
254,171,83,843,159300,15678
1273,1075,198,725,133900,15679
117,106,11,-,-,15680
1977,1596,381,810,120900,15681
3582,2643,939,575,133700,15683
295,273,22,-,91700,15684
367,353,14,525,186000,15686
478,444,34,500,181400,15687
406,406,0,-,84400,15688
79,58,21,-,97700,15689
4034,2590,1444,678,84000,15690
0,0,0,-,-,15691
428,304,124,623,133200,15692
50,35,15,-,-,15693
146,117,29,-,-,15695
114,95,19,719,100500,15696
1350,855,495,710,117800,15697
318,282,36,838,112400,15698
13486,7678,5808,713,154900,15701
66,40,26,672,113200,15710
174,134,40,800,77100,15711
88,74,14,-,56800,15712
117,117,0,-,-,15713
1925,1464,461,599,74500,15714
198,147,51,725,90500,15715
322,200,122,642,96700,15716
4368,3284,1084,670,137900,15717
86,69,17,-,48100,15721
844,749,95,638,98400,15722
12,12,0,-,-,15723
864,761,103,575,89200,15724
603,470,133,608,117900,15725
70,51,19,831,62200,15727
1289,860,429,593,101100,15728
576,440,136,388,97200,15729
50,45,5,-,99200,15730
164,130,34,-,65400,15731
626,545,81,703,141400,15732
85,80,5,-,69600,15733
187,159,28,-,65500,15734
335,207,128,820,112200,15736
45,45,0,-,-,15737
90,75,15,769,42100,15738
199,145,54,850,70100,15739
25,23,2,-,75000,15741
337,280,57,623,81700,15742
48,41,7,-,75600,15744
97,91,6,-,32300,15745
46,29,17,-,67700,15746
700,562,138,684,145200,15747
2923,2214,709,705,115700,15748
80,60,20,-,-,15750
14,2,12,-,-,15752
177,155,22,563,76000,15753
209,157,52,-,74500,15754
83,59,24,789,88300,15756
605,527,78,750,76600,15757
1083,880,203,683,137800,15759
54,37,17,-,50500,15760
39,11,28,-,57500,15761
364,339,25,614,146500,15762
74,71,3,-,160800,15764
610,508,102,639,158000,15765
6005,4353,1652,751,120500,15767
88,82,6,-,142300,15770
370,331,39,225,120300,15771
599,468,131,871,97000,15772
222,218,4,-,78300,15773
1133,995,138,558,147300,15774
368,311,57,-,94400,15775
29,27,2,-,83900,15776
42,42,0,-,76300,15777
65,62,3,-,60800,15778
140,109,31,541,153100,15779
57,54,3,-,74300,15780
42,40,2,-,77500,15781
35,28,7,-,70000,15783
23,20,3,-,82500,15784
7800,5421,2379,777,123600,15801
61,54,7,-,91700,15821
524,445,79,589,111900,15823
2101,1646,455,688,113600,15824
3817,2766,1051,656,124600,15825
122,114,8,-,63300,15827
122,105,17,-,90700,15828
518,410,108,675,110300,15829
132,107,25,390,69200,15832
2113,1381,732,656,77500,15834
828,647,181,865,92400,15840
169,140,29,-,61800,15841
1439,1055,384,538,62400,15845
1558,1454,104,915,121900,15846
132,108,24,710,64300,15847
371,336,35,1125,100700,15848
540,451,89,882,92100,15849
2645,2009,636,643,95200,15851
2967,2295,672,579,89200,15853
372,349,23,688,139600,15856
5997,4407,1590,654,120800,15857
511,431,80,613,123000,15860
76,68,8,725,80000,15861
91,87,4,-,56800,15863
621,508,113,626,97100,15864
591,374,217,650,83200,15865
81,71,10,763,72500,15866
620,538,82,615,140500,15868
544,489,55,546,78900,15870
2094,704,1390,502,17100,15901
5149,3204,1945,593,48700,15902
6782,4762,2020,767,141200,15904
8973,6870,2103,693,102100,15905
4864,3204,1660,509,49100,15906
2022,1790,232,550,87500,15909
310,274,36,833,122100,15920
46,18,28,-,55500,15921
118,111,7,-,86800,15922
652,561,91,613,117900,15923
414,384,30,864,71900,15924
63,51,12,663,65800,15925
1081,927,154,711,78800,15926
422,345,77,-,73200,15927
979,834,145,1221,205000,15928
25,11,14,-,-,15929
81,81,0,-,31200,15930
3788,2740,1048,765,163600,15931
13,13,0,-,-,15934
1276,1104,172,620,111900,15935
689,617,72,625,108200,15936
297,236,61,-,73300,15937
982,875,107,604,91900,15938
707,600,107,950,190300,15940
851,808,43,729,132100,15942
1640,1249,391,626,72800,15943
1184,1028,156,457,133200,15944
18,18,0,-,55000,15945
2828,2343,485,495,92100,15946
191,146,45,-,91900,15948
205,188,17,829,52100,15949
262,262,0,-,-,15951
552,400,152,606,149600,15952
21,21,0,-,-,15953
1079,864,215,707,82600,15954
931,866,65,665,100800,15955
1239,1036,203,592,63100,15956
218,189,29,-,123400,15957
809,681,128,709,117300,15958
124,110,14,875,65200,15960
326,255,71,670,76200,15961
93,73,20,617,91900,15962
4596,3629,967,623,109300,15963
17616,11736,5880,726,160000,16001
6398,5431,967,651,208700,16002
402,341,61,795,149600,16020
155,106,49,783,94000,16022
1818,1206,612,1036,215300,16023
102,89,13,1047,136700,16024
2034,1732,302,638,165100,16025
101,57,44,1081,185600,16027
754,549,205,575,117000,16028
402,295,107,782,117600,16029
117,90,27,617,83800,16030
2908,2254,654,860,223200,16033
777,691,86,866,171200,16034
33,21,12,-,225000,16035
137,99,38,781,112500,16036
1779,1486,293,1162,266300,16037
1369,1122,247,728,151100,16038
356,299,57,494,133800,16040
876,740,136,722,111000,16041
423,236,187,943,104300,16045
6354,5000,1354,1483,370200,16046
42,39,3,-,89200,16048
1203,931,272,650,108900,16049
549,448,101,759,105800,16050
1229,1082,147,596,172000,16051
1023,968,55,900,175400,16052
1720,1586,134,645,233600,16053
174,146,28,645,87200,16054
3357,3022,335,781,251900,16055
2006,1516,490,705,231800,16056
4669,2794,1875,741,186400,16057
3375,2947,428,1724,286600,16059
1160,1018,142,903,178000,16061
3420,2164,1256,996,217600,16063
12656,9843,2813,1318,315400,16066
13832,9745,4087,632,92400,16101
2281,1649,632,753,89100,16102
6947,5196,1751,837,139100,16105
149,141,8,-,104400,16110
501,433,68,681,119700,16111
639,577,62,710,101800,16112
192,159,33,979,163600,16113
220,196,24,877,119800,16114
1375,1099,276,687,151800,16115
1233,1076,157,642,106900,16116
7626,5817,1809,688,115400,16117
986,787,199,580,135000,16120
2197,1133,1064,593,60400,16121
965,866,99,1083,166900,16123
711,619,92,605,133900,16124
7056,4894,2162,707,112900,16125
5409,3902,1507,710,156900,16127
886,708,178,545,113300,16130
348,265,83,638,144300,16131
154,128,26,-,104200,16132
579,523,56,870,135200,16133
1680,1456,224,715,104300,16134
354,257,97,582,77500,16136
4443,3602,841,612,144100,16137
107,96,11,-,-,16140
691,563,128,717,83600,16141
2010,1525,485,680,184100,16142
979,841,138,704,155200,16143
1330,1090,240,653,133200,16145
6214,3243,2971,575,64700,16146
7566,5608,1958,767,147500,16148
3118,2283,835,696,110500,16150
31,25,6,-,78800,16151
992,794,198,685,130200,16153
974,820,154,771,134700,16154
49,0,49,842,-,16155
1241,1094,147,750,161900,16156
1363,1115,248,585,113000,16157
2305,1839,466,744,132800,16159
496,299,197,759,70300,16160
307,236,71,563,50000,16161
6987,5120,1867,696,127300,16201
322,273,49,758,113800,16210
34,31,3,-,68500,16211
145,116,29,788,68000,16212
62,39,23,-,67500,16213
4170,1919,2251,681,150300,16214
84,72,12,-,153100,16217
463,438,25,388,125000,16218
1016,865,151,539,119800,16222
80,64,16,-,85300,16223
446,337,109,783,91900,16224
3505,2720,785,627,89900,16226
175,154,21,793,78500,16228
2197,1689,508,700,167000,16229
196,155,41,683,77500,16230
1689,1282,407,623,114000,16232
548,485,63,871,138400,16233
526,478,48,675,170100,16235
112,100,12,-,93700,16236
190,150,40,638,121900,16238
590,495,95,709,87000,16239
639,487,152,650,138700,16240
1824,1340,484,617,107400,16242
158,123,35,845,69700,16244
102,56,46,653,58100,16245
73,55,18,1000,68800,16246
1249,904,345,597,90000,16248
812,654,158,875,127700,16249
166,134,32,1027,-,16250
57,25,32,592,65000,16253
1436,1180,256,708,126800,16254
682,528,154,599,121500,16255
510,465,45,544,112500,16256
773,505,268,595,155900,16258
871,698,173,537,110100,16259
150,131,19,-,261900,16260
1222,1030,192,839,137200,16262
103,90,13,-,94700,16263
6462,4523,1939,664,74900,16301
200,179,21,625,125700,16311
0,0,0,-,-,16312
762,622,140,700,79300,16313
2188,1838,350,684,127700,16314
2292,1852,440,668,136800,16316
549,456,93,1007,105000,16317
527,499,28,592,133800,16319
26,15,11,-,67500,16321
47,47,0,-,57000,16322
6667,4473,2194,621,96900,16323
131,107,24,655,129200,16326
1075,969,106,656,138500,16327
61,32,29,825,75000,16328
204,175,29,675,82700,16329
23,20,3,-,-,16331
8,8,0,-,120000,16332
121,112,9,-,56700,16333
156,150,6,-,163300,16334
11767,6936,4831,733,118000,16335
734,668,66,718,92400,16340
763,691,72,639,89000,16341
867,763,104,643,103300,16342
295,227,68,-,88100,16343
174,93,81,692,44000,16344
1509,1390,119,583,151300,16345
1620,1024,596,673,116000,16346
833,680,153,505,89600,16347
873,712,161,558,127700,16350
671,515,156,464,83000,16351
75,66,9,-,76700,16352
1450,1203,247,525,99900,16353
4515,3126,1389,561,84700,16354
592,441,151,678,145800,16360
5,5,0,-,-,16361
391,341,50,533,131700,16362
475,386,89,797,142400,16364
8175,5770,2405,627,98900,16365
145,121,24,375,151800,16370
1382,1006,376,591,86700,16371
242,165,77,518,74800,16372
1302,1052,250,650,115000,16373
816,686,130,726,105700,16374
1641,1266,375,600,122700,16401
326,299,27,718,110900,16402
2537,2015,522,611,128400,16403
1256,1028,228,750,119700,16404
308,268,40,788,89700,16405
1319,1075,244,756,120700,16406
4698,3402,1296,700,95400,16407
725,688,37,682,143800,16410
562,458,104,984,132600,16411
4347,2771,1576,831,183600,16412
3229,3015,214,933,222500,16415
80,69,11,-,-,16416
3417,2543,874,579,140000,16417
223,206,17,1063,80400,16420
1022,669,353,566,159200,16421
134,121,13,-,105600,16422
1714,1411,303,653,127700,16423
1995,1701,294,641,106500,16424
1458,1228,230,636,162100,16426
63,47,16,725,69300,16427
4795,3462,1333,669,152900,16428
2034,1641,393,642,138800,16433
949,822,127,638,128200,16434
751,588,163,719,123300,16435
283,228,55,-,157300,16436
3176,2461,715,652,122400,16438
378,311,67,544,139100,16440
3994,3396,598,702,174500,16441
1185,1005,180,619,157300,16442
461,425,36,-,128900,16443
0,0,0,-,-,16444
1163,14,1149,386,-,16501
6974,2582,4392,715,74200,16502
5628,1858,3770,737,46600,16503
6874,4593,2281,839,90000,16504
7615,5760,1855,759,156400,16505
9967,7112,2855,949,188600,16506
3699,1231,2468,773,48800,16507
6913,4605,2308,757,99600,16508
11852,8249,3603,920,158200,16509
9982,7956,2026,761,126200,16510
4604,2869,1735,778,143100,16511
0,0,0,-,-,16546
0,0,0,-,-,16563
13477,9263,4214,666,111500,16601
12156,7803,4353,747,100800,16602
1041,917,124,663,138100,16611
520,491,29,671,130500,16613
69,54,15,-,77500,16616
1166,861,305,757,120000,16617
129,119,10,567,84000,16619
136,117,19,900,92900,16620
280,218,62,680,128100,16621
56,55,1,-,128100,16622
216,191,25,838,147900,16623
75,56,19,550,105600,16624
1616,1125,491,754,123300,16625
880,785,95,542,75900,16627
1965,1386,579,640,120500,16630
40,35,5,-,135400,16631
120,93,27,780,78800,16633
146,131,15,850,97500,16634
5331,4010,1321,931,151400,16635
296,272,24,1083,165600,16636
1124,906,218,863,117300,16637
14,12,2,-,150000,16638
617,565,52,743,108200,16639
299,272,27,750,117500,16640
1128,941,187,685,95400,16641
83,81,2,-,82100,16645
930,811,119,557,88800,16646
301,245,56,589,190300,16647
6267,4647,1620,750,190500,16648
674,548,126,645,116500,16650
1368,1096,272,557,82300,16651
5961,4212,1749,721,147800,16652
644,538,106,763,129600,16655
483,431,52,595,83100,16656
565,485,80,607,168700,16657
88,38,50,739,96700,16659
346,305,41,592,83400,16661
2331,1639,692,762,162400,16662
687,599,88,650,154900,16664
120,90,30,820,150000,16665
1469,1370,99,692,81300,16666
553,386,167,808,118100,16667
1406,1154,252,431,88900,16668
866,716,150,644,165400,16669
12,12,0,-,116700,16670
186,143,43,744,82900,16671
82,63,19,-,68100,16672
2165,1732,433,916,135700,16673
244,189,55,688,88100,16674
118,89,29,-,109000,16677
1077,859,218,550,103900,16678
285,260,25,525,68400,16679
138,125,13,-,91300,16680
16,11,5,-,-,16682
124,103,21,675,159700,16683
94,94,0,-,186700,16685
5269,3649,1620,708,131100,16686
198,185,13,-,161600,16689
159,147,12,825,171300,16691
363,293,70,675,89800,16692
1450,1197,253,658,126200,16693
76,76,0,-,84000,16694
415,344,71,729,147000,16695
0,0,0,-,-,16699
7220,5016,2204,712,79800,16701
493,430,63,727,79000,16720
50,44,6,675,-,16724
59,39,20,-,114100,16725
240,193,47,588,121100,16726
54,16,38,-,73800,16727
14,14,0,-,-,16728
295,224,71,658,83900,16729
48,42,6,-,81300,16730
1101,912,189,549,86400,16731
108,97,11,-,71900,16732
57,38,19,625,60000,16733
118,87,31,595,61000,16734
2670,1957,713,664,75700,16735
601,533,68,717,93500,16738
440,306,134,643,61500,16740
1617,1266,351,731,89300,16743
100,73,27,-,82100,16744
276,271,5,-,88400,16745
475,396,79,747,85000,16746
1086,824,262,585,80600,16748
1662,1291,371,705,91000,16749
189,165,24,629,68400,16750
18116,7690,10426,1077,299600,16801
0,0,0,-,-,16802
10083,4367,5716,1152,334200,16803
481,432,49,750,168900,16820
120,120,0,-,164300,16821
729,595,134,536,131500,16822
11699,8780,2919,857,204400,16823
155,155,0,-,85700,16825
187,172,15,-,171600,16826
1805,1463,342,1156,348900,16827
2049,1826,223,905,250000,16828
289,256,33,733,136400,16829
5782,3792,1990,658,94800,16830
136,123,13,792,183900,16832
2227,1746,481,591,109500,16833
240,227,13,-,190000,16834
94,88,6,800,145000,16835
459,408,51,688,86800,16836
73,73,0,-,-,16837
750,578,172,766,105400,16838
201,184,17,-,90000,16839
177,151,26,-,72700,16840
2246,1970,276,815,183000,16841
238,197,41,676,49800,16843
989,888,101,870,181800,16844
334,310,24,655,111000,16845
106,83,23,-,119700,16847
176,132,44,660,124200,16848
92,89,3,-,156700,16849
343,256,87,824,262000,16851
101,77,24,575,155300,16852
96,41,55,705,115300,16853
272,195,77,773,159800,16854
83,83,0,-,"10,000-",16855
1490,1250,240,545,129300,16858
199,175,24,778,113400,16859
243,243,0,-,76600,16860
160,156,4,-,186500,16861
205,165,40,758,110100,16863
716,642,74,1253,252700,16865
3929,2685,1244,595,117100,16866
405,405,0,-,239500,16868
2692,2301,391,810,334200,16870
34,32,2,-,73600,16871
410,311,99,726,194100,16872
539,480,59,681,128900,16874
1524,1303,221,843,256200,16875
105,79,26,775,59500,16876
847,729,118,932,223400,16877
665,559,106,889,109200,16878
198,149,49,629,70800,16879
1020,868,152,1034,75400,16881
145,126,19,1018,157700,16882
4230,3298,932,715,179100,16901
193,177,16,625,101000,16911
832,558,274,762,117500,16912
945,811,134,755,195000,16914
2377,1720,657,710,136600,16915
483,372,111,698,165000,16917
768,521,247,703,106400,16920
248,216,32,636,158600,16921
812,594,218,643,102400,16922
600,518,82,769,109300,16923
1269,1101,168,806,156600,16925
340,254,86,819,163200,16926
203,175,28,843,99100,16927
546,404,142,705,120900,16928
956,731,225,767,145100,16929
462,373,89,882,166800,16930
322,242,80,-,201200,16932
2682,1662,1020,727,159600,16933
486,389,97,871,174100,16935
857,676,181,770,146900,16936
69,63,6,-,195800,16937
352,321,31,656,172800,16938
129,93,36,977,85500,16939
88,63,25,480,125900,16940
33,31,2,-,87500,16941
295,230,65,746,109900,16942
172,119,53,713,131300,16943
1003,767,236,809,121900,16946
1697,1241,456,642,142800,16947
589,465,124,469,117100,16948
1272,1005,267,611,107700,16950
219,172,47,375,165700,17002
4472,3427,1045,893,205200,17003
1623,1154,469,567,165500,17004
124,99,25,765,109900,17005
325,259,66,710,143800,17006
2158,1689,469,705,277200,17007
840,603,237,788,95700,17009
75,0,75,-,-,17010
13802,9195,4607,1092,205700,17011
14599,8934,5665,903,184400,17013
8307,7191,1116,1016,243800,17015
472,221,251,2533,131000,17016
658,542,116,586,145500,17017
1897,1590,307,855,189900,17018
7429,6076,1353,972,232300,17019
3639,2906,733,776,184600,17020
408,298,110,688,158300,17021
12054,8124,3930,1156,221600,17022
1318,995,323,632,151700,17023
720,623,97,880,207600,17024
7347,5159,2188,930,198400,17025
1492,1357,135,896,216300,17026
87,70,17,-,196200,17027
1585,1374,211,959,193700,17028
29,29,0,-,-,17029
390,218,172,670,114500,17030
3228,2728,500,698,171800,17032
6864,4032,2832,1070,244400,17033
1063,568,495,913,99600,17034
398,290,108,628,142600,17035
9200,6486,2714,1151,266500,17036
310,221,89,907,151500,17037
3429,2641,788,712,194900,17038
41,41,0,-,-,17039
931,754,177,771,183800,17040
93,93,0,-,247700,17041
14804,10316,4488,874,168400,17042
2752,1474,1278,873,169800,17043
9178,6035,3143,692,96400,17044
1410,1102,308,649,187300,17045
11901,7177,4724,838,144000,17046
893,703,190,670,213800,17047
1555,1146,409,805,116700,17048
1101,845,256,749,139300,17049
15464,11766,3698,1221,282700,17050
2016,1708,308,683,139100,17051
584,508,76,795,119400,17052
2254,1768,486,862,173000,17053
16147,11162,4985,1117,211900,17055
41,34,7,-,-,17056
9845,6892,2953,954,144300,17057
568,330,238,556,153100,17058
3226,2357,869,695,158400,17059
378,294,84,633,118900,17060
2965,2209,756,669,146000,17061
1595,1406,189,748,179200,17062
1328,1084,244,792,96900,17063
244,197,47,1151,258900,17064
1517,1171,346,863,171400,17065
2267,1534,733,657,85200,17066
5750,4442,1308,936,175700,17067
1644,1405,239,822,177800,17068
55,24,31,595,112500,17069
7394,5582,1812,824,183800,17070
46,40,6,-,83300,17071
139,86,53,-,87700,17072
1995,1667,328,818,205600,17073
2966,2208,758,703,166400,17074
68,50,18,847,58600,17075
25,25,0,-,-,17076
0,0,0,-,-,17077
8635,5908,2727,1037,202400,17078
111,99,12,650,96500,17080
191,156,35,-,113800,17081
1166,850,316,710,165400,17082
39,39,0,-,161700,17083
1734,1416,318,720,162800,17084
767,533,234,747,157100,17086
980,871,109,863,191200,17087
303,226,77,-,180900,17088
2672,2358,314,469,181900,17090
514,409,105,1354,139800,17093
1022,778,244,650,131700,17094
269,232,37,788,70400,17097
982,677,305,685,91900,17098
553,425,128,784,83500,17099
1725,109,1616,855,161800,17101
4351,1429,2922,836,140800,17102
4634,1457,3177,812,76800,17103
7512,2906,4606,821,75300,17104
10499,5530,4969,1020,157400,17109
10560,6546,4014,1121,162800,17110
12874,8451,4423,1109,179700,17111
14817,12505,2312,1159,229700,17112
3741,2368,1373,1019,101900,17113
0,0,0,-,-,17120
11719,5659,6060,880,164100,17201
11519,9157,2362,1003,215700,17202
60,40,20,-,120800,17210
173,153,20,-,125900,17211
243,228,15,-,175000,17212
242,214,28,-,164100,17213
424,264,160,725,212600,17214
88,80,8,-,157700,17215
64,53,11,-,162100,17217
271,257,14,-,-,17219
221,146,75,334,219400,17220
256,198,58,725,146500,17221
4635,3639,996,984,177300,17222
133,78,55,650,151900,17223
983,888,95,689,250000,17224
7596,5947,1649,1058,209000,17225
411,323,88,648,174100,17228
569,473,96,619,152200,17229
2303,1668,635,663,150800,17233
335,177,158,1325,141300,17235
3101,2440,661,890,176600,17236
747,535,212,1112,149700,17237
632,498,134,725,169800,17238
63,56,7,-,183300,17239
1442,1172,270,980,200700,17240
4629,3685,944,861,176900,17241
512,378,134,608,142000,17243
840,689,151,1057,172000,17244
155,139,16,-,-,17246
195,41,154,1364,203400,17247
132,126,6,-,88800,17249
33,0,33,-,-,17250
32,18,14,-,118800,17251
1330,1068,262,704,170800,17252
150,125,25,729,91000,17253
36,36,0,-,-,17254
469,396,73,721,141700,17255
56,56,0,-,-,17256
11708,7580,4128,888,174000,17257
442,365,77,580,153100,17260
0,0,0,-,-,17261
543,326,217,555,193700,17262
233,168,65,-,216100,17263
946,752,194,612,142600,17264
269,230,39,820,155700,17265
185,128,57,727,173200,17266
1123,924,199,721,199800,17267
11652,7892,3760,908,180300,17268
28,28,0,-,-,17270
101,94,7,-,184600,17271
163,129,34,-,16500,17272
1571,1415,156,1086,198300,17301
1062,745,317,753,205100,17302
1128,810,318,1008,206900,17304
97,82,15,1292,166100,17306
2409,1880,529,817,195200,17307
901,666,235,749,193100,17309
104,77,27,781,145800,17311
4624,2740,1884,950,165700,17313
2124,1757,367,810,214100,17314
10799,9308,1491,981,163400,17315
3153,2803,350,942,229600,17316
205,171,34,920,142700,17317
126,66,60,1100,125900,17318
4448,3935,513,931,170000,17319
3086,2750,336,1022,236200,17320
883,785,98,988,220700,17321
2340,2185,155,1101,201000,17322
1598,1288,310,741,170200,17324
10853,7853,3000,881,233000,17325
3185,2284,901,840,248600,17327
887,806,81,1048,260200,17329
21175,15620,5555,937,186700,17331
2934,2435,499,1002,224000,17339
4334,3497,837,1062,222200,17340
38,38,0,-,305000,17343
1487,817,670,914,165900,17344
3342,2436,906,973,156900,17345
2546,2250,296,1261,173100,17347
2670,2550,120,1634,279200,17349
5031,3739,1292,1031,173400,17350
578,511,67,1172,245600,17352
1278,1037,241,939,193200,17353
152,74,78,825,180600,17355
8650,6318,2332,876,184100,17356
2585,2282,303,933,226700,17360
2594,1914,680,901,245600,17361
5034,4134,900,1011,206400,17362
3333,2886,447,722,251000,17363
1434,1164,270,1017,166600,17364
949,833,116,802,216200,17365
2259,1932,327,1075,154300,17366
2467,2037,430,817,153000,17368
2202,1975,227,898,164700,17370
100,89,11,975,154700,17371
1498,1204,294,953,221300,17372
6669,1921,4748,813,59900,17401
13767,10036,3731,1084,199000,17402
14768,9348,5420,932,160700,17403
14447,10242,4205,1006,137800,17404
8962,7293,1669,1115,170000,17406
988,833,155,1461,221500,17407
9584,6772,2812,1164,176500,17408
1861,1064,797,975,187800,17501
1042,949,93,-,177300,17502
401,283,118,1027,330400,17505
63,14,49,-,-,17507
106,99,7,-,220300,17508
1398,1037,361,939,243500,17509
7347,4444,2903,905,161800,17512
2017,1819,198,1089,244200,17516
5474,4413,1061,947,205300,17517
485,325,160,942,248300,17518
2352,1783,569,1080,258700,17519
1904,1599,305,1390,195900,17520
13413,8775,4638,937,205700,17522
1764,1404,360,1047,258000,17527
1357,937,420,945,331900,17529
1197,1030,167,932,264300,17532
720,449,271,1130,336200,17535
1065,902,163,647,284300,17536
2921,2408,513,822,212600,17538
3505,2215,1290,1096,234100,17540
17510,13210,4300,1125,247000,17543
8634,7139,1495,1030,203800,17545
3037,2304,733,887,181900,17547
246,164,82,989,208500,17550
4200,2394,1806,1206,199100,17551
8582,6116,2466,1101,207900,17552
2874,2166,708,890,219400,17554
2264,1796,468,1244,298500,17555
5350,3755,1595,1111,238600,17557
1939,1488,451,858,164900,17560
1434,1037,397,1050,294300,17562
1148,880,268,1095,244000,17563
789,726,63,986,244300,17565
4103,2914,1189,1183,237700,17566
2135,1908,227,1059,245400,17569
57,49,8,-,-,17570
1288,893,395,819,282600,17572
2,2,0,-,-,17576
2630,2200,430,884,215800,17578
2116,1642,474,1105,242300,17579
302,197,105,978,168200,17581
797,673,124,646,231200,17582
4032,2534,1498,1659,245300,17584
21439,15669,5770,1206,242300,17601
18712,10611,8101,1021,190400,17602
25687,15152,10535,1021,176400,17603
259,15,244,1450,-,17606
17885,9274,8611,792,139000,17701
4420,3223,1197,857,160900,17702
662,529,133,778,131500,17721
24,16,8,-,162500,17723
1905,1292,613,691,133300,17724
49,49,0,-,306300,17727
2015,1649,366,787,182600,17728
35,30,5,-,85000,17729
98,13,85,-,-,17730
95,87,8,-,403600,17731
2791,2140,651,750,164700,17737
17,13,4,-,225000,17739
4856,3776,1080,746,154700,17740
19,7,12,-,-,17742
1194,1019,175,700,162800,17744
7249,4357,2892,750,150800,17745
1088,842,246,793,171500,17747
84,71,13,541,54200,17748
114,82,32,733,173100,17749
86,51,35,2150,120700,17750
2744,2280,464,746,161400,17751
1690,1297,393,786,144800,17752
4971,4007,964,882,213900,17754
4279,3468,811,833,173100,17756
397,375,22,956,167400,17758
232,218,14,-,100000,17760
238,211,27,817,150800,17762
128,88,40,850,-,17763
1102,727,375,556,63800,17764
428,341,87,850,168100,17765
23,5,18,717,-,17767
164,150,14,-,155800,17768
1289,1154,135,705,165800,17771
1043,907,136,628,195500,17772
572,491,81,744,183500,17774
119,109,10,-,168300,17776
2884,2184,700,678,159700,17777
62,51,11,425,114600,17778
88,20,68,-,-,17779
6878,4104,2774,673,121200,17801
652,538,114,804,184700,17810
613,404,209,657,150400,17812
753,584,169,775,155800,17813
1830,1520,310,802,164900,17814
11612,6895,4717,800,169400,17815
2221,1721,500,813,163400,17820
7638,5316,2322,747,187000,17821
0,0,0,-,-,17822
490,411,79,900,179600,17823
1641,1501,140,377,222400,17824
315,271,44,725,136000,17827
96,85,11,775,131300,17829
821,691,130,646,153600,17830
310,260,50,1080,78000,17832
1510,1064,446,719,77300,17834
96,42,54,885,158900,17835
79,48,31,719,212500,17836
6758,4373,2385,757,212000,17837
239,222,17,-,37300,17840
1722,1398,324,736,137500,17841
3382,2689,693,739,162400,17842
3806,2813,993,783,190800,17844
639,497,142,697,167000,17845
1543,1202,341,658,168600,17846
4892,3120,1772,736,149800,17847
298,230,68,-,43000,17850
3638,2468,1170,668,49600,17851
1171,922,249,682,183200,17853
340,277,63,954,165200,17855
1385,1148,237,746,172000,17856
3149,2404,745,780,148800,17857
1130,984,146,767,174400,17859
916,899,17,-,170600,17860
79,74,5,-,150000,17861
130,58,72,660,114500,17862
695,522,173,723,214800,17864
22,13,9,-,137500,17865
3587,2651,936,618,64800,17866
66,62,4,-,167500,17867
545,489,56,800,174700,17868
5595,3872,1723,804,192600,17870
4281,2710,1571,587,68800,17872
725,473,252,647,161500,17876
562,489,73,713,171800,17878
42,5,37,854,-,17880
596,482,114,635,80400,17881
84,30,54,812,128100,17884
96,93,3,-,157000,17885
470,143,327,861,141400,17886
256,256,0,-,126600,17887
173,167,6,-,75700,17888
893,760,133,850,255200,17889
9912,6931,2981,717,95000,17901
145,139,6,850,85800,17920
2667,2101,566,698,101700,17921
1948,1834,114,861,192600,17922
152,120,32,507,81300,17923
121,114,7,-,83000,17925
575,401,174,784,112300,17929
167,96,71,692,82100,17930
2010,1646,364,751,90800,17931
46,29,17,-,-,17933
132,122,10,-,23500,17934
700,520,180,659,33200,17935
378,324,54,633,96400,17936
1056,820,236,748,156000,17938
288,235,53,638,177200,17941
64,46,18,-,137500,17943
67,61,6,-,107700,17944
71,64,7,-,146900,17945
47,24,23,-,-,17946
1845,1075,770,851,31000,17948
100,63,37,-,35500,17949
171,171,0,-,132900,17951
102,95,7,-,62500,17952
171,141,30,658,65400,17953
2109,1254,855,568,57200,17954
122,122,0,-,113100,17957
587,463,124,594,58600,17959
1795,1504,291,813,195500,17960
2544,1974,570,741,165600,17961
3765,3051,714,763,160000,17963
288,239,49,463,159900,17964
869,718,151,566,82200,17965
940,821,119,617,150500,17967
77,54,23,800,131300,17968
1421,1086,335,719,64700,17970
4874,3443,1431,648,125200,17972
123,100,23,-,166100,17974
2747,2075,672,565,40400,17976
136,85,51,682,115400,17978
66,66,0,-,117900,17979
1214,990,224,792,100700,17980
1066,846,220,680,75700,17981
232,207,25,1054,83500,17982
593,361,232,752,120200,17983
517,457,60,945,157500,17985
1983,1760,223,1341,216500,18011
7113,5156,1957,984,209800,18013
4326,3633,693,1088,217100,18014
11003,5602,5401,998,169200,18015
0,0,0,-,-,18016
15788,10687,5101,1257,237800,18017
13297,6961,6336,1075,169800,18018
7811,6485,1326,1482,272600,18020
313,155,158,868,136900,18030
4244,2824,1420,1586,295900,18031
3913,2822,1091,940,169300,18032
3159,2751,408,1626,342100,18034
7,7,0,-,-,18035
5673,5035,638,903,321200,18036
3185,2561,624,1057,197900,18037
1391,1368,23,-,165400,18038
6449,5859,590,1213,276100,18040
2088,1626,462,965,258400,18041
15200,8393,6807,1064,154300,18042
10153,8256,1897,1348,244000,18045
53,53,0,-,-,18046
7056,5198,1858,1115,227500,18049
1318,1148,170,914,326700,18051
11505,7346,4159,1168,192000,18052
851,677,174,1188,238500,18053
1697,1354,343,977,315400,18054
4620,3415,1205,1154,231800,18055
390,307,83,-,31400,18056
3454,2959,495,1322,180700,18058
381,370,11,-,311700,18059
10426,8242,2184,1520,276400,18062
196,153,43,-,165200,18063
9698,7456,2242,988,273500,18064
2321,2058,263,888,254500,18066
7321,5507,1814,1095,195600,18067
0,0,0,-,-,18068
3168,2702,466,1230,314800,18069
242,215,27,-,214200,18070
4368,2914,1454,820,159700,18071
2522,1810,712,1236,182000,18072
4123,3755,368,1153,267800,18073
2298,2194,104,1339,290300,18074
1187,760,427,1172,188900,18076
935,775,160,1327,344700,18077
3076,2558,518,1070,291400,18078
169,159,10,-,96900,18079
4662,3686,976,854,186400,18080
91,46,45,-,221900,18081
136,98,38,1075,181300,18083
439,349,90,1038,186200,18085
329,290,39,-,170100,18086
270,100,170,1187,181400,18087
3196,2730,466,1087,196200,18088
2518,1907,611,938,223200,18091
1359,1171,188,1164,321100,18092
1788,136,1652,886,168000,18101
16594,4970,11624,978,102600,18102
18309,11522,6787,1111,174100,18103
16419,11374,5045,1342,240800,18104
0,0,0,-,-,18105
2894,2231,663,1416,281300,18106
6609,3140,3469,1032,136900,18109
0,0,0,-,-,18195
10607,5383,5224,831,101400,18201
4592,3061,1531,741,125500,18202
2947,2413,534,1314,161600,18210
471,412,59,1023,206000,18211
49,35,14,-,164100,18212
787,746,41,645,148100,18214
459,334,125,900,90300,18216
910,719,191,780,50000,18218
597,431,166,785,175300,18219
112,106,6,-,44300,18220
277,171,106,-,158800,18221
3658,3464,194,922,186300,18222
76,76,0,-,-,18223
2594,1926,668,702,86200,18224
0,0,0,-,-,18225
3793,3188,605,815,173100,18229
44,44,0,-,69400,18230
195,150,45,740,92300,18231
1572,896,676,800,44400,18232
302,147,155,-,201600,18234
7794,6069,1725,849,164000,18235
1458,1000,458,768,78000,18237
103,103,0,-,-,18239
1557,1016,541,753,102000,18240
341,219,122,731,94700,18241
207,182,25,-,109400,18242
111,88,23,870,87500,18244
152,122,30,-,107900,18245
110,47,63,-,107000,18246
223,163,60,750,108100,18248
1447,1251,196,847,215900,18249
1237,888,349,906,75600,18250
13,0,13,-,-,18251
4807,3233,1574,685,110400,18252
402,276,126,968,84500,18254
1713,1367,346,705,127500,18255
144,104,40,867,95000,18256
9995,6872,3123,1178,184000,18301
5871,5076,795,1297,152600,18302
569,418,151,1217,166900,18321
1041,816,225,926,216400,18322
46,46,0,-,-,18323
3719,3033,686,1408,132900,18324
991,786,205,1021,253600,18325
1247,924,323,730,176300,18326
294,158,136,1118,183000,18327
2982,2661,321,1072,159500,18328
2942,2576,366,1297,170200,18330
217,181,36,-,138400,18331
1070,948,122,1350,184900,18332
215,215,0,-,163100,18333
1604,1418,186,1449,161000,18334
262,213,49,1750,206600,18335
1712,1190,522,944,191600,18336
5459,4626,833,1170,221400,18337
53,53,0,-,333800,18340
234,149,85,-,120000,18342
1570,1262,308,1268,226300,18343
1334,842,492,1040,158000,18344
936,839,97,1063,146800,18346
1554,1226,328,1128,138700,18347
123,123,0,-,-,18349
468,437,31,897,185000,18350
201,75,126,1042,177100,18351
409,409,0,-,255100,18352
4892,4140,752,1133,199900,18353
452,381,71,1369,177700,18354
438,204,234,1706,220200,18355
28,28,0,-,-,18356
54,37,17,-,-,18357
10263,6913,3350,1098,217200,18360
617,470,147,777,232700,18370
263,228,35,-,190900,18371
1029,857,172,884,181800,18372
2786,2025,761,791,173800,18403
1007,925,82,725,169200,18405
6034,3944,2090,716,120600,18407
8397,6875,1522,902,235100,18411
104,49,55,592,206300,18413
2259,1899,360,978,223200,18414
752,684,68,869,311600,18415
375,308,67,603,205400,18417
1666,1324,342,760,169000,18419
13,7,6,-,-,18420
1851,1389,462,680,138800,18421
2036,1835,201,878,152100,18424
455,398,57,1089,146500,18425
1692,1408,284,1078,178600,18426
27,27,0,-,-,18427
4992,4104,888,1113,201300,18428
0,0,0,-,-,18430
4976,3492,1484,772,181800,18431
2782,2194,588,804,164700,18433
1579,1114,465,940,136300,18434
361,318,43,-,230400,18435
4827,4272,555,840,174700,18436
90,71,19,-,198800,18437
574,560,14,-,254500,18438
190,164,26,1047,185000,18439
154,138,16,-,366700,18441
127,99,28,1056,208300,18443
5398,4481,917,858,222400,18444
926,751,175,812,206200,18445
1329,1076,253,696,162700,18446
4435,3077,1358,851,154800,18447
321,295,26,-,232100,18451
2482,1842,640,916,154200,18452
425,362,63,1088,233300,18453
26,19,7,-,336700,18454
57,45,12,-,-,18455
198,161,37,886,143600,18456
44,44,0,-,221400,18457
1227,1133,94,1105,249400,18458
16,16,0,-,-,18459
73,67,6,-,-,18460
146,135,11,836,133900,18461
163,155,8,-,129700,18462
87,84,3,-,225000,18463
530,476,54,1188,217700,18464
497,416,81,855,179200,18465
5796,4183,1613,1396,119900,18466
124,115,9,-,338500,18469
846,767,79,768,211000,18470
243,239,4,-,356300,18471
1495,1057,438,775,199900,18472
197,169,28,-,72500,18473
581,57,524,789,101400,18503
8806,4926,3880,794,109200,18504
8918,4662,4256,775,104400,18505
2077,1476,601,817,175300,18507
5299,2359,2940,821,87200,18508
5178,2432,2746,827,136300,18509
5048,2009,3039,807,139600,18510
5215,3468,1747,777,148200,18512
2121,1468,653,792,133900,18517
3636,2381,1255,809,145600,18518
2149,1288,861,750,124500,18519
123,115,8,1500,269700,18602
8527,6191,2336,648,124400,18603
1551,1441,110,953,169700,18610
6340,4938,1402,1011,206400,18612
1032,777,255,638,161300,18614
780,678,102,730,194900,18615
323,264,59,582,176200,18616
820,490,330,695,69800,18617
1516,1259,257,1190,192000,18618
107,86,21,-,133300,18619
1951,1769,182,942,161700,18621
79,76,3,-,-,18622
1058,761,297,801,149500,18623
262,254,8,-,289300,18624
211,103,108,738,216400,18625
195,178,17,616,227100,18626
102,95,7,-,103500,18628
778,597,181,935,183000,18629
1208,923,285,757,204700,18630
466,321,145,947,149500,18631
265,196,69,806,95800,18632
5478,3516,1962,674,83100,18634
1509,1206,303,786,161700,18635
581,458,123,700,152600,18636
7350,4252,3098,728,119300,18640
3034,2164,870,782,117300,18641
1813,1426,387,635,119600,18642
5657,4180,1477,761,135100,18643
3590,2555,1035,771,152500,18644
4000,2396,1604,710,77700,18651
68,68,0,-,171700,18653
2350,1972,378,790,173000,18655
1008,915,93,777,169300,18656
4698,3495,1203,829,173300,18657
1460,1300,160,740,156200,18660
2129,1801,328,1023,147400,18661
950,116,834,664,177300,18701
16082,9146,6936,783,90000,18702
13214,7954,5260,802,122200,18704
6102,4065,2037,794,95700,18705
6842,4420,2422,664,91200,18706
5824,5230,594,691,213900,18707
3499,3032,467,863,183400,18708
1474,816,658,582,92200,18709
3477,2564,913,770,201600,18801
2701,1726,975,721,137400,18810
687,616,71,905,206800,18812
77,69,8,-,116100,18814
48,39,9,-,144600,18816
98,65,33,954,169700,18817
566,435,131,579,177700,18818
513,319,194,789,147300,18821
1404,1007,397,705,120300,18822
89,62,27,-,125000,18823
618,528,90,903,198400,18824
31,26,5,-,244400,18825
549,465,84,729,208000,18826
153,119,34,806,204600,18828
296,256,40,772,181400,18829
267,209,58,756,163100,18830
430,326,104,661,132200,18831
805,653,152,794,122200,18832
832,688,144,814,164700,18833
1351,995,356,846,187300,18834
1135,948,187,848,161600,18837
4477,2730,1747,802,136500,18840
88,83,5,-,124200,18842
97,80,17,-,125000,18843
749,657,92,834,198700,18844
158,135,23,1313,189800,18845
377,347,30,925,190700,18846
2387,1796,591,769,130200,18847
3742,2612,1130,750,152200,18848
860,681,179,751,140300,18850
271,233,38,1047,139400,18851
1736,1362,374,761,179000,18853
674,554,120,983,173900,18854
10486,7421,3065,1479,438400,18901
7686,7011,675,1709,503700,18902
5,5,0,-,-,18912
16,16,0,-,-,18913
8207,6998,1209,1492,373200,18914
256,175,81,-,331800,18915
960,546,414,1142,270300,18917
127,91,36,-,526000,18920
405,389,16,-,444300,18923
2412,2232,180,2574,485900,18925
3408,3260,148,1727,497400,18929
990,822,168,1319,417000,18930
135,135,0,-,367600,18932
20,20,0,-,-,18935
0,0,0,-,-,18936
6044,5218,826,1584,574800,18938
11515,9829,1686,1699,488400,18940
1163,988,175,1025,423400,18942
9601,7778,1823,1166,322200,18944
2469,2335,134,1355,453900,18947
75,75,0,-,535200,18950
13398,10957,2441,1161,272700,18951
4360,4289,71,1650,394000,18954
523,374,149,908,228200,18955
4649,3611,1038,1192,309000,18960
149,114,35,1175,305200,18962
5283,3913,1370,1091,282000,18964
13591,11680,1911,1445,364500,18966
6061,4907,1154,1114,293900,18969
302,219,83,948,229100,18970
1425,1297,128,1353,413500,18972
17299,13091,4208,1416,332900,18974
7354,6068,1286,1293,421000,18976
1745,1609,136,1250,643900,18977
199,145,54,1115,520800,18980
6132,5012,1120,1144,269800,19001
11620,9006,2614,1244,431700,19002
5665,3776,1889,1438,340800,19003
3869,3148,721,1528,546900,19004
7988,6070,1918,1193,416000,19006
8719,5057,3662,955,205200,19007
6901,5865,1036,1344,371800,19008
256,166,90,1313,566000,19009
7378,4684,2694,1700,646700,19010
2266,1942,324,1061,241100,19012
12664,4584,8080,875,71300,19013
7688,6679,1009,1158,243500,19014
6625,5011,1614,1046,173300,19015
60,42,18,-,604200,19017
9575,5982,3593,1108,161500,19018
21379,12007,9372,1228,282800,19020
3797,2782,1015,1095,208100,19021
1493,653,840,1007,105900,19022
7805,4259,3546,1113,92400,19023
2344,1883,461,2369,456300,19025
11854,7619,4235,1095,184400,19026
8041,4816,3225,1146,283100,19027
1567,988,579,1076,137900,19029
4546,3504,1042,1096,265100,19030
1648,1327,321,1393,387800,19031
2289,1501,788,1203,112900,19032
3007,2265,742,1297,213800,19033
2161,1625,536,1185,513000,19034
1443,1169,274,1497,1021900,19035
4958,3623,1335,1077,141100,19036
11337,9666,1671,1162,306500,19038
7763,5593,2170,1304,298900,19040
2426,1514,912,1834,742100,19041
1039,761,278,962,226900,19043
6480,3672,2808,1289,287000,19044
7312,5153,2159,1328,365200,19046
12297,8962,3335,1369,358200,19047
11225,6671,4554,981,149400,19050
9936,8391,1545,1232,301800,19053
6279,4821,1458,1186,245500,19054
4863,3911,952,1199,211900,19055
5808,4223,1585,1243,279700,19056
5979,4475,1504,1162,227100,19057
3660,3605,55,-,432400,19060
8073,5277,2796,1043,195000,19061
14697,10131,4566,1355,390300,19063
8675,7950,725,1317,323100,19064
1661,1579,82,2188,658900,19066
20311,16432,3879,1289,391200,19067
2793,2033,760,1037,236700,19070
4121,2974,1147,1580,639800,19072
7920,6055,1865,1791,442800,19073
2265,1659,606,1007,172800,19074
2843,2473,370,1046,337100,19075
2718,1745,973,966,197500,19076
4528,3355,1173,998,194600,19078
3452,2353,1099,1033,113500,19079
3599,2998,601,1135,290900,19081
15251,7241,8010,973,115300,19082
13002,11561,1441,1174,338000,19083
1852,1726,126,"3,500+",836700,19085
4369,3804,565,1288,357200,19086
11749,8846,2903,1695,576700,19087
7006,5018,1988,1288,267800,19090
1696,1140,556,922,173000,19094
3123,2015,1108,1488,348400,19095
5549,4192,1357,1687,559700,19096
3365,859,2506,2114,506800,19102
15765,4567,11198,1770,524200,19103
16508,3460,13048,1008,161000,19104
7625,3659,3966,1830,522400,19106
7823,1646,6177,1384,431700,19107
0,0,0,-,-,19109
24355,14266,10089,1038,185700,19111
0,0,0,-,-,19112
45,45,0,-,190600,19113
13032,8521,4511,1170,209100,19114
14391,8646,5745,1032,260200,19115
12850,7388,5462,1055,257100,19116
4651,2296,2355,1544,492300,19118
11846,7737,4109,1061,280000,19119
24531,14742,9789,984,106400,19120
12162,4095,8067,906,120900,19121
6799,2844,3955,936,232300,19122
8565,2531,6034,1424,427800,19123
22837,13535,9302,899,105100,19124
10948,6627,4321,1316,265500,19125
5854,3395,2459,951,158400,19126
2678,1039,1639,1588,254700,19127
16980,9545,7435,1333,259500,19128
4901,2377,2524,1326,243400,19129
14431,5631,8800,1528,404100,19130
17503,8689,8814,1103,123800,19131
13712,6791,6921,849,58600,19132
9012,3782,5230,793,59300,19133
21273,11386,9887,977,91000,19134
12940,7959,4981,1014,122900,19135
12417,7688,4729,913,158500,19136
3105,2479,626,1118,157500,19137
11975,8158,3817,1024,128600,19138
18184,7517,10667,921,88600,19139
19693,9689,10004,880,68400,19140
13077,6660,6417,871,105500,19141
9869,4851,5018,1041,83000,19142
24632,12019,12613,980,107000,19143
18574,7042,11532,911,150600,19144
17977,10698,7279,1120,207800,19145
17302,9101,8201,1292,373200,19146
18239,10032,8207,1315,416000,19147
19493,12781,6712,1178,220200,19148
18513,11156,7357,1228,141800,19149
9662,7277,2385,1100,173000,19150
12019,8033,3986,903,141000,19151
13275,8064,5211,997,204700,19152
5382,2932,2450,1209,150700,19153
12461,9655,2806,1227,211500,19154
2579,2068,511,1426,402100,19301
948,694,254,1113,237400,19310
3115,2585,530,1224,398500,19311
4174,3635,539,1486,676200,19312
118,95,23,-,221900,19316
3659,2963,696,1727,538400,19317
51,51,0,-,631300,19319
20237,14720,5517,1261,247800,19320
2052,1809,243,1014,344400,19330
2787,1708,1079,1660,642800,19333
17913,14394,3519,1307,366000,19335
7825,4457,3368,1659,396800,19341
8064,5467,2597,1880,457000,19342
2635,2250,385,1526,425700,19343
4433,3241,1192,1148,264000,19344
0,0,0,-,-,19345
8940,6292,2648,1081,402700,19348
4136,3712,424,1184,406900,19350
3191,2977,214,991,360700,19352
10090,7645,2445,1687,520200,19355
197,38,159,1145,228600,19358
2101,1763,338,929,230900,19362
5610,4016,1594,1089,272600,19363
2665,1995,670,1000,220000,19365
24,24,0,-,-,19367
698,444,254,1738,267400,19372
850,712,138,1773,592000,19373
377,299,78,784,313200,19374
61,61,0,-,-,19375
20999,14701,6298,1461,416600,19380
20429,14539,5890,1413,440800,19382
0,0,0,-,-,19383
4860,3820,1040,886,314300,19390
16282,7334,8948,1140,176000,19401
18879,13567,5312,1413,288200,19403
2034,930,1104,1221,220800,19405
11438,6407,5031,1592,324200,19406
7366,5899,1467,1829,465500,19422
5402,4965,437,2122,494700,19425
12839,11427,1412,1523,381100,19426
8479,4464,4015,1585,352700,19428
13,13,0,-,-,19435
429,154,275,3119,-,19436
407,407,0,-,713500,19437
9456,7145,2311,1517,356400,19438
7224,4833,2391,1161,306500,19440
0,0,0,-,-,19442
4466,3140,1326,1704,415700,19444
22647,14895,7752,1360,340500,19446
801,511,290,1397,228000,19453
10981,8595,2386,1363,336300,19454
276,226,50,-,593900,19456
52,52,0,-,206300,19457
16443,11813,4630,1259,347800,19460
6055,4720,1335,1552,357300,19462
18589,11865,6724,1030,176500,19464
6833,5425,1408,1079,290800,19465
10002,7363,2639,1430,271200,19468
5,0,5,-,-,19472
6556,5652,904,1247,331100,19473
197,170,27,-,226700,19474
4472,3209,1263,857,281500,19475
0,0,0,-,-,19477
340,21,319,-,-,19492
411,291,120,890,190300,19501
567,366,201,938,180000,19503
1790,1632,158,969,276400,19504
1521,1159,362,1153,231300,19505
2674,2270,404,869,234300,19506
1029,891,138,1102,205000,19507
6257,5146,1111,896,197200,19508
3376,2940,436,1177,214800,19510
50,50,0,-,203700,19511
6899,5224,1675,928,204900,19512
5504,4579,925,1315,262200,19518
69,69,0,-,-,19519
2375,2012,363,886,315300,19520
5392,4557,835,880,205300,19522
62,25,37,-,-,19523
5692,5251,441,1042,319500,19525
4793,3477,1316,936,159600,19526
1212,1061,151,1031,254600,19529
5012,3252,1760,956,214100,19530
2565,2186,379,921,207600,19533
643,534,109,1042,236800,19534
6,6,0,-,-,19535
261,190,71,908,135000,19536
16,7,9,-,-,19538
1887,1498,389,709,195000,19539
4369,3514,855,849,249200,19540
1727,1507,220,935,234000,19541
45,45,0,-,251100,19542
1920,1602,318,1026,273800,19543
62,62,0,-,121600,19544
341,247,94,839,118300,19545
1910,1636,274,1158,251100,19547
139,92,47,1060,95000,19549
152,110,42,-,152100,19550
1671,1407,264,886,182500,19551
171,91,80,862,166200,19554
1371,1029,342,902,169800,19555
106,71,35,863,119400,19559
3406,2782,624,1146,145500,19560
1111,638,473,1146,159600,19562
48,18,30,-,-,19564
3777,3101,676,1023,200000,19565
1991,1516,475,1037,183600,19567
11780,4415,7365,787,79400,19601
6120,1997,4123,752,56600,19602
8835,4055,4780,878,88200,19604
7158,6008,1150,1131,166300,19605
13604,10511,3093,1070,180500,19606
9190,6120,3070,1093,163900,19607
8611,6633,1978,1375,246000,19608
3928,3284,644,1261,164500,19609
6555,4722,1833,1366,258900,19610
3960,1853,2107,857,124200,19611
15070,11714,3356,1486,274400,19701
20009,12146,7863,1340,264700,19702
6250,3271,2979,1127,216300,19703
654,482,172,1145,188600,19706
5937,5282,655,1842,444400,19707
15898,13753,2145,1273,344800,19709
0,0,0,-,-,19710
19607,12610,6997,1237,298100,19711
11688,7127,4561,1142,214700,19713
0,0,0,-,-,19716
0,0,0,-,-,19717
21859,14985,6874,1124,197700,19720
155,131,24,1196,289000,19730
91,81,10,-,185100,19731
24,24,0,-,-,19732
51,51,0,-,211400,19733
4067,3917,150,1245,342800,19734
8,0,8,-,-,19735
24,0,24,-,-,19736
7031,1970,5061,886,147900,19801
10328,4876,5452,1032,162800,19802
8386,7242,1144,1355,377300,19803
7071,5175,1896,1129,199200,19804
15143,8107,7036,1089,179000,19805
5386,2655,2731,1121,316400,19806
3216,2334,882,1318,745600,19807
14680,11408,3272,1212,261800,19808
6062,4107,1955,1159,251700,19809
10048,8083,1965,1219,343600,19810
14492,8060,6432,1206,195900,19901
0,0,0,-,-,19902
14739,9042,5697,1109,228200,19904
1612,1581,31,1264,610500,19930
181,172,9,-,191300,19931
4141,3245,896,803,213200,19933
4676,3792,884,1261,241200,19934
98,50,48,920,187500,19936
2765,2240,525,1293,249900,19938
2852,2636,216,1054,287600,19939
2301,1807,494,795,204300,19940
1222,844,378,962,180800,19941
5221,4357,864,961,218000,19943
325,299,26,542,825000,19944
2839,2508,331,1177,274100,19945
2097,1640,457,1162,195800,19946
6659,4409,2250,1084,225000,19947
2926,2002,924,1113,224100,19950
769,757,12,-,298000,19951
3907,2714,1193,960,211400,19952
1813,1497,316,1134,213300,19953
532,386,146,994,209400,19954
30,15,15,-,110400,19955
5427,3617,1810,784,188500,19956
12824,10856,1968,1298,368300,19958
2319,2098,221,1026,201300,19960
4126,3505,621,1079,268100,19962
8479,5455,3024,1002,230000,19963
588,570,18,-,281000,19964
13093,11093,2000,1096,205500,19966
496,437,59,2193,331700,19967
4975,4220,755,1081,319900,19968
3927,3514,413,1293,356500,19970
7245,6346,899,1290,411200,19971
9612,7159,2453,866,201700,19973
4199,3546,653,1145,343500,19975
8406,6658,1748,1159,239400,19977
297,257,40,1193,200900,19979
20608,7450,13158,2212,727100,20001
28881,11250,17631,1785,669300,20002
14196,6518,7678,2307,802100,20003
1323,559,764,2566,569600,20004
8038,2107,5931,1880,579900,20005
595,52,543,1749,-,20006
11969,6829,5140,1885,1057200,20007
15814,6006,9808,1960,771900,20008
27898,9639,18259,1946,661000,20009
13088,5124,7964,1634,698500,20010
24221,12826,11395,1349,590600,20011
6367,3824,2543,1367,668300,20012
6109,4505,1604,1671,1015800,20015
13149,9038,4111,1913,1004100,20016
7545,4664,2881,1584,561000,20017
8133,4816,3317,1028,538600,20018
23438,8862,14576,1034,325100,20019
20918,7149,13769,1117,334800,20020
8345,3117,5228,1671,432700,20024
17033,3989,13044,1129,319800,20032
3904,1735,2169,1989,403800,20036
6383,2570,3813,2185,713900,20037
0,0,0,-,-,20045
0,0,0,-,-,20052
0,0,0,-,-,20053
0,0,0,-,-,20057
0,0,0,-,-,20064
8281,7307,974,2239,579300,20105
1838,1621,217,1436,369100,20106
13590,5721,7869,1676,301300,20109
14818,10481,4337,1573,347000,20110
10155,6546,3609,1636,357500,20111
8316,7973,343,2192,472600,20112
2638,1740,898,1441,491300,20115
1108,794,314,1189,678400,20117
2,0,2,-,-,20118
1309,1106,203,1333,459900,20119
13731,10098,3633,1855,488600,20120
9233,6127,3106,1895,387600,20121
4802,4420,382,1987,686200,20124
183,157,26,-,1164800,20129
116,87,29,1845,434600,20130
5807,5167,640,1644,552700,20132
1454,1225,229,1509,393100,20135
8954,7841,1113,2079,451200,20136
667,656,11,-,512600,20137
121,48,73,-,381800,20139
2335,2086,249,1141,476500,20141
213,199,14,-,645600,20143
561,489,72,1107,472700,20144
22845,15974,6871,1969,531900,20147
16956,13757,3199,2145,620800,20148
6617,5265,1352,1883,527900,20151
11076,9374,1702,2400,567000,20152
11778,9955,1823,2286,481900,20155
1558,1266,292,-,538900,20158
12121,9169,2952,1902,398400,20164
12040,9661,2379,1997,534500,20165
4336,2299,2037,1959,435600,20166
8215,7578,637,2325,560000,20169
13406,9389,4017,1879,513900,20170
17278,10541,6737,1919,636300,20171
12342,9352,2990,1640,530300,20175
17048,12742,4306,1744,537100,20176
2589,2282,307,1782,522000,20180
2745,2372,373,1414,525800,20181
326,225,101,-,-,20184
5767,3687,2080,1408,399700,20186
5970,5277,693,1582,465500,20187
9594,4648,4946,1968,483300,20190
11695,8240,3455,1742,508000,20191
5391,3907,1484,2006,628000,20194
1024,916,108,-,844300,20197
844,585,259,1036,446300,20198
0,0,0,-,-,20202
0,0,0,-,-,20204
0,0,0,-,-,20228
0,0,0,-,-,20230
0,0,0,-,-,20240
0,0,0,-,-,20245
0,0,0,-,-,20260
0,0,0,-,-,20307
352,19,333,2073,-,20317
0,0,0,-,-,20319
0,0,0,-,-,20373
0,0,0,-,-,20390
0,0,0,-,-,20405
0,0,0,-,-,20418
0,0,0,-,-,20427
0,0,0,-,-,20506
0,0,0,-,-,20510
0,0,0,-,-,20520
0,0,0,-,-,20535
0,0,0,-,-,20540
0,0,0,-,-,20551
0,0,0,-,-,20553
0,0,0,-,-,20560
0,0,0,-,-,20565
0,0,0,-,-,20566
0,0,0,-,-,20593
9317,7215,2102,1785,311200,20601
9987,6354,3633,1631,263300,20602
11248,8800,2448,1769,349200,20603
135,135,0,-,416700,20606
3739,3645,94,1580,397400,20607
264,246,18,1636,297900,20608
417,376,41,-,368600,20609
512,388,124,877,342700,20611
118,118,0,-,237800,20612
4471,4116,355,1875,386200,20613
219,219,0,-,577800,20615
2388,2025,363,1848,282500,20616
255,234,21,-,441700,20617
215,160,55,1257,402900,20618
5154,3122,2032,1647,300300,20619
592,415,177,1211,249800,20620
596,570,26,-,415600,20621
1789,1543,246,1122,356000,20622
795,768,27,-,322300,20623
434,366,68,-,377500,20624
415,358,57,-,199700,20625
138,138,0,-,456300,20626
158,158,0,-,369000,20628
208,136,72,-,375000,20629
105,38,67,-,534100,20630
88,77,11,-,299000,20632
2657,1624,1033,1430,261300,20634
3854,3332,522,1323,410300,20636
1830,1621,209,2399,404800,20637
4694,4384,310,1246,447500,20639
4180,2987,1193,1515,263700,20640
266,247,19,-,364600,20645
7757,6343,1414,1421,362400,20646
4996,3669,1327,1210,391600,20650
10645,5673,4972,1403,265500,20653
6990,5943,1047,1418,254300,20657
362,278,84,1800,252100,20658
7956,6994,962,1263,311900,20659
0,0,0,-,-,20660
933,828,105,1229,285700,20662
1204,851,353,1540,362000,20664
295,212,83,-,265000,20667
359,0,359,1818,-,20670
365,235,130,1330,298900,20674
699,666,33,-,324900,20675
1322,1161,161,1784,360200,20676
778,709,69,1159,456000,20677
4595,3570,1025,897,347400,20678
304,240,64,1145,384200,20680
331,258,73,-,316500,20684
2325,2168,157,1620,347400,20685
87,27,60,-,-,20686
228,172,56,-,428100,20687
836,460,376,2500,450000,20688
668,657,11,-,383200,20689
379,296,83,1387,378900,20690
295,295,0,-,405400,20692
306,281,25,-,405200,20693
3055,2224,831,1795,334200,20695
188,0,188,2114,-,20701
9868,5785,4083,1693,350500,20705
13492,8926,4566,1646,320000,20706
12033,6821,5212,1600,320900,20707
9584,3225,6359,1551,337100,20708
3709,692,3017,1415,273300,20710
2428,2302,126,996,342500,20711
4374,1072,3302,1234,396500,20712
2014,1462,552,1715,282500,20714
8949,8301,648,2242,343700,20715
8712,6229,2483,1819,318900,20716
7624,6999,625,2273,434600,20720
9944,8753,1191,2402,428000,20721
1786,1246,540,1525,287800,20722
11992,8457,3535,1746,422300,20723
6873,4514,2359,1842,328200,20724
4053,3216,837,1497,360300,20732
949,840,109,1627,334800,20733
12142,11003,1139,1816,322600,20735
3080,2884,196,1375,456800,20736
6204,3093,3111,1335,288300,20737
9789,4396,5393,1474,339600,20740
0,0,0,-,-,20742
14833,9984,4849,1316,238500,20743
18678,15252,3426,1609,340300,20744
10641,4409,6232,1354,252000,20745
11394,4372,7022,1487,242000,20746
15704,7861,7843,1371,262700,20747
14957,8237,6720,1347,277600,20748
838,759,79,1518,371200,20751
2304,1985,319,2171,467300,20754
2905,69,2836,2148,421600,20755
190,178,12,-,546900,20758
1565,1476,89,"3,500+",688300,20759
801,0,801,2356,-,20762
858,446,412,1472,360600,20763
1365,1224,141,2000,308000,20764
209,159,50,1395,657700,20765
1900,1753,147,2337,423600,20769
10309,4912,5397,1653,214000,20770
16403,14123,2280,1795,331500,20772
19052,14789,4263,1868,344700,20774
1181,1071,110,"3,500+",510900,20776
1120,1097,23,-,728100,20777
888,792,96,1919,592300,20778
421,393,28,-,460100,20779
3802,2184,1618,1396,351600,20781
11400,4883,6517,1546,347500,20782
12047,5084,6963,1422,318600,20783
9677,5789,3888,1524,272300,20784
14354,7068,7286,1496,282600,20785
4162,2813,1349,1673,324100,20794
109,100,9,2375,870700,20812
13171,7112,6059,1985,806800,20814
13048,8394,4654,1993,1012700,20815
6124,5048,1076,2302,962200,20816
13425,11149,2276,2366,919200,20817
780,752,28,-,1001100,20818
8458,7331,1127,2011,480300,20832
2408,2276,132,2142,633200,20833
2084,1761,323,1884,541800,20837
100,100,0,-,602900,20838
30,30,0,-,837000,20839
3474,3336,138,2553,611600,20841
570,433,137,1366,775000,20842
21275,11123,10152,2004,597200,20850
4980,3165,1815,1772,400500,20851
20626,8501,12125,1921,540900,20852
9733,8040,1693,1781,463300,20853
16497,14924,1573,2556,923600,20854
5487,4403,1084,2021,522200,20855
984,807,177,1602,-,20860
725,711,14,-,595500,20861
125,125,0,-,613300,20862
4606,3650,956,1875,357600,20866
149,134,15,-,644200,20868
5723,4931,792,2153,469100,20871
4371,3892,479,1299,395100,20872
21143,13826,7317,1724,329300,20874
9791,6510,3281,1833,422000,20876
12466,5412,7054,1642,391800,20877
22990,16348,6642,1834,567900,20878
8585,6195,2390,1764,352000,20879
235,216,19,-,443000,20880
4611,4517,94,1839,568600,20882
12109,8412,3697,1615,315300,20886
6900,5599,1301,1729,651200,20895
309,296,13,-,855300,20896
167,28,139,902,-,20899
12669,8854,3815,1655,459900,20901
17150,10934,6216,1850,417400,20902
7428,2804,4624,1567,358900,20903
19428,10723,8705,1692,415900,20904
5720,5055,665,1776,507200,20905
25190,16570,8620,1678,356200,20906
20346,6984,13362,1765,590500,20910
9327,3782,5545,1234,577800,20912
9793,6309,3484,1160,217800,21001
731,0,731,1810,-,21005
12299,10051,2248,1448,273400,21009
133,0,133,-,-,21010
7994,6796,1198,1907,444300,21012
1792,1666,126,955,458500,21013
14128,10880,3248,1271,333700,21014
10317,9147,1170,1434,344000,21015
2480,1581,899,1475,188800,21017
982,882,100,1655,379000,21028
3612,3325,287,2815,717700,21029
9855,4421,5434,1325,371000,21030
17,0,17,-,-,21031
2937,2544,393,1918,517300,21032
1252,1088,164,1033,265300,21034
2847,2662,185,3155,660100,21035
794,763,31,-,708900,21036
7914,6777,1137,1731,406100,21037
8965,6022,2943,1175,181600,21040
14474,12390,2084,1843,599800,21042
16881,11556,5325,1685,490900,21043
18621,11634,6987,1752,423300,21044
15493,10946,4547,1500,362700,21045
6070,3570,2500,1800,372500,21046
4449,4250,199,2218,420100,21047
3549,3281,268,991,368400,21048
6310,5681,629,1436,370900,21050
87,87,0,-,313600,21051
66,66,0,-,284100,21052
1144,1055,89,2080,406000,21053
4054,3441,613,1860,469600,21054
172,172,0,-,1789500,21056
1555,1336,219,860,488600,21057
14077,10198,3879,1358,271200,21060
21596,11934,9662,1388,262700,21061
157,140,17,-,345700,21071
5707,4818,889,869,291500,21074
12502,8311,4191,1793,363700,21075
7110,4719,2391,1988,387700,21076
117,107,10,-,343300,21077
7608,5762,1846,1045,291200,21078
222,204,18,-,412500,21082
2780,2457,323,1060,382000,21084
6380,5095,1285,1204,273200,21085
1984,1823,161,1618,421200,21087
3627,3075,552,1506,313200,21090
15293,11980,3313,1345,385900,21093
4245,3826,419,991,324100,21102
1964,1822,142,2274,568300,21104
0,0,0,-,-,21105
6505,5567,938,1684,446400,21108
1821,1735,86,2577,509400,21111
14449,8775,5674,1853,334100,21113
9397,7353,2044,1896,378300,21114
23125,12512,10613,1530,297900,21117
2202,2060,142,1707,481700,21120
22199,19293,2906,1738,349200,21122
5175,4295,880,1416,345600,21128
40,13,27,-,-,21130
2616,2526,90,1778,544200,21131
1007,992,15,-,412200,21132
11823,8264,3559,1259,251900,21133
13195,10255,2940,1277,306600,21136
1450,1414,36,2667,472200,21140
12100,9675,2425,1646,377000,21144
9556,8595,961,1375,558600,21146
2342,1678,664,1480,439000,21152
150,130,20,-,1300000,21153
2287,2142,145,985,354100,21154
896,663,233,1479,379400,21155
147,147,0,-,347700,21156
14075,10473,3602,1031,329300,21157
7880,6076,1804,1413,319000,21158
897,719,178,1719,318200,21160
2001,1865,136,1196,348400,21161
1334,1221,113,955,395900,21162
2439,1930,509,1204,473100,21163
9731,1369,8362,1178,279400,21201
9865,2111,7754,1194,251900,21202
7773,3866,3907,1661,441300,21204
5251,1848,3403,884,49400,21205
20100,11310,8790,996,161100,21206
19066,12004,7062,1164,199800,21207
14789,9948,4841,1365,252700,21208
11359,6984,4375,1369,340100,21209
5130,3212,1918,1314,458300,21210
7782,4282,3500,1296,234700,21211
12243,8370,3873,1211,298000,21212
11129,6403,4726,1137,103400,21213
7937,6123,1814,1031,191600,21214
21569,10968,10601,965,134900,21215
11103,5255,5848,988,105600,21216
14263,4739,9524,904,155500,21217
18308,8822,9486,1088,172700,21218
3468,2797,671,1314,309300,21219
15266,10101,5165,1288,220700,21220
15945,9460,6485,1098,206200,21221
21258,13059,8199,1158,157200,21222
8485,2821,5664,969,69900,21223
19252,11235,8017,1555,227400,21224
12428,6421,6007,896,165100,21225
2429,1890,539,1230,242600,21226
13148,8343,4805,1109,219100,21227
18971,13808,5163,1387,305600,21228
17772,9462,8310,1072,137400,21229
14835,7601,7234,1502,282900,21230
7694,2590,5104,1410,306400,21231
28640,17792,10848,1334,226500,21234
14826,10267,4559,1358,249300,21236
11493,7648,3845,1229,230700,21237
11731,6364,5367,1142,153800,21239
0,0,0,-,-,21240
13522,6231,7291,1364,222800,21244
0,0,0,-,-,21250
0,0,0,-,-,21251
0,0,0,-,-,21252
7912,4828,3084,1339,361700,21286
16944,10779,6165,1741,476400,21401
521,0,521,2170,-,21402
13671,9154,4517,1531,472100,21403
173,173,0,-,1023400,21405
7274,6469,805,1887,442100,21409
15749,10616,5133,719,131700,21502
859,681,178,660,267400,21520
490,377,113,727,89500,21521
96,75,21,-,-,21522
106,83,23,-,101800,21523
350,222,128,979,126700,21524
216,195,21,-,117200,21529
793,680,113,1097,167800,21530
887,719,168,529,155500,21531
5321,3534,1787,733,137700,21532
1616,1228,388,550,173500,21536
307,269,38,669,-,21538
1094,685,409,578,97500,21539
35,23,12,592,23900,21540
840,553,287,829,246400,21541
255,150,105,747,91600,21542
137,129,8,-,150800,21543
765,650,115,825,108500,21545
6143,4874,1269,648,181400,21550
672,604,68,823,157000,21555
795,571,224,978,106600,21557
1048,880,168,542,257500,21561
1211,947,264,553,108300,21562
10602,6877,3725,1083,298600,21601
262,210,52,980,326500,21607
180,136,44,1000,200000,21610
221,212,9,-,330000,21612
7527,4031,3496,851,208400,21613
3609,3058,551,1231,367200,21617
2438,1694,744,1730,368100,21619
5243,3408,1835,948,267400,21620
294,211,83,1216,172300,21622
821,708,113,1246,304200,21623
55,55,0,-,322700,21624
883,733,150,1470,319600,21625
27,27,0,-,-,21626
4,4,0,-,-,21627
164,131,33,-,155900,21628
3319,2592,727,1019,230600,21629
1030,825,205,1344,255000,21631
2496,1520,976,798,166200,21632
152,152,0,-,343100,21634
870,668,202,487,269800,21635
353,277,76,1156,193800,21636
1971,1540,431,1716,439700,21638
1828,1210,618,1046,180500,21639
536,477,59,859,216200,21640
41,20,21,790,179200,21641
2209,1892,317,725,154500,21643
26,26,0,-,280000,21644
542,385,157,1040,346400,21645
162,135,27,-,494800,21647
49,49,0,-,176100,21648
576,451,125,1236,167400,21649
107,89,18,-,-,21650
1173,924,249,1008,233600,21651
94,86,8,-,492900,21652
46,46,0,-,300000,21653
651,478,173,1371,769500,21654
1894,1420,474,1055,223200,21655
253,205,48,1722,302300,21657
1575,1408,167,1473,408400,21658
578,534,44,832,196100,21659
1655,1158,497,931,249100,21660
1149,858,291,1074,189900,21661
191,168,23,-,1008300,21662
1725,1407,318,1025,497300,21663
215,150,65,1244,144000,21664
71,71,0,-,516300,21665
5201,4007,1194,1659,394900,21666
110,110,0,-,213600,21667
697,572,125,574,299300,21668
58,58,0,-,562500,21669
353,303,50,-,314400,21671
89,89,0,-,-,21672
1337,1019,318,1152,314200,21673
36,36,0,-,-,21675
243,223,20,1417,609700,21676
226,186,40,1192,439100,21677
765,707,58,-,262500,21678
150,141,9,-,226100,21679
16163,10573,5590,1342,310400,21701
16096,10181,5915,1431,294900,21702
13858,9166,4692,1531,283200,21703
5058,4377,681,2188,511200,21704
0,0,0,-,-,21705
1797,1444,353,1890,441000,21710
456,414,42,810,211200,21711
3835,3139,696,1363,278100,21713
47,17,30,-,-,21714
2148,1672,476,856,231900,21716
44,0,44,-,-,21717
82,63,19,980,401700,21718
376,332,44,-,223900,21719
2161,1791,370,1071,230800,21722
245,230,15,-,649600,21723
1975,1525,450,851,275300,21727
336,336,0,-,330500,21733
438,228,210,659,161000,21734
713,713,0,-,896800,21737
1249,1214,35,-,706500,21738
23453,12586,10867,858,183000,21740
12881,9036,3845,1066,232900,21742
0,0,0,-,-,21746
1525,1091,434,832,167100,21750
2469,2002,467,1867,482900,21754
2054,1852,202,1150,385400,21755
1155,1096,59,900,278600,21756
948,776,172,1148,297700,21757
1740,1540,200,1532,298700,21758
58,58,0,-,257400,21762
329,262,67,643,221000,21766
346,244,102,718,178700,21767
4090,3646,444,1415,387500,21769
1898,1830,68,1521,445600,21770
10351,9477,874,1469,420300,21771
1929,1822,107,1538,369200,21773
4695,4407,288,2076,396800,21774
2339,1947,392,1146,356700,21776
700,673,27,-,335700,21777
390,337,53,-,248000,21778
565,422,143,1169,334200,21779
679,521,158,1130,299300,21780
14,14,0,-,-,21781
1634,1454,180,1093,248100,21782
3331,2688,643,1030,272600,21783
12954,11212,1742,1356,389300,21784
4021,3151,870,952,276000,21787
4822,3988,834,1014,273200,21788
63,57,6,-,540400,21790
2053,1670,383,972,336600,21791
3924,3222,702,1589,318200,21793
725,702,23,-,748300,21794
3651,2482,1169,967,220600,21795
2792,2463,329,894,572000,21797
826,617,209,859,372900,21798
11059,6012,5047,880,226700,21801
0,0,0,-,-,21802
14830,7312,7518,1135,172700,21804
194,194,0,-,191200,21810
10471,8429,2042,1165,269800,21811
1075,953,122,1058,358400,21813
111,111,0,-,298900,21814
1876,1146,730,575,114100,21817
390,374,16,1083,157400,21821
692,521,171,826,147800,21822
99,95,4,-,111300,21824
1901,1128,773,1231,166600,21826
171,171,0,-,190800,21829
1728,1500,228,708,173900,21830
106,106,0,-,-,21835
1139,895,244,1244,179700,21837
753,702,51,1313,122400,21838
157,110,47,-,159400,21840
490,294,196,1197,288700,21841
5340,3922,1418,1095,323600,21842
1355,1042,313,1090,202500,21849
1216,1026,190,963,169500,21850
3061,1832,1229,788,142500,21851
3789,2062,1727,779,137500,21853
286,168,118,-,190000,21856
249,202,47,956,145900,21861
15,15,0,-,-,21862
1795,1360,435,873,172200,21863
254,202,52,674,182100,21864
189,165,24,-,277900,21865
39,39,0,-,80500,21866
23,15,8,-,-,21867
439,362,77,1236,155000,21869
772,629,143,875,166800,21871
204,140,64,721,555600,21872
751,502,249,1177,144000,21874
2838,1897,941,1092,166400,21875
0,0,0,-,-,21890
6086,4465,1621,1196,272100,21901
90,0,90,-,-,21902
2213,1509,704,917,243300,21903
2364,2070,294,1087,258600,21904
3931,3163,768,1087,247100,21911
576,451,125,846,477900,21912
382,256,126,721,209800,21913
391,260,131,1264,241800,21914
1139,919,220,1122,290700,21915
0,0,0,-,-,21916
637,562,75,1135,259300,21917
1568,1414,154,-,244900,21918
1331,1265,66,747,317400,21919
188,157,31,-,319000,21920
16339,11296,5043,1200,235100,21921
58,15,43,-,-,21930
18569,12994,5575,1709,563100,22003
14771,12231,2540,2174,513400,22015
6447,5379,1068,2147,401300,22025
5080,3470,1610,1618,311100,22026
704,630,74,3288,998000,22027
20145,11947,8198,1973,617700,22030
13179,6508,6671,1953,576400,22031
9937,8466,1471,2087,603300,22032
14989,9436,5553,1907,509600,22033
166,0,166,1362,-,22035
5707,5493,214,"3,500+",832900,22039
10788,5010,5778,1668,384900,22041
12778,7827,4951,1888,562800,22042
9424,5860,3564,1894,676800,22043
5149,2407,2742,1586,605200,22044
7032,4852,2180,2115,775200,22046
2710,333,2377,2742,602900,22060
5725,5394,331,2871,1072300,22066
11476,8226,3250,2070,482600,22079
10645,9024,1621,3252,1026000,22101
11868,5799,6069,2100,900700,22102
6498,5581,917,1967,781800,22124
382,254,128,1889,401000,22125
1336,50,1286,1791,215000,22134
9398,5728,3670,2150,477200,22150
5527,4617,910,2162,499000,22151
9730,7860,1870,2217,486700,22152
10445,9300,1145,2211,533500,22153
3409,1931,1478,1266,439500,22172
8235,6649,1586,1985,728200,22180
5431,4731,700,1993,767600,22181
9040,6911,2129,2388,895300,22182
0,0,0,-,-,22185
23196,14086,9110,1745,335100,22191
19322,14320,5002,1835,363000,22192
23960,19097,4863,1678,337600,22193
19717,6177,13540,2212,711100,22201
14537,3142,11395,2211,663800,22202
12900,4209,8691,2055,692700,22203
22914,9419,13495,1684,500600,22204
6696,5354,1342,1786,868600,22205
10571,4488,6083,1975,443100,22206
12053,9802,2251,2064,972200,22207
7672,2661,5011,1961,646800,22209
40,0,40,3141,-,22211
1612,1012,600,2860,843300,22213
0,0,0,-,-,22214
5602,3298,2304,1975,826800,22301
8491,4837,3654,1779,470200,22302
7147,3135,4012,1755,428300,22303
22034,8534,13500,1725,388800,22304
7408,2728,4680,1704,644300,22305
11323,5948,5375,1561,459500,22306
4484,3344,1140,1653,549800,22307
4580,4188,392,3105,687500,22308
12363,8251,4112,1522,428900,22309
11529,8779,2750,1892,488100,22310
7512,1412,6100,1685,525000,22311
10788,5630,5158,1800,466200,22312
18205,9151,9054,2030,684000,22314
11339,8425,2914,2156,481600,22315
11059,4398,6661,1287,376700,22401
11336,8994,2342,1429,327400,22405
9180,6832,2348,1440,371300,22406
19816,15303,4513,1478,286200,22407
10903,8091,2812,1437,283000,22408
1378,815,563,806,193800,22427
113,113,0,-,-,22432
123,100,23,-,235700,22433
1064,942,122,1255,144600,22435
313,288,25,-,183000,22436
330,270,60,-,233600,22437
170,132,38,-,86700,22438
4021,3012,1009,1053,204500,22443
169,0,169,1736,-,22448
762,565,197,704,263700,22454
570,499,71,1543,183500,22460
1000,770,230,833,214500,22469
2378,2130,248,810,175000,22473
131,131,0,-,129500,22476
436,229,207,938,351200,22480
1528,938,590,1016,256000,22482
9231,7150,2081,1209,314800,22485
276,234,42,-,-,22488
1784,1578,206,425,194700,22503
61,48,13,-,225000,22504
5737,5587,150,1567,301500,22508
21,21,0,-,-,22509
442,418,24,739,285300,22511
952,698,254,789,193400,22514
2347,1716,631,671,194500,22520
7,7,0,-,-,22529
86,66,20,-,400000,22530
920,821,99,1541,244500,22534
163,111,52,1086,-,22535
88,88,0,-,208500,22538
1039,1039,0,-,365300,22539
738,678,60,-,272400,22542
6161,5307,854,1227,220600,22546
94,56,38,-,-,22548
6696,5910,786,1192,288400,22551
5060,3876,1184,1591,326400,22553
18043,13922,4121,1691,366900,22554
9601,7518,2083,1514,356600,22556
2797,1701,1096,919,204400,22560
1144,926,218,1139,229500,22567
2394,1300,1094,800,197000,22572
940,813,127,837,205200,22576
1261,923,338,953,374300,22578
29,29,0,-,-,22579
2021,1600,421,986,229300,22580
11185,5174,6011,1103,241700,22601
11016,8808,2208,1124,271500,22602
5856,4159,1697,1220,275600,22603
674,645,29,-,293200,22610
3386,2440,946,1222,381300,22611
1082,945,137,1101,366300,22620
240,185,55,1118,192700,22623
988,779,209,1158,261400,22624
1370,1197,173,1224,237000,22625
333,266,67,1233,797300,22627
12330,8987,3343,1027,254400,22630
897,630,267,841,209000,22637
212,164,48,1348,511200,22639
143,102,41,-,466700,22640
151,142,9,-,237300,22641
1736,1539,197,1511,248900,22642
104,104,0,-,368800,22643
1013,827,186,1034,220700,22644
1636,1208,428,812,270700,22645
25,25,0,-,-,22646
326,300,26,-,224700,22650
566,493,73,780,307000,22652
315,281,34,-,251900,22654
7775,5845,1930,1144,267500,22655
1471,1375,96,1311,261000,22656
4202,2971,1231,993,214000,22657
670,502,168,795,167700,22660
384,333,51,1203,249200,22663
3765,2008,1757,931,233200,22664
12087,8237,3850,1178,288500,22701
509,376,133,-,225400,22709
13,13,0,-,-,22711
2602,2076,526,1143,292900,22712
663,536,127,1492,319500,22713
316,238,78,1375,354300,22714
448,409,39,-,266800,22715
352,349,3,-,664700,22716
205,152,53,-,339000,22718
38,38,0,-,-,22719
323,300,23,-,504900,22720
128,128,0,-,233900,22722
75,75,0,-,269900,22723
759,668,91,-,387900,22724
329,246,83,973,319100,22726
2344,1772,572,782,273100,22727
1004,810,194,1178,379400,22728
104,67,37,-,-,22729
61,0,61,-,-,22730
12,12,0,-,-,22731
45,45,0,-,-,22732
456,333,123,-,333200,22733
1196,844,352,1119,285700,22734
892,824,68,1091,297200,22735
390,390,0,-,229900,22736
1148,915,233,1241,338100,22737
517,416,101,1037,341200,22738
491,320,171,877,349300,22740
67,23,44,-,-,22741
617,470,147,1220,326500,22742
56,50,6,-,-,22743
454,373,81,950,372900,22747
72,23,49,-,-,22749
13518,6273,7245,1000,270500,22801
10930,5745,5185,871,200300,22802
0,0,0,-,-,22807
400,376,24,-,194900,22810
224,164,60,-,176900,22811
3258,2330,928,928,248800,22812
3319,2308,1011,779,192200,22815
105,92,13,-,-,22820
2331,1877,454,834,210500,22821
2544,2037,507,875,214100,22824
4553,3461,1092,823,180500,22827
847,757,90,946,155600,22830
340,297,43,818,157000,22831
326,267,59,-,231600,22832
331,281,50,962,263900,22834
4874,3393,1481,785,181000,22835
2058,1661,397,1211,282500,22840
1067,760,307,877,263000,22841
2110,1570,540,880,167300,22842
958,832,126,839,213600,22843
2083,1260,823,684,226600,22844
8,8,0,-,-,22845
702,613,89,1225,326300,22846
309,228,81,841,222000,22847
1925,1506,419,851,150500,22849
430,349,81,1111,219400,22850
2263,1565,698,721,154900,22851
1558,1021,537,850,162900,22853
15170,8430,6740,1324,362900,22901
11107,5293,5814,1295,322100,22902
14865,6062,8803,1243,418300,22903
60,0,60,1011,-,22904
7473,5036,2437,1429,329000,22911
1620,1280,340,1141,298500,22920
818,738,80,-,121500,22922
2373,1734,639,1388,300600,22923
99,61,38,1034,-,22931
3188,2564,624,1398,415100,22932
319,319,0,-,235600,22935
1920,1719,201,1600,412900,22936
800,716,84,954,226600,22937
360,308,52,-,263000,22938
2518,1908,610,1351,279200,22939
450,393,57,1838,430900,22940
3959,2827,1132,816,239800,22942
183,132,51,-,333300,22943
67,67,0,-,217200,22946
1902,1584,318,1054,584100,22947
80,80,0,-,-,22948
624,222,402,-,160900,22949
994,876,118,1018,165800,22952
1051,958,93,1321,404300,22958
739,608,131,745,360400,22959
3788,2263,1525,900,219800,22960
6285,5433,852,1392,235400,22963
78,63,15,-,279200,22964
875,589,286,782,261000,22967
3951,3231,720,1017,248100,22968
616,451,165,993,192400,22969
626,479,147,711,205000,22971
181,134,47,-,484100,22972
2348,1922,426,889,195700,22973
1428,1285,143,1254,256100,22974
138,119,19,-,239300,22976
13255,8910,4345,808,197900,22980
19,0,19,-,-,22989
4186,3440,746,903,211800,23002
368,250,118,913,103100,23004
6462,4624,1838,1112,294000,23005
2399,2154,245,1256,203800,23009
414,281,133,1165,322000,23011
1464,1391,73,1190,327700,23015
127,127,0,-,-,23021
351,303,48,-,-,23022
230,218,12,-,258800,23023
3879,3333,546,945,279500,23024
114,99,15,-,1012000,23025
527,374,153,1111,199400,23027
1990,1630,360,752,167700,23030
151,103,48,-,214400,23032
496,462,34,-,244000,23035
672,600,72,1222,301600,23038
428,423,5,-,338400,23039
1797,1427,370,687,139600,23040
756,561,195,1093,287500,23043
25,25,0,-,-,23045
672,573,99,883,350700,23047
310,310,0,-,293900,23050
514,237,277,-,133500,23055
177,142,35,-,-,23056
14547,11150,3397,1528,442200,23059
13209,10366,2843,1269,301300,23060
8241,7005,1236,1170,233600,23061
1092,704,388,1009,230200,23062
1627,1249,378,935,198900,23063
187,137,50,-,400700,23064
756,707,49,-,238400,23065
109,54,55,-,276900,23066
69,69,0,-,-,23068
1062,993,69,1292,251200,23069
308,286,22,-,377300,23070
785,663,122,902,263100,23071
4834,3730,1104,998,228800,23072
3819,2297,1522,1122,150200,23075
338,299,39,-,281800,23076
156,119,37,-,281300,23079
776,645,131,690,215100,23083
659,544,115,1325,272200,23084
168,168,0,-,233300,23085
1307,1125,182,919,196800,23086
2300,1887,413,1176,277000,23089
158,98,60,-,222100,23091
424,386,38,-,226300,23092
5313,3822,1491,898,213800,23093
1136,1050,86,1308,319900,23102
2262,2059,203,849,472800,23103
533,521,12,-,194400,23106
117,112,5,-,212700,23108
1085,819,266,787,291700,23109
318,262,56,-,219000,23110
14359,11401,2958,1211,244100,23111
20371,16390,3981,1390,284300,23112
9448,7786,1662,1337,467000,23113
7400,6113,1287,1509,324700,23114
1,1,0,-,-,23115
10595,9382,1213,1398,324300,23116
3757,3082,675,1062,247000,23117
91,91,0,-,179400,23119
3838,3688,150,1613,418600,23120
747,553,194,532,106700,23123
1576,1513,63,-,291100,23124
154,154,0,-,184700,23125
163,157,6,-,262200,23126
272,169,103,-,130500,23128
204,187,17,-,482100,23129
97,75,22,-,-,23130
333,282,51,1165,258000,23138
9528,8806,722,1146,284200,23139
2381,2147,234,899,280900,23140
2841,2610,231,1022,286800,23141
1344,1204,140,1219,384500,23146
685,575,110,1036,188400,23148
1105,701,404,902,226800,23149
5058,3657,1401,1074,193400,23150
515,470,45,-,321900,23153
496,451,45,-,156100,23156
0,0,0,-,-,23160
40,24,16,-,-,23161
25,18,7,-,-,23163
2766,2335,431,1085,299300,23168
404,380,24,1036,237500,23169
14,14,0,-,-,23173
826,515,311,752,283600,23175
176,176,0,-,259100,23176
356,260,96,-,166300,23177
268,201,67,1069,287500,23180
2008,1724,284,1013,235300,23181
18257,13179,5078,1193,345500,23185
0,0,0,-,-,23187
17701,12903,4798,1292,336200,23188
2414,2221,193,1095,292100,23192
2943,212,2731,1127,219400,23219
12287,4348,7939,1149,330100,23220
6994,3597,3397,1244,436500,23221
10252,5419,4833,1049,157700,23222
21989,9822,12167,992,165200,23223
14529,5253,9276,1010,131700,23224
18071,8690,9381,1069,228200,23225
7322,5759,1563,1554,384400,23226
11724,6344,5380,1038,245100,23227
15112,7571,7541,1129,197800,23228
13361,9447,3914,1145,359700,23229
3531,1317,2214,1220,217300,23230
14530,9919,4611,1034,205800,23231
12714,8102,4612,1413,356900,23233
15536,8457,7079,1127,168700,23234
13197,9464,3733,1394,244400,23235
9534,8409,1125,1335,233200,23236
8854,5691,3163,1122,177000,23237
11095,6881,4214,1244,317500,23238
0,0,0,-,-,23250
7895,2888,5007,1243,225400,23294
640,357,283,755,213000,23301
26,16,10,-,-,23302
157,124,33,-,136400,23303
0,0,0,-,-,23304
411,271,140,1009,205200,23306
237,95,142,690,108500,23307
786,430,356,891,111400,23308
1859,1117,742,815,242600,23310
49,25,24,-,162500,23313
3442,2331,1111,1496,318100,23314
609,528,81,-,212900,23315
230,117,113,842,121800,23316
23455,14557,8898,1364,268200,23320
13054,10096,2958,1239,274900,23321
21108,18496,2612,1612,362000,23322
13629,10699,2930,1494,271100,23323
8246,4276,3970,967,179500,23324
7045,4479,2566,1264,218400,23325
1685,1251,434,992,312400,23336
205,103,102,-,213200,23337
317,175,142,663,268800,23347
1484,904,580,582,157400,23350
89,89,0,-,369200,23354
553,476,77,1125,185200,23356
272,194,78,834,204800,23357
63,29,34,-,-,23358
413,375,38,644,84500,23359
65,65,0,-,-,23389
152,152,0,-,118300,23395
27,20,7,-,-,23398
149,71,78,1282,-,23401
482,467,15,-,290900,23405
198,133,65,-,74300,23407
69,21,48,-,-,23408
49,49,0,-,-,23409
691,484,207,818,167500,23410
289,195,94,771,85400,23413
104,0,104,-,-,23414
642,350,292,839,150700,23415
104,55,49,-,-,23416
1794,1269,525,880,199300,23417
361,233,128,853,226600,23418
1093,573,520,701,132500,23420
1530,869,661,852,166100,23421
38,8,30,-,-,23422
133,99,34,-,212500,23423
36,26,10,-,209400,23426
130,116,14,822,85000,23427
6968,5587,1381,1040,295400,23430
614,614,0,-,321400,23432
519,484,35,805,371200,23433
18776,12303,6473,1093,238100,23434
11807,8400,3407,1581,292100,23435
387,376,11,-,358300,23436
1830,1578,252,803,247600,23437
670,586,84,1692,247500,23438
227,208,19,-,118000,23440
34,15,19,-,-,23441
391,201,190,845,146000,23442
19924,10455,9469,1334,462500,23451
21603,13334,8269,1281,260000,23452
12279,8631,3648,1397,241100,23453
22368,14346,8022,1371,315000,23454
20340,12187,8153,1401,313400,23455
19116,16835,2281,1763,357200,23456
1699,1455,244,1033,400800,23457
274,0,274,1776,-,23459
0,0,0,-,-,23460
0,0,0,-,-,23461
26805,14425,12380,1402,220700,23462
28031,19836,8195,1385,268600,23464
183,162,21,890,218900,23480
19,19,0,-,-,23486
2310,1839,471,913,209500,23487
326,97,229,-,164600,23488
7983,4316,3667,1179,198600,23502
13693,5748,7945,1074,216500,23503
7993,2747,5246,760,192400,23504
11789,3847,7942,1042,261600,23505
3239,1383,1856,1265,398600,23507
6370,3012,3358,1223,324500,23508
5001,2879,2122,1077,188000,23509
4235,901,3334,1353,322600,23510
198,0,198,1771,-,23511
11622,5983,5639,1074,167800,23513
2281,463,1818,1199,314900,23517
12289,6681,5608,1091,229000,23518
2705,893,1812,870,179400,23523
0,0,0,-,-,23551
11082,5672,5410,966,195100,23601
16612,8684,7928,1142,215000,23602
1282,688,594,1183,191700,23603
734,16,718,1608,-,23604
6115,2672,3443,988,143700,23605
11187,5198,5989,1111,242700,23606
9166,2991,6175,946,112300,23607
15509,8575,6934,1128,192100,23608
206,0,206,1882,-,23651
5410,3800,1610,1039,158700,23661
4614,3774,840,1383,343500,23662
5316,2853,2463,1107,156800,23663
4271,3001,1270,1186,221900,23664
1510,65,1445,1721,-,23665
21885,11493,10392,1168,193700,23666
15951,9456,6495,989,204400,23669
1470,1035,435,997,325000,23690
22,0,22,2107,-,23691
7422,6019,1403,1520,327300,23692
9081,6441,2640,1421,371800,23693
1311,1132,179,1764,387300,23696
8818,5703,3115,1160,165300,23701
4633,2091,2542,1011,149100,23702
9355,6294,3061,1172,226900,23703
7823,2941,4882,996,139600,23704
6016,3228,2788,961,169100,23707
5,0,5,-,-,23708
0,0,0,-,-,23709
1411,15,1396,1691,-,23801
15384,8009,7375,951,151200,23803
7626,4192,3434,991,164800,23805
0,0,0,-,-,23806
732,579,153,708,101700,23821
2571,1731,840,697,172900,23824
564,389,175,771,144000,23827
178,159,19,-,154900,23828
405,331,74,765,152500,23829
522,484,38,519,226300,23830
13742,10038,3704,1283,244500,23831
12269,10650,1619,1470,243600,23832
988,856,132,970,213900,23833
10534,7286,3248,1080,180600,23834
4619,3428,1191,1313,232300,23836
1783,1295,488,727,157200,23837
5913,5631,282,1708,343500,23838
317,238,79,1000,161000,23839
777,708,69,-,168100,23840
1182,920,262,1108,221800,23841
2520,2282,238,848,223400,23842
207,164,43,941,108200,23843
279,112,167,-,88200,23844
211,159,52,-,-,23845
320,249,71,678,167300,23846
5045,3003,2042,818,121500,23847
375,366,9,-,179500,23850
5574,3491,2083,836,194000,23851
445,303,142,721,112500,23856
349,200,149,571,191500,23857
10717,5551,5166,924,142500,23860
827,610,217,861,207800,23866
950,659,291,908,128300,23867
1984,1307,677,697,107800,23868
1052,801,251,1115,157800,23872
365,281,84,1075,159700,23874
4671,3078,1593,1171,204800,23875
136,120,16,-,-,23876
549,472,77,1271,189300,23878
227,120,107,-,85700,23879
954,626,328,687,228200,23881
712,559,153,774,122600,23882
839,632,207,1014,242900,23883
0,0,0,-,-,23884
982,873,109,842,218200,23885
95,55,40,-,271200,23887
901,627,274,926,115000,23888
299,246,53,849,93200,23889
1627,1129,498,900,149900,23890
0,0,0,-,-,23891
144,144,0,-,149200,23893
280,196,84,-,150000,23894
263,210,53,-,84300,23897
821,631,190,661,240300,23898
233,202,31,1036,-,23899
6128,3747,2381,725,177800,23901
0,0,0,-,-,23909
284,201,83,-,147000,23915
985,741,244,475,145900,23917
1099,962,137,672,303800,23919
1307,1159,148,685,140100,23920
708,489,219,743,156000,23921
921,589,332,728,133300,23922
1111,847,264,586,160600,23923
2561,1973,588,638,106200,23924
1981,1590,391,729,195300,23927
2160,1482,678,764,140400,23930
260,149,111,-,327000,23934
2350,1764,586,763,156600,23936
733,520,213,731,69300,23937
136,124,12,-,109700,23938
538,402,136,663,141000,23942
0,0,0,-,-,23943
1354,890,464,813,121700,23944
1342,876,466,571,133100,23947
1263,796,467,826,133800,23950
130,123,7,-,153500,23952
920,565,355,577,96800,23954
970,727,243,827,166500,23958
554,445,109,693,133900,23959
832,577,255,646,130800,23960
282,257,25,-,112800,23962
57,57,0,-,47000,23963
540,413,127,660,88600,23964
695,507,188,931,162200,23966
468,319,149,520,108300,23967
246,154,92,905,103800,23968
3312,1971,1341,733,151300,23970
1655,1115,540,672,121300,23974
65,8,57,-,-,23976
407,33,374,951,919600,24011
12166,6876,5290,836,137600,24012
2668,1269,1399,833,84900,24013
7326,4857,2469,789,172200,24014
6496,3565,2931,766,187100,24015
4303,1013,3290,758,108200,24016
9551,5069,4482,808,107800,24017
15808,11110,4698,980,244500,24018
11304,8928,2376,972,186100,24019
21,0,21,-,-,24020
1180,933,247,729,111200,24053
2330,1896,434,610,99600,24054
5096,3795,1301,523,93100,24055
82,68,14,-,135700,24058
443,430,13,-,210500,24059
18210,8239,9971,1107,314300,24060
1894,1751,143,828,197300,24064
2914,2289,625,709,198900,24065
2110,1720,390,738,146200,24066
912,723,189,581,159800,24067
728,660,68,639,105100,24069
648,613,35,825,171500,24070
415,368,47,-,154600,24072
12330,7846,4484,918,198700,24073
479,349,130,714,147200,24076
447,239,208,-,255900,24077
2864,1478,1386,606,103200,24078
789,674,115,1008,120100,24079
222,175,47,769,114400,24082
1183,984,199,1252,304600,24083
4709,3396,1313,714,155200,24084
1058,950,108,601,141400,24085
71,42,29,-,-,24086
1500,1027,473,781,159800,24087
1527,1320,207,615,100200,24088
1379,1090,289,624,76900,24089
1876,1647,229,1001,244100,24090
3276,2708,568,625,197400,24091
1279,1122,157,845,155300,24092
43,28,15,563,112500,24093
1779,1537,242,988,191500,24095
2376,2100,276,827,221300,24101
632,520,112,604,141900,24102
1346,1292,54,938,306000,24104
227,213,14,-,151700,24105
12825,8588,4237,649,95500,24112
693,607,86,549,146400,24120
4397,3933,464,899,262600,24121
591,562,29,-,148400,24122
1712,1377,335,715,96900,24124
1864,1281,583,607,139300,24127
960,856,104,739,205600,24128
0,0,0,-,-,24130
16,0,16,-,-,24131
150,46,104,-,-,24132
907,753,154,574,112200,24133
1963,1518,445,708,138500,24134
1332,1002,330,745,126100,24136
1514,1296,218,790,159700,24137
592,508,84,1026,165400,24138
461,291,170,-,179400,24139
9242,5608,3634,812,179600,24141
0,0,0,-,-,24142
508,206,302,803,121000,24147
3217,2447,770,634,122700,24148
1448,1249,199,-,170900,24149
349,296,53,-,131400,24150
7865,5777,2088,763,153200,24151
14678,10645,4033,936,205700,24153
161,81,80,874,99600,24161
959,565,394,685,136200,24162
571,381,190,615,105200,24165
75,42,33,-,95700,24167
116,70,46,-,84100,24168
3749,2783,966,600,122500,24171
1320,1151,169,445,119600,24174
3278,2874,404,883,241800,24175
568,530,38,1109,509900,24176
7824,5555,2269,753,169000,24179
1777,1621,156,572,237800,24184
355,342,13,-,229500,24185
6985,4221,2764,705,121900,24201
5397,4472,925,738,160800,24202
7011,4771,2240,742,151700,24210
4351,3560,791,761,220100,24211
1067,748,319,581,50600,24216
109,56,53,-,66200,24217
4147,2838,1309,654,113300,24219
347,347,0,-,84800,24220
220,215,5,-,137500,24221
2279,1773,506,640,89500,24224
947,585,362,344,78500,24225
597,469,128,589,65800,24226
2503,1840,663,618,93700,24228
2945,1990,955,656,91200,24230
1192,799,393,603,122200,24236
373,334,39,1081,93800,24237
70,55,15,-,80200,24239
634,529,105,800,125800,24243
2129,1529,600,291,92900,24244
366,242,124,479,74200,24245
181,33,148,-,-,24246
1010,874,136,-,83400,24248
518,452,66,-,92100,24250
3170,2455,715,527,104500,24251
1399,934,465,472,60400,24256
657,537,120,521,108800,24258
2001,1407,594,558,81100,24260
2578,1598,980,513,79300,24263
355,304,51,594,55600,24265
3904,2939,965,615,97500,24266
132,101,31,621,-,24269
192,174,18,-,145700,24270
1174,1009,165,591,128200,24271
228,198,30,324,77900,24272
2778,1637,1141,464,74700,24273
2078,1218,860,572,82600,24277
1901,1520,381,671,76900,24279
302,232,70,-,164800,24280
921,681,240,729,100400,24281
235,196,39,-,71800,24282
871,628,243,510,90000,24283
765,503,262,612,120800,24290
176,170,6,-,76800,24292
4052,2834,1218,665,103100,24293
5748,3552,2196,791,119300,24301
777,511,266,731,69500,24311
913,659,254,750,89200,24312
281,261,20,-,73100,24313
575,465,110,513,90900,24314
1283,1042,241,667,147200,24315
0,0,0,-,-,24316
1700,1444,256,633,84900,24317
223,211,12,-,103800,24318
2699,1911,788,650,134300,24319
26,26,0,-,-,24322
320,227,93,-,116400,24323
985,844,141,772,181600,24324
558,475,83,-,113800,24325
503,475,28,-,110800,24326
792,781,11,-,137700,24328
1195,1002,193,581,100500,24330
7054,5473,1581,615,105800,24333
2279,1757,522,681,154400,24340
3480,2582,898,598,128000,24343
596,358,238,593,181500,24347
1661,1186,475,479,111400,24348
521,469,52,-,91600,24350
185,140,45,-,78600,24351
439,367,72,-,137300,24352
5926,3925,2001,619,103700,24354
2313,2152,161,564,138800,24360
1796,1398,398,808,129600,24361
633,541,92,191,116000,24363
198,176,22,-,-,24366
2188,1838,350,669,116500,24368
2628,2047,581,522,73200,24370
373,287,86,816,88000,24374
668,499,169,474,83600,24375
203,193,10,-,103700,24377
511,474,37,788,128700,24378
1245,1107,138,729,165500,24380
1462,1068,394,536,107300,24381
6446,4322,2124,622,150500,24382
15783,9963,5820,838,190500,24401
12,12,0,-,-,24411
100,100,0,-,-,24412
109,105,4,-,151800,24413
0,0,0,-,-,24415
3406,2383,1023,835,128300,24416
1798,1604,194,1134,216500,24421
2616,1799,817,589,108300,24422
5661,4600,1061,698,107000,24426
776,405,371,658,156300,24430
1004,887,117,769,128000,24431
177,136,41,-,132000,24432
27,25,2,-,108900,24433
893,872,21,-,241700,24435
552,518,34,-,263600,24437
533,395,138,640,166700,24439
1163,1017,146,1280,171600,24440
2486,2047,439,819,182900,24441
52,36,16,-,91400,24442
1085,796,289,622,150800,24445
173,157,16,883,71500,24448
5995,3734,2261,943,258900,24450
143,102,41,-,-,24457
156,131,25,-,178800,24458
259,199,60,-,257400,24459
496,453,43,-,209200,24460
205,22,183,848,-,24464
591,513,78,588,161900,24465
955,869,86,-,281200,24467
720,586,134,822,219500,24471
841,629,212,865,202200,24472
368,289,79,-,320200,24473
190,180,10,-,80300,24474
101,91,10,-,218300,24476
4392,3168,1224,1024,206000,24477
707,583,124,875,305300,24479
1808,1399,409,897,174200,24482
329,289,40,838,188400,24483
214,214,0,-,116100,24484
173,173,0,-,155400,24485
1131,918,213,904,258500,24486
174,174,0,-,240900,24487
10007,4626,5381,771,114900,24501
16101,8605,7496,952,169100,24502
7760,5687,2073,804,243700,24503
3767,2027,1740,846,149600,24504
2131,1475,656,668,117100,24517
1003,918,85,655,102500,24520
3834,2990,844,672,192600,24521
3675,2810,865,674,152400,24522
8059,6155,1904,827,173600,24523
579,534,45,796,194800,24526
1264,987,277,798,121300,24527
1514,1091,423,740,113600,24528
644,517,127,726,176900,24529
404,269,135,599,107300,24530
3413,2627,786,802,130200,24531
501,389,112,779,99100,24534
85,85,0,-,216200,24536
2254,1910,344,672,143800,24538
111,71,40,-,97800,24539
13389,7912,5477,716,118200,24540
12630,7197,5433,681,113000,24541
1516,1177,339,734,124600,24549
3045,2302,743,745,153700,24550
10080,8178,1902,881,269500,24551
807,593,214,794,129100,24553
1499,1223,276,746,119000,24554
989,569,420,538,141700,24555
1041,971,70,-,249300,24556
3595,2633,962,593,106900,24557
2740,2047,693,641,119700,24558
251,224,27,-,156300,24562
2407,1570,837,718,114000,24563
388,309,79,-,86800,24565
533,443,90,1482,89200,24566
414,390,24,-,138500,24569
0,0,0,-,-,24570
907,763,144,672,121200,24571
6517,4949,1568,681,146600,24572
1450,1220,230,740,168600,24574
2067,1660,407,732,92000,24577
402,329,73,-,176800,24578
350,314,36,-,96000,24579
243,226,17,-,89000,24580
27,27,0,-,-,24581
2225,1641,584,1113,123300,24586
4132,2982,1150,640,151600,24588
997,847,150,434,116200,24589
3151,2306,845,1062,191500,24590
5284,3425,1859,683,133100,24592
866,690,176,849,177900,24593
571,527,44,-,87200,24594
48,29,19,-,334100,24595
457,392,65,841,128600,24597
599,492,107,638,126400,24598
343,292,51,-,104300,24599
0,0,0,-,-,24601
276,230,46,-,-,24602
387,371,16,-,-,24603
95,95,0,-,29400,24604
3424,2717,707,667,123000,24605
56,49,7,-,-,24606
136,123,13,-,-,24607
2850,2230,620,644,115300,24609
61,16,45,653,-,24612
255,226,29,-,-,24613
2675,2160,515,636,77800,24614
1034,869,165,591,54600,24620
251,171,80,587,70500,24622
86,50,36,482,84300,24628
2641,1822,819,673,105900,24630
742,468,274,612,60200,24631
194,172,22,-,103100,24634
232,157,75,363,48900,24635
1420,1067,353,754,125200,24637
1373,1120,253,710,82700,24639
2462,1623,839,730,92900,24641
363,324,39,-,63600,24646
1156,841,315,620,70500,24649
2015,1581,434,581,114500,24651
950,830,120,663,70300,24656
243,105,138,807,76400,24657
8488,5583,2905,695,89100,24701
485,344,141,724,113300,24712
76,76,0,-,51100,24714
156,147,9,-,48300,24715
125,125,0,-,-,24716
13,13,0,-,-,24719
31,27,4,-,-,24724
303,168,135,-,34700,24726
83,69,14,-,33000,24729
67,67,0,-,58400,24731
204,162,42,-,108500,24733
209,161,48,633,52100,24736
55,18,37,-,-,24737
106,80,26,-,134700,24738
12981,8898,4083,695,117300,24740
1222,818,404,716,73600,24747
1473,1021,452,677,60400,24801
224,210,14,482,62000,24808
247,203,44,-,-,24811
0,0,0,-,-,24813
279,199,80,579,56100,24815
11,11,0,-,-,24816
385,347,38,821,43500,24817
430,385,45,-,58900,24818
439,289,150,-,93300,24822
188,160,28,-,-,24823
24,24,0,-,-,24826
519,470,49,919,-,24827
247,221,26,427,20100,24828
64,45,19,-,29200,24830
72,67,5,-,60400,24831
230,230,0,-,69000,24834
277,239,38,-,46300,24836
601,549,52,-,48500,24839
42,30,12,-,-,24843
476,398,78,406,51800,24844
93,72,21,-,-,24845
50,17,33,-,-,24846
70,70,0,-,-,24847
129,110,19,-,-,24848
125,125,0,-,120800,24849
317,251,66,-,37700,24850
232,201,31,-,58500,24851
92,63,29,-,14400,24853
86,49,37,-,-,24854
441,384,57,691,88300,24857
73,73,0,-,99200,24860
44,10,34,-,-,24861
285,240,45,-,-,24862
110,102,8,-,17700,24866
124,96,28,-,-,24867
571,455,116,539,24900,24868
150,150,0,-,56600,24869
999,837,162,849,55700,24870
130,48,82,-,37100,24871
355,261,94,-,-,24872
207,184,23,-,64100,24873
1144,853,291,615,89800,24874
125,63,62,481,-,24878
188,156,32,-,-,24879
123,60,63,-,-,24880
145,145,0,-,45400,24881
330,330,0,-,-,24882
128,119,9,-,26800,24884
11,11,0,-,-,24887
24,24,0,-,45700,24888
653,444,209,621,36500,24892
73,73,0,-,46400,24894
0,0,0,-,-,24898
4670,2831,1839,735,206500,24901
1818,1361,457,670,109700,24910
274,243,31,625,82800,24915
357,340,17,-,182300,24916
826,643,183,664,123300,24918
89,89,0,-,84800,24920
179,179,0,-,132300,24924
235,151,84,842,180000,24925
166,127,39,-,41600,24927
449,374,75,-,120800,24931
151,132,19,-,160900,24934
254,254,0,-,70000,24935
563,459,104,-,154500,24938
385,287,98,763,89800,24941
160,132,28,-,125000,24944
154,154,0,-,187500,24945
435,357,78,-,133600,24946
674,496,178,565,86300,24951
1743,1445,298,657,129400,24954
104,104,0,-,320000,24957
41,41,0,-,-,24962
1562,1188,374,627,115500,24963
577,558,19,-,102800,24966
2006,1468,538,740,100300,24970
153,141,12,-,82600,24974
455,419,36,445,163900,24976
159,144,15,-,150000,24977
245,87,158,-,-,24981
1023,821,202,466,122500,24983
91,91,0,-,332300,24984
2198,1426,772,714,108700,24986
315,304,11,-,118200,24991
0,0,0,-,-,25002
1064,832,232,-,101100,25003
89,89,0,-,125500,25005
138,127,11,-,-,25007
79,57,22,-,81900,25008
409,359,50,707,64000,25009
248,161,87,618,77100,25011
1679,1340,339,748,97000,25015
178,123,55,-,55400,25019
194,139,55,652,83200,25021
137,117,20,-,-,25022
216,116,100,578,97800,25024
50,50,0,-,-,25025
159,144,15,-,69500,25028
131,131,0,-,-,25030
261,149,112,937,82800,25031
636,518,118,442,103000,25033
341,228,113,599,44900,25035
69,52,17,-,-,25036
391,259,132,731,72900,25039
279,234,45,-,87100,25040
656,408,248,558,100000,25043
104,82,22,-,-,25044
1779,1290,489,689,88900,25045
55,55,0,-,54400,25047
18,18,0,-,-,25048
156,141,15,-,72900,25049
57,57,0,-,81500,25051
1598,1091,507,804,90300,25053
72,72,0,-,-,25054
53,53,0,-,56200,25057
177,168,9,-,57900,25059
133,101,32,-,33000,25060
206,167,39,-,74100,25061
71,71,0,-,-,25062
739,631,108,-,84100,25063
4176,2443,1733,800,99100,25064
403,338,65,725,84200,25067
645,502,143,862,162100,25070
4668,3521,1147,732,139000,25071
330,149,181,643,-,25075
117,99,18,-,"10,000-",25076
533,525,8,-,115700,25081
571,495,76,-,229300,25082
196,171,25,-,86000,25083
352,173,179,607,63200,25085
252,214,38,730,81900,25086
72,63,9,-,"10,000-",25088
86,86,0,-,70600,25090
107,68,39,-,50400,25093
99,83,16,-,17800,25102
91,77,14,-,-,25103
252,191,61,678,65800,25106
257,205,52,-,58400,25107
160,100,60,-,-,25108
257,236,21,-,126200,25109
230,188,42,834,-,25110
230,202,28,-,67300,25111
0,0,0,-,-,25112
242,212,30,-,146100,25113
107,45,62,830,79000,25114
55,55,0,-,58800,25115
349,293,56,-,79500,25118
115,104,11,-,43300,25119
404,243,161,-,116500,25121
1117,992,125,568,126800,25123
481,428,53,-,85500,25124
443,376,67,-,78200,25125
22,22,0,-,-,25126
1304,1049,255,656,102700,25130
74,74,0,-,-,25132
295,212,83,361,89400,25133
144,144,0,-,45200,25134
652,276,376,602,79500,25136
155,134,21,-,156000,25139
468,367,101,-,27400,25140
96,96,0,-,-,25141
122,110,12,-,48700,25142
3634,2510,1124,684,101500,25143
164,143,21,-,-,25148
46,46,0,-,-,25149
219,195,24,-,59100,25152
259,179,80,-,95300,25154
103,90,13,-,-,25156
1773,1513,260,1033,117900,25159
118,75,43,-,-,25160
170,157,13,-,47300,25161
134,104,30,650,132100,25162
425,338,87,-,107100,25164
342,309,33,-,97100,25165
1449,1279,170,837,138200,25168
237,164,73,639,-,25169
117,68,49,-,66500,25173
156,148,8,-,38900,25174
9467,6868,2599,752,109900,25177
96,96,0,-,92400,25180
493,455,38,-,68400,25181
18,18,0,-,-,25183
0,0,0,-,-,25185
453,309,144,564,105500,25186
262,241,21,-,-,25187
223,168,55,825,51700,25193
0,0,0,-,-,25201
466,418,48,-,115800,25202
9,9,0,-,-,25203
45,26,19,-,17000,25204
110,99,11,-,72700,25205
121,79,42,-,55000,25206
289,197,92,-,53400,25208
419,345,74,469,65100,25209
33,33,0,-,-,25211
2427,2129,298,895,211700,25213
255,235,20,-,-,25214
311,260,51,-,132100,25234
403,280,123,473,68000,25235
623,538,85,-,137000,25239
614,574,40,-,163300,25241
179,143,36,-,119300,25243
187,180,7,-,88900,25244
306,295,11,-,141400,25245
218,166,52,666,62700,25247
1266,1044,222,622,154000,25248
86,83,3,-,141900,25251
610,530,80,-,133500,25252
876,752,124,-,118300,25253
302,290,12,-,204900,25259
628,529,99,662,68700,25260
43,43,0,-,-,25261
485,460,25,-,113700,25262
154,97,57,-,166200,25264
731,597,134,612,101600,25265
316,226,90,335,88300,25266
258,244,14,-,41500,25267
448,406,42,-,155600,25268
340,248,92,476,94300,25270
3922,2499,1423,664,120000,25271
683,644,39,-,130000,25275
3205,2233,972,523,82700,25276
224,143,81,-,-,25285
673,589,84,-,94700,25286
237,165,72,-,76600,25287
1278,236,1042,564,143800,25301
6254,3705,2549,744,115000,25302
3154,2112,1042,776,140900,25303
3524,2353,1171,828,181000,25304
0,0,0,-,-,25305
3060,2052,1008,1035,81100,25306
5740,4253,1487,673,122000,25309
4848,2777,2071,688,96800,25311
6219,4644,1575,821,92500,25312
5381,4153,1228,810,136100,25313
6316,5228,1088,849,199700,25314
1397,1003,394,751,71400,25315
2175,1696,479,666,92700,25320
6141,3052,3089,943,159700,25401
5664,4638,1026,1113,237800,25403
8953,5736,3217,1022,170200,25404
4842,4013,829,1436,189900,25405
5329,4382,947,744,193200,25411
3529,2943,586,1088,171800,25413
6966,5430,1536,971,277900,25414
4149,3341,808,1076,198200,25419
1968,1521,447,1168,217500,25420
756,697,59,-,132900,25422
5345,4511,834,1173,258800,25425
5933,5051,882,983,210000,25427
4683,3956,727,1230,178400,25428
3154,2579,575,1336,232700,25430
79,52,27,-,-,25431
50,45,5,-,-,25432
1080,828,252,682,104700,25434
46,46,0,-,-,25437
2341,1491,850,996,186700,25438
763,653,110,983,232900,25442
2545,1964,581,1075,325600,25443
123,123,0,-,245500,25444
473,386,87,-,338700,25446
557,464,93,-,112100,25501
296,272,24,-,74200,25502
443,326,117,-,105400,25503
5091,3747,1344,787,151400,25504
118,105,13,-,-,25505
2204,1592,612,636,75600,25506
355,286,69,876,102100,25507
4172,3250,922,614,117100,25508
1900,1566,334,869,154000,25510
329,268,61,-,89200,25511
467,427,40,-,114400,25512
1679,1373,306,693,60500,25514
747,596,151,588,79200,25515
568,393,175,537,48100,25517
528,510,18,-,-,25520
320,307,13,-,82800,25521
1021,661,360,615,83400,25523
941,791,150,709,70700,25524
8381,6752,1629,843,196300,25526
412,341,71,-,70400,25529
2607,1700,907,609,107100,25530
88,32,56,433,63600,25534
858,808,50,-,147900,25535
615,482,133,597,134600,25537
144,132,12,-,32500,25540
4475,3288,1187,784,147200,25541
1916,1778,138,919,148200,25545
407,359,48,-,-,25547
3782,3024,758,433,108100,25550
676,494,182,620,89400,25555
804,616,188,494,69300,25557
760,609,151,-,89200,25559
3117,2465,652,1109,219900,25560
470,457,13,-,214600,25564
260,211,49,-,73800,25565
230,160,70,-,110500,25567
1886,1316,570,696,114300,25570
826,736,90,636,130300,25571
216,182,34,-,157700,25573
2260,1352,908,821,88200,25601
520,354,166,917,100700,25606
353,185,168,816,63700,25607
399,327,72,-,74000,25608
354,278,76,-,-,25611
364,321,43,-,121100,25617
771,565,206,633,54700,25621
55,55,0,-,-,25624
415,322,93,628,68600,25625
115,97,18,-,83900,25628
185,144,41,-,-,25630
140,140,0,-,-,25632
283,139,144,806,"10,000-",25634
653,444,209,814,122900,25635
513,360,153,606,55100,25637
319,229,90,-,101900,25638
160,129,31,-,86100,25639
274,167,107,-,67300,25644
432,339,93,-,74100,25646
265,160,105,715,-,25647
588,420,168,-,102400,25649
120,120,0,-,129400,25650
332,267,65,-,74800,25651
514,362,152,716,74900,25652
159,120,39,-,113700,25653
39,11,28,-,-,25654
2475,1458,1017,514,92900,25661
142,131,11,-,-,25666
419,351,68,-,34000,25669
2413,1969,444,640,85800,25670
544,344,200,658,61400,25671
202,173,29,-,-,25672
882,533,349,563,75100,25674
494,373,121,-,66600,25676
740,531,209,308,77900,25678
92,50,42,-,60000,25688
85,85,0,-,80300,25690
350,218,132,518,63000,25692
137,72,65,-,64800,25696
40,40,0,-,21700,25699
9260,5205,4055,737,125000,25701
3084,1630,1454,636,74600,25702
2288,493,1795,751,75400,25703
6577,4340,2237,742,105300,25704
9069,5831,3238,791,129700,25705
13220,9136,4084,787,115300,25801
29,29,0,-,-,25810
16,16,0,-,-,25811
689,537,152,677,66200,25812
2734,2120,614,740,97200,25813
254,235,19,-,-,25817
236,27,209,715,-,25818
163,131,32,-,-,25820
859,672,187,-,78700,25823
1157,1101,56,-,112500,25825
66,66,0,-,-,25826
1002,771,231,704,104900,25827
669,555,114,693,88600,25831
1766,1429,337,646,176300,25832
53,53,0,-,-,25836
117,117,0,-,99900,25837
184,93,91,-,-,25839
3358,2797,561,581,112400,25840
175,166,9,-,113300,25841
443,392,51,-,420500,25843
518,291,227,678,84800,25844
223,161,62,-,-,25845
97,79,18,-,-,25846
109,109,0,-,-,25848
407,213,194,-,-,25849
15,0,15,-,-,25853
518,399,119,878,154700,25854
63,63,0,-,-,25855
35,35,0,-,-,25857
99,99,0,-,-,25862
76,76,0,-,69300,25864
482,445,37,805,92400,25865
215,205,10,-,86900,25868
14,14,0,-,-,25870
372,196,176,741,63400,25871
380,380,0,-,130700,25873
295,281,14,-,-,25875
15,15,0,-,-,25876
396,383,13,-,107100,25878
59,48,11,-,-,25879
2613,1886,727,529,101500,25880
860,738,122,527,70800,25882
4826,3598,1228,618,105300,25901
80,80,0,-,92700,25902
163,133,30,-,84500,25904
193,143,50,-,89400,25906
34,34,0,-,-,25907
56,56,0,-,-,25908
25,13,12,-,-,25911
133,133,0,-,102800,25913
84,66,18,-,12400,25915
76,76,0,-,-,25916
720,538,182,535,109400,25917
1919,1670,249,723,155300,25918
53,53,0,-,-,25920
942,483,459,701,74300,25921
106,106,0,-,238500,25922
205,205,0,-,-,25928
141,120,21,-,90500,25932
0,0,0,-,-,25936
485,426,59,-,-,25938
47,47,0,-,-,25942
2946,2111,835,722,101900,25951
278,217,61,840,73900,25958
1427,1062,365,496,84100,25962
474,427,47,-,83900,25969
469,433,36,-,100700,25971
64,41,23,-,-,25972
1103,1012,91,583,106100,25976
36,36,0,-,95500,25977
257,189,68,485,174600,25978
345,268,77,628,86700,25979
281,218,63,610,36100,25981
720,526,194,528,56200,25984
178,103,75,770,94800,25985
9,9,0,-,-,25989
17344,11864,5480,661,132500,26003
254,194,60,747,49100,26030
654,459,195,586,65900,26031
174,133,41,633,90400,26032
759,688,71,768,88800,26033
2250,1620,630,670,98300,26034
855,809,46,-,104300,26035
74,55,19,-,125800,26036
2798,1992,806,545,90400,26037
1377,1254,123,675,185200,26038
149,119,30,-,-,26039
770,519,251,488,76600,26040
6331,4968,1363,583,100800,26041
2568,2031,537,597,98700,26047
745,404,341,637,50600,26050
431,381,50,-,84700,26055
34,34,0,-,-,26056
1057,850,207,929,116200,26059
655,537,118,687,151600,26060
8909,6108,2801,650,96200,26062
3566,2754,812,500,104200,26070
230,138,92,1659,114200,26074
227,199,28,725,53100,26075
11951,7452,4499,706,86100,26101
7365,5139,2226,648,131500,26104
5099,3716,1383,692,142000,26105
495,457,38,-,159400,26133
391,272,119,505,98500,26134
197,169,28,-,87300,26136
242,221,21,-,112500,26137
62,7,55,-,-,26138
130,130,0,-,65200,26141
963,865,98,726,84800,26142
1927,1531,396,470,87400,26143
342,339,3,-,150300,26146
873,654,219,537,106400,26147
112,112,0,-,68400,26148
844,703,141,593,95500,26149
2446,1869,577,857,160600,26150
274,216,58,-,73600,26151
2,2,0,-,-,26152
2998,2422,576,721,110900,26155
1168,918,250,764,79700,26159
452,445,7,-,152700,26160
258,258,0,-,-,26161
3092,2427,665,857,109300,26164
324,294,30,-,113800,26167
222,173,49,-,119400,26169
2233,1865,368,475,109900,26170
1367,1133,234,611,93000,26175
91,84,7,-,47000,26178
742,623,119,807,171400,26180
2567,2061,506,784,169700,26181
798,691,107,767,156300,26184
2628,2431,197,765,159300,26187
7878,5736,2142,713,126900,26201
212,212,0,-,87500,26202
101,101,0,-,-,26203
1412,1077,335,529,87200,26205
1285,869,416,430,62400,26206
386,328,58,-,66800,26208
65,29,36,971,-,26209
16,16,0,-,-,26215
59,40,19,-,138900,26217
1010,904,106,829,84200,26218
138,98,40,-,74900,26222
120,107,13,-,106400,26224
0,0,0,-,-,26228
71,62,9,-,-,26230
640,604,36,-,76500,26234
16,16,0,-,-,26236
198,175,23,-,63700,26237
293,265,28,-,117400,26238
5556,3475,2081,659,139000,26241
1845,1492,353,619,93800,26250
1431,992,439,722,133100,26253
75,52,23,-,-,26254
399,357,42,764,77900,26257
13,13,0,-,-,26259
730,611,119,529,184900,26260
1181,928,253,654,43900,26261
81,81,0,-,266300,26263
260,227,33,555,88300,26264
25,25,0,-,-,26266
110,63,47,-,238800,26267
22,22,0,-,-,26268
455,394,61,-,153200,26269
162,126,36,713,146700,26270
236,215,21,725,129600,26271
289,239,50,653,81000,26273
217,165,52,656,64500,26275
293,293,0,-,78800,26276
237,202,35,-,68800,26278
685,470,215,737,83300,26280
42,42,0,-,-,26282
661,553,108,514,141800,26283
134,134,0,-,91800,26285
1370,1052,318,570,97300,26287
1438,1051,387,538,82000,26288
56,56,0,-,153800,26291
256,165,91,598,95300,26292
280,232,48,-,-,26293
457,399,58,-,82800,26294
34,34,0,-,-,26296
51,51,0,-,-,26298
11772,7628,4144,679,94000,26301
286,269,17,-,80400,26320
99,78,21,531,-,26321
288,150,138,668,78200,26323
136,125,11,663,167600,26325
54,54,0,-,105700,26327
5939,4427,1512,980,213200,26330
641,539,102,661,84500,26335
534,436,98,490,73300,26337
246,180,66,445,85800,26338
67,51,16,-,-,26339
88,67,21,-,131300,26342
157,127,30,-,-,26343
344,289,55,522,119300,26346
698,562,136,690,150000,26347
166,133,33,-,64400,26348
56,26,30,-,-,26349
1372,738,634,599,90800,26351
4334,3475,859,566,107700,26354
51,51,0,-,-,26361
1431,1031,400,617,109300,26362
21,21,0,-,-,26366
246,160,86,741,109800,26369
249,207,42,-,322800,26372
595,559,36,746,149500,26374
147,118,29,-,83300,26376
286,233,53,-,109400,26377
1726,1514,212,728,153100,26378
252,252,0,-,78800,26384
1472,1311,161,773,136000,26385
1101,957,144,810,110000,26386
275,222,53,-,53500,26404
430,382,48,-,110700,26405
1003,888,115,1042,181500,26408
354,284,70,844,101500,26410
164,124,40,-,155000,26411
105,87,18,-,69300,26412
1284,1099,185,408,88300,26415
3373,2220,1153,561,113300,26416
411,307,104,-,89300,26419
62,34,28,-,-,26421
203,143,60,916,77400,26422
76,76,0,-,-,26424
419,346,73,608,81200,26425
2618,2350,268,760,108900,26426
115,73,42,-,102100,26430
2384,1830,554,730,119300,26431
39,39,0,-,70500,26435
69,69,0,-,83500,26436
238,219,19,243,83900,26437
28,28,0,-,-,26438
411,311,100,795,124700,26440
144,144,0,-,-,26443
1430,1237,193,673,80700,26444
498,317,181,695,100300,26447
494,443,51,-,105600,26448
263,221,42,788,130100,26451
3795,2679,1116,638,97000,26452
1352,1176,176,378,115900,26456
8635,5275,3360,761,174900,26501
15132,5333,9799,861,228100,26505
12789,9869,2920,900,246700,26508
786,599,187,736,85300,26519
259,259,0,-,78500,26520
71,57,14,615,189800,26521
1868,1682,186,727,167400,26525
940,507,433,733,83200,26534
2415,1715,700,614,127200,26537
1072,933,139,494,186600,26541
1047,881,166,556,119200,26542
80,30,50,-,-,26543
1167,892,275,678,161500,26547
17270,12122,5148,820,137700,26554
540,484,56,813,133800,26559
46,25,21,-,-,26560
179,165,14,-,-,26562
133,90,43,-,-,26563
239,212,27,-,78000,26568
1361,1232,129,668,133000,26570
762,657,105,675,95400,26571
33,20,13,-,-,26572
241,197,44,797,75000,26574
349,269,80,508,84500,26575
433,422,11,-,106300,26576
364,302,62,-,59500,26581
1685,1378,307,578,87800,26582
143,134,9,-,130800,26585
92,92,0,-,-,26586
157,114,43,-,71900,26587
1163,959,204,689,135200,26588
277,264,13,-,-,26590
524,498,26,440,108800,26591
1642,1240,402,450,116600,26601
339,267,72,581,105300,26610
55,45,10,-,-,26611
100,100,0,-,-,26615
29,29,0,-,87600,26617
124,97,27,-,162100,26619
263,234,29,638,90000,26621
451,362,89,-,-,26623
1386,1018,368,579,96100,26624
128,57,71,-,-,26627
115,115,0,-,45500,26629
51,51,0,-,118500,26631
174,150,24,-,85800,26636
71,53,18,-,48300,26638
3944,2862,1082,648,117600,26651
93,87,6,-,66100,26656
168,144,24,-,94700,26660
466,424,42,-,156300,26662
161,161,0,-,85700,26676
459,408,51,-,116400,26678
741,583,158,1266,155600,26679
117,117,0,-,-,26680
421,378,43,-,46200,26681
74,44,30,-,-,26684
260,252,8,-,48600,26690
192,188,4,-,76700,26691
2070,1804,266,-,164800,26704
238,180,58,573,121900,26705
128,97,31,590,78300,26707
844,707,137,618,157600,26710
1257,1042,215,925,181700,26711
182,142,40,-,141100,26714
279,203,76,-,115500,26716
303,266,37,603,71800,26717
1215,1036,179,766,164100,26719
32,32,0,-,-,26720
139,121,18,-,149000,26722
4995,3933,1062,622,131100,26726
238,238,0,-,174300,26731
357,306,51,-,125700,26739
723,683,40,-,222600,26743
313,149,164,456,48700,26750
2391,1741,650,802,173500,26753
376,366,10,-,149600,26755
2837,1988,849,613,132100,26757
337,337,0,-,67000,26761
600,438,162,578,109100,26763
1608,1313,295,565,98200,26764
223,167,56,933,-,26767
312,252,60,-,-,26801
485,332,153,532,131200,26802
255,226,29,-,84000,26804
1249,994,255,615,148800,26807
212,193,19,-,258500,26808
158,137,21,-,173300,26810
639,566,73,582,133500,26812
232,213,19,-,99000,26814
365,345,20,-,165500,26815
123,123,0,-,-,26817
302,222,80,729,93300,26818
68,43,25,-,-,26823
903,828,75,-,157000,26833
3020,1962,1058,825,137500,26836
374,314,60,-,150700,26845
2623,1894,729,536,133000,26847
908,769,139,686,152800,26851
333,263,70,678,156400,26852
303,262,41,-,126900,26855
84,84,0,-,-,26865
294,276,18,-,168000,26866
289,213,76,514,84200,26884
6255,5714,541,840,228600,27006
851,756,95,407,148600,27007
1162,1087,75,973,161800,27009
2279,1641,638,658,127500,27011
10915,8879,2036,848,240500,27012
2339,1959,380,668,130200,27013
343,206,137,1018,88100,27014
620,505,115,621,118100,27016
3509,2613,896,661,117200,27017
3144,2643,501,685,169800,27018
1821,1611,210,652,156800,27019
2478,1852,626,673,145100,27020
7348,5488,1860,758,147800,27021
522,350,172,651,145000,27022
4989,4167,822,949,232800,27023
1239,1043,196,744,128300,27024
4601,3607,994,588,116000,27025
1987,1263,724,523,88500,27027
9616,7414,2202,701,149500,27028
15037,10410,4627,605,118400,27030
4749,4407,342,935,194800,27040
3237,2284,953,668,161500,27041
143,142,1,-,-,27042
2737,2320,417,644,167400,27043
4108,3193,915,817,145900,27045
1119,940,179,420,157900,27046
520,416,104,1072,153300,27047
3334,2779,555,722,124000,27048
1794,1615,179,735,143800,27050
2824,1993,831,792,144700,27051
4257,3093,1164,679,133400,27052
1441,1367,74,675,132400,27053
900,808,92,-,157000,27054
5450,4205,1245,632,137100,27055
9001,2893,6108,758,149100,27101
15645,8629,7016,891,162600,27103
13299,8188,5111,928,249500,27104
14993,7428,7565,740,101400,27105
19281,10768,8513,844,180500,27106
18042,12680,5362,756,138700,27107
0,0,0,-,-,27109
0,0,0,-,-,27110
15548,9586,5962,856,139300,27127
29,29,0,-,97000,27201
8855,4013,4842,676,107700,27203
14298,11224,3074,694,138100,27205
1443,1177,266,544,151400,27207
543,458,85,1010,118500,27208
1571,1040,531,704,111700,27209
498,366,132,599,148500,27212
4462,3169,1293,930,187500,27214
18566,11076,7490,857,176700,27215
14094,9052,5042,761,116900,27217
1155,801,354,579,89800,27229
973,679,294,945,201000,27231
1315,1118,197,765,170800,27233
1906,1685,221,963,191700,27235
3759,2963,796,669,115000,27239
682,464,218,548,110200,27242
1950,1614,336,761,190700,27243
5332,3716,1616,850,204300,27244
1226,876,350,913,123500,27248
5198,4213,985,779,156000,27249
671,451,220,649,172300,27252
12791,8910,3881,754,159600,27253
2797,2302,495,698,138900,27258
9439,3527,5912,709,82000,27260
9063,5468,3595,873,169700,27262
8711,5891,2820,752,126200,27263
20471,13983,6488,943,192700,27265
10672,8345,2327,1044,276100,27278
1309,1002,307,767,214200,27281
6595,5195,1400,1142,200500,27282
1113,999,114,875,171700,27283
22482,15927,6555,869,179900,27284
10125,6080,4045,660,94700,27288
551,430,121,539,165300,27291
16588,11043,5545,692,137700,27292
15811,11484,4327,709,145800,27295
4191,2926,1265,715,147600,27298
1972,1480,492,774,131800,27299
3179,2737,442,863,156500,27301
12428,8712,3716,923,190400,27302
741,580,161,1109,111600,27305
2583,2107,476,678,128100,27306
2398,2314,84,-,395900,27310
1343,925,418,539,93200,27311
9461,7657,1804,862,328100,27312
2698,2339,359,798,168400,27313
350,310,40,-,125900,27314
807,694,113,628,116300,27315
2828,1887,941,693,115600,27316
6275,4949,1326,712,119200,27317
16495,11641,4854,693,120500,27320
2847,2240,607,576,98300,27325
1359,1046,313,563,111200,27326
14075,8591,5484,804,149400,27330
11606,8045,3561,919,162300,27332
9,0,9,-,-,27340
1861,1633,228,634,113100,27341
647,543,104,747,252000,27343
7078,4334,2744,802,161400,27344
2150,1781,369,691,158800,27349
2520,2131,389,761,134400,27350
982,680,302,631,155500,27355
1017,735,282,553,106300,27356
3040,2376,664,855,173600,27357
5321,4592,729,989,310700,27358
18572,12434,6138,697,128200,27360
5456,4680,776,798,132500,27370
3205,2211,994,544,122200,27371
3931,3429,502,800,259100,27376
3542,2660,882,957,191200,27377
2077,1274,803,481,114600,27379
7588,2704,4884,752,110800,27401
7844,3999,3845,891,165200,27403
19357,8425,10932,802,113400,27405
24559,13379,11180,861,134500,27406
21514,10180,11334,894,147800,27407
7606,5360,2246,936,233400,27408
8040,2544,5496,887,147200,27409
24603,15475,9128,1013,231600,27410
11871,8658,3213,967,247100,27455
7454,5481,1973,857,169900,27501
15109,12265,2844,1409,348400,27502
1431,1234,197,1167,271900,27503
5719,4309,1410,686,139300,27504
2623,1887,736,883,143400,27505
713,498,215,773,96500,27507
878,692,186,711,292900,27508
1559,894,665,1006,155800,27509
6595,1992,4603,1145,339700,27510
13427,9287,4140,1142,275200,27511
18953,11485,7468,1221,349800,27513
9619,4973,4646,1189,485500,27514
16073,11243,4830,1213,386500,27516
11182,7462,3720,1315,414200,27517
7704,5205,2499,1330,431500,27518
19516,14263,5253,1530,439800,27519
15112,11226,3886,1012,194100,27520
2699,1812,887,863,140400,27521
4813,3921,892,1010,178400,27522
5634,4200,1434,1399,346100,27523
4710,3055,1655,843,142700,27524
5479,4154,1325,799,152500,27525
17112,13105,4007,1216,252500,27526
9527,7966,1561,1088,248700,27527
18154,12664,5490,1152,214900,27529
15640,9344,6296,699,132700,27530
12,0,12,-,-,27531
13155,7053,6102,920,151900,27534
6331,2442,3889,667,87200,27536
8804,6227,2577,697,114000,27537
8022,6482,1540,1375,341000,27539
13045,10839,2206,1466,348000,27540
1571,1345,226,1003,224300,27541
3765,2555,1210,729,117400,27542
1870,1201,669,785,118300,27544
10097,7762,2335,1124,188200,27545
6731,4430,2301,877,161000,27546
9680,6616,3064,832,143200,27549
741,608,133,879,150400,27551
858,631,227,684,83600,27553
271,95,176,828,113800,27555
126,91,35,942,-,27556
2733,1821,912,708,107000,27557
1066,836,230,1011,264200,27559
15172,7345,7827,1414,328800,27560
1198,1043,155,-,378400,27562
2207,1372,835,580,78400,27563
9931,6929,3002,771,141200,27565
255,151,104,634,134300,27568
3244,2162,1082,798,116400,27569
2369,2033,336,826,317200,27571
2812,2651,161,743,192200,27572
4889,2836,2053,711,108800,27573
5893,5013,880,628,121400,27574
6786,4275,2511,766,130900,27576
9473,6193,3280,727,158300,27577
1286,1139,147,837,166400,27581
181,59,122,485,154900,27582
2668,2400,268,668,159600,27583
26266,20539,5727,1193,331700,27587
2938,2074,864,641,79300,27589
7595,5772,1823,930,182200,27591
6003,5211,792,829,238100,27592
7155,5896,1259,907,217700,27596
9385,7191,2194,815,192300,27597
4271,1073,3198,1188,359800,27601
21301,12731,8570,1169,240500,27603
19107,11222,7885,1117,196200,27604
3551,1188,2363,1319,346400,27605
18933,6933,12000,1103,292500,27606
9076,4731,4345,1182,438900,27607
5074,3817,1257,1193,677000,27608
16475,8423,8052,1114,337600,27609
26381,15314,11067,1101,175200,27610
18988,10027,8961,1221,361300,27612
16836,11950,4886,1133,359500,27613
12541,8951,3590,1288,387200,27614
19224,13510,5714,1242,329400,27615
19979,11615,8364,1179,216400,27616
9534,3961,5573,1370,285700,27617
10354,3079,7275,906,306100,27701
22120,13997,8123,1099,224200,27703
15586,8939,6647,994,166400,27704
21021,9320,11701,1103,277500,27705
20974,10345,10629,1080,266400,27707
330,271,59,-,208700,27709
9044,8180,864,1319,246400,27712
23116,13827,9289,1160,261900,27713
7414,3772,3642,719,86700,27801
8075,5077,2998,773,135700,27803
12488,7135,5353,826,133600,27804
1578,1220,358,732,78400,27805
1126,934,192,705,65600,27806
2320,1506,814,718,131800,27807
897,807,90,1037,287200,27808
1760,1458,302,537,118000,27809
1896,1312,584,712,195300,27810
1120,707,413,713,78700,27812
297,183,114,532,86300,27813
698,690,8,-,129900,27814
1281,958,323,671,107700,27816
3272,2459,813,740,123400,27817
724,518,206,711,58000,27818
147,61,86,932,56800,27819
865,660,205,605,107400,27820
86,59,27,-,-,27821
3225,2496,729,702,110100,27822
2878,1720,1158,770,56700,27823
522,273,249,771,93500,27824
38,7,31,864,-,27825
159,118,41,-,98300,27826
83,83,0,-,38400,27827
3746,2581,1165,716,124800,27828
783,552,231,573,58100,27829
1781,1119,662,677,102500,27830
1278,860,418,793,72100,27831
1258,852,406,794,72100,27832
23798,9023,14775,777,123300,27834
2694,2189,505,670,150600,27837
1404,990,414,782,65300,27839
145,114,31,817,83300,27840
22,3,19,580,-,27841
857,750,107,1229,350800,27842
393,287,106,690,81300,27843
1304,853,451,631,84000,27844
952,639,313,661,80300,27845
1191,911,280,596,80400,27846
308,248,60,769,53300,27847
732,563,169,747,67100,27849
3387,2670,717,671,124000,27850
1959,1473,486,615,106400,27851
1290,1122,168,685,96400,27852
171,140,31,-,69700,27853
2391,1495,896,824,85800,27855
5893,4221,1672,809,153200,27856
523,350,173,725,87000,27857
22205,10335,11870,852,172300,27858
773,622,151,644,83000,27860
34,34,0,-,62500,27861
454,375,79,881,-,27862
4928,3964,964,1021,134500,27863
1985,1127,858,666,85800,27864
826,757,69,1030,155600,27865
302,174,128,1065,100600,27866
786,643,143,731,66700,27869
10354,5963,4391,716,102500,27870
1911,1225,686,668,73000,27871
243,98,145,1115,-,27872
158,113,45,613,109800,27873
2017,1414,603,486,68000,27874
205,66,139,-,-,27875
733,554,179,648,73800,27876
650,332,318,804,91200,27878
142,111,31,883,122900,27879
1613,1323,290,794,140700,27880
23,18,5,-,-,27881
2932,2047,885,668,118700,27882
1248,859,389,688,89800,27883
461,391,70,-,81500,27884
572,397,175,1045,86100,27885
8481,5680,2801,703,94400,27886
783,597,186,683,78100,27888
11282,7511,3771,735,140800,27889
990,434,556,659,84000,27890
1886,1477,409,846,89600,27891
5774,3764,2010,760,92200,27892
15626,6946,8680,717,104000,27893
8066,6147,1919,895,167800,27896
727,370,357,704,85200,27897
14791,9150,5641,951,166700,27909
4713,3076,1637,736,90100,27910
363,291,72,-,257300,27915
374,286,88,1355,244700,27916
288,83,205,579,-,27917
483,370,113,379,156800,27919
600,388,212,890,249000,27920
1757,1241,516,1005,206100,27921
213,143,70,718,86300,27922
284,266,18,-,230300,27923
1491,1213,278,718,81800,27924
1594,1171,423,664,115200,27925
762,520,242,1031,180600,27926
548,457,91,867,453100,27927
881,702,179,634,113100,27928
706,609,97,-,296500,27929
5383,3356,2027,802,135100,27932
638,470,168,-,159300,27935
424,333,91,850,315300,27936
1560,1207,353,992,143000,27937
683,538,145,923,80600,27938
1220,916,304,998,215800,27939
132,123,9,-,278300,27941
205,192,13,706,-,27942
171,100,71,-,388900,27943
5207,4095,1112,901,182300,27944
553,512,41,-,125000,27946
502,466,36,-,255300,27947
5341,4028,1313,1164,267000,27948
3262,2835,427,1355,437500,27949
901,812,89,1083,201800,27950
420,347,73,1025,-,27953
2810,1914,896,1146,263200,27954
157,157,0,-,131800,27956
581,291,290,-,184000,27957
4513,3988,525,1370,278900,27958
1354,1060,294,1321,316300,27959
410,276,134,875,380000,27960
2993,1565,1428,599,84600,27962
339,282,57,1272,206800,27964
167,132,35,-,206600,27965
302,194,108,727,266700,27966
58,42,16,763,85600,27967
110,83,27,-,341200,27968
1375,1050,325,842,82100,27970
39,33,6,-,322700,27972
555,386,169,1168,271400,27973
467,410,57,828,189800,27974
1562,1309,253,681,239600,27976
96,64,32,1031,164800,27978
558,433,125,879,155100,27979
990,805,185,-,147700,27980
809,565,244,920,241100,27981
31,21,10,-,-,27982
3291,2250,1041,599,83100,27983
148,74,74,808,111400,27985
537,365,172,819,109300,27986
10814,7352,3462,774,139600,28001
565,517,48,981,173000,28006
249,198,51,807,68300,28007
447,301,146,700,87100,28009
8821,6269,2552,993,229900,28012
5168,3279,1889,760,130000,28016
0,0,0,-,-,28017
1795,1468,327,787,115700,28018
0,0,0,-,-,28019
772,567,205,697,88300,28020
5582,4064,1518,730,146600,28021
6051,4553,1498,780,144900,28023
20151,14103,6048,907,186000,28025
23676,17053,6623,1084,234800,28027
11813,8590,3223,1227,341600,28031
1282,869,413,889,171100,28032
1080,872,208,675,129400,28033
6703,4956,1747,741,151600,28034
6527,5432,1095,1262,385400,28036
8950,7284,1666,856,337700,28037
29,17,12,-,86900,28039
3069,2495,574,620,99800,28040
8442,5091,3351,628,122300,28043
13086,7384,5702,844,110900,28052
15247,7129,8118,895,148300,28054
13512,10483,3029,854,190600,28056
1106,890,216,654,151600,28071
513,315,198,387,160500,28072
2244,1471,773,712,108700,28073
6017,5407,610,1686,307500,28075
210,165,45,-,-,28076
244,99,145,590,72300,28077
22902,16899,6003,1359,324400,28078
13517,11708,1809,1460,243800,28079
2730,2094,636,941,145800,28080
10312,6456,3856,796,158300,28081
9112,5333,3779,906,136700,28083
9754,7019,2735,708,134500,28086
839,646,193,1025,157800,28088
25,17,8,-,137500,28089
3038,2392,646,638,116800,28090
965,674,291,640,106100,28091
16203,11121,5082,736,151000,28092
2454,2066,388,745,173600,28097
1493,996,497,931,119500,28098
547,452,95,875,277000,28101
28,28,0,-,75600,28102
4101,3452,649,834,171500,28103
10561,9767,794,1411,333100,28104
17849,12010,5839,1340,279100,28105
2794,2403,391,846,255400,28107
44,19,25,-,-,28108
163,148,15,-,160100,28109
18325,13652,4673,1052,200100,28110
10071,7346,2725,864,180200,28112
2763,2078,685,599,98600,28114
13646,9599,4047,906,232400,28115
16369,11625,4744,1249,454800,28117
1116,689,427,909,84000,28119
8516,6138,2378,823,170700,28120
2372,2002,370,845,200200,28124
1120,872,248,931,200000,28125
2654,2232,422,734,169200,28127
2779,2004,775,725,122600,28128
2438,2042,396,677,173700,28129
1041,821,220,675,134800,28133
4163,2546,1617,1259,214300,28134
1619,1253,366,654,123900,28135
1080,933,147,876,170700,28137
3840,2850,990,806,139400,28138
8840,6749,2091,759,147400,28139
9750,5271,4479,801,148300,28144
11941,9585,2356,714,156200,28146
8426,5735,2691,802,160300,28147
10888,7216,3672,670,134400,28150
8802,5779,3023,692,128800,28152
1088,617,471,889,105100,28159
1614,860,754,590,80000,28160
1893,1534,359,749,171000,28163
6214,5176,1038,819,196700,28164
3807,3026,781,1082,207200,28166
906,808,98,758,168300,28167
4126,3531,595,666,127100,28168
61,36,25,615,115900,28169
4872,2925,1947,752,93900,28170
18077,16189,1888,1299,416000,28173
2880,2061,819,928,149900,28174
7528,2361,5167,1605,335500,28202
9680,3037,6643,1477,520700,28203
4516,973,3543,1351,429700,28204
21075,9052,12023,1059,273200,28205
5265,1796,3469,892,138600,28206
4166,3349,817,1232,1060300,28207
15189,5913,9276,957,121000,28208
11670,6073,5597,1292,411800,28209
20613,11014,9599,1196,348600,28210
12897,7344,5553,1302,490900,28211
16322,6227,10095,1032,151700,28212
17146,8466,8680,1023,174100,28213
13789,10344,3445,1143,163400,28214
21575,13268,8307,1102,167000,28215
20795,10483,10312,1150,157700,28216
11373,3669,7704,1185,143000,28217
15646,11258,4388,1212,404400,28226
21163,14566,6597,1083,201400,28227
0,0,0,-,-,28244
18277,6398,11879,1179,207300,28262
29836,19110,10726,1278,199800,28269
12654,8988,3666,1341,386700,28270
15571,8084,7487,1266,199700,28273
26780,17709,9071,1470,376000,28277
10072,7358,2714,1385,300300,28278
0,0,0,-,-,28280
0,0,0,-,-,28282
7332,2677,4655,699,92500,28301
14063,6322,7741,886,131900,28303
14400,7888,6512,1006,120300,28304
2875,1578,1297,857,187700,28305
15738,9726,6012,949,165500,28306
4641,42,4599,1238,156300,28307
16,0,16,-,-,28308
0,0,0,-,-,28310
14503,6890,7613,895,149300,28311
7833,5384,2449,812,154300,28312
23273,10052,13221,976,134200,28314
5202,3737,1465,744,170400,28315
1501,1171,330,797,86300,28318
4000,2825,1175,613,93500,28320
1425,1017,408,835,168100,28323
273,162,111,705,72700,28325
7627,4644,2983,1288,172600,28326
6876,5838,1038,1165,198800,28327
9987,6504,3483,659,108100,28328
135,87,48,-,164700,28330
176,114,62,640,181500,28332
3837,2571,1266,722,78000,28333
9139,6076,3063,716,126000,28334
4241,2905,1336,682,117500,28337
1654,1312,342,511,89800,28338
2690,1865,825,872,98900,28339
3973,2472,1501,557,68900,28340
1369,906,463,725,102200,28341
56,45,11,-,129200,28342
572,375,197,606,59300,28343
1527,1264,263,706,88300,28344
4756,2870,1886,567,82900,28345
440,290,150,760,70700,28347
12850,9303,3547,899,150600,28348
1314,866,448,699,110900,28349
48,48,0,-,-,28350
1802,1226,576,690,67800,28351
9015,5056,3959,679,94400,28352
2016,1503,513,541,159300,28356
1028,786,242,784,82900,28357
13713,7878,5835,681,91000,28358
4984,3452,1532,648,82400,28360
490,299,191,639,92700,28363
5046,3831,1215,618,68800,28364
6278,4629,1649,715,94300,28365
2041,1605,436,635,84900,28366
58,11,47,544,130400,28367
926,683,243,673,67300,28369
2131,1544,587,853,96000,28371
4128,2698,1430,627,89700,28372
1156,783,373,899,179700,28373
8034,6804,1230,1538,327900,28374
94,78,16,638,"10,000-",28375
15314,10308,5006,902,155900,28376
4477,2993,1484,577,70500,28377
10836,7213,3623,680,94200,28379
2896,2221,675,688,89500,28382
2870,2241,629,638,65300,28383
3831,2649,1182,625,70300,28384
824,674,150,549,100900,28385
2089,1621,468,618,53700,28386
6985,4026,2959,896,289600,28387
8675,4191,4484,959,134100,28390
2252,1677,575,738,145700,28391
685,578,107,927,97900,28392
728,547,181,598,64500,28393
2202,1616,586,1237,191900,28394
872,703,169,829,125300,28395
1070,753,317,590,85600,28396
2922,1682,1240,701,78200,28398
815,658,157,664,104300,28399
10944,4186,6758,922,168500,28401
18482,6461,12021,978,250000,28403
14597,8765,5832,1130,231600,28405
13657,11072,2585,1125,295600,28409
15106,11110,3996,1248,280400,28411
17548,10070,7478,1072,235700,28412
1505,1054,451,938,177400,28420
547,432,115,595,105300,28421
3385,2718,667,870,225000,28422
992,800,192,708,107500,28423
26,8,18,665,181300,28424
4138,2922,1216,807,145300,28425
2923,1911,1012,1151,361500,28428
3250,2689,561,869,158500,28429
919,620,299,670,91100,28430
3210,2231,979,582,79700,28431
524,467,57,716,81600,28432
1746,1295,451,706,95600,28433
390,301,89,1030,64600,28434
828,741,87,-,99200,28435
670,485,185,628,132700,28436
701,617,84,538,86400,28438
400,280,120,703,66600,28439
1154,763,391,712,75900,28441
637,527,110,588,95400,28442
8731,7217,1514,1199,256500,28443
1053,854,199,938,117400,28444
3008,2213,795,1153,244600,28445
544,437,107,600,151300,28447
310,174,136,478,48600,28448
881,625,256,1211,454800,28449
914,704,210,913,224100,28450
15753,12373,3380,1134,203100,28451
271,183,88,-,86100,28452
1330,1006,324,584,72700,28453
1010,940,70,972,134300,28454
983,777,206,-,104900,28455
1561,1283,278,709,116600,28456
4257,3485,772,777,170200,28457
2216,1598,618,641,99000,28458
4687,3353,1334,1237,215300,28460
9851,8245,1606,1122,282800,28461
5634,4428,1206,714,143800,28462
2979,2218,761,614,76800,28463
1003,651,352,826,106500,28464
3711,3145,566,1098,285000,28465
3880,3018,862,486,116600,28466
5930,5392,538,1123,211500,28467
2208,1808,400,1097,262100,28468
3351,2882,469,799,325600,28469
5111,3693,1418,828,168700,28470
7192,4586,2606,670,96800,28472
1879,1589,290,609,121100,28478
2566,2029,537,990,196400,28479
1191,883,308,1684,859400,28480
7933,3653,4280,680,78900,28501
8958,5393,3565,736,108000,28504
850,589,261,785,64700,28508
694,524,170,583,203600,28510
262,209,53,-,109200,28511
1648,1305,343,956,379100,28512
3850,2695,1155,622,115500,28513
1015,673,342,493,96100,28515
5287,3452,1835,821,204500,28516
3333,2610,723,714,99800,28518
145,115,30,864,128100,28519
159,109,50,-,160600,28520
852,671,181,792,144500,28521
1047,773,274,582,129000,28523
105,92,13,-,164700,28524
1152,813,339,670,71500,28525
1176,770,406,855,87900,28526
519,396,123,614,181000,28527
222,169,53,-,128100,28528
896,697,199,635,101700,28529
2978,1906,1072,615,93300,28530
538,446,92,1079,243300,28531
8188,3858,4330,1049,144600,28532
0,0,0,-,-,28533
29,19,10,-,-,28537
973,511,462,824,73400,28538
6657,4059,2598,1041,158300,28539
18072,9797,8275,868,157700,28540
1732,38,1694,1210,159700,28543
2218,613,1605,978,104000,28544
17429,8886,8543,969,161500,28546
1980,11,1969,1313,-,28547
5493,3751,1742,644,112300,28551
91,91,0,-,59800,28552
180,132,48,-,253100,28553
82,82,0,-,75300,28554
2059,1557,502,862,124800,28555
474,363,111,-,261600,28556
7076,4410,2666,929,253200,28557
11348,7456,3892,859,147900,28560
16290,11585,4705,890,190900,28562
8512,6270,2242,895,165800,28570
1265,1077,188,857,293300,28571
2722,1831,891,637,87700,28572
757,555,202,678,150200,28573
6531,4204,2327,1051,146400,28574
172,143,29,1400,350900,28575
82,72,10,-,-,28577
2060,1462,598,645,76900,28578
262,186,76,849,255100,28579
4173,2780,1393,734,88300,28580
116,109,7,-,309400,28581
806,629,177,1284,212400,28582
143,83,60,908,74200,28583
5526,4144,1382,1192,243800,28584
1639,1279,360,611,84400,28585
2981,2207,774,610,107800,28586
144,141,3,-,84200,28587
70,35,35,-,-,28589
10225,7632,2593,891,169300,28590
1708,1423,285,1329,382500,28594
20473,13717,6756,763,177800,28601
11560,7639,3921,714,136800,28602
3027,2222,805,850,230300,28604
1673,1160,513,896,357300,28605
565,510,55,580,92500,28606
12966,6590,6376,939,272900,28607
2495,2034,461,903,168500,28609
4135,3037,1098,750,125600,28610
317,276,41,-,75000,28611
4851,3833,1018,645,106700,28612
8888,6439,2449,717,144200,28613
815,625,190,586,106300,28615
43,43,0,-,306500,28616
725,432,293,585,119300,28617
968,741,227,919,191900,28618
570,418,152,638,104300,28619
3829,2598,1231,625,127300,28621
1041,862,179,543,114100,28622
545,488,57,631,142200,28623
705,609,96,-,98800,28624
15867,11828,4039,800,153400,28625
1387,1304,83,981,189200,28626
532,353,179,587,125700,28627
210,143,67,722,138300,28628
0,0,0,-,-,28629
8074,5965,2109,800,148700,28630
424,283,141,-,166800,28631
1864,1511,353,752,109300,28634
1450,1308,142,710,101600,28635
1651,1180,471,687,113300,28636
647,461,186,629,143100,28637
4720,3403,1317,617,131400,28638
1992,1427,565,585,164000,28640
2387,1653,734,492,105300,28642
1634,1357,277,835,118100,28643
556,418,138,682,141300,28644
18785,13554,5231,635,113400,28645
171,130,41,-,400000,28646
8,8,0,-,-,28647
446,324,122,519,159400,28649
4259,3344,915,771,145000,28650
2776,2319,457,611,134800,28651
0,0,0,-,-,28652
1586,1353,233,841,148200,28654
21523,15960,5563,678,125000,28655
3987,3163,824,664,155700,28657
10786,7818,2968,782,133100,28658
9118,6340,2778,683,122700,28659
807,715,92,-,145600,28660
116,87,29,-,153800,28662
275,255,20,-,167200,28663
1039,892,147,560,132600,28665
141,114,27,-,-,28666
156,95,61,917,80300,28667
149,142,7,-,-,28668
1219,1087,132,688,107900,28669
1061,851,210,573,126200,28670
125,97,28,-,167900,28671
63,63,0,-,-,28672
2898,2491,407,998,328200,28673
3182,2285,897,621,152500,28675
1435,1222,213,609,152200,28676
13629,8917,4712,718,142700,28677
2096,1847,249,1059,167000,28678
923,803,120,923,227700,28679
10326,8366,1960,673,138200,28681
499,371,128,-,482800,28682
479,398,81,671,117200,28683
945,739,206,774,222500,28684
824,658,166,666,106300,28685
854,632,222,584,142600,28689
4032,3163,869,673,121500,28690
1875,1408,467,897,227000,28692
697,600,97,765,148600,28693
3306,2639,667,655,151100,28694
6216,4181,2035,626,168500,28697
1058,901,157,637,161600,28698
1567,1349,218,892,230900,28701
188,188,0,-,232400,28702
7819,4837,2982,1139,257700,28704
2839,2273,566,732,162900,28705
79,55,24,-,160100,28707
87,80,7,-,-,28708
1128,811,317,929,183300,28709
5750,3827,1923,1033,250900,28711
8748,6112,2636,734,246300,28712
3769,2852,917,625,165300,28713
6967,5027,1940,644,164100,28714
10100,7379,2721,959,220800,28715
7637,5557,2080,771,166800,28716
952,800,152,796,301300,28717
192,162,30,-,187500,28718
2822,2049,773,568,116700,28719
83,53,30,1297,221900,28720
4599,3199,1400,821,177000,28721
2947,1910,1037,832,213800,28722
3316,1302,2014,719,252800,28723
9,5,4,-,-,28725
1377,761,616,838,148400,28726
1727,1489,238,-,236900,28729
3583,2892,691,777,244400,28730
3654,2870,784,939,254800,28731
7442,6252,1190,992,246900,28732
19,0,19,-,-,28733
12606,9405,3201,762,154600,28734
145,104,41,-,237000,28735
318,271,47,944,331600,28736
9575,7387,2188,858,261900,28739
414,360,54,622,160600,28740
2025,1330,695,789,482000,28741
1186,1019,167,831,204400,28742
914,674,240,573,161300,28743
211,188,23,-,316100,28745
1187,981,206,1024,334800,28746
845,681,164,660,163300,28747
4526,3303,1223,841,189500,28748
53,53,0,-,-,28749
1822,1570,252,844,202800,28751
12428,8945,3483,644,128900,28752
3791,2997,794,579,172300,28753
3935,2880,1055,730,227300,28754
1642,1365,277,762,176900,28756
11,11,0,-,-,28757
3236,2577,659,1036,280900,28759
2913,2319,594,684,144400,28761
2973,2173,800,638,121200,28762
1012,723,289,773,191500,28763
433,366,67,583,194400,28766
3324,2782,542,737,226500,28768
3358,2796,562,517,115400,28771
552,497,55,-,172900,28772
1269,1080,189,925,253400,28773
598,500,98,1462,479500,28774
118,70,48,-,-,28775
3614,2850,764,589,163100,28777
3851,2841,1010,877,169500,28778
8292,5621,2671,751,202400,28779
422,268,154,661,258300,28781
3384,2598,786,1074,243300,28782
516,253,263,620,177000,28783
3037,2540,497,819,246300,28785
9568,6476,3092,808,177000,28786
8448,6518,1930,911,252100,28787
2203,1541,662,905,180100,28789
1447,1264,183,1099,304700,28790
6646,5037,1609,935,247000,28791
14801,9456,5345,917,189700,28792
6466,2419,4047,881,353200,28801
14866,7407,7459,1202,307600,28803
8994,6139,2855,1180,389100,28804
9110,5599,3511,938,265500,28805
17280,9771,7509,999,222300,28806
2330,1842,488,710,130600,28901
449,335,114,678,-,28902
4580,3278,1302,672,209800,28904
1198,1043,155,792,152600,28905
8837,7205,1632,717,172200,28906
426,367,59,-,145100,28909
703,575,128,725,79400,29001
2487,2049,438,643,79200,29003
3784,2778,1006,791,122000,29006
838,689,149,796,87300,29009
4371,3160,1211,728,77600,29010
577,502,75,431,129700,29014
722,598,124,592,125700,29015
9202,7332,1870,1017,265800,29016
1313,1052,261,587,99200,29018
8739,6727,2012,708,139500,29020
738,692,46,815,150800,29030
606,479,127,771,81300,29031
1987,1511,476,749,79200,29032
5703,3324,2379,966,124300,29033
9248,8638,610,1176,307300,29036
307,289,18,-,97800,29037
1029,863,166,709,87200,29038
1636,1233,403,904,57400,29039
4049,3032,1017,724,139000,29040
1273,750,523,699,74700,29042
2274,1886,388,573,103200,29044
10199,8161,2038,1064,167900,29045
60,60,0,-,-,29046
1593,1275,318,658,100300,29047
2261,1783,478,660,115100,29048
199,188,11,-,112500,29051
565,485,80,1068,61800,29052
7430,5099,2331,895,86400,29053
3726,3382,344,797,172400,29054
1567,1342,225,763,69800,29055
901,703,198,603,65300,29056
1481,1097,384,597,119000,29058
2293,1698,595,694,80000,29059
5007,3655,1352,1124,114500,29061
61,53,8,-,-,29062
14600,11934,2666,1274,176900,29063
167,125,42,-,110600,29065
3551,2589,962,771,87200,29067
2041,1566,475,640,85000,29069
6006,4989,1017,763,147300,29070
23028,19050,3978,1079,235500,29072
17813,14362,3451,869,146200,29073
113,103,10,-,299000,29074
1082,1023,59,675,201300,29075
6122,5229,893,806,144800,29078
10,10,0,-,-,29079
972,728,244,509,76300,29080
530,451,79,-,72700,29081
241,237,4,-,59400,29082
1118,930,188,702,73100,29101
6690,5163,1527,617,126900,29102
576,378,198,739,76200,29104
461,357,104,734,58800,29105
1091,898,193,722,56300,29107
8300,5419,2881,786,106500,29108
542,448,94,631,136400,29111
1740,1442,298,690,66400,29112
613,503,110,700,61600,29113
722,613,109,858,79800,29114
10469,5288,5181,672,86300,29115
0,0,0,-,-,29117
6117,4088,2029,746,145600,29118
26,16,10,-,-,29122
2601,2088,513,648,107600,29123
1173,909,264,515,84100,29125
858,800,58,988,158200,29126
3375,2786,589,769,180600,29127
1903,1449,454,747,87900,29128
1726,1394,332,668,111600,29129
3087,2501,586,759,196700,29130
411,271,140,817,96000,29133
3588,2775,813,638,98500,29135
873,726,147,491,91600,29137
3870,2796,1074,587,75600,29138
1995,1528,467,838,117100,29142
241,228,13,-,-,29145
511,415,96,627,81800,29146
0,0,0,-,-,29147
2746,2147,599,551,83400,29148
15187,8649,6538,759,107900,29150
780,0,780,1165,-,29152
6424,4513,1911,931,96200,29153
11050,7779,3271,831,139500,29154
3028,2346,682,742,88400,29160
4539,3344,1195,762,98400,29161
1152,788,364,659,115800,29162
485,352,133,622,70000,29163
2098,1563,535,631,122000,29164
268,232,36,588,112100,29166
1499,1051,448,909,81000,29168
10884,5822,5062,868,158800,29169
8656,6589,2067,878,140100,29170
4190,2902,1288,850,132700,29172
165,130,35,-,85200,29175
1422,1157,265,775,64400,29178
5442,3961,1481,715,92500,29180
8308,2253,6055,1039,177600,29201
236,113,123,1654,265300,29202
15589,7370,8219,892,94200,29203
6745,3965,2780,853,134900,29204
10679,5576,5103,870,261400,29205
8046,5372,2674,1172,259500,29206
5,5,0,-,-,29207
0,0,0,-,-,29208
13981,8515,5466,1049,148800,29209
16332,6222,10110,904,140800,29210
11969,8289,3680,1085,169900,29212
21404,11793,9611,1015,156400,29223
0,0,0,-,-,29225
18444,12994,5450,1465,169200,29229
13277,7508,5769,898,148600,29301
6901,4969,1932,866,168600,29302
9078,4306,4772,754,112400,29303
7175,3333,3842,742,110700,29306
8057,5183,2874,861,155600,29307
10237,7987,2250,870,160500,29316
168,127,41,-,66600,29320
1135,842,293,746,64500,29321
3502,2982,520,751,160600,29322
5392,4635,757,693,134000,29323
79,37,42,-,-,29324
5310,3639,1671,775,108100,29325
89,62,27,-,33400,29329
3307,2413,894,771,99800,29330
82,82,0,-,73700,29331
1078,893,185,711,72100,29332
207,135,72,845,-,29333
5067,3596,1471,1012,208600,29334
2064,1566,498,384,85500,29335
16,16,0,-,-,29338
7539,5584,1955,629,82200,29340
7885,5234,2651,776,133100,29341
120,83,37,-,81000,29346
12725,10719,2006,797,165200,29349
456,331,125,543,75300,29351
1715,1386,329,624,98200,29353
270,240,30,-,57900,29355
3534,2761,773,605,170900,29356
8055,5106,2949,746,112600,29360
236,170,66,688,43100,29364
3833,3267,566,980,163700,29365
56,56,0,-,-,29368
5627,5005,622,1068,172400,29369
310,226,84,-,92200,29370
1845,1534,311,617,86800,29372
119,82,37,1299,37500,29373
1280,1003,277,747,151200,29374
35,16,19,890,-,29375
2644,2296,348,887,165400,29376
223,75,148,624,80900,29377
17,0,17,-,-,29378
7661,4691,2970,700,80500,29379
1628,1457,171,686,111800,29384
2818,2063,755,845,145100,29385
6808,5414,1394,650,176000,29388
3936,2194,1742,1391,1074400,29401
8811,3321,5490,1387,434600,29403
495,0,495,1638,-,29404
10735,4678,6057,967,148400,29405
12722,5267,7455,986,166300,29406
15654,8950,6704,1132,313800,29407
9,4,5,-,-,29409
9537,6408,3129,1108,249000,29410
16315,11419,4896,1456,345100,29412
17198,10652,6546,1321,278500,29414
10353,5657,4696,1063,159600,29418
8537,5594,2943,1240,224600,29420
0,0,0,-,-,29423
30,0,30,-,-,29424
535,461,74,886,239900,29426
1484,1402,82,948,355700,29429
2634,2120,514,738,151400,29431
1199,744,455,-,69500,29432
307,283,24,-,-,29434
1548,1206,342,818,120000,29435
1806,1329,477,758,90100,29436
934,764,170,679,115800,29437
1213,1085,128,1085,383800,29438
1126,692,434,961,642900,29439
10345,8025,2320,842,126700,29440
20533,14189,6344,1224,183700,29445
423,398,25,-,53500,29446
792,558,234,915,135400,29448
2923,2427,496,713,214800,29449
1108,951,157,678,147600,29450
1945,1723,222,2083,817600,29451
92,92,0,-,86100,29452
449,239,210,938,-,29453
9615,8062,1553,1300,375900,29455
11910,7326,4584,1199,182600,29456
1007,815,192,987,143800,29458
14573,11608,2965,949,205100,29461
23516,15037,8479,1657,482600,29464
14632,12322,2310,1724,456400,29466
934,547,387,554,69600,29468
458,439,19,-,270100,29469
1664,1220,444,922,229600,29470
571,405,166,856,132000,29471
2918,2461,457,1009,160000,29472
915,657,258,486,95500,29474
1069,932,137,-,72100,29475
3027,2419,608,790,101200,29477
2622,1922,700,667,86400,29479
595,498,97,1121,60000,29481
780,646,134,1896,1895200,29482
31909,24175,7734,1099,219000,29483
21548,14679,6869,1178,226200,29485
1030,904,126,1164,325900,29487
8437,5680,2757,656,100500,29488
5756,3676,2080,1501,572500,29492
55,44,11,-,77300,29493
18599,11508,7091,801,169300,29501
9887,6783,3104,901,152600,29505
6863,3903,2960,693,93500,29506
3702,2896,806,701,81600,29510
2130,1712,418,807,171900,29511
6050,3713,2337,604,75100,29512
244,206,38,798,42600,29516
512,339,173,639,69900,29518
144,102,42,-,-,29519
5675,3748,1927,731,98300,29520
766,528,238,527,80000,29525
17088,12155,4933,874,168100,29526
9693,7298,2395,816,152100,29527
898,685,213,580,136700,29530
7918,5094,2824,697,100600,29532
6128,3248,2880,594,86300,29536
1699,1298,401,698,58900,29540
3285,2743,542,857,143500,29541
202,169,33,-,135300,29543
2063,1576,487,766,164700,29544
645,388,257,607,92000,29545
1049,749,300,553,88600,29546
958,623,335,670,82700,29547
12476,8841,3635,674,114500,29550
3829,2674,1155,854,80300,29554
1964,1465,499,553,109300,29555
4889,3270,1619,622,71500,29556
5471,3404,2067,650,83100,29560
912,549,363,558,90300,29563
431,313,118,739,132100,29564
2774,1839,935,658,68500,29565
8566,7000,1566,949,178700,29566
154,121,33,650,42700,29567
6651,5467,1184,1125,173900,29568
6433,4607,1826,693,117600,29569
1193,707,486,446,59500,29570
5263,2912,2351,590,84900,29571
4827,3691,1136,984,255400,29572
3850,2646,1204,563,85000,29574
8387,6354,2033,1125,214600,29575
15774,13522,2252,1138,230300,29576
13712,7735,5977,921,187900,29577
16891,11417,5474,1145,220200,29579
533,417,116,680,80200,29580
1637,1378,259,663,81800,29581
8137,6313,1824,1090,272100,29582
2073,1595,478,655,85300,29583
867,702,165,790,-,29584
7435,6201,1234,1163,342100,29585
18732,14180,4552,993,184800,29588
986,757,229,753,68600,29590
1873,1327,546,591,53800,29591
242,156,86,532,49000,29592
816,522,294,695,80900,29593
109,30,79,-,83300,29594
1010,829,181,-,79300,29596
6093,2028,4065,1082,419800,29601
15074,9918,5156,876,169500,29605
18134,8948,9186,1047,232100,29607
13024,8001,5023,861,212200,29609
11699,6250,5449,828,112800,29611
0,0,0,-,-,29613
4,0,4,-,-,29614
17148,8843,8305,996,257800,29615
10823,6865,3958,814,150700,29617
4841,3683,1158,700,116700,29620
16706,11772,4934,845,178200,29621
6272,3039,3233,652,68300,29624
12034,8175,3859,798,141500,29625
5314,4218,1096,837,117100,29626
6641,5088,1553,772,113400,29627
1104,664,440,541,59500,29628
7137,3150,3987,763,148900,29630
6261,2765,3496,981,267600,29631
24,0,24,650,-,29634
473,445,28,-,174700,29635
1298,984,314,683,109500,29638
538,368,170,732,153800,29639
11876,8298,3578,800,145400,29640
12988,10897,2091,758,198000,29642
1008,901,107,829,300200,29643
7723,5744,1979,856,157500,29644
4310,3442,868,834,120600,29645
11045,6397,4648,716,116300,29646
10782,6321,4461,780,159600,29649
13365,9789,3576,1158,255200,29650
18774,14848,3926,829,188700,29651
1783,1448,335,807,106500,29653
3679,2926,753,724,96200,29654
2844,2368,476,674,92900,29655
5977,5132,845,788,126100,29657
184,184,0,-,-,29658
73,57,16,-,546400,29659
2260,2015,245,689,119000,29661
6495,4219,2276,1072,166200,29662
848,718,130,543,175300,29664
49,25,24,-,54400,29665
2526,1995,531,697,116000,29666
93,78,15,938,122200,29667
5101,4042,1059,716,137800,29669
4168,2943,1225,875,168200,29670
6890,5382,1508,716,147700,29671
5331,4129,1202,824,311700,29672
11070,8053,3017,850,163700,29673
2420,2238,182,1639,294800,29676
9739,6370,3369,785,152000,29678
11209,8743,2466,1187,197400,29680
21813,18969,2844,1215,243400,29681
1561,1393,168,644,127700,29682
173,153,20,-,94500,29683
1939,1561,378,703,127500,29684
785,753,32,-,299000,29685
395,252,143,664,172500,29686
15711,12380,3331,936,180400,29687
1720,1312,408,686,233200,29689
8468,6817,1651,789,190900,29690
4614,3366,1248,637,131100,29691
2193,1601,592,700,74700,29692
5770,4083,1687,760,122600,29693
2042,1614,428,850,208600,29696
5425,3922,1503,809,134800,29697
3520,2513,1007,649,87400,29702
1208,1046,162,-,150700,29704
7932,5848,2084,648,93200,29706
13427,12462,965,1459,324100,29707
14227,11067,3160,1192,343700,29708
2760,2210,550,668,75300,29709
13934,10775,3159,1042,233800,29710
887,797,90,925,154200,29712
1168,993,175,882,124900,29714
12693,10269,2424,1172,281900,29715
560,513,47,-,118000,29717
1412,1076,336,506,100500,29718
17980,13186,4794,733,143200,29720
0,0,0,-,-,29724
653,470,183,696,171600,29726
896,565,331,400,76600,29727
3618,2006,1612,746,94800,29728
872,725,147,804,90600,29729
22798,12916,9882,984,157100,29730
23042,16308,6734,1023,200400,29732
0,0,0,-,-,29733
966,866,100,850,76600,29741
1085,945,140,856,120700,29742
560,405,155,714,230500,29743
12786,10139,2647,764,166800,29745
11294,6820,4474,875,124400,29801
15950,12946,3004,947,207400,29803
2159,1923,236,798,178300,29805
1223,903,320,731,98500,29809
1917,1248,669,623,44900,29810
4354,3326,1028,653,86200,29812
415,167,248,700,55800,29816
1745,1412,333,747,72500,29817
634,520,114,544,57500,29819
557,427,130,678,107800,29821
2661,1981,680,643,105500,29824
148,124,24,406,-,29826
1257,902,355,669,52200,29827
274,170,104,591,64300,29828
4146,3124,1022,952,170000,29829
2060,1631,429,498,101700,29831
2168,1347,821,622,104400,29832
716,420,296,882,42900,29834
2936,2182,754,808,140100,29835
130,116,14,-,29800,29836
191,180,11,-,-,29838
172,172,0,-,71600,29840
13623,9015,4608,798,150800,29841
2951,2204,747,715,89100,29842
536,450,86,775,99700,29843
76,67,9,-,-,29844
389,322,67,682,67200,29845
1613,1268,345,785,122600,29847
322,290,32,473,97300,29848
122,54,68,586,-,29849
48,31,17,-,-,29850
2831,2176,655,788,94800,29851
2711,1692,1019,653,104300,29853
1160,1040,120,-,121000,29856
6337,5514,823,891,200700,29860
0,0,0,-,-,29899
5766,3679,2087,1077,207600,29902
0,0,0,-,-,29904
9,0,9,-,-,29905
9492,4648,4844,1108,168700,29906
5464,4446,1018,1370,282800,29907
9675,8797,878,1545,310400,29909
16386,12371,4015,1442,302300,29910
504,389,115,803,76200,29911
0,0,0,-,-,29912
228,221,7,-,634900,29915
773,611,162,-,104400,29916
1546,1240,306,535,67000,29918
4352,3853,499,1118,259200,29920
148,126,22,492,71400,29921
330,312,18,-,41700,29922
99,70,29,750,64000,29923
1999,1456,543,570,114500,29924
11376,8952,2424,1282,450500,29926
3270,2096,1174,1166,161900,29927
7945,6745,1200,1490,598700,29928
350,286,64,911,73800,29929
64,46,18,-,82200,29932
227,144,83,850,-,29934
1806,499,1307,1171,224300,29935
5433,4019,1414,883,137400,29936
111,111,0,-,74200,29939
1659,1441,218,-,115000,29940
242,196,46,-,-,29941
155,155,0,-,-,29943
1382,941,441,641,67500,29944
2360,1837,523,792,50200,29945
2871,1500,1371,851,379000,30002
23681,18279,5402,1401,419600,30004
13492,9366,4126,1588,449300,30005
11441,6568,4873,1078,188400,30008
7142,4613,2529,1501,391900,30009
5418,4297,1121,1236,174100,30011
10714,6189,4525,1018,137400,30012
9289,5976,3313,1167,176900,30013
14140,8764,5376,950,182400,30014
18736,14017,4719,1197,150200,30016
7267,6161,1106,1303,292900,30017
14770,12218,2552,1753,260500,30019
6415,1327,5088,979,159200,30021
24092,17380,6712,1593,453900,30022
25938,21661,4277,1673,367400,30024
3704,3164,540,948,251500,30025
9972,8877,1095,1266,292800,30028
12359,7768,4591,1307,479500,30030
17202,8272,8930,1033,152400,30032
13607,8934,4673,1247,328800,30033
17239,11356,5883,1063,154500,30034
7746,3804,3942,1127,128600,30035
14190,7397,6793,1151,148500,30038
15238,12256,2982,1434,195000,30039
25317,20965,4352,1437,338800,30040
24438,20826,3612,1348,377600,30041
27655,19125,8530,1395,240000,30043
27771,18138,9633,1334,195900,30044
13580,11897,1683,1722,224200,30045
12872,6388,6484,1108,178800,30046
20946,15522,5424,1348,228300,30047
22797,18083,4714,1304,214500,30052
4181,3484,697,1071,170000,30054
1470,1277,193,957,199400,30055
802,682,120,819,157000,30056
20630,11753,8877,1190,139600,30058
13922,6320,7602,1054,178700,30060
23259,18427,4832,1401,350100,30062
18157,15222,2935,1204,313400,30064
21317,16368,4949,1449,275900,30066
19776,8084,11692,1226,371300,30067
12547,10800,1747,1235,432100,30068
148,71,77,683,75800,30070
8044,4299,3745,1225,204200,30071
395,213,182,1078,182500,30072
20979,17101,3878,1500,430100,30075
16461,10640,5821,1325,336700,30076
11890,9474,2416,1450,214800,30078
1379,502,877,1006,201000,30079
26436,12478,13958,1299,307100,30080
11156,7603,3553,1351,284300,30082
20950,9670,11280,1067,139300,30083
13865,9264,4601,1262,247500,30084
13925,11158,2767,1336,220400,30087
10527,5838,4689,1179,134700,30088
15265,7041,8224,1204,363200,30092
18837,5210,13627,1211,157400,30093
11179,8495,2684,1237,178400,30094
25874,10658,15216,1367,236200,30096
16577,11513,5064,1498,429700,30097
19448,15226,4222,1363,270000,30101
14542,10404,4138,1115,204200,30102
5426,4073,1353,921,156700,30103
1728,1196,532,800,122900,30104
787,593,194,483,176300,30105
8267,4396,3871,1135,167400,30106
5005,4393,612,1004,259800,30107
3175,2418,757,649,103700,30108
5454,3859,1595,694,172100,30110
2248,1765,483,823,122100,30113
20236,13544,6692,1250,285200,30114
14534,11918,2616,1281,304600,30115
9064,6916,2148,889,139300,30116
13053,7081,5972,843,162700,30117
0,0,0,-,-,30118
14015,9071,4944,919,189300,30120
9507,5649,3858,965,179700,30121
10564,4900,5664,1165,151600,30122
1283,874,409,802,131200,30124
8749,5489,3260,705,120100,30125
15856,11663,4193,1196,248500,30126
23344,18833,4511,1406,205800,30127
15671,11814,3857,1164,225100,30132
14360,9201,5159,1040,163400,30134
22235,17383,4852,1241,179100,30135
743,528,215,868,155700,30137
1558,1138,420,900,93800,30139
9033,6881,2152,1213,173300,30141
8945,7074,1871,864,236600,30143
21262,12939,8323,1333,215500,30144
3224,2852,372,843,168600,30145
2171,1516,655,835,83900,30147
174,163,11,-,130000,30148
38,0,38,-,-,30149
15475,12261,3214,1294,293900,30152
6683,4107,2576,797,127900,30153
16677,13301,3376,1163,168200,30157
13618,8601,5017,764,139800,30161
0,0,0,-,-,30164
14835,8584,6251,792,154700,30165
8772,4048,4724,1057,157900,30168
1073,911,162,893,123000,30170
1048,837,211,1080,225000,30171
2165,1370,795,775,101800,30173
2025,1561,464,887,168700,30175
2967,1896,1071,716,103400,30176
599,526,73,549,180000,30177
1230,1024,206,724,175500,30178
5879,5022,857,951,142900,30179
12893,9054,3839,1136,166900,30180
1319,988,331,720,151900,30182
2280,1862,418,1283,267800,30183
2252,1926,326,831,175500,30184
1514,1256,258,928,91400,30185
2689,2266,423,885,182200,30187
24135,18956,5179,1377,268900,30188
14639,11220,3419,1444,260700,30189
4957,3541,1416,712,125300,30204
1167,1080,87,875,376300,30205
1211,1126,85,856,185700,30206
11825,6828,4997,1262,185100,30213
11166,9079,2087,1284,242100,30214
12373,10758,1615,1381,274900,30215
811,566,245,836,103700,30216
3821,2542,1279,676,117600,30217
742,712,30,870,142900,30218
2083,1510,573,1063,158400,30220
1693,943,750,500,86200,30222
14614,9089,5525,867,127600,30223
10214,6680,3534,936,155400,30224
13754,10280,3474,1227,173700,30228
3510,2124,1386,798,114300,30230
8167,5865,2302,878,160900,30233
658,566,92,1087,107400,30234
17112,8799,8313,1004,153500,30236
12606,7338,5268,1134,109900,30238
11033,6999,4034,814,163800,30240
8323,4192,4131,920,120200,30241
8821,7265,1556,1213,176600,30248
0,0,0,-,-,30250
716,474,242,738,150300,30251
14771,12628,2143,1345,238700,30252
19586,12215,7371,1185,189600,30253
825,692,133,1214,141300,30256
1508,1139,369,784,152300,30257
1151,941,210,1098,117300,30258
1322,1136,186,1085,261200,30259
7815,3630,4185,1081,108700,30260
22126,14425,7701,1068,193600,30263
13190,9954,3236,1359,233200,30265
3679,2477,1202,973,164100,30268
13883,10286,3597,1509,351200,30269
5263,3850,1413,1176,119400,30273
12260,5326,6934,1006,103700,30274
29,29,0,-,-,30275
6253,5552,701,1098,251100,30276
8226,7493,733,1248,255800,30277
26514,15074,11440,1159,164900,30281
29,17,12,986,94100,30284
219,183,36,-,73800,30285
8914,5548,3366,649,104200,30286
3561,2646,915,890,137100,30288
13,5,8,-,-,30289
3066,2676,390,1099,297300,30290
9722,3651,6071,999,136600,30291
1862,1593,269,804,178100,30292
1123,894,229,748,83900,30293
14660,11595,3065,1251,160900,30294
1557,1219,338,900,176300,30295
9393,6046,3347,1217,123400,30296
9701,3355,6346,907,76200,30297
1379,331,1048,1404,156500,30303
13088,7116,5972,1538,619300,30305
11453,6724,4729,1498,638400,30306
8993,5471,3522,1452,569100,30307
13182,4156,9026,1469,333500,30308
15622,7196,8426,1622,343600,30309
11733,5455,6278,968,203200,30310
14780,6298,8482,881,161000,30311
12704,4531,8173,1251,350900,30312
2640,1084,1556,1206,235300,30313
8136,2935,5201,881,138800,30314
13265,4552,8713,812,167900,30315
13867,8796,5071,1286,286000,30316
5951,4145,1806,1167,386000,30317
22893,8890,14003,1239,281200,30318
20604,11409,9195,1530,567300,30319
0,0,0,-,-,30322
15412,5558,9854,1446,399600,30324
4409,1555,2854,1852,435800,30326
9904,7679,2225,1713,831100,30327
17663,10341,7322,1500,430900,30328
11079,2914,8165,1403,343000,30329
24959,11962,12997,1082,177300,30331
0,0,0,-,-,30332
0,0,0,-,-,30334
346,9,337,-,-,30336
5490,1499,3991,890,210400,30337
14751,9363,5388,1455,466800,30338
13502,4030,9472,1441,361500,30339
10047,4505,5542,1152,224700,30340
12707,6159,6548,1323,344200,30341
13580,6778,6802,1424,637800,30342
13566,5813,7753,1068,155900,30344
10912,5188,5724,1415,407600,30345
3197,169,3028,1511,437500,30346
28684,16341,12343,992,156600,30349
18441,7663,10778,1270,451100,30350
6592,2707,3885,1057,153000,30354
5331,3194,2137,1224,302400,30360
2411,952,1459,1828,256000,30363
5043,2536,2507,642,73600,30401
761,576,185,670,113100,30410
1210,858,352,420,50700,30411
34,33,1,-,113400,30412
646,516,130,638,158800,30413
2677,1980,697,814,149400,30415
4035,2396,1639,637,98500,30417
555,410,145,345,78200,30420
1293,1002,291,545,76300,30421
91,44,47,660,160800,30423
467,419,48,-,87600,30425
314,247,67,686,-,30426
4235,2893,1342,611,114400,30427
589,411,178,-,69800,30428
34,19,15,-,-,30429
1803,1050,753,506,70500,30434
4400,2869,1531,586,71200,30436
25,25,0,-,267100,30438
4026,2301,1725,606,90800,30439
720,532,188,643,91400,30441
3178,2324,854,600,59700,30442
1075,715,360,547,87000,30445
496,406,90,753,112600,30446
23,17,6,-,-,30448
33,12,21,725,72000,30449
772,583,189,875,85000,30450
9,9,0,-,-,30451
584,433,151,841,99800,30452
2697,1581,1116,525,78500,30453
210,180,30,-,67700,30454
299,215,84,654,99700,30455
930,802,128,605,70800,30456
2078,1241,837,589,68300,30457
16023,6699,9324,791,147100,30458
0,0,0,-,-,30460
6111,3938,2173,866,167900,30461
31,10,21,704,90000,30464
4120,2876,1244,564,83200,30467
112,84,28,325,161500,30470
1616,1107,509,562,59800,30471
1002,808,194,1000,75600,30473
6089,3829,2260,613,114800,30474
0,0,0,-,-,30475
1013,627,386,545,71600,30477
10735,4671,6064,904,184900,30501
8440,4459,3981,1003,219500,30504
15768,12853,2915,1148,248800,30506
8361,5700,2661,942,164700,30507
2613,1883,730,571,127600,30510
1171,935,236,688,151400,30511
9533,7410,2123,685,203900,30512
5300,3543,1757,620,220200,30513
943,677,266,707,131300,30516
5483,4860,623,1282,277800,30517
17214,12974,4240,1246,251000,30518
15147,12030,3117,1610,248500,30519
1737,1345,392,740,113800,30520
1551,1166,385,698,117300,30521
660,607,53,566,298900,30522
5069,4248,821,718,193400,30523
3198,2227,971,740,187700,30525
1412,1201,211,1000,215700,30527
9343,6853,2490,842,174300,30528
4606,2721,1885,818,160500,30529
2780,1989,791,844,160500,30530
3746,2728,1018,800,146900,30531
9993,7111,2882,892,202700,30533
11368,9306,2062,998,233400,30534
2736,2131,605,839,157600,30535
3566,2588,978,850,217600,30536
845,505,340,1094,206700,30537
1114,980,134,692,122400,30538
7945,5715,2230,739,200000,30540
658,571,87,-,205800,30541
12254,9918,2336,1233,241000,30542
1589,1322,267,1059,156200,30543
433,297,136,642,227600,30545
3536,2827,709,791,243100,30546
1185,832,353,681,194200,30547
6839,5879,960,893,309700,30548
9056,7374,1682,866,221500,30549
694,632,62,850,189000,30552
3371,2377,994,615,157300,30553
3006,2167,839,838,161400,30554
1201,993,208,691,111300,30555
1976,1599,377,820,99300,30557
1839,1408,431,838,135200,30558
2011,1745,266,950,227700,30559
1980,1767,213,1139,169800,30560
433,306,127,838,114200,30562
1940,1767,173,802,154100,30563
1400,1115,285,796,215500,30564
1767,1438,329,850,137200,30565
2703,1861,842,999,153400,30566
1173,971,202,966,208400,30567
635,526,109,-,167300,30568
2010,1819,191,1104,206900,30571
428,359,69,817,172500,30572
66,47,19,493,-,30573
467,376,91,816,157100,30575
1028,832,196,-,211500,30576
8355,5908,2447,760,125300,30577
38,29,9,-,-,30581
1690,1420,270,707,224100,30582
9764,3598,6166,897,101500,30601
0,0,0,-,-,30602
16639,5512,11127,831,182300,30605
19002,8641,10361,907,251000,30606
3963,2389,1574,820,170500,30607
0,0,0,-,-,30609
686,559,127,959,163200,30619
4517,3910,607,1221,180300,30620
2116,1896,220,918,329700,30621
5193,3613,1580,1176,279300,30622
19,12,7,-,110000,30623
1069,827,242,621,74700,30624
1128,947,181,-,219300,30625
886,682,204,603,132900,30627
2217,1981,236,678,150700,30628
1893,1265,628,666,122500,30629
953,584,369,630,114200,30630
639,497,142,815,63600,30631
2906,2284,622,640,120200,30633
847,674,173,1004,85600,30634
6258,4405,1853,701,90400,30635
882,823,59,1109,220500,30641
5689,4401,1288,739,335300,30642
6229,4481,1748,698,162200,30643
2708,1808,900,802,158100,30646
1086,880,206,581,117700,30648
4521,3247,1274,892,238800,30650
8582,5393,3189,954,181100,30655
5755,4598,1157,1035,228800,30656
428,240,188,506,70000,30660
3288,2114,1174,668,120400,30662
1161,766,395,787,209400,30663
11,11,0,-,-,30664
54,48,6,-,64700,30665
3199,2426,773,1019,171500,30666
380,316,64,-,142400,30667
830,598,232,751,80200,30668
1114,807,307,774,80400,30669
2995,1920,1075,688,79300,30673
6612,5577,1035,995,277700,30677
471,397,74,810,117400,30678
15312,11426,3886,1018,168800,30680
2691,2043,648,813,162400,30683
14547,8877,5670,719,155400,30701
12208,8510,3698,686,129100,30705
6598,5254,1344,750,133100,30707
82,71,11,-,-,30708
2507,2005,502,811,175700,30710
1497,1225,272,701,87800,30711
9749,5672,4077,769,170900,30720
18206,11189,7017,718,123700,30721
1494,1221,273,775,151100,30725
0,0,0,-,-,30726
7702,5083,2619,657,110000,30728
662,573,89,723,95000,30730
970,672,298,709,134600,30731
771,643,128,1010,111400,30733
1273,953,320,819,162600,30734
2180,1754,426,858,135700,30735
15830,12942,2888,788,169200,30736
1448,1247,201,1299,139800,30738
2104,1636,468,960,156900,30739
3361,2899,462,800,156700,30740
11645,8008,3637,825,104500,30741
3210,1495,1715,633,120700,30742
335,270,65,921,114200,30746
5851,4014,1837,538,79100,30747
1159,943,216,852,288900,30750
40,40,0,-,-,30751
3478,2335,1143,664,122700,30752
2444,1771,673,619,78500,30753
3611,2669,942,719,127800,30755
25,17,8,-,-,30756
968,640,328,588,116100,30757
1843,1519,324,832,195200,30802
291,238,53,454,88800,30803
881,699,182,787,73100,30805
80,75,5,-,-,30807
1538,1228,310,818,87300,30808
15279,13063,2216,1496,263300,30809
742,489,253,618,88000,30810
0,0,0,-,-,30812
13707,10271,3436,1233,199600,30813
2960,2272,688,667,135100,30814
13850,9622,4228,1048,115000,30815
860,598,262,657,151600,30816
3196,2284,912,712,135400,30817
170,116,54,-,75000,30818
475,363,112,-,67700,30820
357,281,76,438,62300,30821
201,159,42,-,-,30822
499,333,166,623,76100,30823
6680,4360,2320,714,122300,30824
1652,1098,554,594,70400,30828
4412,3114,1298,721,116300,30830
1409,824,585,651,111200,30833
6744,1795,4949,683,71400,30901
277,277,0,-,210400,30903
10297,4674,5623,848,125900,30904
851,14,837,1390,-,30905
19849,10938,8911,896,87700,30906
18398,12984,5414,1065,166400,30907
16981,8576,8405,901,172500,30909
0,0,0,-,-,30912
819,564,255,458,63100,31001
1089,766,323,512,77500,31002
47,47,0,-,148200,31003
6327,5094,1233,1177,193400,31005
2086,1064,1022,695,88200,31006
399,321,78,228,76000,31007
7776,5581,2195,960,148600,31008
451,343,108,518,68700,31009
316,259,57,600,120800,31011
436,322,114,374,66900,31012
4432,3227,1205,616,97400,31014
7954,4406,3548,642,85300,31015
595,453,142,-,134000,31016
602,487,115,564,78800,31017
589,413,176,758,58100,31018
962,734,228,723,118400,31019
674,560,114,825,61500,31020
10062,5748,4314,603,133300,31021
603,444,159,672,125000,31022
5554,3662,1892,606,93200,31023
8850,6621,2229,808,161900,31024
541,541,0,-,252900,31025
3396,2149,1247,651,67500,31027
2197,1701,496,1052,144700,31028
6014,4583,1431,738,165500,31029
6219,3791,2428,676,106000,31030
2557,2004,553,672,87600,31031
5513,4306,1207,859,158900,31032
890,813,77,582,177200,31033
455,364,91,694,116700,31035
4111,2624,1487,729,117400,31036
902,726,176,764,81200,31037
327,304,23,-,151900,31038
0,0,0,-,-,31039
306,193,113,634,49400,31041
548,469,79,886,66700,31042
997,848,149,575,73200,31044
62,10,52,-,-,31045
1443,1380,63,-,171600,31046
5394,4547,847,1156,195900,31047
628,452,176,667,75000,31049
472,392,80,-,330000,31050
92,73,19,531,63900,31051
3019,2649,370,787,167800,31052
491,384,107,660,82100,31054
2086,1316,770,512,89500,31055
891,549,342,607,92600,31057
770,505,265,289,83200,31058
843,670,173,625,65800,31060
16091,9346,6745,716,130500,31061
0,0,0,-,-,31062
1853,1180,673,599,84300,31063
3648,2843,805,913,144100,31064
495,460,35,579,94800,31065
433,342,91,575,148400,31066
109,88,21,-,152000,31067
1442,847,595,539,45400,31068
7860,5556,2304,770,156400,31069
618,508,110,484,57900,31070
376,315,61,529,58200,31071
421,390,31,625,65900,31072
929,727,202,849,59500,31075
1192,977,215,-,83200,31076
541,420,121,567,76300,31077
1256,839,417,618,93200,31078
1097,818,279,673,68200,31079
11,11,0,-,-,31081
4178,2749,1429,687,97900,31082
117,84,33,500,61700,31083
26,26,0,-,-,31084
352,293,59,942,122200,31085
3140,2357,783,642,80600,31087
20968,13697,7271,990,149100,31088
1704,994,710,724,86900,31089
458,297,161,595,76200,31090
1475,1097,378,609,84100,31091
2417,1555,862,649,90600,31092
11106,5640,5466,801,97400,31093
321,298,23,-,96500,31094
2628,1883,745,493,69000,31096
583,514,69,729,137100,31097
1110,5,1105,1207,-,31098
3542,631,2911,663,115100,31201
12124,5607,6517,717,88400,31204
8730,3662,5068,763,69200,31206
0,0,0,-,-,31207
13459,7140,6319,959,200300,31210
6286,3517,2769,756,112300,31211
0,0,0,-,-,31213
6121,4985,1136,960,137500,31216
6057,4009,2048,749,73500,31217
6015,3906,2109,1064,160100,31220
2014,732,1282,685,112900,31301
3019,2007,1012,774,140000,31302
884,778,106,977,165700,31303
41,41,0,-,-,31304
2979,2342,637,678,138600,31305
404,371,33,-,250400,31307
2919,2367,552,1063,128400,31308
301,222,79,905,91000,31309
6893,5984,909,1156,166200,31312
16329,7623,8706,1025,134400,31313
0,0,0,-,-,31314
2542,0,2542,1287,-,31315
4300,2934,1366,795,144800,31316
110,99,11,-,126100,31318
3244,2357,887,958,149300,31320
2696,2050,646,782,135300,31321
10017,5562,4455,1349,215900,31322
652,547,105,754,84400,31323
9491,6557,2934,1603,276700,31324
8399,6022,2377,1011,187900,31326
54,54,0,-,-,31327
1498,1205,293,1217,548500,31328
3698,2598,1100,1014,150400,31329
3267,2768,499,1104,166400,31331
7751,2612,5139,1057,348700,31401
12328,5629,6699,1002,135800,31404
13815,7472,6343,1152,207900,31405
13361,8007,5354,1101,205000,31406
5401,3345,2056,1315,195600,31407
3238,1283,1955,866,130600,31408
44,0,44,-,-,31409
9744,7376,2368,1341,272800,31410
4332,3981,351,1464,547400,31411
4054,1557,2497,792,85700,31415
22670,11994,10676,1093,172400,31419
6404,3319,3085,661,83500,31501
7525,5448,2077,684,96100,31503
3179,2342,837,527,81500,31510
756,568,188,507,96300,31512
5899,4331,1568,568,85400,31513
5734,4363,1371,738,101500,31516
277,235,42,-,108800,31518
1472,1055,417,504,150900,31519
9107,3901,5206,784,104500,31520
7763,6286,1477,1341,392000,31522
5386,4529,857,956,181600,31523
0,0,0,-,-,31524
11240,6958,4282,979,153300,31525
636,495,141,1142,421400,31527
267,237,30,-,73600,31532
6400,3462,2938,623,113200,31533
4103,3155,948,682,102500,31535
3068,2114,954,520,86400,31537
4924,3162,1762,570,86100,31539
855,668,187,776,95800,31542
1793,1467,326,551,102600,31543
261,238,23,-,70000,31544
5891,3375,2516,658,122900,31545
2569,1804,765,740,114700,31546
54,0,54,1565,-,31547
7766,4911,2855,887,165400,31548
822,596,226,565,57500,31549
306,278,28,-,77700,31550
345,282,63,420,176100,31551
332,299,33,-,90600,31552
1746,1259,487,629,82500,31553
1735,1249,486,673,83100,31554
917,672,245,895,93500,31555
52,40,12,-,-,31556
1088,802,286,650,75600,31557
8507,4449,4058,1059,190100,31558
1075,768,307,621,105000,31560
59,59,0,-,-,31561
784,637,147,619,86800,31562
433,371,62,628,100200,31563
999,851,148,914,186300,31565
1363,1138,225,710,83000,31566
398,202,196,616,83400,31567
249,218,31,-,216700,31568
2145,1772,373,742,149200,31569
11999,5459,6540,703,84100,31601
13648,5743,7905,841,149900,31602
8666,5277,3389,1014,166900,31605
1219,948,271,748,108100,31606
4091,2703,1388,797,106400,31620
812,557,255,667,86000,31622
33,23,10,-,89000,31623
503,388,115,441,57600,31624
477,226,251,558,159000,31625
1428,962,466,823,118800,31626
102,65,37,775,77900,31627
365,274,91,1431,-,31629
235,189,46,686,69800,31630
243,190,53,560,71600,31631
4601,3685,916,1154,174500,31632
1881,1445,436,488,71700,31634
2558,1409,1149,698,113200,31635
4082,2497,1585,741,150300,31636
1093,890,203,659,85700,31637
605,465,140,631,64300,31638
4097,2606,1491,647,100000,31639
577,470,107,956,116300,31641
1501,1136,365,581,61700,31642
3580,2326,1254,584,95600,31643
1881,1220,661,761,123800,31645
1115,638,477,832,62300,31647
382,292,90,814,67800,31648
486,404,82,839,113300,31649
1484,1039,445,460,108800,31650
0,0,0,-,-,31698
0,0,0,-,-,31699
7366,2626,4740,664,86400,31701
10873,4980,5893,703,75400,31705
10432,4563,5869,841,111700,31707
6153,2979,3174,731,135100,31709
293,158,135,524,81900,31711
445,334,111,636,47100,31712
2383,1467,916,542,89900,31714
1105,929,176,707,79200,31716
3127,1927,1200,642,81100,31719
153,123,30,642,66500,31720
8202,5741,2461,964,175100,31721
190,148,42,578,58600,31722
3170,1814,1356,680,89400,31730
507,414,93,902,142100,31733
321,263,58,1346,180200,31735
1010,730,280,684,125300,31738
109,76,33,-,265500,31743
1162,640,522,588,86200,31744
77,56,21,417,40000,31747
1006,694,312,656,77400,31749
7063,4187,2876,680,92100,31750
423,421,2,-,99200,31756
4096,3093,1003,874,160400,31757
8507,6362,2145,924,153800,31763
735,671,64,950,151700,31764
1109,797,312,488,90700,31765
8158,4456,3702,647,104600,31768
2192,1445,747,617,65100,31771
215,202,13,-,154800,31772
1671,1292,379,803,160500,31773
2385,1465,920,558,74000,31774
1015,864,151,588,68400,31775
948,772,176,666,79700,31778
3239,2032,1207,647,99300,31779
737,554,183,834,84800,31780
686,450,236,810,81600,31781
453,402,51,516,101400,31783
319,231,88,629,83900,31784
622,395,227,616,155400,31787
3219,2112,1107,770,107600,31788
511,347,164,928,88400,31789
759,577,182,725,62500,31790
4565,3036,1529,722,96500,31791
9190,4770,4420,897,156700,31792
3075,2405,670,635,162000,31793
10457,5727,4730,664,105300,31794
681,525,156,794,67800,31795
549,407,142,649,127700,31796
295,222,73,-,58100,31798
1288,1188,100,842,117100,31801
2202,1499,703,544,122100,31803
2170,2058,112,-,252900,31804
1198,638,560,634,80200,31805
1813,1384,429,636,136200,31806
918,848,70,-,204300,31807
3115,2812,303,1200,227800,31808
104,84,20,496,-,31810
2030,1716,314,1082,223800,31811
292,245,47,-,87900,31812
44,44,0,-,"10,000-",31814
845,658,187,485,38400,31815
2285,1329,956,764,104900,31816
3978,3555,423,1375,276000,31820
68,68,0,-,-,31821
2354,1817,537,839,154000,31822
346,321,25,-,153500,31823
634,526,108,341,54800,31824
1005,764,241,731,70900,31825
879,537,342,755,119300,31826
1001,715,286,667,99300,31827
470,439,31,-,292200,31829
758,408,350,857,150200,31830
1159,1065,94,519,161300,31831
107,107,0,-,-,31832
2633,1979,654,625,135000,31833
521,436,85,482,84100,31836
3155,815,2340,678,148100,31901
6788,2113,4675,734,62100,31903
12847,6357,6490,874,167700,31904
3563,20,3543,1506,-,31905
8187,3558,4629,775,122700,31906
21633,12361,9272,944,113200,31907
14794,7375,7419,1079,159100,31909
11093,9552,1541,1464,278300,32003
2123,1756,367,689,97300,32008
1384,1211,173,861,141100,32009
5318,4566,752,818,169700,32011
7016,5917,1099,902,144300,32024
7959,4755,3204,851,126900,32025
0,0,0,-,-,32026
1924,1647,277,1446,199300,32033
16291,13404,2887,1059,353600,32034
3973,3318,655,778,115000,32038
2920,2580,340,851,118200,32040
10382,8140,2242,1002,198000,32043
822,475,347,1051,68200,32044
3550,2715,835,861,171200,32046
2147,1476,671,666,94900,32052
1463,1171,292,724,79600,32053
3497,2548,949,625,112100,32054
5914,3965,1949,780,108100,32055
1292,1009,283,841,118600,32058
1028,834,194,750,77800,32059
8456,6631,1825,706,116200,32060
116,103,13,-,190100,32061
582,569,13,-,138800,32062
4417,3115,1302,798,179100,32063
2450,1402,1048,725,96700,32064
12482,9773,2709,1201,202800,32065
1963,1525,438,622,98800,32066
19078,14720,4358,1189,168600,32068
1167,1016,151,631,106400,32071
59,59,0,-,-,32072
15094,9890,5204,1124,183700,32073
196,22,174,1551,-,32079
9976,7901,2075,1310,392100,32080
5476,4883,593,1974,419400,32081
11719,9467,2252,1447,546100,32082
574,388,186,841,115700,32083
13011,8998,4013,1062,214800,32084
11575,8814,2761,1176,246300,32086
1386,965,421,688,110100,32087
5900,3571,2329,756,107600,32091
13656,12015,1641,1775,298600,32092
693,570,123,828,103200,32094
4483,3699,784,1076,372000,32095
1189,897,292,594,94400,32096
6890,5523,1367,1315,208600,32097
980,827,153,1151,162500,32102
3123,2029,1094,843,123500,32110
2809,1936,873,627,107100,32112
2036,1524,512,-,89000,32113
13290,4405,8885,928,122500,32114
11249,5565,5684,1084,120000,32117
9111,5456,3655,1066,250700,32118
10033,5980,4053,1108,149600,32119
1934,1536,398,1627,242400,32124
12582,9372,3210,1124,211300,32127
8695,7279,1416,1609,278200,32128
10088,7019,3069,1185,175200,32129
1793,1462,331,1071,185900,32130
1832,1387,445,840,165800,32131
3887,3194,693,858,174300,32132
0,0,0,-,-,32133
3277,2902,375,659,87000,32134
3981,3218,763,1206,281100,32136
17568,14741,2827,1386,258600,32137
367,324,43,-,74700,32139
599,506,93,-,74800,32140
8633,7340,1293,1126,177400,32141
2016,1678,338,919,121300,32145
150,103,47,-,-,32147
4343,3188,1155,634,65700,32148
148,82,66,844,143000,32157
15819,12892,2927,1078,207600,32159
31260,29944,1316,1372,273400,32162
18365,12766,5599,1385,218300,32164
12310,9594,2716,1213,245300,32168
5840,4796,1044,1370,363100,32169
23090,18340,4750,1091,222000,32174
7165,5447,1718,1229,251500,32176
11092,7263,3829,778,112700,32177
3571,2886,685,824,104700,32179
1364,1103,261,933,136000,32180
1088,729,359,750,86300,32181
659,580,79,-,117100,32187
2674,1894,780,642,90800,32189
443,357,86,625,-,32190
514,400,114,834,204900,32193
1433,1269,164,1580,122100,32195
2265,202,2063,863,102900,32202
4123,993,3130,965,220000,32204
13859,6979,6880,942,178900,32205
6587,2889,3698,758,90300,32206
15566,7550,8016,935,175900,32207
12550,6749,5801,938,90600,32208
13824,6415,7409,783,63800,32209
24886,13127,11759,1000,144900,32210
13606,6552,7054,920,138800,32211
222,3,219,1706,-,32212
16152,7448,8704,1068,178900,32216
8595,4436,4159,928,224100,32217
22441,14266,8175,1118,182100,32218
4367,3754,613,918,123200,32219
4554,3919,635,970,155100,32220
10169,7657,2512,1301,171000,32221
4725,3662,1063,1235,214000,32222
9979,8378,1601,1229,275600,32223
14907,8693,6214,1303,323900,32224
19878,13252,6626,1352,237400,32225
5730,5130,600,1689,243100,32226
481,0,481,1728,-,32227
0,0,0,-,-,32228
10003,5795,4208,1194,313200,32233
2382,1889,493,782,119500,32234
22539,12630,9909,1152,141600,32244
21387,11478,9909,1222,206300,32246
12469,8716,3753,1494,378300,32250
5022,2511,2511,889,59900,32254
21791,8545,13246,1235,282700,32256
16015,10321,5694,1155,219600,32257
13967,9875,4092,1457,241200,32258
17407,15206,2201,1954,358800,32259
3143,2267,876,1262,427800,32266
12259,5783,6476,1041,183200,32277
13163,3813,9350,992,162000,32301
20933,10716,10217,1078,157900,32303
19099,2507,16592,955,104100,32304
7802,4814,2988,857,112200,32305
10547,5456,5091,1099,231600,32308
13089,10365,2724,1091,269200,32309
5797,2763,3034,842,94000,32310
8232,5337,2895,1236,221500,32311
12466,10624,1842,1298,312300,32312
5402,4888,514,1236,274700,32317
1832,1237,595,729,187100,32320
1721,1371,350,717,74100,32321
998,773,225,770,178900,32322
71,42,29,-,-,32323
1918,1232,686,705,62800,32324
10018,8474,1544,916,172300,32327
1553,1275,278,866,219300,32328
272,156,116,816,83800,32330
1757,1454,303,813,59200,32331
505,294,211,-,72600,32332
5116,4203,913,763,125000,32333
792,606,186,736,110300,32334
463,351,112,850,94700,32336
3923,2622,1301,701,108600,32340
1147,909,238,939,162200,32343
4963,3693,1270,767,148500,32344
776,627,149,1636,188100,32346
2583,2134,449,664,117200,32347
3761,2784,977,732,69100,32348
693,590,103,802,70900,32350
5934,3939,1995,600,86300,32351
2415,1910,505,834,89300,32352
167,139,28,925,306800,32355
0,0,0,-,-,32356
658,593,65,857,142400,32358
558,379,179,-,113500,32359
169,149,20,-,-,32361
0,0,0,-,-,32399
9662,4944,4718,869,146700,32401
441,0,441,1707,-,32403
15098,11112,3986,1004,166300,32404
13232,8132,5100,1109,185300,32405
4976,2814,2162,1489,236300,32407
8702,5833,2869,1100,257300,32408
3791,3369,422,921,153700,32409
507,378,129,1396,265300,32410
6558,4913,1645,1184,279500,32413
1162,1068,94,676,93600,32420
1592,1329,263,596,86500,32421
471,446,25,1702,123000,32423
2216,1642,574,521,101900,32424
4958,3615,1343,700,89800,32425
332,305,27,725,72200,32426
403,275,128,591,104200,32427
6066,4796,1270,698,124500,32428
364,264,100,-,152700,32430
1816,1371,445,658,113100,32431
0,0,0,-,-,32432
6875,5088,1787,813,97400,32433
2772,2000,772,813,149200,32435
310,204,106,619,107600,32437
1613,1515,98,481,75000,32438
4024,3163,861,1056,207100,32439
2106,1418,688,681,98100,32440
1513,1032,481,673,121000,32442
1236,939,297,675,92900,32443
7936,5610,2326,1312,225900,32444
472,307,165,690,98100,32445
4063,2741,1322,731,127400,32446
0,0,0,-,-,32447
3473,2334,1139,673,85700,32448
218,195,23,-,65600,32449
1663,1324,339,692,89600,32455
3619,2654,965,1159,233200,32456
7730,6110,1620,1609,408300,32459
1747,1235,512,764,96300,32460
16,16,0,-,-,32461
1462,1190,272,704,119700,32462
82,36,46,648,83000,32463
1609,1430,179,-,83800,32464
2516,1962,554,765,96000,32465
1808,1546,262,1316,118500,32466
4516,2106,2410,730,155800,32501
1555,795,760,1026,168600,32502
12484,8292,4192,952,175500,32503
8985,5437,3548,1070,187900,32504
11025,5111,5914,912,72200,32505
14283,8476,5807,1092,135300,32506
13631,8273,5358,963,172200,32507
543,0,543,1385,-,32508
0,0,0,-,-,32509
0,0,0,-,-,32511
17294,8438,8856,1066,155700,32514
14676,11680,2996,1108,147600,32526
4,4,0,-,-,32530
2404,2192,212,954,195100,32531
10553,8906,1647,994,186700,32533
6321,4114,2207,1074,120500,32534
1700,1137,563,675,72500,32535
8134,5450,2684,1100,203000,32536
10096,7681,2415,1016,180300,32539
8317,5459,2858,1622,381600,32541
842,0,842,1674,-,32542
379,0,379,1446,-,32544
14232,7246,6986,1083,203100,32547
9826,5769,4057,1006,206300,32548
3915,2763,1152,1609,400800,32550
4543,3586,957,1419,416800,32561
10520,8216,2304,1354,261600,32563
1100,1015,85,1103,146200,32564
2010,1623,387,986,117800,32565
14623,11677,2946,1419,256700,32566
1398,1082,316,574,120400,32567
1101,942,159,681,170000,32568
5001,3553,1448,1058,213500,32569
12776,8628,4148,1018,165200,32570
12965,10621,2344,980,193200,32571
1942,1744,198,876,139300,32577
12684,9670,3014,1389,296200,32578
4382,3085,1297,1266,321500,32579
1808,1171,637,1140,268500,32580
9608,7458,2150,1044,164100,32583
8200,2131,6069,865,189000,32601
1753,224,1529,982,252500,32603
10815,7920,2895,1244,210100,32605
10012,4768,5244,1212,237900,32606
12236,4145,8091,973,222200,32607
19909,8364,11545,1058,251900,32608
7160,3838,3322,953,115300,32609
26,0,26,-,-,32612
5430,4166,1264,1034,205400,32615
352,168,184,927,96200,32616
1662,1289,373,647,124000,32617
3383,2978,405,653,174500,32618
2032,1755,277,597,113200,32619
2061,1513,548,642,82100,32621
462,273,189,802,135400,32622
625,487,138,836,215500,32625
3686,2807,879,694,106400,32626
1524,1203,321,633,80100,32628
169,169,0,-,262200,32631
129,116,13,-,-,32639
4141,3465,676,827,116100,32640
5130,2854,2276,885,103400,32641
4094,3399,695,940,173900,32643
114,111,3,-,169300,32648
6106,4775,1331,948,202100,32653
5423,4362,1061,896,142500,32656
92,77,15,-,98800,32658
166,110,56,-,152100,32664
2737,2379,358,1125,164900,32666
1728,1360,368,855,256500,32667
2017,1751,266,1050,230200,32668
4854,4046,808,965,230000,32669
4361,3634,727,625,85900,32680
15,15,0,-,-,32681
103,80,23,-,-,32683
2301,1531,770,644,209600,32686
42,42,0,-,-,32692
4305,3372,933,713,115700,32693
1082,763,319,555,111300,32694
5139,4203,936,748,153600,32696
87,11,76,844,56900,32697
10808,5345,5463,1251,192500,32701
1099,624,475,2693,85500,32702
19623,12844,6779,1172,216900,32703
15680,10591,5089,1192,198700,32707
18514,14118,4396,1383,264700,32708
661,584,77,-,190600,32709
15684,12501,3183,1476,275200,32712
8366,6974,1392,1123,230400,32713
15224,7351,7873,1263,202900,32714
12430,8501,3929,926,207900,32720
14929,10854,4075,1053,191200,32724
16823,12974,3849,1198,173500,32725
9101,5908,3193,834,166400,32726
2809,1025,1784,1191,192700,32730
1868,1780,88,1058,335700,32732
1779,1393,386,1350,140600,32735
3690,3276,414,977,288100,32736
14966,11681,3285,1186,170800,32738
1241,1089,152,1089,189400,32744
19018,12034,6984,1523,318500,32746
9469,6778,2691,1314,258900,32750
8731,5709,3022,1395,317800,32751
4402,3897,505,931,199200,32754
11765,8450,3315,1086,236400,32757
1226,981,245,941,175700,32759
9473,5915,3558,1160,155600,32763
1150,1070,80,-,287400,32764
21663,15579,6084,1579,302300,32765
4925,4382,543,1948,384100,32766
1064,898,166,1044,97500,32767
20486,12812,7674,1198,241900,32771
11327,6239,5088,1167,167600,32773
4183,3638,545,1084,274000,32776
9974,7457,2517,988,159800,32778
11209,9083,2126,1586,352100,32779
15211,10953,4258,968,171200,32780
3962,2989,973,911,153000,32784
11187,7317,3870,1353,500300,32789
21236,10105,11131,1262,247600,32792
8208,6625,1583,961,161700,32796
1329,1281,48,-,104000,32798
7967,2057,5910,1400,348000,32801
9764,5287,4477,1410,302300,32803
8201,5481,2720,1321,355000,32804
7385,2899,4486,825,158100,32805
10922,6768,4154,1203,304500,32806
12012,5845,6167,1167,165600,32807
18603,7559,11044,1058,150900,32808
9457,4895,4562,1083,175900,32809
13410,7012,6398,1229,175600,32810
14402,3753,10649,1168,111300,32811
13889,7899,5990,1166,257500,32812
3417,1414,2003,1881,525600,32814
11083,6134,4949,1316,239000,32817
17456,10016,7440,1131,189000,32818
9814,5786,4028,1463,351300,32819
2992,2477,515,1432,312900,32820
8111,2632,5479,1419,226500,32821
22655,9272,13383,1247,154600,32822
13767,10106,3661,1518,246600,32824
19123,12544,6579,1329,235900,32825
8672,4309,4363,1194,180000,32826
3561,2150,1411,1838,289400,32827
23465,14616,8849,1581,305600,32828
6428,5145,1283,1568,238300,32829
0,0,0,-,-,32830
28,28,0,-,"10,000-",32831
10108,6876,3232,1747,349900,32832
3154,2509,645,1124,281500,32833
17323,7308,10015,1358,266700,32835
7117,4626,2491,1680,478500,32836
16191,9660,6531,1451,263600,32837
17392,4208,13184,1137,152500,32839
10658,4860,5798,1028,161800,32901
6165,5102,1063,1368,356700,32903
12791,10453,2338,1364,236700,32904
9379,5191,4188,1031,136400,32905
15617,12931,2686,1160,178200,32907
3785,3165,620,1138,163600,32908
10655,8987,1668,1129,186000,32909
5939,3517,2422,878,265300,32920
6982,3028,3954,835,112100,32922
487,0,487,1639,-,32925
8923,7259,1664,1020,191300,32926
10005,8706,1299,1067,178400,32927
7451,5339,2112,1247,346200,32931
7159,6347,812,1370,274000,32934
16797,9926,6871,1086,171400,32935
10881,8691,2190,1316,312900,32937
17828,14892,2936,1571,303200,32940
1559,982,577,794,115000,32948
954,906,48,-,353000,32949
1788,1637,151,1295,302400,32950
5928,5059,869,1385,364100,32951
8273,7039,1234,1015,313900,32952
9507,7156,2351,1104,291800,32953
15284,12110,3174,1358,247500,32955
12414,10264,2150,1137,198600,32958
9148,5540,3608,905,173300,32960
8723,7273,1450,995,157600,32962
7574,7073,501,1342,660300,32963
8559,6680,1879,1115,172700,32966
8009,6317,1692,959,255800,32967
4904,4592,312,1423,281300,32968
69,46,23,-,-,32970
5165,4910,255,821,108100,32976
167,113,54,2014,-,33001
6716,2990,3726,1230,225100,33004
18988,10265,8723,1280,223900,33009
15885,4798,11087,1072,269000,33010
25596,12510,13086,1223,253000,33012
9293,5403,3890,1171,278800,33013
14076,6194,7882,1323,303200,33014
22066,11157,10909,1484,286800,33015
15816,8503,7313,1399,224300,33016
15539,11640,3899,1678,298200,33018
6444,4765,1679,1620,486100,33019
18655,6320,12335,1159,233600,33020
18677,11883,6794,1394,302300,33021
20634,13816,6818,1308,242800,33023
23519,15339,8180,1426,271000,33024
26049,11964,14085,1468,249200,33025
11956,9740,2216,1660,287500,33026
24319,18806,5513,1455,316800,33027
8407,6436,1971,2185,412700,33028
12870,11297,1573,2508,422900,33029
9091,3404,5687,1055,257000,33030
2490,2185,305,1720,392000,33031
14559,8383,6176,1294,270400,33032
15906,8631,7275,1417,248500,33033
5056,1639,3417,1119,139900,33034
4533,2040,2493,1458,198800,33035
1592,1286,306,1427,810500,33036
4758,3575,1183,1691,490700,33037
138,138,0,-,324200,33039
14487,6452,8035,1814,630400,33040
2971,2285,686,1896,498200,33042
2063,1582,481,1703,376800,33043
4183,2229,1954,1352,559100,33050
321,261,60,1234,578900,33051
9518,4415,5103,990,189300,33054
10985,8509,2476,1303,222900,33055
10161,6895,3266,1367,213000,33056
13531,6883,6648,1171,245200,33060
12839,8798,4041,1438,375200,33062
24451,17341,7110,1413,208500,33063
21303,13220,8083,1388,215600,33064
18697,9750,8947,1438,291300,33065
8697,7216,1481,1325,144500,33066
8269,5946,2323,1783,457200,33067
17013,9876,7137,1493,199600,33068
10500,4818,5682,1354,178400,33069
2238,1601,637,1743,577400,33070
12985,8614,4371,1666,393200,33071
11776,6633,5143,1808,342800,33073
12372,10298,2074,2565,543300,33076
0,0,0,-,-,33101
213,200,13,-,"2,000,000+",33109
166,0,166,2220,-,33122
21716,5793,15923,1076,265500,33125
18035,6588,11447,1331,252100,33126
9800,2827,6973,1055,247900,33127
3461,157,3304,957,230800,33128
6680,2964,3716,2102,463100,33129
15856,1770,14086,1229,338500,33130
11265,3753,7512,2330,487100,33131
7631,2205,5426,2078,485800,33132
14081,7222,6859,1577,695500,33133
16297,8807,7490,1488,502400,33134
14278,3013,11265,1065,312700,33135
6497,789,5708,981,253100,33136
9900,2288,7612,1783,394400,33137
12053,5733,6320,1125,444500,33138
20559,6481,14078,1503,397900,33139
9002,5125,3877,1643,667500,33140
17387,5703,11684,1403,313100,33141
20142,5471,14671,966,207900,33142
12855,7297,5558,1459,575200,33143
9720,5463,4257,1392,318800,33144
11710,6095,5615,1462,396800,33145
4841,3404,1437,2255,919400,33146
13966,6372,7594,1095,169200,33147
4079,2834,1245,2584,1412800,33149
10221,2812,7409,944,245800,33150
5800,3471,2329,1736,663200,33154
14375,9812,4563,1657,378400,33155
11004,8100,2904,1739,868600,33156
19184,12910,6274,1245,340400,33157
1983,1893,90,2205,690000,33158
19405,10855,8550,1585,286200,33160
16822,6898,9924,1185,269900,33161
13541,7231,6310,1191,230800,33162
16649,11719,4930,1435,348100,33165
8592,4256,4336,1358,397000,33166
6140,3505,2635,1146,215700,33167
6353,4745,1608,1283,235100,33168
11984,6344,5640,1227,236200,33169
3680,2219,1461,1285,283900,33170
13754,6228,7526,1635,180000,33172
11056,7473,3583,1658,331500,33173
10902,5756,5146,1412,280600,33174
16670,12561,4109,1709,330200,33175
18160,11689,6471,1413,437900,33176
15423,11280,4143,1663,288400,33177
15834,7814,8020,2161,410400,33178
16919,9649,7270,1315,179100,33179
14121,8976,5145,1983,391400,33180
7768,3148,4620,1260,263100,33181
3985,3292,693,1820,354000,33182
12243,7772,4471,1603,281900,33183
6126,4600,1526,1653,273100,33184
8627,7073,1554,2311,381700,33185
21711,14598,7113,1768,321000,33186
5224,4532,692,2090,371000,33187
7813,4508,3305,1314,280300,33189
5053,2280,2773,1403,277200,33190
15108,9260,5848,1546,311300,33193
1712,1286,426,1946,372300,33194
15370,10490,4880,1847,355900,33196
8380,3581,4799,2000,530400,33301
8980,3435,5545,1327,434500,33304
6815,4411,2404,1394,418700,33305
1729,1213,516,1144,482200,33306
14957,10366,4591,1502,440400,33308
13517,8221,5296,1371,212700,33309
24216,10475,13741,1120,185500,33311
18201,10854,7347,1334,276100,33312
20084,8614,11470,1225,150700,33313
9195,3596,5599,1608,199100,33314
5778,3277,2501,1409,335400,33315
5042,3138,1904,1346,635100,33316
12453,9594,2859,1463,323700,33317
19166,12353,6813,1305,160700,33319
19943,14837,5106,1511,189900,33321
17901,15079,2822,1778,165500,33322
7576,5388,2188,1976,351900,33323
19331,11006,8325,1713,256700,33324
9933,7601,2332,1671,315600,33325
10632,7427,3205,1893,404300,33326
6681,5139,1542,2647,580000,33327
10179,8005,2174,1694,388800,33328
4569,4167,402,2628,528300,33330
7357,6170,1187,2353,517800,33331
3395,3137,258,2585,643000,33332
12353,7190,5163,1247,321000,33334
11911,6455,5456,1519,244600,33351
12537,4515,8022,1432,275400,33401
4345,2051,2294,1195,228600,33403
10437,5731,4706,1197,186100,33404
7645,4385,3260,1198,294100,33405
8173,5348,2825,1309,229700,33406
11084,5094,5990,1221,201300,33407
9380,7330,2050,1532,378900,33408
10781,4576,6205,1336,186200,33409
14701,10519,4182,1696,354200,33410
25446,18570,6876,1547,295900,33411
5227,4293,934,1777,393500,33412
4993,3247,1746,1645,275000,33413
19720,14434,5286,1890,388500,33414
17195,9937,7258,1262,155400,33415
15284,8902,6382,1188,101500,33417
17185,13598,3587,1896,425600,33418
9760,5972,3788,1662,222400,33426
15030,10498,4532,1704,319000,33428
7219,2450,4769,631,114200,33430
8253,5356,2897,1860,418100,33431
10751,6607,4144,1765,661500,33432
18917,13350,5567,1902,308300,33433
10008,8096,1912,1203,260300,33434
13961,8246,5715,1546,204300,33435
18492,13540,4952,1493,258000,33436
18026,15567,2459,1526,303500,33437
87,72,15,-,131300,33438
6967,4893,2074,831,96300,33440
11166,5839,5327,1272,267500,33441
13835,9051,4784,1674,143800,33442
8807,4689,4118,1378,316900,33444
13922,9383,4539,1662,216600,33445
13280,11552,1728,1305,302500,33446
3765,3466,299,2244,477500,33449
9574,8104,1470,1056,276800,33455
21850,16052,5798,1661,381400,33458
10887,4625,6262,1116,230400,33460
14629,7058,7571,1260,172100,33461
12838,7994,4844,1292,237500,33462
18935,13236,5699,1379,231000,33463
20539,17613,2926,1373,308800,33467
6689,5938,751,1538,393600,33469
8669,7755,914,2057,363700,33470
2428,1891,537,664,69200,33471
7908,7391,517,2122,307900,33472
4249,3931,318,3215,593100,33473
2366,758,1608,619,112900,33476
7188,6188,1000,1814,428600,33477
4888,4794,94,1411,435000,33478
6065,5071,994,1702,903600,33480
6476,4400,2076,1894,634300,33483
14456,11446,3010,1384,156600,33484
9253,6913,2340,1678,468500,33486
9538,7208,2330,1883,415500,33487
795,435,360,929,91700,33493
9994,8480,1514,1910,391400,33496
5555,5098,457,2767,432900,33498
58,45,13,-,361100,33503
10857,6716,4141,1182,193400,33510
22334,11998,10336,1319,216600,33511
4094,3184,910,882,140300,33513
808,514,294,825,109700,33514
240,167,73,706,98500,33521
6460,4632,1828,824,153300,33523
6875,5003,1872,846,166100,33525
5037,3794,1243,797,228000,33527
5058,3603,1455,1009,203600,33534
2203,1733,470,819,109800,33538
4175,3338,837,763,89800,33540
9813,8019,1794,1091,76500,33541
10301,7287,3014,858,84100,33542
9822,8273,1549,1534,237000,33543
9689,6790,2899,1545,271600,33544
6634,4949,1685,1669,239000,33545
7704,6691,1013,1820,327000,33547
2718,2438,280,1589,384800,33548
6883,5549,1334,1239,239900,33549
8310,7459,851,1265,402600,33556
9168,6674,2494,1116,355300,33558
6871,3954,2917,1173,212000,33559
9967,5481,4486,976,142100,33563
6187,4923,1264,983,179900,33565
7342,5310,2032,1131,225700,33566
3868,3062,806,1082,215700,33567
10181,7921,2260,1423,233100,33569
9788,6937,2851,929,178000,33570
8239,6831,1408,1579,290000,33572
13440,10706,2734,1783,186700,33573
2212,2009,203,1021,216600,33576
20742,11180,9562,1352,213100,33578
12030,9040,2990,1693,240100,33579
9440,7219,2221,1102,189500,33584
411,289,122,850,179500,33585
3963,2612,1351,861,146500,33592
13214,10259,2955,1372,201800,33594
10047,8394,1653,1826,288000,33596
2987,2411,576,813,113600,33597
6726,5573,1153,835,251500,33598
8599,3097,5502,1656,368100,33602
8753,4978,3775,1037,226700,33603
15811,8710,7101,1000,174300,33604
7585,2755,4830,967,134100,33605
8894,3861,5033,1576,581700,33606
10932,4519,6413,1374,190200,33607
8497,5134,3363,1278,382500,33609
16771,7756,9015,1060,136800,33610
16269,9213,7056,1226,298700,33611
19021,6608,12413,991,160800,33612
14911,4292,10619,948,181000,33613
18229,7194,11035,1041,189000,33614
18028,9644,8384,1207,195900,33615
6265,2961,3304,1311,224100,33616
19281,7601,11680,1029,192500,33617
12100,8131,3969,1136,292500,33618
13347,6776,6571,1210,138300,33619
11,0,11,-,-,33620
538,0,538,2277,-,33621
15043,9636,5407,1321,255600,33624
11232,7673,3559,1426,262300,33625
11059,7674,3385,1590,370600,33626
10441,8230,2211,1373,590600,33629
7544,4314,3230,1343,187600,33634
7240,4621,2619,1411,216500,33635
7071,3085,3986,1148,167400,33637
25565,14396,11169,1435,309100,33647
9120,3429,5691,1097,380500,33701
14139,9392,4747,1091,195200,33702
11120,8942,2178,1331,270200,33703
8038,5780,2258,1015,432900,33704
11210,6537,4673,1126,196700,33705
8805,6601,2204,1176,445300,33706
12512,8470,4042,1097,236400,33707
7929,5872,2057,1521,350700,33708
10305,7620,2685,1064,138500,33709
14369,11316,3053,1231,208900,33710
6410,3898,2512,1200,177400,33711
9178,5122,4056,1110,201700,33712
13782,9789,3993,1038,182100,33713
7926,5047,2879,1059,113900,33714
3794,3402,392,2309,383000,33715
9360,1821,7539,1339,214400,33716
0,0,0,-,-,33744
9977,5451,4526,1019,206100,33755
13230,7714,5516,1027,212900,33756
7820,4218,3602,1428,188600,33759
7162,3193,3969,1140,154800,33760
8736,6975,1761,1284,188200,33761
2633,2014,619,1408,245400,33762
9403,6619,2784,1158,144700,33763
11852,8328,3524,1297,222500,33764
6372,3571,2801,1117,216500,33765
4049,3185,864,1750,526100,33767
11561,6987,4574,1092,168500,33770
13316,7768,5548,1112,83400,33771
9801,7225,2576,1152,224100,33772
6831,5160,1671,1079,192300,33773
7988,6124,1864,1104,243700,33774
4805,4366,439,1534,313900,33776
6956,5664,1292,1515,208600,33777
6218,5032,1186,1062,174900,33778
9974,6263,3711,938,164500,33781
9273,6730,2543,1306,173700,33782
2874,2125,749,1240,477900,33785
731,648,83,2288,709400,33786
11736,5884,5852,881,90000,33801
11867,7239,4628,1088,170900,33803
9236,4262,4974,996,107800,33805
11094,7405,3689,1140,171900,33809
17958,13762,4196,1116,168600,33810
8064,6215,1849,1103,200100,33811
4216,3343,873,1234,203500,33812
12939,10241,2698,1270,245600,33813
5693,3269,2424,844,22700,33815
11571,8119,3452,809,155600,33823
9629,6825,2804,744,107800,33825
955,865,90,1304,157100,33827
9829,6326,3503,820,154100,33830
1728,1163,565,766,81000,33834
10313,8183,2130,1405,209200,33837
1356,843,513,855,150400,33838
1063,765,298,870,130100,33839
3207,2396,811,783,107200,33841
3945,3278,667,794,68500,33843
13179,9111,4068,941,135100,33844
50,41,9,-,-,33847
172,119,53,917,58500,33848
196,167,29,-,88200,33849
3440,2354,1086,907,117800,33850
342,305,37,947,161800,33851
8826,7457,1369,829,143500,33852
4408,2194,2214,835,156800,33853
188,101,87,616,48200,33854
0,0,0,-,-,33855
251,8,243,533,-,33856
901,681,220,480,73400,33857
4325,3268,1057,886,149900,33859
8217,6114,2103,971,147900,33860
274,212,62,-,-,33865
95,95,0,-,85400,33867
3873,3302,571,944,128800,33868
8700,5619,3081,781,91100,33870
7062,5955,1107,898,118900,33872
4417,2791,1626,744,104000,33873
4883,3985,898,793,154900,33875
2282,1873,409,834,119200,33876
87,35,52,-,-,33877
13688,9127,4561,893,130700,33880
12482,8749,3733,909,95000,33881
12348,9206,3142,1152,198900,33884
1636,1224,412,765,91900,33890
4245,2157,2088,1632,217700,33896
7246,5219,2027,1674,200500,33897
6479,5300,1179,941,119200,33898
9036,3755,5281,1015,215100,33901
11394,9147,2247,911,102500,33903
13958,10784,3174,1212,246300,33904
12616,8458,4158,1170,168900,33905
10115,4271,5844,1173,170600,33907
18163,12864,5299,1431,271500,33908
10678,6892,3786,1368,191900,33909
8628,7378,1250,1428,283900,33912
9244,7834,1410,1480,314200,33913
16168,12765,3403,1235,289500,33914
9000,2906,6094,1044,121400,33916
13204,10711,2493,935,114500,33917
14049,10481,3568,1223,220500,33919
2288,2103,185,920,272100,33920
416,378,38,-,1155200,33921
1674,1452,222,988,229400,33922
31,31,0,-,-,33924
11815,10140,1675,1696,322000,33928
288,233,55,-,111800,33930
5537,5023,514,1192,373800,33931
7109,5146,1963,815,113100,33935
8319,5389,2930,996,142900,33936
138,138,0,-,-,33944
6,6,0,-,-,33945
1256,1132,124,-,512000,33946
4401,3651,750,1165,253500,33947
7315,6150,1165,1127,197700,33948
11367,9510,1857,1085,299400,33950
14495,10498,3997,983,159700,33952
2809,2637,172,1574,232300,33953
3777,2970,807,1340,220700,33954
4562,4163,399,1134,250000,33955
1737,1659,78,1260,235000,33956
3919,3359,560,1100,703800,33957
278,262,16,-,127800,33960
0,0,0,-,-,33965
4263,2894,1369,1248,284000,33966
8494,6379,2115,1374,241000,33967
7446,5570,1876,1272,181600,33971
4423,3247,1176,1210,190100,33972
4025,888,3137,1103,221200,33973
4909,2962,1947,1309,172900,33974
4541,3031,1510,1316,166700,33976
6101,4697,1404,897,161700,33980
5027,4437,590,1213,268300,33981
4187,3578,609,930,140300,33982
6232,5315,917,1047,250200,33983
12337,9069,3268,1335,223000,33990
8620,6903,1717,1690,262000,33991
9249,7874,1375,1575,226800,33993
0,0,0,-,-,34101
5743,3988,1755,1300,1007100,34102
5828,4754,1074,1482,781400,34103
10404,7143,3261,1367,262600,34104
7233,4519,2714,1658,486900,34105
8196,6818,1378,1520,744800,34108
11515,8012,3503,1476,415800,34109
11904,8909,2995,1641,400000,34110
12986,10343,2643,1145,234400,34112
8811,6221,2590,1444,307700,34113
7829,6530,1299,1318,303200,34114
9666,5199,4467,1310,266900,34116
5396,4591,805,1451,316800,34117
13192,10567,2625,1560,481000,34119
11617,10140,1477,1666,317800,34120
7772,6543,1229,1396,519000,34134
20275,16174,4101,1319,287800,34135
93,66,27,-,-,34137
367,306,61,-,-,34138
122,107,15,725,215000,34139
70,31,39,-,-,34140
12,4,8,-,-,34141
7532,3451,4081,790,203800,34142
9056,8042,1014,1507,669200,34145
1666,1551,115,1920,448400,34201
8812,6827,1985,1788,454200,34202
15615,11709,3906,1107,210100,34203
12775,7518,5257,1022,163100,34205
14983,9014,5969,1006,94900,34207
13429,7790,5639,1126,204300,34208
14763,11492,3271,1309,245300,34209
7293,4449,2844,1169,219600,34210
3972,3569,403,1700,428600,34211
7735,6302,1433,1622,362200,34212
299,287,12,-,817300,34215
607,572,35,-,911300,34216
2875,2366,509,1220,575600,34217
8600,7731,869,1718,292300,34219
17455,13644,3811,1175,198100,34221
5286,4264,1022,1108,120200,34222
9666,8096,1570,1074,254100,34223
7631,5994,1637,950,174200,34224
3939,3741,198,2208,724600,34228
3487,3011,476,-,509200,34229
15116,9861,5255,1245,278800,34231
14386,9944,4442,1464,237000,34232
8160,5745,2415,1477,250300,34233
8646,4890,3756,1045,154000,34234
6502,4986,1516,1439,241600,34235
7652,4713,2939,1325,697200,34236
7283,3573,3710,1203,174000,34237
10385,8173,2212,1684,385300,34238
6978,5086,1892,1388,300400,34239
4393,4285,108,2140,419200,34240
5870,5121,749,1722,351800,34241
3939,3429,510,2011,729500,34242
12873,9878,2995,1628,289200,34243
2151,1993,158,860,363400,34251
10112,6567,3545,741,90100,34266
114,72,42,-,-,34268
2195,1916,279,757,141400,34269
9529,7851,1678,1294,318600,34275
9832,7786,2046,1183,250200,34285
6801,5859,942,1595,198500,34286
11295,8700,2595,1124,160100,34287
4560,3830,730,1258,217700,34288
1238,732,506,1259,260800,34289
2332,1939,393,1379,227500,34291
7747,6265,1482,1455,321800,34292
20250,17857,2393,1382,265900,34293
7122,4771,2351,836,122100,34420
4057,3002,1055,679,198200,34428
3928,3402,526,887,150600,34429
3713,3126,587,769,128700,34431
5672,4996,676,858,147000,34432
2913,2613,300,930,157200,34433
3121,2647,474,1137,139900,34434
3821,3190,631,707,123300,34436
7327,6448,879,808,178100,34442
0,0,0,-,-,34445
7861,7054,807,892,143900,34446
4625,3684,941,823,101600,34448
1532,1146,386,470,88200,34449
5218,4004,1214,793,136000,34450
5197,4197,1000,897,127200,34452
4282,3597,685,847,108300,34453
4542,3829,713,874,197600,34461
7555,6158,1397,881,148400,34465
7989,4509,3480,910,122500,34470
10279,6149,4130,991,195900,34471
11106,8395,2711,983,124700,34472
7158,5767,1391,1062,161300,34473
7270,3377,3893,1134,147800,34474
4770,1967,2803,732,94200,34475
10605,9585,1020,945,162300,34476
5280,3302,1978,980,119300,34479
7864,5795,2069,855,196800,34480
11414,10099,1315,978,132100,34481
7091,5632,1459,822,166100,34482
1614,886,728,3248,221500,34484
4680,3370,1310,865,55800,34488
12738,11039,1699,947,181200,34491
249,181,68,1000,167500,34498
10043,7043,3000,839,100600,34601
2904,2572,332,944,164100,34602
4311,3736,575,889,184200,34604
11854,9089,2765,959,146700,34606
3841,3171,670,1120,226500,34607
14076,10434,3642,1059,151300,34608
16170,13100,3070,1173,182400,34609
5216,4171,1045,1020,170400,34610
8451,7309,1142,959,116700,34613
2642,2488,154,639,184100,34614
2521,2219,302,1403,255200,34637
9524,7787,1737,1669,275200,34638
10195,8446,1749,1446,263400,34639
10982,6687,4295,948,134400,34652
15210,9535,5675,1030,117200,34653
8980,6970,2010,1139,178300,34654
17882,14476,3406,1320,251000,34655
110,86,24,-,158300,34661
15736,11462,4274,966,147500,34667
20119,11948,8171,1022,102100,34668
5439,4448,991,1100,157300,34669
8566,6373,2193,1176,255700,34677
22,10,12,-,-,34679
298,298,0,-,474000,34681
13380,10301,3079,1277,293500,34683
13173,9332,3841,1439,196300,34684
7282,5664,1618,1375,359700,34685
3197,2847,350,1346,369400,34688
11823,9037,2786,918,225800,34689
5168,3354,1814,1053,83000,34690
8946,5642,3304,1020,107200,34691
7229,6042,1187,1281,285300,34695
18732,13120,5612,1108,218300,34698
1000,806,194,868,151900,34705
21279,16595,4684,1434,259600,34711
7638,3861,3777,1420,199200,34714
6747,5041,1706,1629,265600,34715
6983,5774,1209,967,187600,34731
1304,1061,243,1422,322700,34734
7531,6299,1232,1290,225900,34736
1200,959,241,1398,286800,34737
263,112,151,-,96000,34739
16278,5360,10918,1177,187800,34741
12257,8661,3596,1257,206600,34743
17975,12019,5956,1170,226700,34744
14223,10061,4162,1404,224800,34746
9160,4215,4945,1548,334000,34747
17561,12524,5037,940,162000,34748
1675,1238,437,965,165400,34753
1167,972,195,1140,320200,34756
11315,8409,2906,1292,186800,34758
12142,9146,2996,1346,203200,34759
255,216,39,1553,259500,34760
14030,9413,4617,1348,256800,34761
187,187,0,-,151500,34762
8603,5642,2961,1077,178600,34769
6618,5753,865,1210,318800,34771
9105,7584,1521,1370,248200,34772
1161,961,200,1792,214500,34773
15192,13057,2135,916,306800,34785
14966,10677,4289,1879,449000,34786
24677,17911,6766,1405,337000,34787
8422,7053,1369,1122,91000,34788
602,579,23,-,271000,34797
1466,1312,154,641,204800,34945
2565,1692,873,760,103600,34946
4057,1481,2576,951,139800,34947
4333,3423,910,1322,311600,34949
5977,2132,3845,918,96100,34950
7051,6051,1000,961,144700,34951
17668,12229,5439,1279,163000,34952
23064,19279,3785,1568,227900,34953
2393,1645,748,719,85600,34956
10713,7892,2821,1098,274200,34957
5994,4075,1919,851,136100,34972
10109,8150,1959,823,105500,34974
1621,1038,583,1193,257500,34981
10262,7724,2538,1030,144300,34982
14674,11659,3015,1395,195100,34983
5822,4758,1064,1557,222200,34984
11932,9672,2260,1660,275100,34986
4311,3275,1036,1728,285300,34987
11834,10556,1278,1720,405500,34990
7445,4504,2941,1187,188300,34994
5783,4815,968,1168,328300,34996
17886,14475,3411,1189,264900,34997
4677,3635,1042,964,165600,35004
3170,2524,646,889,103600,35005
1133,1061,72,-,79600,35006
9566,7826,1740,1096,172300,35007
8055,5566,2489,612,105900,35010
23,6,17,-,-,35013
1582,1466,116,1051,87900,35014
6319,4826,1493,606,151900,35016
829,666,163,596,112800,35019
10438,5745,4693,746,73700,35020
8492,6584,1908,898,185700,35022
8410,6281,2129,934,121000,35023
2630,1735,895,594,123900,35031
19,17,2,-,69400,35032
1145,1007,138,525,117800,35033
1702,1067,635,705,69800,35034
457,440,17,-,67400,35035
121,33,88,256,65000,35036
6379,5192,1187,1175,155900,35040
2185,1818,367,601,121800,35042
4103,3698,405,1099,244700,35043
3188,2011,1177,584,95800,35044
5759,4029,1730,685,124000,35045
1953,1594,359,740,130300,35046
1581,973,608,691,125500,35049
3208,2483,725,728,167500,35051
20,0,20,-,-,35052
854,808,46,807,222700,35053
1744,1556,188,1014,209800,35054
8367,5329,3038,752,139000,35055
5053,4176,877,746,153100,35057
3610,2721,889,764,126100,35058
84,84,0,-,97900,35060
479,310,169,947,150400,35061
3267,2632,635,693,124200,35062
1258,1149,109,779,79900,35063
4425,2417,2008,809,95100,35064
3645,2701,944,1028,162100,35068
106,98,8,-,108900,35070
5996,4562,1434,986,183400,35071
1808,1441,367,540,80200,35072
1063,752,311,853,92000,35073
43,0,43,-,-,35074
5624,3988,1636,669,123200,35077
787,685,102,792,167000,35078
3124,2961,163,809,158500,35079
6416,5996,420,1366,197400,35080
0,0,0,-,-,35082
1254,963,291,710,129700,35083
3216,2632,584,727,97100,35085
1069,866,203,898,106900,35087
691,597,94,768,86200,35089
1109,1056,53,859,209900,35091
5587,4381,1206,906,172400,35094
3113,2688,425,858,131100,35096
695,642,53,1101,134100,35097
415,363,52,-,154300,35098
6440,5814,626,1043,207500,35111
93,83,10,-,-,35112
2859,2532,327,1034,195100,35114
6198,4186,2012,706,132700,35115
1896,1674,222,938,178800,35116
1979,1768,211,706,160300,35117
1088,863,225,783,134800,35118
30,0,30,-,-,35119
5583,4612,971,746,161100,35120
6365,4231,2134,677,135300,35121
9645,8080,1565,1164,201700,35124
4412,2861,1551,905,154500,35125
7533,6398,1135,889,145500,35126
3668,3013,655,1099,157400,35127
4336,3377,959,887,183100,35128
1500,1233,267,470,100700,35130
1278,986,292,611,86500,35131
1229,1162,67,-,143100,35133
752,559,193,947,195100,35135
785,651,134,-,143600,35136
92,51,41,-,16100,35139
1201,1054,147,534,159700,35143
3695,3361,334,-,194300,35146
1970,1799,171,1401,196700,35147
972,696,276,575,114100,35148
125,81,44,-,103900,35149
7104,4485,2619,661,113300,35150
2823,2560,263,844,126700,35151
10312,6444,3868,588,103200,35160
1399,1165,234,-,120800,35171
1155,840,315,765,99500,35172
9574,8638,936,1157,258200,35173
2012,1697,315,636,150000,35175
311,188,123,697,-,35176
1277,1061,216,767,118600,35178
3101,2580,521,705,146100,35179
5003,4235,768,643,148400,35180
239,178,61,-,96700,35183
1635,1254,381,640,82600,35184
1988,1634,354,929,206700,35186
2,2,0,-,-,35187
715,547,168,641,128600,35188
1595,348,1247,670,262000,35203
4615,1885,2730,605,63200,35204
9978,2884,7094,852,200100,35205
6757,3393,3364,916,90200,35206
3506,1913,1593,627,64900,35207
5585,3286,2299,875,78000,35208
12445,6263,6182,1087,358000,35209
6025,4032,1993,912,158200,35210
11493,5183,6310,876,81300,35211
4430,1927,2503,583,146300,35212
5756,4437,1319,1440,558900,35213
7259,5204,2055,785,118700,35214
17816,9867,7949,870,111800,35215
14781,8154,6627,1096,286000,35216
5124,2923,2201,787,87900,35217
2868,1025,1843,823,63400,35218
1764,1125,639,834,67700,35221
4081,2310,1771,825,282100,35222
4140,3654,486,2031,579400,35223
2079,1171,908,819,67600,35224
13214,10383,2831,1279,293200,35226
3937,2430,1507,877,68500,35228
0,0,0,-,-,35229
1431,185,1246,1336,261200,35233
2254,1143,1111,621,57200,35234
8295,5577,2718,1082,124200,35235
22832,16191,6641,1142,364400,35242
7798,4281,3517,1327,361600,35243
11845,8605,3240,1149,295700,35244
134,50,84,685,-,35254
12191,4014,8177,780,114600,35401
7449,3864,3585,920,136000,35404
17462,9721,7741,886,176100,35405
6964,5475,1489,1066,376200,35406
355,325,30,-,61200,35441
1978,1351,627,498,87000,35442
754,548,206,570,53000,35443
1447,1218,229,733,124600,35444
579,489,90,817,76900,35446
1314,951,363,435,112600,35447
1198,1049,149,960,163800,35452
3937,3391,546,809,138400,35453
1472,1037,435,876,117700,35456
28,28,0,-,-,35457
135,83,52,-,167900,35458
392,273,119,658,61100,35459
360,330,30,-,92500,35460
906,856,50,-,152200,35461
1742,1127,615,527,95300,35462
727,653,74,-,157800,35463
283,103,180,418,-,35464
2036,1708,328,616,105000,35466
43,18,25,-,-,35469
1952,911,1041,705,130900,35470
6483,4270,2213,807,188000,35473
2251,1901,350,769,139500,35474
6129,5591,538,778,207500,35475
2675,1080,1595,810,143700,35476
54,54,0,-,-,35477
427,367,60,-,179000,35480
1451,957,494,394,90000,35481
1350,982,368,915,141000,35490
3591,2070,1521,665,112000,35501
3925,3112,813,672,128500,35503
4904,4037,867,659,162300,35504
961,809,152,473,86100,35540
1593,1371,222,716,132100,35541
337,320,17,-,80000,35542
499,329,170,592,61300,35543
311,162,149,768,46400,35544
40,38,2,-,-,35545
1431,1275,156,361,105100,35546
855,671,184,380,59200,35548
1567,1150,417,573,57400,35549
2195,1861,334,532,74700,35550
381,332,49,-,59900,35552
1655,1332,323,463,67900,35553
461,413,48,546,59700,35554
4131,2834,1297,543,102900,35555
17,8,9,-,-,35559
1634,1278,356,556,103100,35563
948,759,189,573,101600,35564
4891,3849,1042,570,60400,35565
4549,3171,1378,513,100200,35570
265,219,46,681,83800,35571
783,731,52,-,253800,35572
609,530,79,291,117400,35574
468,355,113,663,82000,35575
1227,1063,164,491,113700,35576
18,18,0,-,74400,35577
2256,1944,312,861,93200,35578
1315,1059,256,423,87600,35579
1462,1287,175,628,86300,35580
2012,1483,529,673,87100,35581
2002,1428,574,439,84300,35582
97,82,15,833,49500,35584
414,329,85,-,168800,35585
1541,1174,367,429,82300,35586
304,270,34,-,87300,35587
1949,1195,754,442,108000,35592
518,428,90,529,89600,35593
2469,1860,609,562,118700,35594
12167,7445,4722,690,103300,35601
13476,9667,3809,695,176600,35603
732,616,116,481,165000,35610
10290,6185,4105,641,135700,35611
7884,6932,952,962,202200,35613
2487,1978,509,768,132800,35614
33,0,33,-,-,35615
1459,972,487,680,97000,35616
813,556,257,475,81200,35618
1703,1362,341,690,130400,35619
3536,3050,486,878,141900,35620
1186,1054,132,944,109000,35621
2506,1857,649,770,104300,35622
15057,6514,8543,651,122000,35630
8236,7065,1171,786,141000,35633
3819,3155,664,875,198100,35634
9787,7721,2066,701,146400,35640
1450,1281,169,562,102400,35643
5259,4382,877,691,187000,35645
1859,1470,389,516,89200,35646
335,279,56,355,113800,35647
1164,953,211,561,117100,35648
23,23,0,-,350000,35649
5137,4156,981,523,130100,35650
537,420,117,728,-,35651
3653,3026,627,714,139300,35652
3370,2271,1099,683,92800,35653
3018,2116,902,544,133100,35654
4118,2373,1745,695,100500,35660
6932,5595,1337,780,154500,35661
2410,1876,534,628,127200,35670
1125,537,588,1258,81000,35671
1961,1495,466,568,106800,35672
2816,2182,634,611,124700,35673
7006,4890,2116,695,121300,35674
777,665,112,822,108800,35677
1916,1533,383,742,144100,35739
1553,1024,529,338,104200,35740
1817,1509,308,1038,264300,35741
669,535,134,-,111500,35744
74,65,9,-,162500,35745
299,266,33,-,-,35746
2259,1795,464,655,179000,35747
2523,2221,302,622,246900,35748
8303,7668,635,945,191700,35749
5183,4129,1054,866,139500,35750
82,82,0,-,165000,35751
981,756,225,839,78000,35752
2287,1685,602,611,160900,35754
203,148,55,-,385700,35755
4677,4178,499,1425,240600,35756
6261,5328,933,1299,230100,35757
19804,13602,6202,1023,252700,35758
3434,3218,216,1191,193200,35759
1619,1339,280,782,134500,35760
5023,4323,700,913,147000,35761
6565,5976,589,1484,273300,35763
275,214,61,580,77500,35764
1576,1353,223,592,112300,35765
69,47,22,-,-,35766
4602,3137,1465,549,103100,35768
3992,3153,839,671,150900,35769
1245,1002,243,639,114600,35771
1844,1386,458,626,84700,35772
5115,4128,987,914,130600,35773
63,63,0,-,-,35774
277,265,12,-,80300,35775
1382,1165,217,492,99800,35776
10085,6688,3397,936,295500,35801
10707,5842,4865,871,243200,35802
11424,9096,2328,997,189600,35803
8954,2515,6439,667,77300,35805
11621,5425,6196,1029,221600,35806
371,13,358,1371,-,35808
11487,7374,4113,896,87300,35810
10698,8305,2393,815,172800,35811
6701,1944,4757,710,90500,35816
4173,2286,1887,898,237900,35824
0,0,0,-,-,35896
7426,4742,2684,633,132400,35901
6926,4510,2416,676,114700,35903
5338,4066,1272,665,77200,35904
2283,1892,391,677,147300,35905
3746,2383,1363,846,164700,35906
3004,2693,311,951,158300,35907
7143,4495,2648,716,115500,35950
4241,3177,1064,603,112400,35951
3161,2384,777,622,97900,35952
2536,2060,476,1053,127100,35953
4568,3673,895,575,105200,35954
3091,2490,601,667,132800,35956
5649,3588,2061,589,96900,35957
1212,992,220,521,124000,35958
1872,1500,372,501,143300,35959
4074,3028,1046,652,158600,35960
2387,1652,735,550,90400,35961
3150,2317,833,700,121500,35962
518,371,147,-,111000,35963
1485,1261,224,685,122700,35966
6194,4406,1788,598,120500,35967
1506,1075,431,626,120200,35968
2299,1631,668,665,107500,35971
499,445,54,-,77600,35972
1224,1072,152,-,89000,35973
651,419,232,668,104500,35974
381,333,48,-,151100,35975
6810,5301,1509,641,189200,35976
1806,1475,331,809,96700,35978
450,409,41,-,135000,35979
1952,1583,369,631,112700,35980
667,482,185,579,95500,35981
1536,1310,226,595,155500,35983
833,629,204,803,159300,35984
3099,2278,821,593,145500,35986
938,759,179,632,105500,35987
872,622,250,547,85300,35988
1391,1109,282,586,94200,35989
41,39,2,-,-,35990
935,760,175,435,101900,36003
530,469,61,578,91700,36005
691,622,69,784,174200,36006
893,677,216,431,96800,36009
1594,1165,429,691,100700,36010
228,228,0,-,367300,36013
1630,1081,549,587,58100,36016
779,459,320,425,68700,36017
352,251,101,743,161000,36020
4590,3906,684,770,173600,36022
1874,1533,341,605,179500,36024
1314,894,420,972,149700,36025
475,436,39,1358,255100,36026
5804,3348,2456,597,112000,36027
621,402,219,524,104800,36028
285,239,46,-,-,36029
173,139,34,608,151500,36030
54,50,4,-,121400,36031
1000,728,272,-,62300,36032
1336,1074,262,589,93500,36033
324,287,37,542,57200,36034
632,565,67,745,103900,36035
764,665,99,667,116500,36036
4338,2982,1356,640,96300,36037
10,10,0,-,-,36038
54,33,21,-,-,36039
1562,1017,545,674,65500,36040
539,494,45,-,76200,36041
577,534,43,-,105700,36042
1353,1068,285,1048,152100,36043
485,458,27,-,88000,36046
466,422,44,-,70000,36047
629,478,151,567,70800,36048
1960,1474,486,576,82300,36049
907,756,151,893,84700,36051
290,276,14,-,710000,36052
729,548,181,568,72500,36053
5735,4071,1664,861,143600,36054
3635,3378,257,1456,310300,36064
8522,5133,3389,1128,186500,36066
10025,7645,2380,906,134400,36067
785,703,82,775,120600,36069
229,166,63,569,83100,36071
924,722,202,838,85700,36075
5213,3780,1433,717,142800,36078
3462,2825,637,794,140500,36079
737,601,136,-,191000,36080
6025,2785,3240,712,148100,36081
0,0,0,-,-,36082
3468,2063,1405,582,72100,36083
1287,692,595,675,91800,36088
2610,1849,761,569,80100,36089
1375,1080,295,716,71000,36091
8068,5951,2117,869,155300,36092
3735,3558,177,1080,256500,36093
3451,972,2479,694,86100,36104
4113,2474,1639,841,81800,36105
6031,3378,2653,956,157400,36106
3271,1228,2043,783,64700,36107
6609,3843,2766,638,64100,36108
10144,7115,3029,959,117600,36109
4062,2301,1761,856,62700,36110
4779,2780,1999,893,161800,36111
0,0,0,-,-,36112
287,0,287,1569,-,36113
266,0,266,1367,-,36115
17838,8622,9216,901,98600,36116
21914,12752,9162,1040,181900,36117
7313,4463,2850,621,66300,36201
6733,4675,2058,841,141400,36203
339,207,132,708,214000,36205
4055,2835,1220,805,97200,36206
8118,5957,2161,835,166800,36207
1698,1529,169,915,125200,36250
1847,1320,527,378,112400,36251
410,380,30,-,118300,36255
601,522,79,588,100500,36256
592,518,74,531,96500,36258
1539,1236,303,607,144400,36260
498,414,84,641,90900,36262
163,99,64,710,101400,36263
3179,2325,854,648,135600,36264
8209,5122,3087,647,144300,36265
2208,1631,577,570,126400,36266
12,12,0,-,-,36267
2280,1977,303,763,97300,36268
654,498,156,810,114200,36269
2280,1988,292,738,87800,36271
5210,3983,1227,612,90200,36272
1303,1110,193,665,106600,36273
4220,3259,961,619,91800,36274
917,732,185,567,69800,36276
1981,1598,383,841,109000,36277
1794,1441,353,635,170400,36278
1039,900,139,933,133500,36279
1621,1343,278,785,149200,36280
14687,8940,5747,745,122900,36301
11620,7029,4591,727,145300,36303
6209,4351,1858,986,183200,36305
2542,1905,637,542,94600,36310
966,777,189,585,76500,36311
2331,1727,604,708,128000,36312
114,95,19,-,158800,36313
237,208,29,516,59000,36314
816,701,115,675,155400,36316
313,269,44,-,92300,36317
494,440,54,588,106000,36318
848,700,148,770,89800,36319
1291,1035,256,675,94400,36320
691,563,128,758,150700,36321
3922,2180,1742,663,105700,36322
2990,2234,756,627,83900,36323
14439,9121,5318,846,169200,36330
2333,1760,573,598,103500,36340
503,428,75,830,86300,36343
2180,1516,664,680,146500,36344
3128,2695,433,831,145100,36345
576,525,51,688,97000,36346
2691,1654,1037,705,130300,36350
1337,1057,280,743,124900,36351
1766,1488,278,674,177300,36352
591,530,61,658,88400,36353
7789,4954,2835,677,126600,36360
1427,9,1418,1176,-,36362
346,290,56,829,85400,36370
343,225,118,611,124600,36371
200,176,24,-,62000,36373
283,254,29,-,65200,36374
2674,1976,698,730,93500,36375
839,690,149,732,80800,36376
2989,2110,879,567,85100,36401
4091,2928,1163,609,119700,36420
4027,2990,1037,617,108700,36421
332,268,64,-,-,36425
5527,3781,1746,619,97300,36426
578,429,149,495,86900,36432
148,146,2,-,-,36435
118,117,1,-,88200,36436
163,113,50,837,157200,36439
1424,1014,410,550,100700,36441
1336,1002,334,545,89200,36442
268,227,41,-,47100,36444
2181,1656,525,670,100500,36445
184,132,52,-,83800,36446
1906,1493,413,626,104000,36451
914,697,217,600,79800,36453
4,4,0,-,-,36454
95,63,32,575,70500,36455
598,482,116,438,28300,36456
3571,2164,1407,533,111600,36460
4106,3010,1096,608,92900,36467
35,0,35,-,-,36470
431,219,212,-,44600,36471
40,40,0,-,113300,36473
1197,1046,151,657,81800,36474
731,595,136,519,117800,36475
3,3,0,-,-,36476
1587,1212,375,533,83200,36477
683,544,139,727,131500,36480
98,54,44,-,-,36481
345,302,43,-,83600,36482
183,155,28,-,113700,36483
6073,3876,2197,602,108100,36502
390,316,74,1066,136300,36505
7414,5482,1932,730,130400,36507
565,348,217,735,80000,36509
157,157,0,-,115000,36511
6,6,0,-,-,36512
64,64,0,-,76500,36513
956,731,225,757,131700,36518
2436,2181,255,773,120700,36521
2386,1681,705,751,102800,36522
1046,749,297,896,166100,36523
532,477,55,568,88300,36524
577,435,142,828,133000,36525
12975,9584,3391,1156,222300,36526
5577,3994,1583,1275,267600,36527
679,630,49,1096,309100,36528
79,79,0,-,-,36529
2732,2248,484,812,171300,36530
13497,11364,2133,1160,305100,36532
13926,10743,3183,823,192400,36535
178,178,0,-,-,36538
234,209,25,-,-,36539
328,267,61,-,-,36540
5262,4794,468,1056,121900,36541
7276,4468,2808,1093,258600,36542
11,11,0,-,-,36543
3885,2977,908,766,119600,36544
3480,2505,975,582,114000,36545
397,389,8,-,162500,36548
2235,1883,352,1035,156700,36549
116,83,33,-,-,36550
3276,2658,618,883,164900,36551
859,833,26,420,128500,36553
337,296,41,853,291100,36555
196,134,62,-,47800,36556
1540,1404,136,498,95400,36558
92,76,16,-,630200,36559
1183,877,306,749,69000,36560
3219,2501,718,1351,356800,36561
439,401,38,-,103800,36562
75,75,0,-,-,36564
5055,3893,1162,885,139300,36567
74,64,10,-,-,36568
212,212,0,-,68200,36569
5937,4637,1300,809,157900,36571
2173,1719,454,954,158400,36572
430,392,38,-,201700,36574
7763,6310,1453,866,151500,36575
1791,1405,386,844,177400,36576
663,626,37,719,304600,36578
557,505,52,588,155900,36579
2089,1774,315,804,183000,36580
138,138,0,-,-,36581
8949,6864,2085,737,132800,36582
268,252,16,-,126500,36583
299,292,7,-,72500,36584
359,272,87,776,82600,36585
3594,2888,706,735,119800,36587
0,0,0,-,-,36590
641,115,526,398,215900,36602
2934,1102,1832,664,86500,36603
3999,2235,1764,784,172100,36604
10090,5373,4717,869,84400,36605
7839,3764,4075,857,126300,36606
2727,1335,1392,813,97000,36607
15009,8041,6968,911,163700,36608
11255,4731,6524,832,160300,36609
3978,1857,2121,657,45500,36610
2139,1038,1101,834,73900,36611
1620,936,684,681,65100,36612
4218,2976,1242,1037,116500,36613
0,0,0,-,-,36615
8,0,8,-,-,36616
5039,2705,2334,902,70600,36617
6579,4949,1630,1037,112600,36618
5670,4217,1453,882,139400,36619
0,0,0,-,-,36688
7763,5319,2444,960,158200,36693
19345,12964,6381,1059,185600,36695
8221,4602,3619,714,92600,36701
4927,2581,2346,625,71800,36703
310,252,58,-,-,36720
141,75,66,-,93000,36722
138,86,52,-,81700,36723
1802,1183,619,722,82100,36726
98,98,0,-,"10,000-",36727
97,69,28,-,-,36728
3217,1878,1339,543,142100,36732
413,353,60,-,76400,36736
278,231,47,-,66800,36738
517,361,156,579,106000,36740
1093,829,264,347,90500,36742
2347,1514,833,605,106800,36744
875,588,287,680,79700,36748
370,250,120,-,97100,36749
916,704,212,658,123900,36750
176,148,28,-,31900,36751
526,488,38,-,108800,36752
26,18,8,-,-,36753
198,169,29,-,-,36754
1699,1306,393,433,87800,36756
460,372,88,399,84600,36758
607,499,108,-,56000,36759
356,246,110,548,32300,36761
41,39,2,-,57200,36763
597,570,27,1014,63400,36765
14,10,4,-,141700,36766
487,347,140,319,68000,36767
345,252,93,840,75000,36768
928,648,280,533,66000,36769
142,74,68,725,-,36773
600,376,224,946,80800,36775
630,432,198,-,44500,36776
901,836,65,-,72300,36782
295,233,62,557,56900,36783
2627,1610,1017,587,143300,36784
504,398,106,755,85600,36785
1041,789,252,346,54900,36786
169,139,30,-,-,36790
465,331,134,-,105100,36792
105,65,40,-,-,36793
9973,6397,3576,739,163900,36801
7343,5808,1535,723,118700,36804
15986,8582,7404,894,268900,36830
10274,4314,5960,861,154800,36832
0,0,0,-,-,36849
1156,939,217,370,64400,36850
972,734,238,917,130700,36852
3454,2764,690,744,171700,36853
5865,3712,2153,823,114600,36854
704,576,128,802,127900,36855
2659,2326,333,1631,193800,36856
178,163,15,-,117900,36858
4,4,0,-,-,36859
795,589,206,544,71700,36860
1201,1093,108,679,122100,36861
2374,1595,779,511,110300,36862
4822,3329,1493,595,100000,36863
22,12,10,-,116700,36865
1554,1215,339,563,84200,36866
9608,4247,5361,808,139300,36867
8545,5266,3279,836,112500,36869
7051,5529,1522,856,141400,36870
455,364,91,760,128600,36871
3317,2917,400,1046,172300,36874
1499,1185,314,761,154800,36875
4432,3235,1197,887,153900,36877
916,798,118,579,267100,36879
174,109,65,-,60900,36901
1614,1220,394,585,100900,36904
788,698,90,843,66400,36907
732,648,84,-,79900,36908
21,0,21,-,-,36910
752,622,130,907,63600,36912
21,21,0,-,-,36913
220,168,52,-,52600,36915
452,319,133,326,68500,36916
716,585,131,433,59200,36919
504,489,15,-,109900,36921
220,200,20,-,66900,36922
1293,830,463,658,42200,36925
1736,1598,138,2016,269500,37010
843,675,168,432,143800,37012
36217,20207,16010,1182,205800,37013
1268,1240,28,-,549700,37014
6821,4993,1828,984,175400,37015
416,369,47,879,178700,37016
911,733,178,1076,99500,37018
233,151,82,754,158800,37019
2222,2010,212,935,187500,37020
2332,1937,395,1415,167900,37022
518,366,152,1085,148200,37023
2075,1841,234,731,136600,37025
869,701,168,622,159000,37026
20608,17154,3454,1621,627700,37027
261,193,68,-,201400,37028
2518,2352,166,840,243100,37029
3087,2162,925,599,165500,37030
1665,1556,109,1035,205000,37031
1721,1372,349,808,209500,37032
3029,2301,728,645,131400,37033
2732,2241,491,1075,204500,37034
1505,1313,192,736,162600,37035
2134,1714,420,725,184200,37036
2618,2394,224,1310,247000,37037
19374,11345,8029,895,178700,37040
29781,16511,13270,972,148700,37042
18483,12722,5761,953,231300,37043
1901,1725,176,1438,497100,37046
854,672,182,819,117600,37047
2268,1926,342,987,267300,37048
1438,1177,261,880,240400,37049
648,503,145,554,119200,37050
1312,1123,189,1058,167500,37051
943,886,57,-,179400,37052
10289,7132,3157,796,173100,37055
279,179,100,728,145800,37057
2926,2255,671,613,132600,37058
511,359,152,830,141500,37059
987,878,109,1128,234200,37060
1694,1298,396,666,136000,37061
4597,3633,964,1307,252400,37062
21795,17191,4604,1469,460900,37064
20704,14066,6638,1021,269300,37066
12492,7021,5471,1595,472300,37067
6983,6198,785,2075,499400,37069
12869,8869,4000,1123,237500,37072
5276,4345,931,944,237700,37073
2923,2060,863,670,163700,37074
24850,18187,6663,1166,288300,37075
16682,9697,6985,1149,230900,37076
146,122,24,-,146600,37078
1119,787,332,694,120800,37079
3143,2410,733,921,227800,37080
2237,1798,439,1042,262800,37082
5809,4395,1414,697,135800,37083
2064,1830,234,783,280600,37085
11552,8230,3322,1315,178300,37086
17808,12359,5449,934,262800,37087
5636,4104,1532,1115,263100,37090
8598,6047,2551,799,144900,37091
1080,735,345,589,161400,37095
2109,1687,422,616,94900,37096
803,621,182,709,95300,37097
2010,1634,376,994,121200,37098
2325,1901,424,614,135300,37101
12787,8632,4155,646,117300,37110
17024,7306,9718,1015,184900,37115
413,386,27,-,322900,37118
22013,17836,4177,1466,307700,37122
6948,5345,1603,998,251000,37127
21834,14631,7203,1239,249900,37128
21225,14689,6536,1200,243500,37129
21987,9550,12437,974,232200,37130
0,0,0,-,-,37132
1031,794,237,726,110700,37134
5356,4981,375,1625,441700,37135
1134,1037,97,643,104400,37137
9369,7377,1992,1107,239800,37138
41,41,0,-,-,37140
570,508,62,1008,213300,37141
607,531,76,610,175800,37142
1459,1268,191,1018,234900,37143
1158,1018,140,589,140500,37144
879,760,119,545,140700,37145
2618,2106,512,1164,232200,37146
8726,6316,2410,836,167400,37148
1013,866,147,765,205800,37149
1851,1356,495,639,109000,37150
267,208,59,-,172400,37151
2180,1984,196,832,304600,37153
11919,7602,4317,789,160200,37160
19,12,7,-,-,37165
5457,3484,1973,632,151500,37166
21579,13577,8002,1100,218800,37167
273,273,0,-,-,37171
11294,7726,3568,911,189300,37172
13513,10207,3306,1398,293300,37174
359,308,51,-,118800,37175
763,634,129,750,92500,37178
5131,4199,932,1788,352100,37179
1483,1172,311,586,172600,37180
706,591,115,765,146300,37181
1386,1159,227,669,190800,37183
2592,1952,640,839,196500,37184
3425,2615,810,729,112300,37185
3615,2484,1131,831,145300,37186
2821,2137,684,866,167200,37187
5807,4767,1040,1052,223400,37188
1717,1452,265,995,236100,37189
3295,2519,776,632,168100,37190
1548,1430,118,-,187200,37191
620,368,252,1762,374500,37201
10201,1828,8373,1564,380200,37203
6080,3451,2629,1477,602500,37204
10999,7379,3620,1492,613300,37205
11584,5763,5821,1126,359600,37206
15151,8793,6358,954,186700,37207
8415,2520,5895,1118,288100,37208
16513,7613,8900,1213,351600,37209
7337,2127,5210,867,227100,37210
29353,14000,15353,1113,250900,37211
7149,2857,4292,1222,592800,37212
21,0,21,-,-,37213
13890,8653,5237,1282,212300,37214
10541,8171,2370,1628,682600,37215
8244,5821,2423,1180,293800,37216
12724,5890,6834,1027,194800,37217
5816,3827,1989,922,191900,37218
777,190,587,1541,277100,37219
2368,2203,165,2047,506500,37220
18140,12794,5346,1393,307400,37221
1077,0,1077,1063,-,37228
0,0,0,-,-,37240
0,0,0,-,-,37243
0,0,0,-,-,37246
381,332,49,588,75400,37301
1862,1497,365,806,281400,37302
10127,6880,3247,740,155800,37303
517,490,27,-,-,37305
795,719,76,753,158000,37306
1934,1559,375,701,112700,37307
1062,909,153,649,196500,37308
785,588,197,966,133500,37309
1458,1214,244,582,171500,37310
11030,4935,6095,723,155000,37311
13648,9372,4276,876,191100,37312
628,522,106,-,116700,37313
0,0,0,-,-,37315
1414,1014,400,538,115200,37317
725,443,282,605,78900,37318
7174,4988,2186,655,135300,37321
3357,2552,805,733,131800,37322
12026,9550,2476,843,152900,37323
2493,1368,1125,721,129900,37324
778,654,124,674,140700,37325
258,97,161,479,158000,37326
4340,3261,1079,739,151900,37327
611,523,88,636,113500,37328
2464,2066,398,578,119800,37329
2980,2449,531,954,130000,37330
2784,2077,707,634,109600,37331
934,823,111,758,156300,37332
237,177,60,-,68500,37333
9386,6904,2482,715,153000,37334
952,772,180,1016,126400,37335
1836,1665,171,860,163600,37336
543,442,101,-,106500,37337
1129,851,278,748,95500,37338
681,599,82,670,105200,37339
182,118,64,816,137800,37340
4889,4048,841,1063,173200,37341
1506,1229,277,696,135200,37342
16755,12944,3811,941,193700,37343
989,795,194,722,117000,37345
3254,2602,652,644,110100,37347
323,218,105,-,-,37348
754,723,31,1750,486300,37350
134,97,37,-,126700,37351
1384,1087,297,580,197600,37352
1891,1502,389,810,164800,37353
6621,5021,1600,641,142800,37354
10510,6979,3531,742,166200,37355
1006,630,376,657,219900,37356
1967,1629,338,788,131000,37357
399,333,66,542,159000,37359
711,652,59,923,216400,37360
878,632,246,729,115700,37361
1358,1054,304,657,81700,37362
15894,11840,4054,1096,251600,37363
388,333,55,491,84300,37365
447,367,80,1010,112500,37366
3817,2854,963,668,149200,37367
242,234,8,-,110800,37369
1930,1600,330,803,156100,37370
1142,961,181,943,184000,37373
727,580,147,-,159700,37374
1046,839,207,991,226100,37375
266,122,144,-,65300,37376
5785,4989,796,1189,346100,37377
11248,9442,1806,770,190700,37379
2557,1653,904,619,125500,37380
3860,3148,712,645,133000,37381
3353,2957,396,602,169000,37385
1191,896,295,588,118100,37387
10573,7075,3498,651,156400,37388
653,471,182,701,159900,37391
55,51,4,-,216100,37394
64,64,0,-,104500,37396
3916,3029,887,719,121800,37397
5699,4157,1542,662,161300,37398
2258,221,2037,354,237600,37402
1799,458,1341,979,359800,37403
5016,2596,2420,747,152200,37404
8483,4313,4170,1046,292500,37405
6281,3086,3195,725,125800,37406
3605,1193,2412,729,74700,37407
947,353,594,892,295200,37408
1526,1065,461,929,201200,37409
1472,430,1042,675,60400,37410
7296,4439,2857,819,134500,37411
9236,5365,3871,911,133800,37412
11413,6661,4752,920,175000,37415
6225,3787,2438,912,149000,37416
2678,2019,659,769,224900,37419
21509,12239,9270,1080,203300,37421
15850,8813,7037,736,148700,37601
16725,7901,8824,775,161200,37604
0,0,0,-,-,37614
9250,6731,2519,805,199600,37615
2157,1685,472,679,138900,37616
5532,4687,845,622,169500,37617
5334,4081,1253,732,138700,37618
16324,11568,4756,705,132600,37620
1569,1204,365,646,102300,37640
3995,3239,756,596,143500,37641
6186,4870,1316,692,136400,37642
14186,10045,4141,637,121100,37643
2120,1757,363,682,154700,37645
5460,4053,1407,614,125600,37650
1407,1192,215,718,174800,37656
354,281,73,387,159900,37657
1644,1388,256,540,144100,37658
11480,9449,2031,830,173300,37659
17424,11102,6322,655,126000,37660
5847,4595,1252,672,175700,37663
12286,8804,3482,650,155700,37664
2222,1329,893,705,94500,37665
232,210,22,-,168900,37680
2639,2169,470,623,145200,37681
90,55,35,-,-,37682
5017,3799,1218,502,139100,37683
3113,2550,563,929,177200,37686
1760,1559,201,770,108500,37687
525,459,66,-,114400,37688
1852,1615,237,491,150800,37690
212,105,107,548,-,37691
2069,1447,622,666,174500,37692
927,715,212,687,141300,37694
3118,2132,986,824,149300,37701
1629,1205,424,849,214900,37705
2623,1986,637,578,127500,37708
1413,1074,339,785,164500,37709
448,425,23,608,69300,37710
2072,1662,410,570,94500,37711
543,363,180,721,119600,37713
1735,1283,452,667,162300,37714
379,344,35,411,71900,37715
10946,7600,3346,763,161800,37716
81,42,39,-,-,37719
5416,4643,773,1013,158600,37721
2645,2168,477,577,125600,37722
511,446,65,533,100300,37723
1111,615,496,676,141900,37724
6485,5212,1273,897,170200,37725
707,607,100,492,69000,37726
939,738,201,535,104100,37727
663,549,114,-,74700,37729
6,6,0,-,-,37730
123,110,13,-,73800,37731
33,33,0,-,-,37732
19,19,0,-,-,37733
2484,2246,238,892,217300,37737
2275,1560,715,817,234800,37738
2430,2167,263,864,211100,37742
9566,7289,2277,608,138900,37743
7516,5198,2318,592,149700,37745
7189,5227,1962,640,117800,37748
2674,1829,845,709,135000,37752
291,169,122,477,108900,37753
1498,1268,230,932,107500,37754
1039,676,363,492,66400,37755
1186,822,364,560,78200,37756
4127,2847,1280,620,145000,37757
4632,2845,1787,670,171700,37760
1246,667,579,415,85300,37762
6476,5072,1404,731,196600,37763
3823,2892,931,877,164000,37764
198,192,6,-,108700,37765
7389,4575,2814,654,106400,37766
2364,1652,712,555,138800,37769
1302,1161,141,534,89400,37770
6519,4369,2150,821,169100,37771
5201,4378,823,991,277400,37772
8050,6937,1113,793,236000,37774
5027,3297,1730,729,222800,37777
1424,1100,324,606,110500,37779
10785,7591,3194,795,192300,37801
12997,10630,2367,864,213000,37803
9504,7367,2137,922,165800,37804
1221,844,377,725,128900,37806
4110,3081,1029,733,136200,37807
916,672,244,826,112800,37809
664,575,89,-,122200,37810
1635,1395,240,624,126700,37811
6775,4559,2216,677,118800,37813
13155,8140,5015,740,146500,37814
2103,1604,499,663,82800,37818
248,163,85,596,121900,37819
2866,2289,577,688,137800,37820
8548,5510,3038,685,103000,37821
3607,2530,1077,603,101600,37825
1888,1624,264,745,141500,37826
694,568,126,811,258300,37828
636,517,119,850,97400,37829
12287,7514,4773,870,159700,37830
3957,3020,937,678,137600,37840
4016,2783,1233,536,105800,37841
1758,1463,295,750,149000,37843
165,106,59,-,60900,37845
1562,1253,309,574,145700,37846
1092,874,218,635,88000,37847
45,35,10,-,130200,37848
10552,8301,2251,833,184500,37849
11,11,0,-,-,37851
1046,827,219,623,123900,37852
1465,929,536,748,164200,37853
4746,3587,1159,655,110200,37854
8000,6028,1972,620,118500,37857
1412,1068,344,590,140000,37860
3524,2553,971,586,122200,37861
9069,5313,3756,790,211800,37862
2476,1201,1275,731,178600,37863
9148,7330,1818,887,191100,37865
637,534,103,510,198900,37866
1933,1408,525,473,102900,37869
1941,1485,456,695,118000,37870
3419,2563,856,827,150200,37871
645,572,73,658,102000,37872
1843,1424,419,605,102200,37873
6448,4078,2370,615,128200,37874
12585,9974,2611,825,189500,37876
3404,2907,497,764,146900,37877
144,138,6,-,156800,37878
4790,3507,1283,626,103900,37879
1543,1290,253,602,162000,37880
830,723,107,729,110000,37881
1303,1040,263,885,238700,37882
2565,1908,657,698,228600,37885
1578,1213,365,753,162600,37886
1983,1511,472,668,103100,37887
1193,1066,127,-,109900,37888
2934,2410,524,667,152100,37890
1492,1158,334,683,118700,37891
824,618,206,596,93300,37892
1590,359,1231,1052,355300,37902
7344,3155,4189,954,198400,37909
9959,5074,4885,854,124500,37912
8791,5932,2859,846,144800,37914
2737,522,2215,362,163600,37915
2992,101,2891,919,238800,37916
11867,5977,5890,842,121500,37917
18065,12138,5927,870,167400,37918
13444,7527,5917,951,308600,37919
17183,10310,6873,851,144300,37920
10907,6874,4033,931,133700,37921
13920,11666,2254,1332,346200,37922
12877,7740,5137,1029,214500,37923
5002,3594,1408,778,157400,37924
11145,8414,2731,1096,236700,37931
7454,5136,2318,1210,262900,37932
10580,9126,1454,1352,338000,37934
6710,5925,785,968,205900,37938
1741,1219,522,667,99700,38001
13288,11267,2021,1230,257800,38002
3742,3125,617,1177,210500,38004
2029,1238,791,808,112000,38006
41,41,0,-,111600,38007
3750,2329,1421,815,94800,38008
3290,2632,658,913,160300,38011
5209,2813,2396,634,98300,38012
851,683,168,700,156900,38015
18491,10051,8440,1151,179100,38016
19940,15143,4797,1303,336300,38017
13795,8441,5354,1330,176500,38018
6050,3751,2299,757,126500,38019
22,22,0,-,-,38021
2187,1578,609,959,161500,38023
11120,6608,4512,669,122300,38024
2765,2621,144,1174,356400,38028
14,14,0,-,-,38029
154,78,76,615,113800,38030
1258,974,284,618,100200,38034
250,48,202,391,217600,38036
628,470,158,671,90700,38037
653,484,169,703,93100,38039
2039,1133,906,645,78500,38040
1049,621,428,579,82900,38041
358,224,134,687,131300,38042
281,262,19,625,102800,38044
36,31,5,-,515600,38046
47,28,19,-,-,38047
1526,1164,362,829,109400,38049
306,210,96,697,91200,38050
1749,1322,427,600,98600,38052
9413,6543,2870,977,146300,38053
35,0,35,1898,-,38054
1478,1129,349,686,212200,38057
3601,2838,763,1034,166300,38058
3003,2142,861,762,103800,38059
4199,3665,534,1364,189200,38060
365,308,57,-,108200,38061
6439,3575,2864,651,97000,38063
1198,1070,128,646,269700,38066
658,540,118,576,115500,38067
3995,2628,1367,691,179800,38068
1018,674,344,648,108100,38069
73,67,6,-,163400,38070
1405,1092,313,772,105000,38075
445,390,55,857,189400,38076
33,17,16,-,-,38077
1311,661,650,-,96400,38079
938,513,425,561,75000,38080
7742,2533,5209,1296,291600,38103
13218,4975,8243,829,233900,38104
3183,342,2841,743,66600,38105
9478,4181,5297,776,52600,38106
6848,2660,4188,821,91900,38107
6572,2732,3840,716,54200,38108
16486,9604,6882,851,67500,38109
17656,7884,9772,867,112400,38111
6679,3301,3378,791,130800,38112
9952,4052,5900,765,62100,38114
17023,4116,12907,896,94600,38115
15508,7390,8118,843,95100,38116
11523,8917,2606,1102,214800,38117
12803,5605,7198,948,74800,38118
10244,5680,4564,1102,208700,38119
6427,4899,1528,1164,346600,38120
8876,4512,4364,941,72700,38122
13686,8259,5427,1201,165100,38125
2299,286,2013,604,46900,38126
14308,6503,7805,914,63200,38127
15860,6069,9791,925,86100,38128
0,0,0,-,-,38131
0,0,0,-,-,38132
7957,5788,2169,1179,164500,38133
15063,7283,7780,980,129800,38134
10797,8757,2040,1290,175900,38135
9807,7896,1911,1268,296100,38138
5635,5382,253,2203,410500,38139
7755,5086,2669,1165,105000,38141
0,0,0,-,-,38152
3901,2721,1180,682,107600,38201
721,609,112,615,74800,38220
1399,1082,317,617,71700,38221
718,623,95,695,115000,38222
287,257,30,469,145000,38224
2237,1523,714,647,85700,38225
140,140,0,-,67200,38226
1231,897,334,590,92000,38229
1631,1199,432,619,70900,38230
724,602,122,698,78200,38231
859,682,177,540,76400,38232
1150,907,243,597,80100,38233
217,125,92,618,126900,38235
258,161,97,427,93600,38236
6112,3388,2724,643,144800,38237
956,627,329,690,75200,38240
408,368,40,652,108300,38241
8222,5672,2550,671,109000,38242
1202,930,272,542,73100,38251
383,271,112,769,114700,38253
22,12,10,-,-,38254
1069,688,381,541,83000,38255
1631,1523,108,856,110200,38256
1874,1314,560,572,89600,38257
640,515,125,638,87400,38258
308,193,115,628,62000,38259
1544,1168,376,665,102900,38260
6527,3695,2832,652,109000,38261
13808,6833,6975,774,89100,38301
19968,13151,6817,971,163000,38305
2293,1801,492,617,113700,38310
439,400,39,-,151000,38311
1409,1366,43,-,133900,38313
1547,1285,262,666,73600,38315
1070,869,201,610,103100,38316
1115,921,194,625,87000,38317
131,83,48,920,48400,38318
4289,3165,1124,686,98400,38320
998,830,168,442,78900,38321
1374,1155,219,754,138100,38326
181,151,30,650,88600,38327
302,282,20,-,74700,38328
1172,1009,163,567,99700,38329
1608,1091,517,686,86900,38330
478,441,37,527,138500,38332
98,72,26,-,80000,38333
775,716,59,683,89300,38334
580,453,127,804,107800,38337
287,173,114,539,102300,38339
4169,3022,1147,719,109500,38340
1066,912,154,625,76300,38341
614,390,224,513,90000,38342
6620,4288,2332,678,109800,38343
3039,2168,871,627,106600,38344
674,568,106,-,71400,38345
45,31,14,-,-,38347
416,360,56,588,98900,38348
7042,4862,2180,673,117700,38351
210,173,37,-,99800,38352
2735,2202,533,892,196000,38355
1118,792,326,543,123600,38356
990,867,123,614,125100,38357
4378,2834,1544,663,108800,38358
117,92,25,788,97100,38359
394,353,41,-,143800,38361
413,306,107,1171,116700,38362
2215,1648,567,577,86700,38363
0,0,0,-,-,38365
685,627,58,804,129400,38366
1095,870,225,632,127600,38367
837,608,229,731,116500,38368
617,490,127,645,79700,38369
354,268,86,609,84000,38370
381,320,61,666,96100,38371
6428,4568,1860,608,116100,38372
875,635,240,576,102000,38374
3362,2354,1008,609,97000,38375
48,48,0,-,92900,38376
513,321,192,775,104700,38379
226,186,40,-,97300,38380
570,365,205,701,102200,38381
3587,2071,1516,653,103000,38382
125,91,34,-,83900,38387
641,588,53,573,98000,38388
411,341,70,678,87200,38390
403,261,142,935,95300,38391
236,236,0,-,75600,38392
23980,17094,6886,893,197400,38401
654,530,124,575,138500,38425
1126,879,247,819,129900,38449
1213,975,238,422,77700,38450
1538,1320,218,780,166100,38451
345,299,46,486,94100,38452
119,100,19,-,194200,38453
406,337,69,-,95500,38454
55,39,16,814,152300,38455
1307,1105,202,722,140600,38456
258,177,81,482,93400,38457
128,117,11,-,78800,38459
658,604,54,714,142900,38460
578,526,52,-,151800,38461
3984,3098,886,622,94600,38462
918,824,94,-,121100,38463
8991,6380,2611,655,122900,38464
1995,1530,465,692,120500,38468
1579,1331,248,650,98300,38469
129,111,18,-,-,38471
1126,968,158,634,122200,38472
372,248,124,754,157600,38473
2900,2095,805,590,130400,38474
252,239,13,-,121500,38475
378,370,8,-,190600,38476
1136,993,143,700,125700,38477
7130,4425,2705,664,139700,38478
413,350,63,519,80600,38481
600,547,53,1256,198400,38482
2109,1623,486,646,134800,38483
2558,1866,692,554,106900,38485
456,312,144,-,77600,38486
361,313,48,859,154200,38487
965,850,115,497,184400,38488
16715,8731,7984,711,161900,38501
280,236,44,-,-,38504
0,0,0,-,-,38505
11993,8626,3367,817,168200,38506
802,676,126,746,119400,38541
8,0,8,-,-,38542
155,122,33,600,145800,38543
2700,2145,555,697,152800,38544
717,560,157,525,87000,38545
834,759,75,630,175100,38547
441,372,69,817,203600,38548
1693,1328,365,476,131500,38549
1698,1167,531,489,107800,38551
72,60,12,-,153600,38552
1120,928,192,771,135800,38553
329,262,67,-,146600,38554
8741,5423,3318,681,158600,38555
5001,3547,1454,511,104600,38556
4875,4179,696,823,219800,38558
494,418,76,665,121200,38559
480,410,70,723,136400,38560
2372,1906,466,535,109200,38562
1101,792,309,819,168000,38563
264,210,54,-,83100,38564
310,310,0,-,-,38565
288,211,77,539,188300,38567
778,651,127,543,107200,38568
66,36,30,-,-,38569
4231,3149,1082,546,117700,38570
5721,4843,878,733,152800,38571
4916,4461,455,646,140900,38572
791,695,96,773,140000,38573
3360,2531,829,610,143000,38574
450,368,82,-,88800,38575
554,421,133,757,76600,38577
90,75,15,679,139900,38578
402,323,79,831,211100,38579
605,496,109,513,136800,38580
1455,1238,217,649,109200,38581
700,666,34,700,176500,38582
9299,7270,2029,728,129500,38583
1691,1288,403,503,97900,38585
509,425,84,704,100800,38587
342,272,70,696,117900,38588
110,106,4,-,111400,38589
719,654,65,821,159000,38601
1216,1028,188,590,86400,38603
5299,3818,1481,793,107100,38606
918,695,223,483,81600,38610
6198,4651,1547,811,149100,38611
6447,3483,2964,612,70700,38614
225,127,98,325,65000,38617
4658,3546,1112,773,113100,38618
1868,906,962,556,83200,38619
1008,873,135,1086,74000,38620
658,335,323,709,58000,38621
281,146,135,542,44400,38622
103,89,14,-,31800,38623
614,361,253,530,78400,38625
475,415,60,-,226000,38626
527,473,54,-,127100,38627
594,437,157,491,110600,38629
72,62,10,-,-,38630
540,274,266,392,66000,38631
9726,8220,1506,1029,213600,38632
868,645,223,480,101600,38633
5538,4018,1520,710,112500,38635
9298,5336,3962,1067,114500,38637
334,154,180,358,42900,38639
798,726,72,950,164600,38641
996,778,218,567,90000,38642
797,309,488,364,47900,38643
71,43,28,-,65000,38644
571,270,301,619,82500,38645
1276,911,365,584,73000,38646
235,183,52,-,47900,38647
1413,1072,341,667,112900,38650
2786,2390,396,-,211600,38651
6060,4344,1716,705,113800,38652
19040,15418,3622,1182,210300,38654
16476,9450,7026,978,230100,38655
885,745,140,946,81500,38658
1055,750,305,772,76900,38659
809,784,25,-,151400,38661
4691,3297,1394,575,102200,38663
1383,150,1233,864,146600,38664
1085,746,339,726,132600,38665
2924,1934,990,647,66000,38666
4827,3778,1049,706,159100,38668
371,243,128,758,48400,38670
14355,8887,5468,1045,132300,38671
5155,4832,323,1722,222600,38672
399,384,15,675,193800,38673
309,247,62,-,56400,38674
2230,1098,1132,733,95900,38676
0,0,0,-,-,38677
2338,1530,808,905,130500,38680
1644,1163,481,577,68600,38683
506,498,8,-,211500,38685
9096,4641,4455,674,89900,38701
13,0,13,-,-,38702
4323,2249,2074,800,65900,38703
5,5,0,-,-,38704
353,273,80,706,-,38720
423,295,128,590,55800,38721
106,88,18,475,61500,38722
27,27,0,-,-,38723
341,200,141,663,83800,38725
194,137,57,672,70300,38726
792,593,199,679,130200,38730
68,61,7,-,-,38731
6161,3355,2806,729,138600,38732
91,83,8,-,60500,38736
1205,547,658,503,70400,38737
66,15,51,206,-,38738
67,51,16,-,90600,38740
253,187,66,-,-,38744
69,44,25,-,-,38745
165,93,72,-,76500,38746
1130,683,447,604,81700,38748
23,0,23,-,-,38749
3887,2081,1806,690,91500,38751
487,327,160,658,108100,38753
614,440,174,567,97300,38754
2648,1724,924,626,90000,38756
510,355,155,543,147300,38759
303,159,144,573,73700,38760
677,379,298,615,71200,38761
905,349,556,638,80100,38762
145,127,18,725,75000,38764
71,27,44,-,-,38765
26,13,13,-,-,38767
31,31,0,-,-,38768
809,341,468,351,90700,38769
1098,578,520,532,87000,38771
19,19,0,-,-,38772
1352,873,479,543,83600,38773
735,415,320,536,72100,38774
494,221,273,347,73100,38778
87,18,69,287,75000,38781
11715,7456,4259,811,143500,38801
6686,3977,2709,733,151900,38804
5128,3705,1423,678,126900,38821
2767,2134,633,588,85200,38824
1743,1063,680,1027,168400,38826
1502,968,534,673,121100,38827
1392,1057,335,674,113100,38828
6940,5108,1832,529,98000,38829
951,681,270,488,61100,38833
11769,7409,4360,636,121800,38834
456,413,43,-,63500,38838
1181,908,273,521,82800,38841
3958,3060,898,687,113900,38843
102,102,0,-,-,38844
798,715,83,563,87400,38846
1357,1060,297,647,63700,38847
270,255,15,-,86900,38848
1989,1659,330,853,116800,38849
890,691,199,503,65900,38850
3410,2460,950,693,75800,38851
3767,2793,974,476,106600,38852
1744,1390,354,716,89400,38855
741,647,94,-,76900,38856
1468,1267,201,624,142800,38857
2552,2015,537,697,89500,38858
212,182,30,-,101500,38859
1983,1413,570,470,69500,38860
1051,876,175,693,94600,38862
6896,4967,1929,731,121400,38863
715,603,112,778,93600,38864
1732,1425,307,751,74700,38865
4368,3703,665,777,162600,38866
2225,1606,619,646,90200,38868
155,98,57,804,127300,38869
931,757,174,694,93600,38870
590,480,110,842,112200,38871
993,822,171,613,75100,38873
531,405,126,612,87700,38876
994,751,243,558,61800,38878
278,71,207,-,152200,38879
7281,4792,2489,677,111600,38901
180,161,19,-,81700,38913
272,215,57,814,62700,38914
1569,1129,440,517,79900,38915
2005,1409,596,588,63700,38916
1136,939,197,638,103400,38917
283,221,62,-,58700,38920
1632,1074,558,533,74200,38921
1116,910,206,585,75300,38922
398,325,73,-,127200,38923
169,112,57,-,53800,38924
1200,922,278,514,77700,38925
417,315,102,681,47000,38927
130,48,82,623,-,38928
711,572,139,787,80000,38929
8241,4697,3544,577,91500,38930
594,528,66,680,98700,38940
1332,580,752,606,71200,38941
103,87,16,-,52900,38943
126,64,62,670,75000,38944
15,0,15,-,-,38945
97,75,22,660,63800,38946
267,246,21,473,103800,38947
1059,664,395,761,56300,38948
160,149,11,-,135500,38949
142,100,42,-,74100,38950
536,384,152,821,68800,38951
207,118,89,-,107400,38952
185,185,0,-,90800,38953
308,255,53,640,61100,38954
213,81,132,565,95000,38957
0,0,0,-,-,38958
259,180,79,-,96600,38961
23,0,23,-,-,38962
801,355,446,758,66600,38963
27,27,0,-,-,38964
3482,2550,932,570,98800,38965
279,156,123,530,70000,38966
2835,1856,979,587,105700,38967
2099,1273,826,642,67300,39038
824,669,155,668,81400,39039
1286,892,394,848,99100,39040
1471,1185,286,488,149300,39041
13383,11444,1939,951,183800,39042
1248,1115,133,1250,93000,39044
705,638,67,-,78200,39045
11076,6199,4877,772,156800,39046
14955,12518,2437,1414,197300,39047
5953,4358,1595,717,86300,39051
167,138,29,-,"10,000-",39054
8969,6280,2689,1004,179800,39056
871,732,139,-,79000,39057
3983,3293,690,607,94200,39059
0,0,0,-,-,39061
172,121,51,650,81600,39062
1359,778,581,634,54400,39063
1913,1541,372,612,129800,39066
455,364,91,818,68300,39067
1688,1092,596,418,65700,39069
2331,1756,575,500,220500,39071
7757,6664,1093,842,144100,39073
5672,3910,1762,700,73400,39074
219,186,33,-,81800,39078
459,207,252,419,75700,39079
412,370,42,-,-,39082
3404,2468,936,648,84400,39083
519,401,118,-,46600,39086
26,21,5,-,-,39088
4980,3260,1720,497,103200,39090
1115,919,196,523,74300,39092
1458,1201,257,759,100600,39094
2288,1538,750,524,61600,39095
612,400,212,541,48300,39096
185,106,79,562,53900,39097
563,555,8,-,65900,39108
15467,14727,740,1570,264100,39110
2893,2032,861,635,92900,39111
160,33,127,230,-,39113
3780,3117,663,714,87300,39114
73,66,7,-,45100,39115
1048,891,157,-,113900,39116
3494,2728,766,749,88800,39117
1728,1399,329,639,103500,39119
11068,6880,4188,587,93900,39120
1031,804,227,862,90000,39140
257,213,44,-,75000,39144
2101,1788,313,795,114400,39145
1016,715,301,660,64100,39146
653,633,20,-,90400,39149
1924,1334,590,533,70900,39150
397,357,40,-,74100,39152
1176,947,229,540,87200,39153
3445,2927,518,1064,191400,39154
226,226,0,-,55200,39156
10235,5389,4846,1057,199100,39157
1171,649,522,612,77300,39159
1048,960,88,856,87100,39160
32,29,3,-,126400,39162
237,169,68,318,92100,39166
0,0,0,-,-,39167
2632,2055,577,589,104400,39168
1205,494,711,445,52900,39169
3695,3453,242,777,178900,39170
124,52,72,-,-,39174
1531,1250,281,631,81000,39175
1095,830,265,313,70900,39176
84,64,20,-,138600,39177
334,277,57,-,169900,39179
12568,8134,4434,749,128400,39180
5313,3579,1734,721,150500,39183
1312,885,427,615,68200,39189
2661,2266,395,911,112100,39191
478,436,42,371,51400,39192
0,0,0,-,-,39193
5998,3174,2824,725,83900,39194
723,10,713,1132,-,39201
3668,962,2706,772,198800,39202
2099,771,1328,632,44900,39203
5994,2045,3949,740,61000,39204
9916,4988,4928,895,98000,39206
11756,7239,4517,943,131400,39208
9599,4363,5236,783,60900,39209
10019,6271,3748,1074,162000,39211
11239,7162,4077,950,87100,39212
8195,3888,4307,649,59700,39213
1788,823,965,856,195000,39216
0,0,0,-,-,39217
2843,1982,861,938,119200,39218
3388,1828,1560,1185,198400,39232
0,0,0,-,-,39269
4683,3603,1080,1098,141800,39272
10188,6250,3938,696,84000,39301
8229,5424,2805,859,162600,39305
6364,3331,3033,660,69300,39307
0,0,0,-,-,39309
669,582,87,-,-,39320
629,568,61,-,-,39322
496,432,64,-,61700,39323
2394,2085,309,617,156400,39325
132,132,0,-,56400,39326
1584,1243,341,658,112200,39327
2025,1381,644,314,73700,39328
1006,895,111,725,107300,39330
650,590,60,666,136000,39332
989,857,132,943,133900,39335
413,356,57,-,73300,39336
678,622,56,479,78800,39337
1550,1335,215,593,78400,39338
5849,4334,1515,643,103100,39339
2355,1617,738,554,76000,39341
611,277,334,856,154700,39342
2254,1613,641,706,78500,39345
781,578,203,673,77900,39346
615,502,113,348,166700,39347
272,272,0,-,52700,39348
8877,6408,2469,669,81500,39350
294,234,60,-,78400,39352
1034,876,158,683,76200,39354
2643,2222,421,763,84700,39355
216,173,43,-,321100,39356
398,246,152,404,112200,39358
112,73,39,669,80300,39359
1426,1180,246,548,42400,39360
630,570,60,394,60200,39361
1626,1295,331,910,68900,39362
555,421,134,625,44400,39363
1193,1048,145,1055,83800,39364
2704,2087,617,513,87100,39365
332,306,26,-,69400,39366
5905,5018,887,524,80400,39367
16313,7073,9240,761,94800,39401
15326,9243,6083,983,198000,39402
0,0,0,-,-,39406
1225,1119,106,590,78700,39421
1716,1391,325,582,85000,39422
1203,1017,186,635,85500,39423
868,777,91,682,159700,39425
6477,5630,847,959,170900,39426
540,452,88,514,107600,39427
3374,2438,936,753,62700,39428
6573,4932,1641,525,96500,39429
4318,3264,1054,744,140100,39437
1863,1548,315,715,85500,39439
8282,5039,3243,729,99000,39440
7795,6276,1519,703,101500,39443
1147,867,280,591,76400,39451
9369,7697,1672,755,119100,39452
3475,2783,692,547,92700,39455
224,215,9,571,138500,39456
1320,933,387,-,58900,39459
271,271,0,-,78600,39461
376,252,124,523,175000,39462
1007,902,105,700,108800,39464
7650,6011,1639,836,135800,39465
11319,8374,2945,785,146600,39466
4558,3824,734,685,149100,39470
2358,1749,609,626,82400,39474
5079,3852,1227,860,157100,39475
2688,2354,334,631,120100,39476
255,233,22,908,90400,39477
735,673,62,-,93900,39478
2499,1980,519,555,74300,39479
1157,1035,122,1102,149300,39480
633,547,86,-,135500,39481
4072,3629,443,778,165400,39482
2412,2014,398,639,86300,39483
9376,3314,6062,825,85400,39501
20788,13884,6904,941,154700,39503
7311,3662,3649,924,184400,39507
8943,6476,2467,878,175600,39520
3857,3523,334,888,179200,39525
3391,1491,1900,747,122800,39530
7291,2480,4811,857,161200,39531
14071,8496,5575,959,174600,39532
0,0,0,-,-,39534
3654,1370,2284,1000,98800,39540
6346,4246,2100,891,132400,39553
2978,2599,379,1002,132200,39556
7132,4799,2333,1022,158600,39560
722,608,114,-,110400,39561
7026,5757,1269,875,134700,39562
5207,3975,1232,865,96400,39563
15926,11578,4348,1037,170900,39564
6824,5907,917,946,165000,39565
3830,2565,1265,803,120700,39567
5635,4608,1027,915,167700,39571
496,496,0,-,106000,39572
3095,2661,434,1038,142800,39573
5064,4058,1006,851,159500,39574
2724,1791,933,727,159500,39576
3557,2432,1125,666,108100,39577
4324,2038,2286,739,105200,39581
9051,6360,2691,721,98100,39601
2618,2252,366,655,140600,39629
448,197,251,503,62300,39630
1533,1145,388,424,65100,39631
497,423,74,-,48300,39633
124,88,36,-,72000,39635
1304,977,327,650,69000,39638
1711,1393,318,758,101000,39641
347,312,35,-,107100,39643
2152,1751,401,691,84600,39645
289,274,15,-,112000,39647
7649,4283,3366,744,95200,39648
3088,2616,472,597,77900,39652
943,630,313,-,71900,39653
2108,1552,556,614,110500,39654
234,196,38,-,-,39656
785,661,124,628,85900,39657
955,724,231,-,70700,39661
425,425,0,-,87500,39662
983,651,332,696,106600,39663
758,688,70,852,129400,39664
667,510,157,847,72700,39665
3554,2911,643,733,123000,39666
4743,4097,646,563,108200,39667
400,363,37,-,-,39668
1960,1630,330,598,74500,39669
5290,2621,2669,751,125200,39701
8383,5535,2848,775,118100,39702
5143,3043,2100,957,180100,39705
4220,3108,1112,595,85000,39730
1488,1098,390,530,136900,39735
135,68,67,343,93300,39736
70,70,0,-,84400,39737
989,655,334,530,63200,39739
2137,1573,564,642,148600,39740
707,649,58,-,87400,39741
681,625,56,-,70300,39743
2128,1555,573,569,79100,39744
277,220,57,-,-,39745
1036,855,181,710,113600,39746
800,590,210,570,77800,39747
1089,768,321,572,90600,39750
506,414,92,574,90700,39751
1020,875,145,572,87200,39752
352,326,26,-,125600,39755
607,559,48,-,59400,39756
17580,8461,9119,800,170300,39759
12,12,0,-,-,39760
23,0,23,-,-,39762
988,749,239,978,113100,39766
406,358,48,-,63600,39767
576,446,130,-,121000,39769
51,45,6,-,89300,39771
686,601,85,675,72400,39772
6222,4041,2181,665,99100,39773
563,370,193,807,63800,39776
896,617,279,619,86900,39813
537,361,176,758,66600,39815
3785,2370,1415,632,123800,39817
4029,2237,1792,695,131300,39819
3205,2103,1102,715,129700,39823
284,211,73,548,-,39824
465,295,170,750,164900,39825
245,160,85,668,69800,39826
1527,1088,439,791,131500,39827
5319,3172,2147,724,121000,39828
723,551,172,692,80300,39834
111,81,30,-,138200,39836
2510,1663,847,575,92300,39837
2085,952,1133,574,75800,39840
358,319,39,557,66000,39841
2818,1471,1347,636,90500,39842
3044,1947,1097,741,91900,39845
681,489,192,662,51400,39846
868,592,276,332,61800,39851
1047,853,194,667,73300,39854
413,365,48,581,86600,39859
420,287,133,639,119200,39861
437,275,162,623,86500,39862
177,124,53,394,79300,39866
137,125,12,-,92500,39867
929,604,325,531,108000,39870
198,181,17,-,66100,39877
23,14,9,925,-,39885
569,344,225,475,70300,39886
1253,1003,250,743,71700,39897
749,607,142,1063,152100,40003
11732,8762,2970,803,160500,40004
1675,1301,374,655,124900,40006
25,25,0,-,-,40007
1333,1079,254,810,160500,40008
572,496,76,689,55000,40009
207,184,23,-,350000,40010
1046,800,246,763,124100,40011
255,208,47,837,113400,40012
2250,2068,182,793,208200,40013
7287,6370,917,1094,316000,40014
1533,944,589,772,136900,40019
138,128,10,-,-,40020
325,302,23,-,352400,40022
1872,1782,90,1257,311100,40023
43,43,0,-,955400,40025
1949,1830,119,1517,327400,40026
7529,5776,1753,889,239100,40031
4868,3334,1534,665,115700,40033
124,117,7,-,65600,40036
1040,898,142,633,123800,40037
158,127,31,1096,49200,40040
300,58,242,857,-,40041
1634,1357,277,762,126500,40045
545,537,8,-,162400,40046
7091,6173,918,785,189600,40047
0,0,0,-,-,40048
0,0,0,-,-,40049
656,422,234,816,95200,40050
1817,1450,367,715,136500,40051
162,147,15,-,-,40052
780,569,211,1103,170800,40055
1236,1183,53,1167,239000,40056
1518,1054,464,901,145200,40057
42,38,4,-,92800,40058
7830,7223,607,1564,450200,40059
520,388,132,581,118300,40060
69,44,25,1010,122700,40062
0,0,0,-,-,40063
11213,7364,3849,837,192300,40065
2261,1728,533,718,258400,40067
795,654,141,805,187500,40068
3311,2400,911,632,132800,40069
193,159,34,-,130100,40070
5854,5021,833,702,230900,40071
368,294,74,1103,146600,40075
963,852,111,900,172300,40076
237,195,42,-,173000,40077
977,801,176,801,87900,40078
426,369,57,1037,112200,40104
899,732,167,830,201000,40107
4616,3765,851,735,169600,40108
696,635,61,-,186500,40109
30,21,9,-,-,40110
661,470,191,318,87100,40111
241,225,16,-,112000,40115
864,701,163,853,122500,40117
3650,2492,1158,917,108500,40118
796,752,44,775,151600,40119
2472,16,2456,1046,-,40121
305,243,62,693,47900,40140
833,638,195,840,134300,40142
2429,1894,535,625,110900,40143
589,541,48,-,100600,40144
208,181,27,-,80500,40145
1489,1085,404,636,91700,40146
1703,1328,375,739,137500,40150
338,338,0,-,142900,40152
462,242,220,705,65500,40155
298,238,60,-,188600,40157
9458,4900,4558,771,132200,40160
72,23,49,-,-,40161
1864,1617,247,608,180400,40162
14041,10864,3177,818,180100,40165
157,141,16,-,-,40170
69,60,9,-,77300,40171
5278,4007,1271,964,161800,40175
350,316,34,-,103800,40176
635,462,173,598,128000,40177
194,194,0,-,128400,40178
3104,203,2901,269,310200,40202
8936,1589,7347,604,127500,40203
7590,3501,4089,1005,219500,40204
10321,7561,2760,987,292700,40205
9812,5073,4739,878,216400,40206
13847,9565,4282,1108,328300,40207
5239,1283,3956,754,101400,40208
153,105,48,647,106800,40209
5558,2234,3324,703,66800,40210
9094,3659,5435,784,76500,40211
6628,3412,3216,728,65600,40212
6955,4467,2488,799,122100,40213
17783,9323,8460,801,137900,40214
7580,3096,4484,812,82700,40215
16914,10641,6273,795,119800,40216
6297,4088,2209,952,163600,40217
13614,6502,7112,883,144400,40218
15447,8456,6991,795,135800,40219
14837,9395,5442,1024,191400,40220
10227,6110,4117,1014,273600,40222
9726,7100,2626,1166,272800,40223
6452,5493,959,1064,171300,40228
14897,11158,3739,1074,146400,40229
0,0,0,-,-,40231
12735,8744,3991,1155,280400,40241
4780,3414,1366,1082,232800,40242
4729,3257,1472,1128,248300,40243
12469,10193,2276,1217,348800,40245
10418,7362,3056,923,130900,40258
14373,10770,3603,1011,135000,40272
109,42,67,885,575000,40280
15152,11575,3577,1026,189300,40291
16942,12499,4443,1083,214600,40299
166,146,20,525,62500,40310
2722,1896,826,569,91500,40311
2268,1567,701,595,91800,40312
970,604,366,672,83200,40313
192,171,21,-,105400,40316
1304,969,335,578,88400,40322
18384,12861,5523,946,194200,40324
346,307,39,529,78500,40328
8004,5708,2296,618,144300,40330
7,7,0,-,-,40334
4867,3306,1561,606,83400,40336
2022,1609,413,746,86000,40337
31,31,0,-,-,40339
8677,6530,2147,729,158000,40342
215,180,35,643,77200,40346
1204,864,340,824,254400,40347
305,126,179,560,100500,40348
40,40,0,-,-,40350
7918,4781,3137,638,134300,40351
8590,5568,3022,688,137700,40353
16233,11173,5060,811,185900,40356
512,471,41,-,102400,40358
2642,2011,631,601,131000,40359
2693,1692,1001,485,89800,40360
7293,4571,2722,744,160100,40361
17,17,0,-,-,40363
1125,1009,116,752,220000,40370
1145,961,184,605,66500,40371
831,766,65,721,197100,40372
708,488,220,589,82500,40374
22,22,0,-,-,40376
1548,1289,259,760,164900,40379
2408,1703,705,751,112100,40380
9238,6469,2769,795,215200,40383
997,750,247,-,87200,40385
747,541,206,716,74800,40387
2361,1247,1114,823,186000,40390
14434,9955,4479,725,150800,40391
947,750,197,667,80400,40402
9271,6196,3075,717,136300,40403
0,0,0,-,-,40404
1264,804,460,648,98000,40409
1565,1229,336,438,83400,40419
9225,5997,3228,720,159700,40422
0,0,0,-,-,40434
2272,1875,397,586,107500,40437
901,763,138,619,95300,40440
303,258,45,520,126700,40442
5683,4794,889,718,152900,40444
300,268,32,470,84000,40445
3408,2471,937,507,80800,40447
14,14,0,-,-,40448
3974,3029,945,560,97800,40456
480,427,53,-,69500,40460
1248,889,359,780,146700,40461
498,471,27,-,95000,40464
736,550,186,808,88100,40468
792,620,172,658,65700,40472
23722,13869,9853,725,174100,40475
33,21,12,-,-,40481
4730,3542,1188,592,115300,40484
1020,935,85,-,96400,40486
1527,1422,105,635,88700,40489
12763,7623,5140,891,380800,40502
12314,8024,4290,939,207600,40503
11493,3561,7932,764,155100,40504
10828,6414,4414,791,125200,40505
0,0,0,-,-,40506
1271,368,903,641,275000,40507
9615,2697,6918,774,139900,40508
17069,10909,6160,1048,252300,40509
465,327,138,1025,588500,40510
12555,8023,4532,993,168800,40511
4564,3317,1247,1163,360000,40513
6041,4576,1465,1230,222400,40514
14462,8953,5509,1070,238200,40515
1372,1010,362,1252,177600,40516
16644,6237,10407,902,141100,40517
21652,13545,8107,791,150500,40601
0,0,0,-,-,40604
11098,7259,3839,627,132000,40701
2091,1692,399,725,78600,40729
1365,888,477,390,86400,40734
443,420,23,702,99900,40737
1284,843,441,682,100600,40740
9281,6321,2960,687,127800,40741
45,24,21,-,237500,40743
6584,4821,1763,688,126800,40744
976,860,116,599,78000,40759
215,169,46,-,42800,40763
5953,4008,1945,588,73500,40769
706,265,441,100-,46800,40771
176,176,0,-,54700,40801
1042,687,355,626,108100,40806
125,110,15,471,57500,40807
18,18,0,-,66000,40808
432,370,62,-,46200,40810
154,121,33,540,50200,40813
393,265,128,799,58300,40815
0,0,0,-,-,40816
35,35,0,-,-,40818
300,291,9,-,75900,40819
183,183,0,-,30100,40820
1589,942,647,432,59600,40823
178,92,86,581,42800,40824
276,214,62,-,63500,40826
366,301,65,-,65900,40827
1374,1113,261,603,64000,40828
58,0,58,-,-,40829
131,131,0,-,42900,40830
1993,1094,899,452,73100,40831
90,90,0,-,63300,40840
111,105,6,-,108600,40843
31,31,0,-,-,40844
218,176,42,292,42600,40845
84,84,0,-,64000,40847
139,64,75,828,-,40849
460,254,206,588,66600,40854
309,210,99,551,57100,40855
320,251,69,-,50400,40856
156,122,34,-,68000,40858
176,153,23,-,25300,40862
185,119,66,-,51800,40863
167,126,41,-,75000,40865
346,204,142,-,84200,40868
149,124,25,544,53300,40870
903,714,189,677,77000,40873
146,125,21,-,-,40874
457,319,138,529,53600,40902
274,230,44,674,55000,40903
4425,3070,1355,580,80500,40906
138,95,43,-,-,40913
168,82,86,-,72500,40914
374,188,186,487,111400,40915
55,45,10,-,-,40921
186,156,30,-,59200,40923
201,174,27,-,55200,40927
1082,746,336,599,70000,40935
84,84,0,-,50400,40939
128,96,32,-,73300,40940
69,11,58,-,-,40941
221,173,48,-,85400,40943
89,64,25,-,-,40946
298,213,85,-,135700,40949
200,139,61,-,-,40953
120,107,13,-,-,40958
6534,4527,2007,532,60900,40962
27,20,7,-,-,40964
4843,2741,2102,589,70600,40965
447,348,99,-,53300,40972
3987,2632,1355,576,58100,40977
0,0,0,-,-,40979
125,115,10,-,60300,40982
95,83,12,-,106900,40983
279,140,139,-,61000,40988
27,27,0,-,-,40995
132,68,64,-,75000,40997
6141,5404,737,866,209300,41001
1006,757,249,434,101300,41002
854,618,236,663,136100,41003
1545,1149,396,643,99400,41004
8624,6989,1635,1085,185600,41005
1481,1092,389,755,138300,41006
1716,1539,177,862,245000,41007
2785,1655,1130,644,117400,41008
1409,1148,261,552,142800,41010
12360,5453,6907,753,192300,41011
2747,1294,1453,757,101500,41014
7707,5328,2379,732,135900,41015
2771,1872,899,703,113500,41016
15533,11844,3689,837,205200,41017
10703,6770,3933,898,131000,41018
2163,1666,497,860,167700,41030
6562,4574,1988,600,146500,41031
580,521,59,-,176200,41033
403,360,43,598,108100,41034
4211,2883,1328,716,139000,41035
1047,825,222,645,89200,41039
2839,1864,975,756,105300,41040
2852,1845,1007,557,89000,41041
21516,13972,7544,994,159900,41042
586,495,91,726,129000,41043
387,306,81,779,131600,41044
430,311,119,919,122100,41045
509,423,86,743,95000,41046
5159,4505,654,1173,233800,41048
979,747,232,743,125300,41049
10107,8670,1437,1040,181700,41051
41,17,24,-,-,41052
715,644,71,678,178000,41055
5300,3434,1866,652,141500,41056
1283,1069,214,622,167900,41059
14,14,0,-,-,41062
1107,996,111,634,163100,41063
744,522,222,495,91200,41064
9612,5023,4589,788,145000,41071
2589,1787,802,772,135900,41073
2353,1489,864,824,112000,41074
6292,4397,1895,881,228800,41075
6901,5262,1639,934,153400,41076
705,648,57,-,204300,41080
670,582,88,525,131100,41083
315,206,109,663,94000,41085
943,831,112,840,92800,41086
6677,6226,451,1658,277400,41091
1126,1000,126,861,182900,41092
1281,1065,216,629,75200,41093
5234,4158,1076,955,208200,41094
1339,753,586,715,123700,41095
2473,1692,781,703,123600,41097
774,631,143,678,83100,41098
0,0,0,-,-,41099
7616,4781,2835,699,96500,41101
7253,4962,2291,757,130700,41102
805,795,10,-,138900,41121
353,200,153,601,39800,41124
3657,2824,833,588,109800,41129
134,107,27,-,67700,41132
67,52,15,-,-,41135
3176,2448,728,856,95300,41139
795,672,123,487,49500,41141
0,0,0,-,-,41142
4924,3751,1173,586,123900,41143
3683,2927,756,677,108600,41144
132,104,28,-,-,41146
185,146,39,923,-,41149
188,125,63,313,-,41159
4841,3963,878,603,87200,41164
452,399,53,-,72200,41166
1060,917,143,703,115800,41168
2304,1693,611,721,126900,41169
1348,1015,333,817,96400,41171
442,284,158,518,97500,41174
2081,1500,581,663,103900,41175
2985,2229,756,441,69900,41179
370,306,64,440,55700,41180
704,504,200,740,100000,41183
767,546,221,689,75100,41189
75,75,0,-,101300,41201
219,194,25,-,70800,41203
221,152,69,-,90000,41204
186,62,124,-,95000,41214
516,423,93,675,116900,41216
727,591,136,700,97800,41219
952,867,85,833,122400,41222
1990,1642,348,594,93800,41224
52,52,0,-,63200,41226
4140,3213,927,702,94100,41230
280,143,137,732,71200,41231
255,173,82,731,72500,41232
222,198,24,-,113500,41234
243,162,81,553,120700,41238
2605,1382,1223,613,155100,41240
603,531,72,-,65800,41250
188,148,40,-,-,41254
296,227,69,-,95500,41255
1102,892,210,720,121800,41256
252,172,80,656,80000,41257
291,142,149,297,102700,41260
435,352,83,-,73900,41262
127,47,80,620,131300,41263
211,170,41,-,111300,41264
438,368,70,593,124100,41265
300,165,135,-,85000,41267
376,319,57,-,130600,41268
59,48,11,-,127800,41271
166,121,45,520,-,41274
2591,1671,920,454,67900,41301
2776,1892,884,504,66000,41311
1793,1177,616,319,62200,41314
111,91,20,-,55100,41317
348,271,77,-,62100,41332
4147,2956,1191,491,56500,41339
492,314,178,408,32000,41348
287,245,42,-,44800,41352
116,116,0,-,-,41360
275,118,157,-,46100,41365
21,21,0,-,-,41366
88,58,30,-,-,41367
186,153,33,-,54300,41385
14,0,14,-,-,41390
4,4,0,-,-,41397
183,152,31,-,51400,41408
237,132,105,-,-,41421
485,413,72,873,69700,41425
305,229,76,-,-,41464
4462,3288,1174,607,69800,41465
3420,2565,855,548,84600,41472
9813,5902,3911,727,111700,41501
231,169,62,-,215300,41503
304,258,46,692,122100,41512
224,224,0,-,49700,41513
1215,775,440,715,74700,41514
52,52,0,-,35900,41517
460,370,90,-,78400,41519
2120,1700,420,666,73500,41522
74,74,0,-,-,41524
55,31,24,-,-,41526
296,244,52,-,146500,41527
447,422,25,-,-,41528
394,326,68,549,85300,41531
115,115,0,-,23400,41534
291,228,63,432,138300,41535
1826,1334,492,444,73800,41537
44,44,0,-,99400,41538
643,506,137,755,67500,41539
42,42,0,-,-,41540
209,112,97,-,-,41543
252,207,45,577,54300,41544
345,250,95,-,81100,41547
479,366,113,616,58500,41548
535,489,46,-,85100,41553
471,412,59,704,51800,41554
290,212,78,-,55100,41555
850,720,130,719,125100,41557
380,236,144,525,83400,41558
78,46,32,-,39200,41559
73,59,14,-,114700,41560
1087,797,290,448,76100,41562
129,95,34,-,"10,000-",41563
295,280,15,-,70600,41564
256,147,109,-,63900,41566
47,47,0,-,-,41567
479,462,17,-,-,41568
221,182,39,-,35200,41571
1560,1345,215,765,88900,41572
253,161,92,680,71600,41601
333,286,47,-,71600,41602
656,343,313,804,65400,41603
166,142,24,-,84200,41604
327,313,14,-,105200,41605
383,301,82,570,58100,41606
167,132,35,-,19900,41607
72,46,26,-,-,41612
141,120,21,-,61500,41615
373,306,67,796,60500,41616
106,85,21,-,-,41619
65,26,39,-,-,41621
54,54,0,-,-,41622
502,373,129,580,82300,41630
500,386,114,-,86600,41631
222,189,33,-,79800,41632
1177,907,270,757,67000,41635
357,258,99,729,59800,41636
532,375,157,926,67200,41640
328,204,124,632,106400,41642
53,33,20,-,-,41643
380,327,53,-,-,41645
754,616,138,695,74100,41647
930,597,333,665,68500,41649
151,127,24,-,38000,41650
4239,2735,1504,580,104800,41653
485,238,247,-,64800,41655
205,178,27,-,123400,41659
159,159,0,-,86400,41660
149,70,79,-,-,41663
279,211,68,838,60500,41666
127,127,0,-,49800,41667
262,170,92,525,47900,41669
6649,4875,1774,749,87000,41701
141,141,0,-,-,41712
0,0,0,-,-,41713
166,166,0,-,81400,41714
534,438,96,-,45000,41719
243,160,83,489,-,41721
488,380,108,673,78800,41722
612,462,150,-,83000,41723
19,19,0,-,-,41725
450,389,61,-,71300,41727
0,0,0,-,-,41729
375,342,33,-,50500,41731
57,26,31,-,72500,41735
85,45,40,-,-,41739
322,277,45,-,87500,41740
143,143,0,-,-,41745
352,302,50,-,70100,41746
1405,1282,123,484,84300,41749
105,95,10,-,-,41751
200,181,19,-,-,41754
94,61,33,-,71700,41759
49,49,0,-,-,41760
0,0,0,-,-,41762
249,221,28,-,24800,41763
310,290,20,-,44200,41764
101,101,0,-,55200,41766
115,94,21,-,-,41772
520,378,142,576,39100,41773
1048,906,142,621,70000,41774
25,25,0,-,-,41775
390,335,55,-,62800,41776
438,349,89,-,89400,41777
322,313,9,-,47500,41804
208,164,44,-,-,41810
99,81,18,-,-,41812
322,166,156,-,73600,41815
98,55,43,-,-,41817
161,161,0,-,52600,41819
68,68,0,-,22900,41821
1100,841,259,472,46600,41822
694,486,208,447,35200,41824
151,71,80,-,66900,41825
232,178,54,-,57600,41826
330,272,58,438,58800,41828
435,284,151,519,119300,41831
149,110,39,-,83500,41832
172,68,104,-,-,41833
104,51,53,-,88900,41834
326,302,24,-,53000,41835
399,257,142,788,47300,41836
400,366,34,-,67300,41837
313,198,115,-,54500,41838
454,371,83,624,55600,41839
330,222,108,517,36100,41840
262,206,56,-,43200,41843
545,223,322,458,42600,41844
134,116,18,-,13900,41845
208,164,44,-,26200,41847
0,0,0,-,-,41848
62,62,0,-,51600,41849
408,372,36,-,41300,41855
3320,2293,1027,533,78900,41858
161,134,27,-,50700,41859
68,56,12,-,26600,41861
414,375,39,-,58900,41862
12990,7741,5249,782,164900,42001
11722,7659,4063,659,123200,42003
684,661,23,584,126300,42020
598,465,133,660,76800,42021
57,57,0,-,-,42022
878,714,164,631,81000,42023
461,329,132,575,134100,42024
8174,6997,1177,689,137700,42025
646,579,67,616,146000,42027
234,214,20,-,107300,42028
2537,1888,649,871,130300,42029
1262,960,302,577,81400,42031
69,63,6,-,65000,42032
409,345,64,663,91000,42035
516,465,51,-,115700,42036
26,26,0,-,-,42037
1986,1573,413,578,156900,42038
608,454,154,483,123700,42039
352,301,51,-,103600,42040
1746,1213,533,630,69700,42041
1578,1348,230,726,170700,42044
881,730,151,666,80700,42045
108,55,53,-,-,42047
740,603,137,814,101800,42048
538,443,95,721,119300,42049
1208,860,348,544,65700,42050
1092,981,111,752,104500,42051
2138,1708,430,783,126600,42053
376,266,110,-,148400,42054
1151,1073,78,640,88600,42055
521,416,105,-,114500,42056
878,829,49,995,100700,42058
0,0,0,-,-,42060
62,62,0,-,64300,42061
3238,2648,590,631,96300,42064
9510,6485,3025,666,111000,42066
218,213,5,-,137500,42069
12740,7469,5271,670,148300,42071
529,346,183,525,106500,42076
738,646,92,575,75100,42078
570,489,81,583,131300,42079
932,712,220,533,127600,42081
665,582,83,764,137500,42082
165,165,0,-,-,42083
18,4,14,-,-,42084
292,272,20,-,84100,42085
1733,1352,381,804,142600,42086
950,804,146,630,70200,42087
882,725,157,590,88800,42088
22278,10452,11826,777,137700,42101
21,0,21,-,-,42102
8669,5414,3255,871,255400,42103
14991,9448,5543,864,208500,42104
878,658,220,690,124700,42120
1960,1849,111,733,201300,42122
408,342,66,-,132000,42123
17,17,0,-,-,42124
2792,1594,1198,576,116100,42127
2824,2075,749,536,72200,42129
97,64,33,-,112500,42130
567,380,187,634,117400,42133
6809,4242,2567,844,146600,42134
477,372,105,625,76100,42140
12388,8198,4190,721,130700,42141
52,52,0,-,140500,42151
154,117,37,803,156300,42153
154,148,6,-,66300,42154
157,132,25,-,91800,42156
205,134,71,533,-,42157
702,479,223,1096,159900,42159
631,458,173,656,96300,42160
19,0,19,-,-,42163
6502,4867,1635,673,122500,42164
967,850,117,604,81800,42166
3468,2427,1041,529,104900,42167
528,482,46,631,135500,42170
2499,2008,491,801,141300,42171
828,605,223,514,103900,42202
283,183,100,392,128000,42204
2098,1563,535,788,104400,42206
522,426,96,598,83800,42207
1975,1692,283,566,87100,42210
5481,4308,1173,558,158900,42211
301,263,38,-,139800,42214
548,459,89,734,150500,42215
1243,1009,234,689,98300,42217
2468,1771,697,652,112600,42220
4856,24,4832,1298,-,42223
275,255,20,-,133100,42232
1071,555,516,585,120500,42234
215,159,56,-,-,42236
16928,8904,8024,737,121800,42240
96,69,27,850,84500,42254
1957,1657,300,660,98600,42256
421,359,62,735,103100,42259
4134,2925,1209,597,90400,42261
3106,999,2107,913,118500,42262
267,216,51,575,-,42265
735,591,144,663,162500,42266
151,105,46,478,117400,42273
873,757,116,531,164400,42274
293,218,75,945,-,42275
5801,3817,1984,611,114600,42276
115,110,5,-,108300,42280
179,151,28,-,92500,42285
476,314,162,730,125900,42286
18409,11577,6832,806,139100,42301
16383,10414,5969,825,139900,42303
3320,2437,883,630,86100,42320
58,58,0,-,55800,42321
8,8,0,-,-,42322
267,241,26,720,87100,42323
419,372,47,373,73300,42324
820,621,199,570,83200,42325
151,130,21,-,106200,42326
1600,1289,311,568,118900,42327
443,378,65,738,81900,42328
3288,2508,780,619,118000,42330
96,68,28,-,-,42332
471,361,110,544,67400,42333
667,567,100,750,77200,42337
21,21,0,-,83800,42338
307,296,11,-,87900,42339
541,402,139,623,97000,42343
252,221,31,-,81000,42344
4660,3760,900,609,102700,42345
2385,1835,550,606,98000,42347
1830,1515,315,641,119400,42348
653,517,136,615,82700,42349
659,572,87,615,118300,42350
1635,1254,381,688,102600,42351
816,581,235,426,86800,42352
56,52,4,-,78200,42354
723,600,123,621,119300,42355
0,0,0,-,-,42356
207,173,34,-,112100,42361
1885,1708,177,738,171300,42366
247,230,17,700,83800,42367
510,487,23,-,120400,42368
93,83,10,660,70600,42369
1,1,0,-,-,42370
137,129,8,-,284400,42371
629,504,125,593,92600,42372
124,105,19,838,-,42374
2151,1867,284,793,138600,42376
1247,1089,158,683,147800,42378
961,736,225,629,68400,42404
1210,947,263,685,146600,42406
2905,2149,756,592,67700,42408
901,709,192,546,100900,42409
416,281,135,733,47700,42410
692,576,116,641,88300,42411
1300,1063,237,1287,160600,42413
15733,9433,6300,691,131100,42420
10789,6642,4147,768,124900,42431
535,446,89,-,109900,42436
2740,1803,937,636,107300,42437
394,287,107,674,62600,42440
523,383,140,679,104400,42441
1312,990,322,624,98900,42442
4374,3160,1214,666,90600,42445
1561,1096,465,537,56200,42450
274,195,79,-,72300,42451
834,726,108,744,149200,42452
198,162,36,544,70000,42453
1167,725,442,695,102700,42455
637,535,102,488,106300,42456
616,544,72,-,140500,42458
1575,1188,387,525,83000,42459
512,360,152,710,53800,42461
476,432,44,543,113300,42462
47,45,2,-,42500,42463
645,582,63,627,81800,42464
6631,4141,2490,640,92800,42501
9994,7114,2880,743,142000,42503
276,265,11,-,107000,42516
1217,915,302,760,104200,42518
1311,948,363,634,74100,42519
605,493,112,524,109400,42528
304,159,145,700,91700,42533
3624,2644,980,524,96400,42539
185,176,9,-,103200,42541
2313,1934,379,665,118500,42544
2132,1634,498,709,119400,42553
293,210,83,558,70000,42565
127,97,30,-,-,42566
2360,1726,634,842,82400,42567
4046,2842,1204,513,77600,42602
8,0,8,-,-,42603
2223,1698,525,436,121200,42629
68,0,68,-,-,42631
7922,5803,2119,578,90300,42633
668,588,80,341,52000,42634
1521,817,704,471,91300,42635
30,30,0,-,-,42638
4871,3599,1272,596,92900,42642
1334,982,352,660,59300,42647
735,575,160,592,90500,42649
1743,1099,644,571,82700,42653
20830,12779,8051,787,180900,42701
562,433,129,635,100800,42712
747,521,226,539,92200,42713
92,92,0,-,97500,42715
629,494,135,1029,164400,42716
2590,1858,732,467,110100,42717
9714,6318,3396,643,125500,42718
1308,1037,271,580,115000,42721
179,144,35,784,156800,42722
1937,1759,178,691,139100,42724
1925,1451,474,642,116300,42726
6015,4584,1431,611,108300,42728
678,522,156,644,124100,42729
72,72,0,-,84300,42731
780,610,170,826,82900,42732
585,354,231,875,67500,42733
921,650,271,658,145400,42740
192,158,34,-,107600,42741
3594,2484,1110,518,78600,42743
768,630,138,432,79400,42746
3568,2744,824,709,123400,42748
2177,1522,655,536,84000,42749
350,298,52,712,103800,42753
5983,4245,1738,572,119300,42754
1164,965,199,651,95200,42757
31,23,8,-,-,42758
41,32,9,-,-,42762
219,156,63,-,119400,42764
2366,1742,624,549,100900,42765
955,721,234,733,147900,42776
319,263,56,620,94200,42782
798,654,144,719,103700,42784
137,119,18,-,185300,42788
1003,934,69,1269,263800,43001
2111,1398,713,1478,190900,43002
1162,852,310,828,152700,43003
9675,7619,2056,968,209300,43004
176,145,31,-,-,43005
231,170,61,780,85700,43006
1177,837,340,771,104100,43008
722,609,113,1019,176200,43009
123,98,25,869,113400,43010
2992,2470,522,715,225100,43011
477,403,74,957,330900,43013
1186,907,279,658,167100,43014
21131,14671,6460,973,217600,43015
15402,8160,7242,1204,329200,43016
15377,10487,4890,1243,371000,43017
3103,2688,415,793,153100,43019
3977,3655,322,1141,409100,43021
1033,660,373,889,229700,43022
4366,3704,662,959,341500,43023
1947,1464,483,705,199600,43025
24166,16882,7284,1166,234700,43026
2979,2608,371,1095,164300,43028
149,91,58,-,183000,43029
47,47,0,-,-,43030
5001,4004,997,965,267500,43031
7,7,0,-,-,43032
153,116,37,688,116400,43033
9094,7365,1729,1217,338600,43035
137,71,66,728,105400,43036
101,61,40,758,-,43037
12743,9757,2986,1017,213300,43040
1963,1366,597,767,146600,43044
750,657,93,1003,165400,43045
1405,1085,320,1007,217700,43046
11686,7750,3936,767,154000,43050
9987,6871,3116,1393,372300,43054
23857,14374,9483,806,139300,43055
7148,5522,1626,876,158400,43056
1006,751,255,872,145600,43060
1580,1483,97,750,297800,43061
10320,8241,2079,1126,211300,43062
4635,4001,634,974,290100,43064
14927,13597,1330,1140,348100,43065
609,564,45,1016,235300,43066
555,513,42,-,186900,43067
21424,12422,9002,986,163800,43068
45,45,0,-,65700,43070
807,684,123,828,188100,43071
2458,1970,488,677,137800,43072
4956,4006,950,1251,290200,43074
3588,3148,440,816,207800,43076
89,67,22,1038,127100,43077
8256,5768,2488,713,131600,43078
1897,1191,706,792,165900,43080
25850,16565,9285,1161,218200,43081
12189,10883,1306,1390,335100,43082
215,191,24,950,169900,43084
10115,7236,2879,1150,274300,43085
167,81,86,750,89700,43101
1609,1343,266,903,173600,43102
3853,3011,842,789,176800,43103
3183,2665,518,653,218700,43105
640,474,166,825,83200,43106
1300,1061,239,672,164700,43107
84,40,44,949,157100,43109
15784,9310,6474,998,182000,43110
78,78,0,-,94900,43111
1618,1402,216,836,252300,43112
9476,6402,3074,825,162200,43113
584,437,147,1039,114900,43115
586,533,53,1021,220300,43116
24,0,24,-,-,43117
10470,7790,2680,1063,166800,43119
25432,18881,6551,1075,183400,43123
5948,3309,2639,971,167600,43125
177,117,60,1028,122000,43126
59,31,28,-,65000,43127
948,610,338,723,95400,43128
24002,16369,7633,846,157900,43130
1684,1364,320,530,133700,43135
357,273,84,940,227200,43136
763,612,151,823,134500,43137
7485,5503,1982,617,136900,43138
7740,5588,2152,808,169100,43140
54,27,27,785,72500,43142
1948,1350,598,810,168600,43143
164,111,53,603,65300,43144
899,688,211,839,144800,43145
3635,3168,467,740,242000,43146
14098,12188,1910,1304,233400,43147
738,560,178,631,124400,43148
1001,908,93,879,165200,43149
909,786,123,765,163600,43150
94,61,33,846,92500,43151
316,246,70,499,121300,43152
423,303,120,817,154700,43153
1275,1088,187,1023,152300,43154
1112,860,252,585,170200,43155
90,75,15,-,110400,43156
205,127,78,850,110600,43157
137,106,31,-,78900,43158
9062,5594,3468,698,117800,43160
2766,2147,619,930,151000,43162
779,566,213,925,125000,43164
13106,2215,10891,1094,258900,43201
8889,2712,6177,976,246800,43202
3758,1224,2534,744,188900,43203
17220,8651,8569,935,117300,43204
5510,1949,3561,755,211600,43205
10435,5060,5375,994,197400,43206
18656,11435,7221,908,102700,43207
11990,6785,5205,885,284300,43209
192,0,192,623,-,43210
8714,3464,5250,871,58200,43211
11712,3950,7762,1151,381300,43212
14163,5289,8874,872,125600,43213
12682,8097,4585,998,285800,43214
9609,1891,7718,1215,324000,43215
678,52,626,897,37800,43217
11479,5158,6321,960,114500,43219
12475,6259,6216,1032,355500,43220
14190,10010,4180,1244,306300,43221
1956,401,1555,554,68300,43222
8786,4179,4607,845,84700,43223
17585,8324,9261,827,103200,43224
9751,4742,5009,898,86300,43227
22188,10782,11406,943,135500,43228
21343,8495,12848,879,143000,43229
24546,14855,9691,1140,204000,43230
8243,4227,4016,981,156500,43231
18329,7304,11025,864,104700,43232
18505,10358,8147,1178,256900,43235
2101,553,1548,1246,204800,43240
20193,12913,7280,742,98300,43302
1198,1009,189,853,136600,43310
7485,5101,2384,701,130300,43311
1151,907,244,665,154100,43314
2872,2265,607,805,136600,43315
2405,1718,687,661,123800,43316
48,31,17,880,93900,43317
1635,1375,260,1008,154900,43318
364,358,6,-,200000,43319
563,499,64,926,96800,43320
106,95,11,715,117700,43321
115,82,33,750,81700,43322
315,267,48,763,130300,43323
1225,1089,136,825,205300,43324
5432,3999,1433,617,104600,43326
45,23,22,619,70800,43330
2069,1743,326,814,125500,43331
770,632,138,564,104200,43332
238,196,42,-,-,43333
2203,1929,274,844,188000,43334
0,0,0,-,-,43336
504,461,43,996,117800,43337
3954,3029,925,661,159400,43338
658,488,170,869,136500,43340
372,344,28,585,98700,43341
1257,1102,155,945,126600,43342
648,517,131,625,115300,43343
2326,1931,395,761,166100,43344
375,335,40,766,151100,43345
465,386,79,841,125500,43347
1064,683,381,627,126500,43348
4472,2990,1482,636,136700,43351
510,375,135,566,178600,43356
1587,1166,421,652,173100,43357
1195,866,329,848,142100,43358
300,210,90,608,157300,43359
598,478,120,851,169500,43360
13414,6110,7304,740,183700,43402
5,0,5,-,-,43403
778,628,150,607,120000,43406
181,178,3,625,155000,43407
105,90,15,920,92900,43408
3949,3009,940,703,117200,43410
1677,1479,198,878,171100,43412
377,310,67,898,97300,43413
1256,905,351,653,144300,43416
12194,8122,4072,718,115700,43420
1886,1552,334,809,122900,43430
1812,1509,303,720,120500,43431
509,509,0,-,169700,43432
28,28,0,-,-,43433
44,40,4,-,-,43434
417,371,46,975,140700,43435
176,117,59,864,118500,43437
144,134,10,850,298300,43438
43,43,0,-,-,43439
2368,1893,475,805,204000,43440
329,270,59,642,112300,43442
651,512,139,821,153100,43443
424,409,15,-,145100,43445
40,39,1,-,225000,43446
1170,996,174,823,156500,43447
3467,2596,871,760,154600,43449
1436,984,452,911,184200,43450
386,300,86,679,134300,43451
6919,5234,1685,738,154100,43452
170,156,14,1025,351200,43456
609,543,66,817,135300,43457
159,135,24,754,84400,43458
2552,1874,678,724,145300,43460
439,374,65,866,100500,43462
34,0,34,-,-,43463
782,482,300,813,99800,43464
2398,1716,682,760,117900,43465
792,634,158,978,155200,43466
37,28,9,-,50000,43467
140,127,13,-,88700,43468
1218,925,293,649,151600,43469
327,239,88,595,102900,43501
2466,2014,452,640,153700,43502
415,354,61,489,184600,43504
36,24,12,525,105000,43505
6188,4408,1780,708,114400,43506
450,388,62,-,143100,43511
11658,8713,2945,766,128300,43512
2890,2483,407,679,138300,43515
1142,836,306,776,114700,43516
1576,1315,261,681,103600,43517
1146,1001,145,771,132100,43518
73,54,19,-,84000,43519
1175,840,335,670,97500,43521
1350,1165,185,885,157200,43522
9,9,0,-,-,43523
444,357,87,676,106300,43524
370,336,34,778,196100,43525
2263,1822,441,645,114800,43526
905,783,122,688,99600,43527
6475,4770,1705,962,202600,43528
101,81,20,860,80600,43529
128,105,23,-,103500,43531
1507,1290,217,768,145800,43532
746,499,247,572,159800,43533
731,593,138,704,110600,43534
237,186,51,796,117900,43535
81,81,0,-,-,43536
11940,8209,3731,837,182700,43537
505,423,82,861,147100,43540
52,48,4,-,70000,43541
1126,1063,63,-,276600,43542
3323,2591,732,635,93700,43543
5724,4133,1591,762,140800,43545
162,148,14,-,182000,43547
297,282,15,-,106500,43548
515,477,38,635,136000,43549
16085,10753,5332,988,214600,43551
97,74,23,-,115400,43553
946,712,234,806,106500,43554
89,42,47,-,139200,43555
697,574,123,585,122600,43556
1021,857,164,754,110400,43557
5687,4937,750,782,141800,43558
12287,10196,2091,932,204600,43560
150,106,44,931,121200,43565
3274,2877,397,1121,217400,43566
4969,3868,1101,820,135900,43567
1087,827,260,734,127200,43569
1193,913,280,674,112800,43570
2760,2170,590,821,214600,43571
4761,840,3921,448,31300,43604
10377,4567,5810,734,37900,43605
10335,5344,4991,802,127600,43606
8910,4138,4772,728,57700,43607
5416,2672,2744,720,35200,43608
8850,3810,5040,757,48700,43609
1750,844,906,709,59700,43610
8033,5414,2619,716,87700,43611
12259,6493,5766,838,70200,43612
13622,8579,5043,796,98900,43613
14183,7897,6286,732,127700,43614
18207,9549,8658,824,99700,43615
8718,6504,2214,664,149700,43616
2733,2438,295,796,216800,43617
3031,2420,611,784,146200,43619
2441,760,1681,502,112000,43620
8933,5834,3099,737,135100,43623
22787,14726,8061,707,119100,43701
11,9,2,-,-,43711
2500,2138,362,497,115800,43713
980,739,241,600,99500,43716
64,56,8,375,62700,43717
1115,905,210,855,120900,43718
1050,814,236,636,131100,43719
476,431,45,783,114400,43720
64,40,24,-,-,43721
121,60,61,-,91300,43722
1964,1271,693,586,89300,43723
2864,2184,680,604,99100,43724
8674,5736,2938,718,124200,43725
473,420,53,-,142000,43727
593,486,107,718,106700,43728
838,687,151,625,106800,43730
1959,1480,479,603,83000,43731
681,558,123,600,110100,43732
18,18,0,-,-,43733
600,496,104,435,162100,43734
124,89,35,-,26000,43735
23,20,3,-,95000,43736
62,53,9,-,84800,43738
788,703,85,757,221700,43739
106,79,27,-,101000,43740
561,514,47,-,134500,43746
409,303,106,738,152600,43747
974,783,191,673,145500,43748
964,822,142,-,125000,43749
35,35,0,-,46300,43750
507,415,92,604,120800,43754
702,574,128,1011,121000,43755
2191,1567,624,641,94100,43756
1219,989,230,675,109200,43758
31,26,5,513,85000,43759
496,266,230,764,111700,43760
42,42,0,-,-,43761
1710,1312,398,766,169900,43762
3013,1941,1072,608,98600,43764
620,468,152,660,73000,43766
394,371,23,-,146500,43767
164,84,80,1088,95000,43768
844,670,174,658,112900,43771
777,613,164,689,106700,43772
1195,944,251,767,130800,43773
1982,1484,498,564,80000,43777
482,437,45,773,162900,43778
271,211,60,632,113100,43779
859,781,78,666,165300,43780
224,187,37,842,90300,43782
1821,1584,237,770,142900,43783
11,7,4,-,-,43786
1246,996,250,682,103600,43787
274,250,24,700,142000,43788
2017,1391,626,618,106000,43793
380,355,25,541,132700,43802
957,678,279,708,177600,43804
78,32,46,-,-,43805
290,220,70,675,90000,43811
7832,5251,2581,616,92800,43812
1436,1182,254,644,136700,43821
2062,1784,278,639,116300,43822
1352,1202,150,711,169600,43824
2139,1643,496,705,176800,43830
3194,2431,763,751,92200,43832
66,55,11,-,79600,43836
710,597,113,726,95500,43837
421,366,55,765,138400,43840
149,90,59,764,51700,43842
299,235,64,589,176500,43843
1694,1497,197,843,114900,43844
1766,1361,405,636,87500,43845
771,625,146,755,103300,43901
55,38,17,-,85300,43902
762,581,181,700,104000,43903
40,40,0,-,191700,43905
3210,2180,1030,672,98000,43906
2331,1752,579,582,104300,43907
575,425,150,782,83900,43908
1400,1285,115,379,140400,43910
2777,2008,769,576,85700,43912
579,352,227,535,65400,43913
29,22,7,-,-,43914
487,433,54,569,104300,43915
1466,1295,171,673,86700,43917
9259,6092,3167,634,85800,43920
45,0,45,-,-,43925
93,65,28,539,69000,43926
76,76,0,-,-,43927
39,29,10,-,-,43928
314,269,45,704,99800,43930
120,120,0,-,152200,43931
393,331,62,701,107000,43932
822,774,48,-,121400,43933
160,151,9,-,68700,43934
3577,2338,1239,656,86700,43935
2414,1821,593,696,84000,43938
165,150,15,725,99000,43939
256,217,39,-,"10,000-",43940
1033,764,269,388,103000,43942
1244,1077,167,582,87900,43943
1040,749,291,798,116800,43944
1195,942,253,630,107000,43945
958,781,177,728,109300,43946
2107,1652,455,710,106600,43947
253,223,30,695,69100,43948
5148,4097,1051,764,177400,43950
20,20,0,-,-,43951
7339,3783,3556,626,94300,43952
4664,3224,1440,750,115800,43953
177,125,52,617,53000,43961
32,22,10,600,108300,43962
599,323,276,614,90500,43963
3890,3050,840,550,97300,43964
0,0,0,-,-,43967
2750,2041,709,606,80800,43968
0,0,0,-,-,43970
504,306,198,562,84900,43971
79,79,0,-,85000,43972
898,776,122,624,108000,43973
32,30,2,-,80000,43974
633,504,129,698,96700,43976
814,626,188,787,81200,43977
190,136,54,-,103300,43983
22,15,7,-,64200,43985
784,667,117,731,97700,43986
1011,783,228,675,105800,43988
8208,6928,1280,821,165100,44001
1666,1266,400,803,93800,44003
13399,8586,4813,695,90000,44004
558,393,165,1358,167100,44010
8496,7365,1131,1276,309300,44011
9912,8031,1881,1170,260000,44012
7053,4996,2057,843,145100,44017
2222,1714,508,856,185200,44021
6876,6005,871,1021,372000,44022
6800,6224,576,-,314200,44023
9007,7565,1442,831,254500,44024
4441,4262,179,-,242800,44026
3632,3321,311,1224,225200,44028
6267,4728,1539,637,106300,44030
387,369,18,-,116600,44032
27155,16947,10208,757,112400,44035
12730,11145,1585,1049,188400,44039
1109,1049,60,2250,401500,44040
6326,4253,2073,712,133200,44041
4188,3626,562,793,177900,44044
258,198,60,943,115700,44045
866,660,206,740,207900,44046
3327,2589,738,756,146400,44047
829,661,168,668,123400,44048
76,67,9,-,111300,44049
2426,2025,401,907,171200,44050
11494,6035,5459,723,80900,44052
8104,5049,3055,709,143000,44053
5305,4223,1082,903,129200,44054
8116,4267,3849,729,69600,44055
4671,4348,323,927,230200,44056
7503,5979,1524,932,141500,44057
25247,20332,4915,951,180400,44060
4229,3336,893,690,174100,44062
714,648,66,891,192800,44064
1811,1615,196,757,222800,44065
8469,7433,1036,1002,191800,44067
13040,9767,3273,976,161200,44070
1740,1457,283,1295,272800,44072
3780,2557,1223,796,173900,44074
1852,1326,526,660,138300,44076
22249,15984,6265,838,168900,44077
109,88,21,-,111800,44080
2524,2244,280,740,189400,44081
545,414,131,1017,125700,44082
1190,1042,148,817,156000,44084
1308,1132,176,909,134800,44085
966,936,30,567,189600,44086
8574,6496,2078,1115,222300,44087
6591,5155,1436,890,151400,44089
4339,3419,920,669,181700,44090
7697,5127,2570,916,130400,44092
437,369,68,815,159200,44093
16345,10498,5847,997,196800,44094
14627,10862,3765,871,127500,44095
727,668,59,-,164600,44099
0,0,0,-,-,44101
20377,6774,13603,744,80900,44102
7172,2367,4805,574,47700,44103
8559,2353,6206,529,44100,44104
15187,7502,7685,747,51000,44105
11050,3013,8037,842,188700,44106
25489,10842,14647,813,171500,44107
10007,4506,5501,742,49700,44108
17427,7999,9428,737,82700,44109
9767,3704,6063,684,52200,44110
18438,10483,7955,777,95000,44111
9525,3595,5930,674,64100,44112
10043,2795,7248,1046,249000,44113
3806,298,3508,1017,57900,44114
4387,370,4017,633,103200,44115
9038,6503,2535,896,260500,44116
4919,2042,2877,691,105400,44117
15919,9510,6409,995,155400,44118
6154,3040,3114,747,86300,44119
17128,8038,9090,769,87300,44120
13396,8907,4489,954,101200,44121
13955,8744,5211,1280,255700,44122
8147,3913,4234,858,77800,44123
17329,11033,6296,971,159200,44124
11500,7075,4425,949,80200,44125
7150,4953,2197,830,169900,44126
1960,742,1218,612,34100,44127
12946,6586,6360,832,68300,44128
11852,8222,3630,867,115000,44129
22153,13822,8331,858,137400,44130
8377,7754,623,1249,192600,44131
6381,2749,3632,845,81100,44132
13145,8913,4232,891,215800,44133
15865,12059,3806,941,115900,44134
11733,7167,4566,746,86500,44135
10610,7726,2884,1028,207700,44136
10043,6033,4010,1046,69700,44137
9089,7372,1717,1066,168200,44138
8622,7379,1243,1225,307500,44139
5860,5414,446,1141,257000,44140
5586,4608,978,1555,291800,44141
7768,6073,1695,922,121400,44142
10783,7842,2941,799,198900,44143
9415,5401,4014,778,98300,44144
13779,9898,3881,1223,263500,44145
14269,7520,6749,850,109700,44146
7961,6660,1301,925,232300,44147
7892,7351,541,1148,227800,44149
2476,2153,323,798,160900,44201
7680,6488,1192,1434,266300,44202
17077,11492,5585,788,112200,44203
17532,13406,4126,924,186600,44212
732,638,94,576,174100,44214
944,757,187,918,154500,44215
3376,3052,324,835,158500,44216
1340,1177,163,727,140200,44217
12967,7276,5691,872,121900,44221
7963,6042,1921,835,156100,44223
16095,10891,5204,993,195100,44224
3601,3114,487,809,153400,44230
3445,2741,704,751,157400,44231
2948,2867,81,850,329600,44233
1301,1139,162,771,190500,44234
583,512,71,846,216800,44235
9182,8214,968,1828,354300,44236
16666,8806,7860,812,163400,44240
6900,4847,2053,1097,142600,44241
0,0,0,-,-,44243
469,404,65,714,89800,44250
382,334,48,1306,244600,44251
1195,1124,71,783,215900,44253
1993,1478,515,704,151100,44254
2984,2394,590,778,144500,44255
24611,19759,4852,963,221200,44256
5176,4333,843,905,149900,44260
2105,1627,478,809,167900,44262
1203,1024,179,958,280700,44264
0,0,0,-,-,44265
13832,9750,4082,864,125400,44266
3401,2298,1103,724,136500,44270
2050,1670,380,928,172800,44272
2899,2450,449,779,191700,44273
70,70,0,-,-,44274
1231,1085,146,810,176900,44275
656,584,72,679,170100,44276
7076,5889,1187,866,174700,44278
1882,1590,292,1438,287400,44280
13086,9699,3387,878,192700,44281
11,11,0,-,-,44285
2473,2298,175,1015,264300,44286
2818,2464,354,759,134300,44287
1280,824,456,815,121000,44288
6218,3604,2614,893,78100,44301
2557,960,1597,678,89100,44302
3883,2128,1755,828,157600,44303
1382,136,1246,785,65800,44304
9249,5413,3836,864,73700,44305
9015,4091,4924,812,61300,44306
2878,882,1996,678,62000,44307
286,0,286,281,-,44308
10630,4085,6545,758,70500,44310
3056,528,2528,622,47000,44311
13692,10341,3351,825,107700,44312
12510,7161,5349,848,159500,44313
8191,4458,3733,809,66100,44314
9728,7026,2702,909,152100,44319
8819,4973,3846,745,78100,44320
6190,4835,1355,1132,245900,44321
7643,6304,1339,998,237000,44333
1108,954,154,1058,205500,44401
1235,1103,132,675,155100,44402
1813,1586,227,638,119500,44403
607,558,49,560,145200,44404
3213,2081,1132,663,64200,44405
8582,7491,1091,735,202900,44406
4352,3202,1150,554,162400,44408
7657,6183,1474,687,149300,44410
697,650,47,781,144200,44411
1029,906,123,705,178400,44412
2864,2240,624,767,95500,44413
611,537,74,715,110000,44417
503,434,69,541,162100,44418
6376,4393,1983,658,90100,44420
1047,853,194,826,150100,44423
5965,4685,1280,680,109500,44425
488,442,46,706,-,44427
1294,1027,267,649,114600,44428
1178,934,244,781,124400,44429
1566,1141,425,683,98400,44430
1888,1623,265,733,103200,44431
4159,3027,1132,688,106900,44432
1547,1341,206,565,115100,44436
1745,1470,275,737,98800,44437
2144,1378,766,754,60400,44438
67,35,32,632,-,44439
1961,1629,332,651,121800,44440
685,679,6,-,112700,44441
1676,1500,176,659,141400,44442
633,530,103,687,203500,44443
4452,3156,1296,659,106500,44444
1191,907,284,687,108400,44445
9146,5451,3695,688,86100,44446
576,489,87,632,144200,44449
765,604,161,769,151600,44450
1184,933,251,630,167400,44451
1414,1177,237,-,154900,44452
445,360,85,-,140000,44454
864,828,36,846,137400,44455
10380,7468,2912,669,116500,44460
1598,1418,180,489,123800,44470
4503,3218,1285,759,74300,44471
1584,1222,362,921,141100,44473
3779,3155,624,648,138100,44481
11279,6844,4435,713,79800,44483
9155,6343,2812,737,132600,44484
7038,3750,3288,655,58900,44485
324,186,138,711,78400,44490
992,930,62,683,146300,44491
28,10,18,-,-,44493
3643,2006,1637,781,30900,44502
563,0,563,304,-,44503
2271,1064,1207,638,67200,44504
7273,3843,3430,583,70300,44505
1147,677,470,505,25800,44506
1999,878,1121,628,16700,44507
5589,3295,2294,644,45700,44509
959,457,502,463,-,44510
9244,6799,2445,648,79000,44511
14343,9404,4939,718,122000,44512
9330,7742,1588,827,150100,44514
12503,8118,4385,718,107300,44515
14177,8436,5741,718,114300,44601
2266,1761,505,631,206000,44606
41,41,0,-,91000,44607
640,485,155,749,98000,44608
1512,1314,198,614,122500,44609
55,41,14,-,-,44610
834,761,73,704,128700,44611
2025,1450,575,729,170800,44612
791,554,237,772,101800,44613
5378,4160,1218,826,162900,44614
3908,3127,781,767,127200,44615
2456,1874,582,716,174000,44618
713,605,108,732,145900,44620
1646,1116,530,758,94600,44621
7159,5186,1973,843,152800,44622
1634,1411,223,544,203300,44624
510,374,136,787,192300,44625
1202,991,211,844,123400,44626
1679,1400,279,525,283200,44627
362,291,71,712,111300,44628
1181,887,294,598,136400,44629
3754,3012,742,755,190300,44632
673,572,101,676,208800,44633
966,780,186,637,118700,44634
921,726,195,688,145900,44637
412,281,131,627,163200,44638
73,52,21,825,75600,44640
8016,6080,1936,734,152100,44641
1575,1276,299,720,125300,44643
2403,1692,711,684,140100,44644
1030,857,173,858,173800,44645
19448,13257,6191,754,140900,44646
8056,6029,2027,787,113100,44647
336,291,45,-,152400,44651
0,0,0,-,-,44652
247,192,55,862,75900,44653
5797,4289,1508,672,234100,44654
978,742,236,618,165500,44656
3971,2827,1144,691,121500,44657
47,41,6,-,115800,44659
90,69,21,682,70800,44661
3819,3164,655,677,136900,44662
10988,7259,3729,786,138400,44663
1131,976,155,776,156200,44666
5052,3573,1479,738,147900,44667
579,462,117,735,159200,44669
51,51,0,-,84500,44670
54,54,0,-,-,44671
2110,1097,1013,790,87700,44672
889,706,183,988,115100,44675
1745,1400,345,647,152300,44676
950,747,203,797,148700,44677
82,32,50,-,-,44678
1744,1310,434,690,164900,44680
2577,1980,597,735,250900,44681
358,247,111,689,95500,44682
3087,1927,1160,740,85500,44683
10505,8666,1839,963,199600,44685
22,2,20,-,-,44687
1291,1011,280,764,120200,44688
227,165,62,775,112200,44689
71,62,9,-,162800,44690
18705,13052,5653,776,158200,44691
8,6,2,-,-,44693
639,558,81,456,97300,44695
93,87,6,-,225000,44697
318,250,68,566,153800,44699
505,0,505,285,-,44702
3779,1490,2289,713,56700,44703
1393,693,700,613,62900,44704
7422,3946,3476,725,67900,44705
7255,5347,1908,792,106200,44706
3560,1770,1790,434,88200,44707
10848,7609,3239,824,122300,44708
8312,4682,3630,713,115400,44709
3436,1756,1680,800,77100,44710
4110,2486,1624,733,100000,44714
5619,3900,1719,775,223500,44718
16313,11593,4720,847,185300,44720
5597,4704,893,748,170000,44721
2548,2044,504,765,116500,44730
394,357,37,639,120400,44802
474,426,48,917,158600,44804
12686,8829,3857,712,125800,44805
957,800,157,638,91400,44807
104,29,75,828,48500,44809
5027,3587,1440,712,120700,44811
3227,2492,735,614,160000,44813
947,758,189,936,198000,44814
288,220,68,666,81300,44815
15,15,0,-,-,44816
592,526,66,865,143200,44817
933,805,128,593,102900,44818
7519,5338,2181,648,101400,44820
1183,854,329,689,150000,44822
1461,1251,210,637,149900,44824
37,30,7,-,72000,44825
560,511,49,-,137400,44826
2945,2228,717,631,104300,44827
65,31,34,1038,-,44828
7484,5440,2044,650,85600,44830
7052,4651,2401,644,89800,44833
1000,873,127,909,113900,44836
1531,1197,334,690,120800,44837
74,65,9,755,106300,44838
5420,4226,1194,760,191700,44839
995,846,149,835,151200,44840
272,239,33,731,92600,44841
2099,1472,627,618,137700,44842
952,844,108,705,167400,44843
235,225,10,-,137500,44844
1130,992,138,797,162900,44846
1451,1156,295,845,130700,44847
918,746,172,773,104000,44849
13,6,7,-,-,44850
1894,1435,459,702,117200,44851
551,443,108,559,158000,44853
664,478,186,762,90000,44854
453,349,104,699,133700,44855
128,116,12,636,97500,44856
9939,6592,3347,697,145000,44857
828,817,11,-,160900,44859
19,9,10,-,-,44861
1432,1169,263,739,108000,44864
1072,824,248,756,112400,44865
814,724,90,979,164800,44866
990,750,240,876,129500,44867
16987,10440,6547,763,111300,44870
117,85,32,618,83600,44874
5856,4083,1773,640,110800,44875
915,728,187,835,156200,44878
1009,955,54,-,165800,44880
15,4,11,-,-,44881
1119,946,173,690,112400,44882
11454,7991,3463,686,118900,44883
323,293,30,650,79100,44887
2782,2344,438,661,184800,44889
4039,3015,1024,675,110500,44890
0,0,0,-,-,44901
1989,672,1317,604,46700,44902
9571,6536,3035,715,129900,44903
5819,4294,1525,682,146800,44904
4804,3657,1147,749,83500,44905
7341,4482,2859,687,101100,44906
7039,3779,3260,648,94300,44907
211,92,119,765,-,45001
4913,3687,1226,837,216500,45002
191,130,61,775,112500,45003
12685,8909,3776,830,146000,45005
25435,18698,6737,863,197200,45011
20658,14747,5911,845,159900,45013
17807,10959,6848,958,165500,45014
4776,2714,2062,935,91000,45015
7830,6279,1551,896,172200,45030
207,126,81,794,99100,45032
87,62,25,-,50000,45033
406,334,72,-,209700,45034
12613,8759,3854,877,236800,45036
9796,8261,1535,1226,226800,45039
20480,15774,4706,1424,311100,45040
106,106,0,-,-,45041
11414,8048,3366,876,149200,45042
19737,12308,7429,832,177400,45044
3331,2530,801,1222,185500,45050
0,0,0,-,-,45051
1604,1386,218,715,218700,45052
1276,1215,61,1059,256700,45053
1097,1020,77,-,227700,45054
8565,4250,4315,852,201200,45056
227,197,30,1017,114300,45062
1210,1069,141,950,170500,45064
1994,1712,282,1029,206800,45065
8568,7678,890,1275,251100,45066
4846,3414,1432,1105,146000,45067
4411,3598,813,854,247700,45068
19561,15565,3996,1324,241300,45069
53,37,16,921,57900,45070
958,557,401,547,106300,45101
8584,5973,2611,767,161900,45102
12564,8641,3923,862,178600,45103
5012,3995,1017,710,151000,45106
3689,2535,1154,731,144800,45107
143,138,5,-,238500,45111
25,23,2,-,106300,45112
1753,1506,247,997,213600,45113
46,37,9,-,-,45115
1450,1231,219,896,177800,45118
1180,866,314,716,143900,45120
3511,2408,1103,628,113300,45121
4295,3548,747,1041,153000,45122
3411,2224,1187,637,112300,45123
1566,1199,367,817,114300,45130
109,68,41,786,85000,45131
131,82,49,583,64400,45132
9359,6348,3011,667,137200,45133
2054,1562,492,713,135400,45135
20853,16153,4700,1134,261900,45140
1426,1126,300,781,120300,45142
1592,1189,403,562,83000,45144
10,10,0,-,-,45145
510,380,130,741,112500,45146
76,46,30,829,75900,45147
560,417,143,822,152200,45148
13277,9922,3355,839,200100,45150
3864,3424,440,938,238400,45152
672,614,58,991,133600,45153
3308,2407,901,742,145100,45154
138,111,27,675,69700,45155
21,21,0,-,98800,45156
3734,3195,539,732,179600,45157
143,81,62,729,89700,45158
1381,1022,359,747,124300,45159
408,123,285,302,112900,45160
908,757,151,944,189300,45162
110,76,34,725,78200,45164
38,0,38,-,-,45166
1510,955,555,632,148500,45167
718,542,176,725,119700,45168
1784,1350,434,635,96400,45169
2355,1879,476,835,151500,45171
95,89,6,-,125300,45172
724,687,37,1563,497200,45174
3842,2758,1084,826,151200,45176
9111,5796,3315,758,158000,45177
8131,2122,6009,1182,372300,45202
1271,327,944,350,240900,45203
2760,1154,1606,716,69900,45204
7353,2861,4492,723,80300,45205
6112,2006,4106,715,232200,45206
2287,1059,1228,709,87000,45207
8575,5581,2994,1093,396900,45208
6049,2382,3667,958,279600,45209
15452,7545,7907,733,114600,45211
10252,4614,5638,759,149900,45212
5204,3029,2175,717,198100,45213
3687,781,2906,625,72600,45214
12690,7040,5650,824,150200,45215
3544,1645,1899,834,78800,45216
2862,1803,1059,692,112100,45217
1572,1119,453,883,126200,45218
6630,1054,5576,910,121600,45219
6541,1775,4766,792,299600,45220
5373,2179,3194,732,156900,45223
9590,5870,3720,721,121200,45224
4007,561,3446,511,71000,45225
2712,1601,1111,980,362100,45226
8796,4556,4240,939,164800,45227
6503,2101,4402,642,186500,45229
11671,8710,2961,803,180500,45230
16397,11439,4958,921,112900,45231
3066,580,2486,413,96500,45232
5966,4837,1129,782,219900,45233
11653,7514,4139,864,156400,45236
10071,4773,5298,773,115100,45237
19387,11349,8038,715,129200,45238
12333,7299,5034,845,123400,45239
10090,6037,4053,1010,132900,45240
10063,7483,2580,1056,210500,45241
8852,6930,1922,1351,329900,45242
5633,5100,533,1407,473900,45243
10969,9046,1923,881,288100,45244
8708,5814,2894,943,182900,45245
6025,3075,2950,1036,142900,45246
9084,7413,1671,954,215500,45247
9730,8345,1385,944,157300,45248
5518,3544,1974,1257,364700,45249
8497,6088,2409,1023,122100,45251
2085,2028,57,947,222000,45252
9110,6043,3067,1120,212600,45255
86,86,0,-,99800,45301
1554,1297,257,911,183300,45302
847,610,237,644,94000,45303
2757,2095,662,699,143700,45304
4423,3384,1039,1000,231200,45305
833,616,217,695,160300,45306
147,92,55,688,82300,45307
1707,1296,411,759,117200,45308
5342,3882,1460,817,156100,45309
98,91,7,-,122800,45310
2307,1834,473,703,137900,45311
378,345,33,733,161800,45312
1189,872,317,696,217200,45314
1546,1301,245,1263,139600,45315
41,23,18,725,112500,45316
408,346,62,738,180400,45317
2216,1763,453,622,144900,45318
135,100,35,667,113900,45319
6338,4775,1563,704,134200,45320
385,313,72,884,113500,45321
9418,7008,2410,885,126000,45322
2122,1802,320,673,141600,45323
17495,8553,8942,860,131100,45324
1043,958,85,938,186600,45325
352,291,61,637,117100,45326
3463,2854,609,843,155200,45327
221,131,90,789,81700,45328
321,237,84,932,93900,45330
9847,6363,3484,629,122500,45331
278,225,53,-,109600,45332
415,314,101,720,167700,45333
861,560,301,625,121000,45334
2753,2176,577,723,145200,45335
52,47,5,-,96300,45336
564,470,94,775,157300,45337
1983,1579,404,776,143000,45338
507,403,104,869,136500,45339
209,203,6,-,145600,45340
1535,1209,326,779,86000,45341
14406,8992,5414,991,153900,45342
6669,5046,1623,749,121200,45344
2475,1855,620,760,112500,45345
894,685,209,861,95000,45346
1805,1413,392,692,98900,45347
258,228,30,725,166800,45348
135,85,50,875,110100,45349
19,19,0,-,98600,45350
90,71,19,710,171900,45351
103,70,33,665,53100,45352
72,72,0,-,168800,45353
261,173,88,1314,89700,45354
10072,6449,3623,786,99900,45356
95,80,15,788,116700,45358
674,550,124,597,132300,45359
182,142,40,708,63100,45360
115,77,38,933,97500,45361
504,446,58,581,176700,45362
564,488,76,763,204700,45363
11836,7690,4146,757,134500,45365
1946,1382,564,604,125800,45368
1494,1311,183,759,172700,45369
950,819,131,821,341200,45370
8356,6282,2074,877,193200,45371
136,82,54,755,91000,45372
13412,9450,3962,780,164400,45373
6574,3940,2634,715,149100,45377
183,173,10,742,85200,45378
2120,1657,463,606,160500,45380
2200,1765,435,728,146000,45381
414,317,97,782,120900,45382
2966,2265,701,717,130200,45383
156,139,17,-,117900,45384
15768,10601,5167,747,151300,45385
2641,1944,697,794,250000,45387
221,198,23,625,198900,45388
188,147,41,709,83300,45389
1237,839,398,669,72500,45390
4588,1369,3219,728,75200,45402
6101,2219,3882,646,55100,45403
4219,1806,2413,740,58700,45404
8806,3026,5780,683,59400,45405
9513,4623,4890,743,63200,45406
2886,1947,939,1017,170100,45409
7302,3315,3987,776,71600,45410
9474,5909,3565,755,122300,45414
5644,3621,2023,775,130700,45415
2002,1389,613,1044,69000,45416
11883,6696,5187,732,49500,45417
626,511,115,875,120700,45418
6555,4466,2089,793,174900,45419
12026,6877,5149,775,86900,45420
20179,15477,4702,926,130000,45424
7209,3667,3542,761,83100,45426
0,0,0,-,-,45428
11687,8108,3579,876,159600,45429
2923,2374,549,949,188400,45430
12187,6455,5732,1148,153100,45431
6963,5027,1936,756,137700,45432
612,6,606,1271,-,45433
4473,4237,236,1048,232700,45434
4057,2121,1936,826,85400,45439
8883,5901,2982,901,186300,45440
8471,4998,3473,845,112000,45449
13033,9988,3045,1002,246100,45458
12369,8660,3709,951,211900,45459
6278,5571,707,842,169000,45502
14065,8449,5616,782,120700,45503
6221,4260,1961,815,130400,45504
8139,4036,4103,713,71700,45505
5545,3284,2261,687,76600,45506
20864,14339,6525,746,126500,45601
1732,1462,270,377,106300,45612
1043,747,296,558,140700,45613
1575,1232,343,707,110400,45614
790,684,106,535,150600,45616
107,0,107,-,-,45617
0,0,0,-,-,45618
2969,2367,602,769,123000,45619
371,301,70,639,211200,45620
144,93,51,575,46500,45621
41,41,0,-,-,45622
1164,1010,154,820,109500,45623
29,0,29,-,-,45624
2131,1701,430,722,127200,45628
947,740,207,774,110400,45629
53,28,25,-,-,45630
6092,4363,1729,694,121600,45631
680,471,209,619,67400,45634
36,36,0,-,206300,45636
8163,5584,2579,690,92000,45638
6385,4341,2044,757,126400,45640
0,0,0,-,-,45642
1987,1436,551,759,158500,45644
1203,1013,190,845,75500,45645
183,183,0,-,93100,45646
1323,1179,144,491,138900,45647
4041,3233,808,690,119900,45648
124,104,20,-,56500,45650
2056,1410,646,586,92500,45651
1353,1156,197,543,127300,45652
1450,1114,336,725,130200,45653
491,400,91,889,117200,45654
2629,2119,510,650,91900,45656
755,520,235,569,70200,45657
994,822,172,577,108400,45658
897,769,128,848,81900,45659
2996,1997,999,616,124600,45660
2625,1622,1003,652,98200,45661
12417,6372,6045,598,78500,45662
2560,2045,515,645,83900,45663
3874,3088,786,752,144700,45669
99,84,15,538,-,45671
476,465,11,-,68000,45672
192,51,141,646,125500,45673
77,44,33,808,150000,45674
329,214,115,-,127300,45678
1007,705,302,668,133500,45679
4962,3094,1868,701,114600,45680
622,562,60,894,144100,45681
1018,812,206,637,104300,45682
671,548,123,785,99700,45684
435,311,124,602,143800,45685
1249,932,317,711,112700,45686
201,118,83,868,62500,45688
6141,4096,2045,787,124500,45690
3529,2645,884,494,96300,45692
3334,2209,1125,545,115500,45693
4705,3543,1162,764,163600,45694
261,198,63,775,75900,45695
589,456,133,-,-,45696
1829,1449,380,585,151500,45697
217,165,52,626,107700,45698
10666,5337,5329,869,179400,45701
2224,1641,583,660,128900,45710
370,305,65,783,147300,45711
4133,3100,1033,728,139800,45714
946,648,298,592,126000,45715
157,117,40,675,95000,45716
352,177,175,627,58800,45719
18,18,0,-,-,45721
1552,1336,216,611,112900,45723
1072,868,204,1010,122000,45724
161,155,6,658,58300,45727
584,580,4,-,155900,45729
1697,1276,421,602,71000,45732
212,160,52,-,52800,45734
671,579,92,777,147400,45735
166,114,52,654,63200,45740
335,306,29,-,84400,45741
1083,986,97,1019,141700,45742
573,508,65,634,119300,45743
1037,851,186,583,184300,45744
528,370,158,915,75400,45745
132,94,38,910,54300,45746
11078,7380,3698,679,144700,45750
1550,1177,373,576,63700,45760
877,608,269,746,93700,45761
3043,1785,1258,710,82400,45764
526,387,139,496,112500,45766
1085,825,260,433,120300,45767
714,527,187,618,166000,45768
2551,1916,635,604,111200,45769
305,249,56,-,63200,45770
1407,984,423,673,97100,45771
698,514,184,757,113000,45772
0,0,0,-,-,45773
406,365,41,941,89000,45775
309,266,43,543,156100,45776
293,150,143,1052,-,45778
299,230,69,564,102900,45779
1587,835,752,745,218000,45780
171,129,42,700,45600,45782
1439,1159,280,530,160400,45784
1214,1099,115,835,143200,45786
23,23,0,-,-,45787
351,313,38,650,155200,45788
34,29,5,-,-,45789
8792,5056,3736,674,78200,45801
6368,3468,2900,667,63100,45804
9511,5831,3680,789,118800,45805
4339,3421,918,783,139400,45806
4881,3883,998,794,155000,45807
157,115,42,821,82200,45808
40,34,6,-,88100,45809
2535,1568,967,723,125900,45810
716,551,165,538,92200,45812
1431,1223,208,628,111500,45813
1114,879,235,661,162600,45814
142,125,17,619,91300,45816
2629,2137,492,743,161400,45817
114,67,47,928,82600,45819
234,203,31,681,87800,45820
416,380,36,1013,106800,45821
7892,5823,2069,720,153000,45822
161,129,32,565,208300,45826
838,813,25,595,150900,45827
2304,1934,370,589,169200,45828
2134,1803,331,773,132300,45830
1404,1160,244,672,127400,45831
1254,1065,189,677,118400,45832
4346,3270,1076,738,127800,45833
219,203,16,625,110600,45835
592,511,81,600,96900,45836
51,49,2,-,83300,45838
23903,15073,8830,768,157000,45840
366,330,36,536,151700,45841
1458,1172,286,733,97600,45843
1180,1026,154,669,173500,45844
1094,963,131,639,227200,45845
1609,1447,162,518,192200,45846
348,288,60,875,83800,45849
1163,1023,140,602,158700,45850
253,188,65,665,125000,45851
652,482,170,765,169600,45853
153,87,66,816,89800,45854
61,47,14,1063,111700,45855
1992,1601,391,763,132500,45856
1038,821,217,653,142100,45858
243,207,36,495,50700,45859
969,787,182,649,263000,45860
133,120,13,594,59100,45861
663,569,94,591,94400,45862
571,504,67,778,94000,45863
86,82,4,-,97900,45864
1837,1548,289,729,212400,45865
61,43,18,763,105400,45866
467,411,56,731,152600,45867
222,205,17,850,159300,45868
1842,1598,244,631,169600,45869
112,112,0,-,109000,45870
783,567,216,785,157200,45871
1952,1383,569,715,105000,45872
723,592,131,563,104600,45873
909,791,118,761,90100,45874
4239,3431,808,622,176400,45875
357,271,86,723,170300,45876
877,688,189,838,129400,45877
2661,2035,626,707,98700,45879
1011,814,197,709,110300,45880
608,525,83,964,111700,45881
1060,883,177,539,121100,45882
1275,1074,201,660,246000,45883
18,10,8,-,-,45884
5313,4012,1301,809,142200,45885
225,171,54,720,79300,45886
1737,1286,451,668,141300,45887
165,132,33,-,76600,45888
563,547,16,968,174900,45889
282,225,57,716,108500,45890
6065,4458,1607,684,115900,45891
350,298,52,542,154200,45894
7605,5578,2027,723,137200,45895
756,571,185,558,103900,45896
24,24,0,-,-,45897
395,338,57,673,82500,45898
82,65,17,438,64300,45899
3983,3102,881,775,95400,46001
6870,5442,1428,911,110100,46011
8453,5832,2621,837,110700,46012
7808,5088,2720,752,91600,46013
6983,2705,4278,732,51700,46016
2351,1830,521,873,99300,46017
1129,893,236,826,151400,46030
802,696,106,875,150900,46031
20119,13644,6475,1219,352300,46032
14301,12426,1875,1382,364200,46033
2747,2337,410,941,204500,46034
423,338,85,827,114600,46035
4570,3187,1383,735,78400,46036
14661,12050,2611,1237,317500,46037
17373,11840,5533,1236,224300,46038
225,208,17,-,120800,46039
5311,4597,714,1052,308000,46040
8520,5691,2829,738,114400,46041
1135,906,229,712,115900,46044
42,42,0,-,-,46045
18,0,18,-,-,46047
822,679,143,990,108600,46048
443,363,80,-,98500,46049
792,607,185,806,113400,46050
1186,905,281,884,129800,46051
9749,7114,2635,794,154500,46052
4532,4003,529,1445,243600,46055
752,648,104,918,156800,46056
474,327,147,683,167700,46057
866,738,128,948,116100,46058
15428,11197,4231,1040,217800,46060
12934,10483,2451,1018,244000,46062
177,112,65,738,56600,46063
5327,4310,1017,904,174700,46064
1183,892,291,854,158900,46065
1183,1087,96,700,137000,46068
2804,2132,672,708,167700,46069
809,655,154,718,104700,46070
1290,1124,166,892,174000,46071
3652,2860,792,765,122400,46072
13199,10683,2516,1135,291800,46074
2414,1874,540,1273,212900,46075
669,520,149,818,86400,46076
10829,9147,1682,1427,403400,46077
35,23,12,1225,92500,46103
362,329,33,769,152200,46104
658,539,119,792,175800,46105
2752,2282,470,1132,259900,46106
4975,3136,1839,857,108600,46107
259,247,12,-,190500,46110
89,60,29,634,88900,46111
13502,11072,2430,1128,219000,46112
5732,4458,1274,1141,154600,46113
722,551,171,638,124300,46115
231,158,73,-,175900,46117
1997,1572,425,781,164500,46118
2531,1889,642,685,143900,46120
1885,1690,195,1072,171800,46121
5816,4330,1486,900,207000,46122
13379,10939,2440,1199,211700,46123
3213,2033,1180,793,129100,46124
17,17,0,-,-,46125
1837,1504,333,635,169400,46126
148,95,53,-,70600,46127
938,838,100,933,153700,46128
961,853,108,573,212400,46130
12011,8466,3545,901,161700,46131
330,276,54,909,96900,46133
6717,4378,2339,778,140500,46135
16272,11938,4334,904,166700,46140
12431,9056,3375,904,190700,46142
20886,14508,6378,1106,196200,46143
55,44,11,-,68100,46144
68,9,59,-,-,46146
1253,1021,232,876,176500,46147
2089,1545,544,792,118400,46148
747,652,95,918,187100,46149
395,285,110,763,123700,46150
11585,8986,2599,765,167200,46151
62,22,40,-,-,46155
466,402,64,1097,100000,46156
1329,1117,212,840,166400,46157
9017,7049,1968,873,171100,46158
2634,2273,361,788,190400,46160
866,651,215,854,133900,46161
140,140,0,-,151600,46162
4781,4445,336,771,225600,46163
1561,1501,60,850,195400,46164
699,604,95,943,175700,46165
864,653,211,842,130900,46166
2617,2498,119,940,238400,46167
13703,9370,4333,1041,200500,46168
740,718,22,-,130600,46171
972,844,128,974,106700,46172
4134,2637,1497,708,106800,46173
224,161,63,836,65700,46175
11499,7668,3831,802,124200,46176
448,388,60,-,149000,46180
1941,1720,221,870,226700,46181
641,528,113,773,127200,46182
0,0,0,-,-,46183
5177,4269,908,1281,138200,46184
681,633,48,925,162700,46186
13112,5435,7677,808,80600,46201
9714,2770,6944,999,307400,46202
14085,8054,6031,858,93500,46203
4582,937,3645,1370,350100,46204
11857,6012,5845,909,191100,46205
8535,4258,4277,861,123100,46208
9786,4648,5138,899,128100,46214
1225,379,846,1101,210700,46216
12797,9997,2800,1021,154000,46217
12563,5454,7109,875,63700,46218
15857,8957,6900,818,117600,46219
16879,10371,6508,1072,240900,46220
9805,5860,3945,934,119100,46221
12409,5038,7371,882,73800,46222
13754,4911,8843,832,112900,46224
2163,1070,1093,888,75900,46225
19017,8077,10940,901,92900,46226
22360,10672,11688,833,139900,46227
5590,4478,1112,1002,174100,46228
11683,7092,4591,863,126200,46229
3563,2618,945,1336,142400,46231
9788,7794,1994,1227,163100,46234
12101,5846,6255,764,120300,46235
10633,9180,1453,1335,203700,46236
15314,11063,4251,1007,149700,46237
10310,8535,1775,1058,173200,46239
10165,4619,5546,996,238500,46240
10655,6187,4468,913,80700,46241
9034,3778,5256,1032,228900,46250
15672,6947,8725,874,120600,46254
10354,7293,3061,936,214900,46256
3869,3726,143,1264,226600,46259
14220,6629,7591,925,197000,46260
10741,5200,5541,990,149100,46268
3427,3123,304,1446,323500,46278
3606,2353,1253,1314,201300,46280
92,92,0,-,380700,46290
340,319,21,967,485000,46301
5452,4302,1150,947,197500,46303
9890,7496,2394,1013,211700,46304
22967,20128,2839,1046,227000,46307
5269,4359,910,826,164100,46310
8312,7327,985,1217,235000,46311
10645,4665,5980,658,73100,46312
7300,5327,1973,896,145900,46319
5112,2153,2959,688,73200,46320
8535,7221,1314,1032,232800,46321
9524,7664,1860,1086,166700,46322
7884,5356,2528,1015,104900,46323
8489,5717,2772,981,99900,46324
3912,2176,1736,918,85600,46327
425,425,0,-,121600,46340
3830,3271,559,803,168500,46341
11982,9396,2586,925,145700,46342
78,67,11,931,88400,46345
500,296,204,698,65700,46346
1813,1576,237,852,188400,46347
453,368,85,904,118900,46348
1167,1027,140,857,128100,46349
17710,13410,4300,741,154300,46350
6426,5639,787,1081,193600,46356
17615,11503,6112,769,118200,46360
270,259,11,-,149600,46365
2166,1796,370,666,107700,46366
15178,10584,4594,939,158600,46368
1174,993,181,730,185500,46371
6299,6119,180,986,281300,46373
279,224,55,846,164200,46374
9184,7486,1698,1030,240700,46375
63,48,15,950,91400,46376
132,117,15,-,108000,46377
79,79,0,-,97800,46379
88,72,16,-,175000,46381
787,787,0,-,155000,46382
16411,10028,6383,931,197700,46383
14926,12856,2070,1021,235800,46385
1323,1208,115,1038,151100,46390
1978,1669,309,878,188900,46391
2841,2432,409,830,170500,46392
101,64,37,-,-,46393
5114,3229,1885,797,130400,46394
2648,1179,1469,567,64200,46402
5534,2732,2802,792,89800,46403
7051,3748,3303,851,72600,46404
3774,2591,1183,952,86000,46405
3449,1772,1677,807,57800,46406
4912,2042,2870,695,49400,46407
6730,4301,2429,796,74400,46408
2779,1422,1357,988,53700,46409
15832,9754,6078,1057,139100,46410
1255,870,385,782,105600,46501
44,44,0,-,-,46502
1226,1034,192,751,138100,46504
3685,2616,1069,755,171400,46506
3396,2651,745,836,180400,46507
98,96,2,-,93500,46508
1517,1291,226,726,143800,46510
1725,1389,336,730,164000,46511
16467,11802,4665,871,137500,46514
12046,7193,4853,763,114200,46516
9016,5647,3369,741,133300,46517
841,753,88,746,180900,46524
11799,8399,3400,825,148100,46526
7870,5949,1921,855,177300,46528
10819,9796,1023,1195,239100,46530
622,567,55,939,106700,46531
551,471,80,773,107400,46532
3882,3025,857,638,122600,46534
1145,912,233,799,163400,46536
211,199,12,625,94400,46537
1588,1347,241,872,231000,46538
1137,925,212,723,103800,46539
4045,3534,511,928,257100,46540
1542,1223,319,637,126300,46542
914,783,131,852,247400,46543
12697,8431,4266,794,112600,46544
11903,5498,6405,808,127100,46545
4378,2931,1447,763,184100,46550
2576,2088,488,611,155500,46552
1062,967,95,768,202200,46553
1925,1750,175,403,149500,46554
1264,990,274,879,159800,46555
209,14,195,793,-,46556
4809,4057,752,937,160800,46561
1978,1650,328,780,130200,46562
9014,6593,2421,765,138200,46563
2363,2061,302,654,274000,46565
3894,2906,988,813,175300,46567
383,344,39,-,148200,46570
1474,1251,223,778,291500,46571
1299,1059,240,838,176000,46573
3554,3045,509,726,113000,46574
8189,5774,2415,787,144200,46580
5582,3815,1767,840,183500,46582
1691,1102,589,997,150400,46590
32,32,0,-,-,46595
2141,534,1607,603,91800,46601
3793,2186,1607,881,55400,46613
12535,9478,3057,750,133700,46614
6161,3561,2600,802,86900,46615
2266,1200,1066,871,87300,46616
4136,2687,1449,1124,158300,46617
7496,5404,2092,791,77200,46619
10280,6772,3508,845,118500,46628
2552,1973,579,631,134100,46635
7097,4672,2425,929,144500,46637
3244,2593,651,734,148500,46701
932,843,89,675,85600,46702
7537,5539,1998,776,165600,46703
10,10,0,-,-,46704
771,621,150,557,110200,46705
7708,5894,1814,709,146900,46706
1784,1533,251,572,144200,46710
2577,1916,661,615,156700,46711
5828,4174,1654,594,125300,46714
1898,1585,313,740,103500,46721
3202,2722,480,881,150800,46723
9676,7798,1878,742,159700,46725
353,342,11,929,124700,46730
235,187,48,-,-,46731
1056,756,300,790,117900,46732
7897,6023,1874,642,128500,46733
3278,2835,443,889,147100,46737
3392,2633,759,725,112000,46738
1192,990,202,660,159500,46740
1590,1398,192,1029,199500,46741
1379,1070,309,830,164100,46742
817,748,69,909,167700,46743
781,702,79,961,152400,46745
1620,1243,377,1034,129700,46746
913,855,58,725,140600,46747
1570,1481,89,1044,181300,46748
10682,7716,2966,690,105200,46750
6043,4039,2004,642,118100,46755
170,170,0,-,92900,46759
500,369,131,726,123100,46760
4128,3304,824,665,146900,46761
664,634,30,-,172800,46763
498,464,34,850,175900,46764
1895,1743,152,829,212700,46765
381,320,61,-,113600,46766
2723,2201,522,686,123700,46767
1164,977,187,727,129200,46770
19,0,19,-,-,46771
717,660,57,814,173000,46772
1351,1107,244,740,124400,46773
6515,4939,1576,846,122800,46774
808,640,168,773,103900,46776
2557,2088,469,727,144000,46777
873,756,117,776,126000,46779
267,239,28,775,97000,46781
2537,2322,215,687,190400,46783
948,753,195,681,139200,46784
478,407,71,804,155400,46785
20,20,0,-,-,46786
1500,1242,258,700,115800,46787
1091,1048,43,-,191600,46788
445,426,19,875,195400,46791
1511,1145,366,860,112900,46792
1814,1500,314,675,145500,46793
698,599,99,-,124100,46794
2390,2068,322,792,209800,46795
1319,1204,115,774,154500,46797
544,449,95,1013,123500,46798
72,63,9,-,62500,46799
4883,1733,3150,701,87700,46802
3755,1677,2078,690,55600,46803
12288,8800,3488,904,177400,46804
9594,5474,4120,671,97500,46805
8892,4834,4058,771,55600,46806
6327,3666,2661,829,88100,46807
8447,5108,3339,706,87900,46808
4106,2601,1505,631,89300,46809
4224,3855,369,963,293300,46814
10745,8117,2628,817,133200,46815
7296,4361,2935,659,89000,46816
7684,6436,1248,978,151100,46818
4432,3024,1408,809,115100,46819
12779,7757,5022,869,138600,46825
14347,10017,4330,862,140100,46835
8471,7369,1102,1072,227300,46845
16243,11674,4569,681,96900,46901
15491,10525,4966,767,116200,46902
1126,897,229,704,95500,46910
600,574,26,795,167200,46911
480,435,45,-,150700,46913
836,693,143,542,124200,46914
352,277,75,542,104900,46915
781,675,106,592,105400,46917
983,781,202,595,100200,46919
432,415,17,-,137700,46920
0,0,0,-,-,46922
3094,2337,757,748,132300,46923
524,455,69,648,97000,46926
1826,1404,422,706,104500,46928
1283,866,417,632,102300,46929
42,29,13,675,68100,46930
80,55,25,725,69400,46931
1448,1096,352,558,134000,46932
2468,1756,712,822,98900,46933
2161,1846,315,776,149500,46936
1303,1104,199,783,81700,46938
783,657,126,624,93400,46939
1200,1063,137,739,87800,46940
484,451,33,685,180900,46941
73,38,35,-,142900,46943
41,18,23,-,-,46946
10829,7676,3153,664,84500,46947
260,237,23,804,111300,46950
767,671,96,713,126000,46951
8491,5811,2680,677,103600,46952
8641,5333,3308,722,79400,46953
210,164,46,717,66500,46957
277,277,0,-,69100,46958
349,174,175,753,-,46959
599,429,170,609,92600,46960
63,32,31,-,-,46961
3398,2452,946,747,118800,46962
56,34,22,433,-,46967
45,45,0,-,75400,46968
8922,6040,2882,759,82300,46970
703,494,209,740,105500,46974
5655,4286,1369,680,115400,46975
887,697,190,718,106300,46978
1839,1706,133,824,158800,46979
1075,831,244,752,114400,46982
50,34,16,-,117000,46984
629,467,162,709,88300,46985
691,552,139,642,101300,46986
349,291,58,693,111700,46987
336,220,116,-,87500,46988
1418,1084,334,618,152200,46989
229,224,5,-,122000,46990
836,693,143,784,86000,46991
6899,5259,1640,685,107800,46992
962,867,95,806,106400,46994
2533,1879,654,627,124000,46996
96,96,0,-,49000,46998
4239,3365,874,736,149500,47001
481,313,168,682,104200,47003
4590,3571,1019,542,193200,47006
27,27,0,-,-,47010
348,332,16,-,181700,47011
4136,3119,1017,616,169800,47012
324,277,47,788,173200,47016
235,215,20,-,144200,47017
1697,1250,447,807,157800,47018
558,391,167,929,94000,47020
1128,1066,62,-,245200,47022
698,524,174,1002,108200,47023
1321,987,334,784,79900,47024
8764,6830,1934,731,177700,47025
743,664,79,-,139400,47030
1974,1458,516,784,154800,47031
1073,1003,70,694,153900,47032
59,44,15,-,106700,47034
100,100,0,-,180200,47035
320,285,35,745,219600,47036
1756,1319,437,681,136300,47037
706,559,147,595,125700,47038
2270,1780,490,591,131100,47040
2485,2118,367,745,175900,47041
1762,1447,315,576,149900,47042
2340,1699,641,623,114500,47043
2339,2047,292,731,206300,47060
2689,1801,888,705,85600,47102
0,0,0,-,-,47104
1704,1406,298,797,178800,47106
1018,837,181,-,110300,47108
104,104,0,-,76800,47110
6204,5127,1077,790,187100,47111
5965,4682,1283,767,169100,47112
176,141,35,1031,181400,47114
1196,1024,172,446,129600,47115
249,238,11,-,63800,47116
1707,1499,208,873,140000,47117
1238,1085,153,677,106100,47118
4204,3928,276,1014,261100,47119
352,336,16,-,158200,47120
3737,3427,310,806,200100,47122
46,38,8,-,-,47123
1768,1674,94,893,234800,47124
662,552,110,927,95200,47125
1555,1385,170,935,182800,47126
8541,4761,3780,850,120100,47129
18581,12776,5805,871,142600,47130
317,315,2,-,245700,47135
1452,1351,101,788,198400,47136
570,495,75,731,79900,47137
1768,1526,242,-,121300,47138
1080,787,293,625,88200,47140
583,537,46,-,124500,47141
395,388,7,-,106300,47142
1197,1066,131,1095,200400,47143
845,624,221,680,125800,47145
324,292,32,-,146400,47147
18828,12054,6774,808,145100,47150
30,23,7,-,91700,47160
1176,900,276,893,165700,47161
322,254,68,-,100800,47162
478,455,23,-,135800,47163
1789,1404,385,708,140500,47164
2431,2049,382,729,126100,47165
423,387,36,-,139800,47166
5693,4323,1370,603,116200,47167
5756,3744,2012,796,119000,47170
6102,5207,895,1053,182900,47172
385,385,0,-,87600,47175
544,446,98,786,123400,47177
17959,11791,6168,977,160200,47201
10394,8012,2382,835,181100,47203
2098,1649,449,641,130800,47220
410,328,82,1017,88200,47223
218,218,0,-,83000,47224
62,45,17,855,77000,47226
830,704,126,707,117900,47227
1066,813,253,781,97800,47229
619,557,62,771,117500,47230
253,217,36,1045,115800,47231
1101,889,212,906,113000,47232
621,512,109,-,158300,47234
604,544,60,-,172500,47235
8540,5970,2570,781,145300,47240
1890,1369,521,760,133500,47243
219,194,25,-,113200,47244
1421,1255,166,792,153300,47246
71,58,13,800,108300,47247
9421,6172,3249,703,140400,47250
812,702,110,763,80000,47260
97,66,31,763,96400,47263
508,417,91,-,103300,47264
8040,6091,1949,850,105600,47265
179,147,32,-,101900,47270
774,627,147,863,95400,47272
857,780,77,850,161000,47273
12086,8014,4072,793,142000,47274
264,251,13,-,98400,47280
473,422,51,-,140600,47281
93,73,20,588,68800,47282
1273,905,368,734,141300,47283
10872,6865,4007,709,56700,47302
10567,5212,5355,686,81400,47303
13878,9323,4555,801,127400,47304
1735,663,1072,586,65400,47305
5,0,5,-,-,47306
1721,1458,263,576,97600,47320
64,35,29,930,77500,47324
239,211,28,1017,128100,47325
633,530,103,665,113900,47326
1862,1425,437,682,91400,47327
2028,1608,420,853,126000,47330
9457,6467,2990,701,84100,47331
1378,1168,210,738,146100,47334
390,298,92,613,71700,47335
1339,1124,215,674,67400,47336
66,42,24,1067,65000,47337
1146,921,225,657,78500,47338
208,194,14,700,79400,47339
1232,938,294,738,128200,47340
1012,780,232,669,130500,47341
971,779,192,765,77300,47342
66,63,3,-,85900,47344
565,455,110,639,110600,47345
1477,1253,224,658,103400,47346
3811,2751,1060,626,75100,47348
189,148,41,963,85900,47351
310,269,41,810,98300,47352
2137,1687,450,843,131300,47353
536,492,44,624,109200,47354
1340,1023,317,761,87600,47355
2382,1815,567,701,127400,47356
308,266,42,698,96300,47357
395,347,48,717,111900,47358
1408,984,424,653,78200,47359
516,421,95,696,121400,47360
86,65,21,778,94500,47361
10658,7698,2960,684,95000,47362
58,58,0,-,76500,47367
934,797,137,673,87600,47368
791,569,222,763,144500,47369
4759,3475,1284,697,101000,47371
981,765,216,641,70800,47373
19157,11694,7463,702,100000,47374
589,462,127,543,70200,47380
57,35,22,675,65000,47381
91,48,43,625,51000,47382
1080,906,174,817,125000,47383
774,672,102,733,102300,47384
740,565,175,589,105500,47385
532,481,51,680,151800,47386
284,224,60,790,127400,47387
193,162,31,688,109800,47388
2303,1761,542,516,75400,47390
569,491,78,741,140900,47393
3255,2540,715,766,84500,47394
2883,2394,489,757,144600,47396
18127,10312,7815,1021,255900,47401
14267,8063,6204,929,159700,47403
10476,5302,5174,923,169700,47404
0,0,0,-,-,47405
0,0,0,-,-,47406
8705,3182,5523,919,229200,47408
127,64,63,-,58400,47420
11701,9134,2567,723,129200,47421
3528,2922,606,629,109300,47424
325,210,115,617,143000,47427
3468,3076,392,670,161900,47429
565,514,51,-,103500,47431
1868,1446,422,769,98200,47432
1552,1084,468,694,133100,47433
0,0,0,-,-,47434
519,432,87,-,123100,47436
122,122,0,-,120000,47437
1685,1332,353,658,92700,47438
3993,2885,1108,569,83000,47441
497,380,117,705,79900,47443
4050,3268,782,614,110600,47446
3243,2602,641,849,196300,47448
120,100,20,721,81500,47449
519,317,202,625,99600,47451
2018,1427,591,604,121300,47452
254,203,51,1057,75000,47453
3019,2312,707,639,93800,47454
22,22,0,-,-,47455
565,468,97,1263,144400,47456
44,34,10,-,77100,47457
17,17,0,-,-,47458
1462,1322,140,631,149200,47459
4770,3727,1043,677,130100,47460
1764,1576,188,691,163100,47462
146,94,52,325,89300,47464
175,132,43,652,95800,47465
52,52,0,-,-,47467
708,647,61,-,219200,47468
668,479,189,631,118800,47469
675,584,91,668,143500,47470
1221,974,247,589,87900,47471
7034,4468,2566,708,114900,47501
1678,1075,603,695,67400,47512
725,678,47,565,96700,47513
46,46,0,-,121900,47514
343,319,24,-,118400,47515
481,408,73,430,157800,47516
167,159,8,983,190100,47519
1273,896,377,550,93800,47520
245,245,0,-,176400,47521
169,76,93,670,85700,47522
1319,1001,318,653,110300,47523
264,201,63,710,70800,47524
164,155,9,-,200600,47525
835,753,82,677,207300,47527
214,124,90,-,45200,47528
389,279,110,615,93000,47529
374,302,72,-,163600,47531
1654,1348,306,813,162000,47532
269,167,102,-,61800,47535
0,0,0,-,-,47536
389,272,117,634,200800,47537
433,361,72,521,119700,47541
3941,3004,937,632,126500,47542
8705,6584,2121,635,171100,47546
254,245,9,-,147000,47550
268,248,20,-,148200,47551
80,80,0,-,-,47552
2958,2358,600,536,158300,47553
692,494,198,874,129700,47557
1195,1062,133,681,180300,47558
693,507,186,588,75000,47561
1594,1215,379,551,169600,47562
543,497,46,-,150300,47564
2591,2129,462,602,115600,47567
223,147,76,627,106900,47568
41,41,0,-,-,47574
335,318,17,-,189300,47575
196,188,8,-,99400,47576
467,369,98,564,173900,47577
294,245,49,583,106300,47578
921,819,102,940,178400,47579
138,138,0,-,-,47580
1541,1301,240,548,112600,47581
67,65,2,-,75000,47584
311,262,49,-,113300,47585
4865,3438,1427,544,115300,47586
336,297,39,713,105100,47588
181,171,10,-,69000,47590
10324,6134,4190,693,110800,47591
19,13,6,-,-,47596
335,258,77,620,78600,47597
1346,1105,241,581,82800,47598
5536,4576,960,712,143400,47601
2082,1611,471,827,125000,47610
483,397,86,533,108100,47611
272,215,57,585,84600,47612
1083,1027,56,638,157200,47613
862,671,191,805,100100,47615
105,69,36,380,34200,47616
791,727,64,682,125200,47619
5365,3988,1377,678,144800,47620
14380,11506,2874,957,195600,47630
871,701,170,757,157300,47631
1058,887,171,632,104600,47633
1000,915,85,919,111000,47634
2359,1695,664,597,118100,47635
547,459,88,673,183900,47637
1472,1336,136,430,185500,47638
1584,1332,252,745,206800,47639
377,355,22,588,81500,47640
1795,1405,390,668,160700,47648
699,583,116,853,111900,47649
34,17,17,-,67000,47654
1999,1516,483,736,96900,47660
1481,1269,212,596,137400,47665
608,478,130,679,82800,47666
5056,3369,1687,677,108100,47670
71,63,8,900,88300,47683
234,100,134,1054,247100,47708
8021,4506,3515,694,101800,47710
13420,10094,3326,848,130500,47711
10055,6528,3527,847,142500,47712
4646,1994,2652,747,68300,47713
14073,8157,5916,794,94300,47714
12910,6530,6380,857,149800,47715
6987,5946,1041,895,166600,47720
6939,6558,381,1280,209900,47725
13175,7828,5347,741,131300,47802
9141,6464,2677,846,116900,47803
4601,2743,1858,743,71700,47804
5541,4581,960,721,118900,47805
5286,1537,3749,752,54500,47807
0,0,0,-,-,47809
507,431,76,923,92800,47832
309,273,36,-,118600,47833
7555,5734,1821,759,113800,47834
0,0,0,-,-,47836
352,266,86,732,90800,47837
676,566,110,661,86500,47838
751,652,99,619,115800,47840
1084,843,241,621,81100,47841
4192,2957,1235,686,86900,47842
192,183,9,-,108700,47846
459,412,47,494,57700,47847
609,505,104,592,81100,47848
183,153,30,-,126200,47849
926,787,139,696,84100,47850
54,28,26,875,74000,47853
232,207,25,-,126300,47854
277,205,72,732,77100,47855
122,100,22,545,84400,47857
427,227,200,-,105100,47858
401,297,104,955,101700,47859
219,148,71,488,33300,47860
223,204,19,-,115000,47861
605,505,100,910,75500,47862
111,111,0,-,-,47863
30,30,0,-,102900,47865
173,159,14,-,104500,47866
1331,1027,304,862,115800,47868
82,33,49,-,-,47869
171,118,53,848,80800,47871
2572,1933,639,642,111700,47872
1349,1149,200,744,87800,47874
0,0,0,-,-,47876
1504,1035,469,596,86500,47879
38,38,0,-,90500,47880
157,145,12,-,72500,47881
3363,2419,944,658,93800,47882
112,109,3,-,49800,47884
3442,2830,612,636,97000,47885
2302,246,2056,878,170300,47901
6992,3216,3776,820,87500,47904
17158,10675,6483,886,162900,47905
25531,11840,13691,902,214600,47906
0,0,0,-,-,47907
16714,11057,5657,897,141600,47909
17,10,7,-,37500,47916
159,140,19,819,107500,47917
2417,1759,658,731,112100,47918
925,820,105,678,170600,47920
449,350,99,810,128100,47921
579,387,192,775,80500,47922
1375,1104,271,641,143000,47923
156,156,0,-,86700,47924
60,60,0,-,106500,47925
522,479,43,725,114500,47926
767,638,129,825,76400,47928
287,231,56,810,107400,47929
511,365,146,581,175700,47930
2220,1663,557,714,134200,47932
11554,8203,3351,670,142600,47933
579,507,72,825,133000,47940
510,410,100,772,133100,47941
285,220,65,642,92600,47942
366,249,117,-,-,47943
1470,1027,443,704,97900,47944
781,557,224,518,117900,47946
576,449,127,604,83500,47948
420,371,49,893,96600,47949
298,240,58,779,94500,47950
1123,848,275,682,84400,47951
1268,908,360,680,98100,47952
936,768,168,789,122900,47954
399,312,87,810,81000,47955
781,627,154,792,120100,47957
64,50,14,579,75000,47958
942,722,220,702,92700,47959
6359,4927,1432,713,131100,47960
908,715,193,708,112300,47963
41,36,5,-,72000,47964
258,196,62,838,93500,47965
141,136,5,-,53800,47966
310,263,47,1089,83600,47967
432,386,46,800,147700,47968
46,36,10,950,76700,47969
818,627,191,779,128300,47970
724,610,114,582,91800,47971
485,320,165,669,110600,47974
275,210,65,766,133900,47975
997,745,252,731,125100,47977
4206,2937,1269,746,137600,47978
418,355,63,706,123800,47980
309,277,32,777,218500,47981
62,49,13,795,79400,47982
43,43,0,-,80500,47983
1745,1423,322,660,101200,47987
447,397,50,517,86100,47989
646,553,93,786,109200,47990
459,313,146,748,87100,47991
474,457,17,-,177600,47992
1421,1126,295,732,96800,47993
163,124,39,425,63600,47994
661,526,135,728,120700,47995
62,51,11,-,106500,47997
5236,4296,940,907,170200,48001
1265,1203,62,995,228100,48002
2196,2016,180,783,212900,48003
1910,1754,156,873,247600,48005
1454,1371,83,826,171300,48006
9099,6618,2481,1668,538500,48009
1668,1328,340,700,161900,48014
3457,1605,1852,649,100800,48015
5971,4416,1555,931,190700,48017
12833,8679,4154,1086,83800,48021
1124,1097,27,755,178800,48022
1998,1809,189,933,187700,48023
5679,5269,410,1408,416100,48025
6260,4540,1720,736,151700,48026
1229,1139,90,-,184900,48027
556,544,12,-,304600,48028
7147,3955,3192,957,86100,48030
756,715,41,929,194900,48032
7624,3561,4063,1152,150500,48033
7268,1303,5965,1110,208500,48034
14844,8810,6034,946,142000,48035
8887,6437,2450,852,149100,48036
20346,12774,7572,1027,186200,48038
3406,2849,557,841,149400,48039
4378,3622,756,844,133700,48040
1666,1457,209,721,199600,48041
11240,11021,219,1199,291900,48042
6805,3792,3013,761,118800,48043
19500,17389,2111,1151,277100,48044
11846,8233,3613,884,190200,48045
16505,13203,3302,916,223400,48047
2840,2298,542,1019,155500,48048
2219,2059,160,879,179000,48049
540,497,43,1366,245700,48050
6183,5359,824,951,200700,48051
3016,2586,430,909,218500,48054
6054,4818,1236,915,162500,48059
16462,9451,7011,821,109700,48060
3386,2794,592,721,201000,48062
1564,1372,192,1000,234500,48063
1490,1423,67,688,226700,48064
4792,4051,741,825,249200,48065
20622,12934,7688,1027,97600,48066
12617,8459,4158,1229,240800,48067
1105,1056,49,1563,357100,48069
2339,2248,91,2232,372200,48070
13824,8444,5380,992,137700,48071
6960,5843,1117,1128,222100,48072
16365,10446,5919,1061,232900,48073
3618,3308,310,846,135900,48074
9126,5136,3990,1085,161800,48075
9403,6886,2517,1191,181500,48076
4803,4071,732,931,200500,48079
10850,8223,2627,910,137900,48080
8967,7746,1221,976,147700,48081
7209,6292,917,1057,149200,48082
9364,5805,3559,1114,232800,48083
6494,3206,3288,1294,356000,48084
8747,8082,665,1460,304300,48085
8994,7465,1529,937,155900,48088
12250,6791,5459,966,75900,48089
11126,7057,4069,979,96300,48091
10058,7948,2110,984,157200,48092
10000,7612,2388,907,142500,48093
7875,6485,1390,1145,310700,48094
2076,1911,165,824,358800,48095
1761,1436,325,947,281000,48096
2253,1755,498,751,130100,48097
7050,6489,561,1366,411900,48098
11368,9613,1755,1016,133600,48101
23383,15804,7579,1413,372200,48103
16711,6293,10418,1361,412700,48104
14698,7205,7493,1341,380000,48105
11668,6232,5436,1087,283800,48108
5,0,5,-,-,48109
17187,11598,5589,964,183100,48111
7982,7350,632,1135,295600,48114
11152,9395,1757,1065,272200,48116
4291,3811,480,917,196500,48117
5403,4335,1068,1492,278900,48118
2386,873,1513,1247,164600,48120
3923,2306,1617,897,73700,48122
11888,9433,2455,1069,144200,48124
7600,5306,2294,1106,84600,48125
13492,7342,6150,982,152000,48126
12614,9001,3613,993,153800,48127
4031,3572,459,1392,178000,48128
5949,5182,767,1283,351600,48130
3054,2190,864,984,194500,48131
2093,1874,219,1043,126400,48133
8431,7014,1417,906,197700,48134
11007,8751,2256,967,119900,48135
1940,1813,127,1357,234900,48137
4103,3799,304,1179,298700,48138
69,56,13,-,162500,48139
1307,1205,102,729,210400,48140
8953,3683,5270,915,51500,48141
12,12,0,-,-,48143
3785,3485,300,928,193300,48144
1353,1176,177,958,186600,48145
14734,10425,4309,850,81000,48146
10367,9057,1310,1117,171600,48150
12612,10347,2265,1086,216700,48152
14671,13317,1354,1072,225800,48154
584,425,159,339,131400,48157
3209,2799,410,649,242900,48158
921,761,160,905,178100,48159
4998,4028,970,854,193000,48160
11372,8248,3124,805,140400,48161
11506,8260,3246,809,150700,48162
3133,3012,121,1297,243600,48164
2917,2213,704,1383,282300,48165
4411,3750,661,1036,137000,48166
9391,6934,2457,1312,354600,48167
8486,7611,875,-,442500,48168
8413,7612,801,1093,259900,48169
17282,13270,4012,917,328300,48170
4881,4088,793,906,181700,48173
11808,8645,3163,899,109400,48174
8460,7229,1231,985,323700,48176
61,61,0,-,150400,48177
12933,11720,1213,1095,310100,48178
1468,1150,318,1103,183900,48179
25005,16108,8897,877,109400,48180
8787,7547,1240,897,178800,48182
17837,13592,4245,846,166900,48183
6796,4111,2685,803,99200,48184
21601,12346,9255,908,139200,48185
13352,8921,4431,959,122300,48186
18962,13428,5534,1145,264000,48187
15723,13036,2687,1354,276000,48188
6127,4784,1343,990,222700,48189
61,61,0,-,-,48190
1565,1410,155,1603,211000,48191
10799,7595,3204,776,118900,48192
6464,4079,2385,927,156800,48193
12454,8309,4145,905,125800,48195
25615,13510,12105,1022,210900,48197
15791,9101,6690,962,118100,48198
8719,857,7862,638,340800,48201
7855,2184,5671,721,133200,48202
10049,4251,5798,671,49100,48203
9642,4905,4737,792,35500,48204
13663,4254,9409,989,32300,48205
6648,3323,3325,741,58200,48206
11739,2771,8968,914,116400,48207
4525,1627,2898,623,117300,48208
10078,5157,4921,726,52600,48209
8966,5125,3841,800,40600,48210
1946,672,1274,778,42500,48211
10977,6544,4433,785,63000,48212
8061,4609,3452,702,34500,48213
10575,4272,6303,685,71900,48214
4880,2137,2743,748,87500,48215
2548,905,1643,687,145500,48216
2855,1776,1079,846,48600,48217
3231,1654,1577,619,33600,48218
18766,9788,8978,889,55700,48219
11313,7016,4297,972,175100,48220
16279,10470,5809,928,87400,48221
10088,5432,4656,891,72000,48223
14333,7637,6696,962,49100,48224
5281,3177,2104,1091,100200,48225
4382,536,3846,1440,258900,48226
15888,8594,7294,887,52600,48227
21041,10182,10859,887,33600,48228
3762,2431,1331,829,43500,48229
6520,4964,1556,1196,358700,48230
0,0,0,-,-,48233
13325,7118,6207,830,43600,48234
19559,11671,7888,942,56700,48235
11576,10527,1049,1246,296700,48236
11884,6695,5189,1123,130500,48237
10368,4889,5479,806,41000,48238
13620,10152,3468,1161,96000,48239
6708,4941,1767,1165,88800,48240
0,0,0,-,-,48242
0,0,0,-,-,48243
5617,4966,651,1680,544500,48301
6014,5202,812,1173,492700,48302
6309,5793,516,1545,381000,48304
9522,9011,511,1140,423200,48306
18039,12108,5931,1248,271300,48307
11184,9062,2122,1321,318400,48309
14686,10958,3728,1161,204500,48310
13624,10105,3519,922,190700,48312
13587,10047,3540,1012,189800,48313
8619,6455,2164,1148,242500,48314
10899,9494,1405,883,287900,48315
11397,9259,2138,1124,289900,48316
12107,7144,4963,1021,194400,48317
2359,1689,670,1017,228300,48320
12564,9276,3288,1739,298600,48322
6051,5408,643,1415,362300,48323
6516,5933,583,1171,330400,48324
10146,4716,5430,1148,177300,48326
9365,6543,2822,866,179300,48327
11694,7478,4216,852,160200,48328
9818,8532,1286,1223,185400,48329
8953,6639,2314,1687,322300,48331
7848,4883,2965,1231,247500,48334
10865,4634,6231,1173,298400,48335
10890,7407,3483,920,190600,48336
9989,4238,5751,858,64300,48340
7217,3419,3798,757,87700,48341
6359,2602,3757,732,72000,48342
9225,6466,2759,1148,226700,48346
8680,8075,605,1134,338900,48348
2805,2385,420,1079,273000,48350
2750,2473,277,1351,237700,48353
3250,3012,238,723,248800,48356
3000,2577,423,921,246600,48357
4167,2864,1303,1098,258900,48359
4570,3771,799,1138,286900,48360
5996,5069,927,915,258100,48362
2069,2030,39,1313,409400,48363
1642,1532,110,933,330900,48367
599,540,59,-,332200,48370
9256,8051,1205,885,265300,48371
5240,4609,631,1750,461900,48374
9015,6294,2721,1473,286200,48375
8095,3879,4216,1173,266000,48377
2771,2694,77,1661,327100,48380
5487,4454,1033,1070,311700,48381
8299,7769,530,1498,313200,48382
4622,4261,361,1201,254300,48383
7398,6070,1328,1190,244300,48386
10536,7664,2872,1230,223700,48390
7345,4066,3279,759,229500,48393
0,0,0,-,-,48397
614,470,144,728,128100,48401
28,28,0,-,-,48411
1988,1871,117,776,187300,48412
3062,2177,885,643,119900,48413
1131,1033,98,782,142900,48414
3624,3146,478,866,139900,48415
1836,1490,346,721,139100,48416
1152,1060,92,874,139700,48417
1515,1407,108,696,187000,48418
986,825,161,868,114700,48419
8663,6965,1698,678,124900,48420
2437,2259,178,967,155700,48421
2667,2119,548,751,124100,48422
14068,9195,4873,739,151100,48423
444,353,91,659,107800,48426
1144,898,246,675,99100,48427
2064,1851,213,1028,247200,48428
3755,3103,652,700,115000,48429
14553,11765,2788,1102,230100,48430
280,254,26,792,123200,48432
10131,8681,1450,803,148600,48433
65,40,25,-,70000,48434
727,670,57,850,125700,48435
1465,1400,65,850,185400,48436
264,126,138,595,106800,48437
2523,2444,79,1206,229000,48438
20339,15365,4974,825,188700,48439
58,26,32,-,-,48440
1681,1362,319,580,117400,48441
9079,6800,2279,964,210000,48442
3753,2822,931,739,173400,48444
472,383,89,609,85400,48445
12092,9661,2431,792,164700,48446
1046,933,113,803,98100,48449
2393,1878,515,689,154200,48450
5270,4916,354,1008,211000,48451
2161,1560,601,696,111800,48453
482,449,33,779,131900,48454
3182,2894,288,848,299400,48455
317,287,30,617,125600,48456
3324,2715,609,735,122700,48457
7930,5346,2584,778,65100,48458
1008,854,154,773,154900,48460
3128,2688,440,808,163300,48461
5068,4794,274,851,251200,48462
1819,1654,165,777,128500,48463
888,829,59,-,131000,48464
258,213,45,760,148600,48465
647,543,104,663,85300,48466
1235,1071,164,593,127800,48467
568,505,63,610,91400,48468
623,504,119,722,135200,48469
302,253,49,610,115700,48470
2510,1760,750,626,112600,48471
692,583,109,795,106300,48472
9204,7728,1476,923,147700,48473
1089,957,132,669,117900,48475
145,141,4,-,96500,48476
128,0,128,846,-,48502
11481,6036,5445,730,51000,48503
11190,6994,4196,771,35100,48504
8276,4238,4038,661,24600,48505
11454,7817,3637,763,54900,48506
13675,7871,5804,761,58000,48507
4006,3461,545,915,102300,48509
3150,2024,1126,818,100300,48519
3813,2370,1443,740,53200,48529
8563,5095,3468,783,90600,48532
0,0,0,-,-,48551
0,0,0,-,-,48553
0,0,0,-,-,48554
14133,8976,5157,772,42400,48601
12262,7095,5167,722,55600,48602
11911,7794,4117,891,142300,48603
4251,3019,1232,858,81200,48604
700,269,431,848,68900,48607
5318,4575,743,804,141800,48609
1355,1239,116,704,94300,48610
2637,1922,715,717,140200,48611
3887,3241,646,597,111100,48612
393,355,38,821,115700,48613
502,430,72,721,103700,48614
1109,875,234,673,89000,48615
2918,2360,558,674,113900,48616
3335,2610,725,690,129600,48617
2147,1818,329,640,99700,48618
262,237,25,833,122500,48619
490,391,99,678,121600,48621
2365,1988,377,801,99400,48622
4799,4197,602,838,166600,48623
6819,5950,869,590,111900,48624
5380,4526,854,537,77100,48625
2262,2100,162,751,163100,48626
37,35,2,-,104900,48627
898,835,63,894,133400,48628
3693,2878,815,649,114000,48629
21,21,0,-,-,48630
1798,1504,294,626,141700,48631
2151,1940,211,736,98600,48632
48,48,0,-,132600,48633
1876,1763,113,570,132000,48634
739,684,55,769,107200,48635
468,441,27,-,83100,48636
1287,1130,157,765,111900,48637
5607,3849,1758,771,126500,48638
13007,9516,3491,782,155300,48640
13898,10337,3561,879,152000,48642
1775,1425,350,669,97100,48647
462,388,74,1000,114400,48649
2970,2714,256,695,107400,48650
2244,1613,631,696,134900,48651
695,650,45,829,115400,48652
4785,4235,550,699,113100,48653
1028,883,145,549,93400,48654
2321,2009,312,709,114500,48655
1860,1509,351,596,71200,48656
3326,2888,438,777,134500,48657
2059,1554,505,476,81700,48658
1039,903,136,727,98200,48659
4573,3540,1033,692,120000,48661
632,597,35,883,93500,48662
0,0,0,-,-,48667
517,427,90,833,78200,48701
1472,1258,214,516,122600,48703
222,209,13,588,110800,48705
16830,13147,3683,716,108500,48706
11166,7584,3582,619,76000,48708
0,0,0,-,-,48710
439,369,70,594,94000,48720
224,220,4,-,130800,48721
1248,1125,123,742,102800,48722
4967,3846,1121,723,91600,48723
360,101,259,-,-,48724
1089,937,152,520,126300,48725
2212,1786,426,634,105800,48726
392,343,49,867,122400,48727
158,140,18,436,122900,48728
589,512,77,775,104700,48729
2387,1689,698,591,105500,48730
670,501,169,685,88300,48731
5069,3497,1572,667,123200,48732
676,549,127,747,77800,48733
3442,2472,970,706,214700,48734
447,369,78,920,91200,48735
593,498,95,800,86400,48737
569,516,53,532,103900,48738
1976,1825,151,643,127100,48739
1202,1049,153,757,114000,48740
788,680,108,711,101900,48741
777,664,113,571,132300,48742
30,24,6,-,72000,48743
1850,1623,227,833,130000,48744
599,512,87,600,99000,48745
3325,2898,427,754,131600,48746
522,490,32,640,120400,48747
728,658,70,548,94300,48748
471,443,28,906,91800,48749
4243,3246,997,662,91400,48750
381,333,48,595,80100,48754
1283,1049,234,737,135400,48755
1964,1570,394,663,64600,48756
1609,1437,172,679,125300,48757
1458,1165,293,807,79000,48759
624,571,53,832,112500,48760
451,392,59,612,77800,48761
497,479,18,1275,135500,48762
1984,1738,246,738,119200,48763
321,297,24,-,83300,48765
552,503,49,761,79700,48766
970,843,127,825,106400,48767
3742,3172,570,638,109900,48768
697,602,95,450,87500,48770
5331,3518,1813,667,90000,48801
675,560,115,735,107500,48806
374,314,60,722,80400,48807
3108,2429,679,974,222700,48808
4108,3013,1095,787,137100,48809
1229,854,375,641,110800,48811
7838,6120,1718,733,144000,48813
859,766,93,-,182600,48815
189,20,169,-,160000,48816
2453,1731,722,831,121900,48817
1037,829,208,623,147300,48818
909,849,60,939,165000,48819
6537,5573,964,882,223500,48820
2581,2339,242,1037,187400,48821
934,909,25,877,191200,48822
19555,8913,10642,971,199600,48823
0,0,0,-,-,48825
6217,5167,1050,856,159600,48827
1256,908,348,591,93900,48829
1407,1136,271,736,117600,48831
533,477,56,729,99800,48832
736,578,158,858,114100,48834
1117,962,155,725,161300,48835
4910,4141,769,971,188600,48836
8490,6868,1622,937,192700,48837
7245,5361,1884,754,137300,48838
5989,3646,2343,845,199200,48840
305,280,25,881,125000,48841
9227,6264,2963,958,163200,48842
17412,13311,4101,1023,250200,48843
293,256,37,693,98000,48845
6689,4531,2158,784,133200,48846
2282,1810,472,717,106500,48847
2867,2521,346,797,190000,48848
2257,1751,506,744,143300,48849
1622,1311,311,604,118200,48850
870,778,92,761,102200,48851
63,48,15,700,71900,48852
241,160,81,342,86400,48853
7251,5872,1379,952,178800,48854
5669,4722,947,1241,248100,48855
345,245,100,641,84700,48856
1191,1021,170,852,118600,48857
17476,9042,8434,742,143500,48858
633,501,132,436,120800,48860
695,655,40,-,137500,48861
9366,5785,3581,1077,275300,48864
736,584,152,777,92000,48865
1747,1449,298,703,125400,48866
11478,8011,3467,673,114300,48867
90,69,21,-,84100,48870
767,624,143,780,156900,48871
2526,2029,497,867,162700,48872
480,457,23,556,157200,48873
63,63,0,-,83600,48874
4117,3139,978,935,154100,48875
1639,1180,459,786,138400,48876
821,744,77,550,90700,48877
692,568,124,455,106800,48878
6696,5555,1141,781,163400,48879
2508,2007,501,733,96100,48880
2086,1775,311,502,165400,48881
2748,2398,350,660,117100,48883
1789,1630,159,772,121100,48884
390,380,10,-,125400,48885
759,646,113,728,100900,48886
2590,2042,548,699,122800,48888
598,505,93,750,99300,48889
762,601,161,814,138900,48890
1187,979,208,701,121500,48891
1795,1435,360,901,143000,48892
1988,1827,161,728,138600,48893
633,571,62,525,188100,48894
4572,3853,719,867,230200,48895
97,97,0,-,56500,48896
603,512,91,643,162000,48897
10813,7191,3622,862,101700,48906
15476,8760,6716,868,86800,48910
16362,8668,7694,831,95100,48911
7926,3425,4501,905,110000,48912
4069,2174,1895,931,79900,48915
15219,8772,6447,922,156200,48917
0,0,0,-,-,48921
1570,77,1493,709,115700,48933
9090,4727,4363,814,97300,49001
8359,5860,2499,775,163800,49002
6830,5281,1549,932,130300,49004
10443,3798,6645,855,144000,49006
4269,1189,3080,803,67000,49007
6558,4014,2544,784,158300,49008
18548,12270,6278,902,251300,49009
6465,5337,1128,804,143800,49010
866,774,92,829,98400,49011
1285,1159,126,983,192600,49012
1933,1492,441,718,106900,49013
8546,6088,2458,858,125900,49014
10996,7505,3491,825,130900,49015
8918,6311,2607,821,109300,49017
2293,2000,293,769,142200,49021
13360,7639,5721,665,91300,49022
12113,8043,4070,941,181600,49024
856,585,271,774,120300,49026
97,72,25,817,178700,49027
2360,1833,527,711,109300,49028
566,508,58,648,114500,49029
911,748,163,669,98600,49030
3308,2439,869,707,164300,49031
1128,932,196,614,126000,49032
670,599,71,837,178300,49033
998,858,140,827,166300,49034
9274,6781,2493,760,125900,49036
9048,4913,4135,680,67800,49037
3432,2535,897,817,138700,49038
1212,959,253,713,120400,49040
1936,1495,441,678,126000,49042
933,490,443,579,103800,49043
2413,1927,486,721,124500,49045
3145,2693,452,890,189300,49046
6370,4680,1690,624,122200,49047
9537,5823,3714,838,107600,49048
590,574,16,594,175600,49050
949,897,52,-,195500,49051
362,301,61,700,146100,49052
2754,2260,494,680,165500,49053
2439,1993,446,817,133800,49055
1220,999,221,1008,86900,49056
2357,1676,681,640,77900,49057
7706,6299,1407,910,145900,49058
989,876,113,722,-,49060
648,600,48,1010,144000,49061
1365,1133,232,772,134200,49064
2628,2202,426,806,165900,49065
206,170,36,989,118000,49066
1684,1501,183,876,147700,49067
6556,4915,1641,742,154100,49068
952,878,74,643,147100,49070
3904,3559,345,950,193900,49071
1113,944,169,849,138000,49072
2098,1679,419,775,111900,49073
62,0,62,381,-,49074
75,56,19,-,60000,49075
1435,1109,326,773,151000,49076
3689,2924,765,921,145300,49078
5068,3914,1154,769,153200,49079
6225,5412,813,742,163200,49080
2457,2093,364,762,117200,49082
3121,2764,357,755,223000,49083
0,0,0,-,-,49084
9983,7692,2291,852,212400,49085
2250,2072,178,799,219100,49087
1446,1307,139,1033,191200,49088
691,535,156,765,109200,49089
6163,4536,1627,771,184600,49090
7874,5521,2353,772,122100,49091
754,600,154,926,115700,49092
7567,5481,2086,729,135600,49093
1465,1045,420,674,104800,49094
911,817,94,877,221600,49095
1204,1033,171,765,145000,49096
4579,4000,579,710,178500,49097
2338,1841,497,751,112700,49098
2505,1904,601,743,130200,49099
1247,1039,208,850,159200,49101
752,593,159,894,212300,49102
3823,2185,1638,697,167100,49103
0,0,0,-,-,49104
1983,1582,401,842,178600,49106
4086,3099,987,764,145900,49107
1317,1165,152,836,124200,49111
4235,3511,724,829,166400,49112
797,620,177,815,142200,49113
183,183,0,-,365400,49115
88,88,0,-,385700,49116
1852,1444,408,642,324000,49117
28,21,7,-,142500,49119
14611,10904,3707,733,130000,49120
986,880,106,753,171200,49125
483,419,64,734,121500,49126
4377,3494,883,925,221100,49127
1423,1192,231,816,167400,49128
294,282,12,-,419000,49129
528,450,78,875,280600,49130
15397,11489,3908,818,160000,49201
9041,4802,4239,757,76900,49202
15694,10387,5307,860,107100,49203
1035,844,191,698,152700,49220
15238,10700,4538,800,122600,49221
4805,3296,1509,699,81900,49224
453,397,56,644,100400,49227
2110,1707,403,865,139300,49228
1170,999,171,676,179700,49229
4472,4018,454,764,187200,49230
969,791,178,760,161900,49232
1131,982,149,865,173500,49233
1100,1017,83,817,198100,49234
831,737,94,842,115300,49235
1835,1593,242,720,160400,49236
1085,910,175,750,135300,49237
690,591,99,777,154000,49238
3812,3579,233,903,228400,49240
1122,997,125,810,158000,49241
5689,3883,1806,679,128000,49242
1693,1330,363,725,109200,49245
1133,1043,90,956,162700,49246
2351,1874,477,853,105300,49247
337,308,29,1049,124100,49248
1404,1266,138,956,170700,49249
2404,1916,488,755,120700,49250
2360,2046,314,925,150100,49251
1066,765,301,683,99600,49252
1265,1184,81,598,196600,49253
1682,1469,213,783,136500,49254
718,603,115,919,106400,49255
1546,1184,362,750,89900,49256
1065,970,95,766,157600,49259
84,50,34,-,155500,49261
522,416,106,663,109900,49262
19,11,8,-,-,49263
626,597,29,645,152700,49264
2218,1942,276,788,186600,49265
1283,1108,175,663,120200,49266
1489,1320,169,1234,191000,49267
487,397,90,629,110200,49268
2145,1807,338,777,152500,49269
2025,1826,199,790,192300,49270
810,606,204,766,116300,49271
1011,966,45,-,168700,49272
1368,1048,320,695,145200,49274
343,303,40,1058,140800,49276
1406,1279,127,747,141100,49277
340,299,41,545,140600,49279
176,154,22,-,215700,49282
1053,810,243,625,176500,49283
1160,958,202,931,118200,49284
2540,2126,414,715,160900,49285
5770,4482,1288,827,166100,49286
897,811,86,-,200500,49287
557,384,173,690,88600,49288
50,33,17,-,38800,49289
6647,6399,248,1384,386400,49301
2948,2851,97,988,288100,49302
321,283,38,747,121500,49303
1796,1308,488,600,85500,49304
1025,858,167,663,89800,49305
4163,4041,122,631,253200,49306
7655,4683,2972,711,130600,49307
740,623,117,658,85900,49309
1006,896,110,595,128500,49310
128,110,18,736,85700,49312
8293,7400,893,1058,256800,49315
8470,7557,913,1096,252800,49316
507,462,45,931,164900,49318
7194,6208,986,867,172500,49319
14,14,0,-,-,49320
6385,4161,2224,838,184700,49321
498,399,99,961,99300,49322
3549,3413,136,856,203700,49323
731,649,82,832,177100,49325
1507,1390,117,736,138300,49326
3321,2747,574,681,149400,49327
1574,1389,185,689,149300,49328
3284,2827,457,803,122200,49329
1852,1450,402,792,168400,49330
6773,5775,998,891,231200,49331
1347,1205,142,733,108200,49332
4287,3619,668,997,219800,49333
120,120,0,-,170300,49335
1494,1195,299,781,103200,49336
5022,4238,784,763,127700,49337
694,595,99,859,108800,49338
814,743,71,838,171200,49339
985,820,165,413,106900,49340
13840,12657,1183,993,253600,49341
604,504,100,814,103200,49342
2139,1813,326,681,165300,49343
1605,1325,280,875,198700,49344
5093,4410,683,728,175000,49345
2048,1931,117,824,169600,49346
603,532,71,756,109100,49347
4775,3767,1008,920,181700,49348
3018,2527,491,713,96100,49349
7115,3583,3532,1010,221000,49401
563,507,56,861,109500,49402
980,886,94,950,206600,49403
2969,2531,438,816,195400,49404
590,533,57,697,121800,49405
394,324,70,1100,371700,49406
3908,3322,586,759,159200,49408
756,662,94,646,111700,49410
689,656,33,750,167700,49411
4481,3705,776,812,138300,49412
2755,2578,177,950,165000,49415
12855,10147,2708,858,221800,49417
11253,8616,2637,886,203200,49418
3024,2686,338,845,241800,49419
2442,1970,472,672,113400,49420
2202,1921,281,666,94100,49421
17117,12214,4903,902,184500,49423
17553,13533,4020,944,192500,49424
1383,1166,217,780,105000,49425
12545,11243,1302,989,241700,49426
10348,8569,1779,997,193900,49428
7589,5348,2241,757,159000,49431
0,0,0,-,-,49434
1319,1203,116,733,208200,49435
771,623,148,831,171600,49436
2639,2197,442,703,149600,49437
627,110,517,480,111500,49440
14531,10261,4270,833,131700,49441
15397,10326,5071,735,81800,49442
10157,7190,2967,797,99600,49444
8365,7480,885,880,152100,49445
875,754,121,665,143200,49446
1491,1278,213,637,188100,49448
1192,1007,185,773,229000,49449
1030,636,394,758,106500,49450
2222,1963,259,814,151200,49451
776,690,86,696,92200,49452
1326,1093,233,727,352400,49453
1816,1373,443,684,123900,49454
1789,1420,369,761,106600,49455
8742,7082,1660,893,206400,49456
3831,3426,405,773,138500,49457
64,60,4,-,-,49458
558,444,114,839,83900,49459
3039,2768,271,955,250500,49460
3874,3362,512,735,169900,49461
10437,9189,1248,914,219200,49464
15823,6183,9640,893,165600,49503
16371,9450,6921,929,157400,49504
13358,8596,4762,968,155000,49505
12658,9471,3187,1029,251000,49506
12668,7625,5043,933,121500,49507
14503,8775,5728,979,168100,49508
10330,7221,3109,834,126300,49509
8121,3510,4611,939,211300,49512
10665,6015,4650,955,145600,49519
11996,9864,2132,1060,217200,49525
9020,6028,2992,932,207300,49534
4226,2427,1799,883,186500,49544
12888,8645,4243,1071,289600,49546
11630,8406,3224,878,106800,49548
9002,6840,2162,690,119800,49601
148,139,9,-,85500,49611
629,523,106,707,179900,49612
281,263,18,713,193800,49613
1127,1051,76,916,136400,49614
1647,1432,215,683,215600,49615
876,778,98,687,154300,49616
1280,1209,71,645,210100,49617
342,296,46,950,123400,49618
364,325,39,863,104800,49619
926,786,140,929,138500,49620
1513,1366,147,1038,234600,49621
1119,963,156,918,149800,49622
475,454,21,825,93400,49623
493,445,48,850,121000,49625
138,138,0,-,83100,49626
76,68,8,-,533300,49627
69,66,3,-,122600,49628
1043,867,176,963,245000,49629
696,633,63,381,310700,49630
2557,2050,507,684,92200,49631
482,403,79,753,107000,49632
1534,1355,179,818,118200,49633
23,23,0,-,-,49634
1354,1174,180,785,251800,49635
212,212,0,-,775500,49636
1168,1031,137,944,142500,49637
347,311,36,575,103000,49638
1005,876,129,778,97000,49639
566,526,40,840,232400,49640
390,299,91,488,63900,49642
2790,2467,323,694,207900,49643
988,925,63,539,125800,49644
664,546,118,781,107500,49645
3496,2762,734,652,120300,49646
1147,1070,77,982,278800,49648
2228,1885,343,875,182100,49649
1267,1218,49,1273,191000,49650
3335,2664,671,765,126600,49651
756,690,66,692,318700,49653
283,219,64,1036,567200,49654
1308,1158,150,767,122900,49655
640,546,94,850,93200,49656
1358,1028,330,654,129100,49657
2847,2478,369,738,97700,49659
5630,4573,1057,702,137900,49660
2198,1815,383,754,110100,49663
759,693,66,938,306200,49664
1726,1478,248,641,102900,49665
61,61,0,-,-,49666
255,207,48,638,92500,49667
1268,1056,212,842,102000,49668
946,861,85,1093,331400,49670
11,11,0,-,-,49674
419,345,74,548,223100,49675
1537,1381,156,725,181400,49676
2807,2212,595,602,95700,49677
436,400,36,725,123400,49679
676,615,61,861,113600,49680
1871,1561,310,770,284000,49682
823,682,141,850,124300,49683
16748,12195,4553,999,242000,49684
14653,11234,3419,970,232600,49686
928,785,143,802,132000,49688
636,602,34,575,114300,49689
2750,2425,325,896,253700,49690
390,286,104,701,178000,49701
329,269,60,684,151700,49705
2087,1656,431,722,159500,49706
10038,7606,2432,570,103500,49707
1724,1585,139,475,106100,49709
187,145,42,513,144800,49710
3653,3052,601,836,186900,49712
874,741,133,822,159000,49713
1396,1203,193,570,123800,49715
326,305,21,975,230900,49716
65,65,0,-,-,49717
283,217,66,1014,143800,49718
650,523,127,569,175700,49719
4140,3191,949,763,191800,49720
6112,5048,1064,738,134700,49721
78,78,0,-,116100,49722
414,385,29,-,142700,49724
287,269,18,563,143300,49725
568,522,46,567,171700,49726
2909,2457,452,710,133600,49727
143,118,25,836,123200,49728
678,614,64,924,153000,49729
815,737,78,818,125900,49730
772,679,93,862,111000,49733
8090,6137,1953,757,149900,49735
213,189,24,592,118800,49736
4354,3361,993,751,114700,49738
3176,2808,368,941,243100,49740
352,339,13,575,111300,49743
300,265,35,767,137500,49744
444,326,118,648,122200,49745
1570,1285,285,596,110300,49746
931,814,117,706,135500,49747
93,85,8,613,129700,49748
2064,1714,350,758,161600,49749
872,770,102,805,149400,49751
280,255,25,-,106000,49752
876,829,47,673,117300,49753
849,728,121,794,142200,49755
1833,1577,256,811,116300,49756
492,155,337,777,370500,49757
727,678,49,800,138300,49759
314,293,21,1067,114800,49760
309,270,39,1319,113300,49762
194,47,147,610,-,49764
1760,1501,259,559,88400,49765
883,749,134,574,94800,49766
198,166,32,422,161400,49768
642,500,142,835,106000,49769
7188,4813,2375,851,223900,49770
785,719,66,868,133200,49774
36,34,2,-,206300,49775
714,591,123,517,93300,49776
885,860,25,-,192400,49777
2013,1722,291,538,98000,49779
646,581,65,850,106200,49780
1823,1236,587,581,120900,49781
285,264,21,817,257400,49782
8115,4966,3149,719,118200,49783
1085,490,595,696,81000,49788
142,123,19,416,172500,49791
79,66,13,-,180800,49793
814,662,152,774,120700,49795
162,124,38,1028,200000,49796
849,767,82,739,122200,49799
5121,4016,1105,638,131200,49801
2696,1972,724,642,86800,49802
201,168,33,-,110700,49805
275,263,12,-,201400,49806
1528,1336,192,632,126100,49807
457,444,13,-,139400,49808
360,318,42,963,119300,49812
510,471,39,730,98800,49814
119,89,30,472,86500,49815
306,290,16,546,154400,49816
246,211,35,664,171000,49817
491,469,22,811,128600,49818
11,11,0,-,-,49819
132,90,42,521,141100,49820
568,516,52,583,106900,49821
81,56,25,-,98800,49822
113,90,23,-,145800,49825
31,31,0,-,104800,49826
434,330,104,685,99500,49827
7982,5470,2512,530,104200,49829
293,288,5,-,124000,49831
168,138,30,-,325800,49833
97,91,6,325,109000,49834
367,349,18,1000,117800,49835
420,392,28,563,150000,49836
3636,3038,598,626,122100,49837
234,222,12,1300,125000,49838
174,139,35,666,149300,49839
271,249,22,950,154600,49840
2717,1857,860,640,121100,49841
508,412,96,555,99000,49847
52,52,0,-,79500,49848
5118,4146,972,537,113700,49849
63,58,5,-,66000,49852
628,600,28,-,140700,49853
2919,2401,518,540,108000,49854
13230,7988,5242,833,183500,49855
5553,4011,1542,580,100000,49858
228,217,11,508,189800,49861
1506,1115,391,617,128700,49862
76,76,0,-,63300,49863
31,17,14,-,48500,49864
3286,2849,437,639,154800,49866
1660,1235,425,749,86000,49868
1618,1284,334,709,110800,49870
200,162,38,609,65700,49871
100,83,17,754,135700,49872
38,38,0,-,162500,49873
396,306,90,538,140400,49874
532,504,28,-,104400,49876
5,4,1,-,-,49877
1620,1419,201,447,131200,49878
461,406,55,644,94600,49879
502,437,65,550,124300,49880
171,136,35,835,205600,49881
60,57,3,-,130400,49883
209,154,55,584,134000,49884
728,689,39,625,158800,49885
225,197,28,895,90800,49886
1177,992,185,631,137300,49887
301,252,49,1088,115900,49891
815,729,86,703,157400,49892
612,567,45,572,151300,49893
287,274,13,-,101600,49894
247,213,34,614,153100,49895
566,419,147,463,140700,49896
139,139,0,-,72300,49901
100,88,12,550,28500,49902
43,33,10,325,65000,49903
700,643,57,890,146900,49905
989,712,277,541,116500,49908
174,169,5,-,145500,49910
1182,980,202,439,90200,49911
467,408,59,543,112400,49912
2776,2065,711,528,64800,49913
153,120,33,725,43100,49915
1203,1001,202,633,159400,49916
80,72,8,725,55000,49917
69,59,10,-,236300,49918
89,82,7,-,85700,49919
1916,1719,197,609,94300,49920
147,56,91,1301,177800,49921
288,236,52,711,114200,49922
223,189,34,-,69600,49925
176,166,10,-,58900,49927
83,83,0,-,49300,49929
2656,1642,1014,651,124400,49930
3359,1354,2005,659,184600,49931
343,313,30,789,74600,49934
2706,2074,632,498,76700,49935
3767,2736,1031,465,68100,49938
147,115,32,-,85000,49942
1146,888,258,472,117100,49945
1645,1264,381,565,90800,49946
255,243,12,-,126400,49947
235,216,19,1625,72000,49948
549,474,75,518,160500,49950
46,41,5,-,145300,49952
1131,937,194,525,69800,49953
124,124,0,-,59200,49955
318,305,13,850,142000,49958
169,122,47,489,33500,49959
79,79,0,-,45000,49960
72,70,2,-,70700,49961
107,104,3,-,163800,49962
368,253,115,757,71300,49963
248,244,4,-,202700,49965
204,195,9,1625,80800,49967
980,855,125,547,61400,49968
589,455,134,500,227100,49969
123,115,8,-,93500,49970
223,210,13,565,45400,49971
266,233,33,954,252600,50001
595,438,157,808,124800,50002
3075,2429,646,701,292500,50003
380,307,73,781,99300,50005
687,470,217,513,101000,50006
186,186,0,-,232400,50007
378,304,74,496,72500,50008
7327,5165,2162,1027,206800,50009
14239,7673,6566,876,198200,50010
0,0,0,-,-,50011
5,0,5,-,-,50012
12770,4315,8455,980,246200,50014
534,460,74,645,90900,50020
11310,8499,2811,1191,237100,50021
3808,2580,1228,618,129400,50022
14560,10786,3774,1047,245800,50023
1528,1083,445,641,84200,50025
220,156,64,633,76000,50026
157,134,23,625,83300,50027
703,549,154,678,146800,50028
245,210,35,542,57700,50029
240,240,0,-,-,50032
6,3,3,-,-,50033
164,132,32,575,88000,50034
2769,2477,292,952,236700,50035
6715,5186,1529,763,125500,50036
51,51,0,-,-,50038
158,131,27,724,215800,50039
21,21,0,-,-,50041
111,96,15,650,76400,50042
407,342,65,519,84800,50044
692,600,92,925,166400,50046
2322,1920,402,794,170100,50047
336,246,90,831,90000,50048
2803,2007,796,657,95300,50049
294,233,61,663,69300,50050
139,94,45,-,93300,50051
39,36,3,-,63300,50052
1067,879,188,745,140000,50054
341,266,75,713,159400,50055
504,415,89,928,132600,50056
133,133,0,-,138400,50057
805,635,170,605,122600,50058
1009,771,238,604,89600,50060
858,823,35,932,459800,50061
281,228,53,655,110000,50062
975,804,171,635,223600,50063
71,51,20,231,109300,50064
315,231,84,706,62500,50065
82,63,19,850,74100,50066
111,95,16,720,68400,50067
118,113,5,-,260400,50068
422,359,63,681,164200,50069
526,461,65,908,148900,50070
428,335,93,560,56400,50071
972,784,188,842,244800,50072
466,396,70,670,222400,50073
150,126,24,-,321900,50074
316,234,82,725,133300,50075
679,562,117,533,80000,50076
56,37,19,792,42500,50078
12,6,6,-,-,50101
56,56,0,-,48300,50102
143,124,19,369,68000,50103
38,27,11,-,69000,50104
399,314,85,764,227500,50105
391,323,68,602,88200,50106
411,302,109,600,77000,50107
154,121,33,533,57700,50108
1244,1099,145,1013,280300,50109
5944,4186,1758,942,234500,50111
4838,2996,1842,736,163900,50112
1164,869,295,681,115200,50115
66,64,2,-,76700,50116
56,42,14,-,170000,50117
351,327,24,1083,133200,50118
108,76,32,703,70000,50119
196,171,25,-,151100,50120
603,516,87,550,99300,50122
350,289,61,490,85600,50123
1525,1308,217,934,226000,50124
7622,5495,2127,818,194800,50125
2783,1944,839,792,107700,50126
0,0,0,-,-,50127
186,148,38,578,85700,50128
2328,1603,725,754,95800,50129
587,505,82,780,113000,50130
8884,6448,2436,1130,268100,50131
141,108,33,-,-,50132
219,167,52,713,158000,50133
350,230,120,760,200000,50134
562,452,110,661,114000,50135
184,153,31,827,75800,50136
5110,3710,1400,683,116400,50138
506,464,42,642,120200,50139
1119,609,510,597,88100,50140
171,161,10,580,112500,50141
367,298,69,649,121200,50142
265,219,46,577,160400,50143
1126,671,455,482,94600,50144
213,178,35,781,130900,50146
181,145,36,497,73000,50147
222,188,34,663,85000,50148
371,290,81,732,131500,50149
398,359,39,713,91400,50150
246,230,16,1091,162500,50151
356,288,68,718,125800,50153
230,184,46,548,134200,50154
97,85,12,-,88000,50155
1993,1674,319,728,162600,50156
397,274,123,646,90000,50157
11615,8083,3532,721,103000,50158
237,185,52,631,139600,50160
819,710,109,690,159600,50161
566,379,187,1086,131300,50162
385,282,103,583,79100,50163
238,187,51,495,93700,50164
66,63,3,-,-,50165
703,642,61,796,161600,50166
314,249,65,679,146700,50167
396,301,95,732,226700,50168
940,729,211,723,145400,50169
1255,1037,218,683,137500,50170
1155,787,368,738,175800,50171
362,275,87,913,130900,50173
501,404,97,813,87300,50174
3455,2626,829,714,155300,50201
212,179,33,527,91400,50206
943,714,229,463,124100,50207
7945,5613,2332,743,130200,50208
598,546,52,783,226100,50210
5338,4431,907,991,230500,50211
1221,975,246,660,143500,50212
3041,1978,1063,592,113800,50213
274,261,13,-,252400,50214
1085,906,179,889,202300,50216
273,225,48,496,88900,50217
125,112,13,907,70000,50218
5052,3559,1493,783,222800,50219
3669,2288,1381,810,97900,50220
180,170,10,-,153200,50222
218,171,47,486,123100,50223
1367,983,384,713,153700,50225
2283,2097,186,1099,316300,50226
19,19,0,-,62900,50227
1023,807,216,832,160000,50228
304,300,4,-,325000,50229
426,366,60,425,113600,50230
73,65,8,625,101900,50231
239,154,85,862,190900,50232
577,527,50,1000,165200,50233
238,223,15,700,109300,50234
151,109,42,945,83900,50235
729,589,140,673,146700,50236
1334,1212,122,540,267400,50237
516,455,61,660,62400,50238
31,17,14,1250,48300,50239
1147,972,175,841,240000,50240
178,144,34,775,160000,50242
84,71,13,1047,117500,50243
775,653,122,776,182600,50244
350,247,103,630,106000,50246
947,755,192,638,150300,50247
1825,1320,505,806,152100,50248
512,419,93,723,98600,50249
1023,813,210,711,130200,50250
563,463,100,750,133600,50251
63,59,4,-,203900,50252
82,82,0,-,140600,50254
27,27,0,-,-,50255
236,205,31,-,157800,50256
443,369,74,844,186700,50257
464,394,70,506,68800,50258
891,791,100,1063,239700,50261
130,122,8,-,66000,50262
10501,7746,2755,1152,258600,50263
195,159,36,667,87600,50264
14265,9530,4735,928,209000,50265
13720,7000,6720,1129,265300,50266
423,315,108,746,56100,50268
221,178,43,498,95300,50271
57,51,6,-,53300,50272
3597,2673,924,811,177400,50273
89,77,12,-,126900,50274
228,188,40,244,150000,50275
890,774,116,807,213000,50276
172,145,27,628,75000,50277
308,247,61,750,127400,50278
5634,587,5047,949,299400,50309
12996,9130,3866,891,159800,50310
6079,3085,2994,822,166600,50311
7904,4859,3045,896,218600,50312
6900,5103,1797,926,119000,50313
3902,1512,2390,818,94100,50314
14449,8933,5516,813,126400,50315
5190,3110,2080,819,100500,50316
14011,9782,4229,914,123000,50317
0,0,0,-,-,50319
8147,5809,2338,920,166800,50320
3357,2016,1341,980,212600,50321
12351,8746,3605,931,201700,50322
5123,4647,476,1210,342500,50323
2038,1491,547,1011,194200,50324
6714,5075,1639,923,284900,50325
4451,3416,1035,1045,235900,50327
13264,8760,4504,730,116600,50401
123,83,40,415,49400,50420
1193,940,253,678,88400,50421
1126,893,233,825,92400,50423
680,559,121,531,95400,50424
24,17,7,1075,54100,50426
4090,3017,1073,641,188500,50428
211,168,43,713,60000,50430
88,62,26,514,63100,50431
116,95,21,529,69600,50432
94,90,4,-,117200,50433
281,260,21,707,-,50434
265,247,18,675,136600,50435
2212,1766,446,632,112000,50436
1763,1341,422,812,129700,50438
106,96,10,-,66700,50439
171,115,56,563,99600,50440
2230,1601,629,713,90700,50441
130,104,26,615,106300,50444
213,167,46,567,119900,50446
557,439,118,752,66200,50447
341,275,66,588,109500,50448
348,250,98,650,80400,50449
1285,904,381,639,110300,50450
240,184,56,674,43300,50451
469,236,233,789,90800,50452
244,206,38,681,115000,50453
26,26,0,-,84600,50454
165,154,11,661,101400,50455
737,546,191,545,91900,50456
170,148,22,705,76900,50457
905,796,109,763,121800,50458
1237,1004,233,716,115500,50459
157,110,47,-,176700,50460
2400,1962,438,612,122200,50461
215,174,41,813,105800,50464
81,67,14,704,29700,50465
775,540,235,525,105400,50466
43,31,12,779,131900,50467
609,475,134,561,120700,50468
646,549,97,438,157400,50469
107,91,16,633,54200,50470
256,187,69,566,77500,50471
1035,822,213,759,164300,50472
96,88,8,-,58600,50473
571,474,97,633,99800,50475
293,243,50,445,74600,50476
123,87,36,515,55000,50477
435,384,51,669,90200,50478
284,218,66,555,87600,50479
297,279,18,775,60200,50480
319,267,52,882,161200,50482
287,243,44,502,109600,50483
152,143,9,-,68800,50484
11952,7775,4177,674,109600,50501
442,318,124,633,83800,50510
3217,2162,1055,782,156200,50511
636,525,111,588,81300,50514
103,76,27,583,31900,50515
271,225,46,625,101800,50516
448,327,121,538,80400,50517
182,167,15,565,114300,50518
282,219,63,486,86100,50519
69,64,5,-,38500,50520
46,0,46,815,-,50521
356,321,35,778,74800,50522
222,169,53,-,78000,50523
223,180,43,718,135500,50524
1651,1125,526,635,88800,50525
78,69,9,-,60700,50527
136,101,35,575,107500,50528
328,267,61,675,85200,50529
500,361,139,531,116800,50530
124,99,25,-,110500,50531
356,281,75,505,152300,50532
1691,1196,495,718,88700,50533
457,325,132,595,75300,50535
1834,1318,516,548,131300,50536
208,151,57,518,63800,50538
200,173,27,656,64400,50539
404,330,74,704,84100,50540
396,291,105,560,85000,50541
355,303,52,725,76400,50542
609,510,99,574,96700,50543
219,193,26,658,126900,50544
69,64,5,-,152500,50545
180,156,24,494,58200,50546
2467,1722,745,583,137600,50548
43,33,10,-,-,50551
776,585,191,614,68400,50554
115,103,12,419,59000,50556
344,287,57,542,83100,50557
255,224,31,913,90000,50558
160,93,67,550,96900,50559
265,182,83,709,60800,50560
228,177,51,503,54600,50561
168,143,25,-,59800,50562
1156,892,264,595,119800,50563
171,155,16,819,66800,50565
179,150,29,830,178900,50566
117,99,18,680,139800,50567
537,419,118,499,93600,50568
339,271,68,533,77100,50569
82,57,25,1075,113100,50570
153,125,28,395,53400,50571
36,27,9,-,46900,50573
962,686,276,643,92800,50574
326,282,44,520,67800,50575
129,86,43,448,67700,50576
181,152,29,493,49600,50577
286,234,52,535,43300,50578
1010,786,224,626,84400,50579
341,258,83,772,72000,50581
111,96,15,713,56700,50582
1190,880,310,610,106400,50583
505,392,113,820,81800,50585
119,114,5,-,84600,50586
4616,2569,2047,702,153200,50588
395,313,82,559,56300,50590
181,130,51,1044,155300,50591
21,21,0,-,28800,50593
97,47,50,575,103100,50594
3711,2631,1080,771,98900,50595
428,339,89,575,140300,50597
419,360,59,622,85000,50598
214,147,67,619,110900,50599
1035,831,204,536,98700,50601
659,493,166,481,102100,50602
208,182,26,481,85000,50603
744,598,146,599,119400,50604
106,83,23,613,48100,50605
349,277,72,475,88400,50606
132,124,8,625,125000,50607
131,111,20,733,112500,50609
175,125,50,671,58900,50611
165,145,20,-,244900,50612
16343,10860,5483,945,211400,50613
4454,3029,1425,531,109000,50616
851,594,257,684,118300,50619
24,17,7,-,92500,50620
674,469,205,828,133200,50621
1204,1060,144,725,213800,50622
632,537,95,641,204400,50624
447,379,68,483,65200,50625
617,512,105,673,167700,50626
1244,867,377,596,87900,50627
482,371,111,485,104600,50628
921,790,131,613,143600,50629
715,585,130,664,130200,50630
515,445,70,578,92300,50632
252,103,149,479,65000,50633
340,303,37,679,146000,50634
627,508,119,648,112700,50635
909,698,211,571,113100,50636
1351,1122,229,619,135200,50638
518,404,114,569,99200,50641
263,198,65,936,175000,50642
1059,950,109,939,201900,50643
3580,2778,802,739,151300,50644
527,479,48,443,94300,50645
943,881,62,536,234400,50647
1506,1279,227,759,170300,50648
325,248,77,665,81300,50650
1417,1115,302,674,143000,50651
41,34,7,750,70000,50652
292,243,49,539,107700,50653
161,142,19,425,-,50654
372,287,85,540,110400,50655
975,764,211,633,111400,50658
2421,1954,467,733,126500,50659
482,386,96,700,118100,50660
2751,1943,808,642,97400,50662
14,14,0,-,-,50664
1159,942,217,669,172800,50665
385,305,80,675,166100,50666
301,271,30,625,185300,50667
472,438,34,571,137800,50668
1045,830,215,680,124800,50669
914,741,173,651,138800,50670
105,68,37,-,78000,50671
223,159,64,574,114600,50672
71,61,10,794,97900,50673
1602,1321,281,664,124800,50674
958,735,223,838,125700,50675
999,849,150,643,119100,50676
4473,3508,965,735,186800,50677
494,442,52,538,87200,50680
164,143,21,704,87400,50681
730,590,140,575,147600,50682
13102,8318,4784,760,152200,50701
8490,5151,3339,773,118700,50702
7782,4418,3364,803,75500,50703
3650,2804,846,767,106400,50707
4056,2829,1227,597,113600,50801
676,538,138,535,99000,50830
880,758,122,578,76600,50833
41,30,11,-,137500,50835
166,128,38,604,71700,50836
149,130,19,1034,67700,50837
28,28,0,-,70000,50839
313,262,51,566,108900,50840
1110,855,255,673,78200,50841
34,33,1,-,71300,50842
186,138,48,675,65800,50843
242,193,49,821,96300,50845
464,303,161,579,77600,50846
29,25,4,-,35800,50847
102,90,12,575,-,50848
1206,776,430,483,115500,50849
811,638,173,528,105100,50851
331,260,71,567,109100,50853
972,681,291,603,107600,50854
98,86,12,-,177300,50857
286,243,43,544,98900,50858
282,243,39,912,73800,50859
65,58,7,638,206900,50860
120,113,7,765,103500,50861
71,51,20,1013,45500,50862
84,62,22,600,62500,50863
863,643,220,701,83600,50864
894,672,222,623,129700,51001
1060,839,221,739,113100,51002
740,660,80,858,178200,51003
419,329,90,798,89900,51004
660,531,129,533,138400,51005
468,352,116,387,70300,51006
212,208,4,-,163500,51007
67,57,10,-,98800,51008
59,41,18,450,71500,51009
174,139,35,628,108600,51010
28,23,5,642,-,51011
2751,1930,821,546,127000,51012
204,172,32,621,105200,51014
530,475,55,600,88200,51016
265,207,58,520,313800,51018
295,243,52,488,96800,51019
309,183,126,567,70400,51020
331,279,52,679,125800,51022
1276,955,321,633,109200,51023
912,766,146,820,258300,51024
797,586,211,646,116300,51025
425,402,23,563,161000,51026
412,331,81,675,114300,51027
919,712,207,623,157600,51028
177,150,27,392,100000,51029
674,552,122,550,210200,51030
4919,3568,1351,766,170400,51031
216,182,34,911,92300,51033
776,598,178,583,89600,51034
777,599,178,546,119800,51035
309,268,41,725,222200,51036
184,82,102,526,107400,51037
717,589,128,733,151700,51038
1127,909,218,772,167500,51039
1584,1075,509,634,101200,51040
2470,1933,537,685,184800,51041
114,97,17,500,76100,51044
691,520,171,543,112300,51046
359,317,42,681,93200,51047
221,158,63,721,83300,51048
260,219,41,575,57300,51049
1088,851,237,581,171000,51050
40,36,4,-,-,51051
475,361,114,683,209000,51052
477,392,85,688,91200,51053
1999,1574,425,1104,220900,51054
557,479,78,820,150100,51055
195,178,17,817,66500,51056
407,329,78,358,72000,51058
296,215,81,621,70600,51060
213,171,42,510,58200,51061
264,224,40,638,-,51062
455,336,119,766,83800,51063
371,36,335,473,215400,51101
6094,3726,2368,811,97900,51103
8251,5324,2927,843,153100,51104
4067,1734,2333,707,70200,51105
10403,7457,2946,850,151200,51106
2068,1840,228,801,123800,51108
1424,990,434,825,98600,51109
36,0,36,862,-,51111
2524,1773,751,550,146900,51201
159,155,4,-,145300,51230
191,162,29,-,157200,51231
307,246,61,740,74600,51232
475,420,55,811,149500,51234
413,371,42,675,168100,51235
679,560,119,807,97300,51237
476,437,39,566,141100,51238
1037,891,146,795,178200,51239
806,639,167,1050,157100,51240
809,711,98,720,243200,51241
80,77,3,-,123400,51242
263,228,35,538,76700,51243
48,47,1,-,79000,51244
564,434,130,662,108900,51245
1406,1195,211,668,180300,51246
1839,1501,338,678,184800,51247
738,565,173,650,111300,51248
1407,1063,344,646,112200,51249
2981,2303,678,731,230800,51250
5648,3605,2043,693,141000,51301
581,453,128,622,250600,51331
194,140,54,813,136400,51333
2871,2239,632,649,93400,51334
415,330,85,579,107100,51338
14,13,1,-,38800,51341
588,477,111,540,77000,51342
86,82,4,-,166700,51343
205,122,83,835,118300,51345
907,704,203,707,85400,51346
673,580,93,861,128100,51347
199,144,55,630,57100,51350
2038,1655,383,798,193900,51351
534,459,75,621,83200,51354
513,359,154,811,247800,51355
323,247,76,676,79300,51357
543,402,141,494,100000,51358
4311,3238,1073,866,213100,51360
92,86,6,-,78900,51363
351,301,50,680,113100,51364
141,117,24,530,93100,51365
136,112,24,-,101600,51366
5188,3763,1425,607,157400,51401
416,316,100,655,131100,51430
163,134,29,525,70000,51431
234,126,108,613,67300,51433
414,304,110,681,157400,51436
388,282,106,629,62200,51439
136,130,6,-,108700,51440
181,152,29,550,84200,51441
3301,2065,1236,689,112900,51442
568,484,84,600,134600,51443
103,98,5,975,98200,51444
1145,905,240,560,116900,51445
235,183,52,719,114900,51446
102,85,17,627,-,51447
240,189,51,819,80200,51448
887,698,189,617,86400,51449
688,601,87,497,142800,51450
48,44,4,-,65000,51451
309,273,36,439,74400,51453
539,447,92,521,94800,51454
1014,846,168,577,106700,51455
535,460,75,525,82200,51458
36,32,4,-,55600,51459
541,392,149,437,92500,51461
472,384,88,681,98000,51462
237,200,37,738,150000,51463
302,260,42,715,82600,51465
490,417,73,528,158800,51466
253,219,34,910,122600,51467
14108,8835,5273,863,104500,51501
14624,10068,4556,864,186000,51503
1342,1003,339,934,111900,51510
103,81,22,575,-,51520
817,618,199,721,139400,51521
169,156,13,640,93300,51523
490,397,93,636,160600,51525
739,635,104,758,245400,51526
248,224,24,606,115500,51527
342,227,115,572,80700,51528
855,533,322,746,98600,51529
286,208,78,575,90000,51530
284,245,39,523,121400,51531
288,199,89,705,67400,51532
412,299,113,688,118600,51533
3341,2571,770,796,208500,51534
746,596,150,759,94000,51535
183,160,23,-,83600,51536
2916,2079,837,788,121200,51537
140,127,13,-,115300,51540
140,112,28,807,108300,51541
392,342,50,1027,269900,51542
212,143,69,552,79400,51543
322,297,25,616,69100,51544
135,108,27,775,38300,51545
1155,936,219,713,143000,51546
185,169,16,-,197900,51548
211,169,42,909,171100,51549
65,57,8,-,64500,51550
661,541,120,887,157200,51551
131,93,38,639,164600,51552
380,316,64,625,145900,51553
61,48,13,-,127800,51554
1998,1373,625,722,135100,51555
197,179,18,850,115300,51556
397,374,23,575,117900,51557
239,194,45,644,56700,51558
659,481,178,859,165900,51559
781,510,271,593,123600,51560
439,405,34,918,194300,51561
169,141,28,817,163500,51562
299,241,58,844,136500,51563
182,150,32,657,70400,51564
260,154,106,716,116100,51565
2894,2076,818,646,86800,51566
432,303,129,829,120300,51570
220,171,49,2098,165800,51571
205,169,36,456,60700,51572
451,359,92,832,93100,51573
547,450,97,836,193300,51575
806,719,87,776,219400,51576
530,398,132,753,112400,51577
40,40,0,-,100000,51578
900,651,249,719,137200,51579
2522,1650,872,695,98700,51601
59,59,0,-,-,51630
132,92,40,713,116700,51631
2659,1864,795,626,101900,51632
211,170,41,768,88600,51636
114,102,12,494,60300,51637
598,468,130,568,77700,51638
360,253,107,563,97700,51639
759,588,171,653,94100,51640
111,80,31,-,113200,51645
362,298,64,679,77100,51646
57,43,14,-,-,51647
91,68,23,-,167100,51648
134,119,15,875,142000,51649
134,120,14,660,39200,51650
634,484,150,584,112200,51652
588,451,137,661,153500,51653
163,111,52,1088,115500,51654
20,18,2,-,72000,51656
17642,11084,6558,782,133800,52001
6670,4956,1714,888,219400,52002
5241,4562,679,840,212300,52003
185,118,67,740,93800,52030
2163,1878,285,628,180700,52031
632,590,42,618,186500,52032
1272,986,286,743,170600,52033
421,361,60,546,119500,52035
406,371,35,525,118900,52037
182,157,25,775,166100,52038
350,344,6,850,228600,52039
2418,2166,252,790,174200,52040
701,581,120,625,159000,52041
619,488,131,475,159200,52042
928,580,348,734,120100,52043
81,71,10,-,152100,52044
1009,776,233,748,185900,52045
952,765,187,844,212800,52046
275,235,40,538,92500,52047
137,98,39,659,121400,52048
551,416,135,609,112900,52049
209,166,43,657,135000,52050
1414,1037,377,655,166500,52052
358,325,33,479,165300,52053
299,246,53,915,180600,52054
3305,2673,632,624,135600,52057
3581,2780,801,583,102700,52060
303,247,56,613,133600,52064
362,309,53,948,143600,52065
36,29,7,-,73800,52066
1650,1480,170,532,275800,52068
583,451,132,700,146500,52069
465,358,107,630,152500,52070
120,87,33,565,138800,52072
571,515,56,813,262800,52073
131,123,8,-,213800,52074
955,692,263,542,110600,52076
149,125,24,586,65900,52077
223,168,55,544,144400,52078
313,241,72,600,204500,52079
5109,3834,1275,735,199100,52101
887,582,305,639,163600,52132
280,264,16,635,94200,52133
111,94,17,564,118800,52134
291,244,47,510,114800,52135
2341,1791,550,804,112600,52136
235,225,10,-,113500,52140
572,496,76,525,79100,52141
648,397,251,667,97300,52142
457,435,22,575,142900,52144
390,343,47,813,153300,52146
434,372,62,630,102400,52147
939,724,215,676,118400,52151
358,315,43,415,131700,52154
596,525,71,574,114200,52155
195,175,20,817,163300,52156
881,630,251,656,147100,52157
131,98,33,525,106300,52158
1101,814,287,822,128300,52159
418,376,42,525,163500,52160
606,532,74,757,138800,52161
1193,857,336,719,109100,52162
149,133,16,550,74200,52163
127,119,8,583,120800,52164
418,372,46,638,240400,52165
42,39,3,-,75000,52166
118,84,34,859,130800,52168
129,106,23,460,88300,52169
266,246,20,608,179900,52170
426,322,104,615,168100,52171
2634,2057,577,595,134600,52172
1531,1068,463,678,120000,52175
591,455,136,675,155500,52201
400,326,74,484,175000,52202
947,872,75,641,214100,52203
3272,2551,721,815,161900,52205
915,872,43,608,239800,52206
171,162,9,-,77100,52207
1299,1058,241,572,94200,52208
440,349,91,702,132200,52209
288,225,63,825,134400,52210
1077,792,285,741,134600,52211
133,100,33,933,137500,52212
1465,1204,261,1015,195200,52213
1365,1175,190,617,217800,52214
407,377,30,429,158900,52215
612,431,181,686,118000,52216
232,189,43,875,86700,52217
777,642,135,637,147500,52218
75,60,15,646,85500,52219
108,108,0,-,185600,52220
85,82,3,775,170000,52221
261,232,29,290,88000,52222
409,361,48,688,166600,52223
762,594,168,708,156700,52224
146,142,4,-,94600,52225
1066,902,164,738,240300,52227
1282,1213,69,1149,250300,52228
286,210,76,759,177200,52229
129,106,23,634,153000,52231
120,108,12,-,183800,52232
2864,1773,1091,759,144800,52233
366,226,140,995,173100,52235
259,259,0,-,150700,52236
547,501,46,481,146600,52237
15298,7800,7498,1016,200800,52240
8690,4683,4007,910,239900,52241
0,0,0,-,-,52242
9916,5997,3919,1072,239600,52245
10346,4190,6156,895,263500,52246
1859,1319,540,770,188300,52247
737,606,131,679,116100,52248
385,304,81,834,128700,52249
257,240,17,425,131300,52251
1128,889,239,879,181000,52253
385,275,110,600,80300,52254
586,467,119,768,118000,52255
84,73,11,-,167000,52257
1476,1186,290,565,113400,52301
16422,12712,3710,721,180700,52302
247,209,38,678,118800,52305
618,494,124,517,139200,52306
30,24,6,-,-,52307
84,66,18,475,90900,52308
303,278,25,724,118100,52309
2698,2093,605,619,145500,52310
27,22,5,-,45000,52312
103,94,9,544,-,52313
1786,1372,414,759,221300,52314
495,370,125,481,145200,52315
686,541,145,590,105500,52316
7730,5650,2080,1167,245300,52317
419,337,82,943,156500,52318
503,366,137,688,94400,52320
155,116,39,575,83800,52321
851,773,78,904,184600,52322
382,314,68,606,97400,52323
617,565,52,1132,230000,52324
268,246,22,600,207500,52325
258,208,50,692,106600,52326
1367,982,385,1048,244200,52327
1169,1111,58,1216,288300,52328
315,274,41,775,154800,52329
360,263,97,481,135200,52330
800,660,140,545,194100,52332
2629,2283,346,936,320600,52333
94,94,0,-,197000,52334
312,257,55,630,79300,52335
1131,958,173,855,157900,52336
331,234,97,752,105700,52337
1303,1220,83,786,304000,52338
1350,829,521,726,96000,52339
1571,1241,330,1066,226600,52340
494,432,62,782,346200,52341
1324,974,350,693,107800,52342
515,457,58,642,157600,52345
482,391,91,830,166800,52346
523,427,96,688,107900,52347
38,37,1,-,63200,52348
3232,2574,658,831,156900,52349
495,455,40,725,221600,52351
717,627,90,438,164100,52352
3722,2316,1406,843,136600,52353
156,136,20,-,170200,52354
122,114,8,725,111400,52355
1054,689,365,748,165500,52356
1476,1260,216,828,187700,52358
81,79,2,-,151800,52359
1860,1239,621,646,165400,52361
411,342,69,589,90000,52362
1143,242,901,689,143100,52401
17329,11972,5357,839,150400,52402
9772,7358,2414,739,148700,52403
16811,11443,5368,758,135100,52404
11079,8395,2684,898,144100,52405
2985,2943,42,-,328800,52411
12159,7936,4223,770,84100,52501
450,370,80,650,154800,52530
2394,1754,640,581,124700,52531
493,428,65,492,100700,52533
130,107,23,800,64500,52534
409,340,69,595,108300,52535
411,357,54,553,157400,52536
2574,2150,424,710,119700,52537
524,367,157,666,84000,52540
133,115,18,1063,93500,52542
147,109,38,-,130600,52543
3353,2313,1040,660,79600,52544
39,34,5,-,70000,52548
241,226,15,850,93500,52549
278,244,34,-,108300,52550
224,201,23,-,-,52551
387,327,60,728,153000,52552
660,526,134,903,118100,52553
544,464,80,675,64500,52554
123,103,20,775,75000,52555
5079,3408,1671,760,130100,52556
0,0,0,-,-,52557
100,89,11,731,89500,52560
366,216,150,578,88600,52561
634,472,162,802,101200,52563
786,571,215,667,113400,52565
85,74,11,725,70000,52566
300,239,61,791,150800,52567
349,337,12,1100,81000,52569
358,319,39,563,69900,52570
575,481,94,755,141200,52571
427,282,145,640,74400,52572
60,55,5,-,111400,52573
239,192,47,731,66700,52574
204,167,37,929,127900,52576
6074,3906,2168,702,111900,52577
349,320,29,575,96000,52580
127,70,57,622,95000,52581
150,129,21,-,103800,52583
156,139,17,781,78800,52584
355,271,84,824,96100,52585
246,204,42,-,108400,52586
8,8,0,-,-,52588
399,333,66,542,69500,52590
1303,941,362,769,106400,52591
67,49,18,711,109400,52593
152,145,7,-,100600,52594
161,92,69,698,77000,52595
12561,8478,4083,821,99100,52601
307,217,90,-,122300,52619
344,289,55,564,106900,52620
306,235,71,778,137500,52621
727,641,86,709,151000,52623
212,192,20,-,-,52624
981,787,194,658,138300,52625
541,432,109,587,64100,52626
5167,3790,1377,753,92600,52627
147,116,31,580,51500,52630
5455,3645,1810,690,81700,52632
430,272,158,780,83100,52635
1103,844,259,690,140000,52637
217,176,41,750,143400,52638
763,669,94,725,109900,52639
568,469,99,630,121400,52640
4511,3145,1366,702,131900,52641
162,154,8,900,137900,52644
1379,1048,331,638,103600,52645
147,128,19,806,100000,52646
71,48,23,638,102500,52647
373,299,74,547,162500,52649
259,219,40,845,165900,52650
240,183,57,388,67000,52651
1313,946,367,765,118100,52653
612,472,140,528,105200,52654
1638,1121,517,763,133500,52655
937,819,118,405,174500,52656
19,17,2,-,122900,52657
391,381,10,-,191300,52658
595,458,137,533,98100,52659
71,42,29,-,150000,52660
62,37,25,-,89300,52701
332,299,33,863,154200,52720
326,264,62,613,145400,52721
14904,11498,3406,934,237300,52722
2255,2122,133,888,236700,52726
119,80,39,-,183600,52727
449,341,108,575,110300,52728
362,326,36,625,134600,52729
2206,1795,411,626,128200,52730
298,235,63,775,123300,52731
11403,7863,3540,658,104300,52732
146,134,12,525,79700,52737
1412,1019,393,614,104600,52738
229,132,97,755,74300,52739
2828,2322,506,822,174800,52742
235,199,36,820,190200,52745
413,314,99,960,193500,52746
801,604,197,731,174200,52747
3670,2890,780,787,243100,52748
341,317,24,727,177000,52749
197,174,23,684,139200,52750
333,234,99,720,125000,52751
195,174,21,688,93800,52752
1861,1561,300,1103,249900,52753
559,497,62,693,154900,52754
830,674,156,769,167700,52755
651,637,14,1375,270300,52756
97,90,7,769,93900,52757
112,95,17,1125,148800,52758
231,217,14,-,133700,52760
11816,8400,3416,835,129800,52761
181,152,29,1071,175000,52765
370,357,13,-,101200,52766
29,10,19,-,-,52767
554,484,70,742,205100,52768
251,213,38,731,221200,52769
2156,1681,475,607,164600,52772
1097,820,277,717,148500,52773
48,35,13,739,88100,52774
1619,1209,410,927,139300,52776
526,442,84,735,90600,52777
1603,1336,267,678,139400,52778
759,9,750,749,-,52801
3853,2648,1205,782,72600,52802
8593,5694,2899,742,132700,52803
10782,7125,3657,804,122900,52804
10804,7229,3575,820,147000,52806
6535,3776,2759,797,273100,52807
826,703,123,656,197000,53001
955,765,190,915,254300,53002
50,45,5,-,165300,53003
1348,1185,163,807,210300,53004
7701,6621,1080,1503,299700,53005
704,558,146,836,190000,53006
912,354,558,851,169500,53007
3442,2967,475,808,247000,53010
901,763,138,747,211400,53011
7525,6088,1437,889,332200,53012
1349,1107,242,867,196200,53013
3147,2429,718,662,163700,53014
1123,1006,117,764,164600,53015
133,102,31,825,108700,53016
1977,1953,24,-,349100,53017
3198,2425,773,1405,377500,53018
742,609,133,738,188100,53019
1565,1327,238,918,260300,53020
1829,1436,393,858,254400,53021
7630,5850,1780,1058,275400,53022
567,515,52,836,166100,53023
7727,5447,2280,944,273800,53024
9082,6768,2314,857,234100,53027
8057,6474,1583,1022,369500,53029
0,0,0,-,-,53031
2118,1445,673,744,153700,53032
2219,2145,74,1250,284000,53033
689,491,198,848,181200,53034
890,761,129,1000,206800,53035
1076,763,313,980,266500,53036
3946,2907,1039,983,238800,53037
1723,1395,328,950,240000,53038
1632,1272,360,781,167300,53039
3329,2649,680,840,231500,53040
2775,2235,540,747,164200,53042
841,751,90,1031,268800,53044
8669,7018,1651,1548,352400,53045
507,413,94,533,176300,53046
13,13,0,-,182500,53047
1345,733,612,901,172400,53048
1065,909,156,788,226400,53049
2702,1930,772,735,156300,53050
15434,11503,3931,1126,264900,53051
646,577,69,638,181000,53057
1423,935,488,1234,372400,53058
735,629,106,668,244400,53059
2176,1755,421,624,136300,53061
627,542,85,664,176300,53063
945,802,143,784,197700,53065
13604,10966,2638,1057,317700,53066
347,337,10,-,451200,53069
1935,1602,333,790,185900,53070
11078,8441,2637,1162,320000,53072
6197,4412,1785,735,190600,53073
5410,3610,1800,921,211200,53074
1293,1018,275,740,205400,53075
1298,1218,80,1130,360100,53076
693,609,84,893,270900,53078
576,494,82,676,174600,53079
2320,1365,955,790,223500,53080
17852,10524,7328,699,124600,53081
8446,6353,2093,875,177300,53083
5213,3778,1435,784,166200,53085
3444,2538,906,927,278300,53086
181,126,55,746,137900,53088
7346,5875,1471,1055,294200,53089
8901,6667,2234,958,210300,53090
839,690,149,756,166300,53091
8448,6716,1732,1477,364200,53092
750,691,59,775,181600,53093
7512,4757,2755,860,169100,53094
11994,8643,3351,843,220300,53095
1975,1876,99,1655,398100,53097
4535,3148,1387,935,185600,53098
1531,1437,94,1089,283600,53103
2117,1865,252,1129,271100,53104
11935,8605,3330,863,242600,53105
1367,1288,79,735,222900,53108
7875,4951,2924,847,157100,53110
927,717,210,883,170200,53114
6508,4302,2206,888,165300,53115
2824,2416,408,1298,318000,53118
2258,2046,212,1046,311700,53119
4115,3193,922,1146,247800,53120
7782,5726,2056,890,223000,53121
2190,1993,197,998,395500,53122
778,668,110,889,401700,53125
2728,2307,421,1028,285000,53126
3136,2543,593,1109,177400,53128
5727,3985,1742,932,227400,53129
3219,1772,1447,1060,228700,53130
13514,10609,2905,1116,263900,53132
641,581,60,925,242900,53137
1016,885,131,1051,221900,53139
12083,5789,6294,874,143500,53140
12962,9513,3449,1071,190800,53142
8475,4898,3577,926,141800,53143
9948,5537,4411,903,193800,53144
2936,2782,154,1123,264100,53146
7397,5072,2325,982,238000,53147
7380,6288,1092,920,304400,53149
9921,8481,1440,1172,303500,53150
13586,10012,3574,1284,273700,53151
907,836,71,886,296900,53153
15348,9555,5793,1115,238100,53154
1362,1029,333,626,203900,53156
6340,5232,1108,1201,247700,53158
276,60,216,866,-,53167
3541,2831,710,1103,203600,53168
934,688,246,810,210000,53170
8461,4983,3478,880,166000,53172
2518,2053,465,954,175300,53177
1068,777,291,886,233100,53178
2660,2080,580,891,200300,53179
2781,2057,724,931,230300,53181
3278,2320,958,985,232800,53182
1014,804,210,1098,319800,53183
1620,1066,554,891,197300,53184
7599,6546,1053,961,273700,53185
14681,7520,7161,931,217100,53186
14135,9067,5068,1006,253800,53188
9911,8199,1712,1063,296300,53189
6680,3092,3588,799,203800,53190
1288,1018,270,1093,262300,53191
11,0,11,-,-,53192
65,42,23,1090,179700,53195
15818,3334,12484,995,259200,53202
1051,146,905,1453,296400,53203
13459,3827,9632,785,73500,53204
3304,894,2410,588,80300,53205
8543,2486,6057,812,47300,53206
16471,9483,6988,943,169500,53207
11621,4415,7206,791,149300,53208
19683,8335,11348,835,104800,53209
9348,3330,6018,880,110300,53210
14440,5977,8463,988,343900,53211
13314,4080,9234,872,154000,53212
11626,6893,4733,999,250100,53213
16106,8038,8068,835,139100,53214
18865,8585,10280,800,107200,53215
12558,5367,7191,851,88600,53216
11918,8442,3476,1327,348700,53217
14040,5658,8382,883,85800,53218
14745,9536,5209,801,145000,53219
11589,7135,4454,896,159200,53220
16118,9570,6548,899,156000,53221
11149,7122,4027,894,153300,53222
11925,6166,5759,921,139400,53223
7432,3750,3682,1018,149300,53224
9853,3779,6074,910,129500,53225
8343,5071,3272,1082,251100,53226
10609,4978,5631,913,161300,53227
6606,3473,3133,1140,213700,53228
4212,158,4054,719,65700,53233
4854,2588,2266,750,159300,53235
0,0,0,-,-,53295
13674,9680,3994,930,170100,53402
10406,4974,5432,869,119600,53403
5387,2385,3002,812,98300,53404
10372,7209,3163,895,135200,53405
10892,7861,3031,854,201500,53406
0,0,0,-,-,53501
984,728,256,776,190800,53502
838,628,210,829,184800,53503
893,723,170,533,158600,53504
153,126,27,1219,180800,53505
435,306,129,701,126800,53506
789,635,154,1074,259100,53507
2241,1822,419,883,237300,53508
598,483,115,756,166800,53510
18443,11753,6690,835,117300,53511
938,762,176,793,237800,53515
1055,892,163,608,219400,53516
670,536,134,990,310900,53517
623,516,107,589,135900,53518
2811,2090,721,750,164200,53520
1398,1176,222,967,281100,53521
396,323,73,588,153000,53522
2117,1786,331,980,235600,53523
1551,1204,347,914,173400,53525
240,190,50,638,120800,53526
4006,3405,601,1203,295700,53527
2547,1908,639,1108,322000,53528
791,597,194,923,300300,53529
1802,1312,490,793,125600,53530
1715,1356,359,843,263500,53531
6006,4781,1225,990,259200,53532
2917,1964,953,823,205000,53533
4700,3466,1234,856,194900,53534
3635,2661,974,786,207500,53536
399,298,101,802,112800,53537
7440,5314,2126,894,179900,53538
94,43,51,676,93600,53540
387,318,69,538,159400,53541
740,580,160,550,154300,53543
321,258,63,727,275900,53544
9953,6283,3670,859,149800,53545
12585,8928,3657,921,159400,53546
8202,5548,2654,819,159000,53548
4299,2984,1315,850,173000,53549
462,402,60,785,171700,53550
3412,2612,800,922,221000,53551
265,229,36,329,127400,53553
376,307,69,764,137800,53554
3734,2953,781,918,309300,53555
1061,859,202,678,136600,53556
178,131,47,708,131400,53557
4979,3796,1183,1185,283000,53558
2265,1681,584,948,223600,53559
1461,1197,264,867,258400,53560
793,682,111,1019,302800,53561
11169,6509,4660,1109,395100,53562
4293,3319,974,914,214800,53563
2043,1488,555,698,198200,53565
6606,4462,2144,742,155500,53566
465,377,88,764,157300,53569
1124,847,277,741,186400,53570
18,18,0,-,-,53571
4991,3979,1012,1023,238600,53572
1331,1047,284,604,126000,53573
1475,1273,202,881,241500,53574
6703,5264,1439,972,308100,53575
931,768,163,1002,167200,53576
554,388,166,870,177700,53577
2819,1894,925,967,257300,53578
654,479,175,763,170200,53579
202,155,47,844,107600,53580
4459,3188,1271,669,142000,53581
438,375,63,835,178200,53582
2483,1814,669,750,234100,53583
807,542,265,838,162000,53585
856,653,203,603,119600,53586
534,431,103,574,134900,53587
1744,1402,342,866,210500,53588
8316,6668,1648,927,241100,53589
16018,10697,5321,1131,267800,53590
9920,7281,2639,1286,363000,53593
2290,1623,667,810,185100,53594
7463,5709,1754,1045,350400,53597
1101,759,342,1337,306900,53598
28,17,11,-,57500,53599
73,73,0,-,-,53702
17551,2529,15022,1166,349000,53703
20829,11439,9390,1071,214500,53704
12024,5819,6205,1161,344700,53705
63,0,63,1102,-,53706
20864,13343,7521,1141,302700,53711
10190,3413,6777,975,197200,53713
7391,4369,3022,982,202600,53714
4660,958,3702,1326,315800,53715
8098,5897,2201,1028,242100,53716
6157,3215,2942,1160,314400,53717
6868,4245,2623,1352,257100,53718
13895,6826,7069,1203,275100,53719
2255,844,1411,1265,471800,53726
0,0,0,-,-,53792
435,352,83,-,108000,53801
21,13,8,-,85000,53802
513,378,135,722,117200,53803
535,433,102,557,131600,53804
2154,1577,577,600,122800,53805
736,569,167,508,104600,53806
1875,1537,338,715,174100,53807
428,328,100,713,143100,53808
1535,1104,431,653,142200,53809
148,132,16,488,118300,53810
1268,883,385,826,200600,53811
2242,1544,698,714,156700,53813
275,233,42,663,200600,53816
94,84,10,625,95000,53817
5713,3095,2618,776,168900,53818
922,773,149,594,160700,53820
3293,2207,1086,688,125300,53821
167,128,39,625,160400,53825
564,456,108,665,127000,53826
83,63,20,746,112500,53827
6213,4019,2194,825,162600,53901
1634,1032,602,584,103100,53910
531,433,98,1114,223000,53911
9169,5874,3295,818,167400,53913
9903,6248,3655,832,156800,53916
958,746,212,692,167400,53919
265,214,51,854,196400,53920
423,390,33,591,189400,53922
798,650,148,718,168900,53923
526,429,97,725,141200,53924
3387,2512,875,810,206600,53925
575,462,113,700,152100,53926
38,31,7,-,99400,53928
1136,860,276,680,145800,53929
545,447,98,683,152800,53930
81,63,18,850,124000,53931
956,710,246,1053,212500,53932
1393,827,566,902,186100,53933
2028,1655,373,634,111200,53934
101,85,16,920,111300,53935
598,530,68,730,87200,53936
366,308,58,838,170500,53937
131,103,28,734,105100,53939
1183,1040,143,765,186900,53941
382,307,75,714,169000,53943
910,715,195,834,157700,53944
1805,1493,312,743,171800,53946
98,68,30,711,150000,53947
3412,2529,883,802,131900,53948
2757,2270,487,676,156300,53949
2054,1609,445,774,123800,53950
1036,797,239,668,140400,53951
1428,1224,204,792,145400,53952
140,105,35,803,114100,53953
2909,2412,497,853,193900,53954
2376,1878,498,777,235600,53955
1248,1009,239,656,152800,53956
5273,3714,1559,760,168200,53959
1476,1139,337,671,195200,53960
372,333,39,895,180200,53961
5296,3663,1633,735,137100,53963
1427,1062,365,769,156100,53964
4755,3566,1189,797,167600,53965
944,717,227,723,134300,53968
146,109,37,908,170600,53969
3248,2774,474,683,166200,54001
2501,1970,531,940,205200,54002
356,319,37,1147,253600,54003
963,775,188,749,166400,54004
1194,987,207,595,168000,54005
291,260,31,870,167300,54006
419,362,57,788,188600,54007
970,781,189,961,174700,54009
21,0,21,-,-,54010
2720,2083,637,805,193700,54011
1350,1086,264,875,208700,54013
818,716,102,1000,212500,54014
1354,1025,329,801,208900,54015
12716,9809,2907,1255,326300,54016
6925,5071,1854,968,231000,54017
3042,2305,737,855,205600,54020
2917,2332,585,1019,248000,54021
8243,5288,2955,892,271000,54022
1670,1340,330,1310,274700,54023
2045,1563,482,771,197500,54024
2651,2147,504,920,244200,54025
908,729,179,833,258300,54026
407,378,29,1080,234900,54027
1084,763,321,768,186100,54028
694,644,50,-,389300,54082
1047,943,104,756,199900,54101
455,406,49,545,92300,54102
191,175,16,856,107600,54103
554,480,74,819,124200,54104
2159,1809,350,646,183800,54106
1477,1180,297,573,169100,54107
2020,1649,371,696,159600,54110
1014,852,162,805,159600,54111
1072,781,291,666,136400,54112
1427,1247,180,853,189300,54113
2492,2005,487,673,139900,54114
18116,11892,6224,892,225000,54115
253,197,56,738,110100,54119
110,92,18,489,125000,54120
1460,1281,179,457,136000,54121
121,98,23,542,150000,54123
1543,1257,286,698,109700,54124
276,218,58,505,75600,54125
1314,1145,169,828,197600,54126
22,10,12,-,110000,54127
773,611,162,614,122600,54128
1314,1131,183,801,173200,54129
10719,7890,2829,821,170800,54130
1038,705,333,553,113400,54135
2762,1883,879,736,149000,54136
465,441,24,688,177100,54137
461,393,68,775,158700,54138
1269,1081,188,640,153500,54139
3822,2428,1394,822,155800,54140
896,846,50,775,205100,54141
7109,5093,2016,700,114800,54143
575,546,29,638,155600,54149
318,170,148,543,51400,54150
1445,1227,218,716,104400,54151
3166,2322,844,712,117700,54153
2391,1640,751,609,149100,54154
2924,1970,954,699,257900,54155
726,536,190,654,107200,54156
2660,1841,819,672,155300,54157
563,508,55,747,144100,54159
101,82,19,638,143300,54160
1142,947,195,641,152400,54161
3471,2707,764,699,211800,54162
3078,2193,885,689,187600,54165
7149,5109,2040,673,126400,54166
1071,1035,36,1013,264900,54169
1351,1174,177,669,189400,54170
1379,1305,74,781,227500,54171
1667,1408,259,1084,268800,54173
1399,1178,221,688,123100,54174
555,527,28,906,200400,54175
1315,1079,236,610,144600,54177
1231,913,318,985,190500,54180
2092,1638,454,738,139500,54201
806,663,143,1066,312300,54202
708,619,89,806,200400,54204
812,746,66,658,170500,54205
67,53,14,-,145300,54207
2366,2007,359,754,198800,54208
680,598,82,860,335200,54209
350,298,52,733,288300,54210
126,119,7,-,384300,54211
430,383,47,859,347900,54212
561,503,58,597,147500,54213
152,93,59,682,139200,54214
2662,2055,607,661,150400,54216
2890,2380,510,791,210400,54217
16988,11987,5001,674,121500,54220
608,549,59,725,199000,54227
1163,981,182,694,151100,54228
2169,1689,480,967,214600,54229
1819,1589,230,522,164400,54230
449,368,81,626,124600,54232
909,661,248,831,343600,54234
8231,6287,1944,792,181800,54235
6449,4833,1616,682,103600,54241
845,708,137,735,164800,54245
406,354,52,730,267700,54246
1049,897,152,656,174300,54247
9448,6410,3038,789,157400,54301
12789,6379,6410,739,121500,54302
11726,5248,6478,724,122000,54303
12287,7526,4761,775,139100,54304
0,0,0,-,-,54307
13807,9166,4641,905,208000,54311
15602,12953,2649,884,231000,54313
13432,8462,4970,800,149000,54401
10091,6393,3698,762,144000,54403
1002,707,295,752,114600,54405
1484,1241,243,714,221900,54406
555,501,54,837,217500,54407
456,359,97,505,143700,54408
5716,4245,1471,655,91000,54409
927,847,80,563,160900,54410
1949,1726,223,632,159700,54411
850,724,126,606,163000,54412
70,62,8,525,115800,54413
1308,1094,214,663,144600,54414
643,491,152,557,116100,54416
11,11,0,-,75000,54417
383,345,38,705,140300,54418
462,377,85,567,146700,54420
1445,1068,377,698,133000,54421
405,283,122,584,126800,54422
911,856,55,688,259500,54423
712,672,40,708,171100,54424
771,585,186,713,124900,54425
1689,1437,252,711,160800,54426
537,420,117,677,147600,54427
466,378,88,519,155200,54428
59,52,7,-,115000,54430
759,632,127,648,155900,54433
822,741,81,750,149400,54435
836,688,148,659,122400,54436
1137,878,259,618,128800,54437
1153,1013,140,729,162300,54440
371,341,30,706,184100,54441
465,403,62,858,169400,54442
836,733,103,682,205100,54443
1110,872,238,653,130100,54446
219,166,53,645,106300,54447
1711,1461,250,688,189100,54448
11701,7905,3796,693,158600,54449
141,112,29,730,68800,54450
4910,3653,1257,673,151000,54451
8608,6510,2098,640,131000,54452
559,496,63,613,153900,54454
7227,5983,1244,801,181400,54455
2493,1952,541,587,123800,54456
3504,3098,406,747,143900,54457
42,37,5,-,114100,54458
544,487,57,814,111800,54459
986,799,187,666,107900,54460
200,179,21,833,154300,54462
290,243,47,681,207700,54463
273,266,7,558,174200,54465
1186,993,193,658,139000,54466
5566,3528,2038,840,188800,54467
746,607,139,681,101200,54469
901,717,184,578,124600,54470
677,662,15,-,211100,54471
1049,923,126,664,187400,54473
1777,1171,606,819,135100,54474
671,630,41,642,153000,54475
8001,4638,3363,823,161200,54476
1433,1151,282,538,142800,54479
538,415,123,792,129000,54480
11374,6492,4882,742,153200,54481
4739,3550,1189,930,192400,54482
2272,1943,329,816,201100,54484
131,127,4,-,168800,54485
878,731,147,689,117800,54486
4225,3564,661,702,172500,54487
494,386,108,696,121400,54488
726,592,134,744,135400,54489
393,329,64,538,158200,54490
737,586,151,558,128000,54491
310,284,26,625,164200,54493
11949,8746,3203,789,130600,54494
3471,1901,1570,711,95000,54495
859,691,168,773,112300,54498
1267,904,363,619,142000,54499
8716,7053,1663,749,148900,54501
565,477,88,672,119000,54511
471,415,56,600,233000,54512
234,216,18,688,143800,54513
896,773,123,700,136700,54514
255,236,19,660,87000,54515
60,60,0,-,245000,54517
627,552,75,675,211200,54519
1781,1277,504,479,125300,54520
3894,3152,742,745,191500,54521
306,231,75,750,138400,54524
136,92,44,600,72500,54525
376,320,56,675,89000,54526
436,379,57,596,94800,54527
478,448,30,760,209200,54529
317,282,35,575,83300,54530
555,527,28,856,236000,54531
1147,831,316,506,83400,54534
89,75,14,475,41900,54536
208,194,14,588,110500,54537
1446,835,611,530,179600,54538
587,549,38,778,198000,54539
448,361,87,720,225000,54540
521,397,124,633,135300,54541
239,223,16,-,116500,54542
475,360,115,948,483300,54545
513,415,98,549,84500,54546
728,607,121,664,260300,54547
2244,1790,454,872,250500,54548
268,216,52,493,83500,54550
2117,1666,451,568,109800,54552
596,478,118,573,200000,54554
2400,1788,612,741,139900,54555
571,453,118,693,92800,54556
449,434,15,675,313800,54557
1063,831,232,749,176100,54558
306,241,65,415,125500,54559
280,229,51,821,150900,54560
0,0,0,-,-,54561
859,732,127,798,265200,54562
317,277,40,775,144000,54563
151,138,13,675,154500,54564
19,14,5,-,90000,54565
577,471,106,558,140700,54566
2354,1852,502,720,191000,54568
20418,11312,9106,863,168600,54601
6475,3197,3278,763,138000,54603
686,515,171,779,160500,54610
496,394,102,781,110300,54611
1943,1219,724,791,164400,54612
921,738,183,678,138600,54613
1083,842,241,827,171400,54614
4166,2956,1210,695,137200,54615
994,730,264,717,119500,54616
822,673,149,886,145900,54618
1186,1021,165,704,171600,54619
482,375,107,943,181500,54621
902,797,105,736,159300,54622
863,715,148,821,179000,54623
691,610,81,731,150500,54624
122,92,30,555,98200,54625
531,449,82,632,168200,54626
773,644,129,654,161100,54627
423,392,31,500,166200,54628
1131,870,261,822,175700,54629
1729,1340,389,780,180900,54630
718,566,152,703,132500,54631
463,419,44,602,184900,54632
1618,1242,376,693,148600,54634
749,605,144,846,148800,54635
5353,4078,1275,919,221700,54636
96,66,30,588,97700,54637
594,499,95,589,168100,54638
1054,799,255,611,148600,54639
0,0,0,-,-,54641
801,675,126,827,160900,54642
2,2,0,-,-,54643
534,435,99,775,236200,54644
32,21,11,575,68800,54645
1659,1338,321,801,125500,54646
630,501,129,652,145100,54648
10575,7289,3286,883,211900,54650
584,466,118,600,145000,54651
345,289,56,667,120700,54652
334,249,85,872,168300,54653
80,67,13,-,86500,54654
652,474,178,645,162800,54655
7113,5120,1993,809,158700,54656
140,102,38,643,125000,54657
1088,879,209,908,196100,54658
526,405,121,658,159200,54659
6583,4084,2499,847,151300,54660
1632,1234,398,915,189500,54661
716,592,124,683,107900,54664
3617,2432,1185,703,170100,54665
1199,946,253,835,159100,54666
1897,1577,320,811,153700,54667
2939,2283,656,902,209100,54669
516,440,76,690,168200,54670
16478,9521,6957,816,196700,54701
17611,11509,6102,854,165500,54703
3402,2241,1161,792,187200,54720
559,438,121,771,141100,54721
1432,1121,311,703,171500,54722
460,374,86,781,153800,54723
2805,2116,689,638,165600,54724
1258,1075,183,744,151000,54725
705,542,163,929,131100,54726
1932,1562,370,663,160700,54727
2573,2191,382,727,165600,54728
13815,9339,4476,881,199500,54729
1977,1648,329,706,174300,54730
345,297,48,696,114400,54731
1335,1047,288,629,133700,54732
464,378,86,783,156300,54733
300,269,31,1208,163800,54734
1802,1393,409,573,142200,54736
236,200,36,862,185700,54737
1266,993,273,818,216000,54738
1941,1479,462,859,187400,54739
832,654,178,691,174400,54740
672,555,117,669,117300,54741
1940,1653,287,728,196400,54742
1020,889,131,762,181400,54745
284,227,57,740,101700,54746
981,637,344,789,149900,54747
650,594,56,833,205600,54748
595,414,181,719,170100,54749
370,318,52,775,221000,54750
9644,5468,4176,828,179400,54751
784,616,168,657,131100,54754
3017,2243,774,773,168100,54755
420,325,95,664,182300,54756
1402,1227,175,773,179900,54757
1974,1549,425,725,160000,54758
652,528,124,743,149400,54759
104,42,62,650,155400,54760
484,318,166,685,156100,54761
512,424,88,673,129400,54762
500,403,97,576,126400,54763
7,7,0,-,-,54765
713,591,122,719,150100,54766
1364,1155,209,900,178900,54767
1762,1302,460,778,150000,54768
248,232,16,706,234600,54769
839,679,160,721,181600,54770
1512,1208,304,664,137900,54771
423,320,103,754,156100,54772
1353,992,361,666,148200,54773
3109,2316,793,706,158600,54801
646,464,182,674,109700,54805
4659,3109,1550,653,128300,54806
1112,918,194,825,195900,54810
1990,1338,652,619,131800,54812
260,236,24,767,169400,54813
1265,832,433,531,162500,54814
952,842,110,522,214600,54817
1064,869,195,525,106900,54819
399,328,71,786,163600,54820
576,522,54,550,200000,54821
1941,1536,405,839,164700,54822
1018,780,238,708,146400,54824
308,290,18,658,179200,54826
186,184,2,-,182400,54827
446,351,95,385,85900,54828
2266,1839,427,722,170700,54829
1461,1324,137,680,181000,54830
169,102,67,391,145800,54832
456,366,90,625,121900,54835
421,415,6,-,168800,54836
1669,1328,341,689,156400,54837
476,417,59,863,173700,54838
138,114,24,867,150000,54839
1984,1608,376,768,138200,54840
122,109,13,488,99800,54841
83,74,9,-,165700,54842
5309,3784,1525,604,190600,54843
118,107,11,-,172300,54844
36,36,0,-,150000,54845
261,224,37,1322,135300,54846
1142,895,247,850,199200,54847
2623,1817,806,675,101500,54848
830,727,103,783,207800,54849
110,93,17,625,235500,54850
1803,1417,386,665,158500,54853
362,336,26,910,175000,54854
285,267,18,675,146900,54855
696,616,80,843,150700,54856
69,61,8,-,103200,54857
755,500,255,591,137200,54858
919,742,177,781,172900,54859
44,7,37,316,-,54861
157,151,6,-,148300,54862
549,472,77,950,174200,54864
256,226,30,425,154200,54865
235,133,102,726,88600,54867
6727,4728,1999,758,165200,54868
742,672,70,969,227800,54870
1254,1010,244,734,154900,54871
1251,952,299,804,155400,54872
1414,1207,207,639,171400,54873
1469,1360,109,983,159500,54874
571,492,79,775,142900,54875
782,578,204,577,213300,54876
13289,7932,5357,784,135400,54880
565,516,49,617,184600,54888
1096,808,288,719,167600,54889
1409,1139,270,774,168200,54891
1824,1465,359,747,168300,54893
404,349,55,750,147700,54895
730,632,98,810,156300,54896
13449,7076,6373,804,131000,54901
9932,6377,3555,711,125400,54902
9718,7768,1950,831,207700,54904
891,758,133,733,139600,54909
10245,6065,4180,829,152200,54911
8788,6213,2575,933,278400,54913
13296,8309,4987,773,155400,54914
17578,12696,4882,765,181300,54915
488,435,53,681,158400,54921
510,429,81,798,131300,54922
3612,2710,902,812,139000,54923
206,148,58,720,232300,54927
170,146,24,1641,161700,54928
3878,2844,1034,712,137800,54929
734,618,116,596,134100,54930
130,130,0,-,154600,54931
442,421,21,1284,209700,54932
148,83,65,730,102600,54933
95,73,22,1097,118500,54934
17196,10144,7052,749,133000,54935
8086,6103,1983,888,185000,54937
1753,1557,196,830,228000,54940
1130,877,253,703,225400,54941
3621,3264,357,1035,260100,54942
853,731,122,599,147800,54943
3337,3049,288,720,221700,54944
1566,1242,324,641,165000,54945
0,0,0,-,-,54946
937,862,75,903,222700,54947
100,89,11,-,115600,54948
1412,1114,298,711,150800,54949
1200,974,226,632,112500,54950
11982,7881,4101,765,147000,54952
18502,12465,6037,818,171700,54956
1188,1033,155,673,161500,54960
5858,4134,1724,819,165500,54961
485,406,79,707,166100,54962
2959,2341,618,887,167400,54963
400,373,27,988,236300,54964
573,546,27,810,157100,54965
791,638,153,658,122200,54966
202,138,64,483,115100,54967
1293,1011,282,620,123100,54968
1339,1062,277,614,104600,54970
4369,2939,1430,746,141100,54971
597,526,71,571,172400,54974
616,540,76,783,194300,54977
602,545,57,575,210700,54979
72,62,10,-,141300,54980
6826,4815,2011,669,154900,54981
2982,2295,687,690,150400,54982
1843,1461,382,745,153200,54983
1413,1065,348,727,165600,54984
0,0,0,-,-,54985
2298,1881,417,727,218300,54986
1185,1129,56,1813,552300,55001
965,701,264,1327,279000,55003
1702,1586,116,1110,236500,55005
1496,1191,305,912,157400,55006
911,832,79,847,166000,55007
5984,4767,1217,1047,201900,55008
3402,2639,763,868,264700,55009
3799,3706,93,1510,279400,55011
741,656,85,950,244600,55012
2696,2162,534,1026,290800,55013
10250,8885,1365,1328,252800,55014
12117,10782,1335,1454,260200,55016
332,309,23,1800,225000,55017
359,333,26,1339,257000,55018
823,784,39,1216,239200,55019
1437,1418,19,-,378900,55020
11249,8057,3192,916,205900,55021
12479,10954,1525,1305,274900,55024
9943,7532,2411,1100,287700,55025
153,142,11,-,292100,55026
1072,879,193,891,233700,55027
20,20,0,-,95000,55029
503,442,61,918,169700,55030
682,620,62,980,300000,55031
1389,1322,67,1297,266600,55032
11678,8970,2708,981,260400,55033
27,20,7,1125,65000,55036
1980,1492,488,816,149100,55037
8280,7306,974,1446,281700,55038
4985,4288,697,1057,216800,55040
3236,2471,765,888,211600,55041
3478,3244,234,1209,446300,55042
1533,1348,185,1236,282500,55043
19519,16988,2531,1426,355900,55044
2716,2400,316,980,266000,55045
1976,1666,310,1214,244800,55046
996,910,86,2129,430600,55047
904,784,120,675,166600,55049
3897,3064,833,678,167500,55051
857,765,92,786,208600,55052
390,356,34,1286,237800,55053
780,649,131,899,324100,55054
1505,1020,485,886,227900,55055
5196,4587,609,898,224000,55056
7890,5600,2290,817,267700,55057
11881,8868,3013,817,177900,55060
3777,2962,815,625,186800,55063
492,439,53,1338,295700,55065
8088,5775,2313,882,187800,55066
10631,9086,1545,1463,275900,55068
1882,1491,391,823,189300,55069
2832,2508,324,1052,237000,55070
2259,1745,514,894,208000,55071
1393,1066,327,909,134100,55072
1245,1028,217,792,386500,55073
815,744,71,1027,216900,55074
8258,5513,2745,898,207200,55075
9316,6889,2427,1263,244400,55076
5160,3108,2052,1191,406000,55077
3268,3050,218,1262,255900,55079
1009,952,57,1185,258600,55080
13960,10914,3046,1214,359200,55082
701,558,143,771,220600,55084
184,162,22,900,240000,55085
151,140,11,515,155300,55087
563,518,45,1333,423700,55088
621,560,61,1067,289600,55089
132,104,28,1375,197200,55090
4017,3668,349,984,254100,55092
4546,1097,3449,1340,212200,55101
9832,4421,5411,1044,221500,55102
4969,1972,2997,859,179500,55103
17583,9427,8156,910,229100,55104
10601,7051,3550,1058,374000,55105
17800,9728,8072,1011,169100,55106
5347,2894,2453,923,191100,55107
6416,3379,3037,1175,289800,55108
12409,8085,4324,1092,227000,55109
16301,12344,3957,1226,266500,55110
64,0,64,750,-,55111
16888,11474,5414,1062,256600,55112
17861,11806,6055,1103,264600,55113
1664,468,1196,1324,248700,55114
3539,2931,608,1427,361000,55115
11707,5554,6153,1070,332600,55116
15985,9146,6839,990,205200,55117
12292,8104,4188,1069,263700,55118
15158,9680,5478,1052,198700,55119
1982,1384,598,883,369000,55120
3687,1762,1925,1271,256900,55121
13337,9216,4121,1210,267700,55122
9801,7873,1928,1331,346200,55123
20607,16020,4587,1396,270700,55124
16653,13201,3452,1439,310800,55125
11492,9721,1771,1235,284900,55126
7823,6538,1285,1401,295800,55127
11518,8939,2579,1096,230000,55128
9316,7917,1399,1744,411100,55129
5622,2222,3400,926,163200,55130
70,44,26,806,231800,55150
0,0,0,-,-,55155
4881,3959,922,1290,255800,55301
3004,2520,484,818,248000,55302
18341,13791,4550,1150,256100,55303
16809,15689,1120,1466,312800,55304
10049,5847,4202,1462,347400,55305
5969,4065,1904,1278,288000,55306
1316,919,397,699,187300,55307
3270,3030,240,792,236400,55308
6518,5863,655,1119,252200,55309
588,516,72,625,100000,55310
14360,12793,1567,1599,365100,55311
537,470,67,656,168100,55312
9355,7322,2033,1062,236800,55313
448,366,82,614,132300,55314
1922,1762,160,-,329800,55315
9099,8085,1014,1307,254200,55316
8002,6911,1091,1467,379200,55317
11052,7874,3178,1157,303300,55318
1990,1873,117,1057,275500,55319
2071,1793,278,846,240700,55320
1789,1387,402,753,208200,55321
1363,1225,138,1125,322000,55322
437,408,29,669,269600,55324
1686,1445,241,793,233900,55325
1565,1515,50,1189,350500,55327
3382,2828,554,815,295700,55328
802,667,135,732,168400,55329
13355,11225,2130,1048,255400,55330
7501,6549,952,1066,590400,55331
743,622,121,530,109300,55332
322,240,82,586,94000,55333
1168,839,329,759,155300,55334
667,575,92,725,94800,55335
2982,2317,665,835,180300,55336
17923,12224,5699,1306,256500,55337
411,396,15,943,178300,55338
376,323,53,679,221200,55339
2984,2791,193,1623,487700,55340
1086,973,113,-,308700,55341
751,610,141,873,100600,55342
12213,5379,6834,1139,268400,55343
6729,2536,4193,1411,291300,55344
8785,7202,1583,1354,377700,55345
6381,5526,855,1574,357500,55346
11496,10489,1007,1607,413700,55347
1567,1246,321,802,214800,55349
7897,5683,2214,727,170800,55350
3201,2697,504,1211,300900,55352
1231,1110,121,646,243600,55353
1003,906,97,584,189200,55354
4105,3129,976,727,167200,55355
2260,1969,291,1252,681000,55356
1187,1030,157,692,431200,55357
1945,1607,338,785,231700,55358
2264,1907,357,940,410600,55359
1025,959,66,961,260500,55360
6947,5485,1462,1100,237500,55362
1787,1467,320,1056,213700,55363
6542,5219,1323,838,330000,55364
220,127,93,598,106100,55366
350,300,50,796,233300,55367
793,581,212,790,215200,55368
15579,12373,3206,1525,266500,55369
241,219,22,1094,218300,55370
6356,5175,1181,768,209200,55371
12177,10781,1396,1174,354000,55372
2093,1712,381,1054,222900,55373
5354,4620,734,1274,354300,55374
1336,1246,90,1319,314500,55375
6075,5448,627,1014,285900,55376
10886,9267,1619,1370,330100,55378
15332,11426,3906,1230,280400,55379
813,707,106,625,180800,55381
1329,1214,115,1033,247900,55382
1265,277,988,1097,482300,55384
491,409,82,702,142800,55385
2840,2618,222,1211,447000,55386
4961,4004,957,1059,329100,55387
2106,1775,331,803,256100,55388
971,847,124,558,187500,55389
959,857,102,1017,238000,55390
6594,5259,1335,1350,575300,55391
1128,869,259,642,159300,55395
955,744,211,705,147100,55396
1034,868,166,913,239600,55397
5705,5118,587,1188,235600,55398
7154,2451,4703,1780,319600,55401
339,0,339,1567,-,55402
11419,2306,9113,976,256900,55403
12235,1806,10429,900,250400,55404
7679,2962,4717,987,356400,55405
15661,10675,4986,1030,251600,55406
15106,8940,6166,1022,238300,55407
15710,3595,12115,1127,287000,55408
4811,3134,1677,1134,294700,55409
8083,6542,1541,1196,450700,55410
9581,4644,4937,962,167200,55411
8600,5739,2861,1174,175600,55412
6893,2647,4246,1135,283300,55413
12318,1975,10343,1183,369800,55414
2204,594,1610,1786,468900,55415
16887,8517,8370,1374,379100,55416
10657,8700,1957,1053,280900,55417
13553,8643,4910,972,256000,55418
11095,8566,2529,1212,376200,55419
8358,5441,2917,1088,231200,55420
12166,7090,5076,1045,196500,55421
12602,8465,4137,1093,238100,55422
15350,9599,5751,1150,241200,55423
3672,3429,243,1348,741400,55424
3912,1757,2155,1158,230600,55425
12030,7675,4355,1217,263600,55426
10163,7251,2912,1152,257700,55427
12645,7000,5645,1092,213200,55428
10026,5490,4536,1083,190600,55429
7621,4681,2940,1136,172600,55430
7892,5539,2353,1371,274000,55431
11758,7722,4036,1051,209000,55432
13675,9245,4430,1149,204300,55433
11282,9545,1737,1243,208200,55434
7356,3037,4319,1471,315900,55435
5809,4365,1444,1383,477100,55436
7871,5489,2382,1269,283800,55437
7031,5530,1501,1391,324100,55438
3506,3120,386,1240,556100,55439
7908,4698,3210,1248,345600,55441
5334,4152,1182,1559,352000,55442
11137,8252,2885,1191,259800,55443
5087,4515,572,1031,226000,55444
4169,3311,858,1779,239900,55445
9752,7826,1926,1553,430200,55446
8691,6353,2338,1451,359800,55447
10452,8798,1654,1426,231400,55448
10091,8985,1106,1626,318400,55449
7,7,0,-,-,55450
3473,411,3062,509,137100,55454
0,0,0,-,-,55455
61,55,6,-,228100,55601
149,146,3,-,151900,55602
257,201,56,652,136900,55603
1624,1298,326,800,256300,55604
346,199,147,704,122700,55605
136,136,0,-,356900,55606
90,87,3,-,186500,55607
91,91,0,-,569400,55609
244,171,73,-,282000,55612
116,106,10,-,259100,55613
1124,997,127,815,116300,55614
142,102,40,1167,225000,55615
3332,2727,605,669,185100,55616
218,189,29,1271,222900,55702
329,301,28,1023,138700,55703
459,382,77,403,170800,55704
1524,1256,268,437,86200,55705
846,676,170,655,77700,55706
1443,1252,191,742,179400,55707
317,263,54,643,80200,55708
1693,1580,113,792,170500,55709
557,511,46,-,145300,55710
191,152,39,838,167200,55711
294,269,25,933,142400,55712
532,391,141,864,100200,55713
141,109,32,788,67400,55716
169,165,4,-,266300,55717
1313,1073,240,748,201600,55718
2603,1947,656,607,102300,55719
6932,5085,1847,878,165200,55720
1381,1259,122,816,203600,55721
451,296,155,725,111800,55722
831,698,133,809,160400,55723
366,337,29,792,161800,55724
51,48,3,-,262500,55725
407,308,99,928,171500,55726
3014,2185,829,505,185800,55731
634,588,46,775,124400,55732
1999,1890,109,1181,256500,55733
2721,1999,722,707,135300,55734
727,692,35,577,169100,55735
642,554,88,575,124200,55736
221,210,11,-,114700,55738
1565,1352,213,539,130200,55741
129,119,10,-,176000,55742
8772,6746,2026,747,171500,55744
7517,5622,1895,583,115500,55746
647,500,147,669,152300,55748
202,173,29,1188,190300,55749
896,843,53,588,67700,55750
731,690,41,700,140700,55751
195,185,10,-,139800,55752
541,465,76,650,61400,55753
134,119,15,725,165200,55756
317,278,39,825,170000,55757
80,76,4,-,67500,55758
1414,1144,270,775,186100,55760
311,271,40,464,134200,55763
266,174,92,612,73200,55764
361,315,46,593,127400,55765
7,7,0,-,-,55766
1054,820,234,763,175000,55767
1285,892,393,606,166000,55768
1133,950,183,770,124800,55769
709,597,112,688,116000,55771
21,8,13,725,"10,000-",55772
604,588,16,711,170700,55775
1469,1299,170,1538,229700,55779
68,61,7,-,197900,55780
311,301,10,-,297200,55781
253,217,36,472,72900,55782
980,922,58,950,194500,55783
56,48,8,-,150000,55784
114,113,1,-,165900,55785
156,127,29,642,85200,55786
277,252,25,778,192900,55787
837,742,95,613,270000,55790
4757,2822,1935,639,99000,55792
324,280,44,625,143000,55793
626,518,108,788,174100,55795
694,632,62,950,200500,55797
242,206,36,545,173300,55798
1313,458,855,565,391700,55802
7624,6203,1421,1131,243000,55803
6115,5399,716,1077,225300,55804
4879,1451,3428,786,124300,55805
4295,1776,2519,772,122300,55806
4246,2987,1259,743,132100,55807
2483,1826,657,783,118500,55808
3495,3153,342,642,164400,55810
10824,7642,3182,1059,219100,55811
3569,1556,2013,887,220700,55812
0,0,0,-,-,55814
23207,15253,7954,1087,217200,55901
11027,7736,3291,1271,327600,55902
10572,7307,3265,920,181100,55904
0,0,0,-,-,55905
8165,6509,1656,870,262800,55906
585,513,72,554,153000,55909
529,454,75,744,205300,55910
11412,7772,3640,812,124200,55912
1444,1245,199,716,152900,55917
397,348,49,622,122800,55918
451,423,28,583,158700,55919
2879,2533,346,1088,263500,55920
2122,1731,391,670,140500,55921
396,318,78,498,100800,55922
1759,1430,329,763,209700,55923
519,464,55,772,148500,55924
417,387,30,625,209100,55925
318,229,89,525,164800,55926
1640,1347,293,741,169100,55927
447,385,62,688,200400,55929
161,131,30,-,121200,55931
791,613,178,623,209800,55932
115,108,7,925,173300,55933
1427,1115,312,709,242700,55934
378,342,36,643,181300,55935
747,600,147,665,156600,55936
774,611,163,725,153800,55939
1136,795,341,738,169700,55940
435,311,124,772,173700,55941
1280,1035,245,664,181900,55943
2740,2438,302,680,200900,55944
549,489,60,734,173800,55945
1343,1082,261,833,171400,55946
3168,2647,521,855,212200,55947
770,635,135,498,180500,55949
84,76,8,-,70000,55950
620,469,151,742,119100,55951
907,731,176,725,178600,55952
349,279,70,650,138300,55953
555,478,77,731,104900,55954
943,885,58,681,319300,55955
873,724,149,852,236500,55956
298,247,51,675,201000,55957
935,726,209,715,177200,55959
1148,1094,54,1328,308000,55960
175,154,21,825,119000,55961
347,284,63,682,179000,55962
2096,1587,509,816,254900,55963
1768,1423,345,620,172800,55964
1027,780,247,496,163800,55965
383,351,32,970,222500,55967
61,50,11,1075,253600,55968
417,371,46,950,190200,55969
435,367,68,726,145600,55970
1134,931,203,734,171200,55971
1864,1543,321,686,231100,55972
92,83,9,1500,205400,55973
987,736,251,800,136600,55974
1844,1531,313,711,153400,55975
3046,2564,482,880,209000,55976
73,56,17,-,155600,55977
370,257,113,1092,186000,55979
1755,1349,406,588,187000,55981
176,162,14,838,153600,55982
679,564,115,586,193600,55983
689,575,114,973,172200,55985
13683,9261,4422,682,163100,55987
403,326,77,768,126800,55990
595,510,85,782,253700,55991
2330,1703,627,679,214700,55992
19126,10472,8654,927,201400,56001
6167,4582,1585,834,217100,56003
8967,6542,2425,729,117800,56007
596,499,97,740,124800,56009
509,406,103,655,131700,56010
3206,2895,311,1179,255000,56011
1984,1364,620,638,110600,56013
295,237,58,531,79300,56014
373,340,33,792,139400,56016
707,598,109,773,212300,56017
340,286,54,536,110600,56019
49,48,1,-,65000,56020
428,350,78,688,213100,56021
23,23,0,-,53000,56022
248,198,50,570,99200,56023
1255,834,421,1267,207500,56024
176,164,12,-,131900,56025
880,735,145,772,189000,56026
320,255,65,579,52000,56027
498,424,74,950,284400,56028
320,290,30,592,97300,56029
5295,3638,1657,640,149500,56031
139,124,15,765,72200,56032
151,130,21,511,68800,56033
187,160,27,938,144100,56034
215,178,37,554,150000,56035
798,670,128,633,121900,56036
681,576,105,655,201700,56037
315,272,43,713,131300,56039
427,341,86,575,152500,56041
338,275,63,638,153800,56042
191,165,26,-,136900,56043
805,715,90,930,217300,56044
404,377,27,566,113200,56045
38,30,8,-,80000,56046
45,41,4,-,92500,56047
1646,1423,223,810,173000,56048
530,431,99,588,222400,56050
296,249,47,944,59300,56051
263,234,29,1042,263300,56052
378,342,36,692,119100,56054
1654,1304,350,812,176400,56055
37,33,4,-,60600,56056
1562,1211,351,742,174000,56057
2433,1741,692,689,179200,56058
178,147,31,455,51200,56060
1279,908,371,610,139000,56062
1150,969,181,756,320800,56063
1034,831,203,689,171300,56065
383,311,72,608,135200,56068
1822,1508,314,885,203300,56069
4539,3883,656,973,291700,56071
887,700,187,643,146700,56072
6953,5251,1702,776,156300,56073
697,550,147,875,205300,56074
76,65,11,625,79000,56075
177,147,30,950,159400,56078
266,224,42,614,158500,56080
2433,1822,611,626,98300,56081
4920,3396,1524,911,192800,56082
354,314,40,707,92900,56083
2211,1863,348,610,139400,56085
1315,994,321,663,113900,56087
794,603,191,613,106500,56088
87,64,23,588,33800,56089
268,216,52,842,125000,56090
131,120,11,813,107400,56091
4974,3809,1165,797,161900,56093
1234,952,282,767,185500,56096
1631,1343,288,600,93800,56097
840,643,197,680,97900,56098
2562,1931,631,667,124800,56101
707,579,128,725,156600,56110
185,166,19,675,90000,56111
90,82,8,-,78900,56113
155,132,23,1045,151700,56114
529,433,96,708,165100,56115
279,222,57,725,197200,56116
125,87,38,1335,102700,56117
187,183,4,-,166800,56118
355,321,34,667,151100,56119
410,381,29,692,69900,56120
312,253,59,1016,93000,56121
251,188,63,725,100000,56122
200,178,22,758,95000,56123
27,27,0,-,39400,56125
220,137,83,785,97000,56127
773,650,123,782,141300,56128
326,268,58,652,83500,56129
920,778,142,768,122700,56131
226,202,24,740,181300,56132
181,143,38,600,112500,56134
532,396,136,651,108300,56136
462,373,89,575,98900,56137
413,314,99,789,151900,56138
154,142,12,594,125000,56139
26,23,3,-,55000,56140
126,107,19,529,86500,56141
425,349,76,804,69800,56142
2022,1616,406,718,129500,56143
465,358,107,875,80000,56144
252,226,26,550,69500,56145
29,24,5,-,100000,56146
90,76,14,-,95000,56147
514,394,120,592,126200,56149
1143,932,211,771,106500,56150
327,301,26,644,121700,56151
551,455,96,594,103300,56152
94,84,10,-,62300,56153
217,180,37,573,74200,56155
2503,1842,661,702,161900,56156
303,238,65,843,158300,56157
156,126,30,655,106300,56158
1065,775,290,551,92600,56159
105,85,20,609,81000,56160
135,122,13,875,109300,56161
102,99,3,-,75000,56162
2481,1804,677,542,103900,56164
134,119,15,445,146900,56165
95,87,8,575,124200,56166
325,267,58,518,103500,56167
336,297,39,763,163200,56168
293,258,35,720,113000,56169
252,221,31,775,88700,56170
753,606,147,622,116800,56171
1392,1036,356,496,153500,56172
162,95,67,700,106300,56173
144,117,27,650,66300,56174
1174,977,197,621,98500,56175
440,375,65,595,89400,56176
20,20,0,-,74000,56177
712,546,166,613,113700,56178
451,350,101,496,84800,56180
506,429,77,560,90200,56181
705,496,209,499,77400,56183
211,193,18,586,118800,56185
177,141,36,516,152600,56186
5087,3314,1773,781,139700,56187
8944,5657,3287,730,154800,56201
99,86,13,739,140600,56207
978,732,246,491,69900,56208
919,762,157,760,168300,56209
3,3,0,-,-,56210
198,167,31,-,87200,56211
222,188,34,447,59200,56212
289,235,54,708,85000,56214
1979,1308,671,731,126300,56215
338,289,49,1057,116000,56216
202,190,12,775,110600,56218
463,338,125,729,123200,56219
1199,1053,146,469,114300,56220
307,237,70,625,107200,56221
835,610,225,927,133100,56222
573,456,117,664,85200,56223
133,110,23,715,95700,56224
309,236,73,638,100900,56225
91,81,10,-,176000,56226
102,92,10,-,187500,56227
418,348,70,675,92200,56228
750,591,159,650,166800,56229
304,228,76,828,110300,56230
158,148,10,938,156800,56231
973,777,196,496,122100,56232
225,188,37,872,99600,56235
129,116,13,-,100000,56236
231,192,39,525,100000,56237
252,220,32,763,147900,56239
362,252,110,639,100000,56240
1623,1121,502,661,142100,56241
709,525,184,687,134400,56243
541,425,116,761,132200,56244
276,227,49,622,165300,56245
431,349,82,484,111900,56248
133,114,19,650,66700,56249
343,301,42,720,163400,56251
501,345,156,671,146900,56252
425,381,44,750,184200,56253
164,114,50,536,116700,56255
1196,947,249,643,91900,56256
238,211,27,-,51800,56257
6061,3632,2429,686,165700,56258
402,308,94,594,114100,56260
305,240,65,494,93300,56262
193,174,19,455,121700,56263
856,689,167,703,136300,56264
3183,2123,1060,650,116400,56265
573,471,102,844,107200,56266
2630,1705,925,737,179500,56267
426,383,43,669,80700,56270
504,367,137,821,145500,56271
1997,1690,307,782,247400,56273
91,91,0,-,151800,56274
89,72,17,-,-,56276
1290,795,495,644,146000,56277
1327,869,458,586,115900,56278
501,450,51,655,186300,56279
215,185,30,-,170500,56280
263,222,41,763,153600,56281
616,454,162,825,152100,56282
2652,1880,772,721,144600,56283
777,623,154,592,99000,56284
480,384,96,643,102800,56285
29,27,2,-,54200,56287
2018,1804,214,690,291500,56288
307,277,30,725,250600,56289
169,154,15,617,137500,56291
208,183,25,500,106300,56292
514,414,100,594,132700,56293
50,30,20,-,62900,56294
112,90,22,604,71100,56295
997,799,198,520,83800,56296
309,275,34,561,97200,56297
12181,6381,5800,877,196700,56301
10651,6671,3980,813,149700,56303
7129,3108,4021,785,167900,56304
1883,1596,287,554,223300,56307
11427,7811,3616,721,235600,56308
575,467,108,782,234400,56309
2101,1814,287,916,226300,56310
301,245,56,830,154000,56311
969,767,202,718,167500,56312
34,25,9,1125,83800,56313
468,426,42,786,213200,56314
704,596,108,623,174300,56315
605,503,102,713,161300,56316
428,384,44,800,184500,56318
553,509,44,788,228300,56319
3215,2836,379,884,242600,56320
0,0,0,-,-,56321
260,215,45,600,120800,56323
459,424,35,775,187200,56324
80,76,4,-,134300,56325
705,588,117,555,174000,56326
342,327,15,846,308100,56327
66,58,8,770,99200,56328
2615,2177,438,796,196700,56329
670,608,62,815,196700,56330
814,737,77,817,214000,56331
687,651,36,750,247600,56332
2567,1949,618,674,214900,56334
83,82,1,-,122200,56335
660,599,61,382,236100,56336
653,599,54,888,206900,56338
403,316,87,555,155100,56339
953,812,141,683,228300,56340
1282,1110,172,627,180500,56342
427,396,31,667,175800,56343
6193,4516,1677,701,172100,56345
2817,2199,618,760,141400,56347
309,266,43,658,182500,56349
254,219,35,864,125700,56350
2436,1951,485,926,174900,56352
3515,2746,769,771,169100,56353
540,491,49,725,238300,56354
219,188,31,942,206300,56355
109,108,1,-,119300,56356
417,394,23,908,218100,56357
1283,1119,164,908,174900,56358
1395,976,419,732,159400,56359
1808,1422,386,608,195700,56360
969,830,139,542,159500,56361
2231,1821,410,758,186200,56362
72,55,17,825,152900,56363
2143,1827,316,766,178000,56364
2515,2286,229,676,210900,56367
1696,1547,149,715,248700,56368
245,90,155,688,160300,56369
38,22,16,1000,100000,56371
1215,972,243,742,204900,56373
3537,2921,616,848,195100,56374
330,310,20,663,181000,56375
141,128,13,450,153200,56376
7579,4745,2834,998,216700,56377
3177,2318,859,773,188400,56378
7015,4644,2371,808,194100,56379
1027,853,174,710,162600,56381
557,494,63,569,207500,56382
171,98,73,758,124100,56384
422,365,57,-,152600,56385
368,307,61,713,232900,56386
3321,1320,2001,877,170100,56387
33,30,3,-,105600,56389
12662,9025,3637,745,189200,56401
3395,2329,1066,970,215000,56425
4197,3515,682,712,202500,56431
768,661,107,773,190300,56433
83,75,8,533,160200,56434
1228,1109,119,900,169800,56435
22,17,5,-,162500,56436
493,399,94,775,87700,56437
1074,885,189,699,148100,56438
508,412,96,540,121400,56440
1825,1164,661,775,123500,56441
1317,1179,138,943,362200,56442
617,557,60,851,242900,56443
1428,1235,193,651,239700,56444
689,595,94,592,115700,56446
432,395,37,1118,263900,56447
179,169,10,-,256800,56448
701,652,49,700,200000,56449
462,395,67,940,158400,56450
1024,898,126,672,267100,56452
332,285,47,717,124600,56453
665,514,151,858,138200,56455
22,19,3,-,147500,56456
169,143,26,744,174200,56458
1329,1209,120,757,175100,56461
1714,1429,285,747,158900,56464
893,822,71,1163,242900,56465
1287,1030,257,689,166100,56466
1059,988,71,743,253100,56467
1816,1645,171,928,316400,56468
534,492,42,738,170800,56469
4553,3356,1197,666,215000,56470
3369,2892,477,693,230000,56472
1356,1221,135,825,178500,56473
1944,1421,523,719,157800,56474
645,561,84,721,159500,56475
1189,976,213,496,136100,56477
2109,1698,411,829,125500,56479
877,748,129,580,140500,56481
2968,1965,1003,666,136200,56482
1355,1011,344,771,209300,56484
7337,5424,1913,792,227600,56501
987,720,267,517,107100,56510
838,686,152,620,225000,56511
1390,1150,240,765,181700,56514
1296,1142,154,811,321400,56515
117,102,15,-,151600,56516
107,86,21,-,131700,56517
146,126,20,817,131300,56518
95,77,18,975,130400,56519
1782,1309,473,517,125100,56520
359,292,67,649,126100,56521
171,145,26,1094,125400,56522
178,139,39,621,124400,56523
292,250,42,875,250000,56524
34,34,0,-,90000,56525
317,266,51,860,163600,56527
702,615,87,778,266300,56528
1877,1453,424,813,217900,56529
815,623,192,780,108600,56531
116,99,17,1156,168400,56533
529,479,50,1240,184700,56534
520,401,119,588,165800,56535
148,135,13,-,169500,56536
8459,6032,2427,642,172500,56537
753,619,134,626,134100,56540
10,10,0,-,316700,56541
1120,795,325,813,143900,56542
98,87,11,-,196900,56543
2105,1751,354,769,189400,56544
308,274,34,314,114600,56545
93,92,1,-,187500,56546
1002,866,136,705,225000,56547
304,228,76,676,100000,56548
1879,1596,283,710,239000,56549
150,123,27,825,116000,56550
929,724,205,689,174000,56551
224,181,43,-,117300,56552
112,109,3,-,-,56553
1168,1073,95,654,186100,56554
415,303,112,670,107700,56556
1036,660,376,685,91100,56557
17283,10286,6997,880,203800,56560
12,11,1,-,105400,56565
204,95,109,418,118300,56566
1241,969,272,628,154200,56567
66,59,7,344,108700,56568
513,392,121,406,124400,56569
494,414,80,775,220600,56570
765,713,52,840,242300,56571
2155,1776,379,458,236800,56572
2730,2081,649,695,205500,56573
112,108,4,-,111400,56574
308,261,47,638,129200,56575
348,308,40,880,304700,56576
4,4,0,-,-,56577
269,255,14,1063,262500,56578
429,393,36,675,151800,56579
463,439,24,639,196100,56580
124,112,12,-,103900,56581
86,73,13,-,79500,56583
576,474,102,889,99500,56584
434,347,87,525,155700,56585
797,717,80,836,243300,56586
615,551,64,735,253900,56587
189,180,9,-,263000,56588
779,616,163,558,154500,56589
131,115,16,744,80500,56590
49,42,7,363,75000,56591
173,152,21,800,106900,56592
0,0,0,-,-,56593
200,193,7,375,155500,56594
13875,9124,4751,867,179500,56601
1866,1439,427,650,133500,56621
1061,882,179,638,206500,56623
101,82,19,713,131300,56626
150,117,33,471,48400,56627
754,641,113,921,181300,56628
141,137,4,-,141800,56629
871,670,201,600,130900,56630
1916,1053,863,1034,119100,56633
643,527,116,693,151200,56634
2022,1725,297,595,155700,56636
81,66,15,1111,165000,56637
218,181,37,1000,172800,56639
172,149,23,-,87500,56641
275,236,39,355,123400,56644
185,161,24,519,151300,56646
264,229,35,-,176300,56647
4228,3211,1017,696,120200,56649
370,323,47,469,166500,56650
225,193,32,738,105400,56651
204,194,10,-,171900,56652
620,516,104,571,110800,56653
56,51,5,-,106900,56654
802,732,70,675,249100,56655
130,122,8,-,275000,56657
0,0,0,-,-,56658
40,40,0,-,108300,56659
134,128,6,-,86700,56660
438,389,49,613,107300,56661
241,233,8,-,264700,56662
111,106,5,-,118800,56663
215,80,135,610,90800,56666
264,244,20,956,184100,56667
68,55,13,-,154900,56668
123,121,2,-,167000,56669
356,261,95,704,-,56670
878,535,343,494,80100,56671
967,789,178,595,203300,56672
220,207,13,-,177200,56673
711,627,84,725,159500,56676
526,479,47,1010,154800,56678
70,68,2,-,175000,56680
111,95,16,675,172700,56681
303,281,22,950,193500,56683
107,99,8,-,136200,56684
58,52,6,-,187500,56685
389,351,38,846,82400,56686
20,20,0,-,125000,56687
40,38,2,-,171900,56688
5607,4151,1456,746,163800,56701
227,185,42,496,111600,56710
0,0,0,-,-,56711
425,344,81,393,114600,56713
494,416,78,668,115300,56714
146,133,13,363,173400,56715
3884,2554,1330,667,143100,56716
7,7,0,-,-,56720
4087,2778,1309,692,211800,56721
152,133,19,230,175600,56722
335,280,55,718,165200,56723
50,48,2,-,133300,56724
313,274,39,725,164300,56725
614,561,53,406,116400,56726
390,364,26,608,123800,56727
556,426,130,758,107500,56728
44,40,4,-,90000,56729
48,42,6,-,103400,56731
463,359,104,577,94700,56732
161,148,13,675,70000,56733
217,166,51,608,55000,56734
317,246,71,657,121700,56735
338,306,32,736,254100,56736
386,341,45,437,96700,56737
588,502,86,660,158200,56738
0,0,0,-,-,56741
355,311,44,500,96500,56742
216,181,35,479,109900,56744
266,203,63,586,132600,56748
1026,835,191,581,127700,56750
2321,1762,559,723,159800,56751
229,203,26,646,200800,56754
37,37,0,-,59300,56755
216,192,24,700,130000,56756
371,312,59,738,115600,56757
140,126,14,-,80000,56758
102,97,5,-,164100,56759
190,160,30,794,131300,56760
167,151,16,-,120500,56761
1095,818,277,724,121700,56762
1922,1431,491,539,140200,56763
754,625,129,624,129700,57001
483,384,99,731,166100,57002
620,571,49,965,195100,57003
1571,1149,422,724,183200,57004
4383,3404,979,904,255400,57005
9911,5180,4731,758,195400,57006
281,200,81,-,167700,57010
527,380,147,569,131500,57012
1667,1298,369,637,164300,57013
643,507,136,625,131000,57014
289,233,56,850,195800,57015
366,329,37,938,197500,57016
537,446,91,771,207000,57017
569,489,80,583,152900,57018
524,484,40,1090,212700,57020
164,155,9,-,-,57021
2080,1703,377,855,207400,57022
232,201,31,675,100400,57024
1219,903,316,708,157300,57025
466,330,136,638,153200,57026
45,28,17,-,95000,57027
1350,836,514,568,124800,57028
911,710,201,638,118200,57029
1194,884,310,701,212100,57030
452,412,40,550,112400,57031
2775,2467,308,1000,223700,57032
2131,1640,491,910,202200,57033
421,341,80,-,112100,57034
432,392,40,640,205800,57035
243,213,30,775,105300,57036
365,213,152,591,120400,57037
703,634,69,428,277700,57038
1342,1100,242,634,182100,57039
160,147,13,-,85500,57040
31,31,0,-,234400,57041
3304,2210,1094,660,165700,57042
609,483,126,746,125700,57043
477,388,89,325,78200,57045
399,316,83,802,150900,57046
160,122,38,567,70600,57047
509,384,125,417,191000,57048
3038,1732,1306,953,297700,57049
125,113,12,-,128100,57050
140,109,31,-,68300,57051
102,84,18,529,-,57052
753,659,94,595,191900,57053
273,234,39,600,97200,57054
569,486,83,937,312000,57055
107,98,9,-,-,57057
683,528,155,838,134800,57058
560,430,130,550,89500,57059
57,53,4,-,64000,57061
526,357,169,540,106800,57062
349,281,68,907,85000,57063
2191,1690,501,966,246400,57064
169,124,45,613,114300,57065
682,481,201,583,92200,57066
104,83,21,1313,112500,57067
572,498,74,840,166000,57068
4494,2235,2259,732,172000,57069
627,439,188,586,130800,57070
1310,932,378,818,181900,57071
289,216,73,778,118900,57072
252,208,44,707,76200,57073
419,386,33,718,325600,57075
209,173,36,-,231300,57076
526,496,30,888,173500,57077
8002,5341,2661,648,161200,57078
14657,9609,5048,797,179100,57103
11803,4547,7256,707,127000,57104
9762,6328,3434,859,185900,57105
19523,11895,7628,861,213500,57106
4130,2821,1309,862,175100,57107
9145,6201,2944,1081,321800,57108
7412,5039,2373,919,265600,57110
0,0,0,-,-,57117
0,0,0,-,-,57197
11069,7116,3953,759,189500,57201
906,688,218,683,155000,57212
302,274,28,871,116200,57213
28,25,3,-,57700,57214
639,543,96,678,124500,57216
124,96,28,-,122900,57217
107,76,31,-,213300,57218
215,165,50,-,89700,57219
305,264,41,583,154500,57220
338,242,96,541,159400,57221
472,407,65,500,162100,57223
48,46,2,-,68600,57224
878,706,172,587,105900,57225
790,564,226,536,151300,57226
119,94,25,-,275000,57227
734,586,148,386,138500,57231
172,159,13,745,-,57232
76,66,10,-,271400,57233
515,449,66,518,134900,57234
337,276,61,520,169600,57235
70,60,10,-,-,57236
275,242,33,392,87300,57237
215,158,57,653,124000,57238
133,132,1,-,179500,57239
355,277,78,652,162500,57241
151,133,18,-,185200,57242
303,249,54,685,87100,57243
81,50,31,1115,115600,57245
101,97,4,-,79400,57246
88,73,15,-,272500,57247
424,321,103,829,185200,57248
400,315,85,427,135300,57249
46,37,9,-,140600,57251
1961,1587,374,533,143600,57252
201,160,41,563,72900,57255
71,65,6,-,-,57256
242,156,86,516,-,57257
39,38,1,-,95000,57258
199,164,35,1078,86900,57259
400,338,62,669,114800,57260
140,104,36,485,74400,57261
1927,950,977,563,103100,57262
187,158,29,602,88600,57263
109,95,14,488,103500,57264
84,81,3,-,82100,57265
202,147,55,608,79700,57266
232,195,37,-,79600,57268
128,124,4,-,155000,57269
316,190,126,519,51300,57270
59,59,0,-,111600,57271
78,72,6,-,-,57272
470,296,174,550,103100,57273
1308,984,324,504,138100,57274
476,403,73,638,149500,57276
280,206,74,705,129500,57278
495,410,85,611,105400,57279
8050,4801,3249,720,154700,57301
520,436,84,738,137700,57311
279,243,36,694,65400,57312
496,361,135,536,91300,57313
289,222,67,438,111800,57314
529,382,147,650,81800,57315
256,164,92,486,78200,57317
334,258,76,775,108900,57319
111,93,18,-,106300,57321
131,96,35,597,98000,57322
125,96,29,920,64300,57323
203,178,25,606,135000,57324
1337,807,530,620,168500,57325
544,386,158,811,87300,57328
152,107,45,850,81000,57329
171,147,24,511,89700,57330
149,116,33,183,138600,57331
237,217,20,800,119500,57332
362,248,114,753,125000,57334
134,116,18,558,56000,57335
44,44,0,-,-,57337
403,173,230,455,46200,57339
90,89,1,-,115300,57340
61,55,6,-,178100,57341
167,145,22,-,86300,57342
37,37,0,-,70400,57344
524,445,79,700,100700,57345
73,5,68,422,-,57346
334,206,128,593,159500,57348
601,465,136,538,80700,57349
6316,3944,2372,701,121200,57350
318,292,26,432,145800,57353
536,362,174,808,116700,57355
618,404,214,557,64300,57356
15,13,2,-,18600,57358
259,208,51,691,139500,57359
34,16,18,373,-,57361
961,599,362,485,117700,57362
411,271,140,341,140600,57363
0,0,0,-,-,57364
239,201,38,633,207500,57365
1014,785,229,725,137300,57366
116,87,29,758,213500,57367
440,362,78,702,96700,57368
1054,728,326,721,188700,57369
259,188,71,758,83300,57370
89,66,23,-,65000,57371
200,143,57,-,128400,57373
143,132,11,-,147200,57374
281,241,40,391,86400,57375
393,316,77,418,63200,57376
41,38,3,-,-,57379
1095,701,394,530,119600,57380
181,143,38,654,72100,57381
653,458,195,476,79600,57382
361,289,72,500,81700,57383
462,405,57,549,114400,57384
550,379,171,479,103100,57385
131,97,34,-,95800,57386
13806,8577,5229,671,177500,57401
43,28,15,-,105600,57420
24,24,0,-,-,57421
104,97,7,-,75000,57422
61,52,9,-,70000,57424
10,5,5,-,-,57426
206,206,0,-,-,57427
204,155,49,494,88200,57428
44,40,4,-,55000,57429
936,743,193,685,126100,57430
152,125,27,-,77900,57432
199,170,29,583,125000,57433
191,166,25,475,66900,57434
117,100,17,-,155000,57435
236,198,38,620,57700,57436
704,565,139,469,62000,57437
497,355,142,667,91400,57438
37,37,0,-,-,57439
154,129,25,525,58900,57440
226,206,20,760,107100,57441
802,603,199,586,131300,57442
732,565,167,860,149700,57445
267,254,13,380,58800,57446
191,166,25,575,41400,57448
79,39,40,-,122200,57449
220,165,55,-,84700,57450
879,730,149,669,193600,57451
101,86,15,439,32500,57452
292,254,38,622,93300,57454
51,34,17,-,"10,000-",57455
285,198,87,586,72200,57456
35,33,2,-,53600,57457
121,76,45,611,-,57460
145,120,25,785,100000,57461
154,145,9,467,106500,57465
104,83,21,-,-,57466
96,86,10,-,57300,57467
194,133,61,633,74200,57468
1357,965,392,616,128100,57469
27,15,12,-,41700,57470
250,203,47,725,64800,57471
338,272,66,657,93300,57472
96,96,0,-,128300,57473
60,56,4,-,-,57474
53,48,5,-,100000,57475
193,161,32,750,118800,57476
48,42,6,-,66000,57477
225,202,23,781,185500,57479
186,172,14,-,93300,57481
7219,5121,2098,734,183200,57501
67,56,11,-,85500,57520
68,51,17,285,43600,57521
244,147,97,811,106700,57522
505,360,145,482,108700,57523
425,268,157,533,73300,57528
142,117,25,-,-,57529
56,49,7,-,81700,57531
1423,1161,262,836,155200,57532
773,596,177,591,98800,57533
82,82,0,-,216700,57534
119,94,25,625,85700,57536
30,30,0,-,-,57537
91,78,13,975,110000,57538
15,13,2,-,-,57540
43,23,20,1083,-,57541
228,144,84,575,60000,57543
203,168,35,771,122300,57544
81,75,6,-,57200,57547
407,168,239,500,59400,57548
837,583,254,628,88700,57551
224,186,38,-,-,57552
39,39,0,-,152000,57553
1227,663,564,466,38000,57555
305,196,109,575,105600,57559
141,72,69,372,-,57560
23,20,3,-,116700,57562
41,26,15,413,17700,57563
409,366,43,825,152800,57564
230,82,148,535,"10,000-",57566
545,413,132,704,120400,57567
295,257,38,660,131300,57568
108,78,30,-,65000,57569
531,212,319,481,21200,57570
5,5,0,-,-,57571
492,216,276,396,20900,57572
38,17,21,-,-,57574
102,58,44,-,80000,57576
278,120,158,514,-,57577
442,323,119,651,29300,57579
1654,1236,418,625,105700,57580
25,23,2,-,47500,57584
71,41,30,404,61000,57585
1637,1082,555,719,97200,57601
260,196,64,771,67700,57620
73,31,42,519,-,57621
86,30,56,613,-,57622
331,217,114,605,73200,57623
1196,644,552,602,56500,57625
315,223,92,544,94100,57626
20,20,0,-,-,57630
200,191,9,-,155100,57631
282,205,77,658,68300,57632
171,117,54,617,69000,57633
54,44,10,-,105400,57634
33,13,20,313,-,57636
839,638,201,589,85200,57638
80,25,55,253,38200,57639
102,51,51,-,301900,57640
131,104,27,513,46700,57641
556,248,308,494,52000,57642
156,150,6,-,125000,57644
72,65,7,575,27900,57645
124,120,4,-,63100,57646
165,137,28,-,56300,57648
74,57,17,-,112500,57649
14,0,14,-,-,57650
52,38,14,-,95000,57651
118,65,53,475,75000,57652
314,237,77,584,79800,57656
65,58,7,-,73300,57657
118,57,61,414,52500,57658
27,18,9,-,-,57660
37,24,13,-,125000,57661
18036,10511,7525,785,167500,57701
14972,11253,3719,945,263100,57702
6489,5375,1114,1072,177800,57703
1036,17,1019,1133,-,57706
131,45,86,626,-,57714
110,87,23,613,60300,57716
3334,2692,642,774,154400,57717
3083,2681,402,962,198900,57718
3074,2221,853,887,195600,57719
289,202,87,583,143800,57720
104,91,13,-,32400,57722
89,55,34,-,-,57724
148,115,33,-,-,57725
2572,2008,564,990,222600,57730
1189,721,468,696,206200,57732
607,447,160,750,66400,57735
76,66,10,1042,94000,57738
76,56,20,-,-,57741
932,903,29,942,328300,57744
843,669,174,700,224100,57745
2693,2039,654,787,153500,57747
78,59,19,375,-,57748
67,30,37,-,127500,57750
404,336,68,428,258800,57751
413,149,264,478,-,57752
1916,1325,591,715,171600,57754
42,31,11,-,55000,57755
155,71,84,473,-,57756
50,25,25,-,22600,57758
65,65,0,-,180100,57759
487,396,91,675,111400,57760
411,348,63,-,165100,57761
192,172,20,1050,177500,57762
116,98,18,975,80000,57763
533,237,296,508,-,57764
58,58,0,-,80000,57766
92,83,9,-,76300,57767
1451,1326,125,1024,270700,57769
1116,587,529,511,47400,57770
394,221,173,765,34200,57772
77,60,17,-,-,57773
110,84,26,-,192900,57775
0,0,0,-,-,57776
75,75,0,-,-,57779
21,12,9,-,187500,57780
20,17,3,-,-,57782
6963,4245,2718,822,237900,57783
4058,2769,1289,714,174300,57785
99,72,27,-,221700,57787
184,136,48,-,-,57788
398,316,82,521,150000,57790
70,66,4,-,-,57791
41,41,0,-,164400,57792
856,753,103,681,186600,57793
95,5,90,279,-,57794
11,0,11,-,-,57799
17,17,0,-,187500,58001
5,5,0,-,-,58002
127,117,10,-,193800,58004
348,343,5,-,321700,58005
138,109,29,579,163100,58006
39,34,5,-,305900,58007
92,77,15,-,117500,58008
17,17,0,-,160400,58009
197,184,13,468,213600,58011
1327,826,501,661,219800,58012
73,65,8,-,-,58013
101,83,18,1018,202100,58015
106,93,13,446,119800,58016
158,120,38,575,73000,58017
157,142,15,-,162500,58018
193,176,17,569,196600,58021
727,509,218,734,104600,58027
24,24,0,-,-,58029
245,225,20,306,85500,58030
161,151,10,660,81500,58031
324,237,87,675,148200,58032
163,140,23,823,179200,58033
128,109,19,375,158800,58035
83,83,0,-,157900,58036
114,90,24,-,144600,58038
563,336,227,740,120500,58040
602,527,75,390,110600,58041
473,437,36,1188,279600,58042
82,79,3,-,81500,58043
903,635,268,652,146200,58045
215,185,30,535,103100,58046
1552,1516,36,525,427200,58047
195,173,22,663,142800,58048
143,141,2,-,109900,58049
635,545,90,656,293900,58051
277,225,52,638,195300,58052
534,440,94,596,67600,58053
1275,866,409,754,153400,58054
77,55,22,-,-,58056
53,53,0,-,163500,58057
45,39,6,-,71000,58058
570,508,62,998,200000,58059
511,394,117,775,122100,58060
133,114,19,413,154300,58061
81,81,0,-,126100,58062
179,143,36,596,114000,58063
186,140,46,258,161100,58064
27,27,0,-,222800,58065
109,93,16,625,87000,58067
171,120,51,-,60000,58068
63,40,23,850,118800,58069
183,126,57,466,129500,58071
3636,2346,1290,736,153200,58072
4068,2345,1723,665,132800,58075
0,0,0,-,-,58076
322,280,42,919,208900,58077
14192,9425,4767,955,242100,58078
143,143,0,-,227400,58079
359,324,35,750,151300,58081
13623,6408,7215,733,196000,58102
23659,9471,14188,765,192300,58103
18856,9416,9440,932,287100,58104
13,13,0,-,-,58105
18840,9001,9839,846,234300,58201
0,0,0,-,-,58202
7676,3055,4621,747,166700,58203
678,0,678,1409,-,58204
0,0,0,-,-,58205
160,132,28,575,80000,58210
185,109,76,410,76800,58212
145,116,29,461,-,58214
98,42,56,-,-,58216
342,308,34,678,174200,58218
25,25,0,-,-,58219
995,655,340,646,113300,58220
119,106,13,650,66700,58222
70,63,7,-,109800,58223
17,17,0,-,73800,58224
485,361,124,583,90600,58225
228,213,15,705,103500,58227
407,278,129,691,153700,58228
41,40,1,-,65000,58229
299,211,88,597,72400,58230
166,142,24,-,74400,58231
108,95,13,-,131300,58233
184,157,27,725,82400,58235
2281,1629,652,699,105300,58237
51,50,1,-,-,58238
5,5,0,-,-,58239
562,453,109,621,155400,58240
56,37,19,480,-,58241
270,245,25,767,82100,58243
31,30,1,-,120000,58244
1209,912,297,592,118600,58249
168,91,77,-,72300,58250
794,548,246,659,165300,58251
242,204,38,494,76000,58254
278,242,36,1100,179200,58256
811,457,354,710,153300,58257
192,190,2,-,103600,58258
238,189,49,637,100200,58259
67,61,6,-,94400,58260
572,495,77,759,89100,58261
31,18,13,431,28500,58262
179,169,10,-,89100,58265
58,39,19,-,112500,58266
499,397,102,640,173100,58267
105,98,7,800,67100,58269
813,599,214,943,88300,58270
242,191,51,708,108400,58271
128,100,28,480,88300,58272
75,72,3,-,72300,58273
424,321,103,511,152900,58274
267,235,32,738,155300,58275
238,212,26,700,67600,58276
94,90,4,-,161800,58277
759,690,69,695,260300,58278
41,41,0,-,-,58281
649,435,214,588,91100,58282
4320,2452,1868,608,160000,58301
35,21,14,-,119300,58311
1952,1362,590,388,84200,58316
81,76,5,-,70000,58317
1643,1219,424,691,171800,58318
20,18,2,-,225000,58321
20,20,0,-,-,58323
710,476,234,580,108500,58324
24,23,1,-,-,58325
115,109,6,-,238600,58327
964,728,236,342,72600,58329
205,139,66,722,44600,58330
84,79,5,-,-,58331
156,126,30,530,83800,58332
357,148,209,394,30400,58335
40,39,1,-,115200,58338
9,4,5,-,75000,58339
1209,870,339,607,109400,58341
17,15,2,-,225000,58343
413,284,129,506,108500,58344
53,47,6,-,86900,58345
296,217,79,471,68100,58346
385,327,58,606,106100,58348
150,129,21,621,113800,58351
201,171,30,563,87700,58352
68,31,37,341,184200,58353
25,25,0,-,55000,58355
785,462,323,656,90600,58356
142,132,10,-,62500,58357
123,83,40,1583,-,58361
0,0,0,-,-,58362
46,46,0,-,57100,58363
113,81,32,483,71700,58365
428,327,101,550,112100,58366
534,339,195,629,121700,58367
1578,1187,391,690,139500,58368
488,386,102,597,120600,58369
404,278,126,369,80000,58370
43,43,0,-,73600,58372
251,217,34,483,74600,58374
146,102,44,655,56300,58377
103,53,50,613,312500,58379
186,162,24,453,126000,58380
145,133,12,713,229200,58381
76,64,12,-,150000,58382
221,200,21,588,52200,58384
68,61,7,-,114100,58385
59,50,9,-,54000,58386
7672,4473,3199,693,165900,58401
0,0,0,-,-,58402
0,0,0,-,-,58405
534,397,137,478,69500,58413
73,70,3,-,240000,58415
170,149,21,365,71300,58416
193,153,40,817,72500,58418
83,76,7,-,166700,58420
1295,931,364,604,156700,58421
54,43,11,-,129200,58422
34,31,3,-,156700,58423
120,101,19,671,220700,58424
585,477,108,552,111700,58425
70,70,0,-,143800,58426
101,66,35,-,166200,58428
180,111,69,725,182000,58429
61,61,0,-,-,58430
58,56,2,-,-,58431
555,398,157,464,112000,58433
741,494,247,625,100500,58436
402,323,79,675,71300,58438
69,69,0,-,179500,58439
49,38,11,-,87300,58440
151,118,33,-,168800,58441
177,163,14,550,76800,58442
66,57,9,275,-,58443
89,69,20,475,55800,58444
70,48,22,482,-,58445
149,109,40,600,100700,58448
47,41,6,-,64100,58451
16,9,7,-,-,58452
150,137,13,442,85000,58454
123,109,14,769,66300,58455
267,234,33,547,82300,58456
473,354,119,525,111300,58458
95,79,16,530,47500,58460
186,164,22,600,79500,58461
344,255,89,419,64700,58463
111,106,5,-,152800,58464
229,197,32,671,104600,58466
236,184,52,565,79200,58467
179,165,14,585,155200,58472
1127,888,239,638,135700,58474
86,74,12,-,29200,58475
208,198,10,1031,114700,58476
68,58,10,-,83600,58477
71,61,10,-,33800,58478
69,66,3,-,113900,58479
123,95,28,646,89000,58480
103,91,12,-,264400,58481
522,363,159,667,119300,58482
132,104,28,-,114600,58483
28,22,6,-,90000,58484
110,72,38,388,87000,58486
192,172,20,688,65000,58487
100,87,13,455,29200,58488
103,99,4,-,112500,58490
214,185,29,535,116800,58492
125,91,34,900,73800,58494
586,387,199,609,100300,58495
99,58,41,356,-,58496
63,57,6,-,86700,58497
12787,7381,5406,845,234300,58501
14405,10920,3485,991,328000,58503
11301,8360,2941,807,240400,58504
0,0,0,-,-,58505
123,113,10,633,-,58520
217,210,7,-,420000,58521
1631,1312,319,741,196900,58523
34,34,0,-,128600,58524
138,44,94,446,-,58528
279,236,43,810,59700,58529
429,366,63,522,171100,58530
224,224,0,-,269000,58531
107,90,17,833,108300,58532
479,398,81,502,104900,58533
220,183,37,850,80800,58535
606,226,380,384,93600,58538
1312,990,322,647,164100,58540
249,210,39,673,113300,58541
132,116,16,-,87300,58542
273,218,55,-,100000,58544
1455,1238,217,973,187500,58545
107,95,12,-,116300,58549
771,598,173,418,98100,58552
11461,7925,3536,880,237300,58554
440,363,77,1718,317300,58558
95,86,9,-,172700,58559
70,61,9,682,289300,58560
471,376,95,729,85900,58561
159,152,7,-,65600,58562
962,796,166,758,158800,58563
45,45,0,-,55900,58564
109,85,24,-,182500,58565
58,48,10,-,-,58566
252,177,75,817,87200,58568
48,48,0,-,58300,58569
167,145,22,1036,156900,58570
236,223,13,496,117600,58571
108,99,9,625,281300,58572
268,223,45,465,80500,58573
371,306,65,703,159600,58575
482,397,85,702,179700,58576
865,655,210,744,212300,58577
524,441,83,497,186900,58579
140,127,13,850,394400,58580
140,108,32,240,30000,58581
11013,6671,4342,913,252500,58601
56,42,14,-,83300,58620
619,454,165,697,114200,58621
712,539,173,950,183100,58622
865,671,194,739,163800,58623
90,85,5,-,173400,58625
216,149,67,839,168400,58626
60,51,9,-,230600,58627
278,221,57,1284,235500,58630
476,379,97,695,108400,58631
89,65,24,-,133800,58632
63,47,16,-,332100,58634
395,283,112,618,164100,58636
449,349,100,714,113400,58638
802,581,221,577,114900,58639
623,462,161,1105,250800,58640
34,29,5,-,-,58641
128,82,46,1401,277300,58642
86,65,21,625,86300,58643
112,53,59,-,383300,58645
498,384,114,645,105200,58646
526,431,95,794,117700,58647
140,94,46,550,59400,58649
168,120,48,675,103100,58650
263,232,31,658,85300,58651
503,469,34,538,155700,58652
302,260,42,870,119600,58653
109,102,7,-,89100,58654
279,237,42,1028,249400,58655
173,153,20,535,192700,58656
13923,8258,5665,859,225000,58701
0,0,0,-,-,58702
9667,5751,3916,906,221100,58703
1566,16,1550,1497,-,58704
0,0,0,-,-,58705
0,0,0,-,-,58707
345,308,37,463,79600,58710
125,108,17,-,133300,58711
42,36,6,-,70000,58712
40,40,0,-,602900,58713
80,78,2,-,194600,58716
420,376,44,592,190200,58718
242,178,64,680,84300,58721
636,514,122,1008,184000,58722
85,68,17,389,118800,58723
115,105,10,-,141100,58725
97,91,6,-,150600,58727
679,457,222,931,131900,58730
120,106,14,688,115600,58731
176,167,9,-,200600,58733
136,128,8,-,154800,58734
183,175,8,-,321100,58735
258,226,32,556,67800,58736
52,51,1,-,72100,58737
267,213,54,756,177900,58740
303,258,45,939,107100,58741
55,53,2,-,168800,58744
662,523,139,749,128800,58746
71,55,16,850,-,58748
174,137,37,631,170600,58750
129,73,56,636,109400,58752
73,73,0,-,-,58755
100,81,19,-,97500,58756
196,125,71,444,85000,58757
127,125,2,-,162500,58758
315,276,39,1146,171600,58759
133,101,32,1117,166300,58760
380,318,62,747,123100,58761
120,99,21,418,111800,58762
1271,712,559,645,174000,58763
143,129,14,1104,86300,58765
117,109,8,-,231700,58768
165,133,32,648,165100,58769
562,385,177,712,137500,58770
209,174,35,964,123600,58771
84,56,28,654,82300,58772
396,347,49,1014,179900,58773
47,19,28,489,109400,58775
172,45,127,1240,-,58776
70,70,0,-,336600,58778
108,90,18,1271,70000,58779
259,236,23,913,186000,58781
222,194,28,554,120700,58782
178,160,18,468,122200,58783
1124,743,381,1068,188300,58784
513,434,79,1589,232600,58785
55,55,0,-,116100,58787
510,420,90,394,105700,58788
126,86,40,1063,71000,58789
666,522,144,475,174100,58790
89,72,17,-,224100,58792
222,196,26,345,115600,58793
104,50,54,-,403800,58794
57,41,16,-,-,58795
13041,6511,6530,1011,260100,58801
92,87,5,-,151400,58830
159,116,43,1131,234000,58831
85,61,24,475,162100,58833
186,176,10,-,340000,58835
80,57,23,1063,159400,58838
212,203,9,-,403200,58843
23,15,8,-,61000,58844
182,157,25,-,217300,58845
148,123,25,-,251000,58847
384,315,69,721,218900,58849
608,415,193,888,170000,58852
110,68,42,1031,119700,58853
3295,1672,1623,1154,308800,58854
28,24,4,-,204500,58856
739,607,132,870,244200,59001
76,41,35,896,-,59002
489,172,317,555,77500,59003
646,376,270,706,222700,59006
55,37,18,1050,177500,59007
225,184,41,1021,155500,59008
88,43,45,-,168100,59010
1251,914,337,648,237100,59011
86,54,32,-,-,59012
49,31,18,-,190800,59013
656,443,213,686,187500,59014
175,160,15,-,178600,59015
297,182,115,598,156300,59016
233,180,53,825,259800,59018
1673,1376,297,775,248800,59019
37,17,20,1125,475000,59020
444,298,146,561,84000,59022
152,116,36,475,125000,59024
40,9,31,-,-,59025
98,56,42,922,139600,59026
368,266,102,681,403700,59027
231,178,53,813,374400,59028
344,312,32,1156,206600,59029
734,336,398,685,326500,59030
80,50,30,-,262500,59031
210,158,52,506,153100,59032
125,114,11,-,-,59033
1698,1066,632,731,151200,59034
89,71,18,-,79000,59035
598,420,178,651,130900,59036
1003,980,23,-,242200,59037
278,205,73,781,157300,59038
21,12,9,-,-,59039
765,662,103,1069,283300,59041
707,441,266,585,67900,59043
4989,3768,1221,878,228900,59044
163,121,42,829,104200,59046
5989,4159,1830,845,281900,59047
379,292,87,569,162200,59050
73,56,17,1125,1083300,59052
158,130,28,-,-,59053
126,95,31,622,157900,59054
34,16,18,-,190000,59055
378,356,22,-,314700,59057
15,15,0,-,162500,59058
77,56,21,-,258300,59059
164,143,21,596,298900,59061
16,16,0,-,320000,59062
760,583,177,963,251800,59063
79,38,41,718,258700,59064
63,58,5,-,463200,59065
153,102,51,-,206900,59066
107,54,53,829,-,59067
1624,1058,566,691,328000,59068
192,168,24,1273,255300,59069
407,312,95,979,272500,59070
56,42,14,-,432000,59071
2023,1477,546,773,173700,59072
196,169,27,738,110300,59074
93,74,19,-,161100,59075
18,7,11,-,-,59076
24,13,11,-,-,59077
82,51,31,-,110200,59078
1614,1466,148,-,249200,59079
34,34,0,-,598200,59081
14,11,3,-,206300,59082
67,63,4,-,83200,59085
417,331,86,671,246000,59086
190,124,66,478,161100,59087
557,393,164,945,246100,59088
157,97,60,533,172500,59089
17199,10466,6733,795,190100,59101
20611,13406,7205,962,232300,59102
13097,9622,3475,973,242200,59105
7758,5943,1815,1188,385500,59106
1756,1121,635,553,117300,59201
65,57,8,-,-,59211
140,119,21,-,154200,59212
248,177,71,219,52300,59213
48,34,14,-,-,59214
473,383,90,532,158600,59215
83,80,3,-,195000,59217
342,262,80,775,210700,59218
97,74,23,-,95000,59219
773,628,145,912,173100,59221
110,96,14,-,246900,59222
180,158,22,696,254800,59223
180,111,69,425,76400,59225
199,161,38,554,158400,59226
2019,1497,522,598,156000,59230
181,144,37,1079,19800,59231
7,7,0,-,92500,59240
199,130,69,492,118100,59241
30,28,2,-,113900,59242
102,76,26,603,205600,59243
7,6,1,-,-,59244
155,111,44,658,79700,59247
355,292,63,657,163400,59248
94,75,19,471,-,59250
30,22,8,-,-,59252
39,39,0,-,350000,59253
848,636,212,730,144400,59254
850,496,354,471,66800,59255
25,25,0,-,-,59256
46,35,11,-,-,59257
88,37,51,-,78800,59258
121,101,20,-,88300,59259
40,27,13,-,172500,59260
251,196,55,444,91700,59261
229,159,70,585,107500,59262
681,517,164,516,153600,59263
3388,2241,1147,764,239300,59270
122,92,30,-,105400,59274
197,170,27,625,69600,59275
15,15,0,-,-,59276
4702,3138,1564,878,172900,59301
81,60,21,-,220800,59311
11,11,0,-,-,59312
1064,759,305,753,161400,59313
39,20,19,-,366700,59314
26,25,1,-,120800,59315
502,380,122,625,143100,59317
45,40,5,-,207100,59318
22,6,16,-,80000,59322
956,803,153,791,115200,59323
463,318,145,582,102600,59324
93,39,54,748,262500,59326
1077,759,318,572,157800,59327
3694,2396,1298,752,155700,59330
97,56,41,-,106300,59332
3,3,0,-,-,59333
82,58,24,-,212500,59336
318,215,103,569,155600,59337
45,39,6,-,268800,59338
51,46,5,-,95000,59339
15,11,4,-,-,59343
164,128,36,825,231600,59344
122,95,27,-,-,59347
425,360,65,-,89200,59349
86,69,17,-,-,59351
477,378,99,924,107600,59353
14,14,0,-,-,59354
6354,3463,2891,661,157500,59401
10867,9165,1702,803,209400,59404
13608,7465,6143,822,181700,59405
246,168,78,703,199100,59410
107,75,32,-,-,59411
640,505,135,729,208200,59412
382,231,151,677,120100,59414
131,71,60,764,77500,59416
2109,1143,966,401,87500,59417
26,12,14,-,-,59418
54,34,20,625,115000,59419
89,74,15,-,158300,59420
887,730,157,674,258400,59421
1087,711,376,818,180100,59422
7,6,1,-,-,59424
1328,972,356,692,158600,59425
1782,1228,554,664,108700,59427
210,164,46,679,158300,59430
46,41,5,-,130400,59432
214,154,60,725,103600,59433
160,120,40,725,159700,59434
819,636,183,829,225700,59436
103,58,45,-,225600,59440
20,17,3,-,55000,59441
733,564,169,639,160300,59442
161,142,19,-,294100,59443
86,37,49,-,106300,59444
209,156,53,829,104200,59446
121,104,17,943,165900,59447
147,82,65,423,58200,59448
244,178,66,1088,210000,59450
47,38,9,-,-,59451
212,176,36,585,158000,59452
164,139,25,575,116100,59453
94,80,14,-,65900,59454
54,47,7,-,83200,59456
4108,2854,1254,734,137600,59457
123,114,9,-,93100,59460
5,5,0,-,-,59461
78,65,13,-,73000,59462
65,60,5,-,223500,59463
174,124,50,709,162900,59464
17,16,1,-,143800,59465
50,29,21,-,53800,59466
45,37,8,-,257500,59467
252,199,53,817,200900,59468
42,36,6,-,-,59469
127,91,36,675,169800,59471
290,179,111,843,160800,59472
1328,784,544,560,153700,59474
121,92,29,677,168600,59477
378,248,130,384,127300,59479
150,140,10,725,165900,59480
222,145,77,685,117700,59482
208,171,37,752,235800,59483
61,39,22,-,122000,59484
200,200,0,-,211300,59485
465,364,101,671,119600,59486
557,436,121,766,142000,59487
184,150,34,721,170800,59489
5276,3410,1866,691,169100,59501
415,269,146,-,94800,59520
1117,480,637,308,79600,59521
686,328,358,580,118100,59522
959,646,313,535,142200,59523
279,185,94,487,59100,59524
88,59,29,565,113400,59525
849,438,411,560,66600,59526
266,140,126,448,36700,59527
125,77,48,-,79000,59528
81,47,34,-,226600,59529
42,38,4,-,-,59530
141,110,31,-,100800,59531
65,50,15,-,115600,59532
30,11,19,-,-,59535
35,30,5,-,151900,59537
1149,931,218,529,150600,59538
134,78,56,541,103800,59540
80,44,36,-,72500,59542
80,36,44,270,210700,59544
39,39,0,-,92600,59545
98,94,4,-,793900,59546
19,17,2,-,115600,59547
14163,8271,5892,829,259000,59601
10342,8819,1523,1071,282900,59602
123,122,1,-,230000,59631
722,440,282,741,183600,59632
148,148,0,-,327400,59633
1765,1659,106,1076,359300,59634
2867,2496,371,824,231300,59635
0,0,0,-,-,59636
274,238,36,-,219000,59638
575,471,104,712,211200,59639
37,30,7,-,157700,59640
31,27,4,-,-,59642
179,162,17,-,187500,59643
1748,1400,348,751,213700,59644
592,493,99,592,175500,59645
192,174,18,-,242300,59647
210,149,61,793,247700,59648
14530,10001,4529,684,151700,59701
24,16,8,-,375000,59703
103,80,23,588,275000,59710
4163,2817,1346,540,132500,59711
76,47,29,622,154200,59713
8340,6046,2294,1104,299300,59714
14871,8059,6812,971,559800,59715
1040,616,424,1312,445500,59716
16419,9575,6844,1272,381400,59718
84,74,10,-,312100,59720
202,148,54,740,272200,59721
2017,1230,787,654,131500,59722
46,25,21,-,193800,59724
3558,2223,1335,700,202900,59725
97,77,20,645,308300,59727
141,127,14,575,269600,59728
1156,925,231,737,346300,59729
837,611,226,1327,570500,59730
64,56,8,400,233300,59731
82,31,51,1042,275000,59732
70,29,41,-,308300,59733
108,89,19,-,344600,59735
69,41,28,-,285000,59736
131,101,30,-,150700,59739
228,190,38,-,587800,59740
1925,1368,557,1250,335400,59741
78,63,15,-,234100,59743
35,34,1,-,225000,59745
61,56,5,-,307700,59746
68,57,11,-,225000,59747
109,101,8,-,172800,59748
831,720,111,642,271000,59749
151,148,3,-,297100,59750
78,49,29,975,172900,59751
1575,1230,345,1018,272800,59752
414,266,148,783,249100,59754
81,71,10,1104,231500,59755
8,0,8,-,-,59756
688,456,232,621,337500,59758
1546,1298,248,827,270100,59759
122,87,35,706,173000,59760
162,118,44,763,260400,59761
103,89,14,-,328800,59762
14713,5697,9016,885,273100,59801
9292,4455,4837,866,292500,59802
6578,4795,1783,1042,351900,59803
3138,1961,1177,1112,351200,59804
8297,5668,2629,957,305400,59808
813,673,140,778,238100,59820
946,704,242,786,236100,59821
686,577,109,974,336500,59823
577,369,208,822,305500,59824
956,813,143,870,251500,59825
259,250,9,-,425000,59826
172,148,24,-,330000,59827
2155,1688,467,760,279900,59828
1098,828,270,741,317400,59829
82,65,17,-,173200,59830
206,156,50,613,113200,59831
269,182,87,539,215400,59832
2120,1880,240,796,327200,59833
868,787,81,975,291000,59834
207,165,42,663,282500,59837
6428,4518,1910,796,253800,59840
198,138,60,1089,220700,59841
42,42,0,-,195800,59842
124,62,62,525,400000,59843
284,220,64,1082,300000,59844
660,442,218,499,121300,59845
633,597,36,-,384100,59846
2420,1844,576,776,281200,59847
46,39,7,-,127500,59848
50,39,11,-,-,59851
348,278,70,540,278600,59853
74,50,24,650,-,59854
254,130,124,283,82100,59855
144,78,66,1012,193800,59856
636,529,107,625,227400,59858
1563,1203,360,652,313800,59859
4447,3122,1325,784,281400,59860
125,117,8,-,-,59863
2474,1585,889,662,208800,59864
1278,982,296,671,265600,59865
446,331,115,597,272300,59866
32,9,23,-,-,59867
939,894,45,865,235800,59868
4382,3582,800,778,328300,59870
105,69,36,-,281900,59871
885,688,197,590,177700,59872
1273,1029,244,548,227000,59873
788,649,139,-,288400,59874
1580,1326,254,646,284100,59875
21337,15437,5900,846,269500,59901
191,174,17,-,592900,59910
3785,3162,623,977,422000,59911
5864,4484,1380,812,270100,59912
280,265,15,-,376800,59913
136,104,32,980,340000,59914
199,105,94,814,260300,59915
80,80,0,-,290900,59916
1985,1612,373,781,273500,59917
270,227,43,748,322700,59918
323,259,64,1050,51100,59919
641,553,88,648,370500,59920
985,763,222,840,407100,59922
4424,3405,1019,635,166200,59923
565,517,48,817,296700,59925
198,154,44,573,-,59926
121,86,35,442,311800,59927
93,72,21,-,432000,59928
100,84,16,-,333300,59929
213,196,17,-,172300,59930
143,129,14,-,-,59931
712,466,246,946,243900,59932
17,17,0,-,-,59933
306,251,55,-,300900,59934
1407,1152,255,788,185800,59935
152,111,41,650,445200,59936
5996,4175,1821,1039,418800,59937
9140,7257,1883,1036,226800,60002
20199,15637,4562,1454,356300,60004
12261,7896,4365,1325,335100,60005
12984,9609,3375,1307,287900,60007
8037,5803,2234,1386,241400,60008
16683,14705,1978,1838,542300,60010
3946,3640,306,1895,321900,60012
9547,8467,1080,1276,247000,60013
16968,13503,3465,1199,235800,60014
10011,8357,1654,1854,536500,60015
23350,15812,7538,1161,247100,60016
9437,6882,2555,1039,255500,60018
4836,3316,1520,1122,160500,60020
1958,1650,308,1531,245400,60021
3141,2979,162,-,1042200,60022
15709,12671,3038,1436,431700,60025
5263,3536,1727,1739,586200,60026
163,158,5,-,875000,60029
13940,11079,2861,1272,226100,60030
14048,10496,3552,1262,259600,60031
4652,2998,1654,1000,163700,60033
769,549,220,1048,194000,60034
11704,9823,1881,1666,535200,60035
1967,777,1190,1419,383300,60040
3296,2722,574,980,178500,60041
3158,2510,648,1568,184600,60042
730,689,41,2846,1231500,60043
4284,2780,1504,1412,485700,60044
7813,6815,998,1770,812000,60045
11992,9827,2165,1338,232000,60046
14187,12719,1468,1642,452200,60047
10415,8680,1735,1489,469000,60048
12565,9294,3271,1335,188300,60050
8875,7260,1615,1390,216200,60051
8786,7691,1095,2022,326100,60053
20789,14403,6386,1172,331200,60056
13040,9912,3128,1388,249000,60060
10144,6736,3408,1644,343800,60061
15757,12991,2766,1636,537800,60062
5336,2397,2939,976,101400,60064
15363,11862,3501,1334,366300,60067
14372,11894,2478,1360,451500,60068
3528,2928,600,2725,503500,60069
6030,3946,2084,1137,298700,60070
1621,1056,565,972,279500,60071
375,364,11,-,333300,60072
19510,15090,4420,1266,167100,60073
14493,8708,5785,1179,241300,60074
10793,8353,2440,1285,332900,60076
10184,6481,3703,1243,287800,60077
3291,2958,333,1346,282600,60081
3472,3153,319,1621,265000,60083
6489,5275,1214,1145,242600,60084
23981,10174,13807,950,123700,60085
8853,5714,3139,1082,143800,60087
1311,0,1311,1673,-,60088
15257,12083,3174,1700,338300,60089
15148,9269,5879,1270,202000,60090
10181,8993,1188,1498,685100,60091
7079,6304,775,1807,962900,60093
2608,2145,463,1036,193000,60096
4195,3454,741,1094,166500,60097
12371,8571,3800,1061,208600,60098
10520,6502,4018,1078,145000,60099
13493,8937,4556,1093,258600,60101
11839,10207,1632,1679,266500,60102
13803,11738,2065,1695,288300,60103
6059,4450,1609,1043,161600,60104
7363,4041,3322,1140,228500,60106
13206,11340,1866,1705,205800,60107
8921,6425,2496,1358,310800,60108
175,121,54,1208,207800,60109
11265,8241,3024,1281,176600,60110
65,65,0,-,285200,60111
1512,1121,391,1300,162000,60112
116,85,31,891,112500,60113
16805,6923,9882,881,168200,60115
6433,4526,1907,1273,283900,60118
3817,3433,384,1311,294700,60119
15423,10159,5264,1101,175000,60120
17315,11675,5640,1067,187900,60123
7823,7591,232,1952,320000,60124
17691,14382,3309,1508,434900,60126
104,98,6,-,138500,60129
6695,3299,3396,1130,245900,60130
5713,4133,1580,939,211700,60131
11082,8043,3039,1332,206200,60133
10300,8805,1495,1593,360700,60134
2625,1765,860,967,178600,60135
2655,2388,267,2151,262800,60136
14287,11357,2930,1123,419900,60137
11678,7341,4337,1316,203400,60139
6246,5006,1240,1551,280900,60140
123,0,123,609,-,60141
12804,11287,1517,1278,261000,60142
4578,3539,1039,1343,346800,60143
31,24,7,1094,273300,60144
1034,669,365,1036,202200,60145
899,694,205,780,163500,60146
19825,14165,5660,1447,268100,60148
711,488,223,953,159700,60150
1494,1273,221,1513,252700,60151
4510,3307,1203,925,198400,60152
7634,4780,2854,972,158900,60153
6811,6241,570,1474,244900,60154
3009,2109,900,928,172000,60155
9798,8088,1710,1487,235900,60156
990,972,18,-,380400,60157
7840,3986,3854,1057,200700,60160
2751,1738,1013,1265,190300,60162
1793,1614,179,1017,175900,60163
6920,4928,1992,967,190500,60164
1350,700,650,1014,174400,60165
11857,7549,4308,1361,246000,60169
3642,2317,1325,984,211600,60171
9002,6768,2234,1414,268200,60172
5889,2109,3780,1477,309400,60173
12069,8192,3877,1375,290000,60174
8541,8246,295,2416,399600,60175
4437,2629,1808,1103,228600,60176
7778,6339,1439,1496,238400,60177
8391,5669,2722,946,209700,60178
609,497,112,2088,252500,60180
10895,7341,3554,1320,242700,60181
874,850,24,-,546500,60184
11074,8456,2618,1162,264600,60185
9909,7029,2880,1481,374900,60187
14911,10564,4347,1286,262100,60188
11613,9115,2498,1480,389900,60189
4339,3863,476,1988,322800,60190
5262,4071,1191,1407,246700,60191
5704,5065,639,2170,349000,60192
15340,11558,3782,1402,273500,60193
7564,5449,2115,1552,241800,60194
2090,624,1466,1431,171300,60195
15032,8726,6306,1511,514000,60201
12886,7102,5784,1379,332600,60202
1520,1407,113,1798,455000,60203
1885,347,1538,2150,218900,60301
13545,8030,5515,1137,416400,60302
6271,4678,1593,1146,398500,60304
4040,3498,542,1309,604900,60305
2865,2332,533,960,188700,60401
20936,12978,7958,994,219500,60402
7583,5058,2525,1170,174000,60403
6798,6131,667,1731,264100,60404
8637,4309,4328,913,123300,60406
638,491,147,979,129400,60407
2103,1631,472,1059,181100,60408
14166,8110,6056,959,111500,60409
4431,3867,564,1396,233400,60410
18996,12258,6738,982,104600,60411
5301,2969,2332,975,169200,60415
3750,2870,880,964,190600,60416
5885,5164,721,1002,181500,60417
7985,5413,2572,1320,106200,60419
1814,1296,518,777,133000,60420
1531,1409,122,872,192700,60421
3395,3043,352,2187,239000,60422
10478,9728,750,1286,313100,60423
900,712,188,883,157100,60424
2870,2427,443,1575,129600,60425
10038,5377,4661,952,71400,60426
3727,2518,1209,1361,93900,60428
5566,3302,2264,1432,118000,60429
7410,5843,1567,1163,166400,60430
7700,6763,937,1225,213700,60431
6228,3308,2920,1025,142400,60432
5279,3237,2042,1090,128000,60433
18962,11832,7130,1021,169000,60435
6029,3485,2544,1080,130900,60436
57,36,21,900,121900,60437
10972,7340,3632,1032,132200,60438
8493,7348,1145,1209,379700,60439
17063,12849,4214,1331,199000,60440
12086,9585,2501,1304,230700,60441
3908,3452,456,1078,275400,60442
8727,6562,2165,1232,167000,60443
764,599,165,930,177900,60444
10797,8223,2574,1040,157800,60445
11725,9940,1785,1630,199600,60446
4802,4245,557,1349,223300,60447
9053,8147,906,1172,305800,60448
3631,3357,274,900,222000,60449
8721,5436,3285,970,209400,60450
11897,11006,891,1200,297100,60451
10088,8275,1813,1093,203400,60452
21192,16964,4228,1111,211500,60453
5723,3913,1810,946,201500,60455
1745,1282,463,451,122800,60456
4819,3438,1381,997,237000,60457
5289,2708,2581,1111,176100,60458
9108,7192,1916,1120,201300,60459
490,370,120,767,124000,60460
1752,1625,127,3097,229300,60461
15551,12942,2609,1220,278800,60462
5346,5025,321,1434,290400,60463
3916,3510,406,1787,403700,60464
7247,5509,1738,1073,205600,60465
8225,4821,3404,1247,73800,60466
9698,9036,662,1189,330300,60467
2325,1800,525,940,233400,60468
1744,1249,495,1103,132600,60469
199,166,33,598,100000,60470
5365,2900,2465,1062,147100,60471
1556,865,691,999,82300,60472
7533,6426,1107,1482,157300,60473
321,257,64,963,130300,60474
4121,2783,1338,912,111000,60475
965,737,228,1110,109300,60476
15335,12323,3012,1207,215200,60477
5704,4602,1102,1306,133900,60478
426,325,101,1086,165600,60479
2120,1702,418,1199,295300,60480
4625,3461,1164,872,170300,60481
4182,2715,1467,1045,173500,60482
2368,1481,887,960,124800,60484
9097,8568,529,1182,278000,60487
6094,5759,335,2387,301300,60490
7605,7155,450,1154,340000,60491
3480,1927,1553,891,188700,60501
8184,6488,1696,1629,318100,60502
5741,4920,821,1753,244600,60503
13424,7681,5743,1633,212200,60504
21120,12597,8523,1101,139800,60505
19493,12750,6743,1082,185300,60506
10618,8281,2337,1170,316500,60510
607,508,99,1150,233000,60511
594,484,110,-,223300,60512
7005,5513,1492,1054,265400,60513
4033,3306,727,986,445000,60514
11459,8866,2593,1298,372800,60515
12085,9210,2875,1398,349300,60516
12573,8200,4373,1343,277800,60517
1614,1149,465,845,135200,60518
18,18,0,-,-,60519
1159,882,277,1108,242600,60520
6090,5269,821,1886,865300,60521
4212,3480,732,587,674700,60523
11695,9445,2250,1160,356800,60525
4933,3577,1356,1222,364700,60526
11286,9287,1999,1546,437100,60527
254,196,58,828,157500,60530
794,585,209,1394,177700,60531
12416,7052,5364,1339,336000,60532
3634,2236,1398,1059,175700,60534
41,32,9,1100,219200,60536
255,238,17,1018,169800,60537
8627,6957,1670,1580,203000,60538
0,0,0,-,-,60539
15895,11980,3915,1456,435600,60540
1147,987,160,1258,257500,60541
6856,5195,1661,1274,258100,60542
13578,11762,1816,997,257500,60543
9858,8359,1499,1661,242400,60544
4756,3568,1188,1316,197200,60545
5864,4345,1519,1089,300400,60546
4289,3381,908,1119,176500,60548
55,55,0,-,192800,60549
546,419,127,742,185800,60550
1495,1219,276,835,181800,60551
1628,1326,302,1137,201300,60552
291,243,48,850,140200,60553
4560,4209,351,1053,296500,60554
5135,4088,1047,1530,227000,60555
780,651,129,793,182400,60556
89,89,0,-,115200,60557
4460,4354,106,2036,609600,60558
10194,5741,4453,1214,299500,60559
8219,6841,1378,1370,273500,60560
8898,7367,1531,1541,334100,60561
15780,8621,7159,1499,340400,60563
13926,12151,1775,1931,454200,60564
13568,12001,1567,1440,399100,60565
7557,6909,648,2141,335100,60585
13892,12654,1238,1872,233000,60586
8046,2547,5499,2322,540600,60601
977,437,540,2441,-,60602
644,455,189,2333,499400,60603
437,117,320,2246,485900,60604
16266,8552,7714,2114,404400,60605
2327,790,1537,2090,338700,60606
13532,5713,7819,2073,433300,60607
26211,10169,16042,982,279300,60608
21967,8185,13782,825,194500,60609
24277,9370,14907,1767,458100,60610
21714,9873,11841,2130,574300,60611
13200,3770,9430,1053,294400,60612
27281,10670,16611,1414,341900,60613
33402,15110,18292,1756,662300,60614
21613,6504,15109,1194,261700,60615
24470,9233,15237,1130,343900,60616
29173,16451,12722,871,137100,60617
35951,17732,18219,1239,434300,60618
27274,12181,15093,898,167000,60619
25454,12104,13350,933,148800,60620
10746,2506,8240,867,106300,60621
24297,9607,14690,1627,524400,60622
25746,9269,16477,895,167500,60623
12494,3326,9168,1001,188100,60624
30163,11857,18306,1253,354800,60625
23042,5870,17172,1053,220800,60626
23073,13205,9868,993,123600,60628
31961,17958,14003,921,178300,60629
20868,13868,7000,1134,307600,60630
11632,8751,2881,1199,367100,60631
25170,13824,11346,878,190900,60632
4862,3370,1492,1017,139500,60633
26678,19351,7327,1120,273700,60634
10979,5064,5915,902,104600,60636
20122,4970,15152,962,212000,60637
20226,15909,4317,1062,229800,60638
25807,12979,12828,1047,245300,60639
36011,11366,24645,1137,311800,60640
24522,12764,11758,1079,311700,60641
9739,3519,6220,1898,475000,60642
17601,13122,4479,1092,195900,60643
17309,5202,12107,939,188200,60644
16123,8410,7713,1204,292500,60645
10866,8447,2419,1151,442800,60646
36032,13520,22512,1358,434500,60647
22334,5387,16947,920,165600,60649
19932,8812,11120,1078,191500,60651
13093,10926,2167,1207,183900,60652
15934,4433,11501,781,298700,60653
13181,4958,8223,2270,462000,60654
10386,8754,1632,1109,262100,60655
12523,7511,5012,1204,304500,60656
36931,14173,22758,1611,464500,60657
13709,5844,7865,1172,303900,60659
20623,7216,13407,1091,258600,60660
6384,2110,4274,2100,396100,60661
8793,6662,2131,1095,297100,60706
15490,9831,5659,1157,267000,60707
4405,3578,827,2195,394900,60712
11139,8467,2672,1133,289600,60714
9161,6013,3148,980,165200,60803
22708,11773,10935,951,174500,60804
7161,5716,1445,1160,200900,60805
10485,4281,6204,908,94300,60827
13362,7844,5518,868,115600,60901
207,143,64,855,97800,60910
547,406,141,926,136600,60911
262,208,54,721,86700,60912
750,663,87,499,188800,60913
9561,6826,2735,998,187300,60914
3958,2534,1424,984,118700,60915
178,157,21,863,157200,60917
331,298,33,675,86800,60918
232,175,57,961,114000,60919
71,61,10,813,126400,60920
716,514,202,585,96800,60921
982,717,265,840,144000,60922
674,547,127,664,121500,60924
24,24,0,-,72200,60926
894,690,204,880,142400,60927
261,209,52,835,94800,60928
268,183,85,750,96100,60929
308,241,67,967,120200,60930
198,164,34,810,105000,60931
130,122,8,-,587800,60932
152,106,46,693,75700,60933
90,76,14,656,166700,60934
428,394,34,989,198400,60935
1957,1395,562,591,118900,60936
749,584,165,598,110600,60938
1075,891,184,964,230500,60940
781,617,164,733,180900,60941
2389,1695,694,643,60400,60942
112,98,14,930,86500,60945
206,151,55,843,58300,60946
701,634,67,710,199300,60948
263,177,86,492,75900,60949
4712,3055,1657,886,191900,60950
356,236,120,719,143600,60951
215,180,35,697,75000,60952
1051,786,265,635,80800,60953
2124,1491,633,809,137600,60954
600,522,78,635,97100,60955
2171,1690,481,652,109700,60957
679,417,262,689,74400,60958
495,351,144,577,83300,60959
324,257,67,641,62500,60960
317,281,36,1097,128500,60961
247,158,89,781,58300,60962
553,396,157,792,82500,60963
1910,1423,487,679,148300,60964
710,518,192,599,64300,60966
185,164,21,538,77200,60968
23,17,6,-,69300,60969
3102,2151,951,661,93700,60970
107,69,38,692,60400,60973
114,90,24,775,102700,60974
530,456,74,850,197000,61001
653,437,216,775,122400,61006
152,130,22,-,113600,61007
12385,9835,2550,862,153900,61008
2880,2194,686,857,176300,61010
797,759,38,1336,225300,61011
822,672,150,950,124800,61012
177,157,20,485,92100,61013
511,415,96,769,94800,61014
308,233,75,-,251300,61015
2142,1857,285,775,173100,61016
414,326,88,708,103000,61018
1236,1136,100,896,165200,61019
909,825,84,944,160700,61020
8889,6009,2880,646,118800,61021
960,726,234,701,137400,61024
2092,1598,494,691,141500,61025
37,9,28,-,-,61027
936,697,239,786,133900,61028
826,658,168,768,107400,61030
642,442,200,620,90000,61031
13487,8593,4894,674,81700,61032
3228,2502,726,738,237700,61036
56,56,0,-,95200,61037
316,304,12,-,161000,61038
333,257,76,633,134200,61039
652,415,237,639,110200,61041
254,181,73,523,174500,61042
49,30,19,782,150000,61043
81,68,13,-,83900,61044
1046,881,165,671,131900,61046
683,582,101,781,154900,61047
1634,1399,235,508,129200,61048
220,167,53,833,152800,61049
106,90,16,-,-,61050
641,502,139,620,94200,61051
414,383,31,825,165200,61052
1157,900,257,606,96300,61053
1858,1178,680,625,102400,61054
20,20,0,-,-,61057
101,51,50,1076,91300,61059
624,490,134,548,127600,61060
3071,2171,900,690,160500,61061
747,604,143,741,155200,61062
1726,1520,206,847,135200,61063
1708,1180,528,737,139700,61064
3614,3066,548,1377,156300,61065
355,293,62,790,157500,61067
5794,3431,2363,805,126600,61068
564,497,67,850,144100,61070
5897,4277,1620,701,87400,61071
4399,3774,625,753,170300,61072
6979,5850,1129,1137,178200,61073
2185,1458,727,600,80700,61074
440,382,58,675,160400,61075
0,0,0,-,-,61077
489,423,66,617,121800,61078
74,67,7,-,95600,61079
3976,2951,1025,795,127200,61080
8659,5999,2660,699,108600,61081
1214,1062,152,794,158600,61084
1364,1011,353,715,101200,61085
619,508,111,615,87100,61087
2472,2189,283,890,158400,61088
289,221,68,714,120600,61089
29,29,0,-,-,61091
7440,4130,3310,782,68600,61101
6468,3909,2559,732,69200,61102
10637,5506,5131,776,88100,61103
8210,3006,5204,696,64500,61104
13542,9002,4540,883,127100,61107
12066,7622,4444,844,105100,61108
10648,6652,3996,782,103400,61109
9539,6488,3051,882,113300,61111
53,0,53,-,-,61112
6391,4473,1918,1060,156200,61114
8583,6700,1883,969,127200,61115
15628,9569,6059,717,106200,61201
409,381,28,678,123000,61230
2243,1507,736,758,110000,61231
578,528,50,835,136200,61232
485,374,111,640,131800,61234
694,573,121,736,99900,61235
30,22,8,-,88900,61236
1147,1010,137,832,110900,61238
547,160,387,823,91200,61239
2487,2197,290,1000,185200,61240
2909,2457,452,727,149100,61241
495,430,65,798,157000,61242
102,90,12,-,258800,61243
9171,6317,2854,693,115900,61244
1250,923,327,779,142400,61250
156,156,0,-,161800,61251
2439,1859,580,687,132500,61252
4605,3714,891,795,178500,61254
843,674,169,916,147500,61256
370,307,63,722,85400,61257
65,64,1,-,73500,61258
551,494,57,975,178200,61259
315,232,83,537,87900,61260
318,259,59,903,84800,61261
392,336,56,735,137200,61262
248,167,81,608,99000,61263
4853,3601,1252,782,140000,61264
18674,12491,6183,778,125700,61265
2676,2215,461,791,135500,61270
513,428,85,575,89400,61272
1211,1015,196,648,148400,61273
107,79,28,-,126000,61274
1886,1570,316,694,228200,61275
26,26,0,-,143100,61276
1212,1020,192,711,116900,61277
166,145,21,758,189900,61278
429,341,88,860,127100,61279
1036,951,85,816,177200,61281
3593,2005,1588,782,133500,61282
522,443,79,642,91100,61283
803,723,80,1000,199900,61284
663,570,93,688,152100,61285
4076,2637,1439,821,110800,61301
1592,1201,391,754,156900,61310
136,127,9,-,96300,61311
183,148,35,1068,117500,61312
112,104,8,-,201200,61313
358,295,63,822,76500,61314
82,57,25,750,44700,61315
103,80,23,875,100000,61316
208,165,43,758,79200,61317
263,182,81,666,131300,61318
537,467,70,792,123300,61319
265,219,46,811,131800,61320
103,94,9,-,84100,61321
535,412,123,760,55400,61322
44,40,4,-,105400,61323
49,49,0,-,88700,61324
420,357,63,700,137100,61325
891,722,169,706,110000,61326
553,438,115,733,175000,61327
25,25,0,-,-,61328
524,445,79,770,102100,61329
513,426,87,650,117800,61330
0,0,0,-,-,61331
68,64,4,-,73100,61332
122,119,3,-,97900,61333
274,203,71,873,100400,61334
125,104,21,717,119900,61335
230,177,53,670,170200,61336
197,161,36,842,88300,61337
100,68,32,625,83600,61338
159,131,28,678,145300,61340
3090,2247,843,970,152700,61341
3536,2376,1160,692,123100,61342
181,153,28,838,83900,61344
310,285,25,738,100500,61345
32,29,3,-,65000,61346
1845,1509,336,540,112500,61348
447,375,72,629,97500,61349
9947,6890,3057,843,135000,61350
500,385,115,760,131800,61353
4721,3441,1280,761,136100,61354
4621,3361,1260,642,128400,61356
138,119,19,825,72100,61358
185,148,37,585,85000,61359
1273,1022,251,889,184900,61360
472,348,124,721,89700,61361
2357,1538,819,596,112200,61362
138,106,32,575,85300,61363
8427,5735,2692,681,82100,61364
362,243,119,904,178500,61367
572,476,96,693,98800,61368
712,589,123,683,99700,61369
573,452,121,665,145500,61370
57,45,12,667,153800,61372
829,722,107,907,196400,61373
57,44,13,-,108300,61374
474,441,33,722,120600,61375
868,637,231,1017,105900,61376
677,492,185,649,110300,61377
122,103,19,981,132700,61378
566,456,110,773,82200,61379
13494,8062,5432,621,78500,61401
1574,1102,472,575,76300,61410
194,154,40,728,86300,61411
586,554,32,650,78100,61412
409,342,67,759,121600,61413
319,257,62,617,82600,61414
842,709,133,612,90300,61415
110,94,16,-,32500,61416
128,117,11,-,78500,61417
312,273,39,775,79100,61418
53,42,11,592,82500,61419
402,345,57,718,78800,61420
564,461,103,809,79000,61421
1198,909,289,611,74700,61422
266,208,58,-,154700,61423
21,18,3,-,68200,61424
226,216,10,-,85000,61425
31,31,0,-,103500,61426
860,756,104,727,91300,61427
376,370,6,-,196600,61428
294,222,72,671,93300,61430
114,107,7,-,99400,61431
261,236,25,-,78400,61432
32,25,7,-,-,61433
1289,968,321,639,73200,61434
6,6,0,-,-,61435
300,251,49,648,135600,61436
360,265,95,-,109200,61437
290,256,34,654,109300,61438
108,84,24,900,82500,61439
312,266,46,683,76200,61440
418,355,63,584,79600,61441
319,268,51,533,56200,61442
5603,3906,1697,639,64000,61443
439,415,24,583,85700,61447
1399,1194,205,635,114400,61448
143,134,9,475,44900,61449
820,718,102,582,81600,61450
83,72,11,-,109400,61451
100,95,5,-,67400,61452
260,187,73,638,71300,61453
202,149,53,534,66400,61454
7491,4015,3476,747,107400,61455
239,204,35,679,82400,61458
151,133,18,-,86800,61459
121,109,12,731,90600,61460
4396,3117,1279,595,86900,61462
550,467,83,529,89300,61465
121,107,14,500,78200,61466
437,346,91,829,88200,61467
60,60,0,-,67400,61468
1004,840,164,639,84700,61469
222,204,18,750,93200,61470
43,43,0,-,49600,61471
250,208,42,625,148400,61472
550,428,122,564,82500,61473
101,74,27,-,58000,61474
101,86,15,528,105400,61475
178,161,17,-,82100,61476
219,189,30,758,71400,61477
90,90,0,-,109500,61478
41,41,0,-,87200,61479
448,314,134,633,101400,61480
256,207,49,654,65000,61482
831,639,192,662,92400,61483
363,315,48,-,49600,61484
177,146,31,629,83000,61485
595,510,85,632,114800,61486
531,434,97,530,98600,61488
351,283,68,530,92900,61489
470,378,92,655,115600,61490
933,782,151,590,94300,61491
835,614,221,574,55500,61501
285,255,30,648,118500,61516
1193,1021,172,727,232600,61517
86,72,14,588,104300,61519
6359,4735,1624,614,110700,61520
4329,3456,873,841,136400,61523
156,116,40,813,102400,61524
3192,2648,544,1097,265400,61525
295,295,0,-,215400,61526
1016,902,114,1262,251000,61528
1007,756,251,640,121600,61529
2608,1617,991,638,142700,61530
1315,1059,256,732,104500,61531
249,202,47,737,95000,61532
792,640,152,685,137300,61533
690,552,138,783,144200,61534
657,646,11,-,213300,61535
1251,994,257,797,156800,61536
1167,878,289,563,94500,61537
68,56,12,694,65000,61539
1000,820,180,773,108100,61540
55,47,8,-,81900,61541
1436,1147,289,646,101800,61542
72,50,22,588,46700,61543
297,252,45,950,84000,61544
284,264,20,906,187500,61545
1582,1341,241,646,122000,61546
1455,1392,63,483,189900,61547
4417,3858,559,934,222900,61548
7212,5666,1546,872,204600,61550
90,90,0,-,87200,61552
82,67,15,672,62100,61553
17629,12732,4897,695,108300,61554
1290,1069,221,790,142000,61559
327,286,41,669,171000,61560
893,682,211,725,136400,61561
44,44,0,-,77100,61562
206,182,24,614,58300,61563
327,255,72,794,82900,61564
662,559,103,666,136900,61565
215,169,46,827,102600,61567
1610,1185,425,740,191200,61568
404,391,13,-,155600,61569
726,595,131,777,88400,61570
9521,7448,2073,801,177300,61571
511,363,148,725,88000,61572
449,78,371,568,195000,61602
6541,3044,3497,829,66100,61603
11985,8208,3777,781,89900,61604
5726,2260,3466,703,42200,61605
2554,1100,1454,787,109800,61606
4373,3835,538,886,134900,61607
2257,1718,539,614,76800,61610
10233,7755,2478,736,147600,61611
13175,8134,5041,837,148100,61614
9472,5840,3632,892,180200,61615
2788,1548,1240,785,86000,61616
0,0,0,-,-,61625
15197,8369,6828,764,115900,61701
14834,9720,5114,901,196800,61704
4648,3754,894,1060,259100,61705
77,67,10,850,83700,61720
276,236,40,943,128400,61721
206,183,23,925,103100,61722
1055,906,149,769,108300,61723
184,162,22,738,103000,61724
647,611,36,1068,255300,61725
949,630,319,716,113400,61726
4038,2792,1246,695,96800,61727
432,330,102,753,115500,61728
460,421,39,736,201100,61729
155,126,29,1042,144400,61730
40,26,14,-,-,61731
726,643,83,857,159200,61732
405,306,99,925,159800,61733
1081,887,194,711,127700,61734
170,154,16,1025,187500,61735
717,632,85,1078,229000,61736
164,147,17,591,124700,61737
1535,1231,304,838,136400,61738
1883,1272,611,729,134700,61739
581,476,105,745,115500,61740
654,499,155,604,138700,61741
492,447,45,907,211500,61742
66,63,3,-,96300,61743
728,587,141,620,129700,61744
1676,1391,285,715,162800,61745
581,420,161,794,156500,61747
948,874,74,-,174900,61748
319,271,48,703,66300,61749
61,49,12,-,65400,61750
39,32,7,-,76700,61751
1708,1429,279,640,142000,61752
1137,951,186,732,182000,61753
432,334,98,1095,121500,61754
1881,1654,227,815,176000,61755
871,680,191,683,122000,61756
579,476,103,693,125900,61759
968,755,213,867,111900,61760
19719,11249,8470,851,169100,61761
5338,3542,1796,791,106900,61764
246,212,34,675,87300,61769
452,361,91,731,98100,61770
235,217,18,933,155100,61771
87,72,15,-,259100,61772
156,131,25,642,82100,61773
363,292,71,837,110000,61774
138,120,18,908,112700,61775
491,432,59,1054,188000,61776
488,416,72,677,170800,61777
265,260,5,-,78000,61778
12058,3672,8386,818,145600,61801
9011,5030,3981,869,134200,61802
111,92,19,581,102800,61810
304,242,62,780,96900,61811
133,118,15,-,93300,61812
689,557,132,758,91000,61813
459,413,46,758,98000,61814
124,103,21,598,136000,61815
169,144,25,862,114300,61816
1086,852,234,742,100400,61817
641,527,114,824,106000,61818
14307,3076,11231,871,151700,61820
13189,7475,5714,949,144500,61821
10452,7315,3137,1091,228700,61822
185,160,25,736,111100,61830
83,83,0,-,126600,61831
14291,8669,5622,689,67200,61832
1005,729,276,740,70600,61833
2683,2267,416,701,130900,61834
252,199,53,730,84700,61839
238,221,17,-,231900,61840
482,440,42,621,128600,61841
1064,906,158,675,130800,61842
832,667,165,716,146000,61843
370,330,40,863,117900,61844
161,149,12,-,-,61845
2179,1632,547,653,74800,61846
502,452,50,675,148700,61847
67,51,16,617,69500,61848
853,740,113,779,141000,61849
156,144,12,678,59200,61850
153,125,28,617,101700,61851
89,88,1,-,-,61852
4828,4090,738,991,225700,61853
557,461,96,945,132500,61854
39,39,0,-,78500,61855
3258,2609,649,977,181400,61856
72,61,11,725,59800,61857
1087,952,135,600,115400,61858
479,433,46,945,142900,61859
250,208,42,635,143300,61862
295,266,29,850,150000,61863
583,537,46,916,168500,61864
565,483,82,631,97400,61865
5481,2799,2682,785,95400,61866
492,347,145,743,74800,61870
138,115,23,1325,143800,61871
253,227,26,738,121500,61872
2137,1860,277,626,198000,61873
3435,1853,1582,919,222200,61874
287,276,11,-,235200,61875
246,219,27,771,67200,61876
596,504,92,893,158000,61877
560,455,105,720,99200,61878
1464,1134,330,681,181700,61880
284,270,14,779,102800,61882
1713,1339,374,625,78000,61883
398,370,28,560,235400,61884
1535,1100,435,756,130200,61910
1751,1303,448,623,152400,61911
639,541,98,648,84200,61912
610,520,90,669,89200,61913
834,668,166,815,89700,61914
243,184,59,-,69300,61917
338,290,48,538,123400,61919
9166,4787,4379,716,117300,61920
971,718,253,665,88300,61924
425,368,57,657,112700,61925
344,294,50,958,93400,61928
332,273,59,675,89600,61929
256,217,39,815,67500,61930
492,399,93,748,123100,61931
240,182,58,747,68100,61932
448,344,104,310,63700,61933
99,88,11,-,122500,61936
825,568,257,577,81000,61937
9159,5634,3525,621,92700,61938
155,122,33,572,47900,61940
60,60,0,-,84400,61941
497,442,55,725,97900,61942
782,613,169,475,84800,61943
5541,4085,1456,654,85600,61944
85,71,14,517,73900,61949
3076,2401,675,750,125000,61951
2500,1748,752,769,134100,61953
72,56,16,975,52000,61955
1218,977,241,711,100500,61956
722,606,116,691,86300,61957
682,533,149,603,148000,62001
13430,8785,4645,809,94900,62002
177,177,0,-,133900,62006
762,543,219,713,67500,62009
4469,3605,864,818,144800,62010
101,101,0,-,161700,62011
2396,2146,250,731,141100,62012
224,189,35,675,105800,62013
1458,1173,285,774,154400,62014
239,183,56,950,91000,62015
1479,1060,419,692,105600,62016
569,482,87,494,87400,62017
1123,871,252,755,74600,62018
148,112,36,944,-,62019
387,387,0,-,188900,62021
387,360,27,-,219100,62022
30,30,0,-,56000,62023
4107,3028,1079,739,104900,62024
12548,9174,3374,941,229000,62025
238,216,22,-,101300,62027
304,241,63,660,143800,62028
55,30,25,885,58000,62030
284,275,9,-,104900,62031
339,307,32,695,80200,62032
1979,1454,525,669,90500,62033
5528,3953,1575,997,222400,62034
7051,5589,1462,1020,148000,62035
277,247,30,675,179300,62036
790,651,139,-,193800,62037
17726,12170,5556,755,86200,62040
855,707,148,546,100100,62044
175,169,6,-,141100,62045
282,218,64,794,175000,62046
507,441,66,575,120500,62047
747,565,182,833,69100,62048
2567,1938,629,691,95700,62049
116,96,20,634,92500,62050
369,245,124,768,110500,62051
4789,3666,1123,629,141700,62052
182,135,47,521,69100,62053
152,115,37,625,81700,62054
4048,2937,1111,562,98700,62056
345,255,90,717,83100,62058
172,74,98,376,31600,62059
2017,824,1193,768,46700,62060
687,563,124,839,170300,62061
3427,2794,633,889,205100,62062
413,310,103,735,121700,62063
52,52,0,-,-,62065
824,729,95,622,189800,62067
1455,1141,314,685,82200,62069
0,0,0,-,-,62070
485,463,22,636,187500,62074
1414,1130,284,710,74200,62075
59,44,15,-,85000,62076
111,100,11,667,62900,62077
28,22,6,-,55000,62078
88,80,8,-,-,62079
855,762,93,687,101000,62080
114,108,6,-,76500,62081
1031,837,194,625,68700,62082
105,105,0,-,205500,62083
710,523,187,782,82100,62084
61,45,16,-,73500,62085
501,459,42,690,90200,62086
876,543,333,687,79300,62087
2834,2027,807,738,106800,62088
192,147,45,720,70400,62089
505,207,298,689,47000,62090
138,113,25,-,78100,62091
1106,834,272,575,68200,62092
143,113,30,777,54000,62093
373,292,81,500,54800,62094
4434,3004,1430,796,87900,62095
1073,1009,64,817,174500,62097
7,7,0,-,-,62098
2687,775,1912,303,48700,62201
3138,2260,878,937,55800,62203
3526,1647,1879,589,45500,62204
3151,1900,1251,809,53500,62205
5475,2560,2915,903,48500,62206
3823,1271,2552,562,48900,62207
6830,4217,2613,1044,146400,62208
556,478,78,636,154200,62214
776,582,194,803,170100,62215
945,749,196,894,178700,62216
378,297,81,1054,85700,62217
698,655,43,488,178100,62218
430,362,68,872,88800,62219
7521,5148,2373,866,113000,62220
12611,8666,3945,918,164500,62221
7620,5811,1809,846,122000,62223
1481,16,1465,1528,-,62225
11997,7965,4032,789,134200,62226
2685,2224,461,734,160900,62230
2795,2086,709,844,131000,62231
2429,1874,555,990,102700,62232
2759,1994,765,622,100400,62233
13713,9706,4007,881,139900,62234
5175,4582,593,920,240400,62236
1053,935,118,682,114700,62237
252,185,67,803,66300,62238
1936,1472,464,847,75600,62239
551,308,243,1036,84400,62240
355,323,32,709,103800,62241
514,467,47,564,91200,62242
2255,1850,405,945,212700,62243
407,321,86,843,202300,62244
780,686,94,684,157800,62245
3655,2374,1281,545,126500,62246
158,120,38,594,139800,62248
6559,5044,1515,744,176700,62249
259,241,18,725,89800,62250
297,230,67,536,81800,62253
2281,1485,796,953,146900,62254
317,280,37,779,129900,62255
994,782,212,714,89800,62257
3334,2560,774,966,174600,62258
2747,2330,417,908,194800,62260
39,39,0,-,63600,62261
786,695,91,656,79800,62262
2138,1645,493,720,131300,62263
1301,1081,220,816,133300,62264
1720,1304,416,950,152500,62265
0,0,0,-,-,62266
369,302,67,538,123500,62268
12419,9132,3287,1131,211400,62269
832,647,185,753,122100,62271
660,477,183,664,131500,62272
85,75,10,-,82500,62273
2779,2079,700,449,83100,62274
1267,1059,208,794,156900,62275
496,402,94,643,99400,62277
2563,1955,608,734,162000,62278
6,6,0,-,-,62279
214,195,19,-,175600,62280
958,909,49,1156,217000,62281
201,181,20,740,120300,62282
222,194,28,682,108900,62284
1745,1554,191,775,195300,62285
2643,1791,852,649,110000,62286
1191,888,303,657,124700,62288
114,80,34,872,55000,62289
341,223,118,640,62300,62292
1685,1312,373,666,174400,62293
5283,4204,1079,884,202100,62294
530,420,110,1038,161600,62295
182,144,38,-,282000,62297
7033,5817,1216,786,222100,62298
13618,8146,5472,660,100400,62301
7886,6570,1316,780,173700,62305
376,277,99,-,88100,62311
773,588,185,551,79600,62312
191,172,19,-,66700,62313
273,187,86,665,125800,62314
296,223,73,247,58200,62316
103,94,9,-,77100,62319
863,655,208,842,134800,62320
1623,1283,340,638,98300,62321
82,71,11,-,89200,62323
509,402,107,430,122100,62324
161,132,29,1273,95600,62325
967,732,235,684,86000,62326
798,632,166,722,77500,62330
67,56,11,-,64400,62334
16,15,1,-,57000,62336
445,445,0,-,160800,62338
381,315,66,544,105300,62339
742,532,210,466,82500,62340
1387,1073,314,688,95000,62341
319,272,47,628,62500,62343
12,4,8,-,-,62344
177,139,38,529,86800,62345
77,77,0,-,77900,62346
693,614,79,529,186200,62347
38,37,1,-,73800,62348
315,283,32,547,96800,62349
704,606,98,759,115400,62351
109,84,25,1000,66900,62352
1421,997,424,525,98800,62353
543,419,124,728,118800,62354
308,290,18,-,70000,62355
225,180,45,525,64900,62356
144,111,33,607,85000,62357
214,209,5,-,110400,62358
55,55,0,-,96400,62359
667,572,95,824,104300,62360
116,106,10,-,95000,62361
147,121,26,513,62300,62362
2306,1863,443,567,103700,62363
201,184,17,563,96500,62365
591,472,119,618,69900,62366
543,453,90,607,83800,62367
129,121,8,-,80400,62370
118,118,0,-,76300,62373
190,178,12,613,78400,62374
275,260,15,-,152900,62375
452,316,136,743,126700,62376
394,344,50,426,88100,62378
778,663,115,598,83600,62379
133,118,15,807,35400,62380
7874,5701,2173,634,161000,62401
449,423,26,485,96000,62410
1755,1368,387,765,121300,62411
138,116,22,-,143800,62413
707,589,118,503,111100,62414
1269,863,406,1271,65500,62417
848,676,172,583,98100,62418
103,95,8,683,47500,62419
2045,1649,396,710,82900,62420
201,185,16,811,65600,62421
453,359,94,494,103600,62422
203,192,11,-,116900,62423
890,738,152,625,161200,62424
226,226,0,-,88000,62425
361,310,51,656,64800,62426
839,742,97,533,90200,62427
1145,934,211,569,84000,62428
366,288,78,658,72100,62431
299,282,17,-,-,62432
468,381,87,636,81100,62433
134,134,0,-,152800,62434
226,198,28,525,64700,62436
113,113,0,-,122500,62438
3170,2181,989,712,82600,62439
528,425,103,617,118800,62440
2972,2236,736,702,116100,62441
1181,887,294,583,75800,62442
625,576,49,-,139800,62443
173,173,0,-,109200,62444
427,375,52,525,156400,62445
150,125,25,775,83500,62446
1289,1067,222,582,127900,62447
2263,1786,477,643,96100,62448
1488,1079,409,588,84200,62449
5154,3568,1586,562,92100,62450
902,715,187,634,77700,62451
119,89,30,538,46900,62452
3991,2989,1002,658,106600,62454
824,742,82,605,87100,62458
112,100,12,-,76000,62459
485,360,125,641,78900,62460
307,280,27,492,164100,62461
471,413,58,489,121000,62462
491,440,51,596,102600,62463
348,294,54,830,99700,62465
1179,961,218,641,84600,62466
1527,1256,271,632,181400,62467
976,700,276,693,89000,62468
223,200,23,-,-,62469
3649,2767,882,615,93800,62471
483,437,46,489,90800,62473
325,295,30,625,74500,62474
182,182,0,-,104800,62475
629,579,50,467,78500,62476
228,201,27,-,75500,62477
107,91,16,-,100800,62478
297,215,82,720,136500,62479
234,205,29,581,87800,62480
141,136,5,-,-,62481
1000,904,96,778,150500,62501
743,445,298,590,73700,62510
202,169,33,541,79900,62512
646,528,118,969,105000,62513
156,106,50,-,82400,62514
399,296,103,796,134200,62515
77,44,33,746,62000,62517
59,41,18,-,-,62518
37,37,0,-,-,62519
659,575,84,939,170000,62520
14582,10673,3909,740,105700,62521
6094,4015,2079,709,88700,62522
336,2,334,307,-,62523
14171,8305,5866,650,79700,62526
643,492,151,929,115800,62530
657,557,100,766,102300,62531
44,44,0,-,89200,62532
392,320,72,608,114700,62533
525,410,115,681,85100,62534
1282,1172,110,1610,226500,62535
217,217,0,-,212100,62536
54,54,0,-,75200,62537
197,167,30,613,91500,62538
509,424,85,705,91000,62539
666,490,176,693,76900,62540
10,10,0,-,-,62541
195,124,71,491,96000,62543
645,581,64,668,115900,62544
520,469,51,675,144200,62545
654,557,97,652,101400,62546
382,350,32,772,84900,62547
981,847,134,533,117700,62548
2302,1811,491,687,141300,62549
1215,982,233,809,106900,62550
313,262,51,581,89500,62551
154,147,7,669,100900,62553
559,497,62,776,126500,62554
175,158,17,713,122600,62555
163,155,8,-,70600,62556
3174,2421,753,634,89000,62557
1344,1127,217,904,152100,62558
446,334,112,765,92000,62560
2347,1607,740,879,152700,62561
2165,2045,120,1035,215000,62563
3178,2307,871,698,109800,62565
393,288,105,796,96300,62567
6463,4487,1976,679,97800,62568
239,220,19,443,66100,62570
712,567,145,759,92800,62571
236,191,45,580,128800,62572
581,458,123,584,108300,62573
123,109,14,-,101100,62601
60,45,15,719,46600,62610
460,423,37,715,117100,62611
725,560,165,753,107900,62612
1596,1306,290,799,173800,62613
2069,1752,317,911,132400,62615
294,252,42,606,66900,62617
2785,1998,787,616,76300,62618
439,349,90,586,79500,62621
0,0,0,-,-,62622
172,161,11,-,58900,62624
350,319,31,835,228800,62625
3011,2176,835,854,107000,62626
426,335,91,936,79400,62627
334,284,50,592,90900,62628
5358,4355,1003,1018,201600,62629
258,248,10,-,103000,62630
137,95,42,727,94100,62631
250,227,23,758,67700,62633
398,319,79,592,122000,62634
243,168,75,768,110400,62635
553,487,66,811,109200,62638
132,98,34,-,112500,62639
1315,1008,307,822,128300,62640
579,437,142,588,78400,62642
278,172,106,827,75300,62643
2078,1486,592,660,83900,62644
188,113,75,752,82200,62649
10256,6648,3608,681,118000,62650
249,201,48,725,84700,62655
7004,4595,2409,716,107800,62656
550,433,117,805,107900,62661
83,76,7,475,88000,62663
1379,1085,294,612,87700,62664
617,506,111,483,61100,62665
199,162,37,769,92500,62666
254,203,51,600,131300,62667
584,509,75,611,102000,62668
1061,873,188,635,159600,62670
216,165,51,668,112500,62671
85,77,8,-,65000,62672
179,136,43,341,96400,62673
669,503,166,620,92300,62674
2532,1959,573,769,161100,62675
884,761,123,626,149200,62677
2087,1537,550,763,101800,62681
299,269,30,641,71300,62682
2127,1864,263,942,246300,62684
874,686,188,558,121300,62685
331,275,56,820,94700,62688
249,227,22,732,73400,62689
1652,1167,485,723,97200,62690
939,708,231,550,82400,62691
874,732,142,720,92700,62692
633,536,97,803,158000,62693
1223,1022,201,528,106600,62694
111,92,19,713,106500,62695
529,23,506,477,-,62701
15254,9506,5748,773,84500,62702
12519,7069,5450,830,86000,62703
19102,11368,7734,817,138700,62704
3338,2967,371,843,141400,62707
6871,5739,1132,1027,241500,62711
4352,3783,569,918,214900,62712
8508,6178,2330,627,77800,62801
460,286,174,752,110300,62803
1490,1106,384,645,94300,62806
431,374,57,425,146300,62807
678,512,166,750,105900,62808
57,57,0,-,61700,62809
396,335,61,430,89500,62810
116,95,21,669,31900,62811
4649,3376,1273,644,84500,62812
719,603,116,678,87000,62814
97,73,24,419,56500,62815
532,449,83,652,75300,62816
313,242,71,766,-,62817
154,148,6,-,68600,62818
148,132,16,720,49500,62819
64,54,10,-,44000,62820
3232,2601,631,656,83900,62821
1292,830,462,667,64300,62822
692,557,135,569,106000,62823
726,546,180,465,80000,62824
77,61,16,-,46800,62825
578,409,169,361,70700,62827
597,528,69,488,118900,62828
31,0,31,-,-,62829
611,455,156,327,90500,62830
185,159,26,475,102600,62831
3816,2602,1214,612,89700,62832
143,110,33,-,65000,62833
476,421,55,436,67900,62835
298,245,53,813,90800,62836
4087,2964,1123,604,92400,62837
742,612,130,613,73700,62838
2688,1919,769,625,83500,62839
29,29,0,-,47000,62841
314,272,42,692,68900,62842
107,66,41,-,37100,62843
863,641,222,665,67800,62844
326,224,102,598,78600,62846
259,205,54,696,74600,62848
826,713,113,588,83800,62849
204,133,71,281,-,62850
60,56,4,-,108900,62851
38,38,0,-,53500,62852
388,318,70,846,85700,62853
759,654,105,525,77400,62854
143,115,28,761,52700,62856
1246,847,399,664,95300,62858
2303,1748,555,649,105200,62859
214,194,20,-,84200,62860
56,49,7,-,-,62861
127,124,3,-,60000,62862
4107,3221,886,669,80500,62863
9742,6450,3292,735,94000,62864
813,746,67,640,145500,62865
206,184,22,447,63800,62867
703,600,103,731,84600,62868
1000,813,187,304,79300,62869
882,684,198,819,82300,62870
222,204,18,435,83300,62871
386,358,28,719,83000,62872
199,170,29,588,51100,62874
457,407,50,688,82500,62875
69,63,6,-,60800,62876
204,175,29,867,88100,62877
168,161,7,-,55600,62878
47,43,4,-,-,62879
282,246,36,425,83700,62880
4658,3331,1327,663,86300,62881
948,754,194,573,66500,62882
254,226,28,-,160000,62883
1103,958,145,579,76600,62884
197,148,49,459,95100,62885
136,121,15,-,87500,62886
111,89,22,1111,43800,62887
953,790,163,644,86900,62888
408,339,69,-,121100,62889
991,746,245,829,76700,62890
292,265,27,521,62800,62891
131,109,22,528,101300,62892
351,281,70,733,94200,62893
408,357,51,492,125400,62894
756,618,138,627,88200,62895
5024,3609,1415,634,76800,62896
169,143,26,850,85800,62897
748,649,99,775,140300,62898
593,502,91,705,85900,62899
11448,3778,7670,690,135300,62901
1834,1261,573,694,170500,62902
1294,588,706,719,157900,62903
231,191,40,-,117700,62905
2815,2044,771,701,106500,62906
691,610,81,618,121300,62907
251,222,29,625,138000,62908
954,830,124,660,74400,62910
583,481,102,700,72900,62912
924,674,250,652,30000,62914
124,93,31,539,72700,62915
283,234,49,-,157600,62916
907,717,190,725,65500,62917
4013,2843,1170,815,154000,62918
313,294,19,330,72400,62919
1339,1114,225,402,139200,62920
136,116,20,-,-,62921
1241,1126,115,540,133700,62922
174,155,19,908,72100,62923
1157,655,502,818,80500,62924
827,649,178,661,99300,62926
140,101,39,767,29600,62927
83,46,37,413,65000,62928
2707,2057,650,686,63200,62930
581,433,148,207,78000,62931
501,367,134,633,64300,62932
557,384,173,666,117500,62933
333,278,55,468,91000,62934
795,615,180,675,84800,62935
1248,943,305,326,118800,62938
1188,1037,151,704,136300,62939
212,111,101,623,22500,62940
269,244,25,692,67500,62941
241,187,54,667,28800,62942
130,102,28,-,-,62943
5239,3727,1512,641,87700,62946
185,174,11,-,115600,62947
5733,3827,1906,692,98200,62948
353,173,180,327,61400,62949
63,36,27,-,126300,62950
2064,1674,390,546,67900,62951
1220,998,222,626,102300,62952
89,57,32,613,36900,62953
327,270,57,-,104800,62954
350,286,64,655,64900,62956
304,187,117,849,55200,62957
797,616,181,700,130600,62958
11449,7695,3754,737,142500,62959
4322,3208,1114,728,90200,62960
12,12,0,-,33300,62961
0,0,0,-,-,62962
248,120,128,531,30700,62963
531,405,126,492,34800,62964
23,16,7,563,-,62965
6155,4051,2104,634,100200,62966
116,113,3,-,82500,62967
152,111,41,797,57900,62969
266,207,59,471,69300,62970
412,393,19,738,170900,62972
775,679,96,936,126000,62974
74,74,0,-,-,62975
144,112,32,566,49400,62976
246,210,36,835,88900,62977
533,397,136,519,81800,62979
418,301,117,446,63200,62982
614,474,140,678,60100,62983
658,424,234,421,71600,62984
210,191,19,-,104500,62985
515,458,57,686,89200,62987
481,401,80,518,69200,62988
358,279,79,333,114700,62990
277,211,66,492,86800,62992
271,234,37,635,114300,62994
1418,1016,402,495,103400,62995
115,95,20,-,95000,62996
237,196,41,747,55900,62997
105,83,22,-,84400,62998
671,456,215,583,48100,62999
6937,6155,782,1192,563200,63005
13916,10549,3367,942,166800,63010
14427,12534,1893,1298,292500,63011
3777,3433,344,950,168300,63012
474,474,0,-,222200,63013
350,326,24,629,170900,63014
771,664,107,-,135400,63015
2788,2410,378,863,152300,63016
16425,13232,3193,1229,371600,63017
1819,1272,547,729,143400,63019
8129,6440,1689,774,147200,63020
22050,17988,4062,1113,257700,63021
2063,1775,288,959,154300,63023
5350,4659,691,1061,296800,63025
16988,13433,3555,895,211600,63026
10426,7763,2663,843,162800,63028
105,65,40,-,123400,63030
18136,12974,5162,1107,107500,63031
16441,10914,5527,959,115600,63033
6623,6207,416,1476,179000,63034
572,463,109,768,171600,63036
1220,1080,140,683,158900,63037
2561,2330,231,1264,420400,63038
232,231,1,-,121300,63039
3148,2710,438,1220,332700,63040
180,174,6,-,266300,63041
8687,4568,4119,859,109700,63042
9126,6265,2861,1050,163500,63043
4039,2578,1461,883,173900,63044
0,0,0,-,-,63045
16,16,0,-,-,63047
1375,1059,316,1566,172100,63048
6428,5490,938,861,169800,63049
5985,5007,978,816,195900,63050
4806,3879,927,959,153900,63051
10265,8461,1804,882,194600,63052
40,25,15,892,181900,63053
710,592,118,819,265700,63055
815,734,81,574,205300,63056
0,0,0,-,-,63057
903,773,130,973,117300,63060
48,48,0,-,147200,63061
2125,1797,328,721,183900,63068
6164,4529,1635,762,229300,63069
2861,2136,725,729,135900,63070
439,291,148,756,102900,63071
1196,1135,61,-,162700,63072
148,148,0,-,583300,63073
6630,3183,3447,873,92900,63074
4469,3420,1049,786,135300,63077
22,22,0,-,-,63079
5860,4042,1818,734,133100,63080
7509,5450,2059,765,180300,63084
441,355,86,485,184800,63087
4209,2103,2106,1087,184100,63088
2136,1761,375,951,160000,63089
8727,6771,1956,763,198100,63090
519,435,84,475,180600,63091
2420,790,1630,1054,194000,63101
1203,18,1185,1040,-,63102
5177,729,4448,854,174800,63103
9560,4120,5440,935,213300,63104
6621,3737,2884,1318,564100,63105
4338,678,3660,659,135800,63106
4167,1915,2252,774,47700,63107
11434,3124,8310,943,320000,63108
14225,8725,5500,795,186000,63109
8397,3416,4981,933,232800,63110
8465,3244,5221,766,83700,63111
8399,3034,5365,816,160400,63112
4907,2578,2329,760,67700,63113
14874,8373,6501,928,86700,63114
7070,3192,3878,795,54500,63115
19893,10576,9317,811,124300,63116
4368,2427,1941,1004,250100,63117
11964,4600,7364,864,150900,63118
14327,9904,4423,1054,265800,63119
2890,1388,1502,735,47000,63120
11261,5678,5583,825,76800,63121
15855,12612,3243,1135,366000,63122
22473,15902,6571,868,158100,63123
5126,3729,1397,1130,706500,63124
13798,9527,4271,824,130100,63125
6061,5134,927,951,227000,63126
2083,1566,517,2429,466900,63127
13423,10280,3143,959,242800,63128
21649,17089,4560,920,227400,63129
12310,7300,5010,1061,262600,63130
6439,5982,457,2204,613200,63131
5507,3136,2371,1118,327100,63132
3156,1096,2060,881,51000,63133
5321,2623,2698,1009,66300,63134
8883,4957,3926,945,78300,63135
19169,8327,10842,884,65500,63136
8144,4248,3896,909,61100,63137
7167,3494,3673,832,99600,63138
10790,6642,4148,863,158000,63139
140,26,114,773,39200,63140
8536,6222,2314,1236,460800,63141
4888,2080,2808,764,176600,63143
4419,2931,1488,1274,241900,63144
15135,8572,6563,1118,232400,63146
3598,1819,1779,830,61600,63147
0,0,0,-,-,63155
20142,13833,6309,917,185400,63301
20683,15575,5108,1116,231700,63303
15496,13996,1500,1313,256900,63304
70,49,21,561,-,63330
568,522,46,711,354900,63332
321,283,38,659,106700,63333
2962,2030,932,621,97100,63334
413,279,134,654,131300,63336
325,293,32,553,112900,63339
1194,1042,152,1080,345700,63341
1552,1058,494,930,108700,63343
465,362,103,636,177800,63344
275,234,41,388,71300,63345
1000,887,113,826,145700,63347
2984,2698,286,1598,316900,63348
658,584,74,808,192200,63349
247,202,45,675,158100,63350
814,607,207,761,155600,63351
545,396,149,582,81600,63352
1882,1359,523,643,86700,63353
2234,1979,255,994,183200,63357
520,365,155,623,177600,63359
1916,1260,656,613,119700,63361
2579,2041,538,887,165000,63362
771,603,168,691,114300,63363
18783,15699,3084,1033,214000,63366
9461,8050,1411,1162,286800,63367
16396,13704,2692,1222,259000,63368
673,479,194,782,232800,63369
46,12,34,-,-,63370
219,201,18,908,171000,63373
28500,24028,4472,1070,195400,63376
1045,965,80,671,166200,63377
9160,7388,1772,912,171500,63379
177,130,47,1077,-,63381
1271,891,380,626,72800,63382
6150,4544,1606,825,169500,63383
804,642,162,645,75900,63384
15609,13118,2491,1037,245900,63385
193,156,37,521,150000,63386
38,29,9,744,-,63387
412,385,27,-,62000,63388
2406,1869,537,711,154500,63389
3992,3229,763,830,183800,63390
8846,5454,3392,662,131600,63401
213,176,37,1075,125000,63430
127,123,4,-,119900,63431
233,216,17,-,114700,63432
0,0,0,-,-,63433
241,138,103,398,77500,63434
1389,1041,348,564,110900,63435
600,453,147,492,133300,63436
649,500,149,531,69300,63437
152,133,19,-,103700,63438
100,60,40,-,175000,63439
480,338,142,572,99200,63440
418,319,99,672,79400,63441
146,87,59,403,43900,63443
1366,992,374,511,79700,63445
179,140,39,561,54300,63446
405,254,151,486,66100,63447
605,504,101,618,82600,63448
79,49,30,-,-,63450
88,85,3,-,30700,63451
476,414,62,583,81300,63452
177,152,25,631,172700,63453
330,284,46,740,87200,63454
1930,1149,781,592,119400,63456
104,100,4,-,121400,63457
48,28,20,-,75000,63458
1566,1415,151,825,147700,63459
119,115,4,-,71800,63460
2188,1747,441,621,124400,63461
700,572,128,508,111900,63462
250,194,56,579,142100,63463
6,6,0,-,-,63464
137,78,59,-,107500,63465
14,14,0,-,-,63467
1020,759,261,627,67200,63468
470,383,87,595,97900,63469
293,248,45,740,192100,63471
302,231,71,516,-,63472
86,86,0,-,202900,63473
195,151,44,554,145800,63474
7536,4218,3318,640,126200,63501
367,317,50,465,86900,63530
129,124,5,313,74400,63531
535,464,71,531,80500,63532
282,237,45,668,143400,63533
364,315,49,633,78400,63534
16,7,9,-,-,63535
367,275,92,325,150200,63536
727,606,121,560,84000,63537
92,86,6,-,-,63538
95,82,13,-,-,63539
53,52,1,-,-,63540
176,153,23,622,91700,63541
64,56,8,525,68800,63543
321,274,47,338,87300,63544
379,291,88,592,103100,63545
580,491,89,496,107500,63546
200,181,19,667,66000,63547
359,255,104,442,74400,63548
924,660,264,481,101900,63549
75,70,5,-,162500,63551
3061,2031,1030,552,109600,63552
1186,876,310,443,87900,63555
1264,873,391,657,76400,63556
103,103,0,-,237500,63557
244,215,29,1010,109200,63558
605,515,90,363,82600,63559
63,36,27,-,45000,63560
339,208,131,438,66200,63561
170,125,45,-,226300,63563
1343,1021,322,617,88500,63565
42,42,0,-,88600,63566
46,34,12,581,76200,63567
6469,4101,2368,647,87100,63601
469,367,102,460,95000,63620
624,424,200,575,94500,63621
599,457,142,-,100900,63622
283,224,59,717,76800,63623
1511,1148,363,672,82400,63624
158,143,15,-,142200,63625
477,449,28,-,97000,63626
1420,1198,222,700,177500,63627
4937,3643,1294,679,137900,63628
482,425,57,241,111200,63629
1366,1076,290,698,76900,63630
400,313,87,903,154300,63631
282,196,86,631,109100,63633
228,147,81,669,83300,63636
517,489,28,-,-,63637
1058,797,261,613,87600,63638
10472,6847,3625,676,148800,63640
4487,3177,1310,688,120200,63645
531,424,107,711,95800,63648
1731,1340,391,763,87500,63650
492,299,193,757,47200,63653
302,259,43,635,175200,63654
608,486,122,599,127000,63655
107,90,17,-,161100,63656
1060,887,173,557,87700,63660
557,516,41,-,96500,63662
333,168,165,574,91800,63663
3534,2557,977,540,101900,63664
89,87,2,-,82500,63665
20,20,0,-,-,63666
4578,3634,944,746,169000,63670
686,570,116,632,157100,63673
0,0,0,-,-,63674
44,44,0,-,60800,63675
14614,9102,5512,816,165000,63701
3702,1488,2214,718,92400,63703
1524,1185,339,608,91900,63730
359,335,24,675,160500,63732
336,206,130,-,52700,63735
1498,1088,410,759,98700,63736
0,0,0,-,-,63738
173,105,68,-,144900,63739
2033,1574,459,817,117000,63740
27,24,3,-,55700,63742
22,22,0,-,175000,63743
25,19,6,-,83800,63744
4,0,4,-,-,63745
25,22,3,-,143800,63746
194,180,14,-,116100,63747
547,507,40,716,115800,63748
9,9,0,-,-,63750
505,422,83,853,142900,63751
9479,7270,2209,890,175600,63755
100,60,40,484,143300,63758
218,186,32,575,191700,63760
91,91,0,-,85800,63763
1987,1484,503,664,108900,63764
552,499,53,488,155900,63766
281,190,91,725,76700,63767
469,414,55,841,147900,63769
48,41,7,1292,-,63770
982,704,278,633,99200,63771
38,16,22,-,-,63774
6504,4583,1921,713,156000,63775
2386,1645,741,679,115000,63780
385,319,66,739,152200,63781
108,96,12,-,101300,63782
30,30,0,-,-,63783
78,55,23,-,70600,63784
399,364,35,763,136200,63785
251,233,18,617,74600,63787
9446,5937,3509,730,119100,63801
87,74,13,1111,58000,63820
314,247,67,490,41300,63821
1001,688,313,650,79900,63822
493,387,106,532,89900,63823
35,15,20,875,181300,63824
1558,1127,431,603,91800,63825
21,21,0,-,50600,63826
277,222,55,547,59700,63827
67,57,10,-,29400,63828
525,282,243,626,51500,63829
2764,1410,1354,656,114200,63830
82,76,6,-,-,63833
1942,1126,816,652,81900,63834
629,382,247,468,45600,63837
169,64,105,658,75000,63839
5286,3457,1829,684,118400,63841
2469,1466,1003,651,85900,63845
531,437,94,639,92700,63846
12,12,0,-,-,63847
406,288,118,716,57200,63848
70,20,50,-,-,63849
1416,667,749,629,72500,63851
569,415,154,544,66400,63852
71,52,19,-,38800,63853
397,326,71,517,60400,63855
5023,2903,2120,546,97200,63857
88,79,9,-,63600,63860
608,336,272,676,65500,63862
2442,1387,1055,602,73700,63863
164,90,74,644,20400,63866
404,284,120,646,76800,63867
343,177,166,532,56900,63868
1576,874,702,649,97200,63869
512,299,213,613,44600,63870
1775,1061,714,664,79500,63873
122,89,33,725,61600,63874
864,556,308,603,78600,63876
1433,755,678,565,109900,63877
38,38,0,-,-,63878
293,232,61,570,60600,63879
60,39,21,-,45000,63880
147,94,53,645,32600,63882
13466,8246,5220,672,119900,63901
0,0,0,-,-,63902
403,279,124,463,65800,63932
1296,944,352,562,67800,63933
82,40,42,-,-,63934
3645,2925,720,601,97300,63935
261,169,92,772,151300,63936
1178,911,267,580,124400,63937
558,471,87,-,82700,63939
615,490,125,611,103900,63940
77,61,16,-,124200,63941
229,183,46,617,97900,63942
177,126,51,742,82300,63943
766,696,70,564,115100,63944
334,293,41,-,176500,63945
104,67,37,-,-,63951
135,112,23,442,96500,63952
534,410,124,522,72300,63953
298,254,44,490,66300,63954
58,45,13,-,"10,000-",63955
418,280,138,424,105300,63956
2534,1830,704,567,81700,63957
1222,961,261,599,95400,63960
658,457,201,614,85800,63961
48,0,48,-,-,63962
89,32,57,-,-,63964
1057,723,334,324,137300,63965
1093,886,207,581,109300,63966
753,560,193,461,93200,63967
321,269,52,645,98600,64001
1444,1249,195,675,255300,64011
10879,7449,3430,1079,151700,64012
9852,6937,2915,1031,174100,64014
11585,8504,3081,979,178300,64015
1849,1490,359,873,176400,64016
126,106,20,675,66300,64017
387,283,104,-,229900,64018
819,723,96,1060,168600,64019
1385,933,452,617,127500,64020
237,212,25,733,76700,64021
47,42,5,731,110000,64022
5732,4138,1594,767,146400,64024
6731,4920,1811,1088,203200,64029
10219,5070,5149,843,117900,64030
3287,2990,297,1388,234800,64034
393,301,92,1044,88500,64035
113,52,61,732,41300,64036
2286,1382,904,703,134100,64037
2387,1993,394,663,164600,64040
1492,1339,153,895,255900,64048
9339,4401,4938,767,96200,64050
9136,5008,4128,882,95400,64052
2192,1081,1111,854,60700,64053
1158,664,494,913,75500,64054
14848,10045,4803,891,134200,64055
5798,3589,2209,930,121700,64056
5971,3591,2380,978,171800,64057
2478,1998,480,1043,140700,64058
5903,4816,1087,1062,241700,64060
1230,1110,120,864,164100,64061
2219,1887,332,907,169000,64062
8361,5468,2893,976,171500,64063
7163,6064,1099,1115,292200,64064
6,0,6,525,-,64065
7,3,4,-,-,64066
2464,1602,862,702,149400,64067
13449,9947,3502,919,197800,64068
1267,1108,159,1049,256300,64070
280,217,63,447,93300,64071
209,184,25,800,74300,64072
241,188,53,1488,260000,64074
4449,3344,1105,826,176500,64075
3379,2538,841,781,175100,64076
711,580,131,930,137700,64077
3617,3147,470,961,187100,64078
5065,3509,1556,1158,240400,64079
4949,3641,1308,908,233300,64080
9750,7358,2392,1101,255200,64081
5866,5106,760,1488,301600,64082
9046,7450,1596,1197,225900,64083
580,523,57,761,208100,64084
3383,2233,1150,641,123000,64085
9114,6968,2146,986,217200,64086
465,403,62,930,184300,64088
4939,4103,836,876,225400,64089
58,53,5,-,101100,64090
18,0,18,-,-,64092
10430,5605,4825,728,166400,64093
460,289,171,703,87800,64096
450,317,133,608,123200,64097
1242,922,320,903,240000,64098
21,15,6,-,-,64101
0,0,0,-,-,64102
3530,481,3049,1242,213800,64105
5180,783,4397,924,170500,64106
4594,1655,2939,1111,219100,64108
4980,1998,2982,802,151800,64109
7411,3336,4075,961,175500,64110
10279,3101,7178,958,206900,64111
4875,2071,2804,1206,368800,64112
4702,4438,264,1574,423000,64113
12864,7883,4981,1067,194000,64114
7838,3552,4286,928,175400,64116
6094,3209,2885,956,122500,64117
17207,10192,7015,971,150200,64118
11578,8390,3188,1064,155500,64119
145,97,48,729,51300,64120
3807,2087,1720,833,74300,64123
4057,2220,1837,690,66800,64124
628,339,289,834,47900,64125
2152,1174,978,775,39100,64126
6626,2803,3823,776,44300,64127
5178,2190,2988,742,48900,64128
3623,1981,1642,852,86100,64129
8522,4553,3969,864,51000,64130
10151,4967,5184,944,159500,64131
5298,2258,3040,845,68800,64132
15128,8801,6327,931,117500,64133
8780,4315,4465,1084,90800,64134
758,421,337,1057,122400,64136
4705,2435,2270,980,140700,64137
10558,6472,4086,905,118800,64138
761,563,198,1306,314900,64139
1811,1567,244,1226,255900,64145
875,766,109,876,177100,64146
129,0,129,532,-,64147
189,159,30,-,306600,64149
1617,602,1015,748,231200,64150
10685,6519,4166,1088,216400,64151
11345,9532,1813,1040,256000,64152
2404,1306,1098,1160,252600,64153
5074,2657,2417,1175,258500,64154
8911,6268,2643,1108,199300,64155
2707,2132,575,1226,296000,64156
6326,5686,640,1572,260900,64157
1988,947,1041,1197,236900,64158
140,88,52,1273,115700,64161
331,137,194,687,162500,64163
54,54,0,-,-,64164
124,124,0,-,420000,64165
135,88,47,-,262000,64166
145,145,0,-,369600,64167
0,0,0,-,-,64192
447,393,54,771,169800,64401
979,718,261,518,79000,64402
27,23,4,-,117500,64420
410,349,61,1073,78900,64421
190,132,58,-,139400,64422
334,279,55,-,121800,64423
1691,1034,657,492,100000,64424
162,117,45,713,71800,64426
233,159,74,565,88500,64427
241,199,42,608,61000,64428
3601,2413,1188,858,152300,64429
323,275,48,755,161100,64430
176,135,41,500,110800,64431
22,21,1,-,82500,64432
18,15,3,-,-,64433
200,179,21,405,175400,64434
378,315,63,1311,187500,64436
221,193,28,720,85800,64437
68,62,6,-,-,64438
588,469,119,634,202800,64439
316,254,62,720,162100,64440
36,30,6,-,-,64441
315,264,51,804,78300,64442
616,451,165,773,259600,64443
535,434,101,623,138800,64444
116,85,31,681,80300,64445
508,360,148,490,78700,64446
449,378,71,729,159700,64448
261,233,28,630,87900,64449
244,183,61,341,67700,64451
93,86,7,-,-,64453
1011,885,126,779,156300,64454
166,127,39,404,89500,64455
570,462,108,275,71100,64456
78,74,4,-,112500,64457
74,66,8,-,65000,64458
212,211,1,-,160800,64459
322,253,69,653,63600,64461
618,440,178,751,108300,64463
1626,1314,312,664,155900,64465
190,141,49,392,85000,64466
82,60,22,-,111300,64467
5926,2872,3054,675,147100,64468
847,568,279,633,101800,64469
712,520,192,492,103000,64470
187,137,50,575,59500,64471
622,490,132,623,90800,64473
375,237,138,679,107400,64474
119,86,33,700,130900,64475
129,100,29,625,100000,64476
1531,1146,385,675,167600,64477
350,272,78,688,108000,64479
135,123,12,-,164800,64480
351,262,89,575,68200,64481
1024,725,299,598,105900,64482
209,190,19,611,117900,64483
346,270,76,548,98100,64484
3137,2271,866,742,140100,64485
135,111,24,-,62800,64486
282,204,78,636,77300,64487
759,603,156,555,103400,64489
684,552,132,698,166200,64490
845,548,297,533,82400,64491
694,590,104,800,161400,64492
160,117,43,937,93800,64493
454,322,132,757,98000,64494
60,23,37,-,46500,64496
169,162,7,550,300000,64497
108,102,6,-,65000,64498
54,51,3,-,82100,64499
4557,1786,2771,734,83200,64501
4839,3233,1606,886,112300,64503
4186,2810,1376,803,86900,64504
5051,3501,1550,808,136500,64505
8921,5458,3463,782,170700,64506
5279,3413,1866,827,109400,64507
4775,3011,1764,684,113400,64601
186,169,17,750,136900,64620
174,136,38,517,104800,64622
134,118,16,792,53800,64623
706,565,141,675,88600,64624
309,212,97,508,71000,64625
2469,1782,687,569,90800,64628
240,210,30,388,141700,64630
292,238,54,350,70500,64631
178,156,22,375,67300,64632
1920,1277,643,683,95200,64633
183,154,29,566,89400,64635
107,96,11,917,50000,64636
216,162,54,491,96700,64637
207,176,31,432,115400,64638
79,62,17,-,60000,64639
1288,975,313,589,122900,64640
271,208,63,431,84500,64641
366,284,82,563,64900,64642
479,381,98,579,124200,64643
1260,933,327,781,120700,64644
62,56,6,225,-,64645
78,67,11,375,77500,64646
185,135,50,617,58400,64647
652,550,102,619,111600,64648
327,297,30,654,109000,64649
343,245,98,719,202200,64650
239,179,60,711,72900,64651
149,117,32,435,70600,64652
271,241,30,565,92400,64653
21,16,5,-,-,64654
85,83,2,-,-,64655
127,90,37,508,89000,64656
169,110,59,476,57800,64657
1243,981,262,531,105900,64658
410,308,102,522,129600,64659
169,161,8,538,73000,64660
382,270,112,475,97400,64661
134,114,20,500,101300,64664
117,93,24,940,37800,64667
646,472,174,767,85300,64668
314,249,65,585,154400,64670
751,597,154,491,113700,64671
55,48,7,-,-,64672
853,713,140,508,81600,64673
132,116,16,289,121400,64674
79,69,10,-,-,64676
332,209,123,440,71000,64679
49,39,10,-,75000,64681
174,160,14,-,85300,64682
3111,2034,1077,624,106800,64683
118,114,4,-,76700,64686
215,169,46,709,-,64688
204,174,30,854,89000,64689
5644,3536,2108,862,171900,64701
1591,1199,392,689,136100,64720
159,134,25,-,106700,64722
339,270,69,827,143100,64723
785,539,246,398,69300,64724
814,585,229,884,157900,64725
153,127,26,938,160600,64726
188,137,51,822,100600,64728
2827,1677,1150,619,124600,64730
479,340,139,639,141300,64733
887,743,144,1065,277800,64734
5587,3785,1802,677,121400,64735
542,472,70,653,120700,64738
343,290,53,693,221400,64739
804,681,123,842,83000,64740
78,64,14,531,87000,64741
893,727,166,739,171200,64742
81,42,39,807,82500,64743
3089,2080,1009,604,91500,64744
23,19,4,-,63800,64745
603,477,126,856,169000,64746
1557,1260,297,808,161300,64747
670,433,237,545,69900,64748
163,145,18,-,101100,64750
245,214,31,750,86200,64752
995,767,228,592,125100,64755
261,209,52,644,49500,64756
3066,1988,1078,678,100200,64759
529,432,97,742,147400,64761
667,519,148,565,74000,64762
629,511,118,642,73200,64763
8,5,3,-,"10,000-",64765
273,253,20,-,59600,64767
299,242,57,588,38800,64769
546,413,133,725,124800,64770
194,167,27,525,154300,64771
5682,3988,1694,639,107500,64772
1645,1291,354,531,111900,64776
187,160,27,-,95000,64778
960,773,187,565,80400,64779
172,141,31,688,78900,64780
45,40,5,-,63300,64781
324,288,36,496,80900,64783
510,408,102,573,79300,64784
674,519,155,685,138200,64788
390,309,81,563,89000,64790
15535,9017,6518,761,120800,64801
14463,10153,4310,773,140000,64804
304,172,132,882,72900,64830
2508,1939,569,674,99300,64831
395,279,116,1000,124300,64832
19,17,2,-,107500,64833
3417,2524,893,955,159200,64834
766,588,178,721,81800,64835
8921,5528,3393,760,134700,64836
1152,959,193,634,140100,64840
156,117,39,711,97500,64841
334,239,95,701,84700,64842
1268,938,330,684,87900,64843
1821,1260,561,766,102900,64844
171,66,105,470,43800,64847
194,161,33,531,85800,64848
75,71,4,-,82300,64849
8647,5611,3036,710,126200,64850
1447,669,778,629,62800,64854
913,793,120,781,136200,64855
1474,935,539,669,152800,64856
152,138,14,808,77000,64857
195,195,0,-,-,64858
504,377,127,495,83300,64859
334,260,74,-,-,64861
1434,1078,356,647,105900,64862
566,336,230,652,129400,64863
1994,1422,572,708,115000,64865
379,328,51,613,77400,64866
478,378,100,753,142000,64867
5658,3693,1965,740,127000,64870
299,291,8,-,84300,64873
217,135,82,480,83800,64874
123,123,0,-,67000,65001
2531,1933,598,954,223100,65010
716,622,94,525,122900,65011
1172,842,330,599,145000,65013
1067,842,225,498,130800,65014
538,497,41,-,176600,65016
416,376,40,-,-,65017
2920,2228,692,650,141300,65018
5637,4465,1172,700,189000,65020
723,628,95,804,203600,65023
447,380,67,582,98400,65024
259,165,94,642,155100,65025
4929,3474,1455,666,124700,65026
618,551,67,541,128800,65032
388,363,25,-,-,65034
685,542,143,497,181700,65035
2106,1876,230,592,194200,65037
1077,1003,74,-,292600,65039
438,397,41,-,144300,65040
2389,1880,509,579,159200,65041
3978,3096,882,822,148600,65043
607,571,36,395,139900,65046
555,338,217,463,302100,65047
59,48,11,-,140300,65048
3154,2421,733,781,252400,65049
195,177,18,583,196700,65050
1773,1354,419,562,146200,65051
1405,1234,171,1011,235500,65052
637,600,37,640,229300,65053
418,394,24,-,180700,65054
402,357,45,500,148300,65058
431,300,131,819,170000,65059
233,214,19,913,75000,65061
8,8,0,-,-,65062
1235,988,247,812,183100,65063
251,236,15,-,140000,65064
2532,1754,778,757,287500,65065
2565,2004,561,614,122200,65066
198,162,36,747,-,65067
302,262,40,533,144300,65068
232,209,23,-,142000,65069
689,626,63,1113,179300,65072
1136,912,224,642,151500,65074
363,321,42,600,171500,65075
289,243,46,513,161800,65076
178,158,20,-,217500,65077
1436,1188,248,762,86800,65078
2098,1886,212,853,239700,65079
495,424,71,1083,214500,65080
1102,732,370,623,120400,65081
346,305,41,585,191000,65082
64,53,11,-,-,65083
2391,1623,768,429,128800,65084
514,450,64,483,225000,65085
10634,6978,3656,673,177600,65101
16668,10780,5888,704,166200,65109
17837,5522,12315,873,186200,65201
18933,11112,7821,927,161200,65202
24944,15389,9555,880,250500,65203
0,0,0,-,-,65215
215,185,30,423,92500,65230
1334,1081,253,532,179600,65231
113,99,14,-,73200,65232
4075,2934,1141,683,154300,65233
548,335,213,421,88100,65236
415,313,102,562,98000,65237
726,688,38,700,137000,65239
3408,2691,717,546,142700,65240
739,675,64,781,147800,65243
165,142,23,-,125000,65244
20,19,1,-,-,65246
256,234,22,-,-,65247
1478,1073,405,726,138100,65248
187,173,14,755,150600,65250
7284,4956,2328,683,151000,65251
754,635,119,549,110000,65254
1547,1168,379,694,165700,65255
548,533,15,763,185000,65256
623,546,77,819,109000,65257
238,211,27,725,161700,65258
986,842,144,683,98100,65259
138,123,15,-,74600,65260
388,268,120,429,98300,65261
271,207,64,831,166600,65262
639,535,104,596,96900,65263
361,324,37,383,90000,65264
5919,3970,1949,638,95800,65265
5966,3738,2228,673,110400,65270
629,491,138,484,141800,65274
1020,872,148,339,111300,65275
648,487,161,608,151500,65276
45,34,11,685,74000,65278
725,676,49,1016,293300,65279
127,97,30,-,104600,65280
1017,805,212,579,100700,65281
91,91,0,-,-,65282
294,290,4,-,214800,65283
910,687,223,758,144800,65284
201,170,31,-,106300,65285
33,30,3,-,79200,65286
142,140,2,-,220000,65287
13171,8756,4415,726,125700,65301
930,31,899,1124,-,65305
24,21,3,-,154200,65320
166,136,30,525,96700,65321
213,176,37,766,107300,65322
335,296,39,488,89000,65323
555,479,76,706,183400,65324
1151,904,247,614,125000,65325
845,676,169,831,119100,65326
67,54,13,725,94000,65327
119,80,39,-,215900,65329
184,132,52,655,108000,65330
612,530,82,600,154500,65332
278,256,22,550,92700,65333
442,292,150,1101,146100,65334
65,59,6,-,88300,65335
2600,1736,864,883,146300,65336
665,439,226,635,130900,65337
1188,960,228,710,104900,65338
155,139,16,1031,70900,65339
5331,3649,1682,666,127000,65340
76,63,13,513,112500,65344
152,137,15,-,204100,65345
372,325,47,638,132700,65347
570,459,111,574,142500,65348
1130,768,362,457,71500,65349
705,619,86,789,170700,65350
832,633,199,658,108500,65351
252,158,94,575,164000,65354
4749,4024,725,696,128400,65355
1725,1309,416,605,100400,65360
13571,7490,6081,730,157700,65401
13,13,0,-,-,65436
984,710,274,525,109000,65438
55,48,7,-,-,65439
156,156,0,-,95900,65440
2318,1796,522,730,154800,65441
36,36,0,-,177500,65443
429,295,134,535,103100,65444
187,92,95,-,-,65446
145,125,20,-,-,65449
946,727,219,682,121300,65452
3685,2560,1125,620,134400,65453
165,136,29,-,81000,65456
99,90,9,-,229200,65457
2426,1928,498,763,139900,65459
62,51,11,-,122500,65461
641,609,32,650,82100,65462
582,306,276,-,124200,65463
291,229,62,-,143900,65464
733,505,228,658,162900,65466
0,0,0,-,-,65468
469,425,44,-,115100,65470
1784,12,1772,1251,-,65473
84,74,10,-,-,65479
1893,1283,610,632,111700,65483
31,31,0,-,-,65484
1355,1188,167,578,117600,65486
64,64,0,-,67300,65501
122,122,0,-,-,65529
234,211,23,-,152700,65534
524,426,98,-,76500,65535
11883,7982,3901,657,117600,65536
117,117,0,-,-,65541
2135,1533,602,616,111600,65542
152,125,27,-,167400,65543
2247,1643,604,571,123800,65548
1161,865,296,563,89300,65550
845,699,146,615,179200,65552
464,363,101,454,74200,65555
2165,1602,563,637,108200,65556
33,33,0,-,-,65557
3424,2269,1155,700,138400,65559
6003,4160,1843,588,108300,65560
34,20,14,-,-,65564
2000,1458,542,659,118800,65565
317,265,52,616,74600,65566
710,501,209,-,112800,65567
293,277,16,1028,68300,65570
739,563,176,457,109700,65571
262,193,69,-,161100,65580
982,728,254,623,124800,65582
4418,2398,2020,1035,164400,65583
4424,1998,2426,1058,177100,65584
38,38,0,-,-,65586
885,616,269,605,89500,65588
39,26,13,-,65300,65589
442,278,164,546,95000,65590
476,360,116,780,165100,65591
217,179,38,559,150500,65601
70,55,15,-,269100,65603
1418,1122,296,610,133200,65604
5088,3611,1477,725,109500,65605
1252,921,331,631,95300,65606
3612,2879,733,610,115900,65608
368,284,84,680,77900,65609
1950,1690,260,795,187200,65610
1089,934,155,778,164000,65611
758,587,171,-,193100,65612
6733,4327,2406,717,147100,65613
187,146,41,831,132300,65614
11109,6358,4751,844,169000,65616
508,434,74,1035,171400,65617
40,40,0,-,108300,65618
3249,2623,626,814,161400,65619
78,78,0,-,-,65620
3464,2377,1087,573,134600,65622
6,2,4,-,-,65623
510,487,23,-,223800,65624
3201,2151,1050,670,118600,65625
810,641,169,579,134800,65626
336,246,90,835,119100,65627
266,221,45,-,198900,65629
152,134,18,-,457900,65630
2228,1890,338,954,149500,65631
900,704,196,584,148300,65632
1348,971,377,838,106400,65633
191,166,25,575,72900,65634
189,161,28,558,151100,65635
473,398,75,482,130000,65637
254,202,52,-,179200,65638
311,283,28,-,149100,65640
494,433,61,-,160200,65641
789,697,92,759,149300,65644
756,635,121,490,112500,65646
1089,876,213,700,130600,65647
1961,1669,292,735,145000,65648
777,596,181,807,156300,65649
505,439,66,484,102800,65650
1300,1043,257,583,142400,65652
2614,2078,536,576,141900,65653
138,92,46,-,84400,65654
1249,916,333,589,103200,65655
1809,1512,297,636,187600,65656
93,56,37,-,161300,65657
717,623,94,610,163000,65658
109,109,0,-,211600,65660
994,739,255,479,85800,65661
433,362,71,-,89300,65662
925,667,258,570,140700,65663
45,24,21,744,-,65664
1275,977,298,471,158500,65667
830,626,204,854,89600,65668
814,680,134,828,154100,65669
3620,2378,1242,732,152500,65672
1065,691,374,629,70400,65674
207,135,72,-,104800,65676
1298,796,502,681,165400,65679
453,424,29,-,82400,65680
924,867,57,-,165500,65681
744,485,259,742,103900,65682
255,216,39,476,83200,65685
2370,1958,412,599,198100,65686
2254,1817,437,589,132800,65689
90,70,20,-,64000,65690
496,403,93,646,140400,65692
135,122,13,-,159100,65702
1486,1096,390,383,118900,65704
1546,1042,504,778,112900,65705
6330,4980,1350,623,164600,65706
748,598,150,634,110100,65707
4646,2984,1662,720,122300,65708
479,344,135,668,164600,65710
3648,2826,822,560,96800,65711
3610,2493,1117,587,130200,65712
900,742,158,575,105600,65713
12544,8874,3670,848,200200,65714
8,8,0,-,-,65715
824,628,196,560,109000,65717
391,337,54,579,122200,65720
12092,8892,3200,882,177200,65721
547,431,116,580,94800,65722
1138,856,282,672,115400,65723
674,629,45,-,60000,65724
1202,1015,187,825,157300,65725
87,87,0,-,-,65727
0,0,0,-,-,65728
102,86,16,-,263300,65729
8,8,0,-,-,65730
117,70,47,760,83300,65731
437,380,57,717,221900,65732
254,233,21,-,67500,65733
1202,889,313,667,86700,65734
46,17,29,-,-,65735
3126,2531,595,686,184700,65737
7791,4815,2976,840,140700,65738
382,371,11,-,225000,65739
1453,1023,430,752,84700,65740
4968,3915,1053,707,188200,65742
35,31,4,-,155200,65744
974,569,405,791,105200,65745
2672,2201,471,629,145800,65746
1695,1580,115,674,176200,65747
152,67,85,483,84100,65752
1845,1403,442,695,157100,65753
226,200,26,-,180100,65754
263,241,22,-,136200,65755
283,258,25,656,183800,65756
2818,2420,398,820,194500,65757
471,371,100,705,107200,65759
359,355,4,-,95400,65760
619,553,66,660,179300,65761
150,117,33,-,111300,65762
431,377,54,-,86600,65764
40,35,5,-,55400,65766
828,638,190,500,132500,65767
179,134,45,463,204700,65768
1076,909,167,704,121700,65769
1122,961,161,645,136800,65770
547,525,22,-,244500,65771
844,751,93,658,111100,65772
255,229,26,-,70300,65773
521,410,111,624,87100,65774
9963,6564,3399,658,112600,65775
98,98,0,-,90200,65777
216,125,91,-,148800,65778
787,656,131,825,74100,65779
3098,2254,844,906,149600,65781
56,50,6,-,75600,65783
10,5,5,-,-,65784
2232,1572,660,752,100200,65785
746,624,122,559,168600,65786
602,498,104,542,234300,65787
146,133,13,-,-,65788
688,495,193,483,125200,65789
279,248,31,-,64400,65790
1905,1338,567,651,110700,65791
2325,1658,667,463,99400,65793
19446,10101,9345,748,117900,65802
18070,9790,8280,741,118000,65803
18828,10313,8515,735,165900,65804
7132,971,6161,684,72900,65806
26557,12047,14510,819,131400,65807
4519,3776,743,914,281200,65809
9358,7116,2242,910,216000,65810
4778,3258,1520,699,106500,66002
2622,2048,574,810,226200,66006
2578,1985,593,1036,246900,66007
100,89,11,-,95000,66008
374,322,52,550,122400,66010
4468,3570,898,958,206800,66012
658,637,21,-,379800,66013
210,179,31,-,-,66014
285,217,68,538,79100,66015
173,161,12,-,151500,66016
174,130,44,438,87600,66017
2271,1560,711,820,254000,66018
110,0,110,725,-,66019
485,448,37,716,267200,66020
1013,887,126,982,173300,66021
396,303,93,903,98000,66023
292,193,99,817,78200,66024
2650,1730,920,1058,189300,66025
240,227,13,-,138900,66026
1497,0,1497,1683,-,66027
8198,5503,2695,1108,206500,66030
0,0,0,-,-,66031
2003,1356,647,699,109400,66032
299,262,37,675,103600,66033
244,195,49,543,95700,66035
237,207,30,763,115800,66039
1569,1198,371,698,108800,66040
362,340,22,656,97500,66041
254,227,27,435,114400,66042
3099,2365,734,1032,177400,66043
11241,4157,7084,860,173900,66044
0,0,0,-,-,66045
8298,3918,4380,853,171600,66046
8742,4035,4707,1046,237700,66047
13609,8256,5353,850,156400,66048
13689,7782,5907,1042,261300,66049
841,770,71,957,183600,66050
785,589,196,1035,213300,66052
2656,2118,538,1168,232200,66053
1020,847,173,860,192300,66054
624,470,154,633,115300,66056
118,95,23,565,73500,66058
492,334,158,728,127800,66060
22360,16461,5899,993,253600,66061
29174,22042,7132,1122,265800,66062
2354,1618,736,868,110700,66064
1121,992,129,718,201900,66066
6413,4306,2107,770,131600,66067
904,863,41,771,160400,66070
5353,4278,1075,836,212300,66071
568,545,23,1070,160700,66072
1075,886,189,928,155700,66073
1034,757,277,730,84000,66075
847,704,143,826,124100,66076
378,317,61,678,158900,66078
334,278,56,883,155400,66079
325,279,46,732,93800,66080
3596,3043,553,993,263800,66083
3442,3161,281,1697,420400,66085
3746,3149,597,1015,221000,66086
884,706,178,701,93400,66087
1073,865,208,668,131600,66088
1134,850,284,642,112000,66090
194,138,56,560,81700,66091
1490,1244,246,845,185100,66092
231,194,37,1352,176500,66093
127,80,47,565,68500,66094
357,283,74,789,175900,66095
546,444,102,586,164100,66097
5078,1960,3118,611,60300,66101
10372,5098,5274,819,73200,66102
6141,2122,4019,908,100500,66103
9530,6163,3367,887,76700,66104
923,402,521,698,34300,66105
7824,5225,2599,865,114700,66106
8862,7006,1856,1391,178500,66109
3830,2924,906,962,111800,66111
4759,2453,2306,913,130900,66112
0,0,0,-,-,66115
0,0,0,-,-,66118
8193,4226,3967,992,197700,66202
7742,5106,2636,961,174900,66203
8634,4048,4586,1060,168400,66204
6210,4963,1247,1199,242600,66205
4540,4028,512,2193,444000,66206
6304,4788,1516,1521,304000,66207
9162,7262,1900,1487,329100,66208
8569,6465,2104,1219,413300,66209
8890,4872,4018,1225,279300,66210
2373,1667,706,1260,578900,66211
14989,8846,6143,1056,205400,66212
11879,7577,4302,1235,345600,66213
5328,2531,2797,916,224800,66214
11089,6887,4202,1167,229400,66215
9079,7702,1377,1026,245600,66216
2613,1451,1162,1100,360200,66217
2482,2126,356,1552,287300,66218
6234,2265,3969,1213,283300,66219
2674,2492,182,1217,439600,66220
5976,4516,1460,1346,485000,66221
10114,5674,4440,1415,330200,66223
4643,3995,648,1353,474500,66224
4663,4045,618,1125,316900,66226
2520,2181,339,1418,346200,66227
750,623,127,654,158500,66401
1126,889,237,806,197500,66402
327,282,45,764,246300,66403
162,123,39,608,241700,66404
237,136,101,283,103800,66406
140,120,20,1036,153800,66407
114,88,26,800,-,66408
1447,1374,73,736,252100,66409
509,422,87,640,80400,66411
79,74,5,-,230000,66412
835,596,239,589,108400,66413
1220,998,222,654,106600,66414
335,293,42,575,92300,66415
210,182,28,539,110000,66416
149,110,39,817,85000,66417
195,176,19,589,81800,66418
160,149,11,875,105300,66419
274,251,23,-,"10,000-",66422
362,283,79,550,83600,66423
187,153,34,575,76400,66424
220,162,58,630,82000,66425
445,402,43,550,85200,66427
92,92,0,-,125000,66428
188,174,14,-,133300,66429
218,208,10,725,92000,66431
156,85,71,759,116100,66432
1834,1312,522,692,96100,66434
2596,1692,904,556,165200,66436
62,55,7,-,168800,66438
1055,666,389,544,66400,66439
799,735,64,906,154000,66440
10551,4765,5786,868,136700,66441
3524,41,3483,1189,213400,66442
452,383,69,843,159000,66449
649,538,111,736,123400,66451
121,103,18,1219,80400,66501
17364,6912,10452,878,187900,66502
7033,4372,2661,1056,269500,66503
0,0,0,-,-,66506
428,373,55,629,171000,66507
1866,1334,532,580,107800,66508
1014,725,289,735,133800,66509
305,215,90,781,124000,66510
1093,968,125,819,159900,66512
585,552,33,795,196100,66514
122,118,4,-,119700,66515
115,95,20,600,85300,66516
636,300,336,781,115900,66517
101,100,1,-,128100,66518
293,252,41,600,141700,66520
669,457,212,592,119700,66521
79,13,66,841,51700,66522
1599,998,601,724,134300,66523
866,749,117,725,160000,66524
291,211,80,833,216000,66526
92,53,39,832,110400,66527
318,249,69,843,129400,66528
665,586,79,1014,160200,66531
289,254,35,840,141700,66532
562,426,136,783,177000,66533
1643,1061,582,616,145400,66534
1163,899,264,934,215700,66535
1142,949,193,737,164200,66536
459,395,64,920,101400,66537
1261,1006,255,766,170700,66538
1037,794,243,684,172000,66539
239,220,19,750,131800,66540
85,84,1,-,46100,66541
1131,1087,44,-,162600,66542
436,337,99,941,133700,66543
149,115,34,-,89700,66544
412,382,30,567,216800,66546
3268,2405,863,953,168900,66547
339,302,37,632,87600,66548
719,553,166,827,147400,66549
185,148,37,827,82900,66550
183,142,41,636,90000,66552
254,226,28,950,191000,66554
710,132,578,607,63100,66603
9961,5996,3965,879,100300,66604
7557,5167,2390,751,125300,66605
4851,2487,2364,845,88600,66606
3439,1373,2066,699,47300,66607
2072,1315,757,801,58700,66608
2875,2190,685,722,92900,66609
4283,4057,226,1577,249000,66610
4442,2360,2082,837,99600,66611
1193,268,925,545,45000,66612
14368,9396,4972,867,144500,66614
1376,901,475,1060,212500,66615
2514,1585,929,764,70800,66616
3340,2838,502,948,159100,66617
3738,3464,274,835,171600,66618
872,211,661,1140,58300,66619
0,0,0,-,-,66621
0,0,0,-,-,66622
5006,3571,1435,695,83800,66701
221,183,38,593,62500,66710
260,168,92,550,26100,66711
762,474,288,642,87100,66712
2071,1377,694,647,81800,66713
80,67,13,-,39800,66714
147,120,27,734,26700,66716
236,212,24,500,56500,66717
4509,3142,1367,598,81500,66720
386,332,54,644,75000,66724
2362,1696,666,487,85200,66725
25,17,8,-,-,66728
80,79,1,-,101000,66732
926,708,218,687,75700,66733
77,77,0,-,167700,66734
204,169,35,-,-,66735
1578,1141,437,692,81900,66736
117,114,3,-,110200,66738
2187,1505,682,588,74900,66739
83,71,12,638,-,66740
72,72,0,-,135700,66741
1693,1122,571,799,93200,66743
66,56,10,-,-,66746
1260,1004,256,502,89800,66748
3005,1892,1113,752,81300,66749
249,208,41,664,56300,66751
445,409,36,488,71000,66753
136,83,53,1121,-,66754
370,292,78,589,72400,66755
446,361,85,342,76700,66756
1373,1005,368,621,88900,66757
104,79,25,725,59000,66758
0,0,0,-,-,66760
95,91,4,-,97000,66761
9958,5282,4676,730,101100,66762
1360,928,432,716,132400,66763
212,170,42,-,107600,66767
191,154,37,725,105900,66769
354,281,73,607,99300,66770
366,319,47,580,112500,66771
64,62,2,-,38300,66772
256,227,29,675,49900,66773
75,68,7,-,187500,66775
569,438,131,785,84000,66776
238,204,34,563,80000,66777
0,0,0,-,-,66778
243,210,33,447,94000,66779
211,193,18,625,73400,66780
420,330,90,694,65500,66781
48,34,14,-,33600,66782
989,828,161,591,59000,66783
11600,6241,5359,651,116000,66801
91,82,9,-,-,66830
234,215,19,575,94200,66833
383,290,93,775,86500,66834
479,360,119,696,101100,66835
75,75,0,-,58800,66838
1494,1007,487,702,143500,66839
182,157,25,656,85000,66840
174,129,45,929,110400,66842
74,74,0,-,101500,66843
475,379,96,448,76000,66845
1342,934,408,596,110700,66846
182,171,11,917,86900,66849
102,57,45,944,112500,66850
237,168,69,486,33800,66851
275,210,65,810,90000,66852
209,181,28,692,31300,66853
274,189,85,711,69300,66854
760,650,110,615,156300,66856
552,454,98,642,89300,66857
145,120,25,631,52500,66858
87,81,6,-,85000,66859
537,409,128,594,78000,66860
1265,993,272,666,100700,66861
49,39,10,492,112500,66862
22,22,0,-,17500,66863
153,140,13,567,72600,66864
473,367,106,-,177000,66865
664,516,148,533,86800,66866
347,308,39,835,150000,66868
293,219,74,537,108400,66869
63,57,6,-,120800,66870
608,519,89,789,90500,66871
403,313,90,725,96400,66872
121,115,6,531,51500,66873
2512,1737,775,671,84300,66901
109,48,61,-,-,66930
33,28,5,-,66300,66932
147,106,41,644,95000,66933
1065,705,360,660,88600,66935
137,110,27,-,28300,66936
360,315,45,419,75000,66937
443,354,89,655,74800,66938
189,150,39,643,77500,66939
184,157,27,-,41500,66940
56,52,4,375,41700,66941
104,90,14,-,28400,66942
245,182,63,488,84400,66943
128,110,18,-,-,66944
358,309,49,531,91800,66945
102,90,12,-,105000,66946
185,171,14,-,79300,66948
300,235,65,472,53800,66949
302,255,47,566,77400,66951
236,175,61,277,55000,66952
275,169,106,437,112500,66953
53,53,0,-,65000,66955
526,430,96,725,67700,66956
116,70,46,313,30700,66958
88,78,10,-,32700,66959
57,44,13,-,16900,66960
112,86,26,688,118800,66962
95,75,20,-,31400,66963
68,62,6,-,20000,66964
331,238,93,574,66500,66966
876,659,217,508,82300,66967
613,469,144,490,75800,66968
40,40,0,-,127100,66970
532,455,77,938,227600,67001
4977,3888,1089,1434,204000,67002
969,709,260,743,73700,67003
319,249,70,597,106300,67004
6378,4237,2141,655,72800,67005
299,211,88,570,117700,67008
357,220,137,616,55000,67009
5715,4315,1400,841,144800,67010
21,21,0,-,-,67012
1346,1029,317,804,111800,67013
162,135,27,925,115800,67016
804,724,80,978,196800,67017
43,35,8,-,-,67018
357,292,65,666,87900,67019
559,460,99,669,90000,67020
18,18,0,-,56000,67021
759,540,219,603,57300,67022
92,82,10,690,87500,67023
412,290,122,573,37900,67024
1311,1102,209,897,147400,67025
1719,1444,275,907,193600,67026
151,123,28,-,41000,67028
505,330,175,583,71700,67029
816,697,119,1020,172800,67030
969,742,227,792,137200,67031
392,299,93,658,88500,67035
69,51,18,-,82800,67036
10744,8027,2717,962,178000,67037
301,242,59,592,88500,67038
1119,924,195,690,155700,67039
87,87,0,-,111100,67041
6815,4307,2508,742,100200,67042
1420,1035,385,551,66100,67045
315,245,70,692,77800,67047
40,40,0,-,173600,67049
696,589,107,939,188900,67050
171,167,4,-,80600,67051
2545,2182,363,977,197800,67052
260,225,35,469,82400,67053
522,350,172,635,176600,67054
35,35,0,-,131000,67055
1167,859,308,733,150700,67056
105,69,36,475,49000,67057
884,605,279,686,77500,67058
304,234,70,634,92700,67059
5531,4351,1180,855,124900,67060
46,30,16,-,-,67061
1615,917,698,667,138800,67062
1455,1137,318,619,123300,67063
113,105,8,-,78400,67065
153,115,38,-,122500,67066
705,591,114,1029,176000,67067
1893,1316,577,772,86800,67068
447,353,94,390,75500,67070
63,63,0,-,-,67071
167,87,80,478,-,67072
123,96,27,850,100000,67073
499,412,87,724,90700,67074
2089,1189,900,913,169300,67101
76,74,2,-,153700,67103
919,622,297,597,72600,67104
79,68,11,-,87100,67105
179,103,76,-,111800,67106
1344,972,372,683,159100,67107
552,471,81,769,153300,67108
166,111,55,603,79300,67109
3171,2748,423,688,140800,67110
102,81,21,900,-,67111
91,84,7,-,92000,67112
8516,6071,2445,740,120600,67114
790,453,337,528,163800,67117
281,228,53,725,95500,67118
536,396,140,550,84900,67119
311,311,0,-,183000,67120
70,41,29,-,106300,67122
332,261,71,746,65000,67123
3092,2003,1089,704,108500,67124
248,186,62,391,70800,67127
108,86,22,-,228600,67131
146,119,27,669,127200,67132
2286,2016,270,1056,176300,67133
165,124,41,571,110700,67134
1153,900,253,879,175400,67135
185,156,29,616,36700,67137
175,160,15,723,-,67138
424,367,57,539,83900,67140
175,156,19,428,111000,67142
15,12,3,-,72000,67143
995,829,166,803,141000,67144
798,634,164,857,124200,67146
3699,2918,781,996,173400,67147
405,394,11,-,181600,67149
12,10,2,-,-,67150
164,112,52,894,80900,67151
3606,2225,1381,755,85500,67152
622,527,95,739,120100,67154
65,53,12,-,-,67155
5494,3647,1847,681,104300,67156
48,48,0,-,70000,67159
1230,206,1024,896,-,67202
12588,6214,6374,758,104600,67203
8510,6132,2378,744,115100,67204
6938,5760,1178,1214,239100,67205
7398,4601,2797,1040,248600,67206
11413,5267,6146,820,153500,67207
7502,4018,3484,850,131900,67208
5100,3638,1462,890,156100,67209
3401,1259,2142,767,143600,67210
8160,3428,4732,726,79400,67211
18043,11621,6422,880,147000,67212
8424,3461,4963,781,69000,67213
6089,2198,3891,711,63000,67214
2106,1900,206,1346,155400,67215
9223,5122,4101,742,78200,67216
11871,7824,4047,859,90400,67217
9914,4871,5043,753,88900,67218
4527,3118,1409,917,122700,67219
5033,3108,1925,803,155600,67220
186,179,7,-,292900,67223
8085,4463,3622,984,219600,67226
80,80,0,-,-,67227
687,684,3,-,355500,67228
3911,3645,266,1714,316300,67230
147,147,0,-,348800,67232
4663,4418,245,1296,233100,67235
0,0,0,-,-,67260
5475,3742,1733,710,87000,67301
519,401,118,583,84600,67330
56,48,8,-,74100,67332
1115,882,233,575,70600,67333
25,16,9,-,23600,67334
1402,1001,401,655,75900,67335
701,499,202,492,56400,67336
4959,3166,1793,643,70500,67337
212,187,25,495,47200,67340
152,152,0,-,138400,67341
339,277,62,765,86300,67342
287,260,27,761,78800,67344
68,62,6,-,-,67345
140,115,25,672,47300,67346
167,167,0,-,163100,67347
405,314,91,384,60200,67349
160,96,64,633,101300,67351
259,219,40,491,43000,67352
234,195,39,675,45300,67353
246,197,49,575,86600,67354
92,90,2,-,135000,67355
1105,822,283,545,73600,67356
5028,3446,1582,675,79100,67357
179,140,39,-,-,67360
678,501,177,648,48800,67361
78,78,0,-,85200,67363
129,121,8,-,68900,67364
20828,13323,7505,772,141000,67401
4402,3296,1106,685,128600,67410
393,338,55,764,169700,67416
85,35,50,-,-,67417
84,53,31,-,30900,67418
1780,1182,598,580,97700,67420
614,516,98,769,145800,67422
80,62,18,970,46700,67423
248,220,28,775,112500,67425
198,172,26,661,51300,67427
567,417,150,800,128500,67428
267,199,68,598,68600,67430
862,632,230,693,153700,67431
2620,1861,759,592,102700,67432
268,197,71,592,59100,67436
468,379,89,502,83300,67437
98,86,12,550,78900,67438
1120,818,302,623,135200,67439
405,322,83,488,85500,67441
40,40,0,-,162500,67442
681,577,104,645,170600,67443
258,232,26,600,83000,67444
247,218,29,678,39800,67445
308,253,55,439,80400,67446
164,93,71,389,85700,67447
464,381,83,825,111300,67448
1364,909,455,702,75800,67449
281,239,42,489,75000,67450
436,298,138,612,86300,67451
98,98,0,-,90300,67452
321,257,64,603,89800,67454
804,614,190,605,73500,67455
1606,1102,504,723,157900,67456
304,204,100,668,139100,67457
142,112,30,-,155600,67458
136,126,10,-,185000,67459
7025,4639,2386,765,158500,67460
437,367,70,681,91600,67464
298,226,72,642,74000,67466
1081,799,282,613,110700,67467
114,87,27,718,69500,67468
195,130,65,962,156600,67470
866,620,246,577,72500,67473
103,102,1,-,61300,67474
57,51,6,-,82700,67475
37,33,4,-,21800,67478
597,483,114,607,140300,67480
286,244,42,504,84500,67481
53,42,11,-,85000,67482
193,129,64,613,70400,67483
405,355,50,500,102800,67484
188,109,79,384,92800,67485
574,443,131,841,153000,67487
372,310,62,653,80000,67490
172,136,36,698,120000,67491
58,53,5,925,87000,67492
9498,5700,3798,711,68600,67501
10137,7638,2499,855,146800,67502
1297,814,483,529,114500,67505
101,96,5,-,97500,67510
90,86,4,-,58200,67511
87,78,9,-,46700,67512
49,41,8,-,35300,67513
351,239,112,678,70200,67514
26,23,3,-,-,67515
164,140,24,475,50000,67516
14,10,4,-,162500,67518
61,47,14,-,-,67519
144,140,4,-,46300,67520
78,48,30,-,65900,67521
780,611,169,684,124200,67522
180,109,71,1052,54400,67523
248,185,63,570,33100,67524
386,334,52,475,87300,67525
1056,801,255,671,79700,67526
71,66,5,608,23200,67529
7603,4892,2711,678,106100,67530
818,679,139,699,104400,67543
1216,826,390,696,89300,67544
78,71,7,-,83400,67545
908,710,198,794,160700,67546
774,572,202,655,57700,67547
743,452,291,608,77400,67548
2108,1261,847,634,82900,67550
323,274,49,482,62600,67552
66,55,11,925,67900,67553
1717,1203,514,593,74800,67554
94,88,6,-,64400,67556
250,181,69,461,58800,67557
14,12,2,-,-,67559
692,590,102,648,88900,67560
503,383,120,712,74900,67561
142,119,23,530,76500,67563
75,74,1,-,70000,67564
168,145,23,-,72400,67565
214,199,15,782,88500,67566
274,200,74,492,57500,67567
100,81,19,557,91300,67568
514,402,112,648,100000,67570
209,200,9,563,65800,67572
81,78,3,-,103600,67573
55,41,14,581,52100,67574
210,174,36,547,76000,67575
807,658,149,695,92600,67576
545,417,128,623,53800,67578
1176,865,311,618,117100,67579
142,129,13,392,65900,67581
409,323,86,541,47400,67583
108,94,14,613,50000,67584
9831,5861,3970,727,179400,67601
155,134,21,425,59600,67621
260,180,80,539,67400,67622
72,58,14,600,23300,67623
86,68,18,479,62500,67625
86,70,16,-,95000,67626
43,39,4,-,87900,67628
69,66,3,-,61700,67629
52,52,0,-,80000,67631
127,85,42,517,67000,67632
80,65,15,518,79400,67634
62,58,4,-,-,67635
1077,914,163,768,136300,67637
133,94,39,191,50000,67638
80,80,0,-,155000,67639
282,220,62,858,121200,67640
944,687,257,631,84300,67642
113,90,23,665,-,67643
125,99,26,-,39500,67644
296,265,31,411,41100,67645
423,311,112,523,66500,67646
83,61,22,482,103700,67647
285,234,51,541,34700,67648
108,92,16,242,73300,67649
118,112,6,-,61200,67650
218,181,37,530,44200,67651
166,108,58,656,57000,67653
1267,946,321,636,95900,67654
83,74,9,-,-,67656
116,84,32,583,86700,67657
34,28,6,-,200000,67658
46,42,4,-,57100,67659
32,26,6,-,-,67660
1400,922,478,618,91800,67661
1039,724,315,622,88600,67663
124,93,31,600,68100,67664
2168,1694,474,659,112000,67665
61,60,1,-,112500,67667
826,621,205,526,68200,67669
656,472,184,822,170200,67671
1158,859,299,591,99100,67672
42,25,17,-,62500,67673
21,21,0,-,-,67674
88,86,2,-,34800,67675
2699,1912,787,657,132800,67701
770,517,253,639,113900,67730
326,221,105,540,81600,67731
234,167,67,708,117000,67732
79,48,31,-,118400,67733
95,68,27,-,114600,67734
2262,1492,770,819,107800,67735
97,70,27,638,80000,67736
248,192,56,598,102800,67737
219,188,31,625,88600,67738
124,103,21,375,35200,67739
741,597,144,677,122800,67740
186,130,56,770,90900,67741
61,61,0,-,87900,67743
50,50,0,-,112500,67744
181,128,53,382,74900,67745
54,50,4,-,54000,67747
1048,699,349,707,113800,67748
1053,772,281,675,69300,67749
113,104,9,-,86700,67751
653,431,222,638,126600,67752
203,161,42,773,94800,67753
931,779,152,642,85300,67756
168,144,24,525,70000,67757
510,345,165,454,79000,67758
91,78,13,550,90000,67761
71,36,35,523,95000,67762
152,115,37,396,65000,67764
9832,6164,3668,786,110100,67801
468,346,122,665,58300,67831
358,274,84,639,80800,67834
1075,843,232,650,155600,67835
55,46,9,-,-,67836
357,261,96,490,131900,67837
306,265,41,750,57900,67838
568,429,139,431,79100,67839
45,43,2,-,58300,67840
158,137,21,832,76200,67841
150,106,44,638,44000,67842
115,0,115,494,-,67843
346,208,138,645,98900,67844
11450,7146,4304,834,158400,67846
152,119,33,542,58300,67849
170,104,66,588,65100,67850
919,818,101,-,166700,67851
247,207,40,856,126300,67853
553,433,120,846,93800,67854
731,554,177,656,64800,67855
39,22,17,-,222500,67857
221,186,35,788,83800,67859
894,615,279,828,106000,67860
805,617,188,690,102600,67861
126,105,21,344,60400,67862
157,101,56,-,87500,67863
763,521,242,637,100500,67864
413,330,83,725,108400,67865
590,471,119,642,127500,67867
50,50,0,-,210900,67868
608,411,197,640,110200,67869
461,362,99,646,86200,67870
2084,1256,828,644,139600,67871
580,423,157,663,135800,67876
820,666,154,631,107700,67877
747,583,164,649,80500,67878
491,313,178,600,112100,67879
2613,1756,857,592,136600,67880
155,86,69,616,186400,67882
6904,4244,2660,768,112100,67901
747,490,257,598,100400,67950
1581,1052,529,727,98800,67951
183,150,33,906,153200,67952
42,15,27,-,60800,67953
265,168,97,750,81400,67954
20,19,1,-,61300,68001
1002,799,203,696,209100,68002
1895,1416,479,759,212500,68003
423,308,115,715,91300,68004
9241,5249,3992,862,145800,68005
4443,4039,404,1156,275500,68007
4996,3827,1169,770,182900,68008
18,2,16,-,-,68010
137,121,16,670,118600,68014
486,441,45,911,145000,68015
172,160,12,1141,271100,68016
731,635,96,745,153000,68017
189,173,16,483,162200,68018
202,176,26,705,105600,68019
294,239,55,481,84100,68020
9512,7152,2360,1124,365100,68022
964,683,281,871,286800,68023
12623,7544,5079,774,145500,68025
5396,4347,1049,1025,284700,68028
411,280,131,-,153100,68029
289,220,69,818,127300,68030
709,513,196,758,151200,68031
135,121,14,775,158000,68033
286,226,60,871,161800,68034
160,116,44,738,95000,68036
982,749,233,782,248200,68037
614,454,160,552,91700,68038
293,91,202,701,58300,68039
156,119,37,1225,171900,68040
444,358,86,850,179200,68041
20,19,1,-,95000,68042
269,236,33,871,97500,68044
806,585,221,633,118000,68045
10398,7533,2865,986,239100,68046
729,585,144,646,124800,68047
5077,3979,1098,875,187300,68048
256,229,27,704,107500,68050
100,78,22,675,59100,68055
628,472,156,705,94700,68057
114,100,14,775,346700,68058
1361,1195,166,952,250900,68059
951,717,234,710,109900,68061
117,98,19,675,134400,68062
108,85,23,842,91300,68063
1592,1233,359,889,246300,68064
630,566,64,700,179200,68065
2112,1542,570,759,165400,68066
339,217,122,630,41900,68067
58,56,2,-,139300,68068
1231,1061,170,800,258300,68069
357,317,40,671,166700,68070
582,271,311,598,72300,68071
20,15,5,-,65000,68072
905,711,194,831,181800,68073
4798,641,4157,1074,288500,68102
15387,9050,6337,847,114800,68104
9605,4170,5435,841,130000,68105
9640,5759,3881,999,145800,68106
9012,5863,3149,852,96400,68107
5171,2363,2808,950,98100,68108
3196,1499,1697,797,68100,68110
8434,3450,4984,930,66500,68111
4242,2899,1343,1060,109000,68112
243,0,243,1314,-,68113
8166,4131,4035,1029,191600,68114
11668,9027,2641,1153,238300,68116
3017,2251,766,1063,118600,68117
3447,2889,558,1448,283500,68118
3906,3269,637,1101,168700,68122
11685,6557,5128,1186,205900,68123
6508,4159,2349,1047,222200,68124
9856,4499,5357,864,168300,68127
7756,4486,3270,1027,201100,68128
7873,6153,1720,1386,292800,68130
5863,1521,4342,893,136100,68131
5817,3236,2581,787,267000,68132
3942,3373,569,1153,274700,68133
12973,7148,5825,880,152300,68134
10043,9137,906,1439,248700,68135
5994,5241,753,1304,258300,68136
10148,6668,3480,1097,164100,68137
4565,3635,930,886,165200,68138
1756,1661,95,1176,227400,68142
10273,7244,3029,919,184400,68144
4076,3226,850,974,147400,68147
2498,1972,526,870,201900,68152
9909,6163,3746,953,230300,68154
2827,1670,1157,1159,161500,68157
11795,7539,4256,1073,174100,68164
20,0,20,-,-,68178
546,465,81,867,242300,68301
142,131,11,-,61000,68303
102,93,9,1089,198600,68304
1827,1279,548,549,91000,68305
193,149,44,775,137500,68307
43,34,9,-,50000,68309
6190,3781,2409,625,122500,68310
296,240,56,1308,131300,68313
148,118,30,731,154200,68314
35,22,13,-,-,68315
212,187,25,575,95500,68316
700,669,31,1087,221600,68317
182,132,50,938,56400,68318
257,186,71,821,123900,68319
191,134,57,638,91400,68320
163,158,5,-,173200,68321
186,139,47,355,101000,68322
114,81,33,547,53500,68323
35,35,0,-,106300,68324
72,61,11,579,55000,68325
95,90,5,-,95000,68326
176,158,18,725,60800,68327
171,137,34,717,124500,68328
222,185,37,525,73400,68329
349,299,50,1083,158500,68331
53,49,4,-,43000,68332
2943,1998,945,741,135700,68333
225,181,44,703,61500,68335
297,289,8,-,308200,68336
164,151,13,550,72100,68337
143,117,26,488,120800,68338
414,383,31,441,295600,68339
389,284,105,639,66100,68340
445,338,107,754,152600,68341
272,166,106,471,94300,68342
373,300,73,503,123300,68343
183,161,22,808,113900,68344
134,116,18,775,97500,68345
238,204,34,653,141400,68346
979,955,24,783,206800,68347
115,89,26,380,-,68348
435,387,48,779,188500,68349
110,97,13,-,68000,68350
416,322,94,505,84800,68351
2137,1422,715,698,88900,68352
450,375,75,574,67600,68354
2241,1564,677,655,77800,68355
122,111,11,694,149100,68357
494,455,39,828,279700,68358
649,526,123,775,150000,68359
200,185,15,925,159500,68360
923,710,213,581,108800,68361
20,17,3,-,38800,68362
61,58,3,-,111100,68364
113,95,18,-,86900,68365
334,305,29,882,159400,68366
141,117,24,447,62500,68367
195,190,5,775,262800,68368
903,615,288,633,87600,68370
592,454,138,757,126500,68371
1265,1154,111,1289,255600,68372
67,57,10,372,-,68375
639,475,164,557,71600,68376
196,159,37,-,116100,68377
267,255,12,825,130600,68378
28,28,0,-,82500,68379
23,23,0,-,37900,68380
53,40,13,-,64000,68381
18,8,10,-,95000,68382
380,344,36,702,119000,68401
398,335,63,800,244500,68402
93,80,13,688,127100,68403
386,362,24,-,218200,68404
1301,814,487,719,184000,68405
231,185,46,723,101200,68406
322,280,42,918,281800,68407
291,235,56,933,156000,68409
3540,2322,1218,747,136100,68410
218,185,33,-,191100,68413
124,58,66,629,68000,68414
255,227,28,658,97600,68415
98,64,34,511,85800,68416
142,106,36,880,35400,68417
417,367,50,925,160900,68418
93,76,17,725,146200,68419
592,515,77,561,73900,68420
307,212,95,473,85800,68421
204,181,23,812,174000,68422
499,434,65,802,237500,68423
316,250,66,831,104900,68424
455,408,47,1357,356100,68428
646,578,68,1283,373300,68430
119,119,0,-,65500,68431
126,111,15,-,-,68433
3269,2153,1116,795,185800,68434
237,196,41,625,98300,68436
140,137,3,-,74200,68437
42,38,4,950,118800,68438
331,311,20,677,108900,68439
64,56,8,-,-,68440
61,46,15,-,-,68441
121,91,30,540,92500,68442
391,346,45,720,119100,68443
21,16,5,-,112500,68444
77,53,24,-,-,68445
1232,901,331,664,160300,68446
266,193,73,490,56100,68447
152,132,20,725,100900,68448
1026,587,439,696,114800,68450
45,40,5,-,-,68452
163,117,46,-,78300,68453
290,252,38,735,155400,68454
215,146,69,-,146900,68455
532,407,125,725,154000,68456
215,176,39,672,68000,68457
64,55,9,725,97500,68458
271,213,58,667,135400,68460
386,353,33,-,-,68461
1582,1267,315,858,210300,68462
574,431,143,697,150900,68463
279,260,19,544,68000,68464
994,739,255,677,136900,68465
662,512,150,644,54500,68466
3788,2653,1135,745,143800,68467
11602,6042,5560,710,165100,68502
6343,2285,4058,707,113900,68503
7836,2751,5085,843,130200,68504
7082,3845,3237,972,156000,68505
12758,7910,4848,961,180700,68506
6543,4514,2029,822,158400,68507
5729,555,5174,645,79700,68508
9115,5496,3619,820,163900,68510
5620,3649,1971,1068,235500,68512
57,57,0,-,298300,68514
18036,12299,5737,1023,253400,68516
176,157,19,-,339800,68517
1075,1042,33,1428,354000,68520
14127,8254,5873,948,171800,68521
4434,3194,1240,969,165900,68522
489,481,8,-,397700,68523
2257,1388,869,800,167200,68524
2507,1990,517,1166,347600,68526
293,293,0,-,411000,68527
2266,1351,915,1017,165600,68528
280,148,132,985,283000,68531
196,196,0,-,350000,68532
11419,7981,3438,740,158900,68601
1125,833,292,599,165400,68620
168,150,18,-,-,68621
126,89,37,465,-,68622
180,153,27,622,32400,68623
357,326,31,745,130000,68624
280,225,55,713,112500,68626
323,277,46,779,94200,68627
355,278,77,775,96000,68628
515,442,73,564,78800,68629
163,134,29,525,155100,68631
1551,1079,472,815,128200,68632
502,409,93,619,126000,68633
202,184,18,-,91400,68634
216,164,52,680,177200,68635
633,515,118,588,90300,68636
145,114,31,590,83900,68637
788,698,90,571,80400,68638
511,438,73,828,103700,68640
522,459,63,508,111100,68641
780,674,106,805,220300,68642
476,426,50,663,121300,68643
288,211,77,811,159400,68644
282,241,41,629,148200,68647
126,93,33,-,129600,68648
828,586,242,732,146200,68649
490,390,100,596,119400,68651
314,265,49,618,111200,68652
237,221,16,1000,122500,68653
249,184,65,830,76800,68654
39,32,7,-,55000,68655
320,283,37,809,124700,68658
93,64,29,554,181800,68659
480,370,110,582,113300,68660
2290,1470,820,715,101500,68661
465,408,57,605,116300,68662
429,371,58,708,134500,68663
137,108,29,900,73800,68664
329,271,58,713,75200,68665
615,489,126,592,113700,68666
30,23,7,-,55000,68667
217,183,34,570,126000,68669
12790,8600,4190,712,158500,68701
334,258,76,505,114300,68710
64,44,20,-,133800,68711
982,739,243,594,148700,68713
546,404,142,514,93700,68714
557,444,113,736,159900,68715
430,264,166,700,79600,68716
131,96,35,-,112500,68717
803,542,261,591,80800,68718
83,76,7,775,156900,68719
128,99,29,638,110400,68720
209,169,40,400,56500,68722
273,259,14,850,116300,68723
60,40,20,-,-,68724
252,225,27,675,74300,68725
239,157,82,513,61700,68726
286,219,67,528,104000,68727
105,75,30,-,82500,68728
786,611,175,606,112600,68729
793,659,134,447,160100,68730
939,720,219,754,132000,68731
98,91,7,-,98300,68732
458,336,122,638,110300,68733
43,18,25,-,-,68734
348,271,77,619,72100,68735
295,231,64,-,121200,68736
1122,974,148,801,138800,68739
358,298,60,729,216700,68740
275,216,59,1000,170700,68741
95,78,17,761,216700,68742
196,154,42,730,169400,68743
657,497,160,664,113900,68745
204,179,25,479,55900,68746
64,52,12,-,-,68747
939,742,197,715,104700,68748
32,23,9,-,32500,68749
25,20,5,-,50000,68751
300,263,37,531,114000,68752
65,43,22,-,-,68753
157,131,26,-,113500,68755
768,554,214,674,86700,68756
323,301,22,643,92700,68757
547,366,181,612,87400,68758
91,76,15,-,69300,68759
542,330,212,469,76600,68760
159,132,27,728,35800,68761
2036,1338,698,739,144000,68763
369,293,76,442,82000,68764
475,392,83,690,121400,68765
171,137,34,571,95900,68766
1429,1042,387,627,176600,68767
266,172,94,608,153800,68768
756,551,205,770,95500,68769
665,480,185,584,99500,68770
597,427,170,746,116900,68771
83,64,19,571,211100,68773
91,84,7,-,137500,68774
5485,3449,2036,822,127500,68776
271,224,47,654,95000,68777
245,183,62,690,65000,68778
1022,713,309,677,117300,68779
414,294,120,615,115200,68780
595,455,140,564,87500,68781
360,291,69,440,78500,68783
675,474,201,718,110000,68784
94,68,26,-,152700,68785
396,332,64,-,78500,68786
2463,1376,1087,710,145200,68787
1941,1250,691,734,144400,68788
47,44,3,-,-,68789
492,410,82,760,120700,68790
832,566,266,654,123900,68791
193,172,21,685,95600,68792
10902,6386,4516,781,128700,68801
10192,6489,3703,780,170000,68803
405,313,92,766,99600,68810
206,161,45,625,130700,68812
210,141,69,536,87000,68813
420,297,123,911,80300,68814
307,228,79,638,110800,68815
112,101,11,-,110200,68816
168,131,37,709,71700,68817
2119,1600,519,730,165500,68818
169,153,16,788,114600,68820
51,33,18,815,158000,68821
2147,1414,733,673,135100,68822
1029,812,217,447,114300,68823
613,440,173,720,158300,68824
407,316,91,521,143300,68825
1539,1041,498,659,131700,68826
263,198,65,858,96700,68827
109,84,25,1339,101900,68828
302,209,93,990,98600,68831
844,680,164,845,215100,68832
141,91,50,-,77700,68833
93,80,13,-,80000,68834
253,163,90,596,93900,68835
656,495,161,775,143500,68836
34,29,5,-,270800,68837
103,96,7,-,233300,68838
1108,819,289,838,145100,68840
226,194,32,725,159500,68841
277,190,87,565,70000,68842
293,256,37,800,136500,68843
106,99,7,-,212500,68844
8411,4948,3463,814,214900,68845
130,110,20,515,74800,68846
6774,4685,2089,771,178300,68847
0,0,0,-,-,68849
4272,2514,1758,825,127300,68850
254,188,66,625,83300,68852
700,491,209,555,92800,68853
327,293,34,850,154600,68854
183,135,48,573,155400,68855
307,171,136,821,147500,68856
123,96,27,606,101900,68858
259,209,50,378,71900,68859
147,118,29,433,59500,68860
33,30,3,-,80000,68861
1289,993,296,587,126200,68862
536,293,243,498,96900,68863
405,350,55,850,102100,68864
413,342,71,682,240000,68865
413,323,90,607,167400,68866
868,614,254,765,103700,68869
177,149,28,817,169200,68870
127,110,17,-,103100,68871
374,318,56,-,160900,68872
1474,1038,436,722,163900,68873
353,259,94,885,62400,68874
298,247,51,486,108600,68875
647,492,155,683,119000,68876
179,121,58,704,103900,68878
215,158,57,675,60000,68879
0,0,0,-,-,68881
217,168,49,728,54500,68882
1044,778,266,749,130200,68883
10614,6830,3784,732,131600,68901
762,581,181,697,141300,68920
523,391,132,756,84500,68922
34,34,0,-,116700,68923
528,438,90,1016,172200,68924
211,184,27,683,195800,68925
254,205,49,517,65300,68926
569,444,125,668,154700,68927
147,140,7,-,58800,68928
96,88,8,-,58300,68929
596,475,121,610,153500,68930
174,160,14,525,56400,68932
437,350,87,550,100000,68933
69,39,30,-,126400,68934
292,169,123,484,75600,68935
119,86,33,625,31300,68936
840,651,189,683,207400,68937
268,235,33,636,106900,68938
471,357,114,445,82500,68939
202,166,36,696,184100,68940
330,291,39,840,120400,68941
139,127,12,713,36900,68942
113,103,10,488,-,68943
523,379,144,568,93400,68944
104,68,36,738,-,68945
12,12,0,-,28300,68946
285,255,30,571,103900,68947
135,121,14,-,61900,68948
2873,1971,902,642,137600,68949
142,115,27,544,100900,68950
30,20,10,-,-,68952
8,8,0,-,-,68954
820,743,77,717,205000,68955
541,442,99,741,129300,68956
212,193,19,484,66900,68957
262,208,54,643,150000,68958
1555,1185,370,635,164000,68959
96,81,15,-,43900,68960
289,270,19,547,70800,68961
19,19,0,-,-,68964
278,230,48,431,90600,68966
460,349,111,688,99400,68967
4,4,0,-,60000,68969
673,522,151,513,60000,68970
187,152,35,-,111600,68971
89,59,30,-,87400,68972
166,135,31,663,120500,68973
119,115,4,-,61400,68974
44,44,0,-,-,68975
183,141,42,692,120800,68976
98,79,19,534,56000,68977
1112,838,274,468,74000,68978
715,628,87,744,125500,68979
158,116,42,778,119400,68980
100,82,18,-,63000,68981
287,174,113,790,123100,68982
3768,2652,1116,637,116700,69001
225,168,57,808,78000,69020
595,447,148,463,78300,69021
800,661,139,732,86600,69022
108,99,9,-,214500,69023
532,402,130,863,86700,69024
441,254,187,434,123000,69025
45,24,21,-,50000,69026
13,6,7,-,-,69027
356,277,79,714,119100,69028
159,132,27,420,66300,69029
111,69,42,683,39400,69030
222,160,62,425,91600,69032
1107,876,231,691,163400,69033
364,290,74,725,90000,69034
99,90,9,-,208300,69036
74,74,0,-,-,69037
223,158,65,617,82800,69038
44,20,24,-,225000,69039
291,237,54,588,57400,69040
41,37,4,-,104900,69041
6,6,0,-,225000,69042
210,174,36,700,58300,69043
304,213,91,556,79700,69044
434,305,129,575,76200,69045
54,45,9,-,36500,69046
12179,7914,4265,768,153900,69101
495,393,102,668,124600,69120
172,123,49,767,153100,69121
298,212,86,684,83800,69122
360,286,74,682,143500,69123
128,66,62,688,60000,69125
331,288,43,658,203200,69127
133,81,52,950,86100,69128
526,434,92,613,98200,69129
2129,1495,634,695,93600,69130
303,251,52,1066,91300,69131
41,19,22,-,143800,69132
203,172,31,1036,85600,69133
173,156,17,683,119300,69134
9,9,0,-,-,69135
1487,1089,398,728,117600,69138
775,576,199,693,121200,69140
166,133,33,820,68800,69141
44,24,20,625,76700,69142
638,554,84,695,159300,69143
71,55,16,-,96800,69144
1315,884,431,734,78700,69145
160,129,31,-,156300,69146
245,200,45,714,69500,69147
62,49,13,538,218800,69148
342,269,73,540,84700,69149
150,139,11,900,171300,69150
364,313,51,725,187200,69151
360,218,142,533,98100,69152
2843,1901,942,676,130900,69153
590,467,123,707,82200,69154
428,357,71,557,113900,69155
256,217,39,763,84600,69156
42,34,8,-,57300,69157
32,30,2,-,275000,69161
3385,2073,1312,800,104800,69162
354,281,73,611,112200,69163
744,615,129,833,132000,69165
295,182,113,594,120800,69166
134,101,33,572,92500,69167
90,74,16,850,58600,69168
267,161,106,485,96900,69169
115,96,19,696,107100,69170
4,4,0,-,-,69171
1693,921,772,722,140700,69201
1059,833,226,537,87200,69210
174,109,65,585,82300,69211
100,47,53,450,79500,69212
107,59,48,772,112500,69214
74,40,34,-,-,69216
167,160,7,525,47100,69217
164,119,45,-,105200,69218
51,25,26,-,304500,69219
9,7,2,-,-,69220
55,40,15,-,-,69221
4103,2884,1219,685,131500,69301
29,21,8,-,-,69331
107,84,23,-,-,69333
955,806,149,610,108700,69334
15,6,9,-,-,69335
929,642,287,729,102100,69336
2796,1680,1116,747,133100,69337
607,450,157,668,70700,69339
26,17,9,-,105400,69340
4127,2987,1140,816,139700,69341
1084,695,389,704,75600,69343
133,84,49,-,187500,69345
244,151,93,590,76300,69346
579,408,171,728,100700,69347
566,426,140,688,100000,69348
193,128,65,805,70000,69350
118,66,52,-,113600,69351
287,204,83,-,64700,69352
15,13,2,-,81000,69353
47,6,41,-,-,69354
80,75,5,575,112500,69355
743,541,202,489,108900,69356
1500,1137,363,759,121800,69357
910,651,259,547,150700,69358
599,366,233,752,66400,69360
7129,4249,2880,851,130000,69361
0,0,0,-,-,69365
85,61,24,-,166300,69366
131,124,7,-,128100,69367
16638,8471,8167,947,242600,70001
8954,4750,4204,970,315900,70002
15213,11679,3534,960,204400,70003
11705,7623,4082,1028,320800,70005
6223,4093,2130,1004,265300,70006
1309,1239,70,1344,192100,70030
438,412,26,1563,133900,70031
1542,1058,484,884,167600,70032
389,380,9,-,163500,70036
5665,3773,1892,1363,280100,70037
80,73,7,-,56900,70038
988,725,263,1073,225900,70039
412,336,76,557,101100,70040
1148,1039,109,897,57700,70041
7668,4638,3030,961,155300,70043
4779,3850,929,1073,249200,70047
504,441,63,718,161600,70049
89,45,44,-,-,70050
718,602,116,-,140100,70051
1187,965,222,969,167200,70052
7564,3879,3685,909,142700,70053
14638,8651,5987,1036,168200,70056
1620,1248,372,572,162000,70057
13844,9150,4694,1030,154700,70058
5681,2917,2764,947,147800,70062
19229,11904,7325,1007,201900,70065
999,827,172,860,183500,70067
12037,9546,2491,944,162700,70068
5012,4111,901,1247,206400,70070
1377,1144,233,445,153600,70071
19825,14724,5101,942,161000,70072
1615,1454,161,941,179700,70075
172,172,0,-,161800,70076
1145,814,331,1071,166000,70079
791,686,105,-,159800,70080
158,127,31,-,32800,70082
962,814,148,866,97200,70083
2085,1727,358,457,119200,70084
1650,1462,188,884,116800,70085
757,519,238,600,109800,70086
2630,1957,673,711,147800,70087
2886,2255,631,611,160600,70090
86,68,18,-,88000,70091
2690,2216,474,1009,142000,70092
11485,7515,3970,995,112600,70094
1951,223,1728,969,376700,70112
3647,754,2893,780,171000,70113
9140,3957,5183,926,168900,70114
14847,8106,6741,1195,481400,70115
5823,2245,3578,939,336000,70116
11998,5330,6668,960,200500,70117
13727,7463,6264,1096,337300,70118
16549,6659,9890,1085,280800,70119
5557,2771,2786,842,191500,70121
15659,9551,6108,996,210200,70122
12165,7389,4776,1187,249000,70123
7593,5439,2154,1471,460000,70124
6237,3072,3165,1107,351300,70125
10441,5052,5389,985,152900,70126
8901,3898,5003,920,156700,70127
7186,4517,2669,1040,179700,70128
2683,1817,866,1044,144700,70129
7175,2600,4575,1247,375000,70130
11269,6383,4886,947,196500,70131
0,0,0,-,-,70139
0,0,0,-,-,70163
16930,12639,4291,846,177300,70301
2076,1536,540,684,166000,70339
59,59,0,-,-,70340
1766,1359,407,1094,126700,70341
1524,1063,461,444,142300,70342
1874,1761,113,-,174500,70343
1910,1662,248,620,86900,70344
3543,2849,694,783,155500,70345
3890,2581,1309,694,154600,70346
81,51,30,-,-,70352
313,295,18,-,73000,70353
1891,1420,471,925,128600,70354
365,356,9,-,147200,70355
687,497,190,630,92900,70356
1162,790,372,499,107500,70357
289,166,123,1028,202700,70358
3840,3139,701,922,110000,70359
11007,7783,3224,964,248900,70360
8570,5675,2895,743,127000,70363
10724,7155,3569,860,160600,70364
1142,955,187,863,83100,70372
2301,1849,452,647,130000,70373
2761,1971,790,833,126400,70374
33,33,0,-,233000,70375
1452,1168,284,588,90200,70377
9065,5371,3694,802,122800,70380
2914,2148,766,647,86500,70390
135,106,29,-,-,70391
2870,1785,1085,760,120000,70392
280,187,93,-,152200,70393
5723,4320,1403,648,148100,70394
1573,1273,300,859,138100,70395
375,307,68,-,139500,70397
8266,4054,4212,815,180800,70401
0,0,0,-,-,70402
11035,7062,3973,827,177400,70403
3221,2684,537,953,213500,70420
4878,3760,1118,733,117800,70422
1848,1331,517,527,91300,70426
7604,5089,2515,667,109500,70427
1936,1850,86,-,258500,70431
14291,10261,4030,1192,260200,70433
6356,5521,835,1051,217000,70435
245,187,58,-,253400,70436
3555,3272,283,992,222800,70437
7580,5655,1925,648,133100,70438
1758,1225,533,647,109000,70441
108,108,0,-,220000,70442
3506,2825,681,796,96900,70443
4709,3779,930,733,118600,70444
3958,3381,577,984,191300,70445
2246,2000,246,1028,176100,70446
5316,4897,419,1567,292200,70447
9086,7179,1907,1368,269300,70448
1467,1282,185,886,197800,70449
973,766,207,-,122300,70450
0,0,0,-,-,70451
4901,4345,556,808,165400,70452
244,217,27,-,156600,70453
10697,8555,2142,911,172700,70454
430,430,0,-,180000,70455
895,686,209,950,98600,70456
14866,10230,4636,1225,178700,70458
7477,5726,1751,1125,152700,70460
11902,9276,2626,1014,220900,70461
2143,1880,263,746,168400,70462
33,19,14,629,109400,70463
128,107,21,-,117700,70464
168,127,41,817,23700,70465
3187,2032,1155,714,153000,70466
8238,6148,2090,1031,308300,70471
10915,5140,5775,811,115000,70501
11815,8418,3397,988,230300,70503
17132,9006,8126,878,179700,70506
6826,4778,2048,836,160400,70507
16007,11030,4977,964,245400,70508
9977,6597,3380,700,123800,70510
4044,2915,1129,583,114000,70512
95,24,71,506,-,70513
899,386,513,827,111900,70514
1178,871,307,539,78800,70515
264,264,0,-,93400,70516
9769,7655,2114,817,121900,70517
5098,3990,1108,881,215600,70518
96,96,0,-,56200,70519
8704,6807,1897,834,176700,70520
383,296,87,845,-,70523
113,74,39,543,86400,70524
5184,3501,1683,674,104900,70525
7089,4287,2802,671,138600,70526
853,689,164,714,92400,70528
4517,3512,1005,732,142700,70529
755,621,134,-,185900,70531
996,835,161,592,85500,70532
2602,2063,539,702,115100,70533
208,140,68,593,82200,70534
6304,4040,2264,666,134500,70535
146,117,29,-,-,70537
5302,3490,1812,753,88400,70538
154,106,48,769,119600,70541
1234,1077,157,703,113600,70542
1748,1455,293,489,183800,70543
4178,3143,1035,729,98700,70544
6578,4663,1915,627,116700,70546
3697,2682,1015,399,93200,70548
1133,735,398,598,87300,70549
0,0,0,-,-,70550
511,316,195,924,79500,70552
2309,1165,1144,484,87800,70554
2987,2640,347,675,196300,70555
155,93,62,325,48300,70556
13,0,13,-,-,70558
986,654,332,434,90000,70559
14839,8692,6147,799,100800,70560
7185,5781,1404,956,166800,70563
14377,9728,4649,637,122100,70570
0,0,0,-,-,70575
494,374,120,644,158500,70576
1227,937,290,591,103300,70577
6036,4466,1570,703,130800,70578
88,22,66,-,-,70580
265,250,15,-,77500,70581
7116,5638,1478,625,124600,70582
4140,3134,1006,778,109600,70583
2519,1902,617,633,143600,70584
152,134,18,494,48300,70585
7229,4340,2889,610,94500,70586
978,681,297,535,125100,70589
1579,1279,300,781,132600,70591
8320,7015,1305,1053,207000,70592
13817,7462,6355,740,123700,70601
14887,10796,4091,1152,227100,70605
11329,6175,5154,801,124300,70607
7120,6143,977,875,209400,70611
4583,2878,1705,785,110100,70615
820,714,106,693,162000,70630
200,188,12,-,169800,70631
231,231,0,-,108300,70632
2683,2254,429,561,174700,70633
10565,8044,2521,781,151600,70634
351,319,32,-,-,70637
319,229,90,1038,104300,70638
127,127,0,-,-,70639
172,152,20,469,84200,70640
192,114,78,-,-,70643
228,228,0,-,103100,70644
582,503,79,830,162600,70645
229,142,87,-,74600,70646
3546,2680,866,905,202000,70647
2904,2251,653,698,128300,70648
41,23,18,-,-,70650
53,28,25,-,-,70651
554,478,76,-,58200,70652
1252,998,254,360,84200,70653
50,50,0,-,-,70654
946,714,232,622,77700,70655
1225,1001,224,972,61100,70656
1535,1444,91,785,123300,70657
271,234,37,775,105000,70658
436,233,203,838,127000,70659
648,514,134,-,-,70660
609,555,54,380,59000,70661
63,55,8,-,54300,70662
10638,7571,3067,759,144000,70663
4367,3564,803,1295,175000,70665
2779,2226,553,772,135800,70668
4453,3628,825,862,98400,70669
7755,6398,1357,1032,183300,70706
2019,1659,360,1083,210300,70710
1759,1417,342,682,193800,70711
95,8,87,779,16300,70712
6498,4843,1655,902,132200,70714
510,450,60,-,71300,70715
1587,1270,317,964,209900,70719
137,74,63,422,-,70721
2444,2024,420,516,147800,70722
503,425,78,1092,159600,70723
685,685,0,-,179600,70725
20130,16182,3948,970,173300,70726
331,319,12,-,247000,70729
1148,959,189,806,238500,70730
449,362,87,594,108300,70732
492,412,80,904,169000,70733
3190,2641,549,1188,249600,70734
190,179,11,-,98300,70736
16185,12380,3805,1092,205300,70737
4866,4491,375,1038,271200,70739
698,577,121,850,111400,70740
110,110,0,-,169400,70743
2251,2048,203,928,116000,70744
112,29,83,506,128700,70747
1759,1311,448,638,131600,70748
577,415,162,846,219100,70749
585,445,140,544,93200,70750
310,194,116,-,139100,70752
367,214,153,781,83200,70753
4445,3735,710,1063,133400,70754
662,560,102,679,133600,70755
146,146,0,-,166400,70756
1057,882,175,-,107600,70757
659,552,107,925,131400,70759
2888,1913,975,928,171800,70760
219,171,48,425,168800,70761
383,289,94,-,223000,70762
1549,1325,224,442,275400,70763
5810,4409,1401,854,145700,70764
5700,3999,1701,842,176700,70767
16086,14653,1433,1072,253600,70769
922,855,67,-,188500,70770
466,459,7,-,-,70772
101,59,42,-,144900,70773
3267,2735,532,933,191400,70774
3839,2860,979,883,245600,70775
1513,1020,493,692,280100,70776
1491,1134,357,872,153000,70777
935,832,103,825,203400,70778
424,424,0,-,131300,70780
39,16,23,-,225000,70782
1165,1066,99,1038,294400,70783
7662,6623,1039,973,184700,70785
229,168,61,-,-,70787
1510,914,596,571,117000,70788
327,228,99,-,113900,70789
9382,7421,1961,866,222500,70791
218,20,198,1421,-,70801
9459,3286,6173,781,84800,70802
0,0,0,-,-,70803
8806,3707,5099,801,80500,70805
12813,5257,7556,841,246800,70806
5271,2617,2654,714,94000,70807
16316,9415,6901,1079,302400,70808
11295,6118,5177,1180,239600,70809
15231,10836,4395,1171,312500,70810
4754,2939,1815,901,141100,70811
3236,2044,1192,927,115100,70812
4265,3184,1081,918,156800,70814
10629,7461,3168,877,168500,70815
16626,8417,8209,972,189700,70816
12239,10070,2169,1170,250000,70817
3334,2672,662,985,198500,70818
1453,1144,309,1266,143200,70819
6667,2016,4651,835,247000,70820
0,0,0,-,-,70836
1768,1184,584,527,81700,71001
445,374,71,843,82400,71003
240,170,70,892,143300,71004
4758,4213,545,1035,266000,71006
477,457,20,-,-,71007
353,259,94,567,56000,71008
761,575,186,490,71200,71016
693,459,234,254,53700,71018
2873,2001,872,545,84000,71019
359,176,183,451,29900,71021
1276,1133,143,783,75300,71023
582,497,85,415,83000,71024
551,336,215,883,-,71027
595,384,211,378,81300,71028
76,69,7,-,88500,71029
532,478,54,-,161000,71030
287,187,100,721,69600,71031
997,784,213,637,155800,71032
1446,1176,270,755,181600,71033
139,132,7,-,79200,71034
7077,6075,1002,918,156900,71037
1904,1217,687,512,71700,71038
617,537,80,795,70500,71039
2859,1828,1031,636,74800,71040
400,374,26,456,154000,71043
246,213,33,693,71400,71044
311,230,81,336,117700,71045
600,574,26,-,89700,71046
4479,3989,490,766,151700,71047
79,78,1,-,51100,71048
1280,929,351,647,79300,71049
990,842,148,1661,-,71051
3748,2122,1626,482,81700,71052
8100,5099,3001,735,111500,71055
847,654,193,938,115200,71060
723,421,302,411,135100,71061
375,284,91,-,27800,71063
1151,915,236,708,70500,71064
507,357,150,452,69500,71065
1070,734,336,654,84200,71067
1734,1256,478,351,71400,71068
294,225,69,-,47200,71069
579,502,77,600,75700,71070
1075,801,274,334,87500,71071
609,524,85,738,74100,71072
909,577,332,762,83900,71073
2525,1347,1178,625,68400,71075
2807,2323,484,983,166300,71078
56,49,7,-,177300,71079
2017,1387,630,609,59200,71082
2945,859,2086,640,80000,71101
2820,1528,1292,712,39100,71103
5843,2574,3269,895,143500,71104
9704,5261,4443,983,183900,71105
13877,9303,4574,765,270300,71106
11754,7516,4238,799,128800,71107
6622,3208,3414,813,75500,71108
7033,2742,4291,770,70800,71109
1241,0,1241,1406,-,71110
17971,10578,7393,901,217300,71111
13666,8056,5610,1031,157400,71112
7057,4537,2520,990,196700,71115
9030,5904,3126,863,148800,71118
4829,3820,1009,917,143900,71119
5016,2811,2205,788,157800,71129
8827,4536,4291,784,213600,71201
8090,3551,4539,671,66200,71202
14785,8868,5917,834,152900,71203
0,0,0,-,-,71209
459,395,64,-,81800,71219
7888,5080,2808,569,88300,71220
1299,918,381,472,83200,71222
120,84,36,604,48000,71223
2670,2441,229,927,191900,71225
742,498,244,496,101900,71226
1497,1020,477,780,151400,71227
593,526,67,-,135600,71229
2419,1574,845,646,77900,71232
123,83,40,638,-,71233
1386,1276,110,599,124200,71234
2014,1597,417,755,102900,71235
573,431,142,839,63700,71237
861,790,71,575,112400,71238
3582,2827,755,643,115700,71241
95,64,31,-,153100,71243
1593,665,928,671,155200,71245
655,443,212,479,64300,71247
110,42,68,-,38300,71250
2976,1820,1156,623,85300,71251
80,37,43,658,105400,71253
1455,778,677,598,53500,71254
297,243,54,404,45800,71256
762,629,133,741,107400,71259
1149,898,251,342,60000,71260
537,334,203,465,78300,71261
2871,2248,623,554,89100,71263
598,532,66,641,121800,71264
664,523,141,719,90700,71266
1017,934,83,525,113400,71268
4481,2821,1660,647,111700,71269
12138,5528,6610,739,163000,71270
0,0,0,-,-,71272
1044,701,343,751,69000,71275
25,4,21,-,-,71276
607,507,100,-,64100,71277
47,0,47,-,-,71279
1689,1102,587,896,154000,71280
3348,1841,1507,609,81800,71282
176,157,19,-,73900,71286
12966,8100,4866,781,164500,71291
7545,5294,2251,705,129000,71292
4834,3423,1411,644,86900,71295
8163,3661,4502,823,134100,71301
5192,2961,2231,768,86300,71302
8344,4796,3548,984,197900,71303
6,6,0,-,-,71316
2735,2001,734,898,98800,71322
803,759,44,-,-,71323
559,385,174,-,67500,71325
339,273,66,650,60400,71326
1222,845,377,633,115100,71327
3026,2705,321,932,162000,71328
489,471,18,-,210300,71331
202,148,54,525,-,71333
3213,2210,1003,617,77000,71334
703,498,205,579,80300,71336
85,85,0,-,118600,71339
367,318,49,258,-,71340
1073,718,355,795,111400,71341
2548,2171,377,597,126500,71342
2484,1951,533,673,86800,71343
47,0,47,-,-,71345
867,673,194,604,150800,71346
1659,1196,463,575,102500,71350
4590,2809,1781,647,107600,71351
735,610,125,293,93500,71353
721,682,39,-,133800,71354
1070,769,301,609,102100,71355
224,188,36,-,96600,71356
752,534,218,615,89400,71357
710,614,96,497,155900,71358
12683,8391,4292,754,159900,71360
696,503,193,547,87500,71362
629,418,211,577,68400,71366
595,492,103,573,-,71367
601,466,135,588,133600,71368
876,534,342,373,73500,71369
716,589,127,-,129600,71371
2215,1556,659,917,104800,71373
433,324,109,559,60800,71375
75,75,0,-,-,71377
1033,689,344,498,94500,71378
45,45,0,-,138000,71401
1571,1316,255,779,116000,71403
314,204,110,590,80000,71404
2096,1582,514,835,148300,71405
35,14,21,-,-,71406
441,412,29,-,401000,71407
2310,1515,795,803,152400,71409
31,25,6,-,75000,71410
1518,763,755,674,113600,71411
57,0,57,770,-,71414
637,411,226,717,76200,71416
1880,1230,650,655,102900,71417
2244,1509,735,718,76700,71418
660,551,109,-,68200,71419
630,538,92,584,76300,71422
1395,1159,236,863,126100,71423
623,601,22,-,109700,71424
13,0,13,-,-,71425
74,50,24,708,75000,71426
170,132,38,-,66200,71427
1344,889,455,684,109900,71429
1380,982,398,-,174400,71430
343,282,61,422,74100,71432
1530,1239,291,547,77700,71433
1542,1170,372,775,96700,71435
594,500,94,-,116600,71438
755,596,159,672,78100,71439
330,301,29,675,-,71441
7989,4986,3003,804,139600,71446
697,553,144,776,89300,71447
3388,2055,1333,583,129100,71449
387,261,126,727,58600,71450
29,28,1,-,-,71452
901,612,289,659,74600,71454
30,30,0,-,-,71455
522,278,244,758,159200,71456
9425,4322,5103,720,168600,71457
3395,5,3390,1000,-,71459
1264,515,749,652,118600,71461
733,581,152,625,42900,71462
3034,2074,960,657,96800,71463
1114,891,223,705,79900,71465
270,252,18,-,138500,71466
2004,1604,400,704,156900,71467
242,101,141,-,184800,71468
955,621,334,788,90600,71469
144,144,0,-,-,71472
158,130,28,-,47500,71473
147,117,30,-,131900,71474
271,209,62,729,124000,71479
335,301,34,-,47300,71480
3800,2430,1370,588,79300,71483
894,732,162,954,232000,71485
2196,1689,507,648,73400,71486
5584,2882,2702,696,54600,71601
6044,3635,2409,753,112600,71602
12637,8212,4425,783,89200,71603
234,203,31,578,66000,71630
231,226,5,-,54900,71631
4395,3323,1072,535,78500,71635
1195,818,377,555,67300,71638
2386,1487,899,548,83600,71639
1279,752,527,537,52400,71640
270,201,69,836,51700,71642
512,337,175,455,63000,71643
226,161,65,570,59200,71644
2390,1912,478,508,80700,71646
836,544,292,436,88800,71647
46,46,0,-,214100,71651
496,324,172,620,66200,71652
1707,1229,478,615,84600,71653
1888,1152,736,565,91500,71654
6017,3846,2171,661,110100,71655
277,202,75,620,50800,71658
181,181,0,-,-,71659
392,297,95,-,109200,71660
112,77,35,-,31100,71661
35,0,35,-,-,71662
234,189,45,470,65600,71663
2093,1671,422,630,92900,71665
38,10,28,-,-,71666
2684,2161,523,668,97500,71667
531,362,169,591,67500,71670
3207,1939,1268,602,98600,71671
272,230,42,804,87300,71674
737,629,108,625,100700,71675
197,154,43,875,55900,71676
68,62,6,-,46300,71677
7192,4933,2259,578,82100,71701
17,0,17,-,-,71711
999,716,283,503,61700,71720
37,30,7,-,-,71722
193,159,34,-,75500,71724
151,114,37,470,50000,71725
557,481,76,-,85700,71726
11816,8255,3561,708,108900,71730
571,471,100,-,120900,71740
1987,1296,691,724,77400,71742
1395,1009,386,669,91500,71743
1142,922,220,684,76400,71744
128,100,28,-,91400,71745
393,363,30,-,44000,71747
1155,1002,153,714,85500,71749
401,366,35,646,45000,71751
307,183,124,602,59700,71752
5976,3848,2128,715,105500,71753
42,42,0,-,-,71758
304,288,16,-,86800,71759
1055,831,224,869,86900,71762
759,633,126,444,79100,71763
626,505,121,-,81600,71764
1069,967,102,425,45800,71765
221,197,24,586,73800,71766
1256,1083,173,513,69600,71770
0,0,0,-,-,71772
6165,3924,2241,685,92000,71801
31,31,0,-,-,71820
3619,2824,795,623,82100,71822
16,13,3,-,57500,71823
147,124,23,595,70000,71825
471,358,113,419,50000,71826
345,311,34,-,-,71827
3584,2206,1378,611,103600,71832
870,722,148,355,72500,71833
529,501,28,-,-,71834
397,364,33,463,74500,71835
1155,874,281,492,67700,71836
1600,1357,243,719,83200,71837
451,395,56,740,-,71838
143,86,57,431,34000,71839
339,299,40,625,77200,71841
898,675,223,522,83100,71842
806,552,254,553,69100,71845
875,633,242,568,82100,71846
191,186,5,-,71100,71847
804,571,233,707,88600,71851
3763,2446,1317,634,114300,71852
163,129,34,586,40700,71853
13965,8732,5233,746,123200,71854
144,123,21,-,-,71855
1877,1178,699,706,68400,71857
835,634,201,911,50200,71858
268,207,61,-,111500,71859
909,691,218,554,59000,71860
865,727,138,589,70700,71861
312,230,82,648,24500,71862
98,69,29,1048,74100,71865
226,197,29,575,119000,71866
11911,6924,4987,703,132000,71901
7904,6826,1078,1076,192100,71909
19677,12721,6956,820,140200,71913
1189,940,249,633,79200,71921
60,29,31,668,37300,71922
6094,3288,2806,593,129400,71923
1692,1671,21,-,120600,71929
571,418,153,397,118700,71933
237,231,6,-,110100,71935
896,715,181,563,103500,71937
716,592,124,608,81400,71940
912,781,131,537,94100,71941
1721,1179,542,625,116800,71943
310,244,66,443,101600,71944
705,569,136,665,83100,71945
582,472,110,-,113500,71949
291,222,69,-,86300,71950
16,16,0,-,122200,71952
5491,4166,1325,680,118900,71953
573,442,131,618,69400,71956
1208,1010,198,566,125000,71957
923,620,303,539,79900,71958
273,259,14,-,116700,71959
695,566,129,446,102600,71960
446,371,75,1050,80400,71961
357,302,55,385,71800,71962
1870,1619,251,881,152200,71964
108,69,39,-,85000,71965
1799,1602,197,930,152900,71968
129,118,11,-,120800,71969
294,294,0,-,115700,71970
246,150,96,684,150500,71971
155,100,55,575,81100,71972
599,395,204,540,65100,71973
0,0,0,-,-,71998
0,0,0,-,-,71999
317,264,53,603,68300,72001
6432,5699,733,881,158900,72002
317,264,53,648,75200,72003
387,279,108,-,68800,72004
42,39,3,-,49300,72005
1178,734,444,489,83300,72006
2888,2314,574,1018,155300,72007
2467,1640,827,656,102400,72010
1341,1121,220,792,128000,72011
4411,2963,1448,690,147200,72012
893,605,288,686,129500,72013
10,9,1,-,-,72014
11137,7987,3150,808,133900,72015
1113,916,197,666,142400,72016
228,150,78,550,53300,72017
9926,7657,2269,871,185100,72019
1348,1148,200,569,62400,72020
1688,986,702,510,74500,72021
6801,4617,2184,807,160500,72022
14076,9883,4193,850,164000,72023
1598,1299,299,593,97800,72024
277,262,15,-,87900,72025
138,103,35,-,-,72026
629,495,134,-,121100,72027
720,407,313,348,61500,72029
280,251,29,-,56500,72030
2872,2120,752,519,108300,72031
12287,7423,4864,832,143300,72032
19442,10010,9432,822,188000,72034
0,0,0,-,-,72035
329,230,99,423,38000,72036
6,3,3,-,-,72037
21,13,8,-,-,72038
757,661,96,672,125200,72039
1123,765,358,531,79100,72040
652,486,166,520,29500,72041
2265,1537,728,613,96300,72042
416,374,42,810,172300,72044
827,623,204,827,77300,72045
1639,1035,604,679,89400,72046
252,224,28,533,188500,72047
29,29,0,-,-,72048
208,154,54,-,67500,72051
369,298,71,661,107900,72055
500,401,99,833,109100,72057
6122,4628,1494,794,161500,72058
22,22,0,-,-,72059
315,265,50,619,68600,72060
67,53,14,775,201800,72061
889,740,149,547,134200,72063
1123,834,289,752,79500,72064
1711,1431,280,741,134400,72065
1204,917,287,608,138600,72067
153,83,70,525,111000,72068
585,416,169,588,78000,72069
632,506,126,577,120300,72070
157,133,24,-,69500,72072
340,226,114,682,86200,72073
55,50,5,-,74000,72074
14801,8054,6747,808,122600,72076
318,310,8,-,63300,72079
153,140,13,-,-,72080
2710,1965,745,603,107800,72081
838,459,379,654,68400,72082
73,55,18,806,-,72083
416,338,78,588,55200,72084
88,38,50,743,91800,72085
4188,3102,1086,725,125600,72086
1108,1028,80,-,227000,72087
1408,1238,170,868,114300,72088
0,0,0,-,-,72099
1305,923,382,582,82700,72101
1228,1029,199,715,84200,72102
4726,3781,945,868,109600,72103
8313,6057,2256,634,96500,72104
2049,1486,563,797,117600,72106
135,131,4,-,99400,72107
20,20,0,-,-,72108
4589,2637,1952,607,106800,72110
490,438,52,767,175000,72111
3831,2441,1390,566,76100,72112
10975,6364,4611,902,220900,72113
5074,1435,3639,695,76700,72114
9460,6195,3265,920,184900,72116
5794,3676,2118,898,86600,72117
8716,5082,3634,815,105300,72118
0,0,0,-,-,72119
13326,9218,4108,883,156500,72120
1328,1065,263,665,119100,72121
260,234,26,-,-,72122
157,104,53,575,43300,72123
307,222,85,683,112500,72125
1245,963,282,584,113400,72126
806,717,89,626,108100,72127
274,228,46,688,112500,72128
455,422,33,560,79500,72129
213,159,54,458,127200,72130
1949,1630,319,728,119100,72131
1165,888,277,871,111000,72132
211,158,53,-,96300,72134
1254,1066,188,710,250700,72135
599,477,122,703,-,72136
822,630,192,498,87900,72137
104,42,62,318,83600,72139
130,107,23,-,99300,72140
223,174,49,-,95900,72141
932,808,124,718,169400,72142
12814,8103,4711,708,150600,72143
0,0,0,-,-,72149
4875,3539,1336,699,141700,72150
250,154,96,-,-,72152
1265,1101,164,608,127600,72153
152,133,19,-,254500,72156
517,449,68,760,135500,72157
3958,2415,1543,646,108300,72160
30,16,14,-,-,72165
39,35,4,-,-,72166
675,632,43,610,88100,72167
122,86,36,-,-,72168
32,28,4,-,46700,72169
158,137,21,-,72800,72170
3213,2853,360,756,154000,72173
151,90,61,902,64800,72175
2992,1929,1063,835,119000,72176
160,140,20,-,83300,72179
2,2,0,-,-,72181
853,357,496,1256,287900,72201
4961,1268,3693,839,138400,72202
12210,7189,5021,859,100800,72204
10486,5061,5425,923,170200,72205
8426,5345,3081,739,106300,72206
5174,3465,1709,831,332600,72207
11567,5512,6055,820,80600,72209
6465,3936,2529,881,194200,72210
10214,5167,5047,896,198500,72211
5103,4419,684,1065,281400,72212
10087,6459,3628,1072,365100,72223
4852,3269,1583,950,204900,72227
9894,4565,5329,712,86200,72301
58,43,15,-,49000,72311
8840,5018,3822,679,101600,72315
1,1,0,-,-,72320
75,33,42,1046,78100,72321
60,47,13,-,46300,72322
977,659,318,811,80100,72324
8,6,2,-,-,72325
945,533,412,643,66400,72326
604,453,151,556,96800,72327
15,0,15,-,-,72328
47,16,31,-,-,72329
183,147,36,594,56800,72330
1113,632,481,699,64500,72331
45,4,41,600,-,72332
247,174,73,375,57400,72333
6131,3113,3018,716,70600,72335
6,6,0,-,-,72338
91,77,14,675,-,72339
53,53,0,-,57700,72340
140,75,65,-,56400,72341
2013,660,1353,548,110600,72342
215,167,48,1065,53800,72346
318,239,79,471,55300,72347
1142,745,397,529,76800,72348
422,256,166,521,46300,72350
322,178,144,682,102600,72351
51,0,51,-,-,72353
969,631,338,555,57700,72354
950,717,233,807,88800,72355
431,270,161,529,41500,72358
218,94,124,671,18300,72359
2300,1254,1046,523,76800,72360
5724,3992,1732,866,163500,72364
1061,637,424,526,65100,72365
929,418,511,628,42200,72366
8,0,8,-,-,72367
532,359,173,504,84300,72368
2963,1467,1496,665,86600,72370
792,558,234,629,63200,72372
432,253,179,485,42300,72373
260,196,64,-,-,72374
622,502,120,635,79200,72376
50,9,41,-,-,72377
6,6,0,-,-,72379
54,54,0,-,-,72383
354,164,190,651,66400,72384
662,482,180,585,69100,72386
152,68,84,286,48100,72389
2993,1259,1734,572,74600,72390
232,191,41,469,47400,72392
165,109,56,541,24300,72394
518,329,189,543,128500,72395
4801,3172,1629,737,91600,72396
22747,11727,11020,758,149600,72401
11585,7366,4219,862,183800,72404
184,135,49,-,40600,72410
971,521,450,766,86300,72411
216,165,51,-,-,72412
241,162,79,586,52700,72413
137,82,55,422,67500,72414
469,396,73,532,68400,72415
1983,1407,576,744,123600,72416
2113,1297,816,776,128100,72417
688,488,200,568,56800,72419
179,61,118,570,74000,72421
1853,1119,734,545,79000,72422
26,17,9,-,-,72424
124,120,4,-,81700,72425
79,55,24,381,87600,72426
83,76,7,-,-,72427
52,16,36,530,85000,72428
107,62,45,507,61700,72429
181,133,48,575,28000,72430
176,130,46,558,-,72431
2573,1820,753,620,88100,72432
1194,775,419,519,71900,72433
855,729,126,428,82200,72434
284,246,38,-,45300,72435
322,270,52,837,89300,72436
1472,1031,441,829,93500,72437
988,595,393,495,83800,72438
110,79,31,545,83400,72440
31,30,1,-,101600,72441
1566,1077,489,623,128400,72442
1249,868,381,757,81100,72443
650,565,85,522,90100,72444
18,17,1,-,80800,72445
759,439,320,514,81200,72447
94,56,38,758,45000,72449
15108,9848,5260,725,132600,72450
86,75,11,-,56100,72453
1998,1306,692,751,93400,72454
5239,3796,1443,666,99000,72455
231,163,68,681,62200,72456
78,75,3,-,78600,72457
216,207,9,-,70200,72458
596,485,111,482,80300,72459
298,222,76,538,-,72460
1663,1210,453,531,81900,72461
187,94,93,483,55000,72462
62,49,13,525,31600,72464
515,374,141,437,58400,72466
25,0,25,-,-,72467
410,344,66,629,92000,72469
90,75,15,-,-,72470
464,333,131,370,59900,72471
3771,2242,1529,652,96700,72472
995,754,241,565,73600,72473
2708,1627,1081,582,77200,72476
84,84,0,-,64600,72478
601,306,295,671,67300,72479
477,358,119,528,66500,72482
9937,6983,2954,648,110000,72501
1061,828,233,623,82400,72512
1022,725,297,467,102100,72513
0,0,0,-,-,72515
111,111,0,-,-,72517
1086,843,243,647,95100,72519
218,218,0,-,23000,72520
2153,1610,543,534,73700,72521
172,142,30,-,75000,72522
467,396,71,441,87600,72523
137,75,62,766,257400,72524
59,37,22,383,53600,72526
193,179,14,-,130100,72527
32,32,0,-,-,72528
2186,1849,337,731,70000,72529
660,603,57,593,114100,72530
379,346,33,-,145800,72531
450,362,88,542,88300,72532
141,121,20,833,97200,72533
549,519,30,-,78300,72534
151,131,20,500,76900,72536
428,354,74,1042,85500,72537
338,338,0,-,126900,72538
84,84,0,-,155600,72539
31,18,13,775,129200,72540
1818,1620,198,573,84500,72542
5391,3857,1534,719,147100,72543
435,339,96,783,152000,72544
61,50,11,-,113600,72546
290,290,0,-,102400,72550
15,8,7,-,75000,72553
1059,885,174,498,85100,72554
101,75,26,-,187500,72555
1331,970,361,554,82700,72556
3405,2384,1021,617,151700,72560
211,180,31,446,87100,72561
922,629,293,498,78200,72562
105,78,27,-,92900,72564
264,229,35,589,72900,72565
335,310,25,-,58700,72566
94,82,12,-,92900,72567
458,355,103,900,80600,72568
233,202,31,-,83900,72569
158,158,0,-,55000,72571
118,57,61,-,73100,72572
94,79,15,-,-,72573
1553,1064,489,491,79500,72576
293,170,123,436,107100,72577
78,78,0,-,342600,72578
574,406,168,734,-,72579
600,561,39,-,114200,72581
700,519,181,685,78200,72583
140,140,0,-,68900,72584
103,103,0,-,100800,72585
8,6,2,-,-,72587
12056,8465,3591,648,131600,72601
537,433,104,718,157000,72611
3880,2971,909,496,116900,72616
67,66,1,-,65100,72617
804,592,212,527,128800,72619
361,347,14,-,123100,72623
145,128,17,-,122600,72624
764,617,147,556,147000,72626
385,338,47,-,108300,72628
208,199,9,-,61500,72629
108,91,17,450,93600,72630
2140,1726,414,583,188900,72631
1878,1386,492,629,172200,72632
726,669,57,548,118900,72633
1749,1307,442,608,128300,72634
1504,1169,335,731,100800,72635
3,3,0,-,187500,72636
2529,1640,889,549,117200,72638
233,195,38,-,110300,72639
169,169,0,-,142200,72640
1066,842,224,555,158500,72641
1007,859,148,704,135900,72642
1095,958,137,625,100300,72644
793,584,209,469,81000,72645
167,129,38,-,158800,72648
1716,1268,448,583,106600,72650
406,291,115,803,117200,72651
12827,9483,3344,727,140700,72653
183,162,21,-,108500,72655
510,419,91,545,125600,72658
327,308,19,775,104800,72660
297,243,54,-,95000,72661
1115,765,350,469,130000,72662
101,79,22,-,57300,72663
52,52,0,-,-,72666
91,91,0,-,262100,72668
46,45,1,-,-,72669
0,0,0,-,-,72670
85,52,33,675,34400,72672
598,432,166,509,95900,72675
133,78,55,736,86700,72677
7,0,7,-,-,72679
324,223,101,836,203400,72680
73,73,0,-,65200,72682
123,66,57,-,66300,72683
520,449,71,480,139500,72685
50,50,0,-,110500,72686
3135,2527,608,734,139600,72687
16655,6752,9903,813,244800,72701
14750,6132,8618,781,252900,72703
11276,6525,4751,1001,196300,72704
21868,12216,9652,977,266300,72712
5263,4532,731,1056,172400,72714
6765,5959,806,870,172800,72715
438,272,166,626,65200,72717
1359,1265,94,1567,297500,72718
5140,3328,1812,1116,190700,72719
189,189,0,-,214500,72721
988,662,326,681,114300,72722
2410,1890,520,799,134700,72727
56,56,0,-,-,72729
3264,2463,801,958,173300,72730
1783,1583,200,815,205100,72732
3312,2345,967,908,142300,72734
2343,1857,486,835,196900,72736
854,706,148,637,141700,72738
210,144,66,747,108600,72739
3095,2421,674,602,111000,72740
408,362,46,-,-,72742
1850,1267,583,839,143100,72744
4823,3357,1466,887,189300,72745
115,115,0,-,42600,72747
71,28,43,-,-,72749
3503,1832,1671,2107,145800,72751
163,130,33,-,90600,72752
3659,2636,1023,767,178100,72753
16049,10124,5925,738,159300,72756
15071,8946,6125,1008,236000,72758
114,109,5,-,107200,72760
7669,4911,2758,739,171300,72761
14885,10119,4766,915,189900,72762
19105,8630,10475,753,159400,72764
452,341,111,561,178500,72768
568,392,176,706,80000,72769
547,518,29,-,124800,72773
2318,1829,489,1061,154400,72774
294,254,40,-,110500,72776
6070,2786,3284,686,116200,72801
8430,7101,1329,768,162700,72802
734,569,165,547,71900,72821
2220,1600,620,665,96400,72823
667,392,275,605,95200,72824
24,11,13,-,-,72826
119,84,35,-,-,72827
77,18,59,-,-,72828
5886,3809,2077,634,122600,72830
358,242,116,441,70000,72832
1322,857,465,550,98400,72833
3690,2722,968,675,117700,72834
323,296,27,-,107700,72835
3065,2516,549,628,102900,72837
80,80,0,-,67800,72838
180,148,32,-,58700,72839
764,635,129,538,78500,72840
81,63,18,-,23300,72841
410,335,75,643,74400,72842
956,798,158,710,94100,72843
345,328,17,646,116400,72845
1463,1223,240,608,107900,72846
1094,924,170,897,87900,72847
225,218,7,-,137500,72851
71,71,0,-,114000,72852
878,640,238,437,125800,72853
396,353,43,655,81700,72854
2498,1877,621,572,95000,72855
136,126,10,-,152100,72856
717,551,166,318,92500,72857
1344,1126,218,656,142300,72858
81,75,6,-,220500,72860
728,629,99,646,117500,72863
482,422,60,767,129200,72865
9223,3790,5433,614,94300,72901
11296,5710,5586,689,167600,72903
7767,4025,3742,693,77900,72904
5855,3705,2150,828,144900,72908
3975,2719,1256,856,222500,72916
5091,3893,1198,618,150600,72921
2167,1514,653,983,97400,72923
277,199,78,694,129200,72926
2981,1974,1007,587,92300,72927
318,265,53,575,96100,72928
77,77,0,-,82800,72930
626,574,52,724,85000,72932
1970,1564,406,640,83200,72933
446,435,11,617,65000,72934
216,152,64,558,126500,72935
5632,4373,1259,743,136000,72936
1443,1104,339,718,109700,72937
445,329,116,728,68800,72938
787,688,99,700,121200,72940
1928,1620,308,644,131000,72941
1022,769,253,670,110100,72943
1028,847,181,601,94300,72944
168,55,113,845,60600,72945
1389,1297,92,513,97400,72946
1553,1396,157,590,75400,72947
122,122,0,-,-,72948
3906,2714,1192,597,107900,72949
279,216,63,-,158600,72950
359,286,73,619,68100,72951
946,916,30,-,88400,72952
142,134,8,-,28700,72955
13885,9630,4255,722,127000,72956
2809,1989,820,609,77600,72958
1210,1108,102,813,152500,72959
369,313,56,655,62300,73002
8690,5171,3519,1151,173300,73003
330,268,62,888,120800,73004
3454,2257,1197,603,70800,73005
1235,962,273,654,86200,73006
907,835,72,633,363400,73007
7761,4215,3546,921,130800,73008
479,353,126,528,95200,73009
6681,5734,947,849,184900,73010
160,149,11,631,40600,73011
14503,11966,2537,1658,241200,73012
19354,15093,4261,1194,233500,73013
445,359,86,931,127100,73014
1106,818,288,528,71900,73015
682,615,67,911,195100,73016
500,381,119,532,83600,73017
8028,5029,2999,734,99100,73018
0,0,0,-,-,73019
8602,7525,1077,1068,191100,73020
85,66,19,580,121400,73021
251,208,43,775,106800,73024
4565,4441,124,-,368400,73025
3828,3481,347,919,198600,73026
518,358,160,648,-,73027
1482,1182,300,781,124200,73028
619,527,92,441,106000,73029
1599,1010,589,716,121200,73030
101,80,21,829,-,73032
144,97,47,688,74400,73033
16703,12177,4526,993,304700,73034
7033,4366,2667,772,116700,73036
793,655,138,539,81600,73038
700,480,220,550,86200,73040
150,133,17,633,78300,73041
401,306,95,678,87100,73042
78,67,11,-,56400,73043
7792,6293,1499,767,143500,73044
4296,3469,827,885,164700,73045
1341,998,343,708,118100,73047
1086,850,236,688,129600,73048
2042,1615,427,830,149100,73049
15,7,8,579,-,73050
3016,2312,704,739,122500,73051
2510,1857,653,738,113500,73052
255,189,66,475,126400,73053
1760,1533,227,677,171300,73054
3783,2971,812,671,119000,73055
184,164,20,575,59300,73056
995,763,232,711,126600,73057
52,49,3,-,171900,73058
1208,848,360,396,117300,73059
679,586,93,775,149400,73061
562,445,117,473,71200,73062
290,274,16,625,132900,73063
8665,6885,1780,1052,179600,73064
3488,2943,545,777,201700,73065
147,126,21,725,69100,73066
855,741,114,836,107300,73067
4197,3296,901,909,143800,73068
10627,5230,5397,845,156600,73069
17544,8216,9328,889,157900,73071
18322,10440,7882,903,233600,73072
311,276,35,-,311500,73073
413,275,138,733,100500,73074
3754,2367,1387,648,107700,73075
2647,1995,652,757,95900,73077
3843,3710,133,896,233700,73078
172,131,41,750,96400,73079
3670,2375,1295,764,165200,73080
1191,958,233,567,84800,73082
2736,1810,926,-,87600,73084
3215,2411,804,766,134300,73086
4432,3995,437,789,188500,73089
272,212,60,690,166700,73090
304,213,91,660,75000,73092
1165,963,202,858,204200,73093
830,657,173,700,113100,73095
5143,2647,2496,675,194600,73096
44,44,0,-,-,73097
1435,999,436,708,104500,73098
22668,17300,5368,1076,169200,73099
1134,86,1048,1132,208700,73102
2979,1010,1969,865,276800,73103
1693,322,1371,1216,258800,73104
2924,1276,1648,939,117700,73105
4672,1797,2875,777,144000,73106
10620,5648,4972,866,109400,73107
4938,1725,3213,662,57200,73108
7531,3936,3595,701,67300,73109
14245,6519,7726,807,98200,73110
4784,2647,2137,830,70600,73111
14760,7452,7308,824,132800,73112
7921,3044,4877,905,100500,73114
8148,4758,3390,848,85900,73115
4250,3144,1106,1003,241900,73116
2825,1266,1559,688,112200,73117
6651,3868,2783,910,184200,73118
10359,5473,4886,809,63700,73119
17214,8968,8246,869,178600,73120
1306,971,335,760,206100,73121
5289,3230,2059,878,120200,73122
8530,3961,4569,773,116100,73127
2121,1512,609,1090,138800,73128
6238,3080,3158,769,54800,73129
7756,5938,1818,972,142300,73130
1562,1169,393,1038,280000,73131
10578,5813,4765,851,160600,73132
2874,510,2364,1049,-,73134
8554,5219,3335,1037,131200,73135
7347,3131,4216,779,123100,73139
982,634,348,805,101400,73141
6486,3798,2688,1040,256300,73142
542,0,542,1381,-,73145
1804,942,862,804,66100,73149
1902,1511,391,730,240900,73150
607,601,6,-,470800,73151
12288,7102,5186,918,114700,73159
23131,15183,7948,1045,150000,73160
11456,8353,3103,917,183900,73162
2067,1984,83,1018,262100,73165
804,563,241,1019,156900,73169
14624,11709,2915,1195,203800,73170
1101,1078,23,-,310000,73173
1910,1705,205,1364,164000,73179
13649,8611,5038,804,134500,73401
31,31,0,-,52300,73425
473,442,31,-,114700,73430
464,332,132,736,110700,73432
1040,777,263,661,101700,73433
198,151,47,789,80600,73434
31,25,6,-,55400,73437
1516,1132,384,629,60900,73438
3058,2426,632,696,115000,73439
133,111,22,-,131900,73440
66,60,6,425,-,73441
137,135,2,-,78300,73442
1295,960,335,788,109300,73443
38,38,0,-,-,73444
3193,2348,845,677,90800,73446
517,435,82,727,84900,73447
1949,1375,574,695,103400,73448
1281,956,325,727,106700,73449
561,485,76,656,86800,73450
245,197,48,683,259300,73453
234,186,48,660,53000,73455
737,600,137,493,78300,73456
382,259,123,805,118000,73458
428,306,122,859,135000,73459
1871,1203,668,574,95300,73460
260,185,75,660,73000,73461
1326,1164,162,684,100600,73463
348,300,48,532,137500,73481
57,47,10,600,52700,73487
276,201,75,770,81900,73491
7425,3259,4166,708,107400,73501
1595,3,1592,1213,-,73503
18319,9646,8673,778,120900,73505
8756,4553,4203,859,124100,73507
46,42,4,-,55000,73520
7898,4611,3287,738,102000,73521
817,634,183,754,115100,73526
1603,1299,304,724,159300,73527
183,131,52,900,107800,73528
1840,1391,449,664,77400,73529
168,139,29,542,41300,73530
107,93,14,-,151300,73531
205,125,80,621,113200,73532
10574,7618,2956,709,122800,73533
249,207,42,723,40300,73537
1871,1356,515,1322,204700,73538
120,120,0,-,105200,73539
113,80,33,825,175000,73540
1367,1179,188,742,127900,73541
1596,1108,488,629,49200,73542
907,720,187,944,103300,73543
113,107,6,-,62100,73544
523,394,129,608,50000,73546
537,418,119,100-,94300,73547
155,145,10,-,63000,73548
88,74,14,825,206300,73549
918,614,304,648,72900,73550
23,23,0,-,-,73551
449,382,67,750,109500,73552
14,13,1,-,259400,73553
1328,927,401,550,84800,73554
59,52,7,-,35000,73555
52,37,15,558,85500,73556
184,163,21,963,259900,73557
209,139,70,439,28600,73559
298,157,141,482,77400,73560
216,177,39,633,113400,73562
196,150,46,421,80000,73564
384,278,106,347,51500,73565
670,485,185,515,83000,73566
291,212,79,375,100000,73567
413,318,95,607,40700,73568
213,155,58,508,43600,73569
371,304,67,605,65200,73570
32,5,27,-,-,73571
1398,964,434,672,82500,73572
1022,734,288,512,69700,73573
3991,3032,959,753,106900,73601
452,319,133,675,129000,73620
142,117,25,788,68100,73622
731,315,416,705,92800,73624
231,184,47,810,92000,73625
355,303,52,753,127300,73626
221,173,48,930,-,73627
621,480,141,729,119900,73628
1207,781,426,730,89400,73632
54,45,9,-,280300,73638
205,159,46,544,108500,73639
189,142,47,519,49000,73641
59,47,12,-,-,73642
5424,3599,1825,783,155900,73644
542,344,198,665,69600,73645
174,169,5,-,87200,73646
179,167,12,-,137500,73647
300,272,28,555,138600,73650
1570,1057,513,657,62800,73651
355,293,62,736,129200,73654
339,283,56,536,63700,73655
98,82,16,-,65300,73658
46,36,10,483,151900,73659
131,102,29,-,82900,73660
170,151,19,741,83900,73661
1712,1196,516,689,95000,73662
467,320,147,818,116700,73663
621,496,125,588,84600,73664
93,73,20,-,-,73666
232,168,64,625,82900,73667
599,457,142,575,120400,73669
226,140,86,648,35700,73673
8975,5027,3948,695,77300,73701
11808,8159,3649,922,155000,73703
0,0,0,-,-,73705
249,221,28,478,126400,73716
2380,1522,858,724,117200,73717
195,169,26,860,96300,73718
27,23,4,-,-,73719
62,50,12,-,69200,73720
115,95,20,488,154600,73722
434,343,91,630,57800,73724
179,138,41,588,65000,73726
63,63,0,-,170400,73727
785,538,247,625,90000,73728
228,191,37,741,85900,73729
306,273,33,739,121900,73730
74,65,9,-,68300,73731
61,51,10,-,61000,73733
382,310,72,858,150800,73734
255,225,30,833,64700,73735
263,229,34,-,219700,73736
1478,1219,259,561,113100,73737
393,316,77,750,88200,73738
182,178,4,-,104500,73739
187,166,21,-,71400,73741
1388,983,405,801,118600,73742
25,15,10,-,77500,73743
55,50,5,-,65000,73744
14,10,4,-,-,73746
126,58,68,880,82500,73747
234,202,32,683,77000,73749
2644,2188,456,843,151900,73750
179,149,30,1307,107000,73753
411,343,68,863,119500,73754
322,264,58,431,95400,73755
146,132,14,775,137900,73756
82,58,24,-,131800,73757
52,46,6,-,-,73758
625,479,146,647,57300,73759
135,106,29,489,119100,73760
127,121,6,-,83100,73761
654,503,151,911,183000,73762
690,484,206,675,98600,73763
122,104,18,645,161100,73764
493,337,156,738,102500,73766
611,502,109,667,120200,73768
182,146,36,550,-,73771
1366,928,438,612,113000,73772
810,515,295,841,94900,73773
6141,4102,2039,791,139600,73801
428,365,63,548,98400,73832
596,497,99,541,85600,73834
105,76,29,-,73300,73835
157,127,30,594,160200,73838
236,212,24,867,93300,73840
190,146,44,645,81800,73841
218,185,33,-,156800,73842
296,194,102,683,69000,73843
111,88,23,-,93000,73844
670,507,163,660,83000,73848
32,24,8,-,228100,73851
702,590,112,863,121400,73852
148,121,27,-,182900,73853
42,23,19,-,-,73855
279,243,36,-,154200,73857
683,502,181,736,120300,73858
481,361,120,814,124100,73859
450,334,116,815,98500,73860
78,35,43,-,-,73901
291,238,53,625,78500,73931
725,516,209,702,107100,73932
618,456,162,588,56500,73933
84,56,28,-,-,73937
278,239,39,890,73100,73938
420,229,191,623,107200,73939
4097,2656,1441,810,127500,73942
166,102,64,620,57500,73944
991,704,287,755,109700,73945
13,9,4,-,-,73946
236,176,60,442,83000,73947
749,542,207,725,106300,73949
504,445,59,613,122300,73950
407,362,45,767,74300,73951
153,138,15,495,69100,74001
710,550,160,593,88600,74002
5496,3298,2198,720,82600,74003
10708,7957,2751,742,151200,74006
10826,8397,2429,1033,243500,74008
3785,2637,1148,625,124100,74010
10813,8566,2247,1174,176900,74011
23245,15958,7287,1027,165700,74012
14978,12846,2132,1154,182900,74014
3554,2337,1217,851,142900,74015
2296,1678,618,660,99300,74016
11021,7704,3317,892,144200,74017
7409,6089,1320,836,174000,74019
2889,2078,811,769,99700,74020
7671,6219,1452,1063,166200,74021
801,731,70,583,96000,74022
4132,2554,1578,643,109300,74023
282,215,67,681,71100,74026
391,314,77,538,106300,74027
659,544,115,635,100500,74028
1896,1410,486,623,95400,74029
1727,1250,477,515,64400,74030
698,578,120,661,112100,74032
4305,3061,1244,1115,138200,74033
37,34,3,-,55000,74034
1447,1086,361,626,67200,74035
2587,2080,507,829,152900,74036
6658,4946,1712,1226,218600,74037
841,734,107,758,108100,74038
1305,951,354,825,128700,74039
918,702,216,897,158100,74041
169,109,60,634,63000,74042
2835,2243,592,808,135200,74044
126,104,22,517,227800,74045
48,27,21,-,-,74046
2462,2109,353,806,146700,74047
2415,1678,737,645,87800,74048
147,103,44,621,-,74050
844,778,66,850,123500,74051
376,260,116,642,64800,74052
1858,1514,344,832,162400,74053
270,220,50,492,66500,74054
17274,12552,4722,1043,198600,74055
2210,1601,609,655,87100,74056
1557,1170,387,664,107800,74058
1940,1442,498,722,151600,74059
183,135,48,683,61300,74060
744,585,159,777,141300,74061
345,267,78,606,136600,74062
12285,9784,2501,847,145100,74063
12240,9329,2911,884,135600,74066
14,14,0,-,-,74068
5685,4031,1654,790,158700,74070
81,48,33,-,60000,74071
780,615,165,710,112300,74072
2000,1648,352,910,153800,74073
12506,6141,6365,888,200600,74074
11328,4987,6341,783,167100,74075
0,0,0,-,-,74078
1574,1196,378,681,117600,74079
990,795,195,825,163000,74080
705,638,67,789,86600,74081
25,20,5,-,63300,74082
406,326,80,855,150700,74083
198,153,45,613,66800,74084
901,713,188,736,120600,74085
367,3,364,1329,-,74103
5085,2426,2659,942,178400,74104
12362,6490,5872,854,251600,74105
7212,3108,4104,705,69100,74106
7976,4228,3748,787,97800,74107
3011,1981,1030,932,100100,74108
4891,2429,2462,776,56400,74110
9103,4956,4147,916,112600,74112
7064,5410,1654,1092,194800,74114
8323,4583,3740,842,61500,74115
1369,544,825,714,105300,74116
12,7,5,-,-,74117
2030,514,1516,839,174600,74119
2479,938,1541,820,293300,74120
3751,2179,1572,850,51900,74126
6618,3717,2901,820,86400,74127
4225,2477,1748,905,86300,74128
6978,3379,3599,795,113100,74129
713,479,234,820,57900,74130
1116,755,361,681,163800,74131
3691,2153,1538,925,193600,74132
19695,10283,9412,922,193300,74133
6375,3824,2551,851,131600,74134
8827,4652,4175,802,175900,74135
13547,5055,8492,778,235500,74136
10851,7390,3461,941,300500,74137
7894,4079,3815,800,125500,74145
5431,1905,3526,710,98700,74146
4317,2961,1356,729,112400,74301
1208,994,214,738,112900,74330
3457,2667,790,823,137900,74331
620,458,162,929,123000,74332
351,285,66,692,95000,74333
1888,1561,327,749,92600,74337
2005,1536,469,623,110500,74338
834,580,254,595,61500,74339
101,83,18,675,104500,74340
992,785,207,822,66100,74342
1240,904,336,630,93300,74343
6676,4940,1736,733,159600,74344
2513,1705,808,627,100900,74346
1010,856,154,625,71300,74347
130,69,61,540,75400,74349
290,207,83,712,106400,74350
2460,1989,471,679,94800,74352
6810,4462,2348,725,95500,74354
82,62,20,788,45500,74358
216,163,53,590,93000,74359
16,16,0,-,-,74360
6767,4485,2282,759,143300,74361
1024,787,237,668,86500,74363
748,640,108,447,115600,74364
1640,1223,417,757,95700,74365
558,484,74,744,79100,74366
213,187,26,791,97900,74367
31,17,14,645,57000,74368
767,610,157,667,101800,74369
1457,1131,326,597,104400,74370
6648,3936,2712,670,91600,74401
11959,7369,4590,687,117500,74403
1560,1248,312,778,129300,74421
297,251,46,910,93800,74422
309,249,60,781,89800,74423
407,295,112,651,100300,74425
3843,2906,937,617,94000,74426
502,491,11,-,115200,74427
488,449,39,860,144800,74428
5490,4346,1144,829,161300,74429
260,193,67,587,97100,74430
298,234,64,688,69500,74431
4332,3572,760,702,130500,74432
3725,2795,930,659,144500,74434
1273,1033,240,664,97100,74435
2023,1594,429,743,114600,74436
4080,2960,1120,646,74700,74437
47,39,8,-,34700,74438
1904,1584,320,709,108700,74441
378,325,53,788,98700,74442
1197,813,384,686,125200,74445
181,146,35,688,81000,74446
6199,3854,2345,648,77300,74447
605,529,76,775,94000,74450
1666,1388,278,685,130300,74451
153,128,25,723,178000,74452
1389,1095,294,643,153100,74454
1162,970,192,619,107600,74455
100,72,28,554,88300,74456
149,115,34,-,134400,74457
20,14,6,-,-,74458
39,34,5,625,93800,74459
79,63,16,538,57500,74460
3062,2306,756,644,114700,74462
72,35,37,679,-,74463
11237,6478,4759,674,130000,74464
5930,4063,1867,700,119300,74467
108,96,12,742,53800,74468
728,517,211,619,91700,74469
770,553,217,299,120200,74470
580,490,90,444,117000,74471
243,202,41,833,93600,74472
10,0,10,-,-,74477
11226,7891,3335,732,118800,74501
90,70,20,725,80000,74521
136,96,40,1098,110700,74522
2292,1590,702,461,77900,74523
3516,2455,1061,568,111500,74525
72,56,16,441,50000,74528
80,63,17,-,-,74530
330,235,95,596,68100,74531
360,287,73,625,98100,74533
56,49,7,-,115600,74534
57,52,5,-,83300,74535
723,516,207,343,103400,74536
1602,1175,427,616,80000,74538
69,61,8,-,97000,74540
128,111,17,-,152300,74543
266,187,79,705,68000,74546
1246,913,333,662,92300,74547
23,18,5,-,105000,74549
448,349,99,550,113500,74552
489,379,110,655,87400,74553
805,418,387,739,92000,74554
252,192,60,475,77000,74555
150,132,18,438,88800,74556
217,192,25,733,102600,74557
167,139,28,438,76200,74558
200,147,53,692,79300,74560
767,586,181,509,87500,74561
363,306,57,463,84800,74562
839,689,150,652,76500,74563
219,171,48,762,76600,74565
83,80,3,-,125000,74567
278,218,60,665,76000,74569
393,328,65,775,86500,74570
1602,1107,495,456,78500,74571
298,241,57,689,78300,74572
407,341,66,717,85500,74574
147,139,8,-,270500,74576
133,91,42,473,33900,74577
2298,1586,712,664,84900,74578
7298,4305,2993,698,80600,74601
4992,3775,1217,712,154700,74604
186,122,64,658,100800,74630
2877,1917,960,750,68900,74631
226,179,47,583,-,74632
205,188,17,608,119900,74633
100,75,25,744,86300,74636
653,537,116,475,39000,74637
85,74,11,-,70000,74640
255,235,20,513,115300,74641
190,155,35,675,56400,74643
205,170,35,622,52500,74644
49,47,2,-,-,74646
1217,923,294,636,92300,74647
219,196,23,575,72500,74650
332,233,99,443,260300,74651
373,327,46,575,55800,74652
1580,1084,496,603,71000,74653
9634,5268,4366,770,142400,74701
198,147,51,625,67200,74720
71,58,13,444,137500,74722
473,344,129,521,106300,74723
94,76,18,-,63300,74724
743,512,231,636,87300,74726
911,655,256,543,80800,74727
4355,3090,1265,587,97800,74728
1047,850,197,736,98500,74729
1990,1286,704,835,130800,74730
556,510,46,677,76700,74731
1428,1008,420,706,99700,74733
458,389,69,525,90200,74734
582,479,103,705,104700,74735
345,291,54,586,111900,74736
245,202,43,536,71200,74738
867,664,203,489,75200,74740
433,364,69,625,117700,74741
3404,2042,1362,579,104900,74743
3912,2372,1540,557,80600,74745
106,57,49,775,74200,74747
177,160,17,533,75300,74748
111,97,14,575,77300,74750
0,0,0,-,-,74753
188,140,48,825,34500,74754
22,22,0,-,"10,000-",74755
266,217,49,738,157900,74756
558,472,86,625,88600,74759
138,74,64,520,-,74760
32,24,8,575,95000,74761
1423,1093,330,624,103800,74764
553,452,101,403,65200,74766
8391,5027,3364,702,97700,74801
7716,5353,2363,748,153200,74804
11616,7193,4423,726,137200,74820
460,416,44,645,130200,74824
844,570,274,828,94200,74825
584,505,79,750,134100,74826
142,109,33,650,137500,74827
162,130,32,475,87700,74829
72,61,11,675,32300,74830
229,175,54,588,88300,74831
267,195,72,770,80700,74832
249,198,51,614,81400,74833
3046,2448,598,605,140400,74834
77,56,21,-,-,74836
124,106,18,725,59100,74837
244,190,54,575,55400,74839
681,507,174,689,115500,74840
45,38,7,-,156300,74842
161,149,12,692,87500,74843
139,105,34,725,113300,74844
150,119,31,363,58300,74845
2205,1610,595,563,75500,74848
1297,930,367,618,101700,74849
102,83,19,-,55600,74850
3590,3036,554,644,124400,74851
441,360,81,1017,113800,74852
638,509,129,604,64000,74854
1704,1365,339,804,117800,74855
303,239,64,783,113000,74856
3775,3353,422,757,140300,74857
2389,1634,755,573,88100,74859
637,581,56,613,114400,74860
1795,1442,353,599,120700,74864
624,529,95,660,116900,74865
206,155,51,725,70600,74867
4824,3210,1614,630,76700,74868
252,199,53,947,75000,74869
949,826,123,508,145500,74871
1225,861,364,562,109400,74872
3931,3041,890,760,99800,74873
370,322,48,694,104800,74875
733,662,71,684,111000,74878
704,545,159,653,69300,74880
2022,1601,421,579,92100,74881
843,574,269,541,68500,74883
2251,1471,780,653,70000,74884
712,414,298,586,68100,74901
1596,1184,412,694,86800,74902
845,709,136,615,80100,74930
459,410,49,688,88200,74931
927,714,213,690,106100,74932
68,49,19,733,29600,74935
465,339,126,714,104800,74936
1959,1372,587,654,66600,74937
229,173,56,447,81300,74939
924,717,207,623,105100,74940
941,699,242,571,84500,74941
62,45,17,-,66300,74942
43,29,14,-,63800,74943
529,436,93,485,71800,74944
124,90,34,575,64400,74945
32,14,18,500,32500,74946
4467,3487,980,688,93300,74948
98,68,30,750,80000,74949
606,378,228,723,87700,74951
4296,2774,1522,717,125700,74953
1727,1100,627,753,99600,74954
5863,3949,1914,682,104900,74955
662,485,177,682,95400,74956
427,371,56,509,101400,74957
2504,1827,677,658,88200,74959
4573,3042,1531,550,91600,74960
1652,1268,384,713,101000,74962
221,186,35,-,76400,74963
971,736,235,751,89700,74964
1842,1233,609,471,98100,74965
1418,1167,251,644,99000,74966
8404,1408,6996,1397,337300,75001
22483,17953,4530,1577,291600,75002
19537,10077,9460,1223,230400,75006
19744,14156,5588,1302,269900,75007
4850,4154,696,1598,293200,75009
12411,5606,6805,1393,347700,75010
14967,10263,4704,1436,421400,75013
16190,10972,5218,1492,414000,75019
8856,5369,3487,884,118800,75020
3445,2721,724,911,136200,75021
8760,7812,948,2085,446400,75022
18497,11671,6826,1511,292800,75023
17490,6911,10579,1474,432500,75024
18800,12708,6092,1496,363100,75025
17046,14236,2810,1751,341100,75028
11546,9816,1730,1394,354100,75032
41335,26713,14622,1421,428100,75034
25783,20049,5734,1854,388600,75035
12698,2199,10499,1160,279800,75038
10075,1536,8539,1525,453500,75039
18599,13016,5583,1288,166900,75040
9459,5504,3955,1072,151000,75041
10909,6248,4661,997,152000,75042
21160,12942,8218,1163,179700,75043
15607,10206,5401,1338,218400,75044
8815,7796,1019,1428,259700,75048
15316,6631,8685,1117,155100,75050
13453,6597,6856,963,118700,75051
29461,21229,8232,1326,191200,75052
3803,3356,447,2077,344400,75054
22310,14386,7924,1436,286600,75056
5685,2070,3615,1264,129200,75057
940,722,218,1235,357100,75058
14175,9002,5173,1069,158000,75060
17547,7087,10460,1008,155500,75061
16330,7153,9177,1084,175700,75062
15862,6082,9780,1332,378600,75063
4655,3204,1451,1278,225800,75065
25200,9479,15721,1213,229600,75067
21753,17070,4683,1724,276700,75068
14063,7199,6864,1151,297200,75069
37715,26299,11416,1578,341000,75070
20073,14783,5290,1675,332300,75071
18574,9393,9181,1380,244300,75074
14784,9262,5522,1350,292900,75075
3237,2584,653,1028,168600,75076
12871,10529,2342,1456,326800,75077
10001,9085,916,1685,465100,75078
19538,10743,8795,1414,315500,75080
15082,8296,6786,1396,252600,75081
8670,6152,2518,1685,362300,75082
12963,10467,2496,1338,294100,75087
9308,7776,1532,1618,232900,75088
11895,9832,2063,1593,239900,75089
8421,5667,2754,857,95400,75090
10849,6169,4680,968,170600,75092
19566,12415,7151,1487,477800,75093
6309,5627,682,2185,367900,75094
18172,13983,4189,1589,260500,75098
231,122,109,989,80700,75101
463,383,80,929,95000,75102
5797,4757,1040,963,172600,75103
15697,11249,4448,1475,191000,75104
79,56,23,-,137500,75105
1623,1405,218,1267,120200,75109
10234,6463,3771,789,108000,75110
1877,1580,297,1075,184300,75114
18989,12303,6686,1212,195900,75115
6811,4023,2788,1147,147700,75116
1446,1114,332,1042,162800,75117
9537,6648,2889,970,147600,75119
1806,1470,336,691,134800,75124
2387,1992,395,1025,114900,75125
15405,12737,2668,1524,231400,75126
757,616,141,716,156800,75127
866,704,162,2107,225700,75132
7328,4731,2597,1127,151300,75134
2236,1818,418,1034,182600,75135
6762,4776,1986,1360,185600,75137
2290,1718,572,712,90500,75140
984,538,446,1125,80500,75141
6246,4687,1559,1037,124100,75142
5340,4250,1090,892,117300,75143
1257,902,355,705,108300,75144
7089,4556,2533,1322,164300,75146
2396,1624,772,835,156100,75147
2655,1951,704,796,128500,75148
18502,11534,6968,1113,139400,75149
21308,9909,11399,1155,161000,75150
1668,1252,416,1308,125900,75152
151,127,24,690,92500,75153
13504,11032,2472,1245,212100,75154
945,776,169,845,103000,75155
6792,5401,1391,737,138100,75156
106,88,18,581,70000,75157
1328,1179,149,960,215000,75158
5553,4279,1274,1093,159100,75159
7941,5091,2850,1040,142800,75160
2448,1890,558,872,156800,75161
1178,961,217,922,78400,75163
310,233,77,1092,156800,75164
15206,9700,5506,1113,209700,75165
1467,1276,191,1720,258100,75166
3762,3370,392,1526,278800,75167
5110,3887,1223,761,117300,75169
1607,932,675,908,74300,75172
1477,1315,162,1139,215700,75173
6635,4346,2289,1024,116800,75180
7431,6426,1005,1763,191400,75181
1873,1811,62,-,397800,75182
10067,8998,1069,1601,230400,75189
11332,1197,10135,1797,630100,75201
1736,489,1247,1543,269200,75202
6759,2520,4239,888,108600,75203
18839,3576,15263,1538,378600,75204
9065,5470,3595,1742,1212700,75205
21248,5836,15412,1347,433100,75206
1979,10,1969,1619,-,75207
11241,6413,4828,1131,325800,75208
6807,4100,2707,1447,576300,75209
3108,965,2143,814,69200,75210
22763,12464,10299,967,122100,75211
8183,4203,3980,770,112500,75212
16061,8779,7282,1300,516200,75214
6601,2243,4358,863,82000,75215
18827,9548,9279,913,78100,75216
23659,13993,9666,990,94600,75217
9826,6523,3303,1375,353700,75218
15484,4777,10707,1405,324600,75219
14495,4381,10114,910,296500,75220
4705,2195,2510,1062,133000,75223
11879,5860,6019,927,147000,75224
9035,7142,1893,1976,1127600,75225
1960,203,1757,1301,81700,75226
19059,10669,8390,982,125300,75227
25843,11812,14031,940,165800,75228
11095,8032,3063,1144,430800,75229
13459,8110,5349,1130,656600,75230
17849,3061,14788,953,347700,75231
11467,7266,4201,1051,133500,75232
4908,2537,2371,1057,172300,75233
13859,8184,5675,1385,200000,75234
8583,2153,6430,1239,192700,75235
5869,2185,3684,995,153100,75236
9197,1210,7987,933,136800,75237
13292,6530,6762,1022,398200,75238
10283,2739,7544,1067,236500,75240
10701,6633,4068,985,96700,75241
28350,6884,21466,975,264800,75243
6113,3006,3107,1485,448300,75244
1319,206,1113,877,338500,75246
158,0,158,925,-,75247
16983,8731,8252,1289,419300,75248
5574,4141,1433,1620,161900,75249
2266,0,2266,1427,-,75251
12413,5405,7008,1102,411000,75252
6702,4229,2473,1145,54400,75253
12011,2120,9891,1188,288400,75254
0,0,0,-,-,75270
28296,6214,22082,1121,327500,75287
0,0,0,-,-,75390
7462,4083,3379,931,95000,75401
6424,4271,2153,1076,157500,75402
6031,4594,1437,1380,193800,75407
5461,4058,1403,1689,216000,75409
1881,1633,248,648,151100,75410
333,185,148,1077,-,75411
294,288,6,-,108200,75412
108,83,25,990,62300,75413
1264,1051,213,713,176400,75414
81,71,10,-,134600,75415
1096,916,180,773,126200,75416
957,826,131,558,103000,75417
4835,3318,1517,881,123000,75418
514,447,67,760,110000,75420
215,186,29,727,103700,75421
1172,920,252,930,119200,75422
1124,940,184,874,108300,75423
1047,877,170,1212,189700,75424
2072,1428,644,583,52700,75426
3595,1827,1768,844,99300,75428
607,405,202,812,58900,75431
1220,863,357,614,102600,75432
1185,926,259,833,116000,75433
499,329,170,539,64800,75435
805,630,175,477,119700,75436
425,397,28,950,133000,75437
364,281,83,1549,108700,75438
431,247,184,847,98100,75439
2580,2121,459,656,135100,75440
137,137,0,-,63600,75441
3353,2608,745,1256,215500,75442
1346,984,362,630,120700,75446
435,409,26,-,173600,75447
258,248,10,-,115000,75448
483,309,174,792,96400,75449
112,104,8,-,187500,75450
556,492,64,-,117600,75451
1480,1055,425,879,163400,75452
970,778,192,1073,142100,75453
3401,2972,429,1814,315000,75454
9384,6049,3335,739,106900,75455
2154,1621,533,844,140200,75457
1822,1277,545,903,134000,75459
10067,5160,4907,719,84200,75460
4654,3406,1248,767,170400,75462
393,360,33,-,78900,75468
128,117,11,-,154000,75469
77,77,0,-,55200,75470
545,331,214,1069,123500,75471
1402,1018,384,781,125700,75472
1300,1187,113,647,96500,75473
5748,4572,1176,879,119700,75474
53,53,0,-,97500,75475
469,415,54,880,145200,75476
420,296,124,583,-,75477
354,276,78,783,106500,75478
690,543,147,798,119500,75479
821,813,8,-,257200,75480
141,132,9,-,132600,75481
9336,6119,3217,837,124900,75482
847,749,98,-,143200,75486
605,488,117,566,100700,75487
263,223,40,-,172500,75488
397,245,152,959,115500,75489
974,838,136,1147,191000,75490
1761,1432,329,699,160500,75491
171,155,16,525,144200,75492
153,108,45,633,50000,75493
3632,2958,674,801,135600,75494
2737,2265,472,1041,215900,75495
1137,956,181,808,132400,75496
1694,1420,274,705,210200,75497
13062,7521,5541,692,104200,75501
9979,6570,3409,928,179700,75503
272,236,36,440,61800,75550
4246,3423,823,811,115000,75551
887,772,115,538,112500,75554
696,617,79,641,76200,75555
459,362,97,840,81700,75556
743,707,36,-,67300,75558
2178,1552,626,639,95100,75559
526,444,82,1019,57600,75560
2075,1477,598,729,87600,75561
66,66,0,-,70000,75562
1877,1340,537,531,81800,75563
125,79,46,-,83100,75565
286,281,5,-,94100,75566
1728,1315,413,834,107500,75567
1019,701,318,785,93300,75568
1367,734,633,789,112700,75569
3050,2024,1026,645,99700,75570
1101,1004,97,483,92400,75571
1438,1195,243,588,59500,75572
13,9,4,-,-,75573
620,516,104,559,79400,75574
5658,3549,2109,760,144900,75601
6847,4306,2541,767,87500,75602
2330,2065,265,967,130900,75603
11635,6567,5068,861,142400,75604
13500,7376,6124,963,194300,75605
1015,881,134,736,107700,75630
1050,814,236,782,95700,75631
5000,3608,1392,671,126000,75633
2242,1685,557,673,80000,75638
1065,954,111,869,122100,75639
1818,1426,392,786,178800,75640
63,38,25,825,102500,75641
6,6,0,-,-,75642
857,674,183,645,116700,75643
4500,3242,1258,751,135900,75644
3811,3351,460,987,161100,75645
4466,3109,1357,870,137700,75647
3647,2356,1291,973,159400,75650
917,788,129,894,156600,75651
4672,3340,1332,800,167600,75652
4550,3595,955,708,139700,75654
1764,1290,474,664,96200,75656
3220,2394,826,727,103300,75657
929,764,165,678,87500,75661
8723,6643,2080,859,124300,75662
475,358,117,872,86000,75667
1086,682,404,763,119100,75668
337,321,16,-,104000,75669
6358,3672,2686,740,75900,75670
5937,4768,1169,863,138800,75672
1045,924,121,715,128600,75681
175,175,0,-,155100,75682
1513,1219,294,919,102400,75683
2402,1919,483,807,111900,75684
4619,3383,1236,752,115500,75686
1411,1097,314,816,127200,75691
1458,1320,138,1105,97200,75692
2249,1551,698,1054,167500,75693
12409,7111,5298,949,141300,75701
8027,4135,3892,746,81200,75702
16365,8951,7414,1022,239300,75703
3031,2416,615,877,125100,75704
868,703,165,-,-,75705
3089,2367,722,736,127000,75706
5118,4009,1109,1214,191800,75707
2625,1951,674,737,113500,75708
1888,1155,733,1064,135300,75709
1175,930,245,803,124600,75750
5840,3391,2449,839,115600,75751
2770,2363,407,809,135400,75752
2769,2170,599,954,192800,75754
1824,1050,774,754,155200,75755
1564,1214,350,906,108700,75756
4576,3916,660,1122,203300,75757
3446,2777,669,847,108600,75758
32,30,2,-,84600,75759
1019,827,192,540,131400,75760
4975,4011,964,1030,191800,75762
2437,2150,287,789,107800,75763
80,45,35,488,49300,75764
2958,2465,493,814,132900,75765
9982,6926,3056,781,111000,75766
1002,866,136,779,164200,75770
7109,5690,1419,1100,199300,75771
4939,3667,1272,797,153500,75773
1011,806,205,664,101000,75778
24,24,0,-,68600,75779
63,51,12,475,-,75780
3160,2653,507,780,123600,75783
225,194,31,838,114300,75784
3382,2566,816,807,97800,75785
25,0,25,-,-,75788
2926,2221,705,898,167100,75789
1348,1012,336,809,127700,75790
4649,3482,1167,1061,163400,75791
953,775,178,1035,109100,75792
6049,3639,2410,826,121000,75801
5726,4450,1276,842,116200,75803
2209,1582,627,784,88700,75831
0,0,0,-,-,75832
1025,776,249,776,135400,75833
4630,3072,1558,663,108900,75835
243,186,57,-,190600,75838
2161,1779,382,906,94700,75839
2278,1667,611,755,142400,75840
2310,1747,563,723,111100,75844
1276,1034,242,694,78300,75845
1183,935,248,695,143100,75846
713,535,178,595,86500,75847
42,27,15,610,58500,75848
17,5,12,679,-,75849
474,418,56,-,161100,75850
947,797,150,792,131900,75851
478,382,96,867,119000,75852
294,210,84,660,-,75853
1208,1018,190,816,94400,75855
64,16,48,-,-,75856
0,0,0,-,-,75858
894,733,161,1310,137100,75859
1698,1421,277,717,89500,75860
715,411,304,810,83200,75861
4188,3113,1075,620,89500,75862
10262,6624,3638,847,119300,75901
13009,7680,5329,836,129400,75904
1447,917,530,656,87000,75925
511,423,88,643,79900,75926
479,429,50,-,67300,75928
743,546,197,428,156500,75929
734,664,70,892,67700,75930
868,779,89,1070,111200,75931
604,573,31,-,98600,75932
393,346,47,-,60200,75933
72,51,21,-,68500,75934
4802,3695,1107,659,75200,75935
334,287,47,-,107600,75936
374,319,55,544,74600,75937
1060,883,177,756,106100,75938
1859,1276,583,536,70200,75939
2536,1969,567,396,87700,75941
30,30,0,-,-,75942
462,381,81,959,124000,75943
475,455,20,658,75800,75944
1539,1130,409,758,109700,75946
2717,2371,346,669,120700,75948
3385,2460,925,667,74700,75949
6089,4213,1876,804,101500,75951
1065,808,257,672,93100,75954
3664,2820,844,645,120000,75956
300,262,38,-,129500,75959
163,160,3,-,101900,75960
6063,2976,3087,770,110500,75961
0,0,0,-,-,75962
6556,4089,2467,770,95100,75964
7642,3870,3772,770,186900,75965
1647,1178,469,586,79800,75966
868,672,196,547,70800,75968
1378,1239,139,-,123100,75969
2795,2007,788,629,69400,75972
1188,997,191,-,108600,75973
1294,867,427,444,79400,75974
1454,1055,399,663,129400,75975
267,153,114,567,48400,75976
199,168,31,-,45500,75977
62,55,7,-,85000,75978
3727,2946,781,781,80900,75979
949,790,159,806,76700,75980
11012,8913,2099,1482,232000,76001
9491,8026,1465,1887,204500,76002
11809,2988,8821,1060,249200,76006
6479,6064,415,2002,339400,76008
6363,4651,1712,907,127700,76009
18019,6146,11873,960,115700,76010
9853,1771,8082,984,139800,76011
10465,6600,3865,984,217900,76012
13041,6516,6525,1028,213400,76013
10442,5385,5057,1212,134700,76014
6313,2977,3336,1251,160300,76015
11103,9064,2039,1604,215100,76016
16288,11184,5104,1154,196000,76017
8364,6118,2246,1556,164800,76018
10767,8396,2371,919,179900,76020
14388,7694,6694,1145,258200,76021
5679,2955,2724,1222,177800,76022
2325,1942,383,989,175800,76023
24470,18392,6078,1342,210200,76028
6115,4509,1606,941,146600,76031
9625,6293,3332,1019,148300,76033
9215,8833,382,2261,566500,76034
738,635,103,1271,293400,76035
8872,6582,2290,1329,199700,76036
15650,6202,9448,1295,222000,76039
11799,5707,6092,969,221300,76040
201,177,24,-,109800,76041
2482,1972,510,715,218100,76043
2041,1684,357,873,264800,76044
9933,7031,2902,945,163100,76048
11604,10068,1536,1125,232600,76049
2209,1773,436,967,174500,76050
21843,11740,10103,1445,338600,76051
7057,6351,706,1591,287700,76052
10878,5867,5011,1115,178000,76053
4489,3651,838,1406,268100,76054
1146,858,288,761,109000,76055
6917,5208,1709,1048,137500,76058
1740,643,1097,854,112900,76059
3013,2149,864,1047,236400,76060
39,39,0,-,-,76061
24595,18443,6152,1413,280600,76063
690,424,266,1216,183500,76064
12749,10476,2273,1242,267200,76065
1281,1034,247,510,234200,76066
6799,4789,2010,844,111000,76067
424,424,0,-,-,76070
1138,892,246,878,181600,76071
1945,1555,390,998,163100,76073
163,163,0,-,190300,76077
2773,2351,422,1216,175500,76078
6258,5258,1000,1076,164700,76082
2580,2228,352,949,148400,76084
3322,2772,550,1062,246000,76085
8314,4362,3952,1075,154300,76086
10259,9271,988,1217,264600,76087
4292,3528,764,1035,254500,76088
9388,8879,509,1337,699200,76092
1153,835,318,874,86200,76093
3795,1063,2732,1364,275800,76102
5268,3427,1841,881,117400,76103
6693,2779,3914,1045,83800,76104
6637,3729,2908,879,80800,76105
10848,4985,5863,938,89800,76106
14592,7025,7567,1190,327000,76107
15347,10395,4952,1157,167400,76108
9288,4994,4294,1244,498300,76109
11134,6840,4294,1025,144100,76110
6966,4110,2856,996,111900,76111
16697,7978,8719,939,134800,76112
9281,5158,4123,983,113900,76114
6142,2908,3234,910,83600,76115
22025,7505,14520,996,218900,76116
10601,5510,5091,976,121200,76117
5480,4158,1322,1055,196500,76118
14780,7495,7285,948,84300,76119
7362,3573,3789,1053,190600,76120
11462,8936,2526,1738,184500,76123
8455,6942,1513,1221,236500,76126
51,10,41,1896,-,76127
0,0,0,-,-,76129
15265,11795,3470,1549,229300,76131
12523,3826,8697,1091,309900,76132
18593,11716,6877,1127,155300,76133
9347,5287,4060,1113,134400,76134
7748,5256,2492,1018,180100,76135
20835,12713,8122,1360,196800,76137
9603,6504,3099,1099,135800,76140
7684,6217,1467,1446,151900,76148
3239,0,3239,1186,-,76155
4022,2222,1800,887,88100,76164
3818,2282,1536,1518,262400,76177
23296,17916,5380,1563,226000,76179
15102,7735,7367,1192,206600,76180
11508,9601,1907,1314,262000,76182
10013,2274,7739,954,190400,76201
7450,2781,4669,1112,242200,76205
5733,3807,1926,1222,264400,76207
7648,5321,2327,1272,268500,76208
9607,4424,5183,1123,192500,76209
15190,11447,3743,1490,258900,76210
979,798,181,797,172400,76225
9365,8695,670,1971,420700,76226
12223,10146,2077,1684,259800,76227
463,372,91,829,87900,76228
3954,3102,852,974,136700,76230
1161,813,348,1025,174900,76233
6391,4884,1507,1087,204000,76234
126,76,50,-,76300,76238
583,412,171,732,175000,76239
11017,7066,3951,941,153100,76240
24890,18574,6316,1612,267700,76244
733,579,154,719,121600,76245
4136,3510,626,1531,224200,76247
13647,10838,2809,1546,392000,76248
2835,2320,515,1274,197200,76249
359,314,45,1094,190400,76250
278,223,55,1161,161700,76251
942,747,195,886,210700,76252
94,80,14,-,-,76253
2171,1521,650,645,104600,76255
2537,1725,812,1068,265900,76258
1985,1689,296,1161,225400,76259
113,79,34,-,52500,76261
14732,11071,3661,1260,418800,76262
12,12,0,-,-,76263
600,436,164,810,164800,76264
656,513,143,663,144700,76265
5458,4267,1191,1198,225900,76266
81,66,15,-,34000,76268
758,651,107,436,-,76270
634,539,95,1107,252700,76271
1711,1533,178,887,209400,76272
3610,2747,863,1032,178600,76273
6201,3008,3193,679,56000,76301
5264,3251,2013,848,114400,76302
1685,1480,205,777,120300,76305
5906,3246,2660,796,79800,76306
8337,4674,3663,874,156300,76308
5414,3336,2078,850,105000,76309
7230,5167,2063,873,147600,76310
618,9,609,1324,-,76311
803,596,207,538,88500,76351
5107,3364,1743,783,106700,76354
212,173,39,727,73300,76357
1563,1124,439,546,45100,76360
125,111,14,-,23700,76363
79,47,32,1589,59000,76364
1911,1484,427,778,104300,76365
839,638,201,896,118600,76366
3638,3086,552,1010,102100,76367
146,119,27,-,19800,76370
589,538,51,416,47900,76371
397,285,112,458,73500,76372
68,68,0,-,-,76373
1759,1207,552,636,75500,76374
192,164,28,575,58400,76377
197,157,40,809,115900,76379
1636,1211,425,481,68300,76380
4755,2822,1933,680,74200,76384
104,73,31,790,30800,76388
574,497,77,612,159100,76389
10557,6093,4464,965,174200,76401
0,0,0,-,-,76402
3149,2369,780,710,79100,76424
4203,3037,1166,914,159500,76426
365,215,150,840,94200,76427
129,28,101,-,260000,76429
930,756,174,587,106300,76430
1426,1257,169,971,141300,76431
574,526,48,913,158700,76432
611,568,43,1203,306300,76433
208,196,12,-,64300,76435
55,44,11,-,355600,76436
2165,1816,349,617,97000,76437
3038,2536,502,480,115000,76442
801,614,187,664,91700,76443
1427,1104,323,601,82100,76444
164,164,0,-,-,76445
2755,2396,359,808,137400,76446
2004,1559,445,818,123800,76448
1010,856,154,694,141000,76449
5352,4110,1242,716,144900,76450
27,27,0,-,-,76452
595,516,79,847,218400,76453
703,417,286,385,69500,76454
356,309,47,-,112900,76455
1473,1110,363,717,109000,76457
2144,1687,457,628,92500,76458
74,68,6,-,71500,76459
165,129,36,-,178000,76460
1374,1233,141,1045,202200,76462
187,161,26,1050,64300,76463
262,201,61,675,63500,76464
91,91,0,-,-,76466
41,41,0,-,55600,76469
1304,897,407,650,61000,76470
734,580,154,593,57400,76471
615,444,171,880,123600,76472
137,133,4,-,318900,76474
447,318,129,606,77900,76475
1064,882,182,883,165700,76476
49,36,13,-,-,76481
447,313,134,-,48900,76483
331,298,33,732,124200,76484
408,359,49,533,182500,76486
779,719,60,1260,164800,76487
49,38,11,-,-,76490
211,168,43,674,82900,76491
6342,4132,2210,699,120600,76501
15313,10158,5155,1117,166500,76502
9009,3072,5937,879,98500,76504
0,0,0,-,-,76508
775,585,190,665,101700,76511
14123,9398,4725,960,179300,76513
550,443,107,671,96800,76518
153,120,33,-,140800,76519
2881,1929,952,675,99800,76520
14201,8635,5566,855,121100,76522
0,0,0,-,-,76523
1342,1082,260,951,158300,76524
525,412,113,644,97900,76525
1187,800,387,854,289300,76527
5708,4313,1395,675,130600,76528
616,473,143,779,152400,76530
1537,1314,223,607,137600,76531
1116,892,224,853,159100,76534
2030,1640,390,1296,188800,76537
466,402,64,-,120800,76538
3106,2895,211,786,198400,76539
7766,1967,5799,711,71600,76541
18315,10302,8013,1063,161800,76542
12618,4786,7832,888,96900,76543
2978,57,2921,1203,-,76544
10945,6104,4841,907,200900,76548
18213,9072,9141,1107,146400,76549
5248,3829,1419,752,158200,76550
835,607,228,930,133200,76554
636,577,59,650,103800,76556
2033,1637,396,855,170500,76557
2170,1339,831,937,141400,76559
382,287,95,589,97000,76561
51,51,0,-,-,76565
73,68,5,-,185000,76566
3628,2574,1054,724,115800,76567
824,652,172,838,77900,76569
894,712,182,600,72000,76570
3096,2631,465,760,283700,76571
10,10,0,-,-,76573
6571,4594,1977,880,174800,76574
1166,908,258,821,152400,76577
378,295,83,964,163500,76578
1855,1284,571,739,137600,76579
0,0,0,-,-,76596
0,0,0,-,-,76597
0,0,0,-,-,76598
0,0,0,-,-,76599
416,379,37,775,199600,76621
504,431,73,1026,158100,76622
83,74,9,-,93300,76623
833,691,142,700,102700,76624
435,314,121,1002,125000,76626
493,431,62,967,87400,76627
43,38,5,-,-,76628
864,644,220,653,115600,76629
524,466,58,981,120700,76630
183,148,35,790,113900,76631
512,410,102,1090,102200,76632
1746,1621,125,917,236000,76633
2988,2297,691,666,152100,76634
449,316,133,663,66800,76635
577,513,64,663,181500,76636
216,153,63,515,261800,76637
1134,1043,91,1085,243000,76638
649,387,262,515,101500,76639
1083,770,313,810,88800,76640
625,527,98,688,110400,76641
2403,1697,706,661,147800,76642
5167,3565,1602,1224,174900,76643
3753,2262,1491,814,96500,76645
1014,727,287,729,84000,76648
297,249,48,850,112500,76649
57,49,8,-,75000,76650
1481,1011,470,904,148100,76651
464,405,59,756,150600,76652
590,489,101,-,141100,76653
56,30,26,842,137500,76654
2938,2605,333,1026,198100,76655
825,682,143,700,108100,76656
3784,2837,947,1010,253000,76657
186,135,51,805,87100,76660
2355,1511,844,508,47700,76661
1083,788,295,811,99800,76664
1057,668,389,584,108900,76665
94,68,26,-,107500,76666
3775,2710,1065,690,91200,76667
523,354,169,855,101900,76670
703,589,114,743,148500,76671
482,352,130,710,150000,76673
110,103,7,-,71000,76676
77,38,39,-,138600,76678
434,397,37,-,114200,76679
64,64,0,-,-,76680
272,209,63,978,105900,76681
992,779,213,952,106300,76682
23,23,0,-,-,76685
90,67,23,1264,88100,76686
801,713,88,846,243300,76687
1454,1146,308,950,151600,76689
366,274,92,824,92500,76690
2316,1798,518,869,141300,76691
3915,2926,989,672,116500,76692
707,465,242,737,200600,76693
696,151,545,1029,153000,76701
3186,1118,2068,616,102700,76704
11050,6300,4750,743,109900,76705
13488,5278,8210,877,127000,76706
5437,2767,2670,836,81200,76707
9641,5938,3703,875,139700,76708
10943,5393,5550,855,151900,76710
3653,2015,1638,1143,72500,76711
9926,6895,3031,1023,218600,76712
0,0,0,-,-,76798
9368,6177,3191,803,98600,76801
1955,1541,414,785,131100,76802
53,42,11,-,377800,76820
1864,1349,515,855,82700,76821
1168,980,188,604,89000,76823
13,0,13,-,-,76824
2550,1691,859,731,93000,76825
289,266,23,-,160000,76827
106,102,4,-,-,76828
0,0,0,-,-,76831
182,105,77,627,169300,76832
2267,1681,586,713,74600,76834
1,1,0,-,-,76836
480,357,123,625,81200,76837
18,0,18,-,-,76841
114,110,4,-,-,76842
1246,1066,180,647,128600,76844
100,88,12,-,165000,76845
40,40,0,-,-,76848
1649,1248,401,674,123200,76849
132,108,24,664,187500,76852
474,371,103,1250,161500,76853
160,56,104,-,-,76854
1445,1061,384,728,214500,76856
868,646,222,-,150000,76857
131,101,30,-,50500,76858
951,596,355,693,76000,76859
628,481,147,720,118000,76861
96,85,11,-,182700,76862
292,272,20,636,173400,76864
85,81,4,-,95500,76865
250,221,29,818,165900,76866
24,24,0,-,1073500,76869
68,58,10,-,-,76870
311,223,88,875,161400,76871
359,314,45,668,141300,76872
41,38,3,-,-,76873
14,14,0,-,-,76874
246,197,49,1013,132100,76875
1539,1099,440,779,116400,76877
656,448,208,656,80400,76878
108,85,23,-,213000,76882
45,38,7,-,-,76884
73,50,23,-,-,76885
71,60,11,-,232100,76887
80,54,26,-,-,76888
335,272,63,674,113000,76890
11096,7857,3239,937,129600,76901
11403,7083,4320,785,86200,76903
14479,8918,5561,890,203600,76904
4521,2975,1546,1026,135700,76905
0,0,0,-,-,76908
30,30,0,-,84000,76930
1176,732,444,857,98500,76932
593,363,230,714,94700,76933
297,261,36,784,58000,76934
603,603,0,-,258900,76935
1036,808,228,400,80900,76936
7,7,0,-,-,76937
0,0,0,-,-,76939
30,30,0,-,-,76940
583,472,111,1014,122100,76941
1354,945,409,559,104400,76943
876,590,286,504,67000,76945
6,6,0,-,-,76949
1286,877,409,648,101800,76950
405,354,51,773,75000,76951
54,24,30,-,-,76953
45,38,7,-,218200,76955
38,9,29,-,-,76957
59,55,4,-,252300,76958
5341,684,4657,1598,275800,77002
4784,2167,2617,1371,294500,77003
14577,5030,9547,1107,322600,77004
10271,7380,2891,1811,1135300,77005
13130,4632,8498,1474,479100,77006
20930,11005,9925,1722,430300,77007
17326,10861,6465,1310,464400,77008
14847,8584,6263,915,279200,77009
598,50,548,3123,-,77010
6225,3131,3094,691,113100,77011
5816,2230,3586,769,88700,77012
6169,2601,3568,958,99500,77013
11505,5490,6015,971,153700,77014
17789,9290,8499,972,116900,77015
9599,5841,3758,918,77700,77016
10232,5246,4986,910,105800,77017
11445,8031,3414,1004,416700,77018
11510,5437,6073,1645,634700,77019
8846,4087,4759,773,81700,77020
10506,4389,6117,988,121100,77021
9380,4596,4784,826,122700,77022
10119,4526,5593,885,164200,77023
16019,9854,6165,1610,1077500,77024
13741,5549,8192,1325,451700,77025
7537,3139,4398,734,65700,77026
10699,3041,7658,1538,808100,77027
6227,3414,2813,902,76400,77028
5695,3706,1989,851,80900,77029
5089,2227,2862,1459,660400,77030
6119,2676,3443,941,168300,77031
4402,1588,2814,988,84600,77032
9116,5597,3519,1002,70100,77033
11584,5635,5949,1101,130800,77034
14159,6272,7887,919,215500,77035
25439,5130,20309,860,166700,77036
5221,3727,1494,958,109600,77037
8705,4947,3758,1030,128100,77038
7995,4530,3465,965,105500,77039
18259,9801,8458,1131,171700,77040
10870,8216,2654,1473,210800,77041
19074,5269,13805,1088,301900,77042
9422,5540,3882,1173,292400,77043
14827,11549,3278,1528,224600,77044
10091,6165,3926,1181,92300,77045
938,397,541,1822,-,77046
11370,8575,2795,1308,157400,77047
6144,3451,2693,956,98000,77048
11143,7692,3451,1212,156600,77049
1664,1075,589,926,80800,77050
6114,2413,3701,929,83800,77051
9022,6113,2909,1293,95400,77053
14532,1952,12580,1208,145800,77054
16017,7185,8832,1029,485600,77055
11597,4309,7288,1658,786200,77056
20520,6706,13814,1144,312000,77057
8086,2394,5692,1145,190700,77058
5868,5692,176,1969,316600,77059
14318,3287,11031,846,103200,77060
9024,3363,5661,835,158100,77061
9597,7499,2098,1082,220900,77062
19782,4467,15315,1132,240600,77063
15593,9581,6012,1301,178900,77064
15777,7173,8604,1152,194700,77065
11763,8445,3318,1237,160400,77066
10140,4369,5771,935,135000,77067
3721,2500,1221,1152,233400,77068
8019,4466,3553,1203,268200,77069
21174,10289,10885,1312,201000,77070
10280,5503,4777,938,165200,77071
19035,9115,9920,1050,126200,77072
13878,8116,5762,1096,151600,77073
13136,4459,8677,934,152000,77074
13398,7173,6225,1010,161700,77075
10133,4914,5219,946,110000,77076
28771,10183,18588,1240,300100,77077
4861,2959,1902,931,87800,77078
12823,7341,5482,1359,533800,77079
14984,7002,7982,1044,235300,77080
18632,1091,17541,863,318300,77081
21135,7602,13533,1150,169800,77082
22584,14363,8221,1120,161900,77083
34667,20958,13709,1303,173800,77084
5444,3620,1824,1071,123600,77085
8345,4787,3558,977,130400,77086
11179,6216,4963,803,101700,77087
17616,11284,6332,949,120100,77088
17210,11820,5390,1208,167900,77089
15417,3944,11473,1006,166500,77090
10365,4173,6192,867,149700,77091
14854,5662,9192,944,186800,77092
13208,7761,5447,884,87500,77093
3991,3396,595,1533,385500,77094
25143,17752,7391,1384,224200,77095
12797,6507,6290,1069,361600,77096
8825,2807,6018,1644,611700,77098
16151,5634,10517,970,131200,77099
0,0,0,-,-,77201
10655,5670,4985,971,137100,77301
6213,5172,1041,1241,209500,77302
7317,5292,2025,1050,159100,77303
14407,8379,6028,1104,242600,77304
4865,4154,711,976,115400,77306
8927,8025,902,1556,347200,77316
7123,5305,1818,1065,213700,77318
9060,5997,3063,922,155200,77320
59,59,0,-,-,77326
8900,6716,2184,760,97700,77327
5620,4182,1438,1031,122300,77328
3178,2643,535,825,161600,77331
110,20,90,-,-,77334
1240,1016,224,1052,122600,77335
4342,3196,1146,1005,199400,77336
15509,8384,7125,1063,157500,77338
16616,10268,6348,1388,213500,77339
12009,4473,7536,889,166500,77340
0,0,0,-,-,77342
9440,8332,1108,1687,306900,77345
20907,17399,3508,1534,217200,77346
36,36,0,-,-,77350
12128,9321,2807,796,138500,77351
13208,9929,3279,1237,282500,77354
10138,8667,1471,1169,252300,77355
11799,9458,2341,1376,292000,77356
8798,6430,2368,1019,144900,77357
1745,1480,265,584,178000,77358
108,51,57,-,-,77359
2322,1871,451,856,110200,77360
1605,1324,281,1684,180600,77362
1333,1207,126,-,204500,77363
1012,875,137,813,118200,77364
11263,9237,2026,1112,212300,77365
14,14,0,-,-,77367
45,45,0,-,-,77368
269,209,60,-,70300,77369
2202,1668,534,809,89100,77371
4504,3758,746,1075,132600,77372
20656,14553,6103,1413,164200,77373
222,186,36,-,45500,77374
19849,14642,5207,1233,210600,77375
297,297,0,-,-,77376
12338,10140,2198,1468,261600,77377
5293,4233,1060,954,148200,77378
27588,21301,6287,1291,262400,77379
13454,4988,8466,1365,268900,77380
13027,9903,3124,1421,361200,77381
12531,9490,3041,1710,426000,77382
8115,4590,3525,1332,315700,77384
8448,6883,1565,1414,234100,77385
18496,14605,3891,1626,250100,77386
16797,12119,4678,1601,208700,77388
12761,10345,2416,1694,310300,77389
19848,12840,7008,1237,167400,77396
7057,6004,1053,1833,826700,77401
18691,15843,2848,1399,314600,77406
17615,14364,3251,1725,266200,77407
0,0,0,-,-,77412
9286,5976,3310,883,134000,77414
0,0,0,-,-,77415
990,590,400,877,98100,77417
3797,2837,960,705,224800,77418
374,311,63,571,125200,77419
777,547,230,879,122700,77420
4957,4044,913,920,152800,77422
3631,2884,747,1030,219200,77423
916,648,268,1301,262600,77426
0,0,0,-,-,77428
30278,25675,4603,1374,266000,77429
649,615,34,-,195600,77430
14,0,14,-,-,77432
27750,22875,4875,1659,294900,77433
1602,1271,331,726,58200,77434
1544,1305,239,921,181400,77435
17,17,0,-,-,77436
6442,4109,2333,817,156600,77437
28,0,28,-,-,77440
3795,3728,67,-,462600,77441
296,223,73,607,123400,77442
126,45,81,-,-,77443
222,156,66,-,235600,77444
5047,2963,2084,966,168100,77445
999,176,823,1011,193200,77446
5367,4468,899,1307,223700,77447
56,15,41,-,-,77448
37436,25930,11506,1512,174600,77449
25619,17879,7740,1419,272300,77450
15,15,0,-,-,77451
136,55,81,-,-,77453
0,0,0,-,-,77454
684,624,60,-,126300,77455
390,339,51,775,131500,77456
271,229,42,694,121600,77457
145,127,18,-,94500,77458
23823,20423,3400,1860,296900,77459
8,8,0,-,-,77460
4117,3146,971,1027,209400,77461
43,18,25,-,162500,77464
2618,2154,464,523,120900,77465
236,148,88,982,178100,77466
16,0,16,-,-,77467
13,13,0,-,-,77468
19102,14496,4606,1150,238800,77469
184,153,31,-,-,77470
12653,7006,5647,1089,168500,77471
24,1,23,-,-,77473
5241,4337,904,964,181900,77474
356,356,0,-,175200,77475
84,66,18,-,-,77476
12951,5825,7126,1232,180600,77477
9073,6798,2275,1666,314100,77478
29628,24460,5168,1780,384700,77479
3251,2702,549,930,112700,77480
66,1,65,-,-,77481
677,558,119,860,94700,77482
104,104,0,-,134100,77483
3772,2707,1065,986,232400,77484
1525,967,558,771,151100,77485
2779,2126,653,1131,159900,77486
5276,3282,1994,735,128900,77488
12560,9349,3211,1457,139700,77489
12301,9808,2493,1377,226600,77493
38439,28880,9559,1745,360100,77494
15914,11866,4048,1595,221400,77498
10834,6753,4081,1018,110500,77502
7776,3849,3927,959,112200,77503
8965,3763,5202,1009,153900,77504
7837,5378,2459,1224,200000,77505
10535,3854,6681,891,87000,77506
219,0,219,1436,-,77507
5422,4338,1084,904,193900,77510
16877,11503,5374,1057,163800,77511
2095,1600,495,862,133300,77514
11728,8179,3549,900,154500,77515
2074,1942,132,1171,180600,77517
3672,2205,1467,979,141400,77518
350,331,19,-,60600,77519
11882,7026,4856,943,99700,77520
20786,12586,8200,1020,162900,77521
7370,6655,715,1167,272100,77523
8888,6384,2504,880,116700,77530
6191,3445,2746,1095,143200,77531
10686,8520,2166,918,173000,77532
369,250,119,805,77900,77533
908,833,75,1004,183300,77534
9678,8052,1626,885,134800,77535
11305,8475,2830,1186,182000,77536
282,257,25,-,157400,77538
16255,12402,3853,1125,183400,77539
6813,4351,2462,948,109400,77541
7242,5877,1365,1693,197800,77545
17987,13584,4403,1429,265000,77546
2765,1811,954,1010,82000,77547
10170,4333,5837,939,180400,77550
8751,3787,4964,1066,190600,77551
4092,2818,1274,1204,299900,77554
270,270,0,-,-,77560
40,32,8,-,103100,77561
3600,2658,942,866,141400,77562
4430,3232,1198,954,164900,77563
551,523,28,-,145800,77564
3204,1763,1441,1262,284500,77565
10865,7050,3815,1222,205900,77566
6468,4574,1894,891,115900,77568
13195,9619,3576,1130,162300,77571
31934,24345,7589,1415,265800,77573
6013,4553,1460,871,128200,77575
514,480,34,-,162800,77577
7559,6436,1123,1081,273800,77578
320,282,38,-,340400,77580
16912,13439,3473,1224,244800,77581
10563,9217,1346,1228,207400,77583
31048,23114,7934,1476,269000,77584
466,421,45,-,-,77585
8869,5806,3063,1275,256400,77586
5048,2602,2446,1013,109100,77587
11618,6168,5450,977,120300,77590
5187,2651,2536,1057,142300,77591
274,209,65,-,247000,77597
11962,2368,9594,1085,159800,77598
3306,2386,920,841,156600,77611
3601,3232,369,643,92000,77612
507,392,115,681,132300,77613
176,140,36,-,105600,77614
373,232,141,576,90000,77615
93,74,19,-,200000,77616
38,29,9,-,-,77617
5747,4196,1551,1006,119600,77619
455,407,48,1104,186500,77622
262,248,14,-,77800,77623
312,279,33,-,-,77624
3732,2921,811,822,84300,77625
8426,6217,2209,1004,142900,77627
340,300,40,675,92200,77629
10498,7086,3412,845,98900,77630
8263,6539,1724,846,133800,77632
6692,4264,2428,938,65700,77640
13761,7273,6488,779,69300,77642
986,829,157,604,296500,77650
4707,3731,976,965,173900,77651
155,138,17,-,120000,77655
6156,4950,1206,816,109600,77656
7871,6450,1421,869,172500,77657
1797,1447,350,983,158300,77659
443,400,43,-,117200,77660
481,358,123,-,114800,77661
10343,8092,2251,748,95800,77662
382,291,91,-,178000,77663
1038,918,120,433,131100,77664
1931,1525,406,591,145800,77665
5117,2537,2580,808,53100,77701
1360,821,539,965,105100,77702
4613,2255,2358,730,75100,77703
10827,6222,4605,704,90500,77705
13286,7677,5609,914,183800,77706
6839,4791,2048,951,127600,77707
4882,2505,2377,862,125300,77708
5822,3676,2146,1138,163000,77713
5821,723,5098,853,139300,77801
11116,5955,5161,1005,181500,77802
9736,5960,3776,888,94100,77803
3679,2349,1330,1061,196300,77807
4662,4255,407,932,264300,77808
1178,934,244,816,276300,77830
1068,891,177,688,82900,77831
10528,7686,2842,907,188000,77833
1207,964,243,1067,219600,77835
4710,3660,1050,699,155600,77836
751,468,283,808,88000,77837
20655,2252,18403,914,200000,77840
25639,16737,8902,1168,271200,77845
508,436,72,650,118800,77853
64,22,42,-,-,77855
1976,1523,453,768,182900,77856
361,316,45,831,214100,77857
2644,1886,758,751,99900,77859
798,691,107,723,171100,77861
2767,2036,731,708,106000,77864
779,677,102,1096,117700,77865
109,73,36,-,-,77867
5133,3509,1624,739,147000,77868
1362,1045,317,647,156000,77871
710,609,101,861,122300,77872
543,468,75,558,156000,77873
70,58,12,-,-,77876
145,75,70,850,-,77878
2042,1629,413,860,96000,77879
807,694,113,-,229000,77880
14584,8205,6379,917,107300,77901
10695,7600,3095,996,199200,77904
5545,4739,806,1105,156200,77905
75,58,17,-,80900,77950
502,347,155,660,50500,77951
3374,2176,1198,890,133700,77954
2937,2074,863,857,100200,77957
62,37,25,-,-,77960
103,62,41,-,-,77961
1094,738,356,841,121400,77962
2065,1616,449,513,127500,77963
3097,2180,917,775,188900,77964
1004,863,141,596,282600,77968
64,64,0,-,-,77969
96,49,47,743,57400,77970
327,207,120,694,169100,77971
7,0,7,-,-,77973
159,101,58,1102,185400,77974
690,494,196,809,155500,77975
17,17,0,-,178100,77976
258,222,36,668,48200,77977
221,121,100,891,82700,77978
6428,4645,1783,789,115200,77979
433,366,67,-,202500,77982
911,762,149,1066,113500,77983
1675,1425,250,780,178400,77984
90,77,13,-,120800,77987
96,80,16,-,106300,77988
331,281,50,825,78400,77990
100,87,13,-,-,77991
23,23,0,-,-,77993
136,108,28,-,-,77994
3852,2937,915,724,119900,77995
0,0,0,-,-,78001
1529,1192,337,939,115800,78002
3712,3023,689,864,173600,78003
436,416,20,-,403100,78004
465,313,152,-,219300,78005
12515,9165,3350,1337,374100,78006
67,58,9,-,162500,78007
183,139,44,-,-,78008
2511,2025,486,1051,172600,78009
1499,1073,426,628,177000,78010
558,495,63,568,41200,78011
103,73,30,-,68800,78012
2030,1671,359,896,258400,78013
1721,1197,524,678,83300,78014
5658,5271,387,1765,433400,78015
3442,2431,1011,752,105300,78016
1127,645,482,766,87700,78017
513,447,66,721,69900,78019
41,41,0,-,-,78021
1368,1070,298,745,117600,78022
8768,7978,790,1648,315500,78023
578,459,119,875,373000,78024
1986,1465,521,844,138900,78025
2522,1874,648,861,103100,78026
230,230,0,-,250000,78027
16597,10979,5618,950,198100,78028
0,0,0,-,-,78029
743,627,116,600,66000,78039
11581,5062,6519,741,78200,78040
14459,7535,6924,823,160900,78041
12725,6776,5949,853,113200,78043
196,131,65,636,-,78044
19698,15219,4479,1154,180500,78045
17231,12987,4244,862,104600,78046
217,161,56,-,-,78050
1854,1512,342,916,95800,78052
796,658,138,440,216700,78055
806,738,68,-,432700,78056
258,258,0,-,597200,78057
327,276,51,630,316700,78058
1762,1568,194,861,159300,78059
0,0,0,-,-,78060
2928,2012,916,857,78400,78061
3875,3561,314,1272,209300,78063
5109,3769,1340,1069,160700,78064
3521,2690,831,701,94300,78065
264,249,15,-,177700,78066
223,193,30,-,118500,78067
1737,1525,212,631,87200,78069
5635,5314,321,1246,320100,78070
1021,787,234,768,119400,78071
147,121,26,993,85600,78072
2033,1641,392,828,97000,78073
121,91,30,-,-,78075
4377,3039,1338,512,87600,78076
2356,2152,204,726,236200,78101
7012,4414,2598,864,95600,78102
60,39,21,-,-,78104
218,136,82,-,64200,78107
13401,11268,2133,1738,234100,78108
11936,8763,3173,1320,166600,78109
2525,2196,329,1061,100900,78112
1218,1001,217,940,189200,78113
7790,6525,1265,936,192300,78114
130,130,0,-,265900,78116
241,209,32,-,287500,78117
1117,881,236,844,94400,78118
1869,1266,603,759,95200,78119
4207,3870,337,1096,261500,78121
223,176,47,-,213600,78122
1035,859,176,920,173200,78123
2294,2075,219,983,179700,78124
27,27,0,-,43800,78125
29297,18176,11121,1204,222100,78130
11312,9422,1890,1167,393400,78132
7664,6661,1003,1156,227500,78133
1094,731,363,791,74500,78140
321,273,48,775,61200,78141
36,32,4,-,-,78142
42,42,0,-,120800,78143
14,0,14,-,-,78144
24,17,7,-,24700,78145
224,108,116,678,89500,78146
504,318,186,1004,150000,78147
7817,4135,3682,1038,180000,78148
0,0,0,-,-,78150
657,423,234,-,100200,78151
803,764,39,1223,239100,78152
14681,10255,4426,1376,215700,78154
17693,12427,5266,967,167900,78155
360,302,58,832,48200,78159
1747,1547,200,833,167400,78160
233,224,9,-,163500,78161
130,81,49,-,118800,78162
4893,4578,315,1146,352800,78163
1570,1314,256,722,175700,78164
16631,7899,8732,840,126100,78201
4056,2010,2046,854,89200,78202
2088,1048,1040,718,89800,78203
4310,2322,1988,985,88100,78204
1127,113,1014,826,377900,78205
15573,7326,8247,699,65600,78207
1789,623,1166,740,93200,78208
18787,9714,9073,1195,394800,78209
11828,6756,5072,868,100600,78210
9074,5802,3272,896,76900,78211
10939,4956,5983,875,190400,78212
16155,7920,8235,961,145300,78213
7939,4512,3427,773,84400,78214
1914,103,1811,1494,425000,78215
18652,6970,11682,994,200600,78216
13919,5815,8104,987,146400,78217
13421,6329,7092,892,120800,78218
5513,2910,2603,959,100100,78219
5436,3147,2289,940,80000,78220
11828,7822,4006,889,92700,78221
7630,5388,2242,1021,136900,78222
18203,10289,7914,849,101000,78223
6005,3270,2735,947,100700,78224
4921,3381,1540,894,83400,78225
2334,928,1406,770,82200,78226
14401,8251,6150,882,97800,78227
18773,11095,7678,825,103700,78228
14847,2339,12508,1017,153400,78229
18527,9284,9243,1059,254900,78230
3679,2503,1176,1124,308100,78231
15471,8512,6959,1201,257600,78232
16709,10212,6497,1156,149100,78233
979,35,944,1795,57000,78234
663,0,663,1220,-,78235
355,0,355,1808,-,78236
11662,7430,4232,796,70400,78237
9712,4929,4783,937,147600,78238
7931,5814,2117,1192,154800,78239
23502,8515,14987,1121,182800,78240
9262,5160,4102,897,85800,78242
0,0,0,-,-,78243
9796,7264,2532,1310,145900,78244
21283,15544,5739,1251,168900,78245
17644,13584,4060,1274,188600,78247
5427,4092,1335,1213,358600,78248
20991,11358,9633,1212,213000,78249
18665,14247,4418,1241,163700,78250
20593,10810,9783,1153,184900,78251
2655,2071,584,1302,134100,78252
11930,9731,2199,1434,251500,78253
17473,13583,3890,1387,218700,78254
4702,4025,677,1351,351300,78255
4122,1279,2843,1353,425700,78256
3825,1784,2041,1404,448300,78257
16380,10555,5825,1428,351300,78258
9502,6441,3061,1214,286000,78259
7947,7169,778,1811,353100,78260
5942,4493,1449,1477,310600,78261
1193,1106,87,1113,210400,78263
2890,2319,571,993,101600,78264
2501,2393,108,1977,445600,78266
232,205,27,1103,74800,78330
9006,6070,2936,800,75400,78332
0,0,0,-,-,78335
4751,3197,1554,916,146400,78336
0,0,0,-,-,78338
166,166,0,-,68900,78339
201,173,28,1179,130800,78340
686,486,200,765,62800,78341
89,50,39,842,-,78342
1629,1304,325,831,96600,78343
138,119,19,-,90600,78344
154,149,5,-,72500,78349
149,27,122,938,-,78351
65,65,0,-,32600,78352
214,132,82,-,62900,78353
2406,1488,918,389,70200,78355
857,593,264,698,68200,78357
273,200,73,862,67300,78358
644,407,237,599,73700,78359
1563,1120,443,496,80100,78361
3779,2665,1114,1182,152800,78362
10632,5379,5253,895,99300,78363
3801,2890,911,563,74700,78368
146,108,38,-,-,78369
1497,1122,375,877,124300,78370
75,56,19,-,67600,78371
1363,976,387,821,78100,78372
2090,1461,629,1594,376800,78373
6201,4222,1979,1392,177400,78374
1001,688,313,643,70800,78375
181,135,46,929,67900,78376
1198,762,436,578,88400,78377
499,432,67,1146,71300,78379
8124,6125,1999,854,99900,78380
8033,6720,1313,935,185300,78382
1980,1767,213,795,146500,78383
1756,1190,566,563,44400,78384
129,27,102,-,-,78385
3209,2116,1093,646,79300,78387
714,585,129,865,51400,78389
1826,1079,747,989,73900,78390
62,40,22,-,64400,78391
788,622,166,649,84100,78393
1653,313,1340,849,83400,78401
110,51,59,1051,180400,78402
6271,3198,3073,960,117000,78404
5238,2940,2298,736,57500,78405
355,207,148,1206,49300,78406
642,327,315,964,76500,78407
4207,2357,1850,685,73200,78408
913,505,408,675,99400,78409
9377,6268,3109,1071,165100,78410
9362,5892,3470,1043,132500,78411
15836,7086,8750,1061,137700,78412
14818,7864,6954,1180,185600,78413
16261,10284,5977,1247,211600,78414
13871,7892,5979,1018,107100,78415
5310,3163,2147,922,75300,78416
1379,929,450,1076,116800,78417
12127,7899,4228,1065,225800,78418
210,0,210,1750,-,78419
20650,10900,9750,715,113000,78501
6137,3831,2306,977,104500,78503
18506,12176,6330,935,151700,78504
10443,8074,2369,643,62900,78516
18128,10623,7505,690,92400,78520
25503,15107,10396,725,73400,78521
13915,9487,4428,917,117300,78526
236,163,73,675,63100,78535
126,119,7,-,85000,78536
12207,9228,2979,538,62000,78537
3125,2355,770,441,68300,78538
12831,7435,5396,837,149400,78539
13635,7258,6377,782,92300,78541
18707,14179,4528,696,89600,78542
2851,2213,638,585,60200,78543
76,76,0,-,36600,78545
167,149,18,-,44600,78548
286,245,41,-,48900,78549
16893,8662,8231,722,88200,78550
12884,9941,2943,816,100400,78552
3774,2695,1079,701,114200,78557
239,194,45,-,54200,78558
4265,3336,929,711,73300,78559
1368,804,564,707,79800,78560
133,114,19,-,58300,78561
540,394,146,468,70600,78562
104,87,17,-,165100,78563
42,8,34,-,-,78564
42,42,0,-,-,78565
5246,3822,1424,776,118800,78566
106,84,22,-,47100,78567
1355,1071,284,561,97300,78569
8732,6349,2383,545,64400,78570
24758,17840,6918,790,97600,78572
10650,7473,3177,732,100600,78573
15823,12155,3668,735,84500,78574
3425,2590,835,1068,138200,78575
2398,1995,403,499,66700,78576
22690,13423,9267,774,81700,78577
4206,2848,1358,674,136600,78578
1232,1155,77,580,58000,78579
3831,2290,1541,723,58600,78580
10957,8376,2581,596,82900,78582
2259,1889,370,648,118900,78583
4802,3325,1477,556,70000,78584
88,84,4,-,-,78585
16556,12987,3569,727,61600,78586
39,36,3,-,-,78588
11123,8505,2618,759,88800,78589
64,64,0,-,37000,78590
73,59,14,-,-,78591
223,183,40,580,33200,78592
1531,1181,350,709,59200,78593
514,421,93,237,48200,78594
1974,1714,260,501,59600,78595
19053,13074,5979,738,83300,78596
1477,1036,441,1150,422700,78597
92,86,6,-,112500,78598
9107,6990,2117,1143,209200,78602
2144,1869,275,793,151400,78605
2383,1827,556,735,273000,78606
55,45,10,-,356300,78607
142,103,39,-,221500,78608
850,658,192,845,182100,78609
13284,10341,2943,1349,274800,78610
4507,3508,999,917,195100,78611
4119,3446,673,1214,191000,78612
27558,19693,7865,1457,318400,78613
223,164,59,912,200000,78614
376,296,80,1066,210900,78615
2491,1852,639,895,148900,78616
6981,5665,1316,1246,178100,78617
148,121,27,950,312800,78618
1907,1721,186,1270,521100,78619
6416,5509,907,1176,430300,78620
7183,5704,1479,1055,187400,78621
105,70,35,1131,-,78622
427,397,30,-,277900,78623
9343,6565,2778,987,317200,78624
11466,7736,3730,1311,247700,78626
13159,9788,3371,1218,329200,78628
4487,2949,1538,811,135300,78629
1129,952,177,1323,237200,78631
503,482,21,-,168400,78632
12626,11580,1046,1632,333300,78633
11461,9072,2389,1590,224000,78634
183,138,45,-,-,78635
1512,1132,380,969,259100,78636
820,694,126,1153,163300,78638
3481,2461,1020,828,192200,78639
19246,13360,5886,1380,203400,78640
24371,19304,5067,1539,281700,78641
3825,3023,802,950,313000,78642
2666,2112,554,813,227700,78643
5836,3901,1935,998,153400,78644
4851,4105,746,1189,293900,78645
3095,2110,985,926,146300,78648
702,578,124,825,191700,78650
2210,1450,760,1458,320100,78652
8981,7565,1416,1501,219800,78653
7174,5216,1958,1016,226200,78654
1405,940,465,1050,148800,78655
850,564,286,905,120800,78656
2787,2429,358,1143,321100,78657
943,879,64,-,259000,78659
33953,25252,8701,1381,254400,78660
97,76,21,825,90000,78661
1041,795,246,910,211600,78662
304,249,55,-,-,78663
21034,11435,9599,1319,231800,78664
16257,10702,5555,1476,286300,78665
29205,11069,18136,1091,186400,78666
5185,4763,422,941,447700,78669
41,28,13,-,167500,78670
229,174,55,-,162000,78671
497,483,14,-,132100,78672
129,106,23,-,-,78675
5884,4608,1276,1066,355400,78676
6,6,0,-,-,78677
18018,13689,4329,1451,320200,78681
7287,2748,4539,2220,498400,78701
10513,4262,6251,1327,449400,78702
9478,5343,4135,1583,980500,78703
26471,8758,17713,1476,596200,78704
8492,764,7728,1365,405800,78705
0,0,0,-,-,78712
9916,5900,4016,1407,390000,78717
405,319,86,881,153600,78719
4027,2119,1908,1319,321900,78721
3145,1456,1689,1465,442300,78722
14192,6835,7357,1195,371200,78723
6619,4180,2439,1311,150400,78724
3038,2583,455,1552,190600,78725
5604,2476,3128,1378,468900,78726
13911,6221,7690,1436,320000,78727
10429,3062,7367,1215,280500,78728
11516,4811,6705,1346,310800,78729
4453,2566,1887,1375,761700,78730
13412,7313,6099,1369,642300,78731
6197,4597,1600,1455,546400,78732
2839,2578,261,1887,684400,78733
8181,6786,1395,1700,436800,78734
7862,3871,3991,1659,555300,78735
3677,2665,1012,1481,368000,78736
6280,5708,572,1682,482000,78737
6368,4611,1757,1645,568600,78738
6788,6395,393,2619,493600,78739
20714,3467,17247,1174,250500,78741
273,170,103,1051,-,78742
16053,7677,8376,1255,196700,78744
27994,13565,14429,1373,307700,78745
10414,7224,3190,1651,936000,78746
6657,5305,1352,1585,247200,78747
21027,12485,8542,1497,297600,78748
15836,10462,5374,1460,363600,78749
12383,7193,5190,1546,409800,78750
8446,2124,6322,1317,482100,78751
9133,2129,7004,1232,292500,78752
21602,7644,13958,1140,218100,78753
9348,5410,3938,1249,245300,78754
4414,1997,2417,1316,562300,78756
11261,6369,4892,1238,447000,78757
21851,6301,15550,1278,261300,78758
21740,10542,11198,1309,459600,78759
7386,4996,2390,834,103400,78801
60,0,60,-,-,78802
407,299,108,521,74800,78827
63,63,0,-,-,78828
323,190,133,1028,38800,78829
291,225,66,665,49500,78830
1475,1110,365,672,82000,78832
543,317,226,769,58700,78833
2460,1683,777,722,58700,78834
20,20,0,-,-,78836
95,87,8,-,-,78837
83,83,0,-,310000,78838
2951,2233,718,578,63200,78839
16221,10486,5735,767,105800,78840
22,0,22,-,-,78843
303,268,35,694,172900,78850
11,11,0,-,-,78851
16369,10786,5583,677,99600,78852
0,0,0,-,-,78860
4402,3341,1061,809,130800,78861
323,243,80,-,123800,78870
13,13,0,-,-,78871
400,287,113,-,29500,78872
679,559,120,916,216100,78873
278,262,16,-,-,78877
50,50,0,-,-,78879
690,484,206,627,71300,78880
706,565,141,697,67600,78881
144,131,13,-,364100,78883
540,450,90,1036,180400,78884
49,46,3,-,309100,78885
150,150,0,-,-,78886
127,115,12,-,336300,78931
181,158,23,-,-,78932
510,370,140,-,120700,78933
2246,1815,431,768,161000,78934
412,412,0,-,-,78935
111,87,24,757,163900,78938
846,773,73,731,174500,78940
1050,878,172,921,165100,78941
3194,2285,909,901,150400,78942
88,88,0,-,-,78943
262,255,7,-,288700,78944
4133,3411,722,705,202700,78945
499,360,139,938,123000,78946
1742,1562,180,1159,210100,78947
154,132,22,-,357100,78948
210,201,9,-,173800,78949
783,704,79,-,237100,78950
0,0,0,-,-,78951
403,282,121,1239,161000,78953
505,467,38,1075,410000,78954
1932,1496,436,886,171300,78956
3483,2813,670,1031,194900,78957
709,558,151,519,104400,78959
1906,1550,356,519,174000,78962
241,236,5,-,163000,78963
61,46,15,-,97500,79001
75,50,25,1278,94300,79003
570,424,146,776,118800,79005
4661,3540,1121,817,82300,79007
538,316,222,731,92800,79009
118,53,65,-,-,79010
111,81,30,825,157500,79011
675,637,38,-,266000,79012
1081,531,550,584,54200,79013
1326,890,436,942,175000,79014
7584,5269,2315,836,197400,79015
0,0,0,-,-,79016
133,73,60,668,87300,79018
692,572,120,935,155100,79019
43,17,26,-,74400,79021
3360,2489,871,921,118000,79022
148,108,40,656,111800,79024
17,17,0,-,-,79025
1715,852,863,751,85700,79027
4752,3210,1542,892,129100,79029
481,352,129,631,80600,79031
34,20,14,-,83600,79032
32,20,12,-,-,79033
180,138,42,718,96500,79034
1850,1252,598,715,117100,79035
1790,1645,145,798,82600,79036
336,276,60,936,135000,79039
583,445,138,850,167300,79040
1075,822,253,626,81000,79041
382,296,86,819,84200,79042
414,285,129,575,50100,79043
289,147,142,1213,151700,79044
6046,3947,2099,767,90500,79045
245,178,67,-,93600,79046
0,0,0,-,-,79051
494,403,91,644,74400,79052
21,11,10,-,85000,79053
213,166,47,735,31500,79054
35,29,6,-,77200,79056
516,368,148,686,55000,79057
0,0,0,-,-,79058
278,236,42,531,97000,79059
88,75,13,567,-,79061
78,65,13,642,65600,79062
278,242,36,519,191200,79063
820,583,237,608,73700,79064
7136,5146,1990,743,83400,79065
1335,1071,264,849,124200,79068
3259,2363,896,815,102400,79070
8264,4903,3361,664,85800,79072
61,55,6,-,-,79078
1049,710,339,781,68000,79079
196,189,7,-,34700,79080
1311,974,337,705,110400,79081
83,78,5,-,72500,79082
721,585,136,921,80200,79083
742,563,179,694,94600,79084
5,5,0,-,-,79085
852,668,184,842,88500,79086
256,190,66,717,92500,79087
1863,1293,570,549,82200,79088
16,16,0,-,-,79091
432,381,51,787,119900,79092
40,40,0,-,-,79093
8,8,0,-,-,79094
961,716,245,568,59000,79095
785,588,197,851,117600,79096
376,329,47,747,112300,79097
165,141,24,1087,132600,79098
1166,83,1083,774,75000,79101
4426,2224,2202,811,114900,79102
3719,2577,1142,909,96200,79103
2431,1429,1002,844,63000,79104
0,0,0,-,-,79105
11960,5746,6214,818,129200,79106
11385,6598,4787,798,68900,79107
3968,2965,1003,959,122200,79108
17943,10779,7164,820,166900,79109
6948,4449,2499,1091,116300,79110
487,8,479,1054,-,79111
8089,6701,1388,1072,174300,79118
7215,4701,2514,1025,267200,79119
2464,1741,723,933,209600,79121
3395,2842,553,986,257400,79124
2321,1378,943,774,86100,79201
73,41,32,-,102900,79220
379,290,89,684,39900,79225
1090,792,298,690,66800,79226
540,437,103,489,47700,79227
183,170,13,-,34000,79229
38,32,6,-,-,79230
35,0,35,-,-,79231
62,36,26,725,26700,79233
16,8,8,-,-,79234
1338,1017,321,664,64400,79235
87,35,52,675,22800,79236
231,168,63,633,-,79237
83,69,14,-,88100,79239
22,14,8,-,-,79240
759,572,187,728,74400,79241
22,16,6,-,61400,79243
302,215,87,635,74300,79244
941,638,303,521,60900,79245
22,20,2,-,21700,79247
680,412,268,378,41100,79248
550,416,134,546,60500,79250
8,8,0,-,108300,79251
1327,903,424,447,55200,79252
209,139,70,579,106500,79255
151,102,49,620,45000,79256
388,296,92,642,66300,79257
27,27,0,-,57500,79258
16,16,0,-,-,79259
157,106,51,532,55300,79261
1328,1024,304,667,109300,79311
314,246,68,519,57700,79312
550,399,151,617,58200,79313
35,14,21,-,-,79314
3717,2305,1412,698,77800,79316
764,600,164,644,61800,79322
2296,1743,553,627,161700,79323
18,18,0,-,259100,79324
711,466,245,904,107100,79325
18,18,0,-,115000,79326
1118,860,258,625,162500,79329
37,37,0,-,-,79330
4256,2984,1272,691,81100,79331
6015,4266,1749,679,98700,79336
2420,1661,759,773,66500,79339
142,95,47,424,90800,79342
558,394,164,613,86800,79343
74,68,6,-,64100,79344
290,213,77,725,79800,79345
816,580,236,715,32900,79346
2048,1563,485,546,81700,79347
175,146,29,817,50000,79350
574,404,170,781,80000,79351
6,6,0,-,-,79353
567,349,218,744,69900,79355
1669,1133,536,701,79500,79356
796,540,256,620,57300,79357
414,341,73,836,133000,79358
930,626,304,-,56200,79359
4537,3446,1091,764,154500,79360
1971,1605,366,864,183200,79363
2614,1807,807,808,81500,79364
400,372,28,993,252300,79366
256,167,89,745,71000,79367
38,38,0,-,37500,79369
626,484,142,548,55200,79370
612,489,123,632,80900,79371
499,413,86,547,81300,79372
1125,723,402,838,84100,79373
15,15,0,-,-,79376
84,58,26,-,95000,79377
77,66,11,411,85000,79378
174,143,31,608,67200,79379
32,26,6,-,-,79380
544,418,126,825,138300,79381
2921,2230,691,1017,193400,79382
3614,370,3244,1026,97000,79401
5742,3193,2549,809,61300,79403
3422,2264,1158,717,59600,79404
0,0,0,-,-,79406
9401,4146,5255,924,122100,79407
4195,1518,2677,1112,155300,79410
3080,1093,1987,857,65500,79411
5773,2886,2887,839,85100,79412
8667,5148,3519,1195,155300,79413
8199,3281,4918,891,109400,79414
6354,2562,3792,900,64600,79415
13294,6826,6468,1095,149900,79416
15780,11002,4778,1064,170200,79423
19685,13445,6240,940,213400,79424
1176,899,277,725,72500,79501
472,376,96,-,53500,79502
91,72,19,-,94000,79503
1280,1063,217,585,77000,79504
97,75,22,-,45000,79505
326,276,50,525,71000,79506
428,345,83,782,156000,79508
2871,2384,487,848,106000,79510
529,456,73,775,101600,79511
2141,1730,411,653,68500,79512
114,88,26,-,-,79517
23,23,0,-,212500,79518
39,39,0,-,189200,79519
924,654,270,710,45700,79520
1234,860,374,632,65200,79521
1018,863,155,880,131400,79525
351,310,41,655,107000,79526
70,66,4,-,55600,79527
254,199,55,819,46300,79528
537,424,113,788,40400,79529
206,176,30,650,52900,79530
227,180,47,556,64800,79532
178,132,46,825,30700,79533
88,84,4,-,108000,79534
92,86,6,-,57000,79535
1792,1521,271,944,83800,79536
13,12,1,-,-,79537
93,91,2,-,117000,79538
84,66,18,633,-,79539
26,26,0,-,-,79540
392,359,33,-,219200,79541
533,435,98,645,63300,79543
174,120,54,645,33400,79544
767,648,119,783,79200,79545
761,502,259,540,57800,79546
442,329,113,1017,58300,79547
85,72,13,-,-,79548
5651,4405,1246,755,88000,79549
1402,1071,331,729,64800,79553
4620,3017,1603,738,82100,79556
61,34,27,681,94200,79560
183,132,51,669,98000,79561
1230,1095,135,1097,208100,79562
378,286,92,834,59700,79563
67,61,6,-,55000,79565
98,86,12,-,224200,79566
1134,788,346,645,59700,79567
7654,3680,3974,811,129600,79601
8798,6469,2329,964,173800,79602
8501,4819,3682,843,82900,79603
10980,6106,4874,910,114500,79605
10527,5682,4845,959,195300,79606
792,0,792,1194,-,79607
0,0,0,-,-,79699
9881,6277,3604,1075,141900,79701
7883,5028,2855,1371,169400,79703
15637,10849,4788,1275,269600,79705
8603,6797,1806,1083,216000,79706
13849,8567,5282,1268,319000,79707
234,174,60,525,162000,79713
5649,4220,1429,1095,153200,79714
268,192,76,702,53100,79718
172,142,30,773,45600,79719
10776,7055,3721,872,104400,79720
76,76,0,-,24100,79730
1463,1274,189,829,89500,79731
105,53,52,336,74100,79733
915,773,142,1093,140100,79734
4199,3099,1100,817,107200,79735
59,43,16,-,137500,79738
355,241,114,810,313500,79739
98,83,15,1156,78100,79741
205,164,41,548,85700,79742
120,56,64,407,62000,79743
416,332,84,811,116400,79744
2286,1839,447,834,80100,79745
71,54,17,-,-,79748
123,86,37,760,180600,79749
847,658,189,839,70000,79752
62,11,51,-,-,79754
47,20,27,-,309100,79755
3345,2425,920,875,110300,79756
1090,973,117,893,285000,79758
0,0,0,-,-,79759
12106,7097,5009,1035,122700,79761
15613,9038,6575,1126,176300,79762
11544,8218,3326,1001,104600,79763
7104,5066,2038,884,115100,79764
6097,4195,1902,1322,237800,79765
2069,1616,453,842,147400,79766
0,0,0,-,-,79770
3445,2761,684,878,100100,79772
73,51,22,-,167000,79777
432,356,76,563,90800,79778
43,33,10,-,-,79780
124,118,6,-,151300,79781
1324,889,435,-,119800,79782
80,65,15,-,275000,79783
16,16,0,-,47100,79785
305,276,29,630,69200,79788
324,272,52,808,103900,79789
1878,1493,385,829,100600,79821
3569,2095,1474,736,182300,79830
0,0,0,-,-,79831
152,2,150,671,-,79834
3559,2603,956,749,84200,79835
1772,1405,367,752,81500,79836
116,44,72,-,42700,79837
1623,1069,554,551,62500,79838
501,356,145,650,48100,79839
226,135,91,-,100800,79842
985,719,266,644,168400,79843
1570,673,897,387,50400,79845
14,0,14,-,-,79846
28,20,8,-,-,79847
351,336,15,-,72300,79848
3199,2070,1129,733,80400,79849
270,202,68,-,-,79851
345,275,70,457,92300,79852
667,614,53,769,72600,79853
67,43,24,-,74300,79854
655,431,224,577,62700,79855
3436,301,3135,441,55600,79901
8561,3235,5326,656,188200,79902
5847,3411,2436,753,98100,79903
11461,4592,6869,854,95800,79904
7817,3797,4020,575,85400,79905
832,0,832,1314,-,79906
16023,9463,6560,767,90600,79907
894,0,894,1596,-,79908
2273,1747,526,1241,234400,79911
28881,15807,13074,967,194100,79912
12964,7531,5433,663,91200,79915
346,0,346,1341,-,79916
0,0,0,-,-,79920
2795,2457,338,980,237600,79922
20366,12608,7758,864,102300,79924
14442,7853,6589,853,140100,79925
12229,9606,2623,776,93700,79927
17370,14821,2549,942,129900,79928
10496,4959,5537,773,98100,79930
9422,6705,2717,901,184200,79932
9414,6302,3112,1189,150000,79934
6434,3606,2828,854,161700,79935
34755,23594,11161,984,130900,79936
24132,18996,5136,1106,155700,79938
0,0,0,-,-,79942
8499,4804,3695,1315,378600,80002
13508,9566,3942,1393,349900,80003
14444,10364,4080,1380,418900,80004
10795,9456,1339,1650,449800,80005
5617,5336,281,2125,642200,80007
13291,5069,8222,1120,276800,80010
16822,8925,7897,1280,257000,80011
18867,8901,9966,1349,285100,80012
24832,18967,5865,1646,331500,80013
17980,10830,7150,1469,292500,80014
23124,19052,4072,1812,397700,80015
20148,16235,3913,1719,552700,80016
13575,8207,5368,1397,285900,80017
4386,3732,654,1821,400100,80018
1202,1093,109,1373,309000,80019
19376,13752,5624,1623,390700,80020
14942,8168,6774,1722,374300,80021
15423,11143,4280,1305,327700,80022
8269,6825,1444,1740,609800,80023
65,24,41,1554,190000,80024
22,13,9,-,-,80025
12738,9180,3558,1705,482900,80026
11944,8111,3833,1857,619600,80027
6167,3295,2872,1113,294400,80030
13191,9713,3478,1641,375100,80031
12091,6132,5959,1180,418400,80033
526,0,526,1738,-,80045
209,169,40,1658,373500,80101
2144,1764,380,1107,396300,80102
916,792,124,1197,367800,80103
11220,8832,2388,1608,419100,80104
580,516,64,578,303600,80105
2245,2141,104,811,435100,80106
4683,4305,378,1613,497700,80107
9555,8215,1340,1650,657100,80108
7931,6700,1231,1620,462800,80109
9394,5133,4261,1295,337100,80110
12412,7727,4685,1713,682800,80111
14462,8218,6244,1668,457000,80112
10701,5618,5083,1185,485400,80113
1591,1531,60,-,653300,80116
901,807,94,1117,417000,80117
2351,2230,121,1768,623400,80118
13733,7617,6116,1258,442600,80120
7237,6077,1160,1405,479100,80121
12698,10914,1784,1705,451700,80122
18540,13625,4915,1638,418600,80123
8877,5107,3770,1745,584300,80124
3806,3619,187,2012,480400,80125
15383,12877,2506,1833,525900,80126
16721,14854,1867,1779,467800,80127
14205,11843,2362,1659,418000,80128
12103,9020,3083,1904,482800,80129
9410,7317,2093,2155,476400,80130
162,125,37,-,262900,80131
7348,6676,672,1720,505100,80132
1074,987,87,985,321300,80133
24865,20436,4429,1686,471400,80134
1494,1338,156,1155,647400,80135
1659,1516,143,1237,360400,80136
531,454,77,1193,493300,80137
11521,9489,2032,1684,498000,80138
9529,2633,6896,1832,566600,80202
13935,3059,10876,1258,369000,80203
13266,5082,8184,1274,412500,80204
14163,5865,8298,1388,472200,80205
13064,6079,6985,1346,683200,80206
9570,6675,2895,1481,469100,80207
13259,6142,7117,1557,702800,80209
14991,9352,5639,1460,646400,80210
16523,8498,8025,1560,535800,80211
8991,5895,3096,1224,543500,80212
11427,4110,7317,1179,392900,80214
8355,5239,3116,1427,474400,80215
4379,1421,2958,1499,285100,80216
10818,3727,7091,1250,442800,80218
20491,11157,9334,1179,296600,80219
15112,8966,6146,1352,540400,80220
12990,8380,4610,1330,327400,80221
10403,4819,5584,1384,423800,80222
7889,3692,4197,1229,350800,80223
7781,4429,3352,1326,426200,80224
13167,7467,5700,1450,374300,80226
14393,9493,4900,1480,389500,80227
14062,9587,4475,1473,441300,80228
18495,11874,6621,1406,271600,80229
4388,2379,2009,1655,626500,80230
15494,5969,9525,1361,368500,80231
9165,6395,2770,1400,357700,80232
16906,10210,6696,1519,330400,80233
11418,6871,4547,1428,382000,80234
3704,2040,1664,1358,409200,80235
6063,3684,2379,1303,347700,80236
10361,4687,5674,1588,445200,80237
7188,5616,1572,1844,612600,80238
12448,7574,4874,1458,283500,80239
11804,9606,2198,1680,361700,80241
7084,1531,5553,1369,486100,80246
14151,5513,8638,1393,223700,80247
10010,7876,2134,1863,333200,80249
12002,6880,5122,1283,143800,80260
0,0,0,-,-,80264
77,0,77,2582,-,80290
0,0,0,-,-,80293
0,0,0,-,-,80294
11803,7109,4694,1705,549400,80301
12192,4828,7364,1527,872600,80302
11118,5231,5887,1477,724700,80303
11348,7931,3417,1560,871700,80304
7044,4416,2628,1858,734500,80305
0,0,0,-,-,80310
16227,11186,5041,1494,544200,80401
8078,7039,1039,1698,572800,80403
0,0,0,-,-,80419
309,259,50,1321,364400,80420
3503,3201,302,1216,385600,80421
2311,2081,230,1162,385000,80422
49,44,5,-,-,80423
3771,2529,1242,1812,670500,80424
64,64,0,-,480000,80425
26,20,6,-,-,80426
316,144,172,1317,314700,80427
226,189,37,-,505100,80428
111,98,13,-,239500,80432
3511,3136,375,1697,491800,80433
19,19,0,-,222900,80434
2742,1659,1083,1238,589400,80435
140,116,24,-,338200,80436
340,235,105,1577,182800,80438
10097,8784,1313,1666,584100,80439
1009,788,221,1142,357900,80440
854,377,477,1078,297000,80442
1805,1319,486,1840,615400,80443
656,389,267,1079,323800,80444
1741,1181,560,1048,290000,80446
995,737,258,781,409500,80447
0,0,0,-,-,80448
498,498,0,-,330300,80449
322,275,47,928,288800,80451
1460,1100,360,986,337400,80452
78,43,35,-,455800,80453
617,599,18,-,522100,80454
262,205,57,1250,323200,80455
178,135,43,-,325000,80456
86,86,0,-,406500,80457
999,743,256,921,260900,80459
3179,2440,739,1086,249500,80461
93,87,6,-,-,80463
5891,5258,633,1918,435000,80465
1616,1028,588,1513,537500,80466
1041,776,265,979,405500,80467
141,76,65,-,361500,80468
187,127,60,1153,202900,80469
1637,1530,107,1133,457900,80470
0,0,0,-,-,80471
43,8,35,-,-,80473
10,10,0,-,-,80475
85,46,39,844,254200,80476
48,15,33,-,-,80477
575,520,55,-,675600,80478
0,0,0,-,-,80479
573,430,143,-,205800,80480
227,210,17,1625,444800,80481
659,474,185,863,714300,80482
256,218,38,1214,254800,80483
7198,5369,1829,1494,641600,80487
62,0,62,1358,-,80488
96,70,26,-,-,80497
3195,2409,786,1193,534500,80498
16609,9239,7370,1272,344100,80501
13961,10001,3960,1569,535400,80503
19035,15828,3207,1641,405000,80504
148,125,23,-,364300,80510
0,0,0,-,-,80511
822,805,17,-,410900,80512
4895,4342,553,1609,421200,80513
1901,1411,490,1265,323000,80514
395,386,9,-,389700,80515
10184,8705,1479,2059,511000,80516
5522,4057,1465,1009,466500,80517
407,349,58,1586,293100,80520
12404,4976,7428,1214,397700,80521
14685,10096,4589,1315,374600,80524
21651,13700,7951,1411,419000,80525
17465,10272,7193,1350,381900,80526
7327,5431,1896,1678,482500,80528
1280,1130,150,1050,335800,80530
25,25,0,-,-,80532
5347,4611,736,1484,372200,80534
1110,843,267,806,356000,80535
870,849,21,-,392500,80536
18920,12096,6824,1345,350400,80537
20082,14081,6001,1304,357600,80538
1906,1672,234,1344,545200,80540
1471,1441,30,-,384600,80542
2768,2416,352,998,310900,80543
38,38,0,-,-,80544
604,571,33,-,275600,80545
87,87,0,-,225000,80546
358,346,12,1167,495400,80547
4005,3444,561,2004,356000,80549
10064,8462,1602,1401,412800,80550
12091,7886,4205,1363,340500,80601
11631,10779,852,2150,471800,80602
4666,4289,377,1199,338600,80603
1317,962,355,985,318000,80610
313,243,70,880,328800,80611
120,108,12,-,358100,80612
3379,2929,450,888,386200,80615
6139,4036,2103,1281,231000,80620
4768,3596,1172,972,327000,80621
37,37,0,-,270300,80622
336,291,45,1375,204500,80623
362,204,158,1575,434100,80624
16405,7951,8454,930,225600,80631
21872,15861,6011,1307,304500,80634
3967,3116,851,1722,340600,80640
1689,1341,348,1134,344700,80642
1457,1027,430,1458,344100,80643
1078,787,291,894,296200,80644
1886,1445,441,942,300600,80645
548,486,62,1438,347500,80648
203,146,57,732,426300,80649
717,665,52,1188,256400,80650
1371,1157,214,993,333900,80651
156,144,12,-,386700,80652
340,236,104,850,264300,80653
886,644,242,1015,288200,80654
6113,3667,2446,886,225300,80701
375,222,153,754,104300,80705
1093,779,314,793,154100,80720
89,82,7,-,170800,80721
173,131,42,1208,161600,80722
2806,1818,988,937,200700,80723
187,112,75,788,233800,80726
319,140,179,877,88800,80727
386,316,70,665,142500,80728
255,168,87,817,166300,80729
497,401,96,755,173200,80731
231,157,74,879,140400,80733
1260,834,426,738,202000,80734
155,83,72,813,202100,80735
204,178,26,765,122500,80736
657,392,265,595,116500,80737
49,29,20,-,235000,80740
425,342,83,918,243900,80741
105,65,40,684,128800,80742
470,307,163,747,146500,80743
194,172,22,640,86000,80744
76,55,21,-,165600,80745
26,16,10,800,95500,80746
167,129,38,711,144900,80747
103,81,22,575,148800,80749
111,65,46,-,126800,80750
6714,4293,2421,814,161700,80751
77,51,26,505,195800,80754
26,13,13,-,-,80755
113,60,53,239,131300,80757
1354,916,438,783,174000,80758
1905,1493,412,862,211600,80759
75,74,1,-,175800,80801
65,33,32,-,-,80802
105,66,39,515,100000,80804
154,142,12,775,129200,80805
1855,1185,670,813,113000,80807
2251,1621,630,891,268200,80808
426,358,68,1647,342300,80809
509,382,127,716,162500,80810
101,82,19,-,120800,80812
769,386,383,878,166300,80813
1825,1497,328,-,261300,80814
399,291,108,689,122100,80815
2683,2511,172,2026,278100,80816
10354,7449,2905,1501,255200,80817
140,118,22,783,119400,80818
409,269,140,1034,294400,80819
387,387,0,-,306900,80820
429,332,97,680,157300,80821
115,89,26,935,162500,80822
70,52,18,528,-,80823
154,115,39,-,201300,80824
205,158,47,442,106500,80825
268,268,0,-,305000,80827
751,510,241,822,166100,80828
2817,1730,1087,938,432300,80829
69,57,12,-,316700,80830
8586,7806,780,1727,339700,80831
305,237,68,1119,239200,80832
426,400,26,757,167800,80833
145,103,42,708,93000,80834
289,200,89,850,199100,80835
407,264,143,938,158000,80836
607,0,607,1725,-,80840
334,225,109,704,127700,80860
97,85,12,345,220500,80861
19,19,0,-,-,80862
4994,4010,984,1215,340000,80863
603,507,96,-,217700,80864
3063,13,3050,1687,-,80902
7346,2969,4377,899,296700,80903
10368,6298,4070,1070,290300,80904
7786,3916,3870,1067,250000,80905
15210,9580,5630,1298,382400,80906
12516,6708,5808,1005,239900,80907
6725,6116,609,1603,498600,80908
16305,8250,8055,915,242000,80909
12287,5479,6808,1019,176800,80910
12012,9495,2517,1370,232200,80911
127,0,127,-,-,80913
50,0,50,2268,-,80914
8396,5878,2518,1150,237900,80915
13980,7159,6821,1221,191700,80916
13000,7914,5086,1144,251700,80917
19089,11868,7221,1233,297400,80918
11359,8232,3127,1410,396100,80919
13560,9637,3923,1593,351300,80920
9258,7083,2175,1695,473400,80921
10307,7668,2639,1610,286000,80922
11085,7983,3102,1692,307300,80923
3636,2472,1164,1893,461700,80924
4053,3456,597,1757,299800,80925
606,549,57,678,433600,80926
1356,1248,108,2526,407300,80927
373,320,53,1528,159200,80928
46,46,0,-,320700,80929
598,276,322,1563,256800,80930
122,122,0,-,343500,80938
0,0,0,-,-,80939
1516,1186,330,1768,270700,80951
12390,6433,5957,803,136200,81001
5608,2585,3023,713,117100,81003
11082,5763,5319,805,114600,81004
12690,9429,3261,863,177000,81005
4499,3631,868,850,214300,81006
11403,9467,1936,1094,236400,81007
4770,2817,1953,1145,183500,81008
642,431,211,864,158900,81019
535,456,79,554,94600,81020
7,3,4,-,-,81021
531,420,111,1033,181300,81022
548,520,28,1550,252000,81023
102,84,18,-,197900,81024
349,328,21,843,92500,81025
75,47,28,-,57000,81027
124,93,31,-,70700,81029
55,42,13,600,-,81030
52,46,6,-,35000,81033
480,377,103,815,82800,81036
0,0,0,-,-,81038
704,498,206,754,113200,81039
164,164,0,-,303000,81040
287,165,122,430,79400,81041
22,19,3,-,-,81043
103,89,14,422,80500,81044
25,22,3,-,65000,81045
634,420,214,509,100800,81047
124,77,47,-,123000,81049
4371,2895,1476,660,106200,81050
3711,2324,1387,741,112300,81052
1519,832,687,674,73300,81054
721,587,134,1094,265200,81055
146,108,38,700,94600,81057
489,385,104,605,76000,81058
29,25,4,-,-,81059
382,274,108,-,100000,81062
768,560,208,1064,80700,81063
129,91,38,563,71300,81064
1928,1194,734,768,86700,81067
895,782,113,825,268800,81069
103,56,47,785,150000,81071
892,598,294,454,104900,81073
209,153,56,1125,87500,81076
288,239,49,556,119000,81077
68,25,43,-,320800,81081
5469,3640,1829,726,162000,81082
70,32,38,-,82200,81084
46,34,12,367,70000,81087
2098,1403,695,622,148600,81089
473,390,83,234,121900,81090
345,269,76,-,217600,81091
354,263,91,674,172900,81092
5826,3210,2616,700,152300,81101
1067,772,295,582,86200,81120
150,133,17,1042,197100,81121
3216,2618,598,1242,346400,81122
380,290,90,719,86900,81123
51,51,0,-,-,81124
1407,782,625,452,96800,81125
84,76,8,-,252400,81126
57,43,14,-,597200,81128
37,25,12,-,48300,81129
381,278,103,750,328200,81130
655,519,136,786,247200,81131
1450,1164,286,675,157800,81132
505,409,96,497,168600,81133
118,79,39,630,143800,81136
2096,1472,624,938,264800,81137
33,8,25,-,-,81138
875,689,186,629,166000,81140
458,396,62,535,144500,81141
275,216,59,842,119700,81143
2717,1800,917,656,195000,81144
356,199,157,693,157100,81146
5403,3968,1435,998,335300,81147
126,114,12,783,92200,81148
460,339,121,621,135600,81149
631,553,78,539,119300,81151
558,350,208,419,107000,81152
427,332,95,738,246300,81154
103,100,3,-,344000,81155
4070,2930,1140,1095,391300,81201
195,152,43,-,592700,81210
3556,2392,1164,1157,367700,81211
11487,8336,3151,848,203600,81212
53,53,0,-,271200,81220
125,108,17,900,109700,81221
133,122,11,-,243800,81222
902,800,102,1295,192000,81223
1348,1009,339,1289,687000,81224
517,335,182,1328,476300,81225
2571,1880,691,829,154400,81226
0,0,0,-,-,81227
4110,2398,1712,921,312300,81230
0,0,0,-,-,81231
97,97,0,-,-,81232
430,351,79,1040,299000,81233
357,280,77,815,331900,81235
660,544,116,-,495600,81236
30,30,0,-,-,81237
87,87,0,-,358200,81239
1439,1274,165,1017,223600,81240
110,106,4,-,327900,81241
370,294,76,756,420200,81242
37,29,8,-,-,81243
199,177,22,-,145500,81244
58,58,0,-,-,81248
96,96,0,-,433300,81251
1964,1704,260,642,244400,81252
307,307,0,-,-,81253
11986,8037,3949,1228,469700,81301
3317,2398,919,1174,401200,81303
168,168,0,-,166300,81320
5772,3837,1935,828,198700,81321
2166,1616,550,700,293600,81323
675,519,156,286,135500,81324
81,72,9,-,145800,81325
937,821,116,1281,361300,81326
218,191,27,-,275000,81327
1693,1448,245,1036,317800,81328
111,0,111,-,-,81330
114,114,0,-,276000,81331
112,84,28,1125,386700,81332
470,241,229,383,178100,81334
11,11,0,-,-,81335
9528,6740,2788,931,227200,81401
4714,3686,1028,1121,326500,81403
710,564,146,866,277000,81410
28,26,2,-,143200,81411
2245,1589,656,852,265100,81413
793,681,112,1317,367600,81415
5181,3571,1610,812,234700,81416
662,518,144,1123,225000,81418
1310,929,381,805,251000,81419
260,170,90,475,158300,81422
713,519,194,1099,296800,81423
539,452,87,586,151400,81424
2117,1608,509,959,236600,81425
66,63,3,-,594700,81426
552,400,152,883,436400,81427
1675,1346,329,684,266000,81428
36,36,0,-,216700,81429
395,331,64,2011,567800,81430
142,132,10,-,218200,81431
1493,1036,457,1391,529600,81432
284,152,132,1038,347100,81433
132,86,46,1078,-,81434
2392,1210,1182,1159,498000,81435
9729,4302,5427,796,198300,81501
5876,4398,1478,1005,222900,81503
11477,8543,2934,1060,203700,81504
4444,3068,1376,1154,314200,81505
5212,3229,1983,975,317400,81506
6272,5606,666,1338,354500,81507
5035,3141,1894,958,156100,81520
5685,4150,1535,1205,256800,81521
54,54,0,-,-,81522
459,388,71,-,534400,81523
811,670,141,1324,372200,81524
440,377,63,-,220900,81525
2427,1845,582,848,325500,81526
685,558,127,-,349400,81527
6161,3848,2313,1174,513700,81601
106,77,29,565,153800,81610
4378,2608,1770,1677,584100,81611
0,0,0,-,-,81612
1428,1127,301,1312,642400,81615
4147,2535,1612,1501,641100,81620
2457,1659,798,1757,749600,81621
5787,3870,1917,1640,646900,81623
496,419,77,933,326800,81624
4997,3182,1815,839,192200,81625
380,304,76,1046,232800,81630
2605,1918,687,1431,623100,81631
3219,2290,929,1542,698600,81632
0,0,0,-,-,81633
2658,1768,890,803,213900,81635
2526,1876,650,1707,397900,81637
16,8,8,-,-,81638
1047,810,237,989,300900,81639
61,44,17,-,-,81640
1564,1132,432,773,249000,81641
9,0,9,-,-,81642
237,191,46,969,431800,81643
374,229,145,1818,732900,81645
79,65,14,-,383800,81646
2472,1913,559,1361,368600,81647
932,722,210,750,164500,81648
110,70,40,1765,345200,81649
4546,3224,1322,1072,278100,81650
1713,1293,420,1492,361800,81652
8,8,0,-,-,81653
541,504,37,-,423100,81654
34,17,17,-,-,81655
153,153,0,-,-,81656
2447,1757,690,1541,788300,81657
15736,10013,5723,912,211100,82001
0,0,0,-,-,82005
8384,5400,2984,1006,163000,82007
14098,12076,2022,899,309000,82009
135,114,21,863,141700,82050
11,6,5,-,-,82051
0,0,0,-,-,82052
583,448,135,1339,187600,82053
288,255,33,-,240600,82054
154,129,25,-,323300,82055
6,6,0,-,-,82058
100,100,0,-,171600,82059
69,69,0,-,282500,82060
0,0,0,-,-,82061
75,23,52,-,310000,82063
8612,4704,3908,857,245000,82070
7143,3426,3717,788,241100,82072
0,0,0,-,-,82073
26,16,10,-,-,82081
790,685,105,1102,254300,82082
131,68,63,1510,70000,82083
6,6,0,-,-,82084
271,0,271,466,-,82190
2991,2273,718,779,194700,82201
136,115,21,577,225000,82210
255,193,62,1068,202000,82212
212,176,36,725,167300,82213
519,367,152,780,154300,82214
52,24,28,1075,-,82215
14,14,0,-,-,82217
9,9,0,-,-,82219
255,177,78,487,124500,82221
41,38,3,-,-,82222
354,266,88,769,189100,82223
4,4,0,-,-,82224
683,509,174,834,135200,82225
96,76,20,408,89200,82227
1,1,0,-,-,82229
4072,2931,1141,686,186000,82240
17,17,0,-,182500,82242
23,23,0,-,-,82243
223,158,65,539,170800,82244
3368,2340,1028,741,181700,82301
321,217,104,765,209600,82321
83,78,5,-,30000,82322
57,44,13,-,145800,82323
96,54,42,-,204300,82324
454,357,97,1021,210700,82325
357,201,156,1079,90600,82327
164,122,42,588,107400,82329
1100,825,275,691,241000,82331
40,21,19,-,-,82332
219,183,36,600,124100,82334
26,26,0,-,-,82335
98,38,60,768,52300,82336
3129,2297,832,627,164100,82401
808,640,168,605,127700,82410
170,94,76,680,166700,82411
179,150,29,525,140000,82412
6898,4935,1963,975,288600,82414
221,201,20,688,167300,82420
106,96,10,925,95500,82421
13,13,0,-,-,82422
101,58,43,552,100000,82423
1133,836,297,756,154600,82426
79,59,20,-,82300,82428
29,27,2,-,106300,82430
1258,891,367,548,175100,82431
143,102,41,-,187500,82432
491,353,138,852,248400,82433
45,17,28,-,114100,82434
4893,3817,1076,892,272500,82435
109,50,59,-,-,82440
89,89,0,-,359600,82441
377,259,118,587,244600,82442
2158,1528,630,739,166500,82443
86,86,0,-,376800,82450
7226,4949,2277,757,177100,82501
84,72,12,-,133800,82510
78,40,38,685,-,82512
882,641,241,728,198500,82513
420,257,163,464,101500,82514
141,111,30,722,181300,82515
134,79,55,685,-,82516
5050,3585,1465,912,240200,82520
340,295,45,865,185200,82523
11027,7473,3554,774,209700,82601
11033,8684,2349,961,206600,82604
8345,5257,3088,877,247500,82609
90,43,47,769,331300,82620
0,0,0,-,-,82630
3973,3034,939,673,226400,82633
47,19,28,811,-,82635
1457,1059,398,799,209900,82636
1494,1149,345,813,220100,82637
18,18,0,-,-,82638
271,189,82,1015,197900,82639
137,137,0,-,-,82640
35,32,3,-,-,82642
123,107,16,667,53600,82643
731,527,204,794,131600,82644
0,0,0,-,-,82646
33,33,0,-,-,82648
444,322,122,600,115200,82649
2098,1829,269,813,170600,82701
60,47,13,-,396700,82710
15,7,8,-,-,82711
125,125,0,-,320800,82712
23,6,17,-,-,82714
0,0,0,-,-,82715
6905,4951,1954,766,191200,82716
8957,6743,2214,966,250800,82718
288,226,62,646,162500,82720
1086,928,158,667,235900,82721
58,58,0,-,-,82723
96,82,14,-,300000,82725
711,624,87,-,282700,82727
1168,841,327,752,243200,82729
834,618,216,724,173600,82730
66,13,53,-,-,82731
729,601,128,1356,183800,82732
11091,7192,3899,855,275000,82801
154,137,17,708,337200,82831
422,403,19,-,375900,82832
56,56,0,-,-,82833
3427,2356,1071,874,238700,82834
168,79,89,715,260300,82835
423,324,99,900,276600,82836
20,12,8,-,"2,000,000+",82837
241,235,6,-,513100,82838
471,411,60,-,261500,82839
407,301,106,1207,328700,82842
9,9,0,-,-,82844
0,0,0,-,-,82845
10294,7678,2616,872,198800,82901
202,202,0,-,592800,82922
348,348,0,-,585700,82923
179,179,0,-,290000,82925
24,0,24,-,-,82929
5699,4269,1430,656,177500,82930
194,169,25,-,109000,82932
161,161,0,-,-,82933
69,64,5,-,112500,82934
4651,3541,1110,854,225100,82935
6,6,0,-,-,82936
1267,1093,174,732,187800,82937
106,106,0,-,323900,82938
569,354,215,828,169400,82939
1696,1337,359,1130,244000,82941
36,36,0,-,-,82942
81,61,20,-,-,82943
117,117,0,-,-,82944
83,74,9,-,72900,82945
7764,4208,3556,1519,831000,83001
56,56,0,-,-,83011
0,0,0,-,-,83012
53,53,0,-,-,83013
1328,972,356,1277,881300,83014
477,169,308,-,1502900,83025
1423,1089,334,613,153000,83101
1744,1238,506,588,237200,83110
308,231,77,-,218100,83111
161,139,22,-,-,83112
792,554,238,721,197600,83113
293,256,37,1125,181100,83114
312,312,0,-,322400,83115
323,241,82,807,103400,83116
329,329,0,-,442900,83118
49,49,0,-,-,83119
124,108,16,-,375000,83120
0,0,0,-,-,83121
198,156,42,-,-,83122
303,246,57,546,301600,83123
64,56,8,-,-,83124
152,152,0,-,422900,83126
1534,1350,184,1172,313400,83127
396,280,116,1163,350000,83128
13529,8947,4582,682,160000,83201
8210,5921,2289,803,183600,83202
155,124,31,430,217400,83203
7512,4863,2649,615,156000,83204
252,0,252,548,-,83209
1319,1048,271,519,122500,83210
2120,1283,837,751,157000,83211
134,113,21,327,116900,83212
453,342,111,540,87900,83213
217,169,48,-,179900,83214
25,23,2,-,64600,83215
335,286,49,675,179200,83217
120,102,18,836,171900,83218
60,35,25,-,113400,83220
9203,7137,2066,668,165800,83221
57,44,13,-,269600,83223
989,731,258,677,196700,83226
7,7,0,-,-,83227
251,193,58,766,225800,83228
196,156,40,775,186900,83232
127,103,24,-,-,83233
493,429,64,750,130600,83234
79,79,0,-,-,83235
923,762,161,653,205500,83236
303,230,73,917,171900,83237
32,32,0,-,212500,83238
231,201,30,850,137500,83239
851,640,211,563,156300,83241
0,0,0,-,-,83243
172,130,42,-,211200,83244
833,722,111,694,208900,83245
439,376,63,658,232100,83246
733,645,88,532,215000,83250
449,374,75,869,219200,83251
1715,1406,309,731,182700,83252
25,25,0,-,-,83253
1453,1058,395,560,121800,83254
486,392,94,715,173200,83255
230,203,27,745,159900,83261
274,254,20,-,161900,83262
3244,2770,474,647,234800,83263
137,117,20,-,126800,83271
122,108,14,-,257100,83272
3194,2513,681,795,191100,83274
1347,1084,263,660,146100,83276
69,69,0,-,267500,83277
242,235,7,-,564100,83278
23,0,23,-,-,83281
51,51,0,-,465000,83283
39,19,20,-,277900,83285
387,313,74,896,197500,83286
98,98,0,-,436800,83287
21990,14644,7346,844,182100,83301
91,45,46,673,108800,83302
293,218,75,856,183900,83311
25,18,7,-,140000,83312
1412,1090,322,1263,395700,83313
406,320,86,765,164500,83314
3905,2971,934,689,154900,83316
5975,4020,1955,701,168300,83318
355,302,53,713,170600,83320
229,165,64,819,237500,83321
5,5,0,-,-,83322
574,426,148,758,192700,83323
209,150,59,700,162500,83324
282,164,118,838,159200,83325
357,261,96,844,160000,83327
2111,1570,541,851,193200,83328
2457,1709,748,752,155800,83330
1176,867,309,752,196500,83332
3897,2647,1250,901,455400,83333
780,525,255,827,124400,83334
622,451,171,523,130900,83335
2011,1419,592,872,162200,83336
16,16,0,-,-,83337
7081,4836,2245,766,183200,83338
1934,1395,539,1205,716300,83340
2421,2120,301,786,261300,83341
404,388,16,-,178000,83342
375,217,158,697,142000,83344
533,399,134,920,171300,83346
1155,925,230,639,160100,83347
100,74,26,-,447900,83348
397,314,83,642,133600,83349
4335,2898,1437,671,148400,83350
1221,818,403,667,152300,83352
553,479,74,1677,919400,83353
13,13,0,-,-,83354
1532,920,612,704,139100,83355
14116,10036,4080,852,188800,83401
10396,6121,4275,741,179600,83402
9038,6776,2262,864,219300,83404
6267,4641,1626,916,227900,83406
170,151,19,-,795200,83414
867,635,232,736,183900,83420
145,145,0,-,170200,83421
1255,904,351,983,388700,83422
301,156,145,670,117300,83423
47,47,0,-,-,83424
203,164,39,970,181300,83425
586,555,31,1305,218800,83427
243,218,25,550,328600,83428
357,352,5,-,428000,83429
285,234,51,852,200000,83431
4,4,0,-,-,83433
564,428,136,805,168300,83434
238,123,115,1302,166900,83435
231,200,31,995,233300,83436
11245,4547,6698,770,226000,83440
6524,5467,1057,864,240700,83442
398,346,52,950,127300,83443
457,292,165,496,203300,83444
2482,1971,511,685,158600,83445
12,12,0,-,-,83446
729,510,219,1097,225900,83448
72,60,12,850,413600,83449
297,226,71,816,128100,83450
226,171,55,834,164200,83451
807,691,116,915,332400,83452
163,136,27,869,186700,83454
2181,1708,473,1004,358600,83455
0,0,0,-,-,83460
267,231,36,-,306800,83462
39,26,13,-,170500,83463
117,74,43,469,95500,83464
53,40,13,-,281300,83465
124,91,33,-,224000,83466
2979,2339,640,646,190300,83467
82,71,11,-,269400,83468
15,15,0,-,-,83469
14617,10680,3937,727,208700,83501
94,50,44,623,216700,83520
698,546,152,750,181100,83522
339,297,42,638,130900,83523
399,281,118,760,175500,83524
135,107,28,-,253800,83525
104,89,15,821,208300,83526
2083,1428,655,804,181500,83530
82,65,17,775,267300,83533
404,294,110,850,182600,83535
1913,1469,444,587,179400,83536
416,356,60,687,174600,83537
934,741,193,670,199800,83539
788,463,325,748,149500,83540
433,395,38,1054,225000,83541
70,47,23,-,212500,83542
267,217,50,650,123000,83543
2605,1898,707,800,177100,83544
185,170,15,718,130600,83545
192,163,29,550,110500,83546
177,132,45,-,259500,83547
50,42,8,775,93300,83548
312,229,83,785,241700,83549
459,400,59,693,174200,83552
410,356,54,606,119900,83553
220,212,8,-,185700,83554
216,180,36,605,164100,83555
0,0,0,-,-,83601
6,6,0,-,-,83602
298,162,136,443,220000,83604
14542,9468,5074,861,179800,83605
8027,6112,1915,862,239900,83607
377,289,88,621,181900,83610
943,851,92,780,275500,83611
877,671,206,688,205800,83612
432,366,66,1290,212600,83615
11230,9724,1506,1258,460500,83616
6210,4585,1625,658,187100,83617
2971,2183,788,803,190000,83619
991,839,152,718,275900,83622
600,351,249,479,84000,83623
570,305,265,581,208600,83624
464,321,143,1031,189900,83626
236,198,38,-,141700,83627
1628,1098,530,729,98800,83628
878,692,186,836,272700,83629
533,404,129,667,152900,83631
141,113,28,648,225000,83632
284,188,96,-,168200,83633
8146,6604,1542,1328,237900,83634
54,27,27,-,-,83636
122,113,9,-,192500,83637
2508,1994,514,853,351400,83638
1332,1042,290,558,171900,83639
1252,1095,157,761,226200,83641
17854,12529,5325,1077,304600,83642
46,46,0,-,157800,83643
4507,4145,362,893,266300,83644
315,258,57,550,257400,83645
23299,19603,3696,1341,319500,83646
8757,5883,2874,835,167500,83647
890,0,890,1113,-,83648
186,159,27,-,241700,83650
13086,8863,4223,966,176800,83651
657,586,71,719,314800,83654
1986,1653,333,738,220400,83655
164,132,32,893,109700,83656
90,78,12,-,290000,83657
2171,1596,575,856,207900,83660
3753,2337,1416,686,151700,83661
25,19,6,-,87900,83666
3926,3201,725,894,322500,83669
244,235,9,-,199200,83670
5,5,0,-,-,83671
3555,2534,1021,710,154500,83672
1868,1310,558,672,259000,83676
69,69,0,-,-,83677
18119,13686,4433,990,231500,83686
12173,8407,3766,982,216100,83687
11069,5844,5225,894,460400,83702
7354,4547,2807,1048,289000,83703
16351,9972,6379,979,223100,83704
12267,6673,5594,905,224800,83705
14623,6950,7673,1032,320700,83706
21787,17815,3972,1253,276600,83709
4641,2849,1792,1042,464000,83712
10803,8109,2694,1253,276200,83713
10436,7219,3217,1024,272000,83714
6865,5336,1529,1396,355600,83716
2534,2182,352,1113,313100,83801
20,4,16,781,-,83802
484,336,148,1040,450000,83803
678,590,88,733,216000,83804
3230,2518,712,720,233900,83805
81,70,11,563,104700,83806
55,43,12,517,89200,83808
97,97,0,-,-,83809
673,626,47,-,390000,83810
684,459,225,916,162800,83811
22,22,0,-,95000,83812
365,308,57,-,365100,83813
11348,6120,5228,952,335600,83814
15252,9718,5534,1102,294600,83815
106,99,7,-,432100,83821
885,742,143,637,170700,83822
731,627,104,826,255600,83823
99,70,29,667,-,83824
90,75,15,-,227500,83825
0,0,0,-,-,83826
72,63,9,-,111900,83827
163,163,0,-,189800,83830
658,569,89,836,225200,83832
810,719,91,933,456500,83833
66,66,0,-,-,83834
9124,7680,1444,1147,318100,83835
438,364,74,873,371400,83836
1347,762,585,747,117200,83837
667,543,124,774,172200,83839
107,92,15,713,154300,83840
149,68,81,-,-,83841
43,33,10,-,212500,83842
11327,4982,6345,726,252900,83843
0,0,0,-,-,83844
743,611,132,806,241100,83845
353,247,106,742,89600,83846
623,376,247,539,226800,83847
80,52,28,-,-,83848
882,735,147,628,122100,83849
840,656,184,808,160600,83850
649,468,181,753,143800,83851
403,84,319,799,163600,83852
16097,11575,4522,1030,253800,83854
850,645,205,691,180000,83855
2739,2265,474,682,223900,83856
411,411,0,-,311100,83857
6238,5338,900,1116,296900,83858
2400,1987,413,942,323600,83860
2633,1918,715,692,183300,83861
7693,5457,2236,974,303500,83864
82,82,0,-,-,83866
136,136,0,-,162500,83867
335,246,89,836,88300,83868
2076,1855,221,832,243600,83869
131,106,25,325,230600,83870
828,718,110,668,243200,83871
231,199,32,1235,295100,83872
735,473,262,541,142800,83873
17,17,0,-,-,83874
714,588,126,679,246000,83876
219,209,10,675,186900,84001
107,86,21,-,235300,84002
14288,10964,3324,1337,382700,84003
2851,2411,440,2896,628300,84004
7768,7107,661,1628,317100,84005
289,197,92,1094,211300,84006
259,186,73,-,188300,84007
15019,10893,4126,1137,342200,84010
232,221,11,813,291700,84013
5921,5128,793,1244,349400,84014
20182,15356,4826,1067,244000,84015
1471,1203,268,1116,322800,84017
77,77,0,-,408300,84018
14390,11190,3200,1436,517100,84020
1331,998,333,870,165700,84021
260,12,248,865,-,84022
68,31,37,242,285000,84023
10,10,0,-,-,84024
6920,5688,1232,1215,420200,84025
389,319,70,619,123300,84026
225,200,25,1107,191300,84027
143,73,70,858,282100,84028
3208,2729,479,800,274100,84029
86,66,20,-,195300,84031
7376,5337,2039,1334,423700,84032
379,290,89,804,294400,84033
64,37,27,-,104800,84034
216,207,9,-,121000,84035
2489,1938,551,1194,426800,84036
11109,9719,1390,1156,385400,84037
143,130,13,-,326900,84038
188,181,7,-,162100,84039
8066,6852,1214,1408,326700,84040
16539,10851,5688,1054,260800,84041
2929,2425,504,1172,429200,84042
17849,14004,3845,1518,379300,84043
8214,6449,1765,1109,229200,84044
7542,6370,1172,1596,364900,84045
101,89,12,-,133800,84046
13909,6184,7725,1155,281900,84047
2046,1584,462,2341,531000,84049
3357,2962,395,1230,418100,84050
175,145,30,950,153100,84051
499,372,127,758,153000,84052
338,312,26,773,185000,84053
6983,4886,2097,1277,338600,84054
472,397,75,-,378200,84055
1022,6,1016,1361,-,84056
12266,7318,4948,1080,267100,84057
13285,6417,6868,1141,320700,84058
3171,2004,1167,1681,1106200,84060
168,123,45,-,351300,84061
13764,10020,3744,1227,339900,84062
65,48,17,-,222200,84063
201,131,70,537,165300,84064
13283,11419,1864,1388,405600,84065
4312,3115,1197,789,194100,84066
13087,10758,2329,1126,222500,84067
156,130,26,1139,256900,84069
10594,6718,3876,1317,279500,84070
533,514,19,914,317500,84071
133,111,22,813,183500,84072
84,71,13,-,197300,84073
16410,13439,2971,1057,232400,84074
7961,7284,677,1766,340600,84075
87,85,2,-,-,84076
8931,6647,2284,709,207800,84078
107,98,9,1125,158800,84080
13883,11561,2322,1358,344600,84081
364,345,19,-,409300,84082
481,151,330,513,-,84083
11896,9342,2554,1248,287400,84084
133,94,39,778,110000,84085
154,136,18,-,148100,84086
4887,4197,690,1452,315600,84087
12162,8731,3431,1216,319400,84088
9069,8480,589,1798,485900,84092
7632,6778,854,1731,438500,84093
9394,7305,2089,1419,324200,84094
22263,18530,3733,1504,430000,84095
14072,11800,2272,1398,399300,84096
7081,5228,1853,1159,347300,84097
6988,5812,1176,1673,803100,84098
3303,703,2600,1006,272300,84101
9730,2143,7587,1044,353100,84102
11204,5426,5778,964,536300,84103
8111,4368,3743,1083,195900,84104
9457,6029,3428,1196,433800,84105
14431,8633,5798,1213,359500,84106
14424,6851,7573,1114,279100,84107
7572,5989,1583,1239,579500,84108
8759,6739,2020,1313,473200,84109
6969,1570,5399,983,323600,84111
200,6,194,817,-,84112
0,0,0,-,-,84113
11264,4241,7023,925,253200,84115
11628,6771,4857,987,224100,84116
9939,6675,3264,1293,395700,84117
20187,16452,3735,1360,242700,84118
16408,9546,6862,1141,213800,84119
13195,9458,3737,1136,241300,84120
15381,11538,3843,1338,396200,84121
13860,7826,6034,1133,279300,84123
7988,5979,2009,1163,469800,84124
7163,6420,743,1557,254200,84128
217,103,114,1913,1090300,84144
0,0,0,-,-,84180
256,230,26,1375,232900,84301
8567,6140,2427,779,220600,84302
29,29,0,-,-,84304
267,254,13,936,200000,84305
100,100,0,-,361800,84306
337,307,30,-,227000,84307
81,73,8,588,228800,84308
141,133,8,-,260700,84309
1514,1429,85,2591,479900,84310
217,143,74,713,192000,84311
1523,1237,286,697,210000,84312
32,19,13,-,-,84313
335,277,58,888,251800,84314
2801,2691,110,1188,334700,84315
108,96,12,-,166700,84316
918,834,84,-,395200,84317
1343,1169,174,829,293300,84318
2587,2056,531,775,229800,84319
794,623,171,745,220700,84320
15069,7317,7752,759,230700,84321
297,284,13,1042,327500,84324
670,605,65,633,351300,84325
673,560,113,750,276300,84326
236,213,23,708,249300,84327
466,446,20,925,371000,84328
41,41,0,-,-,84329
145,141,4,950,209800,84330
103,85,18,1161,185600,84331
2511,2204,307,1154,324200,84332
882,700,182,790,238400,84333
59,26,33,-,-,84334
3765,3159,606,943,252500,84335
89,83,6,750,168400,84336
4303,3233,1070,768,216000,84337
176,119,57,605,211600,84338
1642,1415,227,821,267800,84339
1080,961,119,933,278700,84340
8390,3830,4560,1005,268500,84341
14585,8745,5840,873,241200,84401
12897,9061,3836,868,260700,84403
21177,15636,5541,999,216000,84404
11468,8669,2799,1026,253800,84405
9084,8011,1073,1044,313800,84414
4796,3463,1333,697,156900,84501
1493,1028,465,786,170900,84511
236,198,38,-,90000,84512
558,466,92,604,133700,84513
0,0,0,-,-,84515
43,35,8,-,159400,84516
278,209,69,875,177800,84518
457,319,138,656,62900,84520
269,202,67,646,136800,84521
112,102,10,-,86700,84522
610,467,143,526,162200,84523
339,227,112,541,89200,84525
1712,1281,431,680,158100,84526
1041,752,289,630,131000,84528
75,54,21,-,160900,84529
63,25,38,-,-,84530
187,173,14,-,28400,84531
4564,3034,1530,1012,292600,84532
34,0,34,-,-,84533
705,592,113,568,55500,84534
1097,886,211,966,184900,84535
376,329,47,-,34400,84536
482,351,131,741,151100,84537
134,87,47,-,40500,84539
19,19,0,-,-,84540
628,433,195,660,121100,84542
11074,4959,6115,916,251700,84601
12033,6277,5756,898,361300,84604
10466,2416,8050,891,278800,84606
360,340,20,575,170400,84620
59,59,0,-,-,84621
523,462,61,856,207800,84622
87,69,18,-,-,84623
1932,1319,613,768,174800,84624
95,68,27,-,323300,84626
2162,1268,894,730,249100,84627
243,228,15,-,-,84628
1131,1076,55,1172,267900,84629
147,65,82,763,151600,84630
957,731,226,653,162200,84631
380,323,57,633,186300,84632
357,289,68,1040,222500,84633
471,367,104,942,210100,84634
314,207,107,814,96100,84635
190,161,29,775,165900,84636
250,195,55,-,198600,84637
116,89,27,740,202300,84638
297,242,55,687,210500,84639
44,44,0,-,121900,84640
1150,805,345,865,173900,84642
183,163,20,933,228700,84643
776,702,74,-,289000,84645
547,490,57,591,169100,84646
1343,1108,235,1050,193200,84647
2103,1517,586,713,262200,84648
323,290,33,528,164400,84649
7508,6274,1234,1104,282800,84651
281,242,39,825,163300,84652
2409,2208,201,1166,372300,84653
1090,883,207,727,151400,84654
3660,3149,511,956,293500,84655
127,117,10,850,192300,84656
154,136,18,833,134800,84657
11280,8514,2766,1136,306900,84660
498,444,54,1016,225000,84662
9611,6855,2756,1152,296100,84663
2642,2368,274,1208,463000,84664
182,163,19,833,306300,84665
131,96,35,830,214300,84667
2954,1992,962,696,181600,84701
50,33,17,788,217500,84710
298,284,14,-,193800,84711
56,51,5,-,215600,84712
1216,994,222,729,246800,84713
288,217,71,856,188100,84714
128,109,19,538,188500,84715
192,109,83,741,231300,84716
133,107,26,1047,-,84718
29,24,5,-,-,84719
7521,4548,2973,786,249300,84720
7672,5197,2475,866,223800,84721
431,395,36,-,194000,84722
277,241,36,754,215000,84723
447,350,97,615,131000,84724
485,435,50,1090,217800,84725
388,296,92,775,188000,84726
20,7,13,-,-,84728
116,110,6,-,138500,84729
126,124,2,-,172600,84730
35,35,0,-,262000,84731
15,15,0,-,268800,84732
84,71,13,-,291000,84733
110,69,41,575,210300,84734
54,39,15,-,412500,84735
97,89,8,-,109200,84736
6494,4781,1713,957,264500,84737
3755,3097,658,1254,351300,84738
194,125,69,738,155700,84739
100,98,2,-,155000,84740
2426,1872,554,1052,247300,84741
130,122,8,-,393800,84742
3,3,0,-,-,84743
84,68,16,-,164100,84744
1450,1096,354,1103,225600,84745
417,373,44,-,350000,84746
395,256,139,636,208800,84747
59,59,0,-,232700,84749
180,153,27,-,151300,84750
698,558,140,781,134600,84751
284,218,66,871,178700,84752
0,0,0,-,-,84753
1427,1309,118,536,204500,84754
14,14,0,-,312500,84755
120,87,33,-,-,84756
620,498,122,1417,440100,84757
159,139,20,814,176000,84758
668,583,85,681,175800,84759
193,158,35,930,205300,84760
1289,890,399,878,181000,84761
48,28,20,-,-,84762
134,113,21,925,390200,84763
82,20,62,623,228600,84764
2279,1721,558,1404,328100,84765
83,63,20,-,180300,84766
219,165,54,623,669000,84767
15864,9299,6565,1022,292000,84770
99,57,42,-,295300,84772
101,59,42,-,168300,84773
444,426,18,-,330600,84774
202,178,24,-,484600,84775
185,163,22,988,181600,84776
238,203,35,875,305600,84779
9096,6390,2706,1162,328500,84780
57,48,9,-,-,84781
275,230,45,-,334800,84782
341,325,16,-,418400,84783
407,108,299,928,253800,84784
16634,12178,4456,1183,324800,84790
4378,1525,2853,1026,405800,85003
3584,933,2651,1260,285000,85004
9471,3664,5807,871,233100,85006
5196,1924,3272,841,292600,85007
22950,6465,16485,978,203300,85008
14042,6378,7664,865,132000,85009
3880,1922,1958,1220,494800,85012
10076,4523,5553,1059,329300,85013
13405,4780,8625,1027,295700,85014
16772,5543,11229,942,205700,85015
17118,8433,8685,1119,359000,85016
11554,5070,6484,883,150000,85017
17326,9469,7857,1049,577000,85018
7966,3980,3986,969,164300,85019
16695,8919,7776,1063,265800,85020
16691,6423,10268,942,294100,85021
23104,11902,11202,1157,277000,85022
13409,7902,5507,1083,235700,85023
10553,7495,3058,1412,288400,85024
16212,9357,6855,1146,215500,85027
7805,6457,1348,1366,394500,85028
17886,9407,8479,1003,207400,85029
8695,5050,3645,993,164200,85031
28664,16410,12254,1116,266600,85032
16107,7893,8214,1049,164400,85033
2317,403,1914,781,166300,85034
15206,6506,8700,1058,165100,85035
15084,8859,6225,1222,184000,85037
10792,4903,5889,911,172300,85040
17415,12179,5236,1141,204600,85041
15168,9260,5908,1157,221600,85042
9838,6232,3606,1245,189600,85043
17550,10858,6692,1344,316200,85044
2587,2376,211,2063,387200,85045
13658,9533,4125,1491,381600,85048
11809,8752,3057,1678,361500,85050
15408,8551,6857,935,184500,85051
11716,6766,4950,1034,223100,85053
4175,1590,2585,1616,381800,85054
6448,5890,558,1757,396000,85083
9352,5412,3940,1425,398500,85085
15537,12637,2900,1694,373300,85086
3229,2981,248,1542,355200,85087
6470,6038,432,1099,283700,85118
11442,8711,2731,914,176700,85119
13855,11332,2523,795,104400,85120
597,173,424,486,81900,85121
19572,12317,7255,1001,150500,85122
4337,3106,1231,881,123000,85123
4811,3335,1476,828,129800,85128
4043,2404,1639,766,118300,85131
8465,6791,1674,1025,182600,85132
154,127,27,-,33700,85135
967,739,228,975,113800,85137
12433,10035,2398,1445,220100,85138
5645,4226,1419,1104,187000,85139
16084,13323,2761,1422,244900,85140
173,145,28,850,-,85141
23221,20181,3040,1575,332100,85142
13419,10144,3275,1442,224000,85143
1175,969,206,1202,174800,85145
1241,635,606,310,95100,85147
496,231,265,649,116300,85172
1375,990,385,693,103400,85173
1062,908,154,584,127300,85192
1635,1152,483,929,83900,85193
3082,2746,336,1045,229400,85194
20510,7321,13189,1010,184600,85201
15919,7423,8496,1021,243200,85202
13123,7192,5931,1059,270200,85203
22969,13130,9839,1085,213900,85204
18304,12802,5502,1080,218600,85205
15759,10161,5598,1250,215900,85206
19041,15202,3839,1212,314700,85207
15184,11826,3358,1161,163600,85208
16815,12691,4124,1387,245200,85209
15048,6518,8530,990,210300,85210
12045,9971,2074,1599,337800,85212
13012,10127,2885,1178,290400,85213
7423,5939,1484,1432,268700,85215
17653,9569,8084,1370,271300,85224
25232,14996,10236,1219,255400,85225
15032,9232,5800,1358,320800,85226
13256,9042,4214,1532,313000,85233
15787,11148,4639,1406,336900,85234
17269,13913,3356,1474,350700,85248
14047,12468,1579,1900,397900,85249
8757,6740,2017,1358,360900,85250
21671,10241,11430,1276,352000,85251
8082,6880,1202,1710,1335800,85253
19040,13834,5206,1490,491000,85254
18074,13674,4400,1985,716200,85255
1621,1260,361,600,60600,85256
14958,8967,5991,1225,294400,85257
13238,9464,3774,1625,540000,85258
10034,7554,2480,1287,678400,85259
19254,11527,7727,1642,445000,85260
6034,5623,411,2341,854300,85262
1577,1496,81,-,560300,85263
427,388,39,575,333300,85264
5759,5579,180,2962,766900,85266
11500,9352,2148,1444,410500,85268
25889,5503,20386,1180,239100,85281
24431,10651,13780,1214,259600,85282
20435,9467,10968,1265,271100,85283
7406,6055,1351,1751,457600,85284
15448,10279,5169,1650,378700,85286
15781,10208,5573,1536,348100,85295
14525,10838,3687,1703,335500,85296
9279,7095,2184,1684,352200,85297
10656,9840,816,2202,400200,85298
21921,8396,13525,893,146100,85301
14344,7047,7297,970,205700,85302
9776,5804,3972,1129,197400,85303
9882,7203,2679,1126,234000,85304
4297,2783,1514,1341,275900,85305
8545,5402,3143,1218,233200,85306
3986,1939,2047,1244,228300,85307
25087,18383,6704,1283,285000,85308
0,0,0,-,-,85309
6890,5954,936,1771,345700,85310
278,222,56,-,233800,85320
1528,1113,415,843,95800,85321
252,213,39,536,155200,85322
13318,8037,5281,1189,209100,85323
1296,1083,213,795,134600,85324
677,653,24,-,96200,85325
16218,12205,4013,1233,219000,85326
172,112,60,-,-,85328
12680,11603,1077,1783,450600,85331
846,717,129,1080,181400,85332
293,184,109,760,-,85333
536,409,127,485,155900,85334
10873,6983,3890,1308,177200,85335
348,103,245,427,131700,85336
811,414,397,689,106500,85337
16472,12692,3780,1378,274300,85338
14022,10344,3678,1559,258600,85339
12170,9807,2363,1602,348200,85340
24,0,24,-,-,85341
913,769,144,588,160900,85342
28,28,0,-,-,85343
4084,2667,1417,650,122800,85344
20384,13559,6825,1170,182100,85345
2556,1623,933,699,47200,85346
131,51,80,344,-,85347
1507,1413,94,323,57300,85348
8356,5552,2804,649,128500,85349
6143,4244,1899,802,152900,85350
17511,14787,2724,1119,165500,85351
197,122,75,765,79500,85352
10855,7082,3773,1324,220200,85353
2436,2070,366,1113,202000,85354
3808,3514,294,1669,332300,85355
2097,1592,505,649,92300,85356
287,203,84,395,-,85357
53,30,23,-,137500,85360
2240,2007,233,983,311800,85361
407,256,151,764,146300,85362
2498,1214,1284,991,169300,85363
26560,15551,11009,800,144500,85364
19734,14792,4942,1073,143400,85365
10783,9028,1755,1077,131800,85367
109,49,60,382,"10,000-",85371
9212,7998,1214,1469,231100,85373
22266,16129,6137,1274,230600,85374
17328,15440,1888,1254,247200,85375
1773,1501,272,1500,724200,85377
14048,10097,3951,1584,261600,85379
9180,5984,3196,1330,279000,85381
15803,10830,4973,1457,272300,85382
18456,16637,1819,1798,405700,85383
5191,4648,543,1182,326700,85387
9855,7870,1985,1659,275200,85388
4262,3482,780,631,264700,85390
12642,7734,4908,1337,251700,85392
10092,8223,1869,1616,361800,85395
8100,7283,817,1732,307000,85396
5233,3803,1430,855,113300,85501
477,368,109,380,34300,85530
167,54,113,1565,184400,85531
1225,853,372,575,81400,85533
974,789,185,468,116700,85534
0,0,0,-,-,85535
170,157,13,-,139500,85536
1584,1127,457,709,83000,85539
1056,0,1056,447,-,85540
10310,7999,2311,966,239000,85541
701,318,383,438,30800,85542
1308,1012,296,893,142100,85543
1497,1273,224,935,288600,85544
370,323,47,-,119200,85545
6199,4551,1648,817,146500,85546
1406,748,658,320,52100,85550
130,120,10,-,129200,85551
2077,1457,620,945,190900,85552
1009,861,148,-,151800,85553
257,203,54,498,254300,85554
416,355,61,-,67600,85601
4064,3197,867,692,133000,85602
3476,2537,939,757,146300,85603
254,140,114,563,64100,85605
415,341,74,570,120400,85606
5779,3896,1883,591,102700,85607
0,0,0,-,-,85608
176,176,0,-,-,85609
372,303,69,579,131300,85610
467,444,23,-,274500,85611
954,0,954,1199,-,85613
13572,11053,2519,1072,189500,85614
3967,3379,588,699,183000,85615
2472,1615,857,788,120900,85616
683,500,183,508,102300,85617
611,494,117,703,61900,85618
28,15,13,-,-,85619
369,283,86,565,65300,85620
7789,4175,3614,585,122400,85621
3435,3164,271,1121,244200,85622
2490,2168,322,879,249800,85623
584,368,216,904,276700,85624
998,886,112,715,104400,85625
261,239,22,-,85000,85626
481,410,71,781,135000,85627
7943,6547,1396,1407,212800,85629
938,710,228,700,125000,85630
1722,1431,291,814,81800,85631
392,327,65,597,136000,85632
5,0,5,-,-,85633
1632,961,671,588,73900,85634
14872,8643,6229,871,158600,85635
476,429,47,-,386100,85637
830,582,248,638,146100,85638
68,68,0,-,169300,85640
9405,8667,738,1454,267400,85641
3144,2254,890,595,115400,85643
654,580,74,860,111500,85645
667,585,82,1712,348500,85646
6170,4976,1194,863,148100,85648
6591,5242,1349,1093,225300,85650
7057,5841,1216,998,180800,85653
0,0,0,-,-,85654
4734,4236,498,1212,378900,85658
2750,654,2096,954,300000,85701
15591,9088,6503,1097,285800,85704
24304,11647,12657,743,82200,85705
17260,10238,7022,828,107700,85706
0,0,0,-,-,85707
1212,16,1196,1344,-,85708
24780,13432,11348,919,174100,85710
17212,8590,8622,800,167600,85711
16384,6465,9919,789,170200,85712
16758,10697,6061,830,107100,85713
5132,2639,2493,655,114400,85714
8792,5737,3055,1073,242400,85715
15259,6301,8958,790,202300,85716
12818,8520,4298,1024,514900,85718
18119,5108,13011,873,244200,85719
0,0,0,-,-,85723
0,0,0,-,-,85724
0,0,0,-,-,85726
15289,10263,5026,940,150600,85730
4070,3710,360,679,141900,85735
1783,1629,154,692,97200,85736
9756,7206,2550,1414,326500,85737
9126,8376,750,994,309000,85739
13989,8134,5855,1153,190100,85741
11154,8643,2511,1263,226900,85742
11441,9776,1665,1335,236600,85743
16596,10504,6092,924,226300,85745
15602,10651,4951,1045,146700,85746
8739,6998,1741,1481,229700,85747
7779,5803,1976,1205,238300,85748
7991,6715,1276,1137,413100,85749
11562,8330,3232,1095,412300,85750
7435,6607,828,1572,340100,85755
11730,9095,2635,1002,144700,85756
6144,4809,1335,743,185700,85757
7380,5249,2131,934,168900,85901
370,214,156,543,-,85911
145,145,0,-,102200,85912
315,273,42,821,225000,85920
40,40,0,-,228600,85922
238,214,24,-,132800,85923
1124,1055,69,-,109600,85924
1662,1359,303,759,177800,85925
235,37,198,379,90800,85926
78,78,0,-,584700,85927
376,240,136,-,291000,85928
3184,2260,924,927,176500,85929
304,139,165,436,93400,85930
73,66,7,-,355300,85931
204,204,0,-,193200,85932
1336,1104,232,757,205900,85933
238,217,21,-,326600,85934
2057,1638,419,710,266900,85935
1079,879,200,703,111100,85936
2707,2202,505,833,161700,85937
954,742,212,667,112800,85938
1624,1321,303,-,200100,85939
440,397,43,-,184000,85940
2672,1519,1153,477,63000,85941
11,11,0,-,-,85942
17753,8672,9081,1316,392700,86001
10,6,4,-,-,86003
13534,8618,4916,1252,343200,86004
194,1,193,730,-,86011
170,115,55,-,310200,86015
14,14,0,-,-,86016
495,444,51,-,275000,86017
283,243,40,2083,314500,86018
584,513,71,642,62800,86020
867,353,514,1679,-,86021
694,506,188,633,116000,86022
707,122,585,404,32400,86023
418,407,11,1708,319900,86024
1851,1117,734,735,101700,86025
27,27,0,-,-,86028
21,21,0,-,-,86029
486,433,53,-,116000,86030
549,405,144,640,63000,86031
581,408,173,753,132100,86032
2270,1307,963,626,34600,86033
550,342,208,485,67300,86034
550,420,130,527,74800,86035
221,139,82,-,109800,86036
23,23,0,-,-,86038
401,360,41,879,103000,86039
3628,2491,1137,1048,87800,86040
623,294,329,845,67900,86042
635,487,148,346,100500,86043
1057,837,220,583,50400,86044
3385,2060,1325,616,43800,86045
2705,2029,676,922,238000,86046
4273,2507,1766,667,94200,86047
0,0,0,-,-,86052
671,586,85,594,50200,86053
496,371,125,533,55000,86054
10248,7218,3030,1169,300500,86301
8821,6045,2776,872,360200,86303
8515,6956,1559,875,440200,86305
0,0,0,-,-,86313
15802,10471,5331,1042,242800,86314
3376,2865,511,1914,317100,86315
1039,961,78,763,143000,86320
826,87,739,558,45000,86321
4110,3111,999,714,216500,86322
7436,6049,1387,966,257400,86323
2278,1643,635,924,277500,86324
2678,1979,699,1245,284500,86325
11153,6899,4254,927,219200,86326
4998,4496,502,1127,271000,86327
415,347,68,867,186600,86329
205,142,63,836,312100,86331
1076,904,172,826,119300,86332
2628,2068,560,697,115900,86333
1818,1260,558,855,227700,86334
2489,1582,907,952,201800,86335
5988,4569,1419,1195,490300,86336
701,540,161,559,105500,86337
214,153,61,625,559000,86338
43,25,18,-,-,86343
3453,2267,1186,1317,460900,86351
10899,7645,3254,905,166900,86401
8202,4751,3451,873,204400,86403
7499,6013,1486,875,274400,86404
11032,8557,2475,1012,293700,86406
12524,8676,3848,778,125500,86409
117,105,12,-,-,86411
5042,4473,569,723,95100,86413
6532,5285,1247,912,182200,86426
3888,2420,1468,850,261100,86429
243,168,75,518,75500,86431
1654,962,692,770,102600,86432
26,26,0,-,-,86433
588,285,303,536,65200,86434
0,0,0,-,-,86435
859,498,361,767,82700,86436
32,17,15,-,252800,86437
397,387,10,-,-,86438
3134,2292,842,691,159900,86440
992,830,162,930,82300,86441
14715,8905,5810,805,124600,86442
0,0,0,-,-,86443
768,720,48,-,101300,86444
116,116,0,-,146900,86445
390,375,15,-,45700,86502
3368,2525,843,506,32300,86503
1965,1369,596,502,45400,86504
2130,1785,345,431,33500,86505
391,366,25,375,43800,86506
582,533,49,888,49000,86507
189,184,5,-,30900,86508
1286,1073,213,494,107300,86510
1051,962,89,560,45300,86511
879,571,308,518,76500,86512
885,657,228,593,50800,86514
1185,720,465,441,52900,86515
447,376,71,680,54800,86520
385,376,9,-,34600,86535
560,394,166,429,35800,86538
279,238,41,463,65400,86540
357,304,53,669,52400,86544
349,309,40,550,43800,86545
280,260,20,-,47100,86547
507,325,182,363,43400,86556
997,716,281,716,177100,87001
8023,6083,1940,773,137200,87002
4728,3412,1316,812,166000,87004
86,65,21,-,"10,000-",87005
200,200,0,-,187500,87006
241,201,40,-,-,87007
1149,1080,69,1589,287000,87008
589,372,217,1185,290800,87010
20,20,0,-,254500,87011
145,94,51,-,320800,87012
1794,1323,471,490,89600,87013
299,257,42,-,-,87014
6066,5420,646,1046,190300,87015
1365,1124,241,638,142000,87016
109,105,4,-,182600,87017
136,80,56,-,-,87018
3779,2355,1424,708,113200,87020
1123,763,360,723,47100,87021
314,307,7,-,-,87022
215,215,0,-,145100,87023
567,432,135,638,109000,87024
713,675,38,-,354700,87025
1081,871,210,396,82200,87026
122,73,49,-,111600,87027
100,100,0,-,212000,87028
147,140,7,-,202900,87029
14578,11770,2808,962,151000,87031
93,54,39,-,-,87032
515,440,75,620,86400,87034
2485,2064,421,673,107700,87035
643,556,87,676,89800,87036
267,231,36,613,45600,87037
128,84,44,214,52500,87038
114,114,0,-,-,87040
351,280,71,718,143400,87041
1433,1233,200,541,195900,87042
2210,1947,263,1151,392700,87043
77,77,0,-,263800,87044
473,437,36,533,28200,87045
80,73,7,-,205000,87046
1837,1641,196,1184,308200,87047
3869,3559,310,1146,435100,87048
386,366,20,667,71000,87049
308,308,0,-,100200,87051
575,439,136,636,121200,87052
388,270,118,825,161300,87053
344,307,37,737,286600,87056
4117,3767,350,-,265900,87059
171,171,0,-,-,87061
431,377,54,736,60400,87062
106,59,47,617,81600,87063
78,78,0,-,-,87064
1965,1830,135,938,216100,87068
20,0,20,-,-,87070
178,152,26,536,162500,87072
252,227,25,1250,153100,87083
9451,3347,6104,735,126500,87102
5801,3648,2153,868,250900,87104
19317,14319,4998,746,147000,87105
11480,4865,6615,768,262500,87106
12657,8074,4583,738,224600,87107
16796,6061,10735,686,168600,87108
18211,9321,8890,890,233700,87109
18064,10960,7104,883,199500,87110
25443,15650,9793,1023,276300,87111
17893,10695,7198,872,189900,87112
5910,4437,1473,1269,276700,87113
25903,17607,8296,1133,222200,87114
1385,44,1341,1375,-,87116
0,0,0,-,-,87117
25274,19201,6073,1177,211700,87120
24950,18128,6822,1052,140400,87121
7045,6233,812,1374,495000,87122
17889,11693,6196,791,184800,87123
20970,16240,4730,1080,192300,87124
15096,12425,2671,1290,207300,87144
8043,4202,3841,691,123300,87301
830,765,65,-,44800,87305
285,264,21,-,67900,87310
1123,925,198,764,33500,87311
146,111,35,-,20200,87312
1868,1026,842,555,79100,87313
45,35,10,-,-,87315
421,199,222,924,53400,87316
479,404,75,-,67500,87317
537,513,24,-,37400,87319
132,117,15,-,43900,87320
853,629,224,1031,100500,87321
57,57,0,-,183200,87322
1412,1181,231,743,71600,87323
1003,872,131,603,56500,87325
511,481,30,-,49200,87326
1851,1565,286,562,66100,87327
808,304,504,534,52200,87328
84,66,18,-,154900,87347
230,110,120,518,-,87357
342,312,30,-,42800,87364
940,888,52,425,45600,87375
15885,9861,6024,865,176300,87401
3593,2769,824,1027,216300,87402
6500,4802,1698,812,168800,87410
500,460,40,-,121800,87412
5586,4283,1303,742,151000,87413
975,797,178,1338,164700,87415
1531,1241,290,808,80900,87416
1706,1090,616,759,151900,87417
341,315,26,596,170900,87418
182,141,41,-,95500,87419
3602,2332,1270,572,74900,87420
516,405,111,950,104100,87421
553,459,94,564,29800,87455
431,414,17,-,43100,87461
167,135,32,-,-,87499
7805,5141,2664,1359,482200,87501
14716,9020,5696,1094,351300,87505
5935,4916,1019,928,347000,87506
18550,12508,6042,1061,238300,87507
6988,6268,720,1321,372900,87508
448,278,170,-,163700,87510
588,423,165,1027,140300,87511
35,35,0,-,-,87512
440,322,118,1076,415500,87513
351,351,0,-,227800,87514
64,64,0,-,-,87515
41,41,0,-,157800,87516
185,155,30,-,259600,87517
0,0,0,-,-,87518
239,152,87,-,162900,87519
504,452,52,707,194200,87520
328,258,70,772,155300,87521
1152,1008,144,-,174100,87522
243,222,21,-,-,87523
34,34,0,-,-,87524
17,17,0,-,608300,87525
213,213,0,-,163800,87527
740,443,297,518,66800,87528
1599,1356,243,1033,265800,87529
271,271,0,-,264900,87530
164,164,0,-,175000,87531
6897,4758,2139,702,185900,87532
75,44,31,389,18800,87533
933,714,219,1417,297700,87535
1048,715,333,619,158100,87537
224,159,65,-,159600,87538
21,21,0,-,-,87539
506,327,179,-,470400,87540
44,44,0,-,-,87543
7895,5775,2120,1071,322200,87544
447,336,111,-,113900,87548
487,469,18,-,156300,87549
106,106,0,-,293800,87551
1148,885,263,678,120300,87552
523,377,146,713,145800,87553
0,0,0,-,-,87554
826,690,136,696,148400,87556
1943,1589,354,936,300100,87557
375,214,161,849,413600,87558
664,479,185,565,86200,87560
138,120,18,-,-,87562
90,90,0,-,-,87564
153,153,0,-,-,87565
713,645,68,700,373400,87566
392,191,201,842,-,87567
299,262,37,-,163900,87569
4869,3381,1488,745,305800,87571
11,11,0,-,-,87573
40,34,6,-,-,87574
345,205,140,-,270800,87575
155,155,0,-,-,87577
123,88,35,1063,162100,87578
328,281,47,1000,133600,87579
226,198,28,-,229400,87580
14,14,0,-,-,87581
293,251,42,-,-,87582
206,150,56,-,-,87583
7884,4998,2886,650,140500,87701
675,526,149,830,247100,87710
297,247,50,-,-,87711
244,207,37,-,"10,000-",87712
177,154,23,-,-,87713
579,284,295,500,122100,87714
251,224,27,-,164000,87715
174,113,61,879,155100,87718
251,236,15,-,-,87722
120,120,0,-,102600,87723
29,0,29,-,-,87724
197,124,73,520,72500,87728
49,49,0,-,625000,87729
6,3,3,-,-,87730
127,113,14,-,239800,87731
677,626,51,772,89400,87732
26,17,9,-,102100,87733
107,93,14,-,284900,87734
77,61,16,-,-,87735
16,16,0,-,-,87736
3558,2430,1128,694,96000,87740
185,185,0,-,242200,87742
107,56,51,817,73300,87743
398,382,16,-,155400,87745
43,7,36,-,-,87746
611,449,162,483,85800,87747
89,42,47,-,-,87749
0,0,0,-,-,87750
297,239,58,491,103800,87752
44,20,24,-,-,87753
3159,2141,1018,686,136500,87801
44,44,0,-,111100,87820
327,323,4,-,252700,87821
209,209,0,-,200600,87823
32,32,0,-,-,87824
711,629,82,-,81000,87825
131,64,67,-,165300,87827
120,110,10,-,157800,87828
316,283,33,-,175700,87829
373,298,75,633,124800,87830
62,57,5,-,-,87831
83,83,0,-,61900,87832
3046,2081,965,508,88300,87901
340,268,72,574,204500,87930
438,304,134,753,136600,87931
51,51,0,-,-,87933
802,656,146,943,129300,87935
249,232,17,-,115700,87936
1005,836,169,468,111000,87937
50,50,0,-,328600,87939
135,87,48,-,-,87940
294,198,96,-,-,87941
313,239,74,680,103500,87942
81,81,0,-,60300,87943
14675,6447,8228,709,114300,88001
319,20,299,1273,-,88002
0,0,0,-,-,88003
0,0,0,-,-,88004
10556,6312,4244,751,166200,88005
8618,6494,2124,742,189200,88007
3819,2914,905,868,192400,88008
6,0,6,-,-,88009
12633,7552,5081,940,258000,88011
10310,8046,2264,1036,147800,88012
314,248,66,560,99200,88020
6083,4209,1874,587,107500,88021
300,212,88,656,123400,88022
1057,672,385,576,88000,88023
14,14,0,-,-,88024
72,72,0,-,163200,88025
547,380,167,631,84100,88026
139,130,9,-,253000,88027
126,91,35,-,218800,88028
411,279,132,337,70200,88029
8500,5272,3228,555,86700,88030
126,76,50,-,57900,88032
0,0,0,-,-,88033
8,8,0,-,-,88034
86,54,32,-,315600,88038
309,294,15,-,115900,88039
34,26,8,-,58200,88040
551,474,77,-,113200,88041
225,200,25,-,254500,88042
624,496,128,877,77000,88043
1138,1015,123,741,108400,88044
1306,869,437,535,87000,88045
449,297,152,791,197700,88046
659,550,109,1102,127300,88047
1035,926,109,-,85900,88048
180,123,57,-,214400,88049
69,39,30,-,99300,88051
99,77,22,-,105900,88052
47,14,33,-,-,88053
14,14,0,-,-,88055
108,92,16,-,117900,88056
7643,4855,2788,711,164300,88061
4167,2977,1190,484,106800,88063
146,108,38,-,129100,88065
612,395,217,406,106300,88072
4121,2879,1242,724,83100,88081
17286,9492,7794,894,134800,88101
0,0,0,-,-,88103
122,106,16,-,-,88112
48,17,31,-,-,88113
25,25,0,-,252500,88114
32,27,5,-,-,88115
150,121,29,-,101800,88116
111,77,34,398,201400,88118
515,314,201,616,150000,88119
195,112,83,-,114700,88120
74,59,15,466,152500,88121
461,398,63,736,131300,88124
24,10,14,-,-,88125
8,8,0,-,-,88126
6296,3626,2670,757,111600,88130
85,61,24,-,113800,88132
23,14,9,-,-,88134
604,425,179,979,95400,88135
16,16,0,-,275000,88136
10150,7333,2817,882,169200,88201
10860,6867,3993,777,94100,88203
6718,4242,2476,857,181400,88210
13996,10265,3731,1038,154900,88220
1677,1261,416,786,86300,88230
1184,955,229,1094,113200,88231
628,499,129,660,108500,88232
13409,8261,5148,922,140300,88240
2373,1848,525,981,199400,88242
98,35,63,-,-,88250
740,567,173,724,79500,88252
282,188,94,853,108900,88253
39,30,9,-,-,88254
11,11,0,-,-,88255
629,432,197,930,137200,88256
4564,3455,1109,810,128000,88260
4,4,0,-,-,88262
51,40,11,-,83800,88263
0,0,0,-,-,88264
68,68,0,-,151100,88265
501,372,129,765,74000,88267
0,0,0,-,-,88268
494,447,47,625,80200,88301
14570,9225,5345,779,131700,88310
454,391,63,573,100900,88311
1237,1138,99,-,282800,88312
45,45,0,-,-,88314
955,800,155,793,159500,88316
834,710,124,692,170400,88317
162,131,31,-,187500,88318
69,50,19,-,55000,88321
0,0,0,-,-,88323
98,98,0,-,166200,88324
411,348,63,-,216500,88325
1107,0,1107,1113,-,88330
169,137,32,-,-,88336
829,719,110,574,110200,88337
73,26,47,-,-,88338
238,206,32,-,208300,88339
1112,668,444,248,39300,88340
282,272,10,-,223600,88341
5,0,5,-,-,88342
13,13,0,-,-,88343
25,25,0,-,117400,88344
3701,2589,1112,722,208800,88345
992,554,438,534,101000,88346
32,18,14,-,-,88347
201,123,78,-,-,88348
0,0,0,-,-,88349
108,108,0,-,109400,88350
105,82,23,-,273800,88351
1559,1409,150,795,125200,88352
130,69,61,392,49000,88353
50,50,0,-,-,88354
0,0,0,-,-,88355
2389,1549,840,593,57000,88401
65,65,0,-,-,88410
33,23,10,-,232700,88411
13,7,6,-,-,88414
1142,691,451,505,88100,88415
100,100,0,-,32800,88416
0,0,0,-,-,88417
77,46,31,-,-,88418
50,40,10,-,267400,88419
7,7,0,-,-,88421
33,14,19,-,-,88422
18,17,1,-,-,88424
451,391,60,688,78300,88426
54,43,11,-,-,88427
41,36,5,-,-,88430
8,8,0,-,-,88431
144,101,43,522,89600,88434
1053,758,295,395,101100,88435
27,18,9,-,-,88436
482,332,150,636,120800,89001
12865,10099,2766,1367,313500,89002
552,217,335,656,-,89003
108,48,60,1320,400000,89004
6556,4631,1925,1071,304600,89005
302,226,76,-,261100,89007
638,412,226,599,105900,89008
185,126,59,468,118900,89010
11491,7579,3912,1259,304000,89011
15336,9623,5713,1471,354200,89012
129,97,32,495,67500,89013
16889,8480,8409,1235,303500,89014
14943,9177,5766,1082,260100,89015
10,10,0,-,-,89017
305,207,98,831,149500,89018
1114,847,267,551,197200,89019
496,272,224,527,115900,89020
979,794,185,1010,297100,89021
0,0,0,-,-,89022
369,242,127,669,200000,89025
0,0,0,-,-,89026
8182,6224,1958,930,257100,89027
4438,2157,2281,774,171600,89029
14464,5359,9105,880,160000,89030
21618,15649,5969,1437,257000,89031
14323,8452,5871,1296,246700,89032
135,108,27,679,73500,89039
1532,1142,390,821,149000,89040
384,297,87,-,169000,89042
489,402,87,627,158900,89043
9846,8311,1535,1788,380700,89044
886,622,264,911,66000,89045
241,146,95,-,97900,89046
82,37,45,420,35600,89047
8973,6400,2573,925,188400,89048
1363,366,997,714,93900,89049
22433,14481,7952,1493,423900,89052
29,29,0,-,171300,89054
4348,3518,830,777,153300,89060
2527,2221,306,1180,221600,89061
20356,11951,8405,1410,326600,89074
11635,7302,4333,1413,272500,89081
9386,6194,3192,1504,323600,89084
1414,1091,323,1862,342200,89085
2181,858,1323,1286,287800,89086
15693,2861,12832,757,166200,89101
15576,4088,11488,916,250500,89102
22864,7237,15627,1017,179300,89103
14846,6621,8225,888,199300,89104
9081,2748,6333,959,173000,89106
13299,6711,6588,1034,202300,89107
26913,12364,14549,1096,208500,89108
4133,1170,2963,955,412700,89109
21651,11488,10163,1062,212900,89110
13130,7444,5686,1357,346400,89113
19252,6712,12540,1009,169600,89115
23404,11143,12261,1237,362700,89117
8599,3684,4915,1229,288300,89118
22347,4263,18084,933,207100,89119
9357,5098,4259,1105,265400,89120
24228,11386,12842,981,195100,89121
18488,10629,7859,1104,193800,89122
24011,13186,10825,1350,311900,89123
580,539,41,1045,509900,89124
15063,7593,7470,1260,267000,89128
20822,13992,6830,1372,304100,89129
12682,9078,3604,1379,286100,89130
17289,13078,4211,1521,366700,89131
11665,9510,2155,1675,335700,89134
12393,8682,3711,1949,453600,89135
6531,4845,1686,1890,552000,89138
13187,8039,5148,1584,321000,89139
11968,8608,3360,1645,363400,89141
10308,6069,4239,1150,210500,89142
3926,3010,916,1516,309300,89143
7718,4719,2999,1560,362200,89144
10187,6449,3738,1257,258500,89145
7356,3285,4071,1129,313700,89146
20918,10837,10081,1345,270900,89147
20184,11015,9169,1511,326400,89148
16322,10304,6018,1377,344000,89149
9708,5428,4280,1043,181300,89156
110,110,0,-,360800,89161
7823,5912,1911,1583,329900,89166
9734,1928,7806,904,199700,89169
14778,10763,4015,1566,332200,89178
2614,2282,332,1665,322700,89179
14861,6971,7890,1398,274800,89183
0,0,0,-,-,89191
2928,2054,874,761,170100,89301
137,92,45,-,150000,89310
87,53,34,-,-,89311
128,62,66,417,36000,89314
364,215,149,-,222100,89316
125,125,0,-,197600,89317
461,343,118,1272,82800,89318
135,135,0,-,64600,89319
8,8,0,-,-,89402
6066,4727,1339,1053,270100,89403
0,0,0,-,-,89404
32,0,32,-,-,89405
9949,6814,3135,888,199100,89406
7535,5124,2411,1204,255000,89408
53,53,0,-,35600,89409
4829,3281,1548,1022,409300,89410
391,374,17,-,878100,89411
26,26,0,-,-,89412
370,319,51,3182,"2,000,000+",89413
39,39,0,-,82500,89414
1414,1043,371,655,121200,89415
86,86,0,-,45000,89418
1545,918,627,578,113100,89419
10,0,10,-,-,89420
221,201,20,-,61600,89421
119,113,6,-,-,89422
4668,3938,730,1529,462700,89423
103,88,15,1292,80700,89424
160,124,36,-,216700,89425
114,77,37,-,110200,89426
381,250,131,377,58900,89427
70,46,24,-,311100,89428
3227,2654,573,1077,165600,89429
86,69,17,-,342500,89430
15322,6693,8629,968,238200,89431
6875,4615,2260,998,191800,89433
10651,6626,4025,1403,298400,89434
16513,12064,4449,1676,376000,89436
39,39,0,-,-,89438
633,479,154,890,479900,89439
274,255,19,-,356300,89440
4644,3899,745,1655,442900,89441
426,298,128,592,110200,89442
1544,1306,238,1069,302500,89444
6398,4409,1989,818,190900,89445
0,0,0,-,-,89446
3632,2402,1230,674,164500,89447
827,670,157,1469,813800,89448
1416,771,645,1178,632400,89449
9,9,0,-,-,89450
4015,2922,1093,1542,922200,89451
5525,4059,1466,1055,366500,89460
2776,639,2137,845,373000,89501
18616,6279,12337,962,275000,89502
12469,5174,7295,1034,323200,89503
14745,9953,4792,1204,278000,89506
4764,4361,403,1393,309000,89508
17073,9060,8013,1073,459200,89509
664,605,59,508,364400,89510
11651,8246,3405,1428,678500,89511
11193,3120,8073,861,237100,89512
3684,2984,700,1642,639200,89519
13512,10039,3473,1623,432100,89521
14986,8986,6000,1383,401200,89523
10523,5886,4637,955,289400,89701
0,0,0,-,-,89702
4727,3354,1373,834,427900,89703
1877,1691,186,1350,392300,89704
2310,1692,618,1243,324500,89705
8235,4475,3760,1079,233700,89706
9619,6203,3416,1051,217900,89801
4778,4320,458,1385,253300,89815
2208,1684,524,839,167700,89820
242,222,20,1083,57200,89821
705,495,210,904,158800,89822
157,157,0,-,438200,89823
409,115,294,507,-,89825
0,0,0,-,-,89826
104,92,12,-,-,89828
64,29,35,-,-,89830
11,11,0,-,-,89831
432,222,210,428,51500,89832
58,14,44,-,-,89833
54,22,32,-,-,89834
500,383,117,731,215400,89835
1746,840,906,654,176900,89883
13689,4875,8814,1192,391800,90001
12961,4898,8063,1246,378000,90002
17542,4717,12825,1252,394200,90003
22528,3781,18747,1400,1144500,90004
16331,1341,14990,1305,889600,90005
19149,1777,17372,1153,672700,90006
12248,1550,10698,1201,671100,90007
14784,5130,9654,1245,724600,90008
2282,352,1930,2089,868600,90010
24827,6904,17923,1228,418300,90011
13558,915,12643,1706,568100,90012
7810,600,7210,712,652900,90013
5968,119,5849,1634,581400,90014
11180,1014,10166,1832,705900,90015
17522,6180,11342,1379,621500,90016
11938,630,11308,1133,662500,90017
16634,5106,11528,1271,648500,90018
24252,6441,17811,1474,1002800,90019
17064,1599,15465,1428,661200,90020
1778,133,1645,740,889700,90021
17439,5847,11592,1144,444100,90022
11573,3029,8544,1190,449000,90023
17092,5549,11543,2323,1182000,90024
22194,5875,16319,2163,886300,90025
26807,6392,20415,1407,899100,90026
21403,4189,17214,1553,1241400,90027
17114,829,16285,1503,807500,90028
13627,1442,12185,1259,829300,90029
12005,3990,8015,1210,579700,90031
13825,7290,6535,1227,556100,90032
13396,2724,10672,1140,483700,90033
26196,5272,20924,1811,1068500,90034
12049,4019,8030,2016,1319200,90035
18761,3294,15467,2293,1585800,90036
17763,4419,13344,1151,455900,90037
12648,1034,11614,1424,903500,90038
12277,5198,7079,1752,899000,90039
3454,1907,1547,1121,424500,90040
10251,5224,5027,1492,841500,90041
21077,9719,11358,1414,673700,90042
17740,9600,8140,1199,621900,90043
28368,8220,20148,1163,434100,90044
15469,7993,7476,2301,1061200,90045
28544,6400,22144,1770,1193400,90046
17197,9505,7692,1277,473300,90047
11906,3485,8421,2094,1401900,90048
16375,8724,7651,2360,"2,000,000+",90049
3552,2336,1216,1887,1058500,90056
17555,567,16988,1150,528500,90057
792,75,717,775,325600,90058
10453,4969,5484,1029,379800,90059
7527,3156,4371,1206,405300,90061
10112,4888,5224,1289,496500,90062
13873,5432,8441,1186,452100,90063
11272,6107,5165,2148,1299400,90064
16244,7557,8687,1435,785800,90065
26696,9723,16973,1916,1171600,90066
1501,1082,419,3245,1343800,90067
11723,5666,6057,1816,1409000,90068
12570,4993,7577,1926,854400,90069
125,14,111,1668,-,90071
0,0,0,-,-,90073
3008,2590,418,2473,"2,000,000+",90077
0,0,0,-,-,90079
9,0,9,-,-,90089
0,0,0,-,-,90090
4026,1920,2106,3159,1092300,90094
0,0,0,-,-,90095
24232,5752,18480,1287,425900,90201
7752,6040,1712,2723,"2,000,000+",90210
3912,1349,2563,2182,"2,000,000+",90211
5728,1459,4269,2228,"2,000,000+",90212
13336,8298,5038,1200,358700,90220
12074,6283,5791,1293,381300,90221
8439,4349,4090,1234,384900,90222
13670,7619,6051,1928,812800,90230
6773,2574,4199,1943,1151400,90232
7607,4688,2919,1639,623100,90240
13304,5446,7858,1519,599200,90241
12522,6257,6265,1593,527600,90242
6645,2844,3801,2022,1180000,90245
15851,6373,9478,1372,498700,90247
3909,2649,1260,1256,539200,90248
8731,5100,3631,1247,537700,90249
30841,9874,20967,1340,609900,90250
8596,4309,4287,2246,1649900,90254
18523,6097,12426,1152,428700,90255
10499,4611,5888,1583,575500,90260
15254,7311,7943,1261,422200,90262
0,0,0,-,-,90263
7028,5603,1425,2805,"2,000,000+",90265
13313,9007,4306,2582,"2,000,000+",90266
6753,1871,4882,1153,427300,90270
8517,6873,1644,2743,"2,000,000+",90272
8893,7908,985,2784,1689100,90274
15223,11813,3410,2841,1208200,90275
15650,7301,8349,2185,1125800,90277
15183,8999,6184,2074,926500,90278
23989,10599,13390,1211,438100,90280
2002,1418,584,"3,500+",1070800,90290
14420,5255,9165,2135,1793300,90291
12817,3706,9111,3037,1053700,90292
6685,3264,3421,2312,837200,90293
12254,3091,9163,1354,491000,90301
10536,3398,7138,1430,531700,90302
7027,2700,4327,1456,564000,90303
7106,2059,5047,1190,537400,90304
5927,3743,2184,1666,598900,90305
4548,234,4314,2010,1227300,90401
4683,3211,1472,1984,"2,000,000+",90402
12901,3140,9761,2064,1441800,90403
10359,2215,8144,1755,886000,90404
14074,4586,9488,1808,1474000,90405
14140,6279,7861,1491,679200,90501
6438,4401,2037,1540,490900,90502
16577,8640,7937,1865,820600,90503
11413,7001,4412,1781,663000,90504
13838,7660,6178,1853,882600,90505
0,0,0,-,-,90506
10836,6333,4503,1414,590700,90601
7659,3042,4617,1346,567300,90602
6325,5267,1058,1938,620900,90603
11939,7689,4250,1529,561200,90604
10813,7319,3494,1534,499100,90605
8861,6100,2761,1498,469800,90606
12843,9341,3502,1892,607500,90620
10224,3808,6416,1652,617100,90621
4925,3196,1729,1854,688000,90623
15933,11010,4923,1969,664700,90630
21548,13091,8457,1649,607300,90631
14903,11505,3398,1583,606400,90638
18937,8409,10528,1442,520200,90640
26748,17680,9068,1678,461000,90650
17060,11977,5083,1393,464700,90660
4893,3294,1599,1499,463700,90670
9577,4648,4929,1689,445400,90680
4503,2384,2119,1747,601100,90701
15496,11742,3754,2433,714600,90703
1716,548,1168,1635,701800,90704
22998,8782,14216,1432,483100,90706
9439,5132,4307,1238,511100,90710
10114,7597,2517,2091,603100,90712
8996,7621,1375,2073,608800,90713
6227,3519,2708,1722,522200,90715
3673,1629,2044,1479,430000,90716
8205,3673,4532,1422,619500,90717
8029,5348,2681,2040,925800,90720
14156,5963,8193,1462,388300,90723
22843,7598,15245,1366,618000,90731
9064,6597,2467,2097,630700,90732
12503,9493,3010,2056,410700,90740
357,137,220,1914,1135400,90742
120,81,39,-,"2,000,000+",90743
14938,5277,9661,1171,428400,90744
14495,10005,4490,1517,476500,90745
8342,6911,1431,1889,548700,90746
0,0,0,-,-,90747
4514,2232,2282,1600,530200,90755
20841,4148,16693,1404,438700,90802
16858,7269,9589,1723,928400,90803
15027,3041,11986,1410,516800,90804
27280,11453,15827,1264,439200,90805
12335,4483,7852,1246,522300,90806
12697,6556,6141,1488,622500,90807
13992,11245,2747,1972,667800,90808
9571,5262,4309,1211,439200,90810
17167,2243,14924,1198,411800,90813
8646,3088,5558,1566,723400,90814
14519,9856,4663,2030,668100,90815
0,0,0,-,-,90822
0,0,0,-,-,90831
12460,9463,2997,1808,812400,91001
10433,7343,3090,1685,1054600,91006
11763,6427,5336,1731,1043800,91007
444,263,181,"3,500+",1505700,91008
7963,5075,2888,1644,502600,91010
6329,5581,748,3186,1642900,91011
14593,7214,7379,1682,676000,91016
3514,1068,2446,1740,678100,91020
4679,2733,1946,1722,1007800,91024
9671,4738,4933,1830,1113100,91030
7482,5625,1857,1282,601500,91040
10079,5470,4609,1449,587200,91042
106,0,106,1373,-,91046
11463,1898,9565,1892,581900,91101
8485,3978,4507,1561,740500,91103
13630,6830,6800,1608,779100,91104
5410,3016,2394,2518,1217700,91105
10657,3685,6972,1774,804800,91106
12971,7757,5214,1820,871800,91107
4108,3483,625,"3,500+","2,000,000+",91108
8238,2395,5843,1695,824300,91201
9359,4029,5330,1855,870200,91202
6223,1144,5079,1754,554400,91203
6743,560,6183,1592,488000,91204
14052,2217,11835,1580,652600,91205
13050,4655,8395,1729,865200,91206
4151,2318,1833,1832,1056900,91207
5908,3760,2148,1919,979100,91208
160,32,128,2717,480000,91210
10575,7795,2780,2010,800300,91214
9116,7302,1814,2712,847600,91301
9949,7137,2812,2454,1322800,91302
10326,2470,7856,1622,498600,91303
18105,9059,9046,1576,641500,91304
14652,8139,6513,1509,566800,91306
8595,7300,1295,3211,679000,91307
14281,9104,5177,1924,644600,91311
12815,6289,6526,1823,706200,91316
14893,11305,3588,2341,724700,91320
10804,6307,4497,1707,509600,91321
10348,4938,5410,1887,646000,91324
12372,5756,6616,1640,692900,91325
12498,9302,3196,2013,800200,91326
0,0,0,-,-,91330
23398,14565,8833,1400,454500,91331
24581,12011,12570,1520,548400,91335
9015,5443,3572,1429,467000,91340
24833,16472,8361,1669,481400,91342
17977,9061,8916,1445,576100,91343
17915,13188,4727,1891,651300,91344
5557,4024,1533,1610,506900,91345
11811,9773,2038,2199,567800,91350
9613,7053,2560,1779,449500,91351
12335,6528,5807,1463,532300,91352
10357,8014,2343,2450,623300,91354
11312,6717,4595,2144,582600,91355
11982,6987,4995,1606,994900,91356
15290,10158,5132,1987,690300,91360
8211,5810,2401,2382,979500,91361
13813,9727,4086,2296,841100,91362
10453,6938,3515,2516,898500,91364
17961,9475,8486,2280,731700,91367
0,0,0,-,-,91371
5033,3487,1546,2618,806700,91377
6624,4321,2303,2176,794400,91381
7019,5961,1058,1754,554900,91384
12554,7827,4727,2046,565300,91387
6110,5312,798,2094,611700,91390
14772,5149,9623,1497,757100,91401
20340,7022,13318,1337,446500,91402
11803,5245,6558,1987,1111300,91403
18558,5112,13446,1378,549800,91405
18685,7217,11468,1559,575800,91406
9559,2506,7053,1542,711500,91411
15341,5836,9505,1884,983200,91423
5878,4603,1275,2732,1423300,91436
7736,2613,5123,1742,853100,91501
5181,566,4615,1585,713900,91502
9747,5160,4587,1814,778400,91504
12533,6056,6477,1953,745800,91505
7544,4283,3261,1572,792900,91506
17004,2675,14329,1668,710500,91601
10146,3539,6607,1828,773300,91602
15167,7003,8164,2038,1199500,91604
16101,6224,9877,1432,561500,91605
15548,5174,10374,1375,609700,91606
13631,4429,9202,1679,851700,91607
9,0,9,-,-,91608
13347,10635,2712,1820,551500,91701
15994,9358,6636,1557,439900,91702
18032,10432,7600,1518,437600,91706
1287,229,1058,1881,612600,91708
25874,18891,6983,2226,642500,91709
23292,15012,8280,1662,476900,91710
12211,8109,4102,1609,690300,91711
10019,6963,3056,1612,478900,91722
5802,2198,3604,1517,549600,91723
8448,6016,2432,1676,584200,91724
24954,11771,13183,1816,427400,91730
8122,3015,5107,1284,475800,91731
15466,7022,8444,1392,486000,91732
10868,5176,5692,1372,457100,91733
7795,5512,2283,2046,645300,91737
11421,8048,3373,1909,618600,91739
8199,5599,2600,1744,555000,91740
8688,6334,2354,1823,737400,91741
18821,12694,6127,1478,445800,91744
16467,12739,3728,1873,622500,91745
6819,5147,1672,1428,460500,91746
13910,9080,4830,1605,647100,91748
12381,9071,3310,1646,606700,91750
8773,5442,3331,1586,491900,91752
11552,6169,5383,1465,655700,91754
8669,4082,4587,1549,622300,91755
175,131,44,1447,411400,91759
17345,11167,6178,1635,423200,91761
17853,9558,8295,1400,406600,91762
10451,5582,4869,1480,391100,91763
16350,7441,8909,1618,383700,91764
14874,11360,3514,2063,695900,91765
18576,9815,8761,1427,426300,91766
14474,7647,6827,1409,424300,91767
8274,4618,3656,1356,402600,91768
16887,8819,8068,1421,570800,91770
11358,7826,3532,1821,602000,91773
8059,5264,2795,1698,851700,91775
11626,4609,7017,1496,641700,91776
11184,6683,4501,1681,720100,91780
8904,7603,1301,2358,644400,91784
18826,7867,10959,1514,459100,91786
13305,10907,2398,2368,766400,91789
12160,7949,4211,1775,565100,91790
10372,6781,3591,1632,631200,91791
8832,5034,3798,1800,525700,91792
20142,7151,12991,1537,634000,91801
10106,4930,5176,1423,625700,91803
6150,4522,1628,1686,612300,91901
6045,4741,1304,1861,697500,91902
645,438,207,724,238500,91905
1282,957,325,1134,285000,91906
24599,12577,12022,1547,507600,91910
25145,12881,12264,1631,457200,91911
14899,10997,3902,2436,536400,91913
4546,3541,1005,2725,700800,91914
9062,6495,2567,2438,586300,91915
617,562,55,1803,454900,91916
231,204,27,-,550700,91917
236,198,38,-,-,91931
9361,3021,6340,1487,593400,91932
241,154,87,-,262500,91934
2939,2588,351,1750,660900,91935
11995,7718,4277,1620,652500,91941
16463,6638,9825,1616,526500,91942
8659,4524,4135,1395,456400,91945
34,34,0,-,-,91948
17392,5908,11484,1248,427400,91950
937,815,122,1852,425100,91962
127,80,47,-,351000,91963
19098,11848,7250,1538,467100,91977
3387,2175,1212,1862,415400,91978
0,0,0,-,-,91980
1849,1168,681,1832,679300,92003
1101,945,156,475,221000,92004
4522,2613,1909,2240,1123700,92007
11340,5394,5946,1901,830700,92008
16258,11528,4730,2228,910000,92009
6064,4050,2014,2047,730500,92010
9445,5988,3457,2359,881900,92011
5634,3870,1764,2661,1686000,92014
14727,10082,4645,1768,546800,92019
19032,8053,10979,1398,551400,92020
22714,11662,11052,1428,440600,92021
19371,12628,6743,2084,977600,92024
16325,6887,9438,1475,521900,92025
17645,10370,7275,1634,497700,92026
17070,10515,6555,1495,472500,92027
15764,10918,4846,1335,596100,92028
7332,5415,1917,1969,669300,92029
1247,1053,194,1137,389500,92036
16657,10324,6333,2081,1578200,92037
15022,9949,5073,1487,503300,92040
15573,6192,9381,1601,635200,92054
254,0,254,2884,-,92055
19161,12305,6856,2005,552000,92056
18799,12535,6264,2010,495900,92057
14277,3888,10389,2126,467600,92058
564,418,146,1296,343900,92059
119,61,58,-,"2,000,000+",92060
702,502,200,1154,545000,92061
16032,12647,3385,1628,716800,92064
11941,8780,3161,1647,562000,92065
165,99,66,-,362500,92066
2867,2530,337,3155,"2,000,000+",92067
14535,8121,6414,1706,551000,92069
330,231,99,481,335700,92070
19360,13850,5510,1765,478900,92071
5152,3284,1868,2359,1338700,92075
17528,12347,5181,1985,614500,92078
10654,5535,5119,1926,572900,92081
6023,5109,914,1414,586400,92082
11550,5479,6071,1666,443800,92083
14603,8646,5957,1574,575600,92084
532,451,81,1110,189800,92086
580,522,58,2962,972600,92091
24984,6629,18355,1797,618000,92101
15049,4857,10192,1453,454500,92102
18397,6111,12286,1605,817300,92103
21873,5944,15929,1520,627800,92104
23130,7106,16024,1273,443100,92105
7565,4563,3002,1912,1039300,92106
13970,5264,8706,1729,924100,92107
10832,2634,8198,2141,405100,92108
21893,6822,15071,1853,919700,92109
11462,4551,6911,1825,627900,92110
17174,8453,8721,1686,568300,92111
13670,3546,10124,1277,388100,92113
18276,12974,5302,1531,439500,92114
21208,7681,13527,1474,551000,92115
16260,5406,10854,1516,655900,92116
21213,12016,9197,1821,640100,92117
8672,4643,4029,2621,1656800,92118
9339,7100,2239,1800,602300,92119
11665,7866,3799,1945,623200,92120
1850,1066,784,2068,802400,92121
19417,6448,12969,2191,751700,92122
12585,6155,6430,2226,580000,92123
11274,5164,6110,2500,662100,92124
25215,13574,11641,2144,571900,92126
15300,10443,4857,1990,869500,92127
21109,13162,7947,2242,645700,92128
18664,12968,5696,2193,766700,92129
20464,13433,7031,2601,1116200,92130
12127,9488,2639,2468,831700,92131
0,0,0,-,-,92132
0,0,0,-,-,92134
0,0,0,-,-,92135
10066,5737,4329,1654,438500,92139
0,0,0,-,-,92140
519,460,59,-,1503600,92145
0,0,0,-,-,92147
22634,13973,8661,1701,449500,92154
0,0,0,-,-,92155
8160,2553,5607,1253,382800,92173
24793,16390,8403,1068,253100,92201
12002,9542,2460,1682,357800,92203
2718,2025,693,806,707500,92210
12899,9497,3402,1487,383800,92211
11988,8231,3757,1106,246500,92220
0,0,0,-,-,92222
17269,13729,3540,1275,336100,92223
5788,3486,2302,764,154900,92225
7325,3927,3398,838,217500,92227
784,506,278,1043,192900,92230
9362,4967,4395,934,220000,92231
1023,657,366,742,147800,92233
19716,12146,7570,1241,302500,92234
17685,12676,5009,831,239600,92236
119,105,14,1833,112300,92239
12955,6801,6154,1063,218600,92240
3597,2949,648,829,91300,92241
617,469,148,689,80100,92242
13146,6861,6285,823,207400,92243
1935,1277,658,856,208900,92249
2180,1250,930,612,236200,92250
5271,3843,1428,1128,252000,92251
3724,2109,1615,941,159800,92252
16231,11792,4439,1420,405200,92253
3178,2364,814,610,155400,92254
1492,1103,389,874,180200,92256
610,261,349,659,64600,92257
178,96,82,621,93600,92258
77,40,37,-,-,92259
15568,9677,5891,1340,343400,92260
13877,8518,5359,1150,422300,92262
11278,7506,3772,1273,371000,92264
67,38,29,-,-,92266
26,0,26,-,-,92267
204,164,40,836,362500,92268
9637,7658,1979,1336,533700,92270
429,251,178,784,165000,92273
5694,4702,992,640,113000,92274
1162,1009,153,972,151300,92275
2822,2125,697,1175,191600,92276
9092,3378,5714,953,135800,92277
400,0,400,1297,-,92278
0,0,0,-,-,92280
668,317,351,781,150200,92281
448,338,110,1442,167800,92282
531,296,235,558,60800,92283
10494,6925,3569,999,189000,92284
1098,868,230,793,156100,92285
7990,4608,3382,1188,212200,92301
0,0,0,-,-,92304
204,128,76,1677,298600,92305
12946,8370,4576,1063,277200,92307
13753,9311,4442,1106,260500,92308
246,82,164,710,-,92309
2881,4,2877,1362,-,92310
11206,5086,6120,836,130900,92311
4380,2735,1645,1416,355400,92313
4411,2838,1573,1119,301200,92314
2132,1208,924,1039,395800,92315
7748,5188,2560,1225,316900,92316
3218,2752,466,1341,244800,92320
341,253,88,1239,320700,92321
286,286,0,-,242000,92322
18047,9863,8184,1215,302800,92324
3308,2346,962,1226,265300,92325
337,137,200,759,102000,92327
302,26,276,715,"10,000-",92328
43,3,40,-,-,92332
218,176,42,971,410000,92333
25003,12187,12816,1268,327000,92335
25768,20399,5369,1765,434200,92336
9923,7417,2506,1694,373600,92337
0,0,0,-,-,92338
551,392,159,1383,300000,92339
125,103,22,1100,262800,92341
2427,1945,482,1477,233100,92342
5607,4266,1341,1669,325200,92344
24572,15177,9395,1166,254200,92345
17282,11828,5454,1197,348700,92346
241,179,62,-,-,92347
2337,1840,497,1491,450000,92352
8202,3505,4697,1408,384700,92354
2131,1436,695,875,159300,92356
339,241,98,1341,319600,92358
3238,2139,1099,976,317400,92359
2095,1178,917,618,110700,92363
5,0,5,-,-,92364
1071,772,299,861,103500,92365
288,119,169,970,206800,92368
5436,4264,1172,1255,249500,92371
1988,1434,554,1102,279300,92372
12608,6730,5878,1521,485300,92373
13964,8168,5796,1481,374200,92374
21559,12933,8626,1277,309700,92376
5393,4612,781,1639,397400,92377
70,70,0,-,286500,92378
1749,1232,517,1297,271600,92382
16,0,16,-,-,92384
113,101,12,-,334400,92385
983,636,347,1121,277100,92386
152,126,26,-,104200,92389
962,593,369,894,262300,92391
15607,9347,6260,1495,245700,92392
8425,5267,3158,1307,241900,92394
14241,7734,6507,1152,239600,92395
2014,1620,394,1132,347100,92397
693,291,402,541,102500,92398
18759,13506,5253,1214,348700,92399
694,140,554,806,248200,92401
18056,8551,9505,1075,269700,92404
8970,3886,5084,1117,256000,92405
17076,10858,6218,1416,352500,92407
3602,1515,2087,1017,295000,92408
12661,5132,7529,988,186400,92410
6621,3559,3062,1102,219700,92411
6608,2930,3678,1320,337200,92501
24650,15923,8727,1452,391600,92503
16576,10065,6511,1437,381900,92504
14326,7358,6968,1614,378200,92505
14660,10974,3686,1560,465900,92506
16843,5678,11165,1353,369700,92507
10110,7984,2126,2108,490800,92508
18757,13298,5459,1420,369700,92509
538,15,523,1614,-,92518
15010,9642,5368,1372,347000,92530
7145,5432,1713,1821,377900,92532
982,812,170,1083,332400,92536
1476,1222,254,840,251400,92539
12546,6453,6093,1051,159200,92543
15298,10286,5012,1202,253600,92544
14828,10342,4486,1386,245400,92545
2413,1718,695,1226,154600,92548
1295,883,412,1153,374800,92549
7743,5241,2502,1555,314800,92551
18513,8952,9561,1488,296200,92553
11380,8650,2730,1873,375700,92555
14135,9378,4757,1613,345700,92557
632,531,101,1170,303300,92561
19971,13832,6139,1801,455600,92562
18869,12758,6111,1998,433100,92563
2473,1800,673,1239,368600,92567
14185,9453,4732,1183,299100,92570
13134,8966,4168,1600,312300,92571
4225,3195,1030,1823,311300,92582
9226,5819,3407,1158,235300,92583
15112,12187,2925,2033,393500,92584
6520,5469,1051,1741,362200,92585
8577,6038,2539,1229,252500,92586
5828,4418,1410,2046,426000,92587
1854,761,1093,976,1063600,92590
13081,7993,5088,1862,467100,92591
24962,18675,6287,2113,487300,92592
9721,7183,2538,1688,382500,92595
8995,7056,1939,2209,453700,92596
7878,3273,4605,2335,867300,92602
7005,4211,2794,2857,1356900,92603
9547,6093,3454,2380,793100,92604
9455,3901,5554,2364,863900,92606
5774,4067,1707,2387,793300,92610
12571,3780,8791,2381,771800,92612
10054,4058,5996,2389,752800,92614
3748,945,2803,1423,581600,92617
20645,7763,12882,2492,903300,92618
17026,10213,6813,2585,925400,92620
2575,1679,896,2213,833300,92624
5895,3917,1978,3092,"2,000,000+",92625
19114,8000,11114,2078,803000,92626
21706,8515,13191,1829,817100,92627
11595,7377,4218,2216,945600,92629
21003,14531,6472,2051,649200,92630
10990,7697,3293,1809,310000,92637
21789,16469,5320,2159,777300,92646
21520,9607,11913,1956,737800,92647
19407,9446,9961,1874,949000,92648
14560,8325,6235,2036,854500,92649
10455,6736,3719,2412,1945000,92651
10475,7444,3031,2181,756900,92653
2514,699,1815,1330,571600,92655
19235,11180,8055,2318,650400,92656
3689,2960,729,2660,"2,000,000+",92657
15368,7982,7386,2628,1705100,92660
1827,720,1107,2282,"2,000,000+",92661
1297,767,530,2141,"2,000,000+",92662
10574,4661,5913,2048,1532200,92663
14480,7702,6778,1855,940300,92672
9959,8299,1660,2399,925500,92673
13592,10042,3550,2156,766100,92675
755,640,115,1762,721100,92676
25108,17048,8060,2326,863600,92677
214,189,25,3054,739000,92678
11008,9774,1234,2353,925100,92679
27169,14509,12660,1685,624400,92683
15593,10697,4896,2165,638000,92688
16703,12323,4380,2240,702900,92691
17061,13383,3678,2334,768200,92692
8334,6571,1763,2829,843900,92694
13320,3816,9504,1347,476000,92701
13708,6677,7031,1633,456200,92703
20324,10510,9814,1753,511900,92704
15042,9652,5390,1811,876700,92705
10178,5822,4356,1476,642100,92706
14597,7498,7099,1782,502100,92707
18567,12402,6165,2082,776700,92708
18873,8914,9959,1761,635800,92780
8129,5072,3057,2452,824700,92782
18240,6412,11828,1689,511800,92801
12217,4401,7816,1612,562300,92802
24772,10327,14445,1703,574800,92804
20112,8300,11812,1663,554500,92805
12501,4994,7507,1890,605100,92806
12460,9702,2758,2167,700900,92807
7921,5840,2081,2338,753600,92808
13902,8360,5542,1933,664900,92821
1595,1383,212,2837,875200,92823
11968,5092,6876,1724,662100,92831
7955,3033,4922,1643,576300,92832
16266,9651,6615,1692,659600,92833
8740,6314,2426,1884,772700,92835
15291,8362,6929,1595,562200,92840
9432,5149,4283,1568,590700,92841
11730,5484,6246,1556,557000,92843
6736,2841,3895,1745,527200,92844
5403,4260,1143,2339,634100,92845
7370,6071,1299,1831,559700,92860
1972,1864,108,-,1239600,92861
6761,4305,2456,1937,629800,92865
5543,1916,3627,1609,689100,92866
12934,8908,4026,1870,729700,92867
7900,2792,5108,1940,511900,92868
11348,8411,2937,1939,733100,92869
16813,10816,5997,1863,652800,92870
14218,8062,6156,1641,431400,92879
18125,13574,4551,2223,579400,92880
9318,7496,1822,1712,591100,92881
20790,13288,7502,1666,483800,92882
11175,9059,2116,2438,494800,92883
16661,13473,3188,2449,842100,92886
6746,5885,861,2138,875800,92887
12655,5435,7220,1482,579000,93001
19279,11281,7998,1769,593000,93003
10895,7250,3645,1847,582500,93004
15705,9770,5935,1941,647100,93010
12797,8920,3877,2332,640500,93012
6449,3625,2824,2003,819600,93013
5369,3161,2208,1530,437400,93015
12064,9345,2719,2098,667000,93021
2276,1695,581,1582,585800,93022
8117,5617,2500,1721,673200,93023
14975,7342,7633,1468,492200,93030
16804,9752,7052,1517,420700,93033
9621,5378,4243,1970,608900,93035
13287,7008,6279,1817,497800,93036
524,349,175,1284,381300,93040
7184,3205,3979,1749,434500,93041
0,0,0,-,-,93042
9,4,5,-,-,93043
9953,5372,4581,1364,432200,93060
19371,13479,5892,2015,606200,93063
0,0,0,-,-,93064
24441,17960,6481,2216,620800,93065
972,670,302,1404,976400,93066
207,106,101,-,895300,93067
13296,3125,10171,1733,890300,93101
8194,4182,4012,2028,1092500,93103
11390,6135,5255,2040,1125700,93105
4409,3139,1270,2442,"2,000,000+",93108
4601,2595,2006,2139,1300600,93109
6385,4017,2368,1938,844300,93110
6643,4401,2242,2425,936200,93111
16568,6294,10274,1759,822000,93117
321,110,211,697,97300,93201
1095,688,407,1125,164200,93202
5077,2530,2547,933,176800,93203
2752,1306,1446,882,144800,93204
881,546,335,847,90900,93205
504,229,275,902,160000,93206
100,95,5,-,162500,93207
88,20,68,-,-,93208
4896,2787,2109,848,199900,93210
4014,1913,2101,868,162100,93212
12230,7095,5135,901,203300,93215
196,154,42,-,122700,93218
2578,1181,1397,753,156000,93219
45,0,45,-,-,93220
4820,3209,1611,997,268200,93221
909,737,172,1324,273100,93222
2862,1888,974,846,173800,93223
122,92,30,1063,120500,93224
2024,1326,698,913,242200,93225
51,36,15,1229,246700,93226
22529,13328,9201,1013,235100,93230
1927,392,1535,792,161100,93234
1217,591,626,640,155600,93235
438,281,157,-,230500,93238
589,98,491,935,186300,93239
2640,1715,925,862,149200,93240
4498,1801,2697,784,133700,93241
1105,628,477,933,232300,93242
661,505,156,1015,172000,93243
132,99,33,900,330000,93244
12005,5679,6326,1217,247100,93245
5343,3027,2316,769,193400,93247
530,162,368,703,125000,93249
3264,1786,1478,939,183600,93250
75,41,34,511,-,93251
902,500,402,865,80600,93252
338,232,106,938,183900,93254
456,406,50,-,145800,93255
1538,606,932,878,141100,93256
22638,11965,10673,942,185700,93257
457,148,309,838,125500,93258
95,65,30,-,134700,93260
599,279,320,733,119500,93261
0,0,0,-,-,93262
5563,2947,2616,960,188900,93263
1441,1299,142,941,276900,93265
241,109,132,1175,110300,93266
1804,1099,705,768,150400,93267
6485,3237,3248,808,162100,93268
1671,1168,503,891,198900,93270
1234,840,394,1343,293400,93271
1198,391,807,1100,163700,93272
21459,12054,9405,1075,227500,93274
46,26,20,600,100000,93276
18229,10335,7894,1067,242900,93277
6717,3935,2782,786,180600,93280
1007,827,180,698,87100,93283
1096,835,261,1084,89000,93285
3048,1701,1347,739,213100,93286
34,34,0,-,232400,93287
18001,10822,7179,1070,282300,93291
13561,8512,5049,1174,239200,93292
4793,1697,3096,883,184300,93301
14649,6403,8246,968,166300,93304
11059,3840,7219,860,159600,93305
21974,13882,8092,1012,211100,93306
22422,11830,10592,962,172500,93307
20080,9022,11058,1025,235300,93308
21448,9979,11469,1045,214100,93309
15182,10614,4568,1453,303300,93311
18584,14460,4124,1574,302200,93312
15244,11531,3713,1557,268300,93313
9909,8157,1752,1501,385600,93314
12667,6162,6505,1496,711600,93401
6303,4506,1797,1593,591600,93402
8400,3134,5266,1720,689200,93405
0,0,0,-,-,93410
11496,8024,3472,1622,681300,93420
12956,8571,4385,1452,551000,93422
526,343,183,1542,877300,93424
547,425,122,1057,449600,93426
2320,1500,820,1792,598900,93427
2731,2033,698,1430,680100,93428
48,28,20,-,263200,93429
1294,804,490,1326,845200,93430
452,407,45,1221,635800,93432
5212,2644,2568,1545,536300,93433
1912,909,1003,1212,304400,93434
17722,9368,8354,1267,357500,93436
1106,0,1106,2069,-,93437
486,335,151,1120,512900,93440
377,290,87,1938,956400,93441
5022,3113,1909,1576,657500,93442
7397,5452,1945,1639,637200,93444
2803,1660,1143,1277,402200,93445
17667,11900,5767,1395,487600,93446
4149,3009,1140,1805,759800,93449
209,70,139,1196,334100,93450
1366,852,514,1938,395100,93451
262,82,180,1119,281100,93452
1283,792,491,-,501400,93453
11560,6051,5509,1409,356900,93454
15584,11827,3757,1854,437600,93455
13286,5678,7608,1442,342000,93458
2318,1661,657,1898,947400,93460
506,322,184,1478,348700,93461
3286,2107,1179,1536,828000,93463
3571,2684,887,1789,774000,93465
1868,939,929,810,114600,93501
4161,2394,1767,917,161200,93505
2571,2270,301,1344,570800,93510
85,77,8,-,206900,93512
692,506,186,837,238200,93513
5985,4137,1848,1002,311000,93514
1075,642,433,695,67100,93516
234,229,5,-,271800,93517
380,321,59,1107,196200,93518
0,0,0,-,-,93519
57,57,0,-,32000,93522
1197,221,976,1617,67200,93523
0,0,0,-,-,93524
307,215,92,914,190600,93526
805,672,133,1146,174000,93527
48,23,25,-,-,93528
195,184,11,-,417700,93529
6,6,0,-,-,93530
169,159,10,-,435700,93531
1010,839,171,1217,311300,93532
14092,4617,9475,1152,241000,93534
21129,12404,8725,1232,225600,93535
21462,14338,7124,1397,352700,93536
160,92,68,1406,-,93541
3577,2293,1284,1277,246700,93543
509,459,50,-,225000,93544
654,364,290,719,252500,93545
3502,2147,1355,1268,460800,93546
141,98,43,-,168500,93549
21100,10872,10228,1182,254400,93550
15683,11926,3757,1722,379700,93551
10053,7350,2703,1565,302600,93552
667,554,113,1339,267800,93553
66,66,0,-,-,93554
13674,8616,5058,948,185300,93555
8,8,0,-,-,93558
6916,4882,2034,933,224000,93560
12247,9631,2616,1060,277900,93561
770,393,377,597,51900,93562
99,90,9,-,642900,93563
1929,1366,563,1340,191800,93591
139,100,39,-,69500,93592
575,417,158,776,320600,93601
1331,1173,158,868,299500,93602
69,52,17,-,-,93603
187,187,0,-,662200,93604
43,16,27,1021,-,93605
175,75,100,950,149300,93606
329,120,209,676,148700,93608
1450,790,660,994,172300,93609
5016,2636,2380,977,229400,93610
15819,11981,3838,1730,345800,93611
13424,5145,8279,1077,226900,93612
4673,4225,448,1363,285400,93614
1490,663,827,946,164900,93615
676,353,323,747,266800,93616
8294,4401,3893,956,217500,93618
13401,11747,1654,2097,435000,93619
2621,1438,1183,953,243400,93620
37,37,0,-,-,93621
2529,1145,1384,661,178400,93622
23,23,0,-,-,93623
170,5,165,628,-,93624
2442,1266,1176,1071,276100,93625
849,742,107,1458,520400,93626
19,0,19,-,-,93627
237,48,189,-,-,93628
5491,2821,2670,1048,242500,93630
5049,3284,1765,1068,294100,93631
0,0,0,-,-,93633
2,2,0,-,-,93634
11463,6489,4974,1243,318100,93635
4076,3694,382,1342,348400,93636
12029,6949,5080,1141,256300,93637
12432,7025,5407,1010,228600,93638
2971,1393,1578,769,176500,93640
150,133,17,-,238200,93641
1248,965,283,883,246700,93643
3287,2353,934,975,295700,93644
54,54,0,-,-,93645
2996,1189,1807,776,171300,93646
2906,1623,1283,856,165500,93647
4146,1785,2361,849,175000,93648
941,337,604,963,146100,93650
781,496,285,1308,393400,93651
161,98,63,850,160900,93652
586,482,104,1375,412400,93653
8738,5294,3444,981,239000,93654
1604,785,819,874,187000,93656
10734,6962,3772,949,294200,93657
949,395,554,815,171700,93660
8929,4857,4072,967,204700,93662
220,188,32,967,564100,93664
175,114,61,-,110800,93665
267,65,202,809,115600,93666
753,636,117,-,251400,93667
309,198,111,1037,315800,93668
87,63,24,-,235800,93669
169,91,78,850,159800,93673
1326,1125,201,966,233500,93675
3670,452,3218,725,184600,93701
12112,4146,7966,898,149000,93702
10331,3985,6346,919,165800,93703
11644,6247,5397,1099,273300,93704
12330,5367,6963,985,197100,93705
11549,4392,7157,882,172500,93706
11752,4745,7007,1018,265300,93710
15941,9653,6288,1208,378000,93711
17935,10118,7817,1634,345700,93720
2352,223,2129,789,195400,93721
25326,14763,10563,1205,254800,93722
3524,2895,629,1745,343500,93723
6812,3710,3102,1036,216000,93725
14279,5787,8492,958,200800,93726
24810,15063,9747,986,279100,93727
5876,2143,3733,966,188600,93728
4404,3507,897,2022,487100,93730
10077,4732,5345,1435,542900,93901
13227,5313,7914,1353,416500,93905
17076,9479,7597,1648,438500,93906
7034,5208,1826,1673,556200,93907
4279,3515,764,2574,827100,93908
568,160,408,854,1564100,93920
1643,741,902,2230,1617500,93921
5375,4303,1072,1777,1164700,93923
2638,2015,623,1873,947000,93924
396,140,256,994,438900,93925
2320,1243,1077,1166,392400,93926
4031,1909,2122,1447,334700,93927
19,0,19,-,-,93928
4416,2206,2210,1211,314400,93930
223,149,74,1115,309400,93932
8988,3468,5520,1496,572000,93933
13947,5543,8404,1875,831900,93940
0,0,0,-,-,93943
6977,3275,3702,1952,897000,93950
1710,1500,210,3474,1364300,93953
100,52,48,967,211400,93954
10986,4337,6649,1876,543200,93955
4147,2469,1678,1136,411200,93960
169,132,37,-,648000,93962
10404,5998,4406,2546,1599200,94002
2039,1372,667,2161,926500,94005
15899,9777,6122,2310,"2,000,000+",94010
14171,8428,5743,1838,804300,94014
20542,12376,8166,2411,878700,94015
7362,5339,2023,1882,1212800,94019
804,661,143,-,883800,94020
113,66,47,1674,742600,94021
7170,5593,1577,3307,"2,000,000+",94022
7797,6855,942,"3,500+","2,000,000+",94024
15194,9324,5870,2517,"2,000,000+",94025
2252,2008,244,"3,500+","2,000,000+",94027
2556,2167,389,"3,500+","2,000,000+",94028
7959,5029,2930,2834,1528900,94030
1023,849,174,1803,1107700,94037
1125,930,195,2120,979600,94038
14408,5982,8426,2454,1995100,94040
5949,1776,4173,2538,1674400,94041
12860,5901,6959,2559,1239400,94043
13833,9562,4271,2530,943500,94044
346,183,163,1618,865100,94060
13332,6789,6543,2334,1520700,94061
10126,7295,2831,2294,"2,000,000+",94062
10724,3669,7055,2296,931400,94063
4780,3158,1622,3462,1453400,94065
15195,9179,6016,2459,957300,94066
11200,7859,3341,2423,1770200,94070
67,67,0,-,1016300,94074
21551,13288,8263,2285,910600,94080
8484,3195,5289,2747,1142800,94085
19415,5973,13442,2559,1349500,94086
19605,11282,8323,2723,1808700,94087
8351,4639,3712,3055,295600,94089
19089,1602,17487,1229,1059800,94102
15918,2373,13545,1480,919400,94103
228,37,191,773,"2,000,000+",94104
6522,3135,3387,3147,1496400,94105
14133,5669,8464,2812,1130600,94107
7298,742,6556,1345,1173900,94108
33011,5580,27431,1944,1177400,94109
27069,10126,16943,1997,1185300,94110
2218,510,1708,2361,1268900,94111
23090,15842,7248,1884,944800,94112
17000,7465,9535,2342,1557200,94114
17000,4444,12556,2072,1350000,94115
16019,11368,4651,2488,1137200,94116
17871,4747,13124,2406,1480400,94117
17508,6239,11269,2213,1599600,94118
17809,7552,10257,1927,1388200,94121
22647,11100,11547,2284,1177100,94122
13172,3943,9229,2682,"2,000,000+",94123
11148,5828,5320,1155,803800,94124
7529,5980,1549,3039,1479500,94127
0,0,0,-,-,94128
1291,7,1284,"3,500+",-,94129
646,0,646,2159,-,94130
12888,7254,5634,2530,1356800,94131
10864,4993,5871,2193,1112600,94132
13247,2137,11110,1470,1297600,94133
12520,7659,4861,1623,898700,94134
4406,1347,3059,2664,1176100,94158
7102,3873,3229,2499,"2,000,000+",94301
14360,8386,5974,2053,1517600,94303
1935,376,1559,3220,"2,000,000+",94304
3505,996,2509,1666,"2,000,000+",94305
10641,5963,4678,2470,"2,000,000+",94306
12689,6090,6599,2345,874300,94401
9872,6496,3376,2712,1752700,94402
16506,8620,7886,2855,1375300,94403
13818,7297,6521,3273,1334200,94404
25477,10423,15054,1960,914900,94501
5037,4277,760,2339,930500,94502
5147,3984,1163,1902,518200,94503
5450,4647,803,2612,640100,94505
9274,8260,1014,2978,1288600,94506
4815,4488,327,2770,1701200,94507
1059,604,455,1600,709600,94508
21744,12331,9413,1756,399200,94509
11496,8201,3295,1995,598400,94510
837,663,174,1203,323700,94511
18,18,0,-,-,94512
21300,16780,4520,2208,610200,94513
527,339,188,2210,735000,94514
2772,1914,858,1492,746400,94515
79,62,17,939,635700,94516
4467,4043,424,2960,793700,94517
10548,7280,3268,2000,618200,94518
7082,5021,2061,2000,573300,94519
13416,4774,8642,1675,451000,94520
15977,11346,4631,1939,620400,94521
13859,8868,4991,2076,779700,94523
1434,942,492,1373,546700,94525
12647,10499,2148,2391,1159300,94526
346,346,0,-,"2,000,000+",94528
10499,6052,4447,2002,855600,94530
12049,8409,3640,2522,470900,94531
24396,13209,11187,1501,372800,94533
13121,9798,3323,2232,548400,94534
924,34,890,2410,-,94535
24879,14498,10381,2398,936400,94536
21690,9915,11775,2413,848100,94538
16458,13451,3007,2650,1457300,94539
21187,9386,11801,1809,615600,94541
4321,2944,1377,2215,831800,94542
22482,11459,11023,1882,592700,94544
9668,6904,2764,1953,628700,94545
15922,10323,5599,1935,764800,94546
8980,7236,1744,2592,564600,94547
127,106,21,-,886400,94548
10830,7935,2895,2302,1481000,94549
18335,13849,4486,2211,880400,94550
16521,11951,4570,2138,776500,94551
5137,4681,456,3255,1020700,94552
19096,13452,5644,1852,597500,94553
11463,7898,3565,2686,1007600,94555
5623,4661,962,2311,1171200,94556
24027,16312,7715,1859,670700,94558
9943,4960,4983,1732,681800,94559
14356,9831,4525,2366,816100,94560
12621,9402,3219,1791,469300,94561
7109,6592,517,2371,1516300,94563
6750,4690,2060,1974,566000,94564
27807,16472,11335,1765,408400,94565
15685,10955,4730,2386,1135500,94566
263,165,98,1763,348100,94567
19065,11557,7508,2768,901100,94568
156,28,128,-,-,94569
4939,3855,1084,1361,367800,94571
3303,1906,1397,1498,490600,94572
23,0,23,-,-,94573
3931,2683,1248,1693,1206700,94574
0,0,0,-,-,94575
66,52,14,-,857100,94576
17261,9569,7692,1778,637300,94577
14357,5554,8803,1662,594700,94578
6594,4932,1662,1888,625800,94579
8794,6239,2555,1905,615900,94580
15095,10617,4478,2348,1108200,94582
13044,9569,3475,2420,930400,94583
9254,5576,3678,1735,380200,94585
284,247,37,1713,1130800,94586
21723,14113,7610,2322,812000,94587
12616,8394,4222,2719,982900,94588
9466,5815,3651,1622,352100,94589
14534,5993,8541,1394,349500,94590
18612,12312,6300,1829,455800,94591
414,341,73,2668,642000,94592
9702,7995,1707,2174,639200,94595
10256,4270,5986,2167,1032100,94596
10708,4962,5746,2269,756800,94597
10327,8010,2317,2743,989200,94598
1428,901,527,1623,529900,94599
15118,5012,10106,1344,524600,94601
11532,6770,4762,1591,859500,94602
9613,4274,5339,1570,408200,94603
16022,9505,6517,1542,648400,94605
15054,2789,12265,1383,613800,94606
11121,3637,7484,1398,621200,94607
14345,4700,9645,2208,654300,94608
9933,2986,6947,1810,913200,94609
15290,5554,9736,1770,1074000,94610
16854,10169,6685,1717,1153300,94611
8988,819,8169,1347,838800,94612
11,0,11,-,-,94613
7136,4561,2575,2426,1317900,94618
9017,6219,2798,1615,744500,94619
9543,2859,6684,1249,402500,94621
7256,3455,3801,1632,913700,94702
8617,3411,5206,1888,970500,94703
8670,981,7689,1741,902200,94704
5746,3249,2497,1809,1394300,94705
8129,4031,4098,1935,914100,94706
4843,4067,776,1731,1209200,94707
4715,4017,698,2567,1153500,94708
5209,1552,3657,1666,1017600,94709
3297,1205,2092,1939,859600,94710
15,15,0,-,-,94720
9407,4558,4849,1444,436100,94801
9131,6729,2402,1819,569800,94803
14466,6914,7552,1429,472100,94804
5450,3834,1616,1822,567600,94805
19732,9231,10501,1697,443100,94806
0,0,0,-,-,94850
15784,7364,8420,1923,1084900,94901
12582,8308,4274,2380,894500,94903
5599,3611,1988,2056,1615700,94904
5026,3611,1415,2644,"2,000,000+",94920
187,128,59,2257,790900,94922
545,314,231,1445,806800,94923
580,434,146,2188,1125000,94924
3823,2587,1236,2757,1290100,94925
16241,8243,7998,1818,506700,94928
118,80,38,-,1147700,94929
3736,2320,1416,1931,885300,94930
3400,1967,1433,1559,595100,94931
380,194,186,2712,875000,94933
480,388,92,1466,1087000,94937
394,293,101,2819,896700,94938
3205,1628,1577,2452,1527600,94939
81,81,0,-,898000,94940
12991,8634,4357,2584,1500700,94941
7282,5119,2163,1941,875100,94945
306,233,73,2060,1652800,94946
9882,7752,2130,1979,822500,94947
7233,4531,2702,2092,779100,94949
57,24,33,-,1125000,94950
1639,1135,504,1872,896100,94951
13834,8166,5668,1851,830400,94952
13878,9394,4484,2105,633700,94954
632,368,264,1900,1319400,94956
410,349,61,2788,"2,000,000+",94957
6381,4418,1963,2184,1220500,94960
80,64,16,-,892900,94963
134,0,134,"3,500+",-,94964
6157,3209,2948,2323,1240200,94965
337,178,159,1791,1666700,94970
87,87,0,-,611600,94971
56,56,0,-,-,94972
709,593,116,1738,936600,94973
558,395,163,2215,562500,95002
10028,7805,2223,2071,892900,95003
1240,888,352,1529,783900,95004
2825,1867,958,2012,761400,95005
3803,2930,873,1811,623700,95006
145,145,0,-,534200,95007
18038,8894,9144,2299,1154400,95008
4133,1993,2140,1893,761100,95010
2359,1212,1147,1292,482300,95012
16,16,0,-,-,95013
21199,12559,8640,3246,1868000,95014
271,153,118,1383,855800,95017
2684,2171,513,1993,664900,95018
2296,805,1491,1159,445800,95019
18154,11780,6374,1912,761000,95020
15932,10468,5464,1539,576000,95023
5239,3922,1317,2469,"2,000,000+",95030
9868,6585,3283,2577,1638400,95032
3777,3020,757,2120,1144200,95033
22207,14155,8052,2626,928600,95035
16586,12069,4517,1885,908700,95037
316,150,166,1269,189500,95039
98,45,53,848,839300,95041
290,179,111,1181,747100,95043
1473,924,549,1585,695200,95045
1789,1192,597,1397,1051500,95046
14160,5071,9089,2091,1064000,95050
21613,10307,11306,2655,1174200,95051
0,0,0,-,-,95053
8136,3551,4585,2852,1081800,95054
19030,9746,9284,2054,927600,95060
15250,8195,7055,1985,788100,95062
518,188,330,1517,428600,95064
3055,2091,964,2138,897500,95065
5975,4425,1550,2120,859900,95066
11187,9634,1553,3339,"2,000,000+",95070
4104,2911,1193,1903,813700,95073
130,109,21,2594,786900,95075
23451,13095,10356,1564,583100,95076
6456,2686,3770,2161,697000,95110
15760,9407,6353,1664,602900,95111
20607,6023,14584,1804,772100,95112
1426,199,1227,2703,921000,95113
14072,5456,8616,1727,619100,95116
10946,4068,6878,2054,1090900,95117
11277,7260,4017,2220,1039500,95118
3429,2534,895,2447,908600,95119
12714,11318,1396,3428,1450700,95120
9823,7244,2579,2318,793000,95121
12010,6222,5788,1974,634500,95122
23446,14385,9061,2574,851400,95123
17445,12884,4561,2642,1179800,95124
21335,13043,8292,1962,1173000,95125
14843,5167,9676,2123,947100,95126
15787,10542,5245,2164,751100,95127
13771,5859,7912,1998,973600,95128
13956,8404,5552,2463,1551500,95129
4714,2918,1796,1887,1314900,95130
9869,6208,3661,2614,892800,95131
12183,8855,3328,2680,1000000,95132
8480,5082,3398,1641,791300,95133
13171,1841,11330,2919,370400,95134
7735,6726,1009,3012,1091200,95135
15687,8825,6862,2378,839600,95136
5773,4993,780,2573,1071600,95138
2136,1669,467,2889,861500,95139
45,24,21,-,1145800,95140
12269,9826,2443,3046,924400,95148
2912,203,2709,639,263500,95202
5357,2105,3252,921,237500,95203
10965,6083,4882,1068,260400,95204
10415,4283,6132,1027,190000,95205
17384,9438,7946,1189,267200,95206
18401,7334,11067,1182,290900,95207
12948,8823,4125,1616,340800,95209
11709,5791,5918,1176,245000,95210
0,0,0,-,-,95211
7411,5233,2178,1833,379000,95212
6828,3831,2997,1005,275400,95215
10720,6274,4446,1450,420200,95219
2596,1768,828,1284,585600,95220
2345,1619,726,1277,389100,95222
1311,1146,165,1394,315500,95223
98,65,33,753,268800,95224
257,45,212,636,325000,95225
0,0,0,-,-,95226
241,187,54,-,803000,95227
1682,1452,230,1841,358900,95228
231,96,135,1860,625000,95230
808,370,438,1178,382100,95231
49,49,0,-,596900,95232
118,100,18,-,332600,95233
0,0,0,-,-,95234
1643,1118,525,1351,473000,95236
1346,1051,295,1369,398000,95237
16499,8088,8411,1140,329800,95240
10077,6539,3538,1558,404200,95242
745,682,63,819,364000,95245
511,453,58,1162,316700,95246
1640,1371,269,1551,337900,95247
57,41,16,-,205400,95248
1856,1132,724,1327,286400,95249
14,14,0,-,-,95250
254,229,25,-,325000,95251
4959,4234,725,1674,350800,95252
277,277,0,-,375300,95254
685,503,182,1067,201000,95255
155,119,36,1357,281900,95257
1465,1153,312,1260,427200,95258
12719,7296,5423,1022,277700,95301
354,165,189,983,546200,95303
4147,2730,1417,1811,628300,95304
0,0,0,-,-,95305
413,316,97,980,247600,95306
12681,7639,5042,1187,291000,95307
872,660,212,655,332600,95310
982,845,137,1108,247300,95311
54,32,22,-,266700,95312
468,265,203,733,411500,95313
0,0,0,-,-,95314
3777,2424,1353,1117,264000,95315
2542,1902,640,1172,369100,95316
302,87,215,850,450000,95317
169,92,77,664,227700,95318
590,209,381,862,177600,95319
4728,3315,1413,1501,432600,95320
1702,1459,243,944,298600,95321
3287,1696,1591,1052,299300,95322
449,279,170,722,454200,95323
2811,1596,1215,1191,322200,95324
33,33,0,-,-,95325
3875,2332,1543,1395,355900,95326
2675,1810,865,927,255800,95327
1103,482,621,1100,288000,95328
1109,860,249,1317,281000,95329
5904,4690,1214,1733,386500,95330
771,535,236,857,221600,95333
4306,2216,2090,1098,234900,95334
69,0,69,-,-,95335
15490,9979,5511,1545,377100,95336
12304,8086,4218,1597,442800,95337
4781,3377,1404,1004,304800,95338
12120,6508,5612,982,286700,95340
9005,3742,5263,905,206900,95341
426,272,154,689,295600,95345
529,362,167,1199,332000,95346
10889,4452,6437,1208,254300,95348
19488,9987,9501,1166,287500,95350
13441,6641,6800,1146,217600,95351
8701,3976,4725,1109,268400,95354
20828,12491,8337,1380,330200,95355
10951,6965,3986,1370,358900,95356
4073,2881,1192,1577,322200,95357
8479,5116,3363,1316,282400,95358
4121,2869,1252,986,281600,95360
12420,8375,4045,1165,379600,95361
7847,5271,2576,1330,336700,95363
0,0,0,-,-,95364
1149,652,497,812,150000,95365
6663,4514,2149,1471,478000,95366
7425,4909,2516,1248,320500,95367
4268,3126,1142,1721,330400,95368
458,242,216,833,340400,95369
12286,8753,3533,1107,324900,95370
627,597,30,-,297500,95372
507,263,244,1068,347800,95374
0,0,0,-,-,95375
16916,9651,7265,1653,427000,95376
8861,6322,2539,2316,540300,95377
1762,1268,494,703,298000,95379
15269,6968,8301,1042,298100,95380
13215,8188,5027,1395,357100,95382
1842,1470,372,1508,334300,95383
165,110,55,931,-,95385
2988,2022,966,1145,289800,95386
161,21,140,1070,-,95387
4091,2427,1664,871,188800,95388
341,53,288,1412,650700,95389
5328,3825,1503,2731,629600,95391
13817,7699,6118,1592,499700,95401
15871,9036,6835,1809,559000,95403
15647,8857,6790,1651,692900,95404
8955,5007,3948,1917,620700,95405
12851,6682,6169,1578,463100,95407
12031,7736,4295,1936,647000,95409
393,289,104,-,570200,95410
189,131,58,-,430000,95412
402,203,199,1137,461400,95415
89,57,32,-,-,95417
91,64,27,-,-,95420
700,551,149,1125,534900,95421
5970,3343,2627,917,131400,95422
1584,1076,508,1040,203600,95423
4394,3022,1372,1372,524600,95425
474,369,105,1671,269400,95426
200,89,111,-,698700,95427
1017,631,386,625,266100,95428
45,45,0,-,302600,95429
13,0,13,-,-,95430
0,0,0,-,-,95431
278,190,88,1825,575300,95432
88,15,73,-,-,95435
2655,1854,801,1631,549700,95436
6430,3876,2554,1119,396900,95437
132,101,31,-,945500,95439
659,424,235,1443,1043100,95441
1365,975,390,1277,1153900,95442
73,0,73,853,-,95443
168,106,62,-,686300,95444
968,670,298,1488,555200,95445
2443,1720,723,1355,476500,95446
6899,4160,2739,1702,927300,95448
508,261,247,1318,447800,95449
119,82,37,1222,625000,95450
4432,3136,1296,1152,257800,95451
447,425,22,-,903100,95452
4623,3167,1456,866,307600,95453
1028,848,180,575,372100,95454
390,220,170,-,469000,95456
1325,1087,238,1030,258500,95457
1279,963,316,1283,233700,95458
323,218,105,930,500000,95459
1087,717,370,1196,569900,95460
1281,879,402,1310,233400,95461
639,418,221,1056,511500,95462
58,58,0,-,432400,95463
935,655,280,1056,116500,95464
890,597,293,1882,870500,95465
290,118,172,1063,802300,95466
2240,1624,616,1678,334400,95467
594,313,281,973,483700,95468
578,358,220,1292,471600,95469
2008,1493,515,1146,456600,95470
265,129,136,1379,411800,95471
12171,8503,3668,1617,851400,95472
15591,10097,5494,1738,737800,95476
11282,6387,4895,1173,377900,95482
1131,889,242,766,317200,95485
29,15,14,-,-,95486
113,77,36,-,-,95488
5533,3148,2385,1005,311300,95490
9915,7679,2236,1978,629700,95492
63,63,0,-,360900,95493
59,38,21,-,1041700,95494
646,560,86,1378,935300,95497
9766,3856,5910,960,299100,95501
9974,6912,3062,1119,324200,95503
77,77,0,-,-,95511
45,45,0,-,-,95514
7314,4878,2436,968,320100,95519
8149,3266,4883,1048,367900,95521
761,617,144,1141,480400,95524
672,387,285,1177,365400,95525
130,111,19,-,283900,95526
241,195,46,775,242500,95527
629,505,124,1082,372300,95528
8364,5548,2816,961,228700,95531
1169,673,496,1087,450900,95536
99,50,49,-,-,95537
5481,3063,2418,938,287700,95540
1029,505,524,1021,369600,95542
250,176,74,850,258500,95543
29,29,0,-,425000,95545
1107,846,261,560,257100,95546
451,378,73,950,485700,95547
439,334,105,775,183300,95548
366,322,44,1569,480600,95549
79,14,65,981,781300,95550
623,303,320,939,363300,95551
387,318,69,-,275400,95552
395,179,216,981,-,95553
152,115,37,-,-,95554
138,55,83,800,225000,95555
274,188,86,478,344100,95556
189,147,42,625,669000,95558
71,29,42,-,-,95559
627,465,162,-,310100,95560
1482,856,626,847,208300,95562
298,191,107,1014,387700,95563
210,72,138,1004,325000,95564
264,60,204,1103,280000,95565
752,648,104,-,255000,95567
60,37,23,-,313200,95568
130,127,3,-,421800,95569
1075,744,331,1405,452200,95570
57,57,0,-,338000,95571
549,400,149,1316,287900,95573
180,103,77,619,350000,95585
32,32,0,-,-,95587
615,488,127,1392,406300,95589
69,59,10,-,-,95595
51,19,32,1068,431800,95601
7218,5856,1362,1340,483300,95602
12196,8106,4090,1234,458000,95603
42,31,11,-,-,95604
4749,1850,2899,947,286000,95605
126,80,46,991,839300,95606
133,133,0,-,745400,95607
25581,13379,12202,1207,421100,95608
17717,8900,8817,1361,353800,95610
523,373,150,1450,842700,95612
1675,1495,180,2160,423000,95614
295,158,137,889,604400,95615
17999,6593,11406,1574,707800,95616
9660,5479,4181,1780,678800,95618
2555,1622,933,1454,281200,95619
7521,4585,2936,1459,438400,95620
16469,11179,5290,1374,297400,95621
1515,1238,277,1380,429700,95623
20006,15461,4545,1595,434100,95624
140,9,131,1591,-,95625
1848,1441,407,1355,365800,95626
1277,853,424,1235,346800,95627
15996,11311,4685,1460,460400,95628
208,176,32,-,372400,95629
27717,18966,8751,1818,558900,95630
2668,2367,301,1074,382800,95631
10358,7603,2755,1260,377500,95632
1529,1413,116,1500,363200,95633
1720,1422,298,1607,290400,95634
406,394,12,-,316700,95635
568,529,39,-,262000,95636
56,26,30,-,-,95637
845,797,48,-,577800,95638
108,48,60,1750,-,95639
4665,3630,1035,944,319100,95640
730,546,184,914,221600,95641
2947,2013,934,1024,331300,95642
566,319,247,857,285200,95645
46,34,12,-,364700,95646
20056,16252,3804,1804,475600,95648
5570,4690,880,1531,662400,95650
171,171,0,-,597400,95651
190,0,190,1356,-,95652
182,130,52,-,166300,95653
1395,1076,319,-,395900,95655
2504,2096,408,1652,664500,95658
320,184,136,1065,400000,95659
11252,6346,4906,1219,233700,95660
12273,7595,4678,1600,512600,95661
12424,9094,3330,1482,378900,95662
1033,936,97,1555,680800,95663
534,415,119,1575,482600,95664
1409,1152,257,1388,297900,95665
2023,1793,230,1097,280400,95666
14053,10928,3125,1284,409700,95667
208,153,55,1857,498600,95668
830,643,187,1188,436900,95669
20765,11777,8988,1331,348500,95670
2183,1961,222,1779,536200,95672
4994,3490,1504,1317,309300,95673
278,210,68,983,432400,95674
130,97,33,-,159100,95675
9706,6582,3124,1634,468400,95677
16677,9211,7466,1677,395600,95678
25,18,7,-,-,95679
0,0,0,-,-,95680
311,245,66,-,269900,95681
11227,8133,3094,1408,507400,95682
2489,2267,222,2042,526800,95683
1208,1043,165,1362,395800,95684
2002,1319,683,1082,398900,95685
368,179,189,776,239800,95686
22193,14204,7989,1767,435900,95687
13703,9671,4032,1634,519000,95688
588,571,17,-,366300,95689
689,424,265,996,586300,95690
13637,8550,5087,1202,389400,95691
1662,1101,561,1317,284000,95692
2305,1793,512,1454,617200,95693
3511,2004,1507,1323,470800,95694
14361,7081,7280,1164,388800,95695
90,79,11,-,-,95697
118,86,32,-,597600,95698
6,6,0,-,-,95699
416,377,39,1423,448300,95701
401,347,54,1686,478400,95703
2274,1764,510,1190,446200,95709
4040,3261,779,1294,387600,95713
174,133,41,1278,328700,95714
29,29,0,-,287500,95715
77,27,50,746,284400,95717
49,49,0,-,338900,95720
0,0,0,-,-,95721
1964,1767,197,2054,536000,95722
0,0,0,-,-,95724
3391,2669,722,1118,319200,95726
152,135,17,-,733100,95728
18,18,0,-,280000,95735
63,0,63,532,-,95736
3727,3258,469,2321,444400,95742
8019,7295,724,2169,790100,95746
24318,19478,4840,1774,492600,95747
14415,10476,3939,2024,477100,95757
21946,15331,6615,1705,404100,95758
14987,12971,2016,1912,664000,95762
13136,8686,4450,1798,542800,95765
7763,4683,3080,1309,393700,95776
3687,622,3065,1203,610300,95811
7029,606,6423,937,495100,95814
9335,3418,5917,1083,227900,95815
9915,2663,7252,1191,606800,95816
6448,2352,4096,1107,348500,95817
9885,5399,4486,1148,600200,95818
8104,5962,2142,1674,607900,95819
13187,7183,6004,1222,292300,95820
15470,7324,8146,1052,356200,95821
16134,9552,6582,1201,335900,95822
23538,11115,12423,1227,262700,95823
8947,3635,5312,1071,220000,95824
15921,3821,12100,1178,318200,95825
15629,8274,7355,1355,329100,95826
7335,4374,2961,1410,294100,95827
17629,11152,6477,1392,285000,95828
8606,6554,2052,1655,400100,95829
211,204,7,-,625000,95830
18496,10515,7981,1483,451300,95831
3241,1712,1529,1545,296400,95832
15179,6756,8423,1473,326600,95833
10771,5323,5448,1444,376500,95834
13900,9156,4744,1790,430100,95835
104,78,26,-,1000000,95837
11233,6107,5126,1268,253500,95838
8067,3018,5049,1216,281100,95841
11367,5390,5977,1259,272800,95842
14602,9921,4681,1712,344000,95843
9767,7216,2551,1444,598700,95864
12260,6791,5469,944,257600,95901
321,0,321,2153,-,95903
65,65,0,-,151100,95910
1545,1011,534,874,330200,95912
278,193,85,961,225000,95914
0,0,0,-,-,95915
505,416,89,767,211000,95916
1135,858,277,1141,248500,95917
1082,837,245,1161,443000,95918
579,523,56,-,273500,95919
129,83,46,555,198100,95920
231,166,65,854,264300,95922
15,15,0,-,487500,95923
114,78,36,-,-,95925
15724,6782,8942,1141,351500,95926
14483,6629,7854,1130,368000,95928
55,55,0,-,-,95930
2986,1923,1063,844,255500,95932
57,38,19,-,-,95934
78,43,35,-,-,95935
56,46,10,-,-,95936
622,383,239,590,-,95937
1413,937,476,1407,492300,95938
191,69,122,583,139800,95939
312,231,81,-,233900,95941
709,680,29,-,534500,95942
260,147,113,745,368800,95943
70,12,58,-,-,95944
11825,6647,5178,1111,377300,95945
3574,2865,709,1705,403500,95946
811,658,153,664,261200,95947
3702,2138,1564,919,245300,95948
8113,7255,858,1575,425000,95949
187,105,82,871,-,95950
917,553,364,734,215000,95951
3236,2036,1200,998,247800,95953
4533,3595,938,1069,191200,95954
549,382,167,995,227800,95955
177,177,0,-,249500,95956
260,159,101,913,244900,95957
7377,5630,1747,1363,473200,95959
305,200,105,1577,321300,95960
9171,5813,3358,1064,276400,95961
457,397,60,-,281300,95962
5608,3515,2093,913,260300,95963
7002,3967,3035,882,189500,95965
11290,8159,3131,975,231200,95966
437,311,126,929,164600,95968
8544,6348,2196,1057,269500,95969
234,127,107,938,371700,95970
2219,1245,974,1064,263100,95971
13845,8651,5194,1192,376600,95973
0,0,0,-,-,95974
722,556,166,1058,418300,95975
729,562,167,1416,386700,95977
62,6,56,757,-,95978
170,106,64,788,252100,95979
10,10,0,-,-,95981
1164,933,231,1117,280400,95982
152,118,34,936,-,95983
123,63,60,-,-,95984
47,42,5,-,275000,95986
1738,1042,696,1257,273400,95987
3255,1712,1543,793,229100,95988
14200,6703,7497,1069,267300,95991
12651,8767,3884,1196,343300,95993
13410,8001,5409,1010,299600,96001
12443,7667,4776,1078,257700,96002
18329,10987,7342,1185,278700,96003
256,228,28,-,150500,96006
9366,6127,3239,961,226800,96007
529,460,69,1322,223800,96008
143,106,37,879,274200,96009
36,24,12,-,-,96010
87,56,31,600,125000,96011
1779,1154,625,814,165700,96013
90,50,40,-,108300,96014
46,25,21,-,-,96015
166,126,40,-,164000,96016
105,74,31,755,268800,96017
3949,2574,1375,1093,203700,96019
1183,919,264,714,216700,96020
5262,3362,1900,872,192700,96021
5850,4607,1243,1084,247400,96022
507,394,113,706,115200,96023
401,319,82,1064,275000,96024
998,631,367,842,194300,96025
925,710,215,954,238100,96027
411,276,135,-,283800,96028
65,54,11,763,331300,96029
46,42,4,-,154200,96031
1129,744,385,891,260800,96032
202,159,43,1330,115800,96033
140,99,41,845,277500,96034
1528,990,538,959,214400,96035
96,54,42,-,-,96037
279,190,89,832,200000,96038
435,262,173,761,153500,96039
33,33,0,-,-,96040
1179,612,567,710,236700,96041
476,321,155,814,174600,96044
59,33,26,-,-,96046
352,300,52,638,350900,96047
415,371,44,709,332400,96048
21,14,7,-,-,96049
234,193,41,-,174500,96050
563,459,104,1083,233100,96051
691,514,177,687,278200,96052
129,102,27,-,156800,96054
1582,1127,455,1084,237900,96055
791,640,151,633,290900,96056
537,383,154,981,223000,96057
176,121,55,1625,216900,96058
209,180,29,-,349000,96059
0,0,0,-,-,96061
486,382,104,1111,333900,96062
99,66,33,673,167900,96063
1833,1324,509,799,189400,96064
126,84,42,650,266300,96065
3602,2265,1337,1206,298800,96067
49,20,29,-,-,96068
471,452,19,913,274500,96069
11,11,0,-,-,96071
1619,1483,136,2127,433000,96073
27,22,5,-,-,96074
157,102,55,-,-,96075
88,62,26,-,173200,96076
12084,7633,4451,980,235800,96080
194,167,27,-,209700,96084
15,15,0,-,157500,96085
131,93,38,938,177500,96086
257,200,57,1164,305400,96087
2326,2103,223,1007,244700,96088
213,137,76,950,177900,96090
359,287,72,918,312200,96091
93,55,38,-,313600,96092
1720,1098,622,824,285900,96093
2930,1824,1106,873,231900,96094
283,246,37,1000,308500,96096
4227,2702,1525,822,185200,96097
2109,1592,517,803,147900,96101
626,518,108,1154,331300,96103
386,270,116,700,167400,96104
225,219,6,-,-,96105
206,89,117,-,491200,96106
400,230,170,892,238800,96107
61,46,15,-,-,96108
355,311,44,-,149800,96109
37,19,18,-,-,96110
68,68,0,-,533300,96111
83,58,25,375,255000,96112
439,200,239,863,-,96113
1357,1055,302,1155,268000,96114
97,92,5,-,181700,96115
98,98,0,-,"2,000,000+",96116
141,126,15,-,211900,96117
658,492,166,887,222100,96118
8,8,0,-,-,96119
311,255,56,981,365200,96120
117,72,45,-,123100,96121
1668,1209,459,773,209300,96122
13,9,4,-,212500,96123
136,108,28,-,-,96124
45,45,0,-,319400,96125
77,47,30,-,-,96126
354,336,18,-,279400,96128
89,89,0,-,-,96129
4814,3053,1761,938,210100,96130
28,21,7,-,-,96132
72,72,0,-,-,96133
713,503,210,672,119200,96134
111,111,0,-,576600,96135
7,7,0,-,-,96136
1615,1210,405,817,205600,96137
639,501,138,1242,693500,96140
196,174,22,1162,844800,96141
356,217,139,1409,481100,96142
1444,887,557,1272,493200,96143
1103,835,268,1092,702600,96145
454,209,245,1532,975400,96146
232,190,42,583,805600,96148
12647,6721,5926,1121,457500,96150
0,0,0,-,-,96155
6975,5567,1408,1826,617500,96161
13316,9062,4254,1784,745200,96701
702,594,108,1398,440100,96703
2814,1740,1074,1401,501600,96704
746,509,237,1411,466600,96705
20356,13944,6412,2462,619100,96706
13811,9518,4293,2057,616800,96707
3958,2277,1681,1958,868200,96708
102,102,0,-,552600,96710
2467,1372,1095,1690,1103100,96712
390,181,209,3115,372000,96713
438,196,242,1328,1051300,96714
902,646,256,1247,485600,96716
1265,649,616,1886,658700,96717
520,357,163,1046,587300,96719
17101,10785,6316,1099,342500,96720
848,660,188,1372,877600,96722
1292,802,490,1440,692600,96725
110,31,79,603,344100,96726
1506,1079,427,1052,381300,96727
166,131,35,1609,308300,96728
369,302,67,1102,147800,96729
489,305,184,1388,805700,96730
825,560,265,1573,625400,96731
8354,4944,3410,1341,616600,96732
15760,9884,5876,2855,1001200,96734
1781,1348,433,647,155800,96737
2810,1957,853,1628,476200,96738
14640,9642,4998,1410,587200,96740
2191,1490,701,1427,726600,96741
306,0,306,1122,-,96742
4636,2920,1716,1763,507200,96743
16156,12312,3844,1991,814200,96744
6647,4534,2113,1611,611000,96746
268,0,268,799,-,96747
1474,1018,456,856,311500,96748
6301,5078,1223,1098,296500,96749
1216,745,471,872,466300,96750
73,49,24,-,558600,96751
1020,682,338,1607,404700,96752
10988,6556,4432,1746,680900,96753
1212,973,239,2038,735800,96754
1227,1030,197,1109,421100,96755
2228,1240,988,1311,699600,96756
213,172,41,1243,361800,96757
324,0,324,3163,-,96759
1165,1040,125,1538,275100,96760
7461,3907,3554,1678,772900,96761
953,341,612,1884,887800,96762
1265,778,487,1113,462800,96763
276,226,50,1096,463200,96764
121,42,79,1635,384000,96765
5129,3294,1835,1416,566800,96766
6436,4660,1776,1542,675100,96768
127,0,127,742,-,96769
226,92,134,684,275000,96770
2779,2026,753,1042,196400,96771
1056,883,173,1008,313700,96772
53,32,21,-,833300,96773
83,83,0,-,270300,96774
493,328,165,1135,345700,96776
601,470,131,528,186300,96777
5964,4676,1288,1148,199800,96778
789,557,232,2118,797700,96779
233,157,76,694,297600,96780
371,279,92,827,335300,96781
11673,7818,3855,1992,666800,96782
649,404,245,463,340000,96783
1802,1370,432,1256,243900,96785
12762,3669,9093,2332,568600,96786
17717,13966,3751,2016,680400,96789
3321,2271,1050,1489,1025500,96790
2336,1469,867,1880,739300,96791
12316,7151,5165,1534,433000,96792
10376,7063,3313,1369,594300,96793
2166,1687,479,1275,628600,96795
679,269,410,1204,461200,96796
19049,12905,6144,1676,613100,96797
11265,5310,5955,1603,651900,96813
10706,4343,6363,1465,602400,96814
13953,6380,7573,1703,537300,96815
17646,10473,7173,1679,956300,96816
19033,7844,11189,1213,781000,96817
18766,6658,12108,2899,568200,96818
11719,5930,5789,1513,786400,96819
6470,5502,968,2538,1142000,96821
18600,10507,8093,1432,765800,96822
10128,8366,1762,2786,886000,96825
14901,4435,10466,1347,447800,96826
0,0,0,-,-,96850
0,0,0,-,-,96853
0,0,0,-,-,96857
0,0,0,-,-,96859
0,0,0,-,-,96860
0,0,0,-,-,96863
82,24,58,621,320000,97001
2270,1897,373,1063,402100,97002
1651,1462,189,1206,514600,97004
11850,4241,7609,1241,364700,97005
27309,14028,13281,1520,368500,97006
26407,19198,7209,1460,392600,97007
12581,7129,5452,1351,396400,97008
2919,2493,426,994,438900,97009
370,370,0,-,412900,97011
8505,5945,2560,1139,370200,97013
710,506,204,866,281800,97014
9403,5865,3538,1417,382200,97015
2615,2143,472,708,216100,97016
1245,1195,50,-,382400,97017
715,619,96,1111,307300,97018
1198,1046,152,1110,460400,97019
418,375,43,1533,174100,97020
553,380,173,1043,267200,97021
1532,1254,278,1514,404400,97022
4065,3445,620,1230,375900,97023
4565,2523,2042,1228,305500,97024
951,748,203,1286,269300,97026
4928,3047,1881,1409,342500,97027
127,98,29,-,-,97028
115,62,53,630,95900,97029
14978,6328,8650,1300,289400,97030
7331,4975,2356,1184,430500,97031
1808,1309,499,1335,326100,97032
26,7,19,-,-,97033
8155,6226,1929,1779,746100,97034
10962,7335,3627,1684,562300,97035
399,273,126,725,188300,97037
5522,4084,1438,1119,344100,97038
202,134,68,791,170200,97039
616,415,201,1127,345400,97040
882,613,269,799,354600,97041
1023,898,125,1081,452900,97042
20332,15226,5106,1312,409000,97045
2737,2114,623,772,269800,97048
809,727,82,1183,333200,97049
109,87,22,713,139600,97050
6360,4262,2098,968,251600,97051
1307,1205,102,865,408300,97053
603,582,21,721,282400,97054
6831,5408,1423,1207,352600,97055
4672,3436,1236,1319,329900,97056
6,4,2,-,-,97057
8101,5072,3029,814,224200,97058
6933,4708,2225,1195,331000,97060
11007,6393,4614,1389,455200,97062
374,339,35,-,200600,97063
1357,1112,245,1331,254000,97064
275,212,63,900,162500,97065
1058,708,350,1235,319900,97067
11267,9402,1865,1605,560000,97068
10007,4945,5062,1412,446800,97070
10001,6473,3528,1069,238300,97071
15745,11646,4099,1303,360600,97080
11689,7378,4311,1335,488900,97086
4562,4215,347,1576,464500,97089
1390,1016,374,1182,391300,97101
183,183,0,-,571200,97102
6910,4396,2514,927,303800,97103
1656,1395,261,1315,451600,97106
922,727,195,891,267700,97107
221,205,16,-,280300,97108
220,190,30,1538,448300,97109
577,195,382,893,558000,97110
1222,947,275,1331,380500,97111
767,551,216,1035,308600,97112
4919,3784,1135,1359,308100,97113
1473,1183,290,1190,286700,97114
1384,1161,223,-,353900,97115
9534,6097,3437,1150,360000,97116
255,217,38,-,464500,97117
325,195,130,1000,286100,97118
1749,1588,161,1230,455800,97119
553,356,197,925,282600,97121
166,142,24,-,253700,97122
16231,11337,4894,1332,362000,97123
20864,10236,10628,1619,391400,97124
25,25,0,-,430600,97125
1377,1186,191,1137,260700,97127
14389,9374,5015,1017,295500,97128
297,249,48,1275,441700,97130
1329,1035,294,1147,281500,97131
10602,7217,3385,1306,373000,97132
1813,1534,279,1458,454800,97133
67,55,12,-,398200,97134
408,351,57,-,377000,97135
823,641,182,1017,228100,97136
357,235,122,1076,437500,97137
4700,2454,2246,951,324200,97138
8739,6867,1872,1570,460500,97140
5295,3275,2020,893,257500,97141
74,74,0,-,391300,97144
186,145,41,-,676000,97145
2595,1720,875,1101,300000,97146
179,86,93,716,300000,97147
1096,884,212,1338,397800,97148
211,175,36,-,312900,97149
9310,2589,6721,1455,630600,97201
18194,9199,8995,1316,580200,97202
12805,7360,5445,1228,377300,97203
512,42,470,673,472400,97204
5286,1186,4100,1118,577200,97205
21211,13816,7395,1411,378500,97206
0,0,0,-,-,97208
13633,3244,10389,1295,520000,97209
6325,2319,4006,1369,792000,97210
14336,9252,5084,1528,495300,97211
11547,7672,3875,1418,678000,97212
14667,9378,5289,1289,476600,97213
14052,4343,9709,1415,613500,97214
7356,4487,2869,1345,552000,97215
7001,4081,2920,1233,336000,97216
14838,8644,6194,1493,440500,97217
5500,3184,2316,1265,381800,97218
17694,12811,4883,1432,519000,97219
11615,6143,5472,1185,337600,97220
4997,3777,1220,1355,641100,97221
16090,8656,7434,1299,348200,97222
20246,12657,7589,1368,441800,97223
14893,10324,4569,1365,428400,97224
11736,6111,5625,1414,556300,97225
3150,871,2279,1408,486800,97227
25804,17950,7854,1616,583800,97229
15326,9552,5774,1168,329400,97230
1675,1430,245,1258,716700,97231
7996,2033,5963,1361,632100,97232
13657,6636,7021,1124,276200,97233
12817,7407,5410,1253,310300,97236
9249,4411,4838,1425,612700,97239
13439,7421,6018,1270,313700,97266
13886,9954,3932,1241,361000,97267
19310,8297,11013,942,210100,97301
17021,10033,6988,994,296600,97302
15214,8971,6243,1072,281000,97303
12593,8303,4290,1128,322700,97304
14176,7843,6333,1075,226500,97305
12387,8289,4098,1179,310800,97306
8043,5562,2481,1184,281000,97317
10407,7801,2606,951,310600,97321
13743,7919,5824,1075,230100,97322
632,364,268,901,211100,97324
2296,1856,440,958,282900,97325
489,410,79,1034,291300,97326
1373,1106,267,1241,275100,97327
56,39,17,-,-,97329
17954,9147,8807,1131,381500,97330
0,0,0,-,-,97331
9775,4554,5221,1223,355200,97333
8517,6316,2201,936,275900,97338
1398,978,420,931,257400,97341
49,37,12,713,181300,97342
135,100,35,-,344800,97343
567,420,147,1010,191000,97344
192,128,64,1296,257100,97345
393,325,68,875,196000,97346
653,418,235,488,221700,97347
587,453,134,829,232100,97348
54,46,8,1667,233300,97350
3511,2018,1493,1163,236700,97351
2037,1445,592,1043,279500,97352
12014,8073,3941,1041,233100,97355
120,110,10,-,325000,97357
1106,1032,74,796,270000,97358
901,636,265,1048,208300,97360
3985,2035,1950,1015,296400,97361
1540,1028,512,821,275700,97362
277,206,71,-,397700,97364
4766,2693,2073,939,280100,97365
880,693,187,992,312800,97366
4514,2808,1706,981,261100,97367
1388,1005,383,973,168000,97368
67,53,14,-,173600,97369
3314,2536,778,1015,305300,97370
304,143,161,777,471300,97371
0,0,0,-,-,97373
1817,1373,444,1066,372400,97374
395,375,20,1545,406000,97375
515,427,88,-,282800,97376
297,240,57,1204,331300,97377
3349,2323,1026,875,238400,97378
818,553,265,927,157100,97380
5739,3954,1785,1038,369400,97381
3859,2284,1575,950,294900,97383
34,34,0,-,-,97384
1355,957,398,1194,354800,97385
5878,4086,1792,952,192200,97386
460,375,85,1038,385900,97388
699,452,247,1302,283100,97389
614,509,105,900,276600,97390
2447,1524,923,904,257800,97391
1974,1667,307,939,341100,97392
2423,1846,577,821,246700,97394
1363,1036,327,927,232800,97396
21770,6500,15270,1026,354900,97401
21782,10344,11438,1032,228500,97402
4261,1963,2298,1035,407300,97403
13222,9351,3871,1227,270100,97404
19350,13419,5931,1135,357700,97405
162,162,0,-,-,97406
5787,3561,2226,1328,373700,97408
278,148,130,848,331100,97410
3411,2354,1057,912,312000,97411
230,211,19,1042,252600,97412
475,265,210,814,351200,97413
73,29,44,-,-,97414
6462,4783,1679,946,312300,97415
404,347,57,589,212500,97416
1093,675,418,778,132800,97417
385,330,55,974,328100,97419
12092,7924,4168,838,214000,97420
3006,2321,685,780,187200,97423
7310,4897,2413,864,238600,97424
3758,2846,912,1240,301200,97426
355,244,111,674,316000,97429
160,126,34,1250,281800,97430
745,612,133,1504,276700,97431
296,198,98,810,275000,97434
934,710,224,802,203100,97435
338,251,87,870,246800,97436
928,756,172,839,307400,97437
424,355,69,1107,315000,97438
7552,5488,2064,987,287700,97439
155,32,123,844,-,97441
1052,639,413,846,228800,97442
1006,618,388,670,288100,97443
2691,1898,793,959,272100,97444
1991,1533,458,1078,238300,97446
210,133,77,-,301200,97447
5255,3681,1574,858,293000,97448
1004,821,183,962,194500,97449
272,244,28,-,254800,97450
167,167,0,-,292500,97451
594,538,56,852,216800,97452
378,274,104,723,239400,97453
411,365,46,973,293900,97454
991,808,183,1205,407400,97455
1200,940,260,748,268200,97456
4100,3069,1031,790,184400,97457
2072,1413,659,697,196900,97458
5737,3828,1909,860,255300,97459
372,322,50,-,426000,97461
1669,1241,428,837,261100,97462
1658,1008,650,786,156000,97463
1055,684,371,820,203500,97465
450,345,105,608,136900,97466
2242,1483,759,632,153100,97467
1076,826,250,873,169200,97469
8589,5644,2945,900,188700,97470
12946,9478,3468,963,238800,97471
143,125,18,-,241700,97473
148,148,0,-,218100,97476
16194,8164,8030,920,239400,97477
14735,10370,4365,1098,257800,97478
4410,2943,1467,945,191400,97479
137,108,29,-,181300,97480
346,292,54,-,167900,97481
69,47,22,588,252800,97484
324,311,13,-,288800,97486
3581,2917,664,1109,234700,97487
474,426,48,950,361500,97488
384,330,54,-,358800,97489
132,92,40,1297,218800,97490
509,460,49,971,214200,97492
125,103,22,731,321300,97493
51,51,0,-,-,97494
681,566,115,1003,360300,97495
2967,1925,1042,890,186800,97496
744,573,171,434,313700,97497
868,670,198,1004,312400,97498
821,642,179,704,216100,97499
18685,10029,8656,993,224300,97501
11211,8250,2961,1067,297900,97502
4364,3416,948,1010,195800,97503
19656,11731,7925,1113,327000,97504
11717,7005,4712,1097,461900,97520
270,208,62,825,206900,97522
2771,2131,640,735,240100,97523
6002,4603,1399,1235,309100,97524
1909,1592,317,1116,331700,97525
14783,9393,5390,916,277400,97526
15275,10593,4682,994,295800,97527
3451,2373,1078,1373,442900,97530
134,123,11,-,248100,97531
1105,925,180,874,313800,97532
458,374,84,-,170600,97534
2289,1477,812,884,206400,97535
511,370,141,625,206900,97536
2879,2036,843,920,266500,97537
719,625,94,712,275700,97538
1522,1101,421,993,185700,97539
3886,2355,1531,1114,262400,97540
691,600,91,1004,226900,97541
198,150,48,-,345100,97543
1066,805,261,1303,354400,97544
10107,5687,4420,779,201900,97601
12200,7798,4402,818,183500,97603
0,0,0,-,-,97604
75,26,49,331,256300,97620
126,103,23,-,441800,97621
166,112,54,-,153400,97622
1161,956,205,729,183800,97623
1591,1347,244,825,207100,97624
100,81,19,655,318800,97625
58,31,27,-,-,97626
206,195,11,-,167600,97627
2009,1376,633,743,155300,97630
531,349,182,488,131000,97632
545,370,175,672,157600,97633
98,93,5,-,202800,97634
94,54,40,-,126700,97635
220,92,128,528,89200,97636
54,36,18,542,216700,97637
188,108,80,764,212500,97638
177,134,43,-,-,97639
94,53,41,-,242200,97640
783,435,348,715,-,97641
29648,18659,10989,1357,478600,97701
20316,13941,6375,1395,414000,97702
2643,2133,510,1240,363400,97707
52,22,30,-,300000,97710
16,15,1,-,-,97711
20,0,20,-,-,97712
1944,1346,598,708,118900,97720
100,70,30,-,-,97721
25,10,15,-,350000,97722
116,96,20,1607,466700,97730
208,55,153,-,307100,97731
46,28,18,606,-,97732
239,139,100,661,137500,97733
1157,871,286,921,218400,97734
37,37,0,-,-,97735
36,11,25,-,162500,97736
236,167,69,-,277000,97737
823,699,124,767,144300,97738
5416,4174,1242,1036,235600,97739
4430,2586,1844,839,227800,97741
157,101,56,771,187500,97750
27,18,9,-,-,97751
0,0,0,-,-,97752
1021,808,213,1343,521700,97753
8913,6483,2430,903,247200,97754
15252,10234,5018,1163,310800,97756
32,16,16,475,350000,97758
3258,2763,495,1253,507000,97759
3076,2763,313,1054,298200,97760
1030,594,436,468,114000,97761
7247,4261,2986,779,199100,97801
444,350,94,1056,263100,97810
340,227,113,1053,124300,97812
553,443,110,775,142400,97813
5275,3706,1569,705,182200,97814
7,7,0,-,-,97817
1433,923,510,643,154000,97818
12,4,8,-,-,97819
443,351,92,683,167900,97820
539,431,108,745,107900,97823
722,582,140,873,296700,97824
170,134,36,675,189100,97825
452,272,180,781,275000,97826
1109,874,235,782,167300,97827
1429,946,483,639,238400,97828
342,288,54,719,149000,97830
338,263,75,710,284200,97833
571,332,239,693,266000,97834
180,136,44,920,193800,97835
914,614,300,595,176200,97836
57,44,13,-,70000,97837
8938,5995,2943,813,204700,97838
128,111,17,1047,164800,97839
48,36,12,-,-,97840
195,156,39,1141,256600,97841
54,35,19,-,-,97842
312,219,93,775,185100,97843
1274,1084,190,940,156100,97844
1062,749,313,745,134200,97845
947,719,228,799,298200,97846
90,60,30,-,295500,97848
7071,4299,2772,834,198500,97850
205,110,95,610,153800,97856
246,209,37,706,283700,97857
72,59,13,-,-,97859
4462,2777,1685,621,157100,97862
168,136,32,586,-,97864
680,533,147,540,215000,97865
368,291,77,690,116200,97867
676,546,130,793,129200,97868
448,367,81,760,138500,97869
318,236,82,550,171700,97870
140,113,27,665,76800,97873
184,135,49,660,230700,97874
1059,818,241,978,138800,97875
357,290,67,1188,356100,97876
203,197,6,-,110500,97877
167,128,39,713,-,97880
2258,1511,747,775,159200,97882
974,692,282,911,157800,97883
62,50,12,900,216700,97884
519,403,116,717,211000,97885
348,257,91,995,136300,97886
269,184,85,666,240900,97901
10,10,0,-,-,97903
117,81,36,525,563900,97904
44,19,25,-,186500,97905
95,59,36,596,203100,97906
238,185,53,529,92000,97907
17,12,5,-,85000,97908
0,0,0,-,-,97909
214,122,92,574,175000,97910
60,35,25,525,119300,97911
1777,1064,713,765,120400,97913
5945,3494,2451,682,145400,97914
1652,994,658,735,173400,97918
19,10,9,-,-,97920
11648,8779,2869,1587,361400,98001
13162,6151,7011,1188,270300,98002
18515,8722,9793,1312,326900,98003
17460,6950,10510,2252,1445500,98004
8590,4462,4128,1989,963600,98005
13030,10311,2719,2366,925200,98006
11578,3929,7649,1927,664200,98007
9125,6756,2369,2033,803100,98008
2286,1946,340,1909,507100,98010
13318,8350,4968,1759,598200,98011
24755,16738,8017,1860,556800,98012
2773,2489,284,1578,607300,98014
4042,3761,281,2387,546300,98019
8590,6403,2187,1659,667200,98020
11534,9203,2331,2061,610200,98021
8484,6363,2121,1234,389800,98022
17466,10989,6477,1605,374100,98023
2293,2015,278,1708,783200,98024
14864,11050,3814,1486,528100,98026
12074,8491,3583,1867,729100,98027
9296,6796,2500,1430,617000,98028
11853,7779,4074,2314,705800,98029
12608,6263,6345,1544,367900,98030
12646,8591,4055,1467,398900,98031
13942,5393,8549,1445,335900,98032
16701,10724,5977,1936,930800,98033
18126,10715,7411,1875,613400,98034
14821,9075,5746,1456,480000,98036
11036,6433,4603,1575,468200,98037
12308,10626,1682,1907,476000,98038
1213,1010,203,"3,500+","2,000,000+",98039
10128,6779,3349,2166,1386300,98040
16810,14006,2804,1720,413100,98042
8554,4556,3998,1595,424700,98043
5718,4560,1158,1474,542900,98045
2380,1210,1170,1425,301800,98047
173,173,0,-,602800,98050
1621,1391,230,1653,486300,98051
28404,14708,13696,2003,799600,98052
8572,7177,1395,2370,836200,98053
9337,4948,4389,1742,406400,98055
14560,8249,6311,1640,558200,98056
5711,1334,4377,1375,397500,98057
15798,11150,4648,1719,433100,98058
14016,11100,2916,1849,600900,98059
5415,4671,744,2140,633000,98065
251,245,6,-,506300,98068
4665,3901,764,1188,551400,98070
9646,7126,2520,1953,727600,98072
9567,8440,1127,2394,854400,98074
7814,6916,898,2498,984500,98075
4856,4399,457,2115,850000,98077
15132,8091,7041,1697,433600,98087
16799,12033,4766,1511,408300,98092
9870,1243,8627,2020,643300,98101
16219,4266,11953,1696,796700,98102
26314,11738,14576,1743,785800,98103
8637,1091,7546,1282,673300,98104
17332,5615,11717,1508,989500,98105
11354,5757,5597,1354,478700,98106
14846,5772,9074,1862,756900,98107
8595,4685,3910,1181,522900,98108
18617,4107,14510,2000,739900,98109
10170,8225,1945,1612,783600,98110
11846,6843,5003,1698,1063200,98112
23430,14136,9294,1817,831000,98115
13120,7483,5637,1697,721700,98116
15301,10861,4440,1772,778100,98117
18077,10763,7314,1550,571500,98118
13762,5636,8126,1712,918600,98119
13511,3469,10042,2114,690900,98121
21237,6230,15007,1734,721500,98122
19643,9110,10533,1575,617600,98125
10437,6035,4402,1449,589600,98126
22212,10507,11705,1485,548500,98133
215,102,113,1896,397000,98134
7855,5268,2587,1620,713300,98136
14263,6852,7411,1505,706200,98144
10336,6458,3878,1429,460000,98146
4504,1955,2549,1470,401800,98148
0,0,0,-,-,98154
13422,9693,3729,1647,590100,98155
0,0,0,-,-,98158
126,101,25,-,657800,98164
8887,5783,3104,1334,572100,98166
11464,6074,5390,1343,353900,98168
0,0,0,-,-,98174
8178,6688,1490,1615,769600,98177
9760,6476,3284,1541,444600,98178
10018,4519,5499,1314,320400,98188
0,0,0,-,-,98195
14423,7729,6694,1467,371200,98198
10296,6249,4047,1958,889700,98199
13138,5563,7575,1108,347000,98201
13844,8764,5080,1398,385800,98203
16982,6221,10761,1391,279900,98204
5369,4347,1022,1838,386100,98205
0,0,0,-,-,98207
21072,14825,6247,1619,430500,98208
249,191,58,-,349500,98220
9760,6908,2852,1249,463800,98221
49,49,0,-,605800,98222
17601,13449,4152,1422,384600,98223
132,119,13,1413,401600,98224
21812,9008,12804,1119,419400,98225
18733,11583,7150,1167,384000,98226
13265,9521,3744,1183,390900,98229
7506,5628,1878,1080,306500,98230
1719,1465,254,1719,461800,98232
6284,4056,2228,1190,310700,98233
29,29,0,-,185900,98235
2517,1971,546,1216,475400,98236
1833,1366,467,924,255500,98237
40,0,40,-,-,98238
3505,2895,610,987,413000,98239
1091,979,112,1266,340600,98240
863,556,307,808,250400,98241
287,200,87,1175,931000,98243
1388,1040,348,859,326900,98244
1899,1408,491,1011,488900,98245
3167,2168,999,971,326500,98247
9405,7040,2365,1009,378300,98248
2244,1808,436,1280,423400,98249
4001,2926,1075,1103,527400,98250
1793,1500,293,1031,249100,98251
3793,2955,838,1141,352700,98252
847,819,28,-,545000,98253
97,86,11,-,172200,98255
169,123,46,950,263900,98256
2020,1547,473,941,345000,98257
11405,9079,2326,1580,398800,98258
2894,2204,690,1116,470100,98260
1452,1130,322,1077,514300,98261
474,416,58,753,467400,98262
21,15,6,-,206300,98263
7847,5094,2753,1194,363000,98264
1358,808,550,913,169700,98266
113,84,29,-,111400,98267
18803,13114,5689,1420,358400,98270
10598,8226,2372,1482,352000,98271
9282,7265,2017,1568,418700,98272
11548,7162,4386,987,313900,98273
6852,5341,1511,1377,363900,98274
8270,5614,2656,1839,624900,98275
219,201,18,1045,296900,98276
15975,8798,7177,1272,316200,98277
0,0,0,-,-,98278
371,238,133,1281,630800,98279
206,176,30,950,743600,98280
608,504,104,845,264800,98281
7344,6632,712,1403,415400,98282
155,128,27,-,311100,98283
9565,6775,2790,1181,287200,98284
98,79,19,-,765000,98286
100,70,30,900,276700,98288
13592,10790,2802,1157,495900,98290
8642,6986,1656,1393,411400,98292
2813,2163,650,1296,280000,98294
1012,617,395,1042,241700,98295
10043,8957,1086,1994,588300,98296
40,38,2,-,321400,98297
803,734,69,1166,382600,98303
436,358,78,742,179500,98304
154,127,27,-,189100,98305
8785,4439,4346,1148,285100,98310
10436,7578,2858,1426,296400,98311
12593,7802,4791,1203,293100,98312
21,0,21,-,-,98314
1201,13,1188,1783,-,98315
625,532,93,844,238900,98320
5840,4901,939,1380,384900,98321
272,238,34,1375,278200,98323
557,524,33,-,220400,98325
360,219,141,889,172000,98326
3906,2095,1811,1844,343400,98327
3778,3138,640,1058,345900,98328
3988,3545,443,1448,328600,98329
61,61,0,-,-,98330
2395,1490,905,711,171500,98331
7088,5844,1244,1787,494900,98332
1368,1284,84,1807,716700,98333
10604,8122,2482,1539,527300,98335
307,271,36,-,172900,98336
3513,1617,1896,1077,248800,98337
10136,8826,1310,1453,319300,98338
1441,1066,375,825,292000,98339
1708,1445,263,1679,330300,98340
600,487,113,1382,471900,98342
205,51,154,979,513900,98345
3881,3089,792,1395,432700,98346
2060,1802,258,997,256600,98349
136,65,71,504,56600,98350
673,565,108,816,439400,98351
18,0,18,-,-,98353
2902,1721,1181,1394,339000,98354
339,287,52,-,-,98355
811,586,225,1009,169700,98356
539,384,155,447,103300,98357
445,349,96,1173,560800,98358
1888,1652,236,876,417000,98359
4898,4097,801,1513,316800,98360
381,287,94,994,170900,98361
10715,7055,3660,927,252600,98362
5955,4429,1526,1025,252000,98363
40,0,40,-,-,98364
2385,2146,239,1791,436000,98365
13838,8850,4988,1264,316000,98366
11736,9671,2065,1406,353900,98367
8018,5758,2260,970,366000,98368
13063,9830,3233,1458,404700,98370
8454,5957,2497,1231,337700,98371
10483,5870,4613,1356,376800,98372
9663,5690,3973,1433,356900,98373
14951,10292,4659,1662,340400,98374
10179,7464,2715,1783,314100,98375
926,770,156,937,302300,98376
891,651,240,493,163000,98377
1623,1395,228,-,427600,98380
110,80,30,789,233300,98381
13487,10359,3128,1078,318700,98382
9053,4895,4158,1625,401900,98383
157,150,7,-,303100,98385
16353,12142,4211,1401,278800,98387
2585,1634,951,1226,394500,98388
4669,2474,2195,1419,350900,98390
18003,15404,2599,1672,384600,98391
1341,972,369,1088,297100,98392
476,431,45,1313,374000,98394
297,239,58,1375,297100,98396
3737,755,2982,1222,412100,98402
4197,1668,2529,1042,480900,98403
12534,7746,4788,1141,251300,98404
9882,4740,5142,1142,300500,98405
10004,6189,3815,1275,380800,98406
9533,5869,3664,1510,413300,98407
7980,4817,3163,1240,247200,98408
11116,4449,6667,1280,253100,98409
0,0,0,-,-,98416
4047,2542,1505,1282,246200,98418
0,0,0,-,-,98421
7905,5978,1927,1690,426400,98422
4221,1888,2333,1434,334500,98424
0,0,0,-,-,98430
4399,73,4326,1781,278500,98433
3,0,3,-,-,98438
2151,202,1949,1106,-,98439
2124,1843,281,1212,348900,98443
13011,5528,7483,1172,235900,98444
11546,8318,3228,1393,276400,98445
4116,3050,1066,1415,331400,98446
0,0,0,-,-,98447
3217,1731,1486,1182,378100,98465
11924,6338,5586,1268,380600,98466
6113,3658,2455,1214,389900,98467
11400,6613,4787,1210,329000,98498
13123,4435,8688,1091,280500,98499
17697,10333,7364,1242,353300,98501
13914,7837,6077,1224,386500,98502
17131,9391,7740,1287,271100,98503
8443,5668,2775,1049,343800,98506
12370,8439,3931,1318,323800,98512
13461,9899,3562,1532,290600,98513
9771,7348,2423,1504,364900,98516
8644,5133,3511,823,166700,98520
1625,1414,211,-,354500,98524
80,46,34,805,141700,98526
127,122,5,-,116700,98527
4805,3693,1112,977,248900,98528
211,154,57,971,142300,98530
10553,6278,4275,940,193700,98531
9543,6852,2691,942,274900,98532
229,167,62,-,198600,98533
319,273,46,-,-,98535
40,40,0,-,-,98536
942,752,190,709,195800,98537
133,83,50,1125,293800,98538
4048,2816,1232,813,197000,98541
316,203,113,-,316700,98542
22,22,0,-,-,98544
1494,1270,224,1123,323300,98546
751,598,153,1059,159500,98547
1045,950,95,1205,218500,98548
4914,3139,1775,787,149700,98550
202,190,12,675,110300,98552
166,166,0,-,134700,98555
1324,1042,282,888,215400,98557
0,0,0,-,-,98558
0,0,0,-,-,98559
51,51,0,-,275900,98560
49,0,49,-,-,98562
3149,2474,675,876,215300,98563
1110,920,190,704,188800,98564
238,135,103,904,213800,98565
1093,851,242,722,241400,98568
3413,2674,739,879,250800,98569
1531,1262,269,798,243900,98570
95,28,67,-,-,98571
343,248,95,753,148800,98572
55,44,11,-,166700,98575
1947,1642,305,970,285800,98576
2753,2259,494,853,163000,98577
4988,4009,979,1035,276000,98579
4474,3629,845,1702,302700,98580
268,268,0,-,141000,98581
50,50,0,-,373700,98582
43,22,21,-,271400,98583
13761,10032,3729,1035,234500,98584
347,268,79,632,290200,98585
725,517,208,665,145400,98586
269,196,73,610,85400,98587
784,686,98,-,257900,98588
2681,2016,665,1108,278200,98589
244,222,22,331,-,98590
1476,1273,203,726,274900,98591
731,703,28,-,279300,98592
413,353,60,890,168200,98593
1172,802,370,866,197800,98595
2628,2082,546,962,226300,98596
9052,6961,2091,1345,268000,98597
1098,919,179,1361,340300,98601
76,63,13,-,425000,98602
451,352,99,-,269700,98603
12728,10294,2434,1250,386500,98604
472,313,159,1108,242800,98605
3338,3085,253,1153,471200,98606
11186,8666,2520,1349,454000,98607
1245,879,366,1012,253700,98610
3211,2622,589,997,253100,98611
1332,1201,131,913,238800,98612
154,119,35,1075,238800,98613
112,112,0,-,-,98614
45,45,0,-,335700,98616
505,323,182,926,201200,98617
264,205,59,866,252300,98619
3299,2216,1083,791,170700,98620
151,139,12,-,196000,98621
682,536,146,809,238900,98624
2736,2058,678,1067,308300,98625
9991,6916,3075,906,236800,98626
127,82,45,795,163600,98628
2879,2533,346,1494,395400,98629
1543,1109,434,697,242100,98631
20842,12254,8588,878,224300,98632
715,479,236,938,370400,98635
607,525,82,918,188700,98638
370,271,99,870,303500,98639
2372,2145,227,920,200400,98640
10,10,0,-,-,98641
7419,6269,1150,1695,443600,98642
139,123,16,-,234500,98643
278,242,36,-,181300,98644
679,619,60,-,325800,98645
162,149,13,-,-,98647
1275,934,341,755,328100,98648
315,278,37,565,273300,98649
482,422,60,797,536100,98650
455,411,44,696,497000,98651
5492,2489,3003,968,320500,98660
19463,8763,10700,1166,305300,98661
12479,8039,4440,1478,303400,98662
6304,3603,2701,1179,297900,98663
9174,5750,3424,1317,317500,98664
10566,6599,3967,1293,324600,98665
19,19,0,-,279200,98670
8423,6748,1675,1270,378300,98671
2893,2149,744,1052,379600,98672
227,131,96,850,144600,98673
5052,3596,1456,952,357000,98674
2127,1955,172,1114,375700,98675
22017,15100,6917,1443,318100,98682
13361,7672,5689,1404,367400,98683
11566,6537,5029,1535,324200,98684
11502,9330,2172,1561,397100,98685
7393,5493,1900,1442,381300,98686
16754,9870,6884,966,289200,98801
11530,7994,3536,1013,314200,98802
59,29,30,-,69100,98811
1771,924,847,790,167600,98812
898,498,400,751,126500,98813
400,282,118,796,387200,98814
2709,1971,738,816,327300,98815
2295,1416,879,952,354300,98816
88,88,0,-,-,98817
140,74,66,663,188200,98819
332,153,179,-,-,98821
744,583,161,1133,253400,98822
4027,2815,1212,823,175500,98823
142,26,116,778,162500,98824
3273,2317,956,961,456100,98826
184,47,137,-,-,98827
777,637,140,1056,284900,98828
135,101,34,-,406000,98829
259,178,81,439,141000,98830
1334,808,526,706,287600,98831
87,72,15,-,160200,98832
68,52,16,-,-,98833
86,82,4,-,275000,98834
315,207,108,-,443400,98836
15238,9634,5604,884,208800,98837
1902,1127,775,686,211300,98840
3879,2602,1277,709,175700,98841
807,403,404,-,378700,98843
2062,1548,514,656,203200,98844
101,75,26,825,236800,98845
464,336,128,686,234600,98846
698,574,124,941,335000,98847
3439,2273,1166,720,183800,98848
559,333,226,861,253100,98849
587,446,141,1059,190500,98850
1781,1364,417,639,163500,98851
7,7,0,-,-,98852
7,7,0,-,-,98853
2616,1821,795,716,180700,98855
1141,675,466,780,322600,98856
1195,840,355,652,142600,98857
802,575,227,824,200200,98858
60,60,0,-,120000,98859
105,96,9,775,88300,98860
1264,900,364,745,425600,98862
10648,5464,5184,794,179900,98901
16484,8586,7898,820,155500,98902
5711,4410,1301,1055,183100,98903
14444,10403,4041,1100,262100,98908
78,0,78,-,-,98921
3242,2474,768,943,383000,98922
501,170,331,762,113600,98923
263,219,44,-,340300,98925
13851,7489,6362,1053,301200,98926
0,0,0,-,-,98929
4627,2570,2057,847,171800,98930
1395,776,619,912,134600,98932
354,242,112,827,162700,98933
416,253,163,1101,169800,98934
1102,743,359,858,124600,98935
1996,1730,266,1280,216100,98936
1760,1286,474,831,239100,98937
523,346,177,1068,184400,98938
28,28,0,-,-,98939
192,152,40,-,278800,98940
297,211,86,919,330600,98941
6936,4842,2094,1068,255300,98942
455,300,155,1196,208800,98943
6751,4187,2564,747,159700,98944
210,149,61,865,377600,98946
894,537,357,690,150700,98947
3484,2122,1362,705,151600,98948
9,0,9,-,-,98950
3637,2061,1576,722,148100,98951
569,340,229,525,91100,98952
2211,1641,570,1015,257000,98953
1623,816,807,959,173800,99001
1670,1508,162,670,310100,99003
8007,4562,3445,949,253300,99004
3290,3096,194,1655,348900,99005
5063,4327,736,761,256200,99006
191,124,67,635,122500,99008
1816,1543,273,717,237900,99009
826,6,820,1359,-,99011
308,248,60,712,169900,99012
646,427,219,441,176000,99013
6549,4763,1786,1133,314900,99016
61,57,4,-,64400,99017
116,97,19,1094,170800,99018
4344,2965,1379,1270,349700,99019
0,0,0,-,-,99020
3441,3069,372,944,275800,99021
3230,2483,747,691,237400,99022
199,199,0,-,323700,99023
2075,1911,164,768,290800,99025
3241,3098,143,950,285100,99026
2350,2172,178,1379,261100,99027
494,403,91,797,276800,99029
409,374,35,927,183800,99030
503,411,92,636,243700,99031
313,250,63,839,102000,99032
355,262,93,660,152200,99033
72,13,59,-,-,99034
709,605,104,1446,470600,99036
5703,3718,1985,990,277700,99037
58,50,8,-,117600,99039
369,278,91,398,119000,99040
586,510,76,759,224700,99101
220,149,71,923,142600,99102
194,158,36,900,180800,99103
21,13,8,-,67500,99105
2075,1579,496,685,215000,99109
617,429,188,664,306900,99110
1656,1097,559,750,173000,99111
264,223,41,781,226500,99113
5050,3725,1325,740,218600,99114
506,372,134,571,140800,99115
775,574,201,844,153300,99116
230,201,29,-,156700,99117
363,283,80,725,271200,99118
556,492,64,669,221100,99119
112,88,24,-,362500,99121
1722,1355,367,742,201700,99122
423,346,77,774,199300,99123
138,104,34,750,137500,99124
247,158,89,828,110400,99125
288,212,76,742,128900,99126
164,148,16,825,265700,99128
283,192,91,481,124100,99129
342,253,89,833,166600,99130
117,86,31,-,236700,99131
803,459,344,625,139200,99133
260,205,55,769,138800,99134
166,143,23,911,-,99135
12,12,0,-,120000,99136
178,106,72,507,177500,99137
409,289,120,463,149300,99138
561,480,81,752,248800,99139
214,149,65,437,158000,99140
2471,1778,693,913,178500,99141
333,287,46,604,114500,99143
9,5,4,-,-,99144
22,22,0,-,-,99146
87,87,0,-,360300,99147
947,872,75,826,271300,99148
85,77,8,-,67500,99149
141,133,8,-,218900,99150
83,72,11,-,133100,99151
55,48,7,-,155000,99152
251,140,111,600,160400,99153
11,11,0,-,168800,99154
467,286,181,525,109400,99155
3694,2876,818,812,255400,99156
301,208,93,681,151300,99157
220,163,57,818,143100,99158
654,493,161,739,120300,99159
71,67,4,-,153100,99160
603,527,76,603,211200,99161
12864,3991,8873,857,287600,99163
0,0,0,-,-,99164
1300,906,394,706,170300,99166
322,300,22,663,232100,99167
1157,790,367,713,138400,99169
402,317,85,592,135100,99170
443,323,120,805,172500,99171
608,490,118,700,168700,99173
21,13,8,-,102500,99174
71,57,14,821,209000,99176
170,110,60,755,266700,99179
433,335,98,734,242100,99180
801,710,91,900,182300,99181
526,401,125,765,184600,99185
7360,2081,5279,689,162400,99201
7852,3555,4297,875,166300,99202
9183,6926,2257,1112,303900,99203
3716,1169,2547,809,254600,99204
17926,11948,5978,1038,177200,99205
16205,10067,6138,881,250700,99206
12623,6253,6370,938,142700,99207
22139,14459,7680,908,269600,99208
8786,6031,2755,998,196500,99212
11013,5062,5951,983,220900,99216
7111,4801,2310,1026,208400,99217
6490,3264,3226,944,292100,99218
13950,8860,5090,978,309800,99223
9314,6343,2971,1023,280300,99224
24402,17047,7355,924,229800,99301
3511,2911,600,953,215900,99320
67,0,67,-,-,99321
226,205,21,607,-,99322
1356,1121,235,902,243500,99323
3865,2360,1505,875,216000,99324
1520,940,580,873,163800,99326
1629,1176,453,768,202700,99328
42,28,14,1091,125000,99329
274,225,49,-,224600,99330
25,23,2,-,510400,99333
72,58,14,492,102100,99335
19569,10192,9377,928,202800,99336
11094,9900,1194,1165,246400,99337
6027,5402,625,1253,357000,99338
271,167,104,716,89200,99341
763,478,285,845,210700,99343
5093,3029,2064,840,169500,99344
80,49,31,688,321200,99345
199,176,23,-,190900,99346
1009,755,254,564,155400,99347
479,181,298,746,150500,99348
2642,1486,1156,980,231500,99349
4941,2980,1961,833,208500,99350
12814,8721,4093,1166,315400,99352
5173,4312,861,1404,299300,99353
9354,5612,3742,1072,247700,99354
61,24,37,688,67100,99356
1144,591,553,679,168500,99357
91,65,26,491,118800,99359
536,391,145,1011,301900,99360
733,563,170,703,233200,99361
15734,9927,5807,985,254400,99362
69,27,42,-,137500,99363
133,84,49,700,80000,99371
120,120,0,-,268000,99401
659,553,106,720,243300,99402
8534,6051,2483,824,207300,99403
7256,2755,4501,1068,334600,99501
8994,6202,2792,1348,350500,99502
6167,1923,4244,977,241500,99503
15522,10709,4813,1377,248500,99504
1023,0,1023,2265,-,99505
2133,10,2123,1834,-,99506
13485,9414,4071,1419,313300,99507
12815,6571,6244,1201,252400,99508
0,0,0,-,-,99510
0,0,0,-,-,99513
7624,5970,1654,1467,337700,99515
7117,6458,659,1773,470100,99516
6892,3922,2970,1278,318000,99517
4172,2562,1610,1416,267600,99518
0,0,0,-,-,99519
157,99,58,-,347700,99540
51,16,35,1321,25000,99546
9,8,1,-,95000,99547
20,13,7,-,162500,99548
22,17,5,-,49000,99549
68,62,6,-,175000,99550
106,82,24,475,-,99551
57,39,18,-,55000,99552
69,51,18,660,91400,99553
228,172,56,731,111400,99554
48,30,18,1188,206300,99555
1101,943,158,1051,190800,99556
196,131,65,1281,200800,99557
33,19,14,-,38800,99558
2322,955,1367,1474,263700,99559
75,59,16,725,47500,99561
140,100,40,725,76700,99563
16,12,4,725,80000,99564
13,6,7,-,187500,99565
28,10,18,-,-,99566
3062,2626,436,1323,349500,99567
161,157,4,-,192200,99568
14,9,5,-,85000,99569
127,39,88,1273,116300,99571
85,75,10,-,346800,99572
341,295,46,775,227800,99573
680,480,200,1415,340100,99574
20,12,8,-,207100,99575
776,414,362,1182,253300,99576
9649,6864,2785,1847,353300,99577
119,87,32,486,54500,99578
7,7,0,-,104200,99579
26,24,2,-,95000,99580
275,207,68,855,111400,99581
35,7,28,-,330000,99583
41,15,26,475,-,99585
151,118,33,345,287100,99586
894,469,425,1336,452300,99587
463,339,124,875,229300,99588
33,22,11,375,63300,99589
66,52,14,569,66000,99590
29,22,7,-,75700,99591
90,74,16,-,42500,99602
4243,3106,1137,1115,292100,99603
146,97,49,533,73100,99604
62,62,0,-,246700,99605
99,66,33,706,122700,99606
55,43,12,1063,151300,99607
72,52,20,663,48300,99609
774,636,138,924,213400,99610
5360,3920,1440,1016,236200,99611
335,210,125,825,108300,99612
154,74,80,1299,250000,99613
96,71,25,-,57500,99614
3990,1920,2070,1425,305800,99615
245,191,54,746,70700,99620
99,74,25,513,56900,99621
82,61,21,479,78800,99622
21,16,5,-,88300,99624
26,19,7,-,58300,99625
65,50,15,400,155000,99626
112,79,33,1058,61700,99627
158,109,49,700,66800,99628
92,76,16,535,90000,99630
86,49,37,-,270300,99631
236,161,75,610,23600,99632
133,79,54,1116,227100,99633
196,89,107,-,31300,99634
148,95,53,650,104900,99636
172,124,48,597,75600,99637
6,4,2,-,-,99638
490,418,72,761,227300,99639
51,23,28,886,153100,99640
143,103,40,-,75900,99641
90,61,29,863,110400,99643
62,43,19,-,154200,99644
8726,6807,1919,1137,268600,99645
12,12,0,-,-,99647
19,13,6,-,87500,99648
30,22,8,800,90000,99649
93,58,35,525,-,99650
4,3,1,-,-,99651
1151,870,281,1036,222100,99652
31,11,20,825,-,99653
19203,14553,4650,1130,261500,99654
186,157,29,550,23400,99655
6,6,0,-,-,99656
25,18,7,-,93300,99657
197,146,51,-,91800,99658
67,44,23,-,70000,99659
104,67,37,1000,-,99660
422,300,122,1153,181900,99661
96,68,28,-,60000,99662
153,123,30,850,198600,99663
1485,977,508,969,249500,99664
18,7,11,375,63000,99665
28,22,6,-,51700,99666
44,44,0,-,237500,99667
25,23,2,-,162500,99668
6345,4725,1620,1145,246200,99669
17,8,9,-,137500,99670
155,110,45,450,90000,99671
1305,1126,179,995,242300,99672
532,428,104,782,189500,99674
557,467,90,1198,196700,99676
11,7,4,-,92500,99677
260,183,77,700,71500,99678
61,31,30,694,33100,99679
122,83,39,538,65000,99680
63,45,18,850,12800,99681
131,92,39,783,31300,99682
172,158,14,-,119600,99683
158,93,65,1096,118100,99684
1045,245,800,1582,403200,99685
1523,1167,356,1136,169100,99686
1054,830,224,794,193300,99688
221,114,107,1071,171200,99689
30,30,0,-,73800,99690
57,43,14,-,68800,99691
62,0,62,1292,-,99692
96,36,60,910,76000,99693
525,388,137,682,182100,99694
0,0,0,-,-,99695
6903,3123,3780,1136,198700,99701
1011,5,1006,1949,-,99702
1964,12,1952,1995,-,99703
0,0,0,-,-,99704
8350,5942,2408,1359,231600,99705
3,2,1,-,-,99706
11969,7320,4649,1128,248500,99709
5413,4555,858,1041,275900,99712
466,361,105,1406,164100,99714
58,39,19,395,-,99720
61,37,24,825,135400,99721
70,55,15,-,-,99722
1360,546,814,1069,197200,99723
47,37,10,-,33800,99724
16,8,8,413,65000,99726
129,99,30,1104,76400,99727
114,99,15,-,178800,99729
32,30,2,-,52700,99730
9,2,7,-,-,99732
17,11,6,-,-,99733
0,0,0,-,-,99734
36,26,10,1000,65000,99736
1490,1118,372,1058,207700,99737
75,53,22,606,110900,99738
55,40,15,738,52500,99739
200,151,49,1013,104000,99740
192,133,59,1500,134700,99741
126,112,14,863,68900,99742
421,359,62,836,255700,99743
61,51,10,950,162500,99744
29,15,14,-,58800,99745
84,73,11,875,49600,99746
61,51,10,950,81000,99747
71,52,19,708,-,99748
78,65,13,850,89400,99749
137,104,33,775,86700,99750
32,19,13,875,109400,99751
922,370,552,1461,239700,99752
82,48,34,629,79100,99753
36,32,4,-,50000,99754
108,71,37,778,330000,99755
22,18,4,-,82500,99756
18,18,0,-,-,99757
51,26,25,775,-,99758
45,17,28,875,107800,99759
224,175,49,1056,108700,99760
90,72,18,975,115000,99761
1419,723,696,1479,249800,99762
96,59,37,600,106300,99763
85,58,27,1654,80000,99764
86,74,12,-,49200,99765
165,101,64,1042,96400,99766
17,15,2,-,72500,99767
65,53,12,325,80800,99768
172,159,13,883,111100,99769
155,108,47,463,72700,99770
76,65,11,1042,84500,99771
138,95,43,825,89600,99772
40,30,10,850,86700,99773
4,1,3,-,-,99774
113,0,113,1208,-,99775
30,19,11,775,-,99776
67,32,35,675,55000,99777
75,41,34,900,112500,99778
675,462,213,704,165900,99780
39,27,12,-,-,99781
126,78,48,785,94400,99782
66,53,13,-,73100,99783
61,38,23,888,86300,99784
127,95,32,650,71800,99785
80,69,11,-,77500,99786
40,35,5,-,29500,99788
109,53,56,900,89500,99789
12,12,0,-,212500,99790
36,28,8,1375,108300,99791
11850,7856,3994,1283,356000,99801
145,84,61,525,150000,99820
1028,463,565,1171,339100,99824
16,16,0,-,325000,99825
185,160,25,1111,247400,99826
946,574,372,694,262500,99827
271,183,88,1097,235800,99829
171,121,50,833,147900,99830
47,36,11,870,121900,99832
1204,850,354,931,228400,99833
3572,2171,1401,1159,365800,99835
31,28,3,-,97500,99836
411,263,148,1090,397200,99840
62,55,7,-,239100,99841
5299,3385,1914,1188,299500,99901
1,1,0,-,-,99903
115,103,12,-,183900,99918
264,202,62,813,163500,99919
827,581,246,845,241700,99921
128,87,41,663,114200,99922
12,12,0,-,-,99923
365,259,106,789,243000,99925
440,338,102,650,159600,99926
0,0,0,-,-,99927
988,704,284,868,221800,99929
